date,season,team,opponent,runs,oppRuns,moneyLine,runLine,runLineOdds,total,overOdds,underOdds,oppMoneyLine,oppRunLine,oppRunLineOdds,projectedRuns,parkName,totalRuns,runDif
2014-03-22,2014,LAD,ARI,3,1,-170,-1.5,-104,6.5,-120,100,150,1.5,-116,4.09,Sydney Cricket Ground,4,2
2014-03-22,2014,ARI,LAD,1,3,150,1.5,-116,6.5,-120,100,-170,-1.5,-104,2.6,Sydney Cricket Ground,4,-2
2014-03-23,2014,LAD,ARI,7,5,-119,-1.5,140,7.5,-115,-105,109,1.5,-160,4.08,Sydney Cricket Ground,12,2
2014-03-23,2014,ARI,LAD,5,7,109,1.5,-160,7.5,-115,-105,-119,-1.5,140,3.59,Sydney Cricket Ground,12,-2
2014-03-30,2014,SD,LAD,3,1,105,1.5,-170,6.5,-105,-115,-115,-1.5,150,3.17,PETCO Park,4,2
2014-03-30,2014,LAD,SD,1,3,-115,-1.5,150,6.5,-105,-115,105,1.5,-170,3.48,PETCO Park,4,-2
2014-03-31,2014,SF,ARI,9,8,-118,-1.5,140,8.0,-114,-106,108,1.5,-160,4.33,Chase Field,17,1
2014-03-31,2014,MIL,ATL,2,0,103,1.5,-165,8.0,-105,-115,-113,-1.5,145,3.94,Miller Park,2,2
2014-03-31,2014,BOS,BAL,1,2,-115,-1.5,140,9.0,105,-125,105,1.5,-160,4.81,Camden Yards,3,-1
2014-03-31,2014,BAL,BOS,2,1,105,1.5,-160,9.0,105,-125,-115,-1.5,140,4.39,Camden Yards,3,1
2014-03-31,2014,PIT,CHC,1,0,-190,-1.5,125,6.5,-110,-110,170,1.5,-145,4.26,PNC Park,1,1
2014-03-31,2014,STL,CIN,1,0,-120,-1.5,135,7.0,-110,-110,110,1.5,-155,3.82,Great American Ballpark,1,1
2014-03-31,2014,OAK,CLE,0,2,-145,-1.5,155,7.0,-114,-106,130,1.5,-175,4.14,Oakland Coliseum,2,-2
2014-03-31,2014,MIA,COL,10,1,-145,-1.5,155,6.5,100,-120,130,1.5,-175,3.85,Marlins Park,11,9
2014-03-31,2014,MIN,CWS,3,5,155,1.5,-145,7.0,-120,100,-175,-1.5,125,2.75,Guaranteed Rate Field,8,-2
2014-03-31,2014,KC,DET,3,4,133,1.5,-170,7.0,-105,-115,-148,-1.5,150,3.0,Comerica Park,7,-1
2014-03-31,2014,DET,KC,4,3,-148,-1.5,150,7.0,-105,-115,133,1.5,-170,4.18,Comerica Park,7,1
2014-03-31,2014,SEA,LAA,10,3,104,1.5,-212,7.0,-114,-106,-114,-1.5,182,3.43,Angel Stadium,13,7
2014-03-31,2014,COL,MIA,1,10,130,1.5,-175,6.5,100,-120,-145,-1.5,155,2.83,Marlins Park,11,-9
2014-03-31,2014,ATL,MIL,0,2,-113,-1.5,145,8.0,-105,-115,103,1.5,-165,4.24,Miller Park,2,-2
2014-03-31,2014,CWS,MIN,5,3,-175,-1.5,125,7.0,-120,100,155,1.5,-145,4.45,Guaranteed Rate Field,8,2
2014-03-31,2014,WSH,NYM,9,7,-179,-1.5,-105,6.5,100,-120,159,1.5,-115,4.17,Citi Field,16,2
2014-03-31,2014,CLE,OAK,2,0,130,1.5,-175,7.0,-114,-106,-145,-1.5,155,3.04,Oakland Coliseum,2,2
2014-03-31,2014,TEX,PHI,10,14,-105,-1.5,185,7.5,-115,-105,-105,1.5,-215,3.84,Rangers Ballpark,24,-4
2014-03-31,2014,CHC,PIT,0,1,170,1.5,-145,6.5,-110,-110,-190,-1.5,125,2.41,PNC Park,1,-1
2014-03-31,2014,LAA,SEA,3,10,-114,-1.5,182,7.0,-114,-106,104,1.5,-212,3.73,Angel Stadium,13,-7
2014-03-31,2014,ARI,SF,8,9,108,1.5,-160,8.0,-114,-106,-118,-1.5,140,3.85,Chase Field,17,-1
2014-03-31,2014,CIN,STL,0,1,110,1.5,-155,7.0,-110,-110,-120,-1.5,135,3.33,Great American Ballpark,1,-1
2014-03-31,2014,TOR,TB,2,9,149,1.5,-155,7.0,-105,-115,-164,-1.5,135,2.81,Tropicana Field,11,-7
2014-03-31,2014,PHI,TEX,14,10,-105,1.5,-215,7.5,-115,-105,-105,-1.5,185,3.84,Rangers Ballpark,24,4
2014-03-31,2014,TB,TOR,9,2,-164,-1.5,135,7.0,-105,-115,149,1.5,-155,4.35,Tropicana Field,11,7
2014-03-31,2014,NYM,WSH,7,9,159,1.5,-115,6.5,100,-120,-179,-1.5,-105,2.51,Citi Field,16,-2
2014-04-01,2014,SF,ARI,4,5,107,1.5,-205,8.5,-110,-110,-117,-1.5,175,4.11,Chase Field,9,-1
2014-04-01,2014,MIL,ATL,2,5,-114,-1.5,175,8.5,-110,-110,104,1.5,-205,4.53,Miller Park,7,-3
2014-04-01,2014,MIA,COL,4,3,112,1.5,-165,7.0,-115,-105,-122,-1.5,145,3.3,Marlins Park,7,1
2014-04-01,2014,NYY,HOU,2,6,-150,-1.5,110,8.5,-120,100,135,1.5,-130,5.1,Minute Maid Park,8,-4
2014-04-01,2014,SEA,LAA,8,3,150,1.5,-145,7.5,105,-125,-170,-1.5,125,3.0,Angel Stadium,11,5
2014-04-01,2014,SD,LAD,2,3,135,1.5,-135,6.5,-110,-110,-150,-1.5,115,2.77,PETCO Park,5,-1
2014-04-01,2014,COL,MIA,3,4,-122,-1.5,145,7.0,-115,-105,112,1.5,-165,3.85,Marlins Park,7,-1
2014-04-01,2014,ATL,MIL,5,2,104,1.5,-205,8.5,-110,-110,-114,-1.5,175,4.17,Miller Park,7,3
2014-04-01,2014,HOU,NYY,6,2,135,1.5,-130,8.5,-120,100,-150,-1.5,110,3.62,Minute Maid Park,8,4
2014-04-01,2014,TEX,PHI,3,2,-146,-1.5,145,8.5,-115,-105,131,1.5,-165,5.04,Rangers Ballpark,5,1
2014-04-01,2014,LAD,SD,3,2,-150,-1.5,115,6.5,-110,-110,135,1.5,-135,3.9,PETCO Park,5,1
2014-04-01,2014,LAA,SEA,3,8,-170,-1.5,125,7.5,105,-125,150,1.5,-145,4.72,Angel Stadium,11,-5
2014-04-01,2014,ARI,SF,5,4,-117,-1.5,175,8.5,-110,-110,107,1.5,-205,4.58,Chase Field,9,1
2014-04-01,2014,TOR,TB,4,2,150,1.5,-145,7.5,-105,-115,-165,-1.5,125,3.0,Tropicana Field,6,2
2014-04-01,2014,PHI,TEX,2,3,131,1.5,-165,8.5,-115,-105,-146,-1.5,145,3.68,Rangers Ballpark,5,-1
2014-04-01,2014,TB,TOR,2,4,-165,-1.5,125,7.5,-105,-115,150,1.5,-145,4.67,Tropicana Field,6,-2
2014-04-02,2014,SF,ARI,2,0,-105,1.5,-215,8.5,-120,100,-105,-1.5,185,4.35,Chase Field,2,2
2014-04-02,2014,MIL,ATL,0,1,-124,-1.5,150,9.0,-105,-115,114,1.5,-170,4.98,Miller Park,1,-1
2014-04-02,2014,BOS,BAL,6,2,-117,-1.5,140,8.5,-115,-105,107,1.5,-160,4.58,Camden Yards,8,4
2014-04-02,2014,BAL,BOS,2,6,107,1.5,-160,8.5,-115,-105,-117,-1.5,140,4.11,Camden Yards,8,-4
2014-04-02,2014,PIT,CHC,4,3,-155,-1.5,147,7.0,110,-130,140,1.5,-167,4.25,PNC Park,7,1
2014-04-02,2014,STL,CIN,0,1,-116,-1.5,145,7.0,-110,-110,106,1.5,-165,3.76,Great American Ballpark,1,-1
2014-04-02,2014,OAK,CLE,6,1,-145,-1.5,155,7.5,-105,-130,118,1.5,-185,4.44,Oakland Coliseum,7,5
2014-04-02,2014,OAK,CLE,4,6,-128,-1.5,165,8.0,110,-115,130,1.5,-175,4.49,Oakland Coliseum,10,-2
2014-04-02,2014,MIA,COL,5,6,-123,-1.5,175,7.5,102,-122,113,1.5,-205,4.14,Marlins Park,11,-1
2014-04-02,2014,MIN,CWS,6,7,125,1.5,-175,8.0,102,-122,-140,-1.5,155,3.56,Guaranteed Rate Field,13,-1
2014-04-02,2014,KC,DET,1,2,170,1.5,-125,7.5,-107,-113,-200,-1.5,105,2.78,Comerica Park,3,-1
2014-04-02,2014,NYY,HOU,1,3,-170,-1.5,-110,8.0,-122,102,150,1.5,-110,5.04,Minute Maid Park,4,-2
2014-04-02,2014,DET,KC,2,1,-200,-1.5,105,7.5,-107,-113,170,1.5,-125,5.0,Comerica Park,3,1
2014-04-02,2014,SEA,LAA,8,2,127,1.5,-175,7.5,105,-125,-142,-1.5,155,3.3,Angel Stadium,10,6
2014-04-02,2014,SD,LAD,1,5,-110,-1.5,190,6.5,-125,105,100,1.5,-230,3.4,PETCO Park,6,-4
2014-04-02,2014,COL,MIA,6,5,113,1.5,-205,7.5,102,-122,-123,-1.5,175,3.52,Marlins Park,11,1
2014-04-02,2014,ATL,MIL,1,0,114,1.5,-170,9.0,-105,-115,-124,-1.5,150,4.21,Miller Park,1,1
2014-04-02,2014,CWS,MIN,7,6,-140,-1.5,155,8.0,102,-122,125,1.5,-175,4.67,Guaranteed Rate Field,13,1
2014-04-02,2014,WSH,NYM,5,1,-122,-1.5,140,6.5,-120,100,112,1.5,-160,3.57,Citi Field,6,4
2014-04-02,2014,HOU,NYY,3,1,150,1.5,-110,8.0,-122,102,-170,-1.5,-110,3.2,Minute Maid Park,4,2
2014-04-02,2014,CLE,OAK,1,6,118,1.5,-185,8.0,-105,-130,-145,-1.5,155,3.67,Oakland Coliseum,7,-5
2014-04-02,2014,CLE,OAK,6,4,130,1.5,-175,7.5,110,-115,-128,-1.5,165,3.26,Oakland Coliseum,10,2
2014-04-02,2014,TEX,PHI,4,3,-170,-1.5,115,9.5,-110,-110,150,1.5,-135,5.98,Rangers Ballpark,7,1
2014-04-02,2014,CHC,PIT,3,4,140,1.5,-167,7.0,110,-130,-155,-1.5,147,2.92,PNC Park,7,-1
2014-04-02,2014,LAD,SD,5,1,100,1.5,-230,6.5,-125,105,-110,-1.5,190,3.25,PETCO Park,6,4
2014-04-02,2014,LAA,SEA,2,8,-142,-1.5,155,7.5,105,-125,127,1.5,-175,4.4,Angel Stadium,10,-6
2014-04-02,2014,ARI,SF,0,2,-105,-1.5,185,8.5,-120,100,-105,1.5,-215,4.35,Chase Field,2,-2
2014-04-02,2014,CIN,STL,1,0,106,1.5,-165,7.0,-110,-110,-116,-1.5,145,3.4,Great American Ballpark,1,1
2014-04-02,2014,TOR,TB,3,0,138,1.5,-160,8.0,100,-120,-153,-1.5,140,3.36,Tropicana Field,3,3
2014-04-02,2014,PHI,TEX,3,4,150,1.5,-135,9.5,-110,-110,-170,-1.5,115,3.8,Rangers Ballpark,7,-1
2014-04-02,2014,TB,TOR,0,3,-153,-1.5,140,8.0,100,-120,138,1.5,-160,4.84,Tropicana Field,3,-3
2014-04-02,2014,NYM,WSH,1,5,112,1.5,-160,6.5,-120,100,-122,-1.5,140,3.07,Citi Field,6,-4
2014-04-03,2014,SF,ARI,8,5,107,1.5,-200,8.5,-110,-110,-117,-1.5,170,4.11,Chase Field,13,3
2014-04-03,2014,BOS,BAL,4,3,-101,1.5,-210,9.0,-105,-115,-109,-1.5,180,4.52,Camden Yards,7,1
2014-04-03,2014,BAL,BOS,3,4,-109,-1.5,180,9.0,-105,-115,-101,1.5,-210,4.69,Camden Yards,7,-1
2014-04-03,2014,PIT,CHC,2,3,-159,-1.5,140,7.0,-115,-105,144,1.5,-160,4.3,PNC Park,5,-1
2014-04-03,2014,STL,CIN,7,6,102,1.5,-220,7.5,100,-120,-112,-1.5,190,3.71,Great American Ballpark,13,1
2014-04-03,2014,MIA,COL,8,5,103,1.5,-170,7.5,105,-125,-113,-1.5,150,3.69,Marlins Park,13,3
2014-04-03,2014,MIN,CWS,10,9,125,1.5,-170,7.5,-110,-110,-140,-1.5,150,3.33,Guaranteed Rate Field,19,1
2014-04-03,2014,NYY,HOU,4,2,-152,-1.5,110,8.5,100,-120,137,1.5,-130,5.13,Minute Maid Park,6,2
2014-04-03,2014,COL,MIA,5,8,-113,-1.5,150,7.5,105,-125,103,1.5,-170,3.98,Marlins Park,13,-3
2014-04-03,2014,CWS,MIN,9,10,-140,-1.5,150,7.5,-110,-110,125,1.5,-170,4.38,Guaranteed Rate Field,19,-1
2014-04-03,2014,WSH,NYM,8,2,-117,-1.5,145,7.0,105,-125,107,1.5,-165,3.77,Citi Field,10,6
2014-04-03,2014,HOU,NYY,2,4,137,1.5,-130,8.5,100,-120,-152,-1.5,110,3.59,Minute Maid Park,6,-2
2014-04-03,2014,SEA,OAK,2,3,125,1.5,-165,8.0,100,-120,-140,-1.5,145,3.56,Oakland Coliseum,5,-1
2014-04-03,2014,CHC,PIT,3,2,144,1.5,-160,7.0,-115,-105,-159,-1.5,140,2.87,PNC Park,5,1
2014-04-03,2014,OAK,SEA,3,2,-140,-1.5,145,8.0,100,-120,125,1.5,-165,4.67,Oakland Coliseum,5,1
2014-04-03,2014,ARI,SF,5,8,-117,-1.5,170,8.5,-110,-110,107,1.5,-200,4.58,Chase Field,13,-3
2014-04-03,2014,CIN,STL,6,7,-112,-1.5,190,7.5,100,-120,102,1.5,-220,3.96,Great American Ballpark,13,-1
2014-04-03,2014,TOR,TB,2,7,141,1.5,-150,8.0,-105,-115,-156,-1.5,130,3.32,Tropicana Field,9,-5
2014-04-03,2014,TB,TOR,7,2,-156,-1.5,130,8.0,-105,-115,141,1.5,-150,4.88,Tropicana Field,9,5
2014-04-03,2014,NYM,WSH,2,8,107,1.5,-165,7.0,105,-125,-117,-1.5,145,3.38,Citi Field,10,-6
2014-04-04,2014,COL,ARI,12,2,-126,-1.5,160,10.0,-105,-115,116,1.5,-180,5.58,Coors Field,14,10
2014-04-04,2014,WSH,ATL,1,2,-172,-1.5,125,7.5,-110,-110,152,1.5,-145,4.74,Nationals Park,3,-1
2014-04-04,2014,DET,BAL,10,4,-167,-1.5,130,7.5,-120,100,152,1.5,-150,4.69,Comerica Park,14,6
2014-04-04,2014,MIL,BOS,6,2,128,1.5,-165,8.5,-125,105,-143,-1.5,145,3.73,Fenway Park,8,4
2014-04-04,2014,PHI,CHC,7,2,135,1.5,-155,11.0,-105,-115,-150,-1.5,135,4.68,Wrigley Field,9,5
2014-04-04,2014,NYM,CIN,4,3,-109,-1.5,190,7.0,-115,-105,-101,1.5,-220,3.65,Citi Field,7,1
2014-04-04,2014,MIN,CLE,2,7,170,1.5,-130,7.5,-112,-108,-190,-1.5,110,2.78,Progressive Field,9,-5
2014-04-04,2014,ARI,COL,2,12,116,1.5,-180,10.0,-105,-115,-126,-1.5,160,4.63,Coors Field,14,-10
2014-04-04,2014,KC,CWS,7,5,-152,-1.5,140,8.5,100,-120,137,1.5,-160,5.13,Kauffman Stadium,12,2
2014-04-04,2014,BAL,DET,4,10,152,1.5,-150,7.5,-120,100,-167,-1.5,130,2.98,Comerica Park,14,-6
2014-04-04,2014,LAA,HOU,11,1,-180,-1.5,-115,9.5,100,-120,160,1.5,-105,6.11,Minute Maid Park,12,10
2014-04-04,2014,CWS,KC,5,7,137,1.5,-160,8.5,100,-120,-152,-1.5,140,3.59,Kauffman Stadium,12,-2
2014-04-04,2014,HOU,LAA,1,11,160,1.5,-105,9.5,100,-120,-180,-1.5,-115,3.65,Minute Maid Park,12,-10
2014-04-04,2014,SF,LAD,8,4,165,1.5,-150,7.5,103,-123,-185,-1.5,130,2.83,Dodger Stadium,12,4
2014-04-04,2014,SD,MIA,2,8,-103,1.5,-215,7.5,-110,-110,-107,-1.5,185,3.81,Marlins Park,10,-6
2014-04-04,2014,BOS,MIL,2,6,-143,-1.5,145,8.5,-125,105,128,1.5,-165,5.0,Fenway Park,8,-4
2014-04-04,2014,CLE,MIN,7,2,-190,-1.5,110,7.5,-112,-108,170,1.5,-130,4.91,Progressive Field,9,5
2014-04-04,2014,CIN,NYM,3,4,-101,1.5,-220,7.0,-115,-105,-109,-1.5,190,3.52,Citi Field,7,-1
2014-04-04,2014,TOR,NYY,3,7,128,1.5,-140,8.5,-115,-105,-143,-1.5,120,3.73,Rogers Centre,10,-4
2014-04-04,2014,CHC,PHI,2,7,-150,-1.5,135,11.0,-105,-115,135,1.5,-155,6.6,Wrigley Field,9,-5
2014-04-04,2014,STL,PIT,2,12,-102,1.5,-240,7.0,105,-125,-108,-1.5,200,3.53,PNC Park,14,-10
2014-04-04,2014,MIA,SD,8,2,-107,-1.5,185,7.5,-110,-110,-103,1.5,-215,3.88,Marlins Park,10,6
2014-04-04,2014,LAD,SF,4,8,-185,-1.5,130,7.5,103,-123,165,1.5,-150,4.87,Dodger Stadium,12,-4
2014-04-04,2014,PIT,STL,12,2,-108,-1.5,200,7.0,105,-125,-102,1.5,-240,3.63,PNC Park,14,10
2014-04-04,2014,TEX,TB,1,8,139,1.5,-155,8.5,-113,-107,-154,-1.5,135,3.56,Tropicana Field,9,-7
2014-04-04,2014,TB,TEX,8,1,-154,-1.5,135,8.5,-113,-107,139,1.5,-155,5.15,Tropicana Field,9,7
2014-04-04,2014,NYY,TOR,7,3,-143,-1.5,120,8.5,-115,-105,128,1.5,-140,5.0,Rogers Centre,10,4
2014-04-04,2014,ATL,WSH,2,1,152,1.5,-145,7.5,-110,-110,-172,-1.5,125,2.98,Nationals Park,3,1
2014-04-05,2014,COL,ARI,9,4,-117,-1.5,170,9.5,-105,-115,107,1.5,-200,5.12,Coors Field,13,5
2014-04-05,2014,WSH,ATL,2,6,-158,-1.5,145,6.5,-105,-115,143,1.5,-165,3.98,Nationals Park,8,-4
2014-04-05,2014,DET,BAL,7,6,-133,-1.5,155,8.5,-120,100,118,1.5,-175,4.85,Comerica Park,13,1
2014-04-05,2014,MIL,BOS,7,6,170,1.5,-140,8.5,-110,-110,-190,-1.5,120,3.15,Fenway Park,13,1
2014-04-05,2014,PHI,CHC,2,0,-116,-1.5,155,6.5,-105,-115,106,1.5,-175,3.49,Wrigley Field,2,2
2014-04-05,2014,NYM,CIN,6,3,115,1.5,-150,6.5,-115,-105,-130,-1.5,130,3.02,Citi Field,9,3
2014-04-05,2014,MIN,CLE,7,3,143,1.5,-155,8.5,-105,-115,-158,-1.5,135,3.5,Progressive Field,10,4
2014-04-05,2014,ARI,COL,4,9,107,1.5,-200,9.5,-105,-115,-117,-1.5,170,4.59,Coors Field,13,-5
2014-04-05,2014,KC,CWS,4,3,-151,-1.5,140,8.0,-105,-115,136,1.5,-160,4.81,Kauffman Stadium,7,1
2014-04-05,2014,BAL,DET,6,7,118,1.5,-175,8.5,-120,100,-133,-1.5,155,3.9,Comerica Park,13,-1
2014-04-05,2014,LAA,HOU,5,1,-150,-1.5,105,9.0,-110,-110,135,1.5,-125,5.4,Minute Maid Park,6,4
2014-04-05,2014,CWS,KC,3,4,136,1.5,-160,8.0,-105,-115,-151,-1.5,140,3.39,Kauffman Stadium,7,-1
2014-04-05,2014,HOU,LAA,1,5,135,1.5,-125,9.0,-110,-110,-150,-1.5,105,3.83,Minute Maid Park,6,-4
2014-04-05,2014,SF,LAD,7,2,-112,-1.5,150,7.5,100,-120,102,1.5,-170,3.96,Dodger Stadium,9,5
2014-04-05,2014,SD,MIA,0,5,135,1.5,-170,6.5,100,-120,-150,-1.5,150,2.77,Marlins Park,5,-5
2014-04-05,2014,BOS,MIL,6,7,-190,-1.5,120,8.5,-110,-110,170,1.5,-140,5.57,Fenway Park,13,-1
2014-04-05,2014,CLE,MIN,3,7,-158,-1.5,135,8.5,-105,-115,143,1.5,-155,5.21,Progressive Field,10,-4
2014-04-05,2014,CIN,NYM,3,6,-130,-1.5,130,6.5,-115,-105,115,1.5,-150,3.67,Citi Field,9,-3
2014-04-05,2014,TOR,NYY,4,0,-129,-1.5,145,9.0,100,-120,119,1.5,-165,5.07,Rogers Centre,4,4
2014-04-05,2014,SEA,OAK,3,1,-122,-1.5,140,7.0,100,-120,112,1.5,-160,3.85,Oakland Coliseum,4,2
2014-04-05,2014,CHC,PHI,0,2,106,1.5,-175,6.5,-105,-115,-116,-1.5,155,3.16,Wrigley Field,2,-2
2014-04-05,2014,STL,PIT,6,1,130,1.5,-180,7.0,100,-120,-145,-1.5,160,3.04,PNC Park,7,5
2014-04-05,2014,MIA,SD,5,0,-150,-1.5,150,6.5,100,-120,135,1.5,-170,3.9,Marlins Park,5,5
2014-04-05,2014,OAK,SEA,1,3,112,1.5,-160,7.0,100,-120,-122,-1.5,140,3.3,Oakland Coliseum,4,-2
2014-04-05,2014,LAD,SF,2,7,102,1.5,-170,7.5,100,-120,-112,-1.5,150,3.71,Dodger Stadium,9,-5
2014-04-05,2014,PIT,STL,1,6,-145,-1.5,160,7.0,100,-120,130,1.5,-180,4.14,PNC Park,7,-5
2014-04-05,2014,TEX,TB,4,5,160,1.5,-140,7.5,-110,-110,-180,-1.5,120,2.88,Tropicana Field,9,-1
2014-04-05,2014,TB,TEX,5,4,-180,-1.5,120,7.5,-110,-110,160,1.5,-140,4.82,Tropicana Field,9,1
2014-04-05,2014,NYY,TOR,0,4,119,1.5,-165,9.0,100,-120,-129,-1.5,145,4.11,Rogers Centre,4,-4
2014-04-05,2014,ATL,WSH,6,2,143,1.5,-165,6.5,-105,-115,-158,-1.5,145,2.67,Nationals Park,8,4
2014-04-06,2014,COL,ARI,3,5,-126,-1.5,160,9.0,-110,-110,116,1.5,-180,5.02,Coors Field,8,-2
2014-04-06,2014,WSH,ATL,2,1,-103,-1.5,195,7.0,100,-120,-107,1.5,-225,3.55,Nationals Park,3,1
2014-04-06,2014,DET,BAL,1,3,-154,-1.5,140,7.5,-105,-115,139,1.5,-160,4.55,Comerica Park,4,-2
2014-04-06,2014,MIL,BOS,4,0,141,1.5,-150,9.0,100,-120,-156,-1.5,130,3.73,Fenway Park,4,4
2014-04-06,2014,PHI,CHC,3,8,-114,-1.5,155,7.5,107,-127,104,1.5,-175,4.0,Wrigley Field,11,-5
2014-04-06,2014,NYM,CIN,1,2,-106,-1.5,195,7.0,-115,-105,-104,1.5,-225,3.6,Citi Field,3,-1
2014-04-06,2014,MIN,CLE,10,7,175,1.5,-130,7.5,103,-123,-195,-1.5,110,2.73,Progressive Field,17,3
2014-04-06,2014,ARI,COL,5,3,116,1.5,-180,9.0,-110,-110,-126,-1.5,160,4.17,Coors Field,8,2
2014-04-06,2014,KC,CWS,1,5,-116,-1.5,180,7.0,100,-120,106,1.5,-210,3.76,Kauffman Stadium,6,-4
2014-04-06,2014,BAL,DET,3,1,139,1.5,-160,7.5,-105,-115,-154,-1.5,140,3.14,Comerica Park,4,2
2014-04-06,2014,LAA,HOU,4,7,-156,-1.5,105,8.0,-120,100,141,1.5,-125,4.88,Minute Maid Park,11,-3
2014-04-06,2014,CWS,KC,5,1,106,1.5,-210,7.0,100,-120,-116,-1.5,180,3.4,Kauffman Stadium,6,4
2014-04-06,2014,HOU,LAA,7,4,141,1.5,-125,8.0,-120,100,-156,-1.5,105,3.32,Minute Maid Park,11,3
2014-04-06,2014,SF,LAD,2,6,132,1.5,-164,6.5,-125,105,-147,-1.5,144,2.8,Dodger Stadium,8,-4
2014-04-06,2014,SD,MIA,4,2,109,1.5,-195,7.5,-105,-115,-119,-1.5,165,3.59,Marlins Park,6,2
2014-04-06,2014,BOS,MIL,0,4,-156,-1.5,130,9.0,100,-120,141,1.5,-150,5.48,Fenway Park,4,-4
2014-04-06,2014,CLE,MIN,7,10,-195,-1.5,110,7.5,103,-123,175,1.5,-130,4.96,Progressive Field,17,-3
2014-04-06,2014,CIN,NYM,2,1,-104,1.5,-225,7.0,-115,-105,-106,-1.5,195,3.57,Citi Field,3,1
2014-04-06,2014,TOR,NYY,4,6,-121,-1.5,170,8.5,-115,-105,111,1.5,-200,4.65,Rogers Centre,10,-2
2014-04-06,2014,SEA,OAK,3,6,132,1.5,-161,7.5,-108,-112,-147,-1.5,141,3.23,Oakland Coliseum,9,-3
2014-04-06,2014,CHC,PHI,8,3,104,1.5,-175,7.5,107,-127,-114,-1.5,155,3.68,Wrigley Field,11,5
2014-04-06,2014,STL,PIT,1,2,-165,-1.5,-101,7.0,-106,-114,150,1.5,-119,4.36,PNC Park,3,-1
2014-04-06,2014,MIA,SD,2,4,-119,-1.5,165,7.5,-105,-115,109,1.5,-195,4.08,Marlins Park,6,-2
2014-04-06,2014,OAK,SEA,6,3,-147,-1.5,141,7.5,-108,-112,132,1.5,-161,4.46,Oakland Coliseum,9,3
2014-04-06,2014,LAD,SF,6,2,-147,-1.5,144,6.5,-125,105,132,1.5,-164,3.87,Dodger Stadium,8,4
2014-04-06,2014,PIT,STL,2,1,150,1.5,-119,7.0,-106,-114,-165,-1.5,-101,2.8,PNC Park,3,1
2014-04-06,2014,TEX,TB,3,0,-108,-1.5,165,7.0,-110,-110,-102,1.5,-185,3.63,Tropicana Field,3,3
2014-04-06,2014,TB,TEX,0,3,-102,1.5,-185,7.0,-110,-110,-108,-1.5,165,3.53,Tropicana Field,3,-3
2014-04-06,2014,NYY,TOR,6,4,111,1.5,-200,8.5,-115,-105,-121,-1.5,170,4.03,Rogers Centre,10,2
2014-04-06,2014,ATL,WSH,1,2,-107,1.5,-225,7.0,100,-120,-103,-1.5,195,3.62,Nationals Park,3,-1
2014-04-07,2014,NYY,BAL,4,2,-142,-1.5,155,8.0,-110,-110,127,1.5,-175,4.69,Yankee Stadium,6,2
2014-04-07,2014,TEX,BOS,1,5,138,1.5,-145,9.0,-125,105,-153,-1.5,125,3.78,Fenway Park,6,-4
2014-04-07,2014,STL,CIN,5,3,-153,-1.5,155,6.5,100,-120,138,1.5,-175,3.93,Busch Stadium,8,2
2014-04-07,2014,CWS,COL,1,8,136,1.5,-155,9.5,-110,-110,-151,-1.5,135,4.03,Coors Field,9,-7
2014-04-07,2014,COL,CWS,8,1,-151,-1.5,135,9.5,-110,-110,136,1.5,-155,5.72,Coors Field,9,7
2014-04-07,2014,LAA,HOU,9,1,-160,-1.5,-101,8.5,-115,-105,145,1.5,-119,5.23,Minute Maid Park,10,8
2014-04-07,2014,TB,KC,2,4,-101,1.5,-220,7.5,-110,-110,-109,-1.5,190,3.77,Kauffman Stadium,6,-2
2014-04-07,2014,HOU,LAA,1,9,145,1.5,-119,8.5,-115,-105,-160,-1.5,-101,3.47,Minute Maid Park,10,-8
2014-04-07,2014,OAK,MIN,8,3,-144,-1.5,115,8.0,-105,-115,129,1.5,-135,4.72,Target Field,11,5
2014-04-07,2014,BAL,NYY,2,4,127,1.5,-175,8.0,-110,-110,-142,-1.5,155,3.52,Yankee Stadium,6,-2
2014-04-07,2014,MIN,OAK,3,8,129,1.5,-135,8.0,-105,-115,-144,-1.5,115,3.49,Target Field,11,-5
2014-04-07,2014,CIN,STL,3,5,138,1.5,-175,6.5,100,-120,-153,-1.5,155,2.73,Busch Stadium,8,-2
2014-04-07,2014,KC,TB,4,2,-109,-1.5,190,7.5,-110,-110,-101,1.5,-220,3.91,Kauffman Stadium,6,2
2014-04-07,2014,BOS,TEX,5,1,-153,-1.5,125,9.0,-125,105,138,1.5,-145,5.44,Fenway Park,6,4
2014-04-08,2014,SF,ARI,7,3,-155,-1.5,145,7.5,-101,-119,140,1.5,-165,4.56,AT&T Park,10,4
2014-04-08,2014,NYM,ATL,4,0,119,1.5,-190,7.0,-115,-105,-129,-1.5,160,3.2,Turner Field,4,4
2014-04-08,2014,NYY,BAL,5,14,-105,-1.5,169,9.0,-125,105,-105,1.5,-199,4.61,Yankee Stadium,19,-9
2014-04-08,2014,TEX,BOS,10,7,118,1.5,-180,9.5,100,-120,-128,-1.5,160,4.36,Fenway Park,17,3
2014-04-08,2014,PIT,CHC,7,6,-118,-1.5,145,7.0,-120,100,108,1.5,-165,3.79,Wrigley Field,13,1
2014-04-08,2014,STL,CIN,7,5,-133,-1.5,170,7.0,-110,-110,118,1.5,-200,4.0,Busch Stadium,12,2
2014-04-08,2014,SD,CLE,6,8,119,1.5,-190,7.5,100,-120,-129,-1.5,160,3.42,Progressive Field,14,-2
2014-04-08,2014,CWS,COL,15,3,140,1.5,-155,9.5,100,-120,-155,-1.5,135,3.96,Coors Field,18,12
2014-04-08,2014,COL,CWS,3,15,-155,-1.5,135,9.5,100,-120,140,1.5,-155,5.77,Coors Field,18,-12
2014-04-08,2014,LAD,DET,3,2,112,1.5,-170,7.0,100,-120,-122,-1.5,150,3.3,Dodger Stadium,5,1
2014-04-08,2014,TOR,HOU,5,2,-205,-1.5,-101,9.5,100,-120,175,1.5,-119,6.39,Rogers Centre,7,3
2014-04-08,2014,TB,KC,1,0,-109,-1.5,150,7.5,-113,-107,-101,1.5,-170,3.91,Kauffman Stadium,1,1
2014-04-08,2014,SEA,LAA,5,3,-120,-1.5,170,7.5,-110,-110,110,1.5,-200,4.09,T-Mobile Park,8,2
2014-04-08,2014,DET,LAD,2,3,-122,-1.5,150,7.0,100,-120,112,1.5,-170,3.85,Dodger Stadium,5,-1
2014-04-08,2014,WSH,MIA,5,0,-200,-1.5,110,7.0,-120,100,170,1.5,-130,4.67,Nationals Park,5,5
2014-04-08,2014,PHI,MIL,4,10,119,1.5,-160,9.0,100,-120,-129,-1.5,140,4.11,Citizens Bank Park,14,-6
2014-04-08,2014,ATL,NYM,0,4,-129,-1.5,160,7.0,-115,-105,119,1.5,-190,3.94,Turner Field,4,-4
2014-04-08,2014,BAL,NYY,14,5,-105,1.5,-199,9.0,-125,105,-105,-1.5,169,4.61,Yankee Stadium,19,9
2014-04-08,2014,MIL,PHI,10,4,-129,-1.5,140,9.0,100,-120,119,1.5,-160,5.07,Citizens Bank Park,14,6
2014-04-08,2014,CHC,PIT,6,7,108,1.5,-165,7.0,-120,100,-118,-1.5,145,3.37,Wrigley Field,13,-1
2014-04-08,2014,CLE,SD,8,6,-129,-1.5,160,7.5,100,-120,119,1.5,-190,4.22,Progressive Field,14,2
2014-04-08,2014,LAA,SEA,3,5,110,1.5,-200,7.5,-110,-110,-120,-1.5,170,3.57,T-Mobile Park,8,-2
2014-04-08,2014,ARI,SF,3,7,140,1.5,-165,7.5,-101,-119,-155,-1.5,145,3.13,AT&T Park,10,-4
2014-04-08,2014,CIN,STL,5,7,118,1.5,-200,7.0,-110,-110,-133,-1.5,170,3.21,Busch Stadium,12,-2
2014-04-08,2014,KC,TB,0,1,-101,1.5,-170,7.5,-113,-107,-109,-1.5,150,3.77,Kauffman Stadium,1,-1
2014-04-08,2014,BOS,TEX,7,10,-128,-1.5,160,9.5,100,-120,118,1.5,-180,5.33,Fenway Park,17,-3
2014-04-08,2014,HOU,TOR,2,5,175,1.5,-119,9.5,100,-120,-205,-1.5,-101,3.45,Rogers Centre,7,-3
2014-04-08,2014,MIA,WSH,0,5,170,1.5,-130,7.0,-120,100,-200,-1.5,110,2.59,Nationals Park,5,-5
2014-04-09,2014,SF,ARI,3,7,-126,-1.5,170,7.5,-105,-115,116,1.5,-200,4.18,AT&T Park,10,-4
2014-04-09,2014,NYM,ATL,3,4,152,1.5,-155,7.0,-106,-114,-167,-1.5,135,2.78,Turner Field,7,-1
2014-04-09,2014,NYY,BAL,4,5,-177,-1.5,115,8.0,-105,-115,157,1.5,-135,5.11,Yankee Stadium,9,-1
2014-04-09,2014,TEX,BOS,2,4,130,1.5,-165,8.5,-120,100,-145,-1.5,145,3.7,Fenway Park,6,-2
2014-04-09,2014,PIT,CHC,5,7,-109,-1.5,145,9.0,-105,-115,-101,1.5,-165,4.69,Wrigley Field,12,-2
2014-04-09,2014,STL,CIN,0,4,-143,-1.5,155,7.5,105,-125,128,1.5,-175,4.41,Busch Stadium,4,-4
2014-04-09,2014,SD,CLE,0,2,135,1.5,-160,8.0,-115,-105,-150,-1.5,140,3.4,Progressive Field,2,-2
2014-04-09,2014,SD,CLE,2,1,109,1.5,-200,8.5,-105,-115,-119,-1.5,170,4.07,Progressive Field,3,1
2014-04-09,2014,CWS,COL,4,10,150,1.5,-140,10.0,-110,-110,-170,-1.5,120,4.0,Coors Field,14,-6
2014-04-09,2014,COL,CWS,10,4,-170,-1.5,120,10.0,-110,-110,150,1.5,-140,6.3,Coors Field,14,6
2014-04-09,2014,LAD,DET,6,7,106,1.5,-165,7.0,-105,-115,-116,-1.5,145,3.4,Dodger Stadium,13,-1
2014-04-09,2014,TOR,HOU,7,3,-205,-1.5,-110,9.0,-125,105,175,1.5,-110,6.05,Rogers Centre,10,4
2014-04-09,2014,TB,KC,3,7,-117,-1.5,130,9.0,100,-120,107,1.5,-150,4.85,Kauffman Stadium,10,-4
2014-04-09,2014,SEA,LAA,0,2,-102,1.5,-170,8.5,-115,-105,-108,-1.5,150,4.29,T-Mobile Park,2,-2
2014-04-09,2014,DET,LAD,7,6,-116,-1.5,145,7.0,-105,-115,106,1.5,-165,3.76,Dodger Stadium,13,1
2014-04-09,2014,WSH,MIA,10,7,-200,-1.5,115,7.0,-105,-115,170,1.5,-135,4.67,Nationals Park,17,3
2014-04-09,2014,PHI,MIL,4,9,116,1.5,-150,7.5,105,-125,-126,-1.5,130,3.47,Citizens Bank Park,13,-5
2014-04-09,2014,OAK,MIN,7,4,-140,-1.5,120,8.5,-104,-116,125,1.5,-140,4.96,Target Field,11,3
2014-04-09,2014,ATL,NYM,4,3,-167,-1.5,135,7.0,-106,-114,152,1.5,-155,4.38,Turner Field,7,1
2014-04-09,2014,BAL,NYY,5,4,157,1.5,-135,8.0,-105,-115,-177,-1.5,115,3.11,Yankee Stadium,9,1
2014-04-09,2014,MIN,OAK,4,7,125,1.5,-140,8.5,-104,-116,-140,-1.5,120,3.78,Target Field,11,-3
2014-04-09,2014,MIL,PHI,9,4,-126,-1.5,130,7.5,105,-125,116,1.5,-150,4.18,Citizens Bank Park,13,5
2014-04-09,2014,CHC,PIT,7,5,-101,1.5,-165,9.0,-105,-115,-109,-1.5,145,4.52,Wrigley Field,12,2
2014-04-09,2014,CLE,SD,2,0,-150,-1.5,140,8.0,-115,-105,135,1.5,-160,4.8,Progressive Field,2,2
2014-04-09,2014,CLE,SD,1,2,-119,-1.5,170,8.5,-105,-115,109,1.5,-200,4.62,Progressive Field,3,-1
2014-04-09,2014,LAA,SEA,2,0,-108,-1.5,150,8.5,-115,-105,-102,1.5,-170,4.41,T-Mobile Park,2,2
2014-04-09,2014,ARI,SF,7,3,116,1.5,-200,7.5,-105,-115,-126,-1.5,170,3.47,AT&T Park,10,4
2014-04-09,2014,CIN,STL,4,0,128,1.5,-175,7.5,105,-125,-143,-1.5,155,3.29,Busch Stadium,4,4
2014-04-09,2014,KC,TB,7,3,107,1.5,-150,9.0,100,-120,-117,-1.5,130,4.35,Kauffman Stadium,10,4
2014-04-09,2014,BOS,TEX,4,2,-145,-1.5,145,8.5,-120,100,130,1.5,-165,5.03,Fenway Park,6,2
2014-04-09,2014,HOU,TOR,3,7,175,1.5,-110,9.0,-125,105,-205,-1.5,-110,3.27,Rogers Centre,10,-4
2014-04-09,2014,MIA,WSH,7,10,170,1.5,-135,7.0,-105,-115,-200,-1.5,115,2.59,Nationals Park,17,-3
2014-04-10,2014,SF,ARI,5,6,-117,-1.5,180,8.0,-120,100,107,1.5,-210,4.31,AT&T Park,11,-1
2014-04-10,2014,NYM,ATL,6,4,125,1.5,-180,7.5,101,-121,-140,-1.5,160,3.33,Turner Field,10,2
2014-04-10,2014,NYY,BOS,4,1,-109,-1.5,180,8.5,-113,-107,-101,1.5,-210,4.43,Yankee Stadium,5,3
2014-04-10,2014,PIT,CHC,5,4,-130,-1.5,125,7.5,105,-125,115,1.5,-145,4.24,Wrigley Field,9,1
2014-04-10,2014,CWS,CLE,7,3,116,1.5,-150,8.0,-115,-105,-126,-1.5,130,3.7,Guaranteed Rate Field,10,4
2014-04-10,2014,CLE,CWS,3,7,-126,-1.5,130,8.0,-115,-105,116,1.5,-150,4.46,Guaranteed Rate Field,10,-4
2014-04-10,2014,TOR,HOU,4,6,-203,-1.5,-105,9.5,100,-120,173,1.5,-115,6.36,Rogers Centre,10,-2
2014-04-10,2014,WSH,MIA,7,1,-220,-1.5,100,7.0,-115,-105,190,1.5,-120,4.81,Nationals Park,8,6
2014-04-10,2014,PHI,MIL,2,6,-118,-1.5,180,7.0,-120,100,108,1.5,-210,3.79,Citizens Bank Park,8,-4
2014-04-10,2014,OAK,MIN,6,1,-140,-1.5,115,8.5,100,-120,125,1.5,-135,4.96,Target Field,7,5
2014-04-10,2014,ATL,NYM,4,6,-140,-1.5,160,7.5,101,-121,125,1.5,-180,4.38,Turner Field,10,-2
2014-04-10,2014,BOS,NYY,1,4,-101,1.5,-210,8.5,-113,-107,-109,-1.5,180,4.27,Yankee Stadium,5,-3
2014-04-10,2014,MIN,OAK,1,6,125,1.5,-135,8.5,100,-120,-140,-1.5,115,3.78,Target Field,7,-5
2014-04-10,2014,MIL,PHI,6,2,108,1.5,-210,7.0,-120,100,-118,-1.5,180,3.37,Citizens Bank Park,8,4
2014-04-10,2014,CHC,PIT,4,5,115,1.5,-145,7.5,105,-125,-130,-1.5,125,3.49,Wrigley Field,9,-1
2014-04-10,2014,ARI,SF,6,5,107,1.5,-210,8.0,-120,100,-117,-1.5,180,3.86,AT&T Park,11,1
2014-04-10,2014,HOU,TOR,6,4,173,1.5,-115,9.5,100,-120,-203,-1.5,-105,3.48,Rogers Centre,10,2
2014-04-10,2014,MIA,WSH,1,7,190,1.5,-120,7.0,-115,-105,-220,-1.5,100,2.41,Nationals Park,8,-6
2014-04-11,2014,LAD,ARI,6,0,-115,-1.5,140,8.5,-125,105,105,1.5,-160,4.55,Chase Field,6,6
2014-04-11,2014,WSH,ATL,6,7,114,1.5,-205,7.5,100,-120,-124,-1.5,175,3.5,Turner Field,13,-1
2014-04-11,2014,TOR,BAL,2,0,142,1.5,-150,8.5,-115,-105,-157,-1.5,130,3.51,Camden Yards,2,2
2014-04-11,2014,NYY,BOS,2,4,116,1.5,-140,8.0,100,-120,-126,-1.5,120,3.7,Yankee Stadium,6,-2
2014-04-11,2014,STL,CHC,3,6,-141,-1.5,155,7.0,-125,105,126,1.5,-175,4.1,Busch Stadium,9,-3
2014-04-11,2014,TB,CIN,2,1,-123,-1.5,140,7.0,107,-127,113,1.5,-160,3.86,Great American Ballpark,3,1
2014-04-11,2014,CWS,CLE,9,6,-158,-1.5,135,7.5,-115,-105,143,1.5,-155,4.59,Guaranteed Rate Field,15,3
2014-04-11,2014,SF,COL,6,5,-161,-1.5,145,6.5,-105,-115,146,1.5,-165,4.01,AT&T Park,11,1
2014-04-11,2014,CLE,CWS,6,9,143,1.5,-155,7.5,-115,-105,-158,-1.5,135,3.09,Guaranteed Rate Field,15,-3
2014-04-11,2014,SD,DET,6,0,-112,-1.5,190,7.0,105,-125,102,1.5,-230,3.7,PETCO Park,6,6
2014-04-11,2014,TEX,HOU,1,0,-220,-1.5,-110,8.0,-120,100,190,1.5,-110,5.5,Rangers Ballpark,1,1
2014-04-11,2014,MIN,KC,10,1,110,1.5,-160,8.0,-110,-110,-120,-1.5,140,3.81,Target Field,11,9
2014-04-11,2014,NYM,LAA,4,5,145,1.5,-155,8.0,-105,-115,-160,-1.5,135,3.27,Angel Stadium,9,-1
2014-04-11,2014,ARI,LAD,0,6,105,1.5,-160,8.5,-125,105,-115,-1.5,140,4.15,Chase Field,6,-6
2014-04-11,2014,PHI,MIA,6,3,125,1.5,-145,7.0,-105,-115,-140,-1.5,125,3.11,Citizens Bank Park,9,3
2014-04-11,2014,PIT,MIL,2,4,105,1.5,-210,8.5,-105,-115,-115,-1.5,180,4.15,Miller Park,6,-2
2014-04-11,2014,KC,MIN,1,10,-120,-1.5,140,8.0,-110,-110,110,1.5,-160,4.36,Target Field,11,-9
2014-04-11,2014,LAA,NYM,5,4,-160,-1.5,135,8.0,-105,-115,145,1.5,-155,4.92,Angel Stadium,9,1
2014-04-11,2014,BOS,NYY,4,2,-126,-1.5,120,8.0,100,-120,116,1.5,-140,4.46,Yankee Stadium,6,2
2014-04-11,2014,SEA,OAK,6,4,-151,-1.5,150,6.5,-105,-115,136,1.5,-170,3.91,T-Mobile Park,10,2
2014-04-11,2014,MIA,PHI,3,6,-140,-1.5,125,7.0,-105,-115,125,1.5,-145,4.08,Citizens Bank Park,9,-3
2014-04-11,2014,MIL,PIT,4,2,-115,-1.5,180,8.5,-105,-115,105,1.5,-210,4.55,Miller Park,6,2
2014-04-11,2014,DET,SD,0,6,102,1.5,-230,7.0,105,-125,-112,-1.5,190,3.47,PETCO Park,6,-6
2014-04-11,2014,OAK,SEA,4,6,136,1.5,-170,6.5,-105,-115,-151,-1.5,150,2.75,T-Mobile Park,10,-2
2014-04-11,2014,COL,SF,5,6,146,1.5,-165,6.5,-105,-115,-161,-1.5,145,2.64,AT&T Park,11,-1
2014-04-11,2014,CHC,STL,6,3,126,1.5,-175,7.0,-125,105,-141,-1.5,155,3.1,Busch Stadium,9,3
2014-04-11,2014,CIN,TB,1,2,113,1.5,-160,7.0,107,-127,-123,-1.5,140,3.29,Great American Ballpark,3,-1
2014-04-11,2014,HOU,TEX,0,1,190,1.5,-110,8.0,-120,100,-220,-1.5,-110,2.76,Rangers Ballpark,1,-1
2014-04-11,2014,BAL,TOR,0,2,-157,-1.5,130,8.5,-115,-105,142,1.5,-150,5.19,Camden Yards,2,-2
2014-04-11,2014,ATL,WSH,7,6,-124,-1.5,175,7.5,100,-120,114,1.5,-205,4.15,Turner Field,13,1
2014-04-12,2014,LAD,ARI,8,5,-116,-1.5,140,8.0,-110,-110,106,1.5,-160,4.3,Chase Field,13,3
2014-04-12,2014,WSH,ATL,3,6,128,1.5,-180,7.0,-105,-115,-143,-1.5,160,3.07,Turner Field,9,-3
2014-04-12,2014,TOR,BAL,1,2,101,1.5,-205,9.0,-110,-110,-111,-1.5,175,4.48,Camden Yards,3,-1
2014-04-12,2014,NYY,BOS,7,4,-112,-1.5,180,8.5,100,-120,102,1.5,-210,4.49,Yankee Stadium,11,3
2014-04-12,2014,STL,CHC,10,4,-230,-1.5,-110,7.0,-105,-115,200,1.5,-110,4.88,Busch Stadium,14,6
2014-04-12,2014,TB,CIN,1,0,-130,-1.5,130,7.5,105,-125,115,1.5,-150,4.24,Great American Ballpark,1,1
2014-04-12,2014,CWS,CLE,6,12,115,1.5,-150,9.0,-117,-103,-125,-1.5,130,4.19,Guaranteed Rate Field,18,-6
2014-04-12,2014,SF,COL,0,1,-126,-1.5,170,7.5,-110,-110,116,1.5,-200,4.18,AT&T Park,1,-1
2014-04-12,2014,CLE,CWS,12,6,-125,-1.5,130,9.0,-117,-103,115,1.5,-150,5.0,Guaranteed Rate Field,18,6
2014-04-12,2014,SD,DET,2,6,116,1.5,-150,6.5,100,-120,-131,-1.5,130,3.01,PETCO Park,8,-4
2014-04-12,2014,TEX,HOU,5,6,-170,-1.5,115,9.5,-105,-115,150,1.5,-135,5.98,Rangers Ballpark,11,-1
2014-04-12,2014,MIN,KC,7,1,126,1.5,-130,7.5,-109,-111,-141,-1.5,110,3.32,Target Field,8,6
2014-04-12,2014,NYM,LAA,7,6,150,1.5,-145,7.5,-110,-110,-170,-1.5,125,3.0,Angel Stadium,13,1
2014-04-12,2014,ARI,LAD,5,8,106,1.5,-160,8.0,-110,-110,-116,-1.5,140,3.88,Chase Field,13,-3
2014-04-12,2014,PHI,MIA,5,4,-108,-1.5,195,8.0,-105,-115,-102,1.5,-225,4.15,Citizens Bank Park,9,1
2014-04-12,2014,PIT,MIL,2,3,130,1.5,-165,8.5,-115,-105,-145,-1.5,145,3.7,Miller Park,5,-1
2014-04-12,2014,KC,MIN,1,7,-141,-1.5,110,7.5,-109,-111,126,1.5,-130,4.39,Target Field,8,-6
2014-04-12,2014,LAA,NYM,6,7,-170,-1.5,125,7.5,-110,-110,150,1.5,-145,4.72,Angel Stadium,13,-1
2014-04-12,2014,BOS,NYY,4,7,102,1.5,-210,8.5,100,-120,-112,-1.5,180,4.21,Yankee Stadium,11,-3
2014-04-12,2014,SEA,OAK,1,3,112,1.5,-150,7.5,100,-120,-122,-1.5,130,3.54,T-Mobile Park,4,-2
2014-04-12,2014,MIA,PHI,4,5,-102,1.5,-225,8.0,-105,-115,-108,-1.5,195,4.04,Citizens Bank Park,9,-1
2014-04-12,2014,MIL,PIT,3,2,-145,-1.5,145,8.5,-115,-105,130,1.5,-165,5.03,Miller Park,5,1
2014-04-12,2014,DET,SD,6,2,-131,-1.5,130,6.5,100,-120,116,1.5,-150,3.69,PETCO Park,8,4
2014-04-12,2014,OAK,SEA,3,1,-122,-1.5,130,7.5,100,-120,112,1.5,-150,4.12,T-Mobile Park,4,2
2014-04-12,2014,COL,SF,1,0,116,1.5,-200,7.5,-110,-110,-126,-1.5,170,3.47,AT&T Park,1,1
2014-04-12,2014,CHC,STL,4,10,200,1.5,-110,7.0,-105,-115,-230,-1.5,-110,2.33,Busch Stadium,14,-6
2014-04-12,2014,CIN,TB,0,1,115,1.5,-150,7.5,105,-125,-130,-1.5,130,3.49,Great American Ballpark,1,-1
2014-04-12,2014,HOU,TEX,6,5,150,1.5,-135,9.5,-105,-115,-170,-1.5,115,3.8,Rangers Ballpark,11,1
2014-04-12,2014,BAL,TOR,2,1,-111,-1.5,175,9.0,-110,-110,101,1.5,-205,4.73,Camden Yards,3,1
2014-04-12,2014,ATL,WSH,6,3,-143,-1.5,160,7.0,-105,-115,128,1.5,-180,4.12,Turner Field,9,3
2014-04-13,2014,LAD,ARI,8,6,-120,-1.5,135,9.0,-125,105,110,1.5,-155,4.91,Chase Field,14,2
2014-04-13,2014,WSH,ATL,2,10,-130,-1.5,130,7.0,-105,-115,115,1.5,-150,3.96,Turner Field,12,-8
2014-04-13,2014,TOR,BAL,11,3,-105,1.5,-210,9.0,-105,-115,-105,-1.5,180,4.61,Camden Yards,14,8
2014-04-13,2014,NYY,BOS,3,2,-118,-1.5,175,9.0,-115,-105,108,1.5,-205,4.87,Yankee Stadium,5,1
2014-04-13,2014,STL,CHC,6,4,-245,-1.5,-115,7.5,-116,-104,205,1.5,-105,5.33,Busch Stadium,10,2
2014-04-13,2014,TB,CIN,4,12,112,1.5,-200,7.5,-120,100,-122,-1.5,170,3.54,Great American Ballpark,16,-8
2014-04-13,2014,CWS,CLE,4,3,-114,-1.5,170,9.0,105,-125,104,1.5,-200,4.79,Guaranteed Rate Field,7,1
2014-04-13,2014,SF,COL,5,4,-157,-1.5,135,7.5,-110,-110,142,1.5,-155,4.58,AT&T Park,9,1
2014-04-13,2014,CLE,CWS,3,4,104,1.5,-200,9.0,105,-125,-114,-1.5,170,4.41,Guaranteed Rate Field,7,-1
2014-04-13,2014,SD,DET,5,1,149,1.5,-125,6.5,-105,-115,-164,-1.5,105,2.61,PETCO Park,6,4
2014-04-13,2014,TEX,HOU,1,0,-160,-1.5,125,9.0,-115,-105,145,1.5,-145,5.54,Rangers Ballpark,1,1
2014-04-13,2014,MIN,KC,4,3,108,1.5,-155,8.0,-105,-115,-118,-1.5,135,3.85,Target Field,7,1
2014-04-13,2014,NYM,LAA,2,14,129,1.5,-165,8.0,-110,-110,-144,-1.5,145,3.49,Angel Stadium,16,-12
2014-04-13,2014,ARI,LAD,6,8,110,1.5,-155,9.0,-125,105,-120,-1.5,135,4.29,Chase Field,14,-2
2014-04-13,2014,PHI,MIA,4,3,-117,-1.5,175,8.5,-115,-105,107,1.5,-205,4.58,Citizens Bank Park,7,1
2014-04-13,2014,PIT,MIL,1,4,108,1.5,-205,8.5,-110,-110,-118,-1.5,175,4.09,Miller Park,5,-3
2014-04-13,2014,KC,MIN,3,4,-118,-1.5,135,8.0,-105,-115,108,1.5,-155,4.33,Target Field,7,-1
2014-04-13,2014,LAA,NYM,14,2,-144,-1.5,145,8.0,-110,-110,129,1.5,-165,4.72,Angel Stadium,16,12
2014-04-13,2014,BOS,NYY,2,3,108,1.5,-205,9.0,-115,-105,-118,-1.5,175,4.33,Yankee Stadium,5,-1
2014-04-13,2014,SEA,OAK,0,3,124,1.5,-140,7.5,110,-130,-139,-1.5,120,3.35,T-Mobile Park,3,-3
2014-04-13,2014,MIA,PHI,3,4,107,1.5,-205,8.5,-115,-105,-117,-1.5,175,4.11,Citizens Bank Park,7,-1
2014-04-13,2014,MIL,PIT,4,1,-118,-1.5,175,8.5,-110,-110,108,1.5,-205,4.6,Miller Park,5,3
2014-04-13,2014,DET,SD,1,5,-164,-1.5,105,6.5,-105,-115,149,1.5,-125,4.04,PETCO Park,6,-4
2014-04-13,2014,OAK,SEA,3,0,-139,-1.5,120,7.5,110,-130,124,1.5,-140,4.36,T-Mobile Park,3,3
2014-04-13,2014,COL,SF,4,5,142,1.5,-155,7.5,-110,-110,-157,-1.5,135,3.1,AT&T Park,9,-1
2014-04-13,2014,CHC,STL,4,6,205,1.5,-105,7.5,-116,-104,-245,-1.5,-115,2.46,Busch Stadium,10,-2
2014-04-13,2014,CIN,TB,12,4,-122,-1.5,170,7.5,-120,100,112,1.5,-200,4.12,Great American Ballpark,16,8
2014-04-13,2014,HOU,TEX,0,1,145,1.5,-145,9.0,-115,-105,-160,-1.5,125,3.67,Rangers Ballpark,1,-1
2014-04-13,2014,BAL,TOR,3,11,-105,-1.5,180,9.0,-105,-115,-105,1.5,-210,4.61,Camden Yards,14,-8
2014-04-13,2014,ATL,WSH,10,2,115,1.5,-150,7.0,-105,-115,-130,-1.5,130,3.26,Turner Field,12,8
2014-04-14,2014,NYM,ARI,7,3,115,1.5,-175,9.0,-110,-110,-130,-1.5,155,4.19,Chase Field,10,4
2014-04-14,2014,PHI,ATL,6,9,111,1.5,-160,8.5,-110,-110,-121,-1.5,140,4.03,Citizens Bank Park,15,-3
2014-04-14,2014,TB,BAL,1,7,-113,-1.5,150,8.5,-114,-106,103,1.5,-170,4.51,Camden Yards,8,-6
2014-04-14,2014,PIT,CIN,8,7,113,1.5,-205,7.5,-105,-115,-123,-1.5,175,3.52,Great American Ballpark,15,1
2014-04-14,2014,SD,COL,5,4,-117,-1.5,185,7.5,100,-120,107,1.5,-215,4.04,PETCO Park,9,1
2014-04-14,2014,OAK,LAA,3,2,-113,-1.5,140,8.5,-115,-105,103,1.5,-160,4.51,Angel Stadium,5,1
2014-04-14,2014,WSH,MIA,9,2,-155,-1.5,105,7.5,-115,-105,140,1.5,-125,4.56,Marlins Park,11,7
2014-04-14,2014,STL,MIL,4,0,113,1.5,-195,8.5,-110,-110,-123,-1.5,165,3.99,Miller Park,4,4
2014-04-14,2014,ARI,NYM,3,7,-130,-1.5,155,9.0,-110,-110,115,1.5,-175,5.09,Chase Field,10,-4
2014-04-14,2014,LAA,OAK,2,3,103,1.5,-160,8.5,-115,-105,-113,-1.5,140,4.19,Angel Stadium,5,-1
2014-04-14,2014,ATL,PHI,9,6,-121,-1.5,140,8.5,-110,-110,111,1.5,-160,4.65,Citizens Bank Park,15,3
2014-04-14,2014,CIN,PIT,7,8,-123,-1.5,175,7.5,-105,-115,113,1.5,-205,4.14,Great American Ballpark,15,-1
2014-04-14,2014,COL,SD,4,5,107,1.5,-215,7.5,100,-120,-117,-1.5,185,3.62,PETCO Park,9,-1
2014-04-14,2014,TEX,SEA,1,7,-110,-1.5,190,9.0,-105,-115,100,1.5,-220,4.71,Rangers Ballpark,8,-6
2014-04-14,2014,MIL,STL,0,4,-123,-1.5,165,8.5,-110,-110,113,1.5,-195,4.69,Miller Park,4,-4
2014-04-14,2014,BAL,TB,7,1,103,1.5,-170,8.5,-114,-106,-113,-1.5,150,4.19,Camden Yards,8,6
2014-04-14,2014,SEA,TEX,7,1,100,1.5,-220,9.0,-105,-115,-110,-1.5,190,4.5,Rangers Ballpark,8,6
2014-04-14,2014,MIA,WSH,2,9,140,1.5,-125,7.5,-115,-105,-155,-1.5,105,3.13,Marlins Park,11,-7
2014-04-15,2014,NYM,ARI,9,0,125,1.5,-165,9.0,-115,-105,-140,-1.5,145,4.0,Chase Field,9,9
2014-04-15,2014,CWS,BOS,2,1,125,1.5,-140,8.0,-105,-115,-140,-1.5,120,3.56,Guaranteed Rate Field,3,1
2014-04-15,2014,PIT,CIN,5,7,-109,-1.5,160,7.0,110,-130,-101,1.5,-180,3.65,Great American Ballpark,12,-2
2014-04-15,2014,SD,COL,2,3,-112,-1.5,190,7.0,-110,-110,102,1.5,-230,3.7,PETCO Park,5,-1
2014-04-15,2014,BOS,CWS,1,2,-140,-1.5,120,8.0,-105,-115,125,1.5,-140,4.67,Guaranteed Rate Field,3,-1
2014-04-15,2014,KC,HOU,4,2,-174,-1.5,-115,8.0,-110,-110,154,1.5,-105,5.08,Minute Maid Park,6,2
2014-04-15,2014,HOU,KC,2,4,154,1.5,-105,8.0,-110,-110,-174,-1.5,-115,3.15,Minute Maid Park,6,-2
2014-04-15,2014,OAK,LAA,10,9,102,1.5,-210,8.5,100,-120,-112,-1.5,180,4.21,Angel Stadium,19,1
2014-04-15,2014,SF,LAD,3,2,-105,1.5,-180,8.0,-110,-110,-105,-1.5,160,4.1,AT&T Park,5,1
2014-04-15,2014,WSH,MIA,2,11,-178,-1.5,-110,7.0,-120,100,158,1.5,-110,4.48,Marlins Park,13,-9
2014-04-15,2014,STL,MIL,6,1,104,1.5,-210,8.0,-111,-109,-114,-1.5,180,3.92,Miller Park,7,5
2014-04-15,2014,TOR,MIN,9,3,-122,-1.5,140,8.0,112,-132,112,1.5,-160,4.4,Target Field,12,6
2014-04-15,2014,ARI,NYM,0,9,-140,-1.5,145,9.0,-115,-105,125,1.5,-165,5.25,Chase Field,9,-9
2014-04-15,2014,LAA,OAK,9,10,-112,-1.5,180,8.5,100,-120,102,1.5,-210,4.49,Angel Stadium,19,-1
2014-04-15,2014,CIN,PIT,7,5,-101,1.5,-180,7.0,110,-130,-109,-1.5,160,3.52,Great American Ballpark,12,2
2014-04-15,2014,COL,SD,3,2,102,1.5,-230,7.0,-110,-110,-112,-1.5,190,3.47,PETCO Park,5,1
2014-04-15,2014,TEX,SEA,5,0,-155,-1.5,135,8.5,-128,108,140,1.5,-155,5.17,Rangers Ballpark,5,5
2014-04-15,2014,LAD,SF,2,3,-105,-1.5,160,8.0,-110,-110,-105,1.5,-180,4.1,AT&T Park,5,-1
2014-04-15,2014,MIL,STL,1,6,-114,-1.5,180,8.0,-111,-109,104,1.5,-210,4.26,Miller Park,7,-5
2014-04-15,2014,SEA,TEX,0,5,140,1.5,-155,8.5,-128,108,-155,-1.5,135,3.54,Rangers Ballpark,5,-5
2014-04-15,2014,MIN,TOR,3,9,112,1.5,-160,8.0,112,-132,-122,-1.5,140,3.77,Target Field,12,-6
2014-04-15,2014,MIA,WSH,11,2,158,1.5,-110,7.0,-120,100,-178,-1.5,-110,2.71,Marlins Park,13,9
2014-04-16,2014,NYM,ARI,5,2,133,1.5,-165,9.0,-105,-115,-148,-1.5,145,3.86,Chase Field,7,3
2014-04-16,2014,PHI,ATL,0,1,-132,-1.5,170,6.5,-109,-111,117,1.5,-200,3.7,Citizens Bank Park,1,-1
2014-04-16,2014,TB,BAL,0,3,-101,1.5,-205,8.0,-120,100,-109,-1.5,175,4.02,Camden Yards,3,-3
2014-04-16,2014,CWS,BOS,4,6,116,1.5,-155,7.5,100,-120,-126,-1.5,135,3.47,Guaranteed Rate Field,10,-2
2014-04-16,2014,NYY,CHC,3,0,-190,-1.5,110,7.0,-125,105,170,1.5,-130,4.59,Yankee Stadium,3,3
2014-04-16,2014,NYY,CHC,2,0,-150,-1.5,150,7.0,-119,-101,135,1.5,-170,4.2,Yankee Stadium,2,2
2014-04-16,2014,PIT,CIN,0,4,103,1.5,-230,7.0,110,-130,-113,-1.5,190,3.45,Great American Ballpark,4,-4
2014-04-16,2014,DET,CLE,2,3,-141,-1.5,155,7.5,100,-120,126,1.5,-175,4.39,Comerica Park,5,-1
2014-04-16,2014,SD,COL,4,2,-132,-1.5,170,6.5,-105,-115,117,1.5,-200,3.7,PETCO Park,6,2
2014-04-16,2014,BOS,CWS,6,4,-126,-1.5,135,7.5,100,-120,116,1.5,-155,4.18,Guaranteed Rate Field,10,2
2014-04-16,2014,CLE,DET,3,2,126,1.5,-175,7.5,100,-120,-141,-1.5,155,3.32,Comerica Park,5,1
2014-04-16,2014,KC,HOU,6,4,-116,-1.5,145,8.0,-104,-116,106,1.5,-165,4.3,Minute Maid Park,10,2
2014-04-16,2014,HOU,KC,4,6,106,1.5,-165,8.0,-104,-116,-116,-1.5,145,3.88,Minute Maid Park,10,-2
2014-04-16,2014,OAK,LAA,4,5,117,1.5,-195,8.0,-110,-110,-127,-1.5,165,3.69,Angel Stadium,9,-1
2014-04-16,2014,SF,LAD,2,1,-108,-1.5,180,8.5,102,-122,-102,1.5,-210,4.41,AT&T Park,3,1
2014-04-16,2014,WSH,MIA,6,3,152,1.5,-155,6.5,-125,105,-172,-1.5,135,2.58,Marlins Park,9,3
2014-04-16,2014,STL,MIL,1,5,-104,1.5,-220,8.5,-110,-110,-106,-1.5,190,4.33,Miller Park,6,-4
2014-04-16,2014,ARI,NYM,2,5,-148,-1.5,145,9.0,-105,-115,133,1.5,-165,5.37,Chase Field,7,-3
2014-04-16,2014,CHC,NYY,0,3,170,1.5,-130,7.0,-125,105,-190,-1.5,110,2.59,Yankee Stadium,3,-3
2014-04-16,2014,CHC,NYY,0,2,135,1.5,-170,7.0,-119,-101,-150,-1.5,150,2.98,Yankee Stadium,2,-2
2014-04-16,2014,LAA,OAK,5,4,-127,-1.5,165,8.0,-110,-110,117,1.5,-195,4.48,Angel Stadium,9,1
2014-04-16,2014,ATL,PHI,1,0,117,1.5,-200,6.5,-109,-111,-132,-1.5,170,3.0,Citizens Bank Park,1,1
2014-04-16,2014,CIN,PIT,4,0,-113,-1.5,190,7.0,110,-130,103,1.5,-230,3.71,Great American Ballpark,4,4
2014-04-16,2014,COL,SD,2,4,117,1.5,-200,6.5,-105,-115,-132,-1.5,170,3.0,PETCO Park,6,-2
2014-04-16,2014,TEX,SEA,3,2,-123,-1.5,180,6.5,-125,105,113,1.5,-210,3.59,Rangers Ballpark,5,1
2014-04-16,2014,LAD,SF,1,2,-102,1.5,-210,8.5,102,-122,-108,-1.5,180,4.29,AT&T Park,3,-1
2014-04-16,2014,MIL,STL,5,1,-106,-1.5,190,8.5,-110,-110,-104,1.5,-220,4.37,Miller Park,6,4
2014-04-16,2014,BAL,TB,3,0,-109,-1.5,175,8.0,-120,100,-101,1.5,-205,4.17,Camden Yards,3,3
2014-04-16,2014,SEA,TEX,2,3,113,1.5,-210,6.5,-125,105,-123,-1.5,180,3.05,Rangers Ballpark,5,-1
2014-04-16,2014,MIA,WSH,3,6,-172,-1.5,135,6.5,-125,105,152,1.5,-155,4.11,Marlins Park,9,-3
2014-04-17,2014,PHI,ATL,1,0,130,1.5,-140,7.0,115,-135,-145,-1.5,120,3.04,Citizens Bank Park,1,1
2014-04-17,2014,CWS,BOS,1,3,-108,-1.5,185,7.0,-101,-119,-102,1.5,-215,3.63,Guaranteed Rate Field,4,-2
2014-04-17,2014,DET,CLE,7,5,-154,-1.5,145,7.5,-104,-116,139,1.5,-165,4.55,Comerica Park,12,2
2014-04-17,2014,SD,COL,1,3,-127,-1.5,175,7.0,-125,105,117,1.5,-205,3.92,PETCO Park,4,-2
2014-04-17,2014,BOS,CWS,3,1,-102,1.5,-215,7.0,-101,-119,-108,-1.5,185,3.53,Guaranteed Rate Field,4,2
2014-04-17,2014,CLE,DET,5,7,139,1.5,-165,7.5,-104,-116,-154,-1.5,145,3.14,Comerica Park,12,-2
2014-04-17,2014,KC,HOU,5,1,-131,-1.5,125,7.5,100,-120,116,1.5,-145,4.25,Minute Maid Park,6,4
2014-04-17,2014,HOU,KC,1,5,116,1.5,-145,7.5,100,-120,-131,-1.5,125,3.47,Minute Maid Park,6,-4
2014-04-17,2014,SF,LAD,1,2,-123,-1.5,185,6.5,-111,-109,113,1.5,-215,3.59,AT&T Park,3,-1
2014-04-17,2014,PIT,MIL,11,2,-108,-1.5,195,7.0,-105,-115,-102,1.5,-225,3.63,PNC Park,13,9
2014-04-17,2014,TOR,MIN,0,7,-120,-1.5,135,7.0,-120,100,110,1.5,-155,3.82,Target Field,7,-7
2014-04-17,2014,TOR,MIN,5,9,-125,-1.5,130,7.0,-130,110,115,1.5,-150,3.89,Target Field,14,-4
2014-04-17,2014,TB,NYY,2,10,-166,-1.5,130,6.5,-125,105,151,1.5,-150,4.06,Tropicana Field,12,-8
2014-04-17,2014,ATL,PHI,0,1,-145,-1.5,120,7.0,115,-135,130,1.5,-140,4.14,Citizens Bank Park,1,-1
2014-04-17,2014,MIL,PIT,2,11,-102,1.5,-225,7.0,-105,-115,-108,-1.5,195,3.53,PNC Park,13,-9
2014-04-17,2014,COL,SD,3,1,117,1.5,-205,7.0,-125,105,-127,-1.5,175,3.23,PETCO Park,4,2
2014-04-17,2014,TEX,SEA,8,6,-120,-1.5,170,9.0,-109,-111,110,1.5,-200,4.91,Rangers Ballpark,14,2
2014-04-17,2014,LAD,SF,2,1,113,1.5,-215,6.5,-111,-109,-123,-1.5,185,3.05,AT&T Park,3,1
2014-04-17,2014,WSH,STL,0,8,126,1.5,-145,6.5,-110,-110,-141,-1.5,125,2.88,Nationals Park,8,-8
2014-04-17,2014,NYY,TB,10,2,151,1.5,-150,6.5,-125,105,-166,-1.5,130,2.59,Tropicana Field,12,8
2014-04-17,2014,SEA,TEX,6,8,110,1.5,-200,9.0,-109,-111,-120,-1.5,170,4.29,Rangers Ballpark,14,-2
2014-04-17,2014,MIN,TOR,7,0,110,1.5,-155,7.0,-120,100,-120,-1.5,135,3.33,Target Field,7,7
2014-04-17,2014,MIN,TOR,9,5,115,1.5,-150,7.0,-130,110,-125,-1.5,130,3.26,Target Field,14,4
2014-04-17,2014,STL,WSH,8,0,-141,-1.5,125,6.5,-110,-110,126,1.5,-145,3.8,Nationals Park,8,8
2014-04-18,2014,LAD,ARI,2,4,-180,-1.5,120,6.5,-105,-115,160,1.5,-140,4.18,Dodger Stadium,6,-2
2014-04-18,2014,NYM,ATL,0,6,-103,1.5,-190,7.0,-105,-115,-107,-1.5,160,3.55,Citi Field,6,-6
2014-04-18,2014,BOS,BAL,4,8,-130,-1.5,160,7.5,-120,100,115,1.5,-190,4.24,Fenway Park,12,-4
2014-04-18,2014,BAL,BOS,8,4,115,1.5,-190,7.5,-120,100,-130,-1.5,160,3.49,Fenway Park,12,4
2014-04-18,2014,CIN,CHC,4,1,-102,1.5,-230,6.5,105,-125,-108,-1.5,190,3.28,Wrigley Field,5,3
2014-04-18,2014,CHC,CIN,1,4,-108,-1.5,190,6.5,105,-125,-102,1.5,-230,3.38,Wrigley Field,5,-3
2014-04-18,2014,TOR,CLE,3,2,125,1.5,-175,8.0,104,-124,-140,-1.5,155,3.56,Progressive Field,5,1
2014-04-18,2014,PHI,COL,1,12,137,1.5,-145,10.5,-120,100,-152,-1.5,125,4.43,Coors Field,13,-11
2014-04-18,2014,TEX,CWS,12,0,-155,-1.5,130,8.5,-105,-115,140,1.5,-150,5.17,Rangers Ballpark,12,12
2014-04-18,2014,LAA,DET,11,6,116,1.5,-200,8.0,-110,-110,-126,-1.5,170,3.7,Comerica Park,17,5
2014-04-18,2014,OAK,HOU,11,3,-234,-1.5,-110,7.0,-110,-110,204,1.5,-110,4.9,Oakland Coliseum,14,8
2014-04-18,2014,MIN,KC,0,5,128,1.5,-165,7.5,105,-125,-143,-1.5,145,3.29,Kauffman Stadium,5,-5
2014-04-18,2014,DET,LAA,6,11,-126,-1.5,170,8.0,-110,-110,116,1.5,-200,4.46,Comerica Park,17,-5
2014-04-18,2014,ARI,LAD,4,2,160,1.5,-140,6.5,-105,-115,-180,-1.5,120,2.5,Dodger Stadium,6,2
2014-04-18,2014,SEA,MIA,4,8,106,1.5,-210,7.5,-116,-104,-116,-1.5,180,3.64,Marlins Park,12,-4
2014-04-18,2014,PIT,MIL,3,5,-118,-1.5,180,7.0,105,-125,108,1.5,-210,3.79,PNC Park,8,-2
2014-04-18,2014,KC,MIN,5,0,-143,-1.5,145,7.5,105,-125,128,1.5,-165,4.41,Kauffman Stadium,5,5
2014-04-18,2014,ATL,NYM,6,0,-107,-1.5,160,7.0,-105,-115,-103,1.5,-190,3.62,Citi Field,6,6
2014-04-18,2014,TB,NYY,11,5,100,1.5,-190,7.5,105,-125,-110,-1.5,160,3.75,Tropicana Field,16,6
2014-04-18,2014,HOU,OAK,3,11,204,1.5,-110,7.0,-110,-110,-234,-1.5,-110,2.3,Oakland Coliseum,14,-8
2014-04-18,2014,COL,PHI,12,1,-152,-1.5,125,10.5,-120,100,137,1.5,-145,6.33,Coors Field,13,11
2014-04-18,2014,MIL,PIT,5,3,108,1.5,-210,7.0,105,-125,-118,-1.5,180,3.37,PNC Park,8,2
2014-04-18,2014,SF,SD,1,2,100,1.5,-225,6.5,-105,-115,-110,-1.5,195,3.25,PETCO Park,3,-1
2014-04-18,2014,MIA,SEA,8,4,-116,-1.5,180,7.5,-116,-104,106,1.5,-210,4.03,Marlins Park,12,4
2014-04-18,2014,SD,SF,2,1,-110,-1.5,195,6.5,-105,-115,100,1.5,-225,3.4,PETCO Park,3,1
2014-04-18,2014,WSH,STL,3,1,100,1.5,-185,6.5,-105,-115,-110,-1.5,165,3.25,Nationals Park,4,2
2014-04-18,2014,NYY,TB,5,11,-110,-1.5,160,7.5,105,-125,100,1.5,-190,3.93,Tropicana Field,16,-6
2014-04-18,2014,CWS,TEX,0,12,140,1.5,-150,8.5,-105,-115,-155,-1.5,130,3.54,Rangers Ballpark,12,-12
2014-04-18,2014,CLE,TOR,2,3,-140,-1.5,155,8.0,104,-124,125,1.5,-175,4.67,Progressive Field,5,-1
2014-04-18,2014,STL,WSH,1,3,-110,-1.5,165,6.5,-105,-115,100,1.5,-185,3.4,Nationals Park,4,-2
2014-04-19,2014,LAD,ARI,8,6,-195,-1.5,110,7.5,105,-125,175,1.5,-130,4.96,Dodger Stadium,14,2
2014-04-19,2014,NYM,ATL,5,7,118,1.5,-150,7.0,100,-120,-128,-1.5,130,3.21,Citi Field,12,-2
2014-04-19,2014,BOS,BAL,4,2,-141,-1.5,140,9.0,105,-125,126,1.5,-160,5.27,Fenway Park,6,2
2014-04-19,2014,BAL,BOS,2,4,126,1.5,-160,9.0,105,-125,-141,-1.5,140,3.98,Fenway Park,6,-2
2014-04-19,2014,CIN,CHC,4,8,-146,-1.5,110,7.5,105,-125,131,1.5,-130,4.45,Wrigley Field,12,-4
2014-04-19,2014,CHC,CIN,8,4,131,1.5,-130,7.5,105,-125,-146,-1.5,110,3.25,Wrigley Field,12,4
2014-04-19,2014,TOR,CLE,5,0,107,1.5,-205,7.5,100,-120,-117,-1.5,175,3.62,Progressive Field,5,5
2014-04-19,2014,PHI,COL,1,3,128,1.5,-155,10.5,-105,-115,-143,-1.5,135,4.61,Coors Field,4,-2
2014-04-19,2014,TEX,CWS,6,3,-124,-1.5,160,8.5,-125,105,114,1.5,-190,4.71,Rangers Ballpark,9,3
2014-04-19,2014,LAA,DET,2,5,149,1.5,-155,7.5,109,-129,-164,-1.5,135,3.01,Comerica Park,7,-3
2014-04-19,2014,OAK,HOU,4,3,-215,-1.5,-107,7.5,-105,-115,185,1.5,-113,5.12,Oakland Coliseum,7,1
2014-04-19,2014,MIN,KC,4,5,130,1.5,-160,8.5,-105,-115,-145,-1.5,140,3.7,Kauffman Stadium,9,-1
2014-04-19,2014,DET,LAA,5,2,-164,-1.5,135,7.5,109,-129,149,1.5,-155,4.66,Comerica Park,7,3
2014-04-19,2014,ARI,LAD,6,8,175,1.5,-130,7.5,105,-125,-195,-1.5,110,2.73,Dodger Stadium,14,-2
2014-04-19,2014,SEA,MIA,0,7,-107,-1.5,155,7.5,-111,-109,-103,1.5,-175,3.88,Marlins Park,7,-7
2014-04-19,2014,PIT,MIL,7,8,-109,-1.5,190,7.0,-120,100,-101,1.5,-230,3.65,PNC Park,15,-1
2014-04-19,2014,KC,MIN,5,4,-145,-1.5,140,8.5,-105,-115,130,1.5,-160,5.03,Kauffman Stadium,9,1
2014-04-19,2014,ATL,NYM,7,5,-128,-1.5,130,7.0,100,-120,118,1.5,-150,3.93,Citi Field,12,2
2014-04-19,2014,TB,NYY,16,1,-140,-1.5,150,7.5,-105,-115,125,1.5,-170,4.38,Tropicana Field,17,15
2014-04-19,2014,HOU,OAK,3,4,185,1.5,-113,7.5,-105,-115,-215,-1.5,-107,2.63,Oakland Coliseum,7,-1
2014-04-19,2014,COL,PHI,3,1,-143,-1.5,135,10.5,-105,-115,128,1.5,-155,6.18,Coors Field,4,2
2014-04-19,2014,MIL,PIT,8,7,-101,1.5,-230,7.0,-120,100,-109,-1.5,190,3.52,PNC Park,15,1
2014-04-19,2014,SF,SD,1,3,-124,-1.5,135,7.0,-122,102,114,1.5,-155,3.88,PETCO Park,4,-2
2014-04-19,2014,MIA,SEA,7,0,-103,1.5,-175,7.5,-111,-109,-107,-1.5,155,3.81,Marlins Park,7,7
2014-04-19,2014,SD,SF,3,1,114,1.5,-155,7.0,-122,102,-124,-1.5,135,3.27,PETCO Park,4,2
2014-04-19,2014,WSH,STL,3,4,-120,-1.5,175,7.0,-115,-105,110,1.5,-205,3.82,Nationals Park,7,-1
2014-04-19,2014,NYY,TB,1,16,125,1.5,-170,7.5,-105,-115,-140,-1.5,150,3.33,Tropicana Field,17,-15
2014-04-19,2014,CWS,TEX,3,6,114,1.5,-190,8.5,-125,105,-124,-1.5,160,3.97,Rangers Ballpark,9,-3
2014-04-19,2014,CLE,TOR,0,5,-117,-1.5,175,7.5,100,-120,107,1.5,-205,4.04,Progressive Field,5,-5
2014-04-19,2014,STL,WSH,4,3,110,1.5,-205,7.0,-115,-105,-120,-1.5,175,3.33,Nationals Park,7,1
2014-04-20,2014,LAD,ARI,4,1,-144,-1.5,155,7.5,105,-125,129,1.5,-175,4.43,Dodger Stadium,5,3
2014-04-20,2014,NYM,ATL,4,3,-108,-1.5,185,7.0,-120,100,-102,1.5,-215,3.63,Citi Field,7,1
2014-04-20,2014,BOS,BAL,6,5,-161,-1.5,125,8.0,100,-120,146,1.5,-145,4.93,Fenway Park,11,1
2014-04-20,2014,BAL,BOS,5,6,146,1.5,-145,8.0,100,-120,-161,-1.5,125,3.25,Fenway Park,11,-1
2014-04-20,2014,CIN,CHC,8,2,-140,-1.5,120,9.0,-105,-115,125,1.5,-140,5.25,Wrigley Field,10,6
2014-04-20,2014,CHC,CIN,2,8,125,1.5,-140,9.0,-105,-115,-140,-1.5,120,4.0,Wrigley Field,10,-6
2014-04-20,2014,TOR,CLE,4,6,-114,-1.5,145,8.5,-115,-105,104,1.5,-165,4.53,Progressive Field,10,-2
2014-04-20,2014,PHI,COL,10,9,137,1.5,-150,9.5,-115,-105,-152,-1.5,130,4.01,Coors Field,19,1
2014-04-20,2014,TEX,CWS,2,16,-176,-1.5,115,9.0,-105,-115,156,1.5,-135,5.74,Rangers Ballpark,18,-14
2014-04-20,2014,LAA,DET,1,2,126,1.5,-170,9.0,100,-120,-141,-1.5,150,3.98,Comerica Park,3,-1
2014-04-20,2014,OAK,HOU,4,1,-275,-1.5,-125,8.0,-120,100,235,1.5,105,5.87,Oakland Coliseum,5,3
2014-04-20,2014,MIN,KC,8,3,163,1.5,-135,8.0,100,-120,-183,-1.5,115,3.04,Kauffman Stadium,11,5
2014-04-20,2014,DET,LAA,2,1,-141,-1.5,150,9.0,100,-120,126,1.5,-170,5.27,Comerica Park,3,1
2014-04-20,2014,ARI,LAD,1,4,129,1.5,-175,7.5,105,-125,-144,-1.5,155,3.28,Dodger Stadium,5,-3
2014-04-20,2014,SEA,MIA,2,3,-101,1.5,-220,8.0,100,-120,-109,-1.5,190,4.02,Marlins Park,5,-1
2014-04-20,2014,PIT,MIL,2,3,-123,-1.5,180,6.5,-125,105,113,1.5,-210,3.59,PNC Park,5,-1
2014-04-20,2014,KC,MIN,3,8,-183,-1.5,115,8.0,100,-120,163,1.5,-135,5.17,Kauffman Stadium,11,-5
2014-04-20,2014,ATL,NYM,3,4,-102,1.5,-215,7.0,-120,100,-108,-1.5,185,3.53,Citi Field,7,-1
2014-04-20,2014,TB,NYY,1,5,-140,-1.5,150,8.5,-105,-115,125,1.5,-170,4.96,Tropicana Field,6,-4
2014-04-20,2014,HOU,OAK,1,4,235,1.5,105,8.0,-120,100,-275,-1.5,-125,2.39,Oakland Coliseum,5,-3
2014-04-20,2014,COL,PHI,9,10,-152,-1.5,130,9.5,-115,-105,137,1.5,-150,5.73,Coors Field,19,-1
2014-04-20,2014,MIL,PIT,3,2,113,1.5,-210,6.5,-125,105,-123,-1.5,180,3.05,PNC Park,5,1
2014-04-20,2014,SF,SD,4,3,-102,1.5,-220,7.0,-125,105,-108,-1.5,190,3.53,PETCO Park,7,1
2014-04-20,2014,MIA,SEA,3,2,-109,-1.5,190,8.0,100,-120,-101,1.5,-220,4.17,Marlins Park,5,1
2014-04-20,2014,SD,SF,3,4,-108,-1.5,190,7.0,-125,105,-102,1.5,-220,3.63,PETCO Park,7,-1
2014-04-20,2014,WSH,STL,3,2,-145,-1.5,150,7.0,112,-132,130,1.5,-170,4.14,Nationals Park,5,1
2014-04-20,2014,NYY,TB,5,1,125,1.5,-170,8.5,-105,-115,-140,-1.5,150,3.78,Tropicana Field,6,4
2014-04-20,2014,CWS,TEX,16,2,156,1.5,-135,9.0,-105,-115,-176,-1.5,115,3.52,Rangers Ballpark,18,14
2014-04-20,2014,CLE,TOR,6,4,104,1.5,-165,8.5,-115,-105,-114,-1.5,145,4.17,Progressive Field,10,2
2014-04-20,2014,STL,WSH,2,3,130,1.5,-170,7.0,112,-132,-145,-1.5,150,3.04,Nationals Park,5,-1
2014-04-21,2014,CHC,ARI,5,1,-115,-1.5,180,9.0,100,-120,105,1.5,-210,4.81,Wrigley Field,6,4
2014-04-21,2014,MIA,ATL,2,4,160,1.5,-140,7.5,-120,100,-180,-1.5,120,2.88,Turner Field,6,-2
2014-04-21,2014,BOS,BAL,6,7,-158,-1.5,135,7.5,-120,100,143,1.5,-155,4.59,Fenway Park,13,-1
2014-04-21,2014,BAL,BOS,7,6,143,1.5,-155,7.5,-120,100,-158,-1.5,135,3.09,Fenway Park,13,1
2014-04-21,2014,ARI,CHC,1,5,105,1.5,-210,9.0,100,-120,-115,-1.5,180,4.39,Wrigley Field,6,-4
2014-04-21,2014,PIT,CIN,6,5,-153,-1.5,155,7.5,-110,-110,138,1.5,-175,4.54,PNC Park,11,1
2014-04-21,2014,KC,CLE,3,4,133,1.5,-155,8.5,-120,100,-148,-1.5,135,3.65,Progressive Field,7,-1
2014-04-21,2014,SF,COL,2,8,131,1.5,-155,10.5,-120,100,-146,-1.5,135,4.55,Coors Field,10,-6
2014-04-21,2014,DET,CWS,1,3,-191,-1.5,110,8.5,-110,-110,171,1.5,-130,5.58,Comerica Park,4,-2
2014-04-21,2014,CWS,DET,3,1,171,1.5,-130,8.5,-110,-110,-191,-1.5,110,3.14,Comerica Park,4,2
2014-04-21,2014,SEA,HOU,2,7,-255,-1.5,-110,6.0,-110,-110,215,1.5,-110,4.31,T-Mobile Park,9,-5
2014-04-21,2014,CLE,KC,4,3,-148,-1.5,135,8.5,-120,100,133,1.5,-155,5.07,Progressive Field,7,1
2014-04-21,2014,WSH,LAA,2,4,-115,-1.5,185,8.0,-115,-105,105,1.5,-215,4.28,Nationals Park,6,-2
2014-04-21,2014,PHI,LAD,7,0,100,1.5,-225,6.5,-110,-110,-110,-1.5,195,3.25,Dodger Stadium,7,7
2014-04-21,2014,ATL,MIA,4,2,-180,-1.5,120,7.5,-120,100,160,1.5,-140,4.82,Turner Field,6,2
2014-04-21,2014,SD,MIL,3,4,-103,1.5,-225,7.5,-115,-105,-107,-1.5,195,3.81,Miller Park,7,-1
2014-04-21,2014,STL,NYM,0,2,-116,-1.5,140,7.5,-113,-107,106,1.5,-160,4.03,Citi Field,2,-2
2014-04-21,2014,TEX,OAK,4,3,-108,-1.5,160,7.0,105,-125,-102,1.5,-180,3.63,Oakland Coliseum,7,1
2014-04-21,2014,LAD,PHI,0,7,-110,-1.5,195,6.5,-110,-110,100,1.5,-225,3.4,Dodger Stadium,7,-7
2014-04-21,2014,CIN,PIT,5,6,138,1.5,-175,7.5,-110,-110,-153,-1.5,155,3.15,PNC Park,11,-1
2014-04-21,2014,MIL,SD,4,3,-107,-1.5,195,7.5,-115,-105,-103,1.5,-225,3.88,Miller Park,7,1
2014-04-21,2014,HOU,SEA,7,2,215,1.5,-110,6.0,-110,-110,-255,-1.5,-110,1.9,T-Mobile Park,9,5
2014-04-21,2014,COL,SF,8,2,-146,-1.5,135,10.5,-120,100,131,1.5,-155,6.23,Coors Field,10,6
2014-04-21,2014,NYM,STL,2,0,106,1.5,-160,7.5,-113,-107,-116,-1.5,140,3.64,Citi Field,2,2
2014-04-21,2014,OAK,TEX,3,4,-102,1.5,-180,7.0,105,-125,-108,-1.5,160,3.53,Oakland Coliseum,7,-1
2014-04-21,2014,LAA,WSH,4,2,105,1.5,-215,8.0,-115,-105,-115,-1.5,185,3.9,Nationals Park,6,2
2014-04-22,2014,CHC,ARI,9,2,-115,-1.5,185,6.5,100,-120,105,1.5,-215,3.48,Wrigley Field,11,7
2014-04-22,2014,MIA,ATL,1,0,118,1.5,-215,6.5,-110,-110,-128,-1.5,185,2.98,Turner Field,1,1
2014-04-22,2014,TOR,BAL,9,3,-152,-1.5,142,9.5,100,-120,137,1.5,-162,5.73,Rogers Centre,12,6
2014-04-22,2014,NYY,BOS,9,3,102,1.5,-210,8.0,-105,-115,-112,-1.5,180,3.96,Fenway Park,12,6
2014-04-22,2014,ARI,CHC,2,9,105,1.5,-215,6.5,100,-120,-115,-1.5,185,3.17,Wrigley Field,11,-7
2014-04-22,2014,PIT,CIN,1,4,100,1.5,-170,7.0,-120,100,-110,-1.5,150,3.5,PNC Park,5,-3
2014-04-22,2014,KC,CLE,8,2,-108,-1.5,155,7.0,100,-120,-102,1.5,-175,3.63,Progressive Field,10,6
2014-04-22,2014,SF,COL,1,2,-110,-1.5,140,10.0,-120,100,100,1.5,-160,5.24,Coors Field,3,-1
2014-04-22,2014,DET,CWS,8,6,-240,-1.5,-115,8.5,-115,-105,200,1.5,-105,6.0,Comerica Park,14,2
2014-04-22,2014,CWS,DET,6,8,200,1.5,-105,8.5,-115,-105,-240,-1.5,-115,2.83,Comerica Park,14,-2
2014-04-22,2014,SEA,HOU,2,5,-160,-1.5,130,8.5,100,-120,145,1.5,-150,5.23,T-Mobile Park,7,-3
2014-04-22,2014,CLE,KC,2,8,-102,1.5,-175,7.0,100,-120,-108,-1.5,155,3.53,Progressive Field,10,-6
2014-04-22,2014,WSH,LAA,2,7,-112,-1.5,180,8.0,-120,100,102,1.5,-210,4.23,Nationals Park,9,-5
2014-04-22,2014,PHI,LAD,3,2,172,1.5,-140,6.5,-110,-110,-192,-1.5,120,2.39,Dodger Stadium,5,1
2014-04-22,2014,ATL,MIA,0,1,-128,-1.5,185,6.5,-110,-110,118,1.5,-215,3.65,Turner Field,1,-1
2014-04-22,2014,SD,MIL,2,1,125,1.5,-170,8.0,-110,-110,-140,-1.5,150,3.56,Miller Park,3,1
2014-04-22,2014,TB,MIN,7,3,-232,-1.5,-105,7.5,100,-120,202,1.5,-115,5.24,Tropicana Field,10,4
2014-04-22,2014,STL,NYM,3,0,-165,-1.5,-101,7.0,-123,103,150,1.5,-119,4.36,Citi Field,3,3
2014-04-22,2014,BOS,NYY,3,9,-112,-1.5,180,8.0,-105,-115,102,1.5,-210,4.23,Fenway Park,12,-6
2014-04-22,2014,TEX,OAK,5,4,150,1.5,-155,7.5,100,-120,-165,-1.5,135,3.0,Oakland Coliseum,9,1
2014-04-22,2014,LAD,PHI,2,3,-192,-1.5,120,6.5,-110,-110,172,1.5,-140,4.27,Dodger Stadium,5,-1
2014-04-22,2014,CIN,PIT,4,1,-110,-1.5,150,7.0,-120,100,100,1.5,-170,3.67,PNC Park,5,3
2014-04-22,2014,MIL,SD,1,2,-140,-1.5,150,8.0,-110,-110,125,1.5,-170,4.67,Miller Park,3,-1
2014-04-22,2014,HOU,SEA,5,2,145,1.5,-150,8.5,100,-120,-160,-1.5,130,3.47,T-Mobile Park,7,3
2014-04-22,2014,COL,SF,2,1,100,1.5,-160,10.0,-120,100,-110,-1.5,140,5.0,Coors Field,3,1
2014-04-22,2014,NYM,STL,0,3,150,1.5,-119,7.0,-123,103,-165,-1.5,-101,2.8,Citi Field,3,-3
2014-04-22,2014,MIN,TB,3,7,202,1.5,-115,7.5,100,-120,-232,-1.5,-105,2.48,Tropicana Field,10,-4
2014-04-22,2014,OAK,TEX,4,5,-165,-1.5,135,7.5,100,-120,150,1.5,-155,4.67,Oakland Coliseum,9,-1
2014-04-22,2014,BAL,TOR,3,9,137,1.5,-162,9.5,100,-120,-152,-1.5,142,4.01,Rogers Centre,12,-6
2014-04-22,2014,LAA,WSH,7,2,102,1.5,-210,8.0,-120,100,-112,-1.5,180,3.96,Nationals Park,9,5
2014-04-23,2014,CHC,ARI,5,7,-115,-1.5,180,6.5,-110,-110,105,1.5,-210,3.48,Wrigley Field,12,-2
2014-04-23,2014,MIA,ATL,1,3,125,1.5,-190,7.0,100,-120,-140,-1.5,160,3.11,Turner Field,4,-2
2014-04-23,2014,TOR,BAL,8,10,-109,-1.5,175,8.5,-128,108,-101,1.5,-205,4.43,Rogers Centre,18,-2
2014-04-23,2014,NYY,BOS,1,5,-102,1.5,-210,8.5,-120,100,-108,-1.5,180,4.29,Fenway Park,6,-4
2014-04-23,2014,ARI,CHC,7,5,105,1.5,-210,6.5,-110,-110,-115,-1.5,180,3.17,Wrigley Field,12,2
2014-04-23,2014,PIT,CIN,2,5,-122,-1.5,175,7.5,-102,-118,112,1.5,-205,4.12,PNC Park,7,-3
2014-04-23,2014,KC,CLE,3,5,109,1.5,-205,7.0,100,-120,-119,-1.5,175,3.35,Progressive Field,8,-2
2014-04-23,2014,SF,COL,12,10,100,1.5,-205,9.5,-105,-115,-110,-1.5,175,4.75,Coors Field,22,2
2014-04-23,2014,DET,CWS,4,6,-191,-1.5,105,8.5,100,-120,171,1.5,-125,5.58,Comerica Park,10,-2
2014-04-23,2014,CWS,DET,6,4,171,1.5,-125,8.5,100,-120,-191,-1.5,105,3.14,Comerica Park,10,2
2014-04-23,2014,SEA,HOU,5,3,-150,-1.5,145,8.0,100,-120,135,1.5,-165,4.8,T-Mobile Park,8,2
2014-04-23,2014,CLE,KC,5,3,-119,-1.5,175,7.0,100,-120,109,1.5,-205,3.8,Progressive Field,8,2
2014-04-23,2014,WSH,LAA,5,4,-124,-1.5,170,7.0,-120,100,114,1.5,-200,3.88,Nationals Park,9,1
2014-04-23,2014,PHI,LAD,2,5,151,1.5,-155,6.5,100,-120,-171,-1.5,135,2.59,Dodger Stadium,7,-3
2014-04-23,2014,ATL,MIA,3,1,-140,-1.5,160,7.0,100,-120,125,1.5,-190,4.08,Turner Field,4,2
2014-04-23,2014,SD,MIL,2,5,116,1.5,-200,7.5,105,-125,-131,-1.5,170,3.47,Miller Park,7,-3
2014-04-23,2014,TB,MIN,4,6,-180,-1.5,110,8.5,100,-120,160,1.5,-130,5.46,Tropicana Field,10,-2
2014-04-23,2014,STL,NYM,2,3,-146,-1.5,120,6.5,-110,-110,131,1.5,-140,3.86,Citi Field,5,-1
2014-04-23,2014,BOS,NYY,5,1,-108,-1.5,180,8.5,-120,100,-102,1.5,-210,4.41,Fenway Park,6,4
2014-04-23,2014,TEX,OAK,3,0,151,1.5,-150,7.0,-120,100,-171,-1.5,130,2.79,Oakland Coliseum,3,3
2014-04-23,2014,LAD,PHI,5,2,-171,-1.5,135,6.5,100,-120,151,1.5,-155,4.1,Dodger Stadium,7,3
2014-04-23,2014,CIN,PIT,5,2,112,1.5,-205,7.5,-102,-118,-122,-1.5,175,3.54,PNC Park,7,3
2014-04-23,2014,MIL,SD,5,2,-131,-1.5,170,7.5,105,-125,116,1.5,-200,4.25,Miller Park,7,3
2014-04-23,2014,HOU,SEA,3,5,135,1.5,-165,8.0,100,-120,-150,-1.5,145,3.4,T-Mobile Park,8,-2
2014-04-23,2014,COL,SF,10,12,-110,-1.5,175,9.5,-105,-115,100,1.5,-205,4.98,Coors Field,22,-2
2014-04-23,2014,NYM,STL,3,2,131,1.5,-140,6.5,-110,-110,-146,-1.5,120,2.81,Citi Field,5,1
2014-04-23,2014,MIN,TB,6,4,160,1.5,-130,8.5,100,-120,-180,-1.5,110,3.27,Tropicana Field,10,2
2014-04-23,2014,OAK,TEX,0,3,-171,-1.5,130,7.0,-120,100,151,1.5,-150,4.42,Oakland Coliseum,3,-3
2014-04-23,2014,BAL,TOR,10,8,-101,1.5,-205,8.5,-128,108,-109,-1.5,175,4.27,Rogers Centre,18,2
2014-04-23,2014,LAA,WSH,4,5,114,1.5,-200,7.0,-120,100,-124,-1.5,170,3.27,Nationals Park,9,-1
2014-04-24,2014,CHC,ARI,2,5,-123,-1.5,155,10.0,-115,-105,113,1.5,-175,5.52,Wrigley Field,7,-3
2014-04-24,2014,TOR,BAL,4,11,-140,-1.5,150,8.5,-125,105,125,1.5,-170,4.96,Rogers Centre,15,-7
2014-04-24,2014,NYY,BOS,14,5,107,1.5,-200,8.5,-110,-110,-117,-1.5,170,4.11,Fenway Park,19,9
2014-04-24,2014,ARI,CHC,5,2,113,1.5,-175,10.0,-115,-105,-123,-1.5,155,4.69,Wrigley Field,7,3
2014-04-24,2014,PIT,CIN,1,2,-110,-1.5,190,7.0,-115,-105,100,1.5,-220,3.67,PNC Park,3,-1
2014-04-24,2014,KC,CLE,1,5,115,1.5,-200,7.5,105,-125,-125,-1.5,170,3.49,Progressive Field,6,-4
2014-04-24,2014,DET,CWS,7,4,-220,-1.5,-110,7.5,100,-120,190,1.5,-110,5.16,Comerica Park,11,3
2014-04-24,2014,CWS,DET,4,7,190,1.5,-110,7.5,100,-120,-220,-1.5,-110,2.59,Comerica Park,11,-3
2014-04-24,2014,OAK,HOU,10,1,-171,-1.5,-110,8.5,-120,100,151,1.5,-110,5.36,Minute Maid Park,11,9
2014-04-24,2014,CLE,KC,5,1,-125,-1.5,170,7.5,105,-125,115,1.5,-200,4.17,Progressive Field,6,4
2014-04-24,2014,PHI,LAD,7,3,154,1.5,-150,7.0,-110,-110,-169,-1.5,130,2.76,Dodger Stadium,10,4
2014-04-24,2014,TB,MIN,7,9,-160,-1.5,135,7.5,-110,-110,145,1.5,-155,4.62,Tropicana Field,16,-2
2014-04-24,2014,STL,NYM,1,4,-127,-1.5,130,7.0,-106,-114,117,1.5,-150,3.92,Citi Field,5,-3
2014-04-24,2014,BOS,NYY,5,14,-117,-1.5,170,8.5,-110,-110,107,1.5,-200,4.58,Fenway Park,19,-9
2014-04-24,2014,HOU,OAK,1,10,151,1.5,-110,8.5,-120,100,-171,-1.5,-110,3.39,Minute Maid Park,11,-9
2014-04-24,2014,LAD,PHI,3,7,-169,-1.5,130,7.0,-110,-110,154,1.5,-150,4.4,Dodger Stadium,10,-4
2014-04-24,2014,CIN,PIT,2,1,100,1.5,-220,7.0,-115,-105,-110,-1.5,190,3.5,PNC Park,3,1
2014-04-24,2014,WSH,SD,3,4,-155,-1.5,140,7.0,-110,-110,140,1.5,-160,4.25,Nationals Park,7,-1
2014-04-24,2014,NYM,STL,4,1,117,1.5,-150,7.0,-106,-114,-127,-1.5,130,3.23,Citi Field,5,3
2014-04-24,2014,MIN,TB,9,7,145,1.5,-155,7.5,-110,-110,-160,-1.5,135,3.06,Tropicana Field,16,2
2014-04-24,2014,BAL,TOR,11,4,125,1.5,-170,8.5,-125,105,-140,-1.5,150,3.78,Rogers Centre,15,7
2014-04-24,2014,SD,WSH,4,3,140,1.5,-160,7.0,-110,-110,-155,-1.5,140,2.92,Nationals Park,7,1
2014-04-25,2014,PHI,ARI,4,5,116,1.5,-180,9.0,-125,105,-126,-1.5,160,4.17,Chase Field,9,-1
2014-04-25,2014,CIN,ATL,4,5,118,1.5,-175,7.0,-115,-105,-133,-1.5,155,3.21,Turner Field,9,-1
2014-04-25,2014,KC,BAL,5,0,-103,1.5,-210,8.0,-120,100,-107,-1.5,180,4.06,Camden Yards,5,5
2014-04-25,2014,TOR,BOS,1,8,-113,-1.5,170,9.5,100,-120,103,1.5,-200,5.04,Rogers Centre,9,-7
2014-04-25,2014,MIL,CHC,5,2,-182,-1.5,115,8.0,-115,-105,162,1.5,-135,5.16,Miller Park,7,3
2014-04-25,2014,ATL,CIN,5,4,-133,-1.5,155,7.0,-115,-105,118,1.5,-175,4.0,Turner Field,9,1
2014-04-25,2014,SF,CLE,5,1,-153,-1.5,140,7.5,100,-120,138,1.5,-160,4.54,AT&T Park,6,4
2014-04-25,2014,LAD,COL,4,5,-143,-1.5,155,7.0,-120,100,128,1.5,-175,4.12,Dodger Stadium,9,-1
2014-04-25,2014,TB,CWS,6,9,-140,-1.5,110,8.5,-110,-110,125,1.5,-130,4.96,Guaranteed Rate Field,15,-3
2014-04-25,2014,MIN,DET,6,10,114,1.5,-150,8.5,-110,-110,-124,-1.5,130,3.97,Target Field,16,-4
2014-04-25,2014,OAK,HOU,12,5,-183,-1.5,-120,9.0,-120,100,163,1.5,100,5.82,Minute Maid Park,17,7
2014-04-25,2014,BAL,KC,0,5,-107,-1.5,180,8.0,-120,100,-103,1.5,-210,4.14,Camden Yards,5,-5
2014-04-25,2014,NYY,LAA,1,13,-120,-1.5,175,8.0,100,-120,110,1.5,-205,4.36,Yankee Stadium,14,-12
2014-04-25,2014,COL,LAD,5,4,128,1.5,-175,7.0,-120,100,-143,-1.5,155,3.07,Dodger Stadium,9,1
2014-04-25,2014,NYM,MIA,4,3,-114,-1.5,190,7.0,100,-120,104,1.5,-220,3.73,Citi Field,7,1
2014-04-25,2014,CHC,MIL,2,5,162,1.5,-135,8.0,-115,-105,-182,-1.5,115,3.05,Miller Park,7,-3
2014-04-25,2014,DET,MIN,10,6,-124,-1.5,130,8.5,-110,-110,114,1.5,-150,4.71,Target Field,16,4
2014-04-25,2014,MIA,NYM,3,4,104,1.5,-220,7.0,100,-120,-114,-1.5,190,3.43,Citi Field,7,-1
2014-04-25,2014,LAA,NYY,13,1,110,1.5,-205,8.0,100,-120,-120,-1.5,175,3.81,Yankee Stadium,14,12
2014-04-25,2014,HOU,OAK,5,12,163,1.5,100,9.0,-120,100,-183,-1.5,-120,3.42,Minute Maid Park,17,-7
2014-04-25,2014,ARI,PHI,5,4,-126,-1.5,160,9.0,-125,105,116,1.5,-180,5.02,Chase Field,9,1
2014-04-25,2014,STL,PIT,1,0,-111,-1.5,185,7.5,105,-125,101,1.5,-215,3.95,Busch Stadium,1,1
2014-04-25,2014,WSH,SD,11,1,-190,-1.5,115,6.5,-115,-105,170,1.5,-135,4.26,Nationals Park,12,10
2014-04-25,2014,TEX,SEA,5,6,-113,-1.5,145,7.0,-113,-107,103,1.5,-165,3.71,T-Mobile Park,11,-1
2014-04-25,2014,CLE,SF,1,5,138,1.5,-160,7.5,100,-120,-153,-1.5,140,3.15,AT&T Park,6,-4
2014-04-25,2014,PIT,STL,0,1,101,1.5,-215,7.5,105,-125,-111,-1.5,185,3.73,Busch Stadium,1,-1
2014-04-25,2014,CWS,TB,9,6,125,1.5,-130,8.5,-110,-110,-140,-1.5,110,3.78,Guaranteed Rate Field,15,3
2014-04-25,2014,SEA,TEX,6,5,103,1.5,-165,7.0,-113,-107,-113,-1.5,145,3.45,T-Mobile Park,11,1
2014-04-25,2014,BOS,TOR,8,1,103,1.5,-200,9.5,100,-120,-113,-1.5,170,4.68,Rogers Centre,9,7
2014-04-25,2014,SD,WSH,1,11,170,1.5,-135,6.5,-115,-105,-190,-1.5,115,2.41,Nationals Park,12,-10
2014-04-26,2014,PHI,ARI,6,5,-149,-1.5,105,8.0,-104,-116,134,1.5,-125,4.79,Chase Field,11,1
2014-04-26,2014,CIN,ATL,1,4,113,1.5,-205,7.5,-105,-115,-123,-1.5,175,3.52,Turner Field,5,-3
2014-04-26,2014,KC,BAL,2,3,125,1.5,-170,8.5,-120,100,-140,-1.5,150,3.78,Camden Yards,5,-1
2014-04-26,2014,TOR,BOS,6,7,-105,-1.5,180,9.0,-120,100,-105,1.5,-210,4.61,Rogers Centre,13,-1
2014-04-26,2014,MIL,CHC,5,3,-167,-1.5,130,8.0,-105,-115,152,1.5,-150,5.0,Miller Park,8,2
2014-04-26,2014,ATL,CIN,4,1,-123,-1.5,175,7.5,-105,-115,113,1.5,-205,4.14,Turner Field,5,3
2014-04-26,2014,SF,CLE,5,3,-110,-1.5,185,7.5,100,-120,100,1.5,-215,3.93,AT&T Park,8,2
2014-04-26,2014,LAD,COL,6,3,-109,-1.5,190,7.0,-115,-105,-101,1.5,-230,3.65,Dodger Stadium,9,3
2014-04-26,2014,TB,CWS,4,0,-112,-1.5,155,8.5,-111,-109,102,1.5,-175,4.49,Guaranteed Rate Field,4,4
2014-04-26,2014,MIN,DET,5,3,125,1.5,-135,8.0,-105,-115,-140,-1.5,115,3.56,Target Field,8,2
2014-04-26,2014,OAK,HOU,6,7,-141,-1.5,115,9.0,-115,-105,126,1.5,-135,5.27,Minute Maid Park,13,-1
2014-04-26,2014,BAL,KC,3,2,-140,-1.5,150,8.5,-120,100,125,1.5,-170,4.96,Camden Yards,5,1
2014-04-26,2014,NYY,LAA,4,3,-111,-1.5,175,9.0,-125,105,101,1.5,-205,4.73,Yankee Stadium,7,1
2014-04-26,2014,COL,LAD,3,6,-101,1.5,-230,7.0,-115,-105,-109,-1.5,190,3.52,Dodger Stadium,9,-3
2014-04-26,2014,NYM,MIA,6,7,-141,-1.5,160,7.0,-129,109,126,1.5,-180,4.1,Citi Field,13,-1
2014-04-26,2014,CHC,MIL,3,5,152,1.5,-150,8.0,-105,-115,-167,-1.5,130,3.17,Miller Park,8,-2
2014-04-26,2014,DET,MIN,3,5,-140,-1.5,115,8.0,-105,-115,125,1.5,-135,4.67,Target Field,8,-2
2014-04-26,2014,MIA,NYM,7,6,126,1.5,-180,7.0,-129,109,-141,-1.5,160,3.1,Citi Field,13,1
2014-04-26,2014,LAA,NYY,3,4,101,1.5,-205,9.0,-125,105,-111,-1.5,175,4.48,Yankee Stadium,7,-1
2014-04-26,2014,HOU,OAK,7,6,126,1.5,-135,9.0,-115,-105,-141,-1.5,115,3.98,Minute Maid Park,13,1
2014-04-26,2014,ARI,PHI,5,6,134,1.5,-125,8.0,-104,-116,-149,-1.5,105,3.42,Chase Field,11,-1
2014-04-26,2014,STL,PIT,1,6,-113,-1.5,185,8.0,100,-120,103,1.5,-215,4.24,Busch Stadium,7,-5
2014-04-26,2014,WSH,SD,4,0,-110,-1.5,190,7.0,-105,-115,100,1.5,-230,3.67,Nationals Park,4,4
2014-04-26,2014,TEX,SEA,6,3,152,1.5,-140,7.0,105,-125,-172,-1.5,120,2.78,T-Mobile Park,9,3
2014-04-26,2014,CLE,SF,3,5,100,1.5,-215,7.5,100,-120,-110,-1.5,185,3.75,AT&T Park,8,-2
2014-04-26,2014,PIT,STL,6,1,103,1.5,-215,8.0,100,-120,-113,-1.5,185,3.94,Busch Stadium,7,5
2014-04-26,2014,CWS,TB,0,4,102,1.5,-175,8.5,-111,-109,-112,-1.5,155,4.21,Guaranteed Rate Field,4,-4
2014-04-26,2014,SEA,TEX,3,6,-172,-1.5,120,7.0,105,-125,152,1.5,-140,4.43,T-Mobile Park,9,-3
2014-04-26,2014,BOS,TOR,7,6,-105,1.5,-210,9.0,-120,100,-105,-1.5,180,4.61,Rogers Centre,13,1
2014-04-26,2014,SD,WSH,0,4,100,1.5,-230,7.0,-105,-115,-110,-1.5,190,3.5,Nationals Park,4,-4
2014-04-27,2014,PHI,ARI,2,0,118,1.5,-190,8.5,-107,-113,-133,-1.5,160,3.9,Chase Field,2,2
2014-04-27,2014,CIN,ATL,0,1,-105,1.5,-225,6.5,-124,104,-105,-1.5,195,3.33,Turner Field,1,-1
2014-04-27,2014,KC,BAL,9,3,-130,-1.5,125,7.5,-105,-115,115,1.5,-145,4.24,Camden Yards,12,6
2014-04-27,2014,TOR,BOS,7,1,100,1.5,-170,8.5,-110,-110,-110,-1.5,150,4.25,Rogers Centre,8,6
2014-04-27,2014,MIL,CHC,0,4,-145,-1.5,155,7.5,100,-120,130,1.5,-175,4.44,Miller Park,4,-4
2014-04-27,2014,ATL,CIN,1,0,-105,-1.5,195,6.5,-124,104,-105,1.5,-225,3.33,Turner Field,1,1
2014-04-27,2014,SF,CLE,4,1,106,1.5,-165,8.0,100,-120,-116,-1.5,145,3.88,AT&T Park,5,3
2014-04-27,2014,LAD,COL,1,6,-147,-1.5,150,7.0,100,-120,132,1.5,-170,4.17,Dodger Stadium,7,-5
2014-04-27,2014,TB,CWS,2,9,-176,-1.5,-105,8.0,-110,-110,156,1.5,-115,5.1,Guaranteed Rate Field,11,-7
2014-04-27,2014,OAK,HOU,1,5,-147,-1.5,110,9.5,100,-120,132,1.5,-130,5.65,Minute Maid Park,6,-4
2014-04-27,2014,BAL,KC,3,9,115,1.5,-145,7.5,-105,-115,-130,-1.5,125,3.49,Camden Yards,12,-6
2014-04-27,2014,NYY,LAA,3,2,-164,-1.5,126,7.5,-105,-115,149,1.5,-145,4.66,Yankee Stadium,5,1
2014-04-27,2014,COL,LAD,6,1,132,1.5,-170,7.0,100,-120,-147,-1.5,150,3.02,Dodger Stadium,7,5
2014-04-27,2014,NYM,MIA,4,0,-119,-1.5,194,7.0,100,-120,109,1.5,-224,3.8,Citi Field,4,4
2014-04-27,2014,CHC,MIL,4,0,130,1.5,-175,7.5,100,-120,-145,-1.5,155,3.26,Miller Park,4,4
2014-04-27,2014,MIA,NYM,0,4,109,1.5,-224,7.0,100,-120,-119,-1.5,194,3.35,Citi Field,4,-4
2014-04-27,2014,LAA,NYY,2,3,149,1.5,-145,7.5,-105,-115,-164,-1.5,126,3.01,Yankee Stadium,5,-1
2014-04-27,2014,HOU,OAK,5,1,132,1.5,-130,9.5,100,-120,-147,-1.5,110,4.09,Minute Maid Park,6,4
2014-04-27,2014,ARI,PHI,0,2,-133,-1.5,160,8.5,-107,-113,118,1.5,-190,4.85,Chase Field,2,-2
2014-04-27,2014,STL,PIT,7,0,-190,-1.5,115,7.5,-115,-105,170,1.5,-135,4.91,Busch Stadium,7,7
2014-04-27,2014,WSH,SD,2,4,-116,-1.5,185,7.0,-125,105,106,1.5,-215,3.76,Nationals Park,6,-2
2014-04-27,2014,TEX,SEA,5,6,-106,-1.5,155,7.5,-103,-117,-104,1.5,-175,3.86,T-Mobile Park,11,-1
2014-04-27,2014,CLE,SF,1,4,-116,-1.5,145,8.0,100,-120,106,1.5,-165,4.3,AT&T Park,5,-3
2014-04-27,2014,PIT,STL,0,7,170,1.5,-135,7.5,-115,-105,-190,-1.5,115,2.78,Busch Stadium,7,-7
2014-04-27,2014,CWS,TB,9,2,156,1.5,-115,8.0,-110,-110,-176,-1.5,-105,3.13,Guaranteed Rate Field,11,7
2014-04-27,2014,SEA,TEX,6,5,-104,1.5,-175,7.5,-103,-117,-106,-1.5,155,3.82,T-Mobile Park,11,1
2014-04-27,2014,BOS,TOR,1,7,-110,-1.5,150,8.5,-110,-110,100,1.5,-170,4.45,Rogers Centre,8,-6
2014-04-27,2014,SD,WSH,4,2,106,1.5,-215,7.0,-125,105,-116,-1.5,185,3.4,Nationals Park,6,2
2014-04-28,2014,COL,ARI,8,5,116,1.5,-185,8.5,-105,-115,-131,-1.5,165,3.94,Chase Field,13,3
2014-04-28,2014,LAA,CLE,6,3,-128,-1.5,160,8.5,-110,-110,118,1.5,-180,4.77,Angel Stadium,9,3
2014-04-28,2014,ARI,COL,5,8,-131,-1.5,165,8.5,-105,-115,116,1.5,-185,4.82,Chase Field,13,-3
2014-04-28,2014,TB,CWS,3,7,-128,-1.5,130,9.0,-110,-110,118,1.5,-150,5.05,Guaranteed Rate Field,10,-4
2014-04-28,2014,CLE,LAA,3,6,118,1.5,-180,8.5,-110,-110,-128,-1.5,160,3.9,Angel Stadium,9,-3
2014-04-28,2014,STL,MIL,3,5,-170,-1.5,130,7.0,-110,-110,150,1.5,-150,4.41,Busch Stadium,8,-2
2014-04-28,2014,TEX,OAK,0,4,-127,-1.5,160,8.0,-117,-103,117,1.5,-190,4.48,Rangers Ballpark,4,-4
2014-04-28,2014,SF,SD,4,6,-173,-1.5,140,6.0,-105,-115,153,1.5,-160,3.8,AT&T Park,10,-2
2014-04-28,2014,SD,SF,6,4,153,1.5,-160,6.0,-105,-115,-173,-1.5,140,2.37,AT&T Park,10,2
2014-04-28,2014,MIL,STL,5,3,150,1.5,-150,7.0,-110,-110,-170,-1.5,130,2.8,Busch Stadium,8,2
2014-04-28,2014,CWS,TB,7,3,118,1.5,-150,9.0,-110,-110,-128,-1.5,130,4.13,Guaranteed Rate Field,10,4
2014-04-28,2014,OAK,TEX,4,0,117,1.5,-190,8.0,-117,-103,-127,-1.5,160,3.69,Rangers Ballpark,4,4
2014-04-29,2014,COL,ARI,5,4,-110,-1.5,150,8.5,-120,100,100,1.5,-170,4.45,Chase Field,9,1
2014-04-29,2014,MIA,ATL,9,0,-133,-1.5,175,6.0,-107,-113,118,1.5,-205,3.42,Marlins Park,9,9
2014-04-29,2014,TB,BOS,4,7,152,1.5,-140,8.5,-104,-116,-167,-1.5,120,3.37,Fenway Park,11,-3
2014-04-29,2014,CIN,CHC,3,2,-132,-1.5,170,7.5,105,-125,117,1.5,-200,4.27,Great American Ballpark,5,1
2014-04-29,2014,CHC,CIN,2,3,117,1.5,-200,7.5,105,-125,-132,-1.5,170,3.46,Great American Ballpark,5,-1
2014-04-29,2014,LAA,CLE,6,4,-129,-1.5,161,8.5,-110,-110,119,1.5,-191,4.79,Angel Stadium,10,2
2014-04-29,2014,ARI,COL,4,5,100,1.5,-170,8.5,-120,100,-110,-1.5,150,4.25,Chase Field,9,-1
2014-04-29,2014,DET,CWS,4,3,-140,-1.5,120,8.5,100,-120,125,1.5,-140,4.96,Guaranteed Rate Field,7,1
2014-04-29,2014,CWS,DET,3,4,125,1.5,-140,8.5,100,-120,-140,-1.5,120,3.78,Guaranteed Rate Field,7,-1
2014-04-29,2014,WSH,HOU,4,3,-144,-1.5,115,8.5,-115,-105,129,1.5,-135,5.02,Minute Maid Park,7,1
2014-04-29,2014,TOR,KC,7,10,129,1.5,-170,8.5,-105,-115,-144,-1.5,150,3.71,Kauffman Stadium,17,-3
2014-04-29,2014,CLE,LAA,4,6,119,1.5,-191,8.5,-110,-110,-129,-1.5,161,3.88,Angel Stadium,10,-2
2014-04-29,2014,ATL,MIA,0,9,118,1.5,-205,6.0,-107,-113,-133,-1.5,175,2.75,Marlins Park,9,-9
2014-04-29,2014,STL,MIL,4,5,-165,-1.5,140,6.5,-125,105,150,1.5,-160,4.05,Busch Stadium,9,-1
2014-04-29,2014,PHI,NYM,1,6,-140,-1.5,160,6.5,-125,105,125,1.5,-190,3.79,Citizens Bank Park,7,-5
2014-04-29,2014,SEA,NYY,6,3,154,1.5,-135,8.0,-120,100,-174,-1.5,115,3.15,Yankee Stadium,9,3
2014-04-29,2014,TEX,OAK,3,9,-101,1.5,-160,8.0,-110,-110,-109,-1.5,140,4.02,Rangers Ballpark,12,-6
2014-04-29,2014,NYM,PHI,6,1,125,1.5,-190,6.5,-125,105,-140,-1.5,160,2.89,Citizens Bank Park,7,5
2014-04-29,2014,SF,SD,6,0,-150,-1.5,145,7.0,-110,-110,135,1.5,-165,4.2,AT&T Park,6,6
2014-04-29,2014,NYY,SEA,3,6,-174,-1.5,115,8.0,-120,100,154,1.5,-135,5.08,Yankee Stadium,9,-3
2014-04-29,2014,SD,SF,0,6,135,1.5,-165,7.0,-110,-110,-150,-1.5,145,2.98,AT&T Park,6,-6
2014-04-29,2014,MIL,STL,5,4,150,1.5,-160,6.5,-125,105,-165,-1.5,140,2.6,Busch Stadium,9,1
2014-04-29,2014,BOS,TB,7,4,-167,-1.5,120,8.5,-104,-116,152,1.5,-140,5.32,Fenway Park,11,3
2014-04-29,2014,OAK,TEX,9,3,-109,-1.5,140,8.0,-110,-110,-101,1.5,-160,4.17,Rangers Ballpark,12,6
2014-04-29,2014,KC,TOR,10,7,-144,-1.5,150,8.5,-105,-115,129,1.5,-170,5.02,Kauffman Stadium,17,3
2014-04-29,2014,HOU,WSH,3,4,129,1.5,-135,8.5,-115,-105,-144,-1.5,115,3.71,Minute Maid Park,7,-1
2014-04-30,2014,COL,ARI,4,5,105,1.5,-200,8.5,-120,100,-115,-1.5,170,4.15,Chase Field,9,-1
2014-04-30,2014,MIA,ATL,9,3,-104,1.5,-175,7.0,-125,105,-106,-1.5,155,3.57,Marlins Park,12,6
2014-04-30,2014,CIN,CHC,4,9,-184,-1.5,115,7.5,100,-120,164,1.5,-135,4.86,Great American Ballpark,13,-5
2014-04-30,2014,CHC,CIN,9,4,164,1.5,-135,7.5,100,-120,-184,-1.5,115,2.84,Great American Ballpark,13,5
2014-04-30,2014,LAA,CLE,7,1,-147,-1.5,140,9.0,-115,-105,132,1.5,-160,5.36,Angel Stadium,8,6
2014-04-30,2014,ARI,COL,5,4,-115,-1.5,170,8.5,-120,100,105,1.5,-200,4.55,Chase Field,9,1
2014-04-30,2014,DET,CWS,5,1,-177,-1.5,-115,8.0,-115,-105,157,1.5,-105,5.11,Guaranteed Rate Field,6,4
2014-04-30,2014,CWS,DET,1,5,157,1.5,-105,8.0,-115,-105,-177,-1.5,-115,3.11,Guaranteed Rate Field,6,-4
2014-04-30,2014,WSH,HOU,7,0,-142,-1.5,115,8.5,-103,-117,127,1.5,-135,4.99,Minute Maid Park,7,7
2014-04-30,2014,TOR,KC,2,4,119,1.5,-190,7.0,-120,100,-134,-1.5,160,3.2,Kauffman Stadium,6,-2
2014-04-30,2014,CLE,LAA,1,7,132,1.5,-160,9.0,-115,-105,-147,-1.5,140,3.88,Angel Stadium,8,-6
2014-04-30,2014,MIN,LAD,4,6,146,1.5,-115,7.5,-106,-114,-161,-1.5,-105,3.05,Target Field,10,-2
2014-04-30,2014,ATL,MIA,3,9,-106,-1.5,155,7.0,-125,105,-104,1.5,-175,3.6,Marlins Park,12,-6
2014-04-30,2014,STL,MIL,9,3,-141,-1.5,160,7.0,100,-120,126,1.5,-180,4.1,Busch Stadium,12,6
2014-04-30,2014,LAD,MIN,6,4,-161,-1.5,-105,7.5,-106,-114,146,1.5,-115,4.63,Target Field,10,2
2014-04-30,2014,TEX,OAK,1,12,-120,-1.5,175,8.0,-105,-115,110,1.5,-205,4.36,Rangers Ballpark,13,-11
2014-04-30,2014,SF,SD,3,2,-170,-1.5,130,7.0,100,-120,150,1.5,-150,4.41,AT&T Park,5,1
2014-04-30,2014,SD,SF,2,3,150,1.5,-150,7.0,100,-120,-170,-1.5,130,2.8,AT&T Park,5,-1
2014-04-30,2014,MIL,STL,3,9,126,1.5,-180,7.0,100,-120,-141,-1.5,160,3.1,Busch Stadium,12,-6
2014-04-30,2014,OAK,TEX,12,1,110,1.5,-205,8.0,-105,-115,-120,-1.5,175,3.81,Rangers Ballpark,13,11
2014-04-30,2014,KC,TOR,4,2,-134,-1.5,160,7.0,-120,100,119,1.5,-190,4.01,Kauffman Stadium,6,2
2014-04-30,2014,HOU,WSH,0,7,127,1.5,-135,8.5,-103,-117,-142,-1.5,115,3.74,Minute Maid Park,7,-7
2014-05-01,2014,MIA,ATL,5,4,117,1.5,-150,7.5,105,-125,-132,-1.5,130,3.46,Marlins Park,9,1
2014-05-01,2014,PIT,BAL,1,5,108,1.5,-200,9.0,-105,-115,-118,-1.5,170,4.33,Camden Yards,6,-4
2014-05-01,2014,PIT,BAL,5,6,118,1.5,-200,8.5,100,-120,-128,-1.5,170,3.9,Camden Yards,11,-1
2014-05-01,2014,TB,BOS,2,1,143,1.5,-145,9.0,-120,100,-158,-1.5,125,3.7,Fenway Park,3,1
2014-05-01,2014,TB,BOS,6,5,103,1.5,-195,9.0,-124,104,-113,-1.5,165,4.43,Fenway Park,11,1
2014-05-01,2014,MIL,CIN,3,8,109,1.5,-205,7.0,-120,100,-119,-1.5,175,3.35,Great American Ballpark,11,-5
2014-05-01,2014,NYM,COL,4,7,125,1.5,-170,9.5,100,-120,-140,-1.5,150,4.22,Coors Field,11,-3
2014-05-01,2014,TOR,KC,7,3,-109,-1.5,140,8.0,-115,-105,-101,1.5,-160,4.17,Kauffman Stadium,10,4
2014-05-01,2014,MIN,LAD,4,9,140,1.5,-120,8.5,-125,105,-155,-1.5,100,3.54,Target Field,13,-5
2014-05-01,2014,MIN,LAD,3,4,-112,-1.5,180,9.0,103,-123,102,1.5,-210,4.75,Target Field,7,-1
2014-05-01,2014,ATL,MIA,4,5,-132,-1.5,130,7.5,105,-125,117,1.5,-150,4.27,Marlins Park,9,-1
2014-05-01,2014,CIN,MIL,8,3,-119,-1.5,175,7.0,-120,100,109,1.5,-205,3.8,Great American Ballpark,11,5
2014-05-01,2014,LAD,MIN,9,4,-155,-1.5,100,8.5,-125,105,140,1.5,-120,5.17,Target Field,13,5
2014-05-01,2014,LAD,MIN,4,3,102,1.5,-210,9.0,103,-123,-112,-1.5,180,4.46,Target Field,7,1
2014-05-01,2014,COL,NYM,7,4,-140,-1.5,150,9.5,100,-120,125,1.5,-170,5.54,Coors Field,11,3
2014-05-01,2014,SEA,NYY,4,2,134,1.5,-165,9.0,-105,-115,-149,-1.5,145,3.85,Yankee Stadium,6,2
2014-05-01,2014,BAL,PIT,5,1,-118,-1.5,170,9.0,-105,-115,108,1.5,-200,4.87,Camden Yards,6,4
2014-05-01,2014,BAL,PIT,6,5,-128,-1.5,170,8.5,100,-120,118,1.5,-200,4.77,Camden Yards,11,1
2014-05-01,2014,NYY,SEA,2,4,-149,-1.5,145,9.0,-105,-115,134,1.5,-165,5.39,Yankee Stadium,6,-2
2014-05-01,2014,BOS,TB,1,2,-158,-1.5,125,9.0,-120,100,143,1.5,-145,5.51,Fenway Park,3,-1
2014-05-01,2014,BOS,TB,5,6,-113,-1.5,165,9.0,-124,104,103,1.5,-195,4.77,Fenway Park,11,-1
2014-05-01,2014,KC,TOR,3,7,-101,1.5,-160,8.0,-115,-105,-109,-1.5,140,4.02,Kauffman Stadium,10,-4
2014-05-02,2014,SD,ARI,0,2,-144,-1.5,155,7.0,105,-125,129,1.5,-175,4.13,PETCO Park,2,-2
2014-05-02,2014,SF,ATL,2,1,119,1.5,-190,7.5,105,-125,-134,-1.5,160,3.42,Turner Field,3,1
2014-05-02,2014,MIN,BAL,0,3,-111,-1.5,180,8.5,-120,100,101,1.5,-210,4.47,Target Field,3,-3
2014-05-02,2014,OAK,BOS,1,7,107,1.5,-195,9.5,-110,-110,-117,-1.5,165,4.59,Fenway Park,8,-6
2014-05-02,2014,STL,CHC,5,6,-165,-1.5,-106,8.0,-115,-105,150,1.5,-114,4.98,Wrigley Field,11,-1
2014-05-02,2014,MIL,CIN,2,0,107,1.5,-210,7.5,-110,-110,-117,-1.5,180,3.62,Great American Ballpark,2,2
2014-05-02,2014,CWS,CLE,5,12,136,1.5,-155,8.0,-120,100,-151,-1.5,135,3.39,Progressive Field,17,-7
2014-05-02,2014,NYM,COL,3,10,117,1.5,-175,10.0,100,-120,-132,-1.5,155,4.61,Coors Field,13,-7
2014-05-02,2014,CLE,CWS,12,5,-151,-1.5,135,8.0,-120,100,136,1.5,-155,4.81,Progressive Field,17,7
2014-05-02,2014,KC,DET,2,8,-138,-1.5,150,7.5,-110,-110,123,1.5,-170,4.35,Kauffman Stadium,10,-6
2014-05-02,2014,SEA,HOU,4,5,-203,-1.5,-125,8.0,100,-120,173,1.5,105,5.36,Minute Maid Park,9,-1
2014-05-02,2014,DET,KC,8,2,123,1.5,-170,7.5,-110,-110,-138,-1.5,150,3.36,Kauffman Stadium,10,6
2014-05-02,2014,TEX,LAA,5,2,119,1.5,-180,9.0,100,-120,-134,-1.5,160,4.11,Angel Stadium,7,3
2014-05-02,2014,MIA,LAD,6,3,105,1.5,-170,7.5,-120,100,-115,-1.5,150,3.66,Marlins Park,9,3
2014-05-02,2014,LAD,MIA,3,6,-115,-1.5,150,7.5,-120,100,105,1.5,-170,4.01,Marlins Park,9,-3
2014-05-02,2014,CIN,MIL,0,2,-117,-1.5,180,7.5,-110,-110,107,1.5,-210,4.04,Great American Ballpark,2,-2
2014-05-02,2014,BAL,MIN,3,0,101,1.5,-210,8.5,-120,100,-111,-1.5,180,4.23,Target Field,3,3
2014-05-02,2014,COL,NYM,10,3,-132,-1.5,155,10.0,100,-120,117,1.5,-175,5.69,Coors Field,13,7
2014-05-02,2014,TB,NYY,10,5,-142,-1.5,120,8.5,103,-123,127,1.5,-140,4.99,Yankee Stadium,15,5
2014-05-02,2014,BOS,OAK,7,1,-117,-1.5,165,9.5,-110,-110,107,1.5,-195,5.12,Fenway Park,8,6
2014-05-02,2014,WSH,PHI,5,3,-102,1.5,-235,6.5,-125,105,-108,-1.5,195,3.28,Citizens Bank Park,8,2
2014-05-02,2014,TOR,PIT,5,6,125,1.5,-175,7.5,105,-125,-140,-1.5,155,3.33,PNC Park,11,-1
2014-05-02,2014,ARI,SD,2,0,129,1.5,-175,7.0,105,-125,-144,-1.5,155,3.06,PETCO Park,2,2
2014-05-02,2014,HOU,SEA,5,4,173,1.5,105,8.0,100,-120,-203,-1.5,-125,2.93,Minute Maid Park,9,1
2014-05-02,2014,ATL,SF,1,2,-134,-1.5,160,7.5,105,-125,119,1.5,-190,4.29,Turner Field,3,-1
2014-05-02,2014,CHC,STL,6,5,150,1.5,-114,8.0,-115,-105,-165,-1.5,-106,3.2,Wrigley Field,11,1
2014-05-02,2014,NYY,TB,5,10,127,1.5,-140,8.5,103,-123,-142,-1.5,120,3.74,Yankee Stadium,15,-5
2014-05-02,2014,LAA,TEX,2,5,-134,-1.5,160,9.0,100,-120,119,1.5,-180,5.15,Angel Stadium,7,-3
2014-05-02,2014,PIT,TOR,6,5,-140,-1.5,155,7.5,105,-125,125,1.5,-175,4.38,PNC Park,11,1
2014-05-02,2014,PHI,WSH,3,5,-108,-1.5,195,6.5,-125,105,-102,1.5,-235,3.38,Citizens Bank Park,8,-2
2014-05-03,2014,SD,ARI,3,4,-132,-1.5,170,6.5,-112,-108,117,1.5,-200,3.7,PETCO Park,7,-1
2014-05-03,2014,SF,ATL,3,1,157,1.5,-140,7.5,100,-120,-177,-1.5,120,2.92,Turner Field,4,2
2014-05-03,2014,MIN,BAL,6,1,110,1.5,-145,8.0,-111,-109,-120,-1.5,125,3.81,Target Field,7,5
2014-05-03,2014,OAK,BOS,3,6,125,1.5,-165,9.0,-105,-115,-140,-1.5,145,4.0,Fenway Park,9,-3
2014-05-03,2014,STL,CHC,0,3,-190,-1.5,-119,8.0,-112,-108,170,1.5,-101,5.24,Wrigley Field,3,-3
2014-05-03,2014,MIL,CIN,2,6,139,1.5,-170,7.0,105,-125,-154,-1.5,150,2.93,Great American Ballpark,8,-4
2014-05-03,2014,CWS,CLE,0,2,148,1.5,-150,8.5,-115,-105,-163,-1.5,130,3.43,Progressive Field,2,-2
2014-05-03,2014,NYM,COL,10,11,116,1.5,-175,10.5,-105,-115,-126,-1.5,155,4.86,Coors Field,21,-1
2014-05-03,2014,CLE,CWS,2,0,-163,-1.5,130,8.5,-115,-105,148,1.5,-150,5.27,Progressive Field,2,2
2014-05-03,2014,KC,DET,2,9,-101,1.5,-175,8.0,-120,100,-109,-1.5,155,4.02,Kauffman Stadium,11,-7
2014-05-03,2014,SEA,HOU,9,8,-122,-1.5,130,8.0,-105,-115,112,1.5,-151,4.4,Minute Maid Park,17,1
2014-05-03,2014,DET,KC,9,2,-109,-1.5,155,8.0,-120,100,-101,1.5,-175,4.17,Kauffman Stadium,11,7
2014-05-03,2014,TEX,LAA,3,5,130,1.5,-165,8.5,-105,-115,-145,-1.5,145,3.7,Angel Stadium,8,-2
2014-05-03,2014,MIA,LAD,7,9,108,1.5,-160,8.5,-115,-105,-118,-1.5,140,4.09,Marlins Park,16,-2
2014-05-03,2014,LAD,MIA,9,7,-118,-1.5,140,8.5,-115,-105,108,1.5,-160,4.6,Marlins Park,16,2
2014-05-03,2014,CIN,MIL,6,2,-154,-1.5,150,7.0,105,-125,139,1.5,-170,4.24,Great American Ballpark,8,4
2014-05-03,2014,BAL,MIN,1,6,-120,-1.5,125,8.0,-111,-109,110,1.5,-145,4.36,Target Field,7,-5
2014-05-03,2014,COL,NYM,11,10,-126,-1.5,155,10.5,-105,-115,116,1.5,-175,5.85,Coors Field,21,1
2014-05-03,2014,TB,NYY,3,9,170,1.5,-119,8.5,100,-120,-200,-1.5,-101,3.15,Yankee Stadium,12,-6
2014-05-03,2014,BOS,OAK,6,3,-140,-1.5,145,9.0,-105,-115,125,1.5,-165,5.25,Fenway Park,9,3
2014-05-03,2014,WSH,PHI,2,7,-102,1.5,-225,7.5,-110,-110,-108,-1.5,195,3.79,Citizens Bank Park,9,-5
2014-05-03,2014,TOR,PIT,6,8,111,1.5,-205,7.0,-120,100,-121,-1.5,175,3.32,PNC Park,14,-2
2014-05-03,2014,ARI,SD,4,3,117,1.5,-200,6.5,-112,-108,-132,-1.5,170,3.0,PETCO Park,7,1
2014-05-03,2014,HOU,SEA,8,9,112,1.5,-151,8.0,-105,-115,-122,-1.5,130,3.77,Minute Maid Park,17,-1
2014-05-03,2014,ATL,SF,1,3,-177,-1.5,120,7.5,100,-120,157,1.5,-140,4.79,Turner Field,4,-2
2014-05-03,2014,CHC,STL,3,0,170,1.5,-101,8.0,-112,-108,-190,-1.5,-119,2.96,Wrigley Field,3,3
2014-05-03,2014,NYY,TB,9,3,-200,-1.5,-101,8.5,100,-120,170,1.5,-119,5.67,Yankee Stadium,12,6
2014-05-03,2014,LAA,TEX,5,3,-145,-1.5,145,8.5,-105,-115,130,1.5,-165,5.03,Angel Stadium,8,2
2014-05-03,2014,PIT,TOR,8,6,-121,-1.5,175,7.0,-120,100,111,1.5,-205,3.83,PNC Park,14,2
2014-05-03,2014,PHI,WSH,7,2,-108,-1.5,195,7.5,-110,-110,-102,1.5,-225,3.89,Citizens Bank Park,9,5
2014-05-04,2014,SD,ARI,4,3,-124,-1.5,175,6.5,-110,-110,114,1.5,-205,3.6,PETCO Park,7,1
2014-05-04,2014,SF,ATL,4,1,115,1.5,-211,7.0,-105,-115,-130,-1.5,181,3.26,Turner Field,5,3
2014-05-04,2014,MIN,BAL,5,2,-110,-1.5,181,8.0,-120,100,100,1.5,-211,4.19,Target Field,7,3
2014-05-04,2014,OAK,BOS,3,2,-105,-1.5,150,8.5,-126,106,-105,1.5,-170,4.35,Fenway Park,5,1
2014-05-04,2014,STL,CHC,5,4,-132,-1.5,120,7.0,-115,-105,117,1.5,-140,3.98,Wrigley Field,9,1
2014-05-04,2014,MIL,CIN,3,4,100,1.5,-215,7.5,-105,-115,-110,-1.5,185,3.75,Great American Ballpark,7,-1
2014-05-04,2014,CWS,CLE,4,3,138,1.5,-159,8.5,-110,-110,-153,-1.5,140,3.57,Progressive Field,7,1
2014-05-04,2014,NYM,COL,5,1,116,1.5,-175,11.0,-105,-115,-126,-1.5,155,5.09,Coors Field,6,4
2014-05-04,2014,CLE,CWS,3,4,-153,-1.5,140,8.5,-110,-110,138,1.5,-159,5.14,Progressive Field,7,-1
2014-05-04,2014,KC,DET,4,9,119,1.5,-145,8.5,-104,-116,-134,-1.5,125,3.88,Kauffman Stadium,13,-5
2014-05-04,2014,SEA,HOU,8,7,-101,1.5,-211,8.5,-115,-105,-109,-1.5,181,4.27,Minute Maid Park,15,1
2014-05-04,2014,DET,KC,9,4,-134,-1.5,125,8.5,-104,-116,119,1.5,-145,4.87,Kauffman Stadium,13,5
2014-05-04,2014,TEX,LAA,14,3,-111,-1.5,145,7.5,101,-121,101,1.5,-165,3.95,Angel Stadium,17,11
2014-05-04,2014,MIA,LAD,5,4,-181,-1.5,120,7.0,-115,-105,161,1.5,-140,4.51,Marlins Park,9,1
2014-05-04,2014,LAD,MIA,4,5,161,1.5,-140,7.0,-115,-105,-181,-1.5,120,2.68,Marlins Park,9,-1
2014-05-04,2014,CIN,MIL,4,3,-110,-1.5,185,7.5,-105,-115,100,1.5,-215,3.93,Great American Ballpark,7,1
2014-05-04,2014,BAL,MIN,2,5,100,1.5,-211,8.0,-120,100,-110,-1.5,181,4.0,Target Field,7,-3
2014-05-04,2014,COL,NYM,1,5,-126,-1.5,155,11.0,-105,-115,116,1.5,-175,6.13,Coors Field,6,-4
2014-05-04,2014,TB,NYY,5,1,126,1.5,-165,9.0,-110,-110,-141,-1.5,145,3.98,Yankee Stadium,6,4
2014-05-04,2014,BOS,OAK,2,3,-105,1.5,-170,8.5,-126,106,-105,-1.5,150,4.35,Fenway Park,5,-1
2014-05-04,2014,WSH,PHI,0,1,-130,-1.5,120,7.5,-115,-105,115,1.5,-140,4.24,Citizens Bank Park,1,-1
2014-05-04,2014,TOR,PIT,7,2,113,1.5,-195,8.5,-110,-110,-123,-1.5,165,3.99,PNC Park,9,5
2014-05-04,2014,ARI,SD,3,4,114,1.5,-205,6.5,-110,-110,-124,-1.5,175,3.04,PETCO Park,7,-1
2014-05-04,2014,HOU,SEA,7,8,-109,-1.5,181,8.5,-115,-105,-101,1.5,-211,4.43,Minute Maid Park,15,-1
2014-05-04,2014,ATL,SF,1,4,-130,-1.5,181,7.0,-105,-115,115,1.5,-211,3.96,Turner Field,5,-3
2014-05-04,2014,CHC,STL,4,5,117,1.5,-140,7.0,-115,-105,-132,-1.5,120,3.23,Wrigley Field,9,-1
2014-05-04,2014,NYY,TB,1,5,-141,-1.5,145,9.0,-110,-110,126,1.5,-165,5.27,Yankee Stadium,6,-4
2014-05-04,2014,LAA,TEX,3,14,101,1.5,-165,7.5,101,-121,-111,-1.5,145,3.73,Angel Stadium,17,-11
2014-05-04,2014,PIT,TOR,2,7,-123,-1.5,165,8.5,-110,-110,113,1.5,-195,4.69,PNC Park,9,-5
2014-05-04,2014,PHI,WSH,1,0,115,1.5,-140,7.5,-115,-105,-130,-1.5,120,3.49,Citizens Bank Park,1,1
2014-05-05,2014,MIL,ARI,8,3,-150,-1.5,145,8.0,100,-120,135,1.5,-165,4.8,Miller Park,11,5
2014-05-05,2014,STL,ATL,4,3,-101,1.5,-210,7.5,-105,-115,-109,-1.5,180,3.77,Turner Field,7,1
2014-05-05,2014,CWS,CHC,3,1,114,1.5,-210,6.5,-110,-110,-124,-1.5,180,3.04,Wrigley Field,4,2
2014-05-05,2014,MIN,CLE,1,0,143,1.5,-155,8.0,-105,-115,-158,-1.5,135,3.29,Progressive Field,1,1
2014-05-05,2014,TEX,COL,2,8,106,1.5,-195,10.5,-120,100,-116,-1.5,165,5.1,Coors Field,10,-6
2014-05-05,2014,CHC,CWS,1,3,-124,-1.5,180,6.5,-110,-110,114,1.5,-210,3.6,Wrigley Field,4,-2
2014-05-05,2014,HOU,DET,0,2,245,1.5,110,7.5,-120,100,-285,-1.5,-130,2.17,Comerica Park,2,-2
2014-05-05,2014,DET,HOU,2,0,-285,-1.5,-130,7.5,-120,100,245,1.5,110,5.55,Comerica Park,2,2
2014-05-05,2014,SD,KC,6,5,113,1.5,-155,6.5,100,-120,-123,-1.5,135,3.05,PETCO Park,11,1
2014-05-05,2014,NYY,LAA,1,4,130,1.5,-165,8.0,-110,-110,-145,-1.5,145,3.48,Angel Stadium,5,-3
2014-05-05,2014,WSH,LAD,4,0,102,1.5,-180,7.0,110,-130,-112,-1.5,160,3.47,Nationals Park,4,4
2014-05-05,2014,NYM,MIA,3,4,119,1.5,-195,7.0,-125,105,-134,-1.5,165,3.2,Marlins Park,7,-1
2014-05-05,2014,ARI,MIL,3,8,135,1.5,-165,8.0,100,-120,-150,-1.5,145,3.4,Miller Park,11,-5
2014-05-05,2014,CLE,MIN,0,1,-158,-1.5,135,8.0,-105,-115,143,1.5,-155,4.9,Progressive Field,1,-1
2014-05-05,2014,MIA,NYM,4,3,-134,-1.5,165,7.0,-125,105,119,1.5,-195,4.01,Marlins Park,7,1
2014-05-05,2014,LAA,NYY,4,1,-145,-1.5,145,8.0,-110,-110,130,1.5,-165,4.73,Angel Stadium,5,3
2014-05-05,2014,SEA,OAK,4,2,171,1.5,-125,7.5,103,-123,-201,-1.5,105,2.77,Oakland Coliseum,6,2
2014-05-05,2014,TOR,PHI,3,0,-111,-1.5,155,8.5,-115,-105,101,1.5,-175,4.47,Citizens Bank Park,3,3
2014-05-05,2014,SF,PIT,11,10,-104,-1.5,150,7.0,-110,-110,-106,1.5,-170,3.57,PNC Park,21,1
2014-05-05,2014,KC,SD,5,6,-123,-1.5,135,6.5,100,-120,113,1.5,-155,3.59,PETCO Park,11,-1
2014-05-05,2014,OAK,SEA,2,4,-201,-1.5,105,7.5,103,-123,171,1.5,-125,5.01,Oakland Coliseum,6,-2
2014-05-05,2014,PIT,SF,10,11,-106,1.5,-170,7.0,-110,-110,-104,-1.5,150,3.6,PNC Park,21,-1
2014-05-05,2014,ATL,STL,3,4,-109,-1.5,180,7.5,-105,-115,-101,1.5,-210,3.91,Turner Field,7,-1
2014-05-05,2014,COL,TEX,8,2,-116,-1.5,165,10.5,-120,100,106,1.5,-195,5.64,Coors Field,10,6
2014-05-05,2014,PHI,TOR,0,3,101,1.5,-175,8.5,-115,-105,-111,-1.5,155,4.23,Citizens Bank Park,3,-3
2014-05-05,2014,LAD,WSH,0,4,-112,-1.5,160,7.0,110,-130,102,1.5,-180,3.7,Nationals Park,4,-4
2014-05-06,2014,MIL,ARI,5,7,-146,-1.5,150,7.5,-115,-105,131,1.5,-170,4.45,Miller Park,12,-2
2014-05-06,2014,STL,ATL,1,2,106,1.5,-205,8.0,-105,-115,-116,-1.5,175,3.88,Turner Field,3,-1
2014-05-06,2014,TB,BAL,3,5,-140,-1.5,150,7.5,-115,-105,125,1.5,-170,4.38,Tropicana Field,8,-2
2014-05-06,2014,CIN,BOS,3,4,115,1.5,-190,8.5,-105,-115,-130,-1.5,160,3.95,Fenway Park,7,-1
2014-05-06,2014,CWS,CHC,5,1,125,1.5,-190,7.0,-120,100,-140,-1.5,160,3.11,Wrigley Field,6,4
2014-05-06,2014,BOS,CIN,4,3,-130,-1.5,160,8.5,-105,-115,115,1.5,-190,4.8,Fenway Park,7,1
2014-05-06,2014,MIN,CLE,2,4,133,1.5,-170,7.5,105,-125,-148,-1.5,150,3.22,Progressive Field,6,-2
2014-05-06,2014,TEX,COL,1,12,114,1.5,-190,10.5,-105,-115,-124,-1.5,160,4.91,Coors Field,13,-11
2014-05-06,2014,CHC,CWS,1,5,-140,-1.5,160,7.0,-120,100,125,1.5,-190,4.08,Wrigley Field,6,-4
2014-05-06,2014,HOU,DET,4,11,159,1.5,-130,9.0,-115,-105,-179,-1.5,110,3.47,Comerica Park,15,-7
2014-05-06,2014,DET,HOU,11,4,-179,-1.5,110,9.0,-115,-105,159,1.5,-130,5.77,Comerica Park,15,7
2014-05-06,2014,SD,KC,1,3,-114,-1.5,190,6.5,-105,-115,104,1.5,-220,3.46,PETCO Park,4,-2
2014-05-06,2014,NYY,LAA,4,3,119,1.5,-175,7.5,-115,-105,-134,-1.5,155,3.42,Angel Stadium,7,1
2014-05-06,2014,WSH,LAD,3,8,149,1.5,-120,7.0,105,-125,-164,-1.5,100,2.81,Nationals Park,11,-5
2014-05-06,2014,NYM,MIA,0,3,109,1.5,-205,7.5,-115,-105,-119,-1.5,175,3.59,Marlins Park,3,-3
2014-05-06,2014,ARI,MIL,7,5,131,1.5,-170,7.5,-115,-105,-146,-1.5,150,3.25,Miller Park,12,2
2014-05-06,2014,CLE,MIN,4,2,-148,-1.5,150,7.5,105,-125,133,1.5,-170,4.48,Progressive Field,6,2
2014-05-06,2014,MIA,NYM,3,0,-119,-1.5,175,7.5,-115,-105,109,1.5,-205,4.08,Marlins Park,3,3
2014-05-06,2014,LAA,NYY,3,4,-134,-1.5,155,7.5,-115,-105,119,1.5,-175,4.29,Angel Stadium,7,-1
2014-05-06,2014,SEA,OAK,8,3,158,1.5,-140,7.0,-130,110,-178,-1.5,120,2.71,Oakland Coliseum,11,5
2014-05-06,2014,TOR,PHI,6,5,105,1.5,-215,7.5,100,-120,-115,-1.5,185,3.66,Citizens Bank Park,11,1
2014-05-06,2014,SF,PIT,1,2,-113,-1.5,150,7.5,-105,-115,103,1.5,-170,3.98,PNC Park,3,-1
2014-05-06,2014,KC,SD,3,1,104,1.5,-220,6.5,-105,-115,-114,-1.5,190,3.19,PETCO Park,4,2
2014-05-06,2014,OAK,SEA,3,8,-178,-1.5,120,7.0,-130,110,158,1.5,-140,4.48,Oakland Coliseum,11,-5
2014-05-06,2014,PIT,SF,2,1,103,1.5,-170,7.5,-105,-115,-113,-1.5,150,3.69,PNC Park,3,1
2014-05-06,2014,ATL,STL,2,1,-116,-1.5,175,8.0,-105,-115,106,1.5,-205,4.3,Turner Field,3,1
2014-05-06,2014,BAL,TB,5,3,125,1.5,-170,7.5,-115,-105,-140,-1.5,150,3.33,Tropicana Field,8,2
2014-05-06,2014,COL,TEX,12,1,-124,-1.5,160,10.5,-105,-115,114,1.5,-190,5.81,Coors Field,13,11
2014-05-06,2014,PHI,TOR,5,6,-115,-1.5,185,7.5,100,-120,105,1.5,-215,4.01,Citizens Bank Park,11,-1
2014-05-06,2014,LAD,WSH,8,3,-164,-1.5,100,7.0,105,-125,149,1.5,-120,4.35,Nationals Park,11,5
2014-05-07,2014,MIL,ARI,2,3,-150,-1.5,145,8.0,-110,-110,135,1.5,-165,4.8,Miller Park,5,-1
2014-05-07,2014,STL,ATL,7,1,-114,-1.5,150,6.5,-126,106,104,1.5,-170,3.46,Turner Field,8,6
2014-05-07,2014,TB,BAL,3,4,-124,-1.5,170,8.0,100,-120,114,1.5,-200,4.43,Tropicana Field,7,-1
2014-05-07,2014,CIN,BOS,3,4,143,1.5,-150,8.5,-102,-118,-158,-1.5,130,3.5,Fenway Park,7,-1
2014-05-07,2014,CWS,CHC,8,3,-102,1.5,-175,9.0,-105,-115,-108,-1.5,155,4.54,Guaranteed Rate Field,11,5
2014-05-07,2014,BOS,CIN,4,3,-158,-1.5,130,8.5,-102,-118,143,1.5,-150,5.21,Fenway Park,7,1
2014-05-07,2014,MIN,CLE,3,4,143,1.5,-159,7.5,-120,100,-158,-1.5,139,3.09,Progressive Field,7,-1
2014-05-07,2014,TEX,COL,2,9,-123,-1.5,160,9.5,-110,-110,113,1.5,-190,5.24,Rangers Ballpark,11,-7
2014-05-07,2014,CHC,CWS,3,8,-108,-1.5,155,9.0,-105,-115,-102,1.5,-175,4.67,Guaranteed Rate Field,11,-5
2014-05-07,2014,HOU,DET,2,3,179,1.5,-110,8.5,-120,100,-209,-1.5,-110,3.05,Comerica Park,5,-1
2014-05-07,2014,DET,HOU,3,2,-209,-1.5,-110,8.5,-120,100,179,1.5,-110,5.75,Comerica Park,5,1
2014-05-07,2014,SD,KC,0,8,107,1.5,-190,5.5,-120,100,-117,-1.5,160,2.66,PETCO Park,8,-8
2014-05-07,2014,NYY,LAA,9,2,125,1.5,-170,8.5,-105,-115,-140,-1.5,150,3.78,Angel Stadium,11,7
2014-05-07,2014,WSH,LAD,3,2,-140,-1.5,160,6.5,-120,100,125,1.5,-180,3.79,Nationals Park,5,1
2014-05-07,2014,NYM,MIA,0,1,102,1.5,-210,7.5,113,-133,-112,-1.5,180,3.71,Marlins Park,1,-1
2014-05-07,2014,ARI,MIL,3,2,135,1.5,-165,8.0,-110,-110,-150,-1.5,145,3.4,Miller Park,5,1
2014-05-07,2014,CLE,MIN,4,3,-158,-1.5,139,7.5,-120,100,143,1.5,-159,4.59,Progressive Field,7,1
2014-05-07,2014,MIA,NYM,1,0,-112,-1.5,180,7.5,113,-133,102,1.5,-210,3.96,Marlins Park,1,1
2014-05-07,2014,LAA,NYY,2,9,-140,-1.5,150,8.5,-105,-115,125,1.5,-170,4.96,Angel Stadium,11,-7
2014-05-07,2014,SEA,OAK,6,4,-120,-1.5,140,7.0,-125,105,110,1.5,-160,3.82,Oakland Coliseum,10,2
2014-05-07,2014,SEA,OAK,0,2,150,1.5,-160,7.5,-110,-110,-165,-1.5,135,3.0,Oakland Coliseum,2,-2
2014-05-07,2014,TOR,PHI,10,0,-108,-1.5,185,8.0,-110,-110,-102,1.5,-215,4.15,Rogers Centre,10,10
2014-05-07,2014,SF,PIT,3,4,142,1.5,-169,7.0,-110,-110,-157,-1.5,149,2.89,PNC Park,7,-1
2014-05-07,2014,KC,SD,8,0,-117,-1.5,160,5.5,-120,100,107,1.5,-190,2.97,PETCO Park,8,8
2014-05-07,2014,OAK,SEA,4,6,110,1.5,-160,7.0,-125,105,-120,-1.5,140,3.33,Oakland Coliseum,10,-2
2014-05-07,2014,OAK,SEA,2,0,-165,-1.5,135,7.5,-110,-110,150,1.5,-160,4.67,Oakland Coliseum,2,2
2014-05-07,2014,PIT,SF,4,3,-157,-1.5,149,7.0,-110,-110,142,1.5,-169,4.28,PNC Park,7,1
2014-05-07,2014,ATL,STL,1,7,104,1.5,-170,6.5,-126,106,-114,-1.5,150,3.19,Turner Field,8,-6
2014-05-07,2014,BAL,TB,4,3,114,1.5,-200,8.0,100,-120,-124,-1.5,170,3.74,Tropicana Field,7,1
2014-05-07,2014,COL,TEX,9,2,113,1.5,-190,9.5,-110,-110,-123,-1.5,160,4.46,Rangers Ballpark,11,7
2014-05-07,2014,PHI,TOR,0,10,-102,1.5,-215,8.0,-110,-110,-108,-1.5,185,4.04,Rogers Centre,10,-10
2014-05-07,2014,LAD,WSH,2,3,125,1.5,-180,6.5,-120,100,-140,-1.5,160,2.89,Nationals Park,5,-1
2014-05-08,2014,TB,BAL,1,3,-173,-1.5,125,7.0,-125,105,153,1.5,-145,4.44,Tropicana Field,4,-2
2014-05-08,2014,CWS,CHC,5,12,-120,-1.5,170,9.0,-115,-105,110,1.5,-200,4.91,Guaranteed Rate Field,17,-7
2014-05-08,2014,MIN,CLE,4,9,150,1.5,-140,8.5,-118,-102,-170,-1.5,120,3.4,Progressive Field,13,-5
2014-05-08,2014,TEX,COL,5,0,-129,-1.5,155,9.0,100,-120,119,1.5,-175,5.07,Rangers Ballpark,5,5
2014-05-08,2014,CHC,CWS,12,5,110,1.5,-200,9.0,-115,-105,-120,-1.5,170,4.29,Guaranteed Rate Field,17,7
2014-05-08,2014,HOU,DET,6,2,171,1.5,-125,9.0,-110,-110,-191,-1.5,105,3.32,Comerica Park,8,4
2014-05-08,2014,DET,HOU,2,6,-191,-1.5,105,9.0,-110,-110,171,1.5,-125,5.91,Comerica Park,8,-4
2014-05-08,2014,SEA,KC,1,0,-122,-1.5,175,6.5,-125,105,112,1.5,-205,3.57,T-Mobile Park,1,1
2014-05-08,2014,SF,LAD,3,1,133,1.5,-172,7.0,-115,-105,-148,-1.5,151,3.0,Dodger Stadium,4,2
2014-05-08,2014,SD,MIA,1,3,-155,-1.5,145,7.0,110,-130,140,1.5,-165,4.25,PETCO Park,4,-2
2014-05-08,2014,CLE,MIN,9,4,-170,-1.5,120,8.5,-118,-102,150,1.5,-140,5.35,Progressive Field,13,5
2014-05-08,2014,TOR,PHI,12,6,-150,-1.5,145,9.0,-105,-115,135,1.5,-165,5.4,Rogers Centre,18,6
2014-05-08,2014,MIA,SD,3,1,140,1.5,-165,7.0,110,-130,-155,-1.5,145,2.92,PETCO Park,4,2
2014-05-08,2014,KC,SEA,0,1,112,1.5,-205,6.5,-125,105,-122,-1.5,175,3.07,T-Mobile Park,1,-1
2014-05-08,2014,LAD,SF,1,3,-148,-1.5,151,7.0,-115,-105,133,1.5,-172,4.18,Dodger Stadium,4,-2
2014-05-08,2014,BAL,TB,3,1,153,1.5,-145,7.0,-125,105,-173,-1.5,125,2.77,Tropicana Field,4,2
2014-05-08,2014,COL,TEX,0,5,119,1.5,-175,9.0,100,-120,-129,-1.5,155,4.11,Rangers Ballpark,5,-5
2014-05-08,2014,PHI,TOR,6,12,135,1.5,-165,9.0,-105,-115,-150,-1.5,145,3.83,Rogers Centre,18,-6
2014-05-09,2014,CWS,ARI,9,3,119,1.5,-145,9.0,-110,-110,-134,-1.5,125,4.11,Guaranteed Rate Field,12,6
2014-05-09,2014,CHC,ATL,2,3,157,1.5,-150,6.5,-120,100,-177,-1.5,130,2.53,Turner Field,5,-1
2014-05-09,2014,HOU,BAL,3,4,147,1.5,-150,8.5,100,-120,-162,-1.5,130,3.44,Camden Yards,7,-1
2014-05-09,2014,TEX,BOS,8,0,-165,-1.5,130,8.5,-116,-104,150,1.5,-150,5.29,Rangers Ballpark,8,8
2014-05-09,2014,ATL,CHC,3,2,-177,-1.5,130,6.5,-120,100,157,1.5,-150,4.15,Turner Field,5,1
2014-05-09,2014,COL,CIN,3,4,154,1.5,-150,7.0,-130,110,-169,-1.5,130,2.76,Great American Ballpark,7,-1
2014-05-09,2014,TB,CLE,3,6,-117,-1.5,180,7.5,-105,-115,107,1.5,-210,4.04,Tropicana Field,9,-3
2014-05-09,2014,CIN,COL,4,3,-169,-1.5,130,7.0,-130,110,154,1.5,-150,4.4,Great American Ballpark,7,1
2014-05-09,2014,ARI,CWS,3,9,-134,-1.5,125,9.0,-110,-110,119,1.5,-145,5.15,Guaranteed Rate Field,12,-6
2014-05-09,2014,MIN,DET,2,1,190,1.5,-120,8.5,-116,-104,-220,-1.5,100,2.93,Comerica Park,3,1
2014-05-09,2014,BAL,HOU,4,3,-162,-1.5,130,8.5,100,-120,147,1.5,-150,5.26,Camden Yards,7,1
2014-05-09,2014,SEA,KC,1,6,100,1.5,-170,7.0,-115,-105,-110,-1.5,150,3.5,T-Mobile Park,7,-5
2014-05-09,2014,TOR,LAA,3,4,101,1.5,-165,10.0,-105,-115,-111,-1.5,145,4.98,Rogers Centre,7,-1
2014-05-09,2014,SF,LAD,3,1,-131,-1.5,130,7.0,-105,-115,116,1.5,-150,3.97,Dodger Stadium,4,2
2014-05-09,2014,SD,MIA,10,1,125,1.5,-150,5.5,-120,100,-140,-1.5,130,2.44,PETCO Park,11,9
2014-05-09,2014,NYY,MIL,5,3,-130,-1.5,125,7.5,100,-120,115,1.5,-145,4.24,Miller Park,8,2
2014-05-09,2014,DET,MIN,1,2,-220,-1.5,100,8.5,-116,-104,190,1.5,-120,5.84,Comerica Park,3,-1
2014-05-09,2014,PHI,NYM,3,2,112,1.5,-205,7.0,100,-120,-122,-1.5,175,3.3,Citi Field,5,1
2014-05-09,2014,MIL,NYY,3,5,115,1.5,-145,7.5,100,-120,-130,-1.5,125,3.49,Miller Park,8,-2
2014-05-09,2014,WSH,OAK,0,8,118,1.5,-200,7.0,-125,105,-128,-1.5,170,3.21,Oakland Coliseum,8,-8
2014-05-09,2014,NYM,PHI,2,3,-122,-1.5,175,7.0,100,-120,112,1.5,-205,3.85,Citi Field,5,-1
2014-05-09,2014,STL,PIT,4,6,-119,-1.5,140,7.0,-115,-105,109,1.5,-160,3.8,PNC Park,10,-2
2014-05-09,2014,MIA,SD,1,10,-140,-1.5,130,5.5,-120,100,125,1.5,-150,3.21,PETCO Park,11,-9
2014-05-09,2014,KC,SEA,6,1,-110,-1.5,150,7.0,-115,-105,100,1.5,-170,3.67,T-Mobile Park,7,5
2014-05-09,2014,LAD,SF,1,3,116,1.5,-150,7.0,-105,-115,-131,-1.5,130,3.24,Dodger Stadium,4,-2
2014-05-09,2014,PIT,STL,6,4,109,1.5,-160,7.0,-115,-105,-119,-1.5,140,3.35,PNC Park,10,2
2014-05-09,2014,CLE,TB,6,3,107,1.5,-210,7.5,-105,-115,-117,-1.5,180,3.62,Tropicana Field,9,3
2014-05-09,2014,BOS,TEX,0,8,150,1.5,-150,8.5,-116,-104,-165,-1.5,130,3.4,Rangers Ballpark,8,-8
2014-05-09,2014,LAA,TOR,4,3,-111,-1.5,145,10.0,-105,-115,101,1.5,-165,5.26,Rogers Centre,7,1
2014-05-09,2014,OAK,WSH,8,0,-128,-1.5,170,7.0,-125,105,118,1.5,-200,3.93,Oakland Coliseum,8,8
2014-05-10,2014,CWS,ARI,3,4,-117,-1.5,160,8.5,-108,-112,107,1.5,-190,4.58,Guaranteed Rate Field,7,-1
2014-05-10,2014,CHC,ATL,0,2,148,1.5,-165,7.0,110,-130,-163,-1.5,145,2.82,Turner Field,2,-2
2014-05-10,2014,HOU,BAL,4,5,131,1.5,-155,8.5,-115,-105,-146,-1.5,135,3.68,Camden Yards,9,-1
2014-05-10,2014,TEX,BOS,3,8,119,1.5,-145,9.0,105,-125,-129,-1.5,125,4.11,Rangers Ballpark,11,-5
2014-05-10,2014,ATL,CHC,2,0,-163,-1.5,145,7.0,110,-130,148,1.5,-165,4.34,Turner Field,2,2
2014-05-10,2014,COL,CIN,11,2,105,1.5,-205,8.0,100,-120,-115,-1.5,175,3.9,Great American Ballpark,13,9
2014-05-10,2014,TB,CLE,7,1,-126,-1.5,170,8.0,100,-120,116,1.5,-200,4.46,Tropicana Field,8,6
2014-05-10,2014,CIN,COL,2,11,-115,-1.5,175,8.0,100,-120,105,1.5,-205,4.28,Great American Ballpark,13,-9
2014-05-10,2014,ARI,CWS,4,3,107,1.5,-190,8.5,-108,-112,-117,-1.5,160,4.11,Guaranteed Rate Field,7,1
2014-05-10,2014,MIN,DET,3,9,235,1.5,105,8.0,-110,-110,-275,-1.5,-125,2.39,Comerica Park,12,-6
2014-05-10,2014,BAL,HOU,5,4,-146,-1.5,135,8.5,-115,-105,131,1.5,-155,5.04,Camden Yards,9,1
2014-05-10,2014,SEA,KC,3,1,126,1.5,-145,6.5,-120,100,-141,-1.5,125,2.88,T-Mobile Park,4,2
2014-05-10,2014,TOR,LAA,3,5,-105,-1.5,180,10.0,105,-125,-105,1.5,-210,5.12,Rogers Centre,8,-2
2014-05-10,2014,SF,LAD,2,6,143,1.5,-165,7.0,105,-125,-158,-1.5,145,2.88,Dodger Stadium,8,-4
2014-05-10,2014,SD,MIA,9,3,103,1.5,-180,6.5,-105,-115,-113,-1.5,160,3.2,PETCO Park,12,6
2014-05-10,2014,NYY,MIL,4,5,112,1.5,-200,7.5,-110,-110,-122,-1.5,170,3.54,Miller Park,9,-1
2014-05-10,2014,DET,MIN,9,3,-275,-1.5,-125,8.0,-110,-110,235,1.5,105,5.87,Comerica Park,12,6
2014-05-10,2014,PHI,NYM,5,4,116,1.5,-195,7.0,-115,-105,-126,-1.5,165,3.24,Citi Field,9,1
2014-05-10,2014,MIL,NYY,5,4,-122,-1.5,170,7.5,-110,-110,112,1.5,-200,4.12,Miller Park,9,1
2014-05-10,2014,WSH,OAK,3,4,155,1.5,-150,7.0,105,-125,-175,-1.5,130,2.75,Oakland Coliseum,7,-1
2014-05-10,2014,NYM,PHI,4,5,-126,-1.5,165,7.0,-115,-105,116,1.5,-195,3.9,Citi Field,9,-1
2014-05-10,2014,STL,PIT,3,4,-122,-1.5,140,7.0,-125,105,112,1.5,-160,3.85,PNC Park,7,-1
2014-05-10,2014,MIA,SD,3,9,-113,-1.5,160,6.5,-105,-115,103,1.5,-180,3.45,PETCO Park,12,-6
2014-05-10,2014,KC,SEA,1,3,-141,-1.5,125,6.5,-120,100,126,1.5,-145,3.8,T-Mobile Park,4,-2
2014-05-10,2014,LAD,SF,6,2,-158,-1.5,145,7.0,105,-125,143,1.5,-165,4.29,Dodger Stadium,8,4
2014-05-10,2014,PIT,STL,4,3,112,1.5,-160,7.0,-125,105,-122,-1.5,140,3.3,PNC Park,7,1
2014-05-10,2014,CLE,TB,1,7,116,1.5,-200,8.0,100,-120,-126,-1.5,170,3.7,Tropicana Field,8,-6
2014-05-10,2014,BOS,TEX,8,3,-129,-1.5,125,9.0,105,-125,119,1.5,-145,5.07,Rangers Ballpark,11,5
2014-05-10,2014,LAA,TOR,5,3,-105,1.5,-210,10.0,105,-125,-105,-1.5,180,5.12,Rogers Centre,8,2
2014-05-10,2014,OAK,WSH,4,3,-175,-1.5,130,7.0,105,-125,155,1.5,-150,4.45,Oakland Coliseum,7,1
2014-05-11,2014,CWS,ARI,1,5,-104,1.5,-170,9.0,-120,100,-106,-1.5,150,4.59,Guaranteed Rate Field,6,-4
2014-05-11,2014,CHC,ATL,2,5,135,1.5,-165,7.0,-120,100,-150,-1.5,145,2.98,Turner Field,7,-3
2014-05-11,2014,HOU,BAL,5,2,163,1.5,-140,8.5,-115,-105,-183,-1.5,120,3.23,Camden Yards,7,3
2014-05-11,2014,TEX,BOS,2,5,-102,1.5,-160,9.5,100,-120,-108,-1.5,140,4.8,Rangers Ballpark,7,-3
2014-05-11,2014,ATL,CHC,5,2,-150,-1.5,145,7.0,-120,100,135,1.5,-165,4.2,Turner Field,7,3
2014-05-11,2014,COL,CIN,1,4,118,1.5,-195,7.5,-110,-110,-128,-1.5,165,3.44,Great American Ballpark,5,-3
2014-05-11,2014,TB,CLE,5,6,-140,-1.5,160,7.5,-105,-115,125,1.5,-180,4.38,Tropicana Field,11,-1
2014-05-11,2014,CIN,COL,4,1,-128,-1.5,165,7.5,-110,-110,118,1.5,-195,4.21,Great American Ballpark,5,3
2014-05-11,2014,ARI,CWS,5,1,-106,-1.5,150,9.0,-120,100,-104,1.5,-170,4.63,Guaranteed Rate Field,6,4
2014-05-11,2014,MIN,DET,4,3,140,1.5,-155,9.5,-105,-115,-155,-1.5,135,3.96,Comerica Park,7,1
2014-05-11,2014,BAL,HOU,2,5,-183,-1.5,120,8.5,-115,-105,163,1.5,-140,5.5,Camden Yards,7,-3
2014-05-11,2014,SEA,KC,7,9,-140,-1.5,160,7.0,105,-125,125,1.5,-190,4.08,T-Mobile Park,16,-2
2014-05-11,2014,TOR,LAA,3,9,-128,-1.5,165,9.0,-115,-105,118,1.5,-185,5.05,Rogers Centre,12,-6
2014-05-11,2014,SF,LAD,7,4,153,1.5,-150,6.0,-120,100,-173,-1.5,130,2.37,Dodger Stadium,11,3
2014-05-11,2014,SD,MIA,5,4,-127,-1.5,180,7.0,105,-125,117,1.5,-210,3.92,PETCO Park,9,1
2014-05-11,2014,NYY,MIL,5,6,-102,1.5,-215,7.5,100,-120,-108,-1.5,185,3.79,Miller Park,11,-1
2014-05-11,2014,DET,MIN,3,4,-155,-1.5,135,9.5,-105,-115,140,1.5,-155,5.77,Comerica Park,7,-1
2014-05-11,2014,PHI,NYM,4,5,116,1.5,-210,6.5,-110,-110,-126,-1.5,180,3.01,Citi Field,9,-1
2014-05-11,2014,MIL,NYY,6,5,-108,-1.5,185,7.5,100,-120,-102,1.5,-215,3.89,Miller Park,11,1
2014-05-11,2014,WSH,OAK,1,9,125,1.5,-190,7.0,-125,105,-140,-1.5,160,3.11,Oakland Coliseum,10,-8
2014-05-11,2014,NYM,PHI,5,4,-126,-1.5,180,6.5,-110,-110,116,1.5,-210,3.62,Citi Field,9,1
2014-05-11,2014,STL,PIT,6,5,-115,-1.5,140,7.5,-110,-110,105,1.5,-160,4.01,PNC Park,11,1
2014-05-11,2014,MIA,SD,4,5,117,1.5,-210,7.0,105,-125,-127,-1.5,180,3.23,PETCO Park,9,-1
2014-05-11,2014,KC,SEA,9,7,125,1.5,-190,7.0,105,-125,-140,-1.5,160,3.11,T-Mobile Park,16,2
2014-05-11,2014,LAD,SF,4,7,-173,-1.5,130,6.0,-120,100,153,1.5,-150,3.8,Dodger Stadium,11,-3
2014-05-11,2014,PIT,STL,5,6,105,1.5,-160,7.5,-110,-110,-115,-1.5,140,3.66,PNC Park,11,-1
2014-05-11,2014,CLE,TB,6,5,125,1.5,-180,7.5,-105,-115,-140,-1.5,160,3.33,Tropicana Field,11,1
2014-05-11,2014,BOS,TEX,5,2,-108,-1.5,140,9.5,100,-120,-102,1.5,-160,4.93,Rangers Ballpark,7,3
2014-05-11,2014,LAA,TOR,9,3,118,1.5,-185,9.0,-115,-105,-128,-1.5,165,4.13,Rogers Centre,12,6
2014-05-11,2014,OAK,WSH,9,1,-140,-1.5,160,7.0,-125,105,125,1.5,-190,4.08,Oakland Coliseum,10,8
2014-05-12,2014,WSH,ARI,6,5,-117,-1.5,145,8.0,-105,-115,107,1.5,-165,4.31,Chase Field,11,1
2014-05-12,2014,SF,ATL,4,2,-105,1.5,-180,7.0,-105,-115,-105,-1.5,160,3.59,AT&T Park,6,2
2014-05-12,2014,DET,BAL,4,1,-105,1.5,-215,9.0,105,-125,-105,-1.5,185,4.61,Camden Yards,5,3
2014-05-12,2014,STL,CHC,5,17,-173,-1.5,130,7.5,-120,100,153,1.5,-150,4.75,Busch Stadium,22,-12
2014-05-12,2014,OAK,CWS,5,4,-210,-1.5,-101,8.0,-115,-105,180,1.5,-119,5.42,Oakland Coliseum,9,1
2014-05-12,2014,BAL,DET,1,4,-105,-1.5,185,9.0,105,-125,-105,1.5,-215,4.61,Camden Yards,5,-3
2014-05-12,2014,TEX,HOU,4,0,-140,-1.5,120,9.0,-120,100,125,1.5,-140,5.25,Minute Maid Park,4,4
2014-05-12,2014,TOR,LAA,7,3,-113,-1.5,175,9.0,-125,105,103,1.5,-205,4.77,Rogers Centre,10,4
2014-05-12,2014,MIA,LAD,5,6,130,1.5,-175,7.0,-142,122,-145,-1.5,155,3.04,Dodger Stadium,11,-1
2014-05-12,2014,LAD,MIA,6,5,-145,-1.5,155,7.0,-142,122,130,1.5,-175,4.14,Dodger Stadium,11,1
2014-05-12,2014,NYY,NYM,7,9,-173,-1.5,125,8.5,-123,103,153,1.5,-145,5.39,Yankee Stadium,16,-2
2014-05-12,2014,NYM,NYY,9,7,153,1.5,-145,8.5,-123,103,-173,-1.5,125,3.36,Yankee Stadium,16,2
2014-05-12,2014,CWS,OAK,4,5,180,1.5,-119,8.0,-115,-105,-210,-1.5,-101,2.86,Oakland Coliseum,9,-1
2014-05-12,2014,TB,SEA,5,12,141,1.5,-160,7.0,105,-125,-156,-1.5,140,2.9,T-Mobile Park,17,-7
2014-05-12,2014,ATL,SF,2,4,-105,-1.5,160,7.0,-105,-115,-105,1.5,-180,3.59,AT&T Park,6,-2
2014-05-12,2014,CHC,STL,17,5,153,1.5,-150,7.5,-120,100,-173,-1.5,130,2.96,Busch Stadium,22,12
2014-05-12,2014,SEA,TB,12,5,-156,-1.5,140,7.0,105,-125,141,1.5,-160,4.27,T-Mobile Park,17,7
2014-05-12,2014,HOU,TEX,0,4,125,1.5,-140,9.0,-120,100,-140,-1.5,120,4.0,Minute Maid Park,4,-4
2014-05-12,2014,LAA,TOR,3,7,103,1.5,-205,9.0,-125,105,-113,-1.5,175,4.43,Rogers Centre,10,-4
2014-05-12,2014,ARI,WSH,5,6,107,1.5,-165,8.0,-105,-115,-117,-1.5,145,3.86,Chase Field,11,-1
2014-05-13,2014,WSH,ARI,1,3,-134,-1.5,125,8.0,100,-120,119,1.5,-145,4.58,Chase Field,4,-2
2014-05-13,2014,SF,ATL,0,5,100,1.5,-180,7.0,-120,100,-110,-1.5,160,3.5,AT&T Park,5,-5
2014-05-13,2014,DET,BAL,4,1,-108,-1.5,150,9.0,105,-125,-102,1.5,-170,4.67,Camden Yards,5,3
2014-05-13,2014,MIN,BOS,8,6,119,1.5,-150,7.5,-110,-110,-134,-1.5,130,3.42,Target Field,14,2
2014-05-13,2014,STL,CHC,4,3,-230,-1.5,-110,6.5,-125,105,200,1.5,-110,4.53,Busch Stadium,7,1
2014-05-13,2014,SD,CIN,2,1,102,1.5,-215,7.0,-120,100,-112,-1.5,185,3.47,Great American Ballpark,3,1
2014-05-13,2014,TOR,CLE,5,4,-133,-1.5,160,9.0,-110,-110,118,1.5,-190,5.14,Rogers Centre,9,1
2014-05-13,2014,KC,COL,5,1,-150,-1.5,150,7.0,-120,100,135,1.5,-170,4.2,Kauffman Stadium,6,4
2014-05-13,2014,OAK,CWS,11,0,-195,-1.5,110,8.5,-120,100,175,1.5,-130,5.62,Oakland Coliseum,11,11
2014-05-13,2014,BAL,DET,1,4,-102,1.5,-170,9.0,105,-125,-108,-1.5,150,4.54,Camden Yards,5,-3
2014-05-13,2014,TEX,HOU,0,8,-114,-1.5,145,8.0,-115,-105,104,1.5,-165,4.26,Minute Maid Park,8,-8
2014-05-13,2014,COL,KC,1,5,135,1.5,-170,7.0,-120,100,-150,-1.5,150,2.98,Kauffman Stadium,6,-4
2014-05-13,2014,PHI,LAA,3,4,-180,-1.5,125,7.5,-110,-110,160,1.5,-145,4.82,Citizens Bank Park,7,-1
2014-05-13,2014,MIA,LAD,1,7,145,1.5,-160,8.0,-105,-115,-160,-1.5,140,3.27,Dodger Stadium,8,-6
2014-05-13,2014,LAD,MIA,7,1,-160,-1.5,140,8.0,-105,-115,145,1.5,-160,4.92,Dodger Stadium,8,6
2014-05-13,2014,PIT,MIL,2,5,103,1.5,-220,7.5,100,-120,-113,-1.5,190,3.69,Miller Park,7,-3
2014-05-13,2014,BOS,MIN,6,8,-134,-1.5,130,7.5,-110,-110,119,1.5,-150,4.29,Target Field,14,-2
2014-05-13,2014,NYY,NYM,7,12,-141,-1.5,155,8.5,-113,-107,126,1.5,-175,4.97,Yankee Stadium,19,-5
2014-05-13,2014,NYM,NYY,12,7,126,1.5,-175,8.5,-113,-107,-141,-1.5,155,3.76,Yankee Stadium,19,5
2014-05-13,2014,CWS,OAK,0,11,175,1.5,-130,8.5,-120,100,-195,-1.5,110,3.09,Oakland Coliseum,11,-11
2014-05-13,2014,LAA,PHI,4,3,160,1.5,-145,7.5,-110,-110,-180,-1.5,125,2.88,Citizens Bank Park,7,1
2014-05-13,2014,MIL,PIT,5,2,-113,-1.5,190,7.5,100,-120,103,1.5,-220,3.98,Miller Park,7,3
2014-05-13,2014,CIN,SD,1,2,-112,-1.5,185,7.0,-120,100,102,1.5,-215,3.7,Great American Ballpark,3,-1
2014-05-13,2014,TB,SEA,2,1,-122,-1.5,140,6.5,-115,-105,112,1.5,-160,3.57,T-Mobile Park,3,1
2014-05-13,2014,ATL,SF,5,0,-110,-1.5,160,7.0,-120,100,100,1.5,-180,3.67,AT&T Park,5,5
2014-05-13,2014,CHC,STL,3,4,200,1.5,-110,6.5,-125,105,-230,-1.5,-110,2.17,Busch Stadium,7,-1
2014-05-13,2014,SEA,TB,1,2,112,1.5,-160,6.5,-115,-105,-122,-1.5,140,3.07,T-Mobile Park,3,-1
2014-05-13,2014,HOU,TEX,8,0,104,1.5,-165,8.0,-115,-105,-114,-1.5,145,3.92,Minute Maid Park,8,8
2014-05-13,2014,CLE,TOR,4,5,118,1.5,-190,9.0,-110,-110,-133,-1.5,160,4.13,Rogers Centre,9,-1
2014-05-13,2014,ARI,WSH,3,1,119,1.5,-145,8.0,100,-120,-134,-1.5,125,3.65,Chase Field,4,2
2014-05-14,2014,WSH,ARI,5,1,111,1.5,-205,7.5,-105,-115,-121,-1.5,175,3.55,Chase Field,6,4
2014-05-14,2014,SF,ATL,10,4,-133,-1.5,175,7.0,105,-125,118,1.5,-205,4.0,AT&T Park,14,6
2014-05-14,2014,DET,BAL,7,5,-113,-1.5,140,7.5,-110,-110,103,1.5,-160,3.98,Camden Yards,12,2
2014-05-14,2014,MIN,BOS,4,9,117,1.5,-145,8.5,100,-120,-127,-1.5,126,3.92,Target Field,13,-5
2014-05-14,2014,TOR,CLE,4,15,-108,-1.5,180,9.0,-125,105,-102,1.5,-210,4.67,Rogers Centre,19,-11
2014-05-14,2014,KC,COL,3,2,-130,-1.5,160,7.5,105,-125,115,1.5,-190,4.24,Kauffman Stadium,5,1
2014-05-14,2014,OAK,CWS,2,4,-200,-1.5,100,9.0,-105,-115,170,1.5,-120,6.0,Oakland Coliseum,6,-2
2014-05-14,2014,BAL,DET,5,7,103,1.5,-160,7.5,-110,-110,-113,-1.5,140,3.69,Camden Yards,12,-2
2014-05-14,2014,TEX,HOU,4,5,-116,-1.5,140,8.5,-105,-115,106,1.5,-160,4.56,Minute Maid Park,9,-1
2014-05-14,2014,COL,KC,2,3,115,1.5,-190,7.5,105,-125,-130,-1.5,160,3.49,Kauffman Stadium,5,-1
2014-05-14,2014,PHI,LAA,0,3,-101,1.5,-165,7.5,-110,-110,-109,-1.5,145,3.77,Citizens Bank Park,3,-3
2014-05-14,2014,MIA,LAD,13,3,142,1.5,-165,8.5,100,-120,-157,-1.5,145,3.51,Dodger Stadium,16,10
2014-05-14,2014,LAD,MIA,3,13,-157,-1.5,145,8.5,100,-120,142,1.5,-165,5.19,Dodger Stadium,16,-10
2014-05-14,2014,PIT,MIL,4,1,107,1.5,-205,7.5,-105,-115,-117,-1.5,175,3.62,Miller Park,5,3
2014-05-14,2014,BOS,MIN,9,4,-127,-1.5,126,8.5,100,-120,117,1.5,-145,4.76,Target Field,13,5
2014-05-14,2014,NYY,NYM,4,0,-155,-1.5,115,6.5,105,-125,140,1.5,-135,3.95,Citi Field,4,4
2014-05-14,2014,NYM,NYY,0,4,140,1.5,-135,6.5,105,-125,-155,-1.5,115,2.71,Citi Field,4,-4
2014-05-14,2014,CWS,OAK,4,2,170,1.5,-120,9.0,-105,-115,-200,-1.5,100,3.33,Oakland Coliseum,6,2
2014-05-14,2014,LAA,PHI,3,0,-109,-1.5,145,7.5,-110,-110,-101,1.5,-165,3.91,Citizens Bank Park,3,3
2014-05-14,2014,MIL,PIT,1,4,-117,-1.5,175,7.5,-105,-115,107,1.5,-205,4.04,Miller Park,5,-3
2014-05-14,2014,TB,SEA,2,0,-117,-1.5,145,8.0,-110,-110,107,1.5,-165,4.31,T-Mobile Park,2,2
2014-05-14,2014,ATL,SF,4,10,118,1.5,-205,7.0,105,-125,-133,-1.5,175,3.21,AT&T Park,14,-6
2014-05-14,2014,SEA,TB,0,2,107,1.5,-165,8.0,-110,-110,-117,-1.5,145,3.86,T-Mobile Park,2,-2
2014-05-14,2014,HOU,TEX,5,4,106,1.5,-160,8.5,-105,-115,-116,-1.5,140,4.13,Minute Maid Park,9,1
2014-05-14,2014,CLE,TOR,15,4,-102,1.5,-210,9.0,-125,105,-108,-1.5,180,4.54,Rogers Centre,19,11
2014-05-14,2014,ARI,WSH,1,5,-121,-1.5,175,7.5,-105,-115,111,1.5,-205,4.11,Chase Field,6,-4
2014-05-15,2014,KC,BAL,1,2,-140,-1.5,160,7.0,105,-125,125,1.5,-190,4.08,Kauffman Stadium,3,-1
2014-05-15,2014,MIN,BOS,4,3,111,1.5,-155,7.5,-110,-110,-121,-1.5,135,3.55,Target Field,7,1
2014-05-15,2014,STL,CHC,5,3,-195,-1.5,120,6.5,-110,-110,175,1.5,-140,4.3,Busch Stadium,8,2
2014-05-15,2014,SD,CIN,0,5,125,1.5,-180,6.5,-110,-110,-140,-1.5,160,2.89,Great American Ballpark,5,-5
2014-05-15,2014,SD,CIN,6,1,-115,-1.5,140,7.0,-125,105,105,1.5,-160,3.74,Great American Ballpark,7,5
2014-05-15,2014,TOR,CLE,4,2,-105,-1.5,185,9.5,-105,-115,-105,1.5,-215,4.87,Rogers Centre,6,2
2014-05-15,2014,BAL,KC,2,1,125,1.5,-190,7.0,105,-125,-140,-1.5,160,3.11,Kauffman Stadium,3,1
2014-05-15,2014,TB,LAA,5,6,131,1.5,-170,9.0,-105,-115,-146,-1.5,150,3.9,Angel Stadium,11,-1
2014-05-15,2014,SF,MIA,6,4,-146,-1.5,160,7.0,104,-124,131,1.5,-190,4.15,AT&T Park,10,2
2014-05-15,2014,PIT,MIL,3,4,137,1.5,-160,8.0,-120,100,-152,-1.5,140,3.38,Miller Park,7,-1
2014-05-15,2014,BOS,MIN,3,4,-121,-1.5,135,7.5,-110,-110,111,1.5,-155,4.11,Target Field,7,-1
2014-05-15,2014,NYY,NYM,1,0,-114,-1.5,145,7.0,-120,100,104,1.5,-165,3.73,Citi Field,1,1
2014-05-15,2014,NYM,NYY,0,1,104,1.5,-165,7.0,-120,100,-114,-1.5,145,3.43,Citi Field,1,-1
2014-05-15,2014,MIL,PIT,4,3,-152,-1.5,140,8.0,-120,100,137,1.5,-160,4.83,Miller Park,7,1
2014-05-15,2014,CIN,SD,5,0,-140,-1.5,160,6.5,-110,-110,125,1.5,-180,3.79,Great American Ballpark,5,5
2014-05-15,2014,CIN,SD,1,6,105,1.5,-160,7.0,-125,105,-115,-1.5,140,3.41,Great American Ballpark,7,-5
2014-05-15,2014,MIA,SF,4,6,131,1.5,-190,7.0,104,-124,-146,-1.5,160,3.03,AT&T Park,10,-2
2014-05-15,2014,CHC,STL,3,5,175,1.5,-140,6.5,-110,-110,-195,-1.5,120,2.36,Busch Stadium,8,-2
2014-05-15,2014,LAA,TB,6,5,-146,-1.5,150,9.0,-105,-115,131,1.5,-170,5.34,Angel Stadium,11,1
2014-05-15,2014,CLE,TOR,2,4,-105,1.5,-215,9.5,-105,-115,-105,-1.5,185,4.87,Rogers Centre,6,-2
2014-05-16,2014,LAD,ARI,7,0,-146,-1.5,110,8.5,-120,100,131,1.5,-130,5.04,Chase Field,7,7
2014-05-16,2014,STL,ATL,5,2,-110,-1.5,185,6.5,-110,-110,100,1.5,-215,3.4,Busch Stadium,7,3
2014-05-16,2014,KC,BAL,0,4,-101,1.5,-170,7.0,-125,105,-109,-1.5,150,3.52,Kauffman Stadium,4,-4
2014-05-16,2014,DET,BOS,1,0,-105,-1.5,150,8.0,-115,-105,-105,1.5,-170,4.1,Fenway Park,1,1
2014-05-16,2014,MIL,CHC,4,3,116,1.5,-210,6.5,-110,-110,-126,-1.5,180,3.01,Wrigley Field,7,1
2014-05-16,2014,PHI,CIN,0,3,-133,-1.5,160,8.0,100,-120,118,1.5,-190,4.57,Citizens Bank Park,3,-3
2014-05-16,2014,OAK,CLE,11,1,-134,-1.5,120,7.5,105,-125,119,1.5,-140,4.29,Progressive Field,12,10
2014-05-16,2014,SD,COL,1,3,145,1.5,-145,9.5,-105,-115,-160,-1.5,125,3.88,Coors Field,4,-2
2014-05-16,2014,HOU,CWS,2,7,-106,-1.5,190,8.0,-120,100,-104,1.5,-220,4.12,Minute Maid Park,9,-5
2014-05-16,2014,BOS,DET,0,1,-105,1.5,-170,8.0,-115,-105,-105,-1.5,150,4.1,Fenway Park,1,-1
2014-05-16,2014,CWS,HOU,7,2,-104,1.5,-220,8.0,-120,100,-106,-1.5,190,4.08,Minute Maid Park,9,5
2014-05-16,2014,BAL,KC,4,0,-109,-1.5,150,7.0,-125,105,-101,1.5,-170,3.65,Kauffman Stadium,4,4
2014-05-16,2014,TB,LAA,3,0,126,1.5,-175,8.5,100,-120,-141,-1.5,155,3.76,Angel Stadium,3,3
2014-05-16,2014,ARI,LAD,0,7,131,1.5,-130,8.5,-120,100,-146,-1.5,110,3.68,Chase Field,7,-7
2014-05-16,2014,SF,MIA,5,7,-143,-1.5,160,7.0,-125,105,128,1.5,-190,4.12,AT&T Park,12,-2
2014-05-16,2014,CHC,MIL,3,4,-126,-1.5,180,6.5,-110,-110,116,1.5,-210,3.62,Wrigley Field,7,-1
2014-05-16,2014,SEA,MIN,4,5,-102,1.5,-210,8.5,-120,100,-108,-1.5,180,4.29,Target Field,9,-1
2014-05-16,2014,WSH,NYM,5,2,-146,-1.5,160,7.5,-110,-110,131,1.5,-190,4.45,Nationals Park,7,3
2014-05-16,2014,CLE,OAK,1,11,119,1.5,-140,7.5,105,-125,-134,-1.5,120,3.42,Progressive Field,12,-10
2014-05-16,2014,CIN,PHI,3,0,118,1.5,-190,8.0,100,-120,-133,-1.5,160,3.67,Citizens Bank Park,3,3
2014-05-16,2014,COL,SD,3,1,-160,-1.5,125,9.5,-105,-115,145,1.5,-145,5.85,Coors Field,4,2
2014-05-16,2014,MIN,SEA,5,4,-108,-1.5,180,8.5,-120,100,-102,1.5,-210,4.41,Target Field,9,1
2014-05-16,2014,MIA,SF,7,5,128,1.5,-190,7.0,-125,105,-143,-1.5,160,3.07,AT&T Park,12,2
2014-05-16,2014,ATL,STL,2,5,100,1.5,-215,6.5,-110,-110,-110,-1.5,185,3.25,Busch Stadium,7,-3
2014-05-16,2014,LAA,TB,0,3,-141,-1.5,155,8.5,100,-120,126,1.5,-175,4.97,Angel Stadium,3,-3
2014-05-16,2014,TOR,TEX,2,0,151,1.5,-140,8.5,-115,-105,-171,-1.5,120,3.39,Rangers Ballpark,2,2
2014-05-16,2014,TEX,TOR,0,2,-171,-1.5,120,8.5,-115,-105,151,1.5,-140,5.36,Rangers Ballpark,2,-2
2014-05-16,2014,NYM,WSH,2,5,131,1.5,-190,7.5,-110,-110,-146,-1.5,160,3.25,Nationals Park,7,-3
2014-05-17,2014,LAD,ARI,7,18,-179,-1.5,-110,8.0,100,-120,159,1.5,-110,5.13,Chase Field,25,-11
2014-05-17,2014,STL,ATL,4,1,-123,-1.5,180,7.0,-105,-115,113,1.5,-210,3.86,Busch Stadium,5,3
2014-05-17,2014,KC,BAL,1,0,-126,-1.5,175,7.0,-110,-110,116,1.5,-205,3.9,Kauffman Stadium,1,1
2014-05-17,2014,DET,BOS,6,1,125,1.5,-165,9.0,100,-120,-140,-1.5,145,4.0,Fenway Park,7,5
2014-05-17,2014,MIL,CHC,0,3,-117,-1.5,145,7.5,-105,-115,107,1.5,-165,4.04,Wrigley Field,3,-3
2014-05-17,2014,PHI,CIN,12,1,-144,-1.5,160,7.0,105,-125,129,1.5,-190,4.13,Citizens Bank Park,13,11
2014-05-17,2014,OAK,CLE,6,2,-141,-1.5,115,7.5,100,-120,126,1.5,-135,4.39,Progressive Field,8,4
2014-05-17,2014,SD,COL,8,5,119,1.5,-175,9.5,-110,-110,-129,-1.5,155,4.34,Coors Field,13,3
2014-05-17,2014,HOU,CWS,6,5,-116,-1.5,175,9.0,-110,-110,106,1.5,-205,4.83,Minute Maid Park,11,1
2014-05-17,2014,BOS,DET,1,6,-140,-1.5,145,9.0,100,-120,125,1.5,-165,5.25,Fenway Park,7,-5
2014-05-17,2014,CWS,HOU,5,6,106,1.5,-205,9.0,-110,-110,-116,-1.5,175,4.37,Minute Maid Park,11,-1
2014-05-17,2014,BAL,KC,0,1,116,1.5,-205,7.0,-110,-110,-126,-1.5,175,3.24,Kauffman Stadium,1,-1
2014-05-17,2014,TB,LAA,0,6,151,1.5,-145,8.5,-110,-110,-171,-1.5,125,3.39,Angel Stadium,6,-6
2014-05-17,2014,ARI,LAD,18,7,159,1.5,-110,8.0,100,-120,-179,-1.5,-110,3.09,Chase Field,25,11
2014-05-17,2014,SF,MIA,0,5,-145,-1.5,150,7.5,105,-125,130,1.5,-170,4.44,AT&T Park,5,-5
2014-05-17,2014,CHC,MIL,3,0,107,1.5,-165,7.5,-105,-115,-117,-1.5,145,3.62,Wrigley Field,3,3
2014-05-17,2014,SEA,MIN,3,4,-110,-1.5,150,8.5,-105,-115,100,1.5,-170,4.45,Target Field,7,-1
2014-05-17,2014,WSH,NYM,2,5,-152,-1.5,140,7.0,105,-125,137,1.5,-160,4.22,Nationals Park,7,-3
2014-05-17,2014,PIT,NYY,1,7,125,1.5,-175,9.0,-110,-110,-140,-1.5,155,4.0,Yankee Stadium,8,-6
2014-05-17,2014,CLE,OAK,2,6,126,1.5,-135,7.5,100,-120,-141,-1.5,115,3.32,Progressive Field,8,-4
2014-05-17,2014,CIN,PHI,1,12,129,1.5,-190,7.0,105,-125,-144,-1.5,160,3.06,Citizens Bank Park,13,-11
2014-05-17,2014,NYY,PIT,7,1,-140,-1.5,155,9.0,-110,-110,125,1.5,-175,5.25,Yankee Stadium,8,6
2014-05-17,2014,COL,SD,5,8,-129,-1.5,155,9.5,-110,-110,119,1.5,-175,5.35,Coors Field,13,-3
2014-05-17,2014,MIN,SEA,4,3,100,1.5,-170,8.5,-105,-115,-110,-1.5,150,4.25,Target Field,7,1
2014-05-17,2014,MIA,SF,5,0,130,1.5,-170,7.5,105,-125,-145,-1.5,150,3.26,AT&T Park,5,5
2014-05-17,2014,ATL,STL,1,4,113,1.5,-210,7.0,-105,-115,-123,-1.5,180,3.29,Busch Stadium,5,-3
2014-05-17,2014,LAA,TB,6,0,-171,-1.5,125,8.5,-110,-110,151,1.5,-145,5.36,Angel Stadium,6,6
2014-05-17,2014,TOR,TEX,4,2,-105,1.5,-210,9.0,-105,-115,-105,-1.5,180,4.61,Rangers Ballpark,6,2
2014-05-17,2014,TEX,TOR,2,4,-105,-1.5,180,9.0,-105,-115,-105,1.5,-210,4.61,Rangers Ballpark,6,-2
2014-05-17,2014,NYM,WSH,5,2,137,1.5,-160,7.0,105,-125,-152,-1.5,140,2.95,Nationals Park,7,3
2014-05-18,2014,LAD,ARI,3,5,-111,-1.5,140,9.0,105,-125,101,1.5,-160,4.73,Chase Field,8,-2
2014-05-18,2014,STL,ATL,5,6,-110,-1.5,190,7.0,102,-122,100,1.5,-220,3.67,Busch Stadium,11,-1
2014-05-18,2014,KC,BAL,8,6,-147,-1.5,155,7.0,105,-125,132,1.5,-175,4.17,Kauffman Stadium,14,2
2014-05-18,2014,DET,BOS,6,2,107,1.5,-200,8.5,-110,-110,-117,-1.5,170,4.11,Fenway Park,8,4
2014-05-18,2014,MIL,CHC,2,4,-119,-1.5,140,9.0,-110,-110,109,1.5,-160,4.89,Wrigley Field,6,-2
2014-05-18,2014,PHI,CIN,8,3,-140,-1.5,170,6.5,100,-120,125,1.5,-200,3.79,Citizens Bank Park,11,5
2014-05-18,2014,OAK,CLE,13,3,-115,-1.5,135,7.0,-125,105,105,1.5,-155,3.74,Progressive Field,16,10
2014-05-18,2014,SD,COL,6,8,160,1.5,-135,10.5,-120,100,-180,-1.5,115,4.04,Coors Field,14,-2
2014-05-18,2014,HOU,CWS,8,2,-127,-1.5,165,9.5,100,-120,117,1.5,-195,5.31,Minute Maid Park,10,6
2014-05-18,2014,BOS,DET,2,6,-117,-1.5,170,8.5,-110,-110,107,1.5,-200,4.58,Fenway Park,8,-4
2014-05-18,2014,CWS,HOU,2,8,117,1.5,-195,9.5,100,-120,-127,-1.5,165,4.38,Minute Maid Park,10,-6
2014-05-18,2014,BAL,KC,6,8,132,1.5,-175,7.0,105,-125,-147,-1.5,155,3.02,Kauffman Stadium,14,-2
2014-05-18,2014,TB,LAA,2,6,-124,-1.5,135,7.5,-120,100,114,1.5,-155,4.15,Angel Stadium,8,-4
2014-05-18,2014,ARI,LAD,5,3,101,1.5,-160,9.0,105,-125,-111,-1.5,140,4.48,Chase Field,8,2
2014-05-18,2014,SF,MIA,4,1,-165,-1.5,130,7.5,102,-122,150,1.5,-150,4.67,AT&T Park,5,3
2014-05-18,2014,CHC,MIL,4,2,109,1.5,-160,9.0,-110,-110,-119,-1.5,140,4.31,Wrigley Field,6,2
2014-05-18,2014,SEA,MIN,6,2,-157,-1.5,100,7.5,-115,-105,142,1.5,-120,4.58,Target Field,8,4
2014-05-18,2014,WSH,NYM,6,3,-170,-1.5,135,6.5,-123,103,150,1.5,-155,4.09,Nationals Park,9,3
2014-05-18,2014,PIT,NYY,3,4,142,1.5,-155,8.5,-118,-102,-157,-1.5,135,3.51,Yankee Stadium,7,-1
2014-05-18,2014,PIT,NYY,5,3,-127,-1.5,130,9.0,105,-125,117,1.5,-150,5.04,Yankee Stadium,8,2
2014-05-18,2014,CLE,OAK,3,13,105,1.5,-155,7.0,-125,105,-115,-1.5,135,3.41,Progressive Field,16,-10
2014-05-18,2014,CIN,PHI,3,8,125,1.5,-200,6.5,100,-120,-140,-1.5,170,2.89,Citizens Bank Park,11,-5
2014-05-18,2014,NYY,PIT,4,3,-157,-1.5,135,8.5,-118,-102,142,1.5,-155,5.19,Yankee Stadium,7,1
2014-05-18,2014,NYY,PIT,3,5,117,1.5,-150,9.0,105,-125,-127,-1.5,130,4.15,Yankee Stadium,8,-2
2014-05-18,2014,COL,SD,8,6,-180,-1.5,115,10.5,-120,100,160,1.5,-135,6.75,Coors Field,14,2
2014-05-18,2014,MIN,SEA,2,6,142,1.5,-120,7.5,-115,-105,-157,-1.5,100,3.1,Target Field,8,-4
2014-05-18,2014,MIA,SF,1,4,150,1.5,-150,7.5,102,-122,-165,-1.5,130,3.0,AT&T Park,5,-3
2014-05-18,2014,ATL,STL,6,5,100,1.5,-220,7.0,102,-122,-110,-1.5,190,3.5,Busch Stadium,11,1
2014-05-18,2014,LAA,TB,6,2,114,1.5,-155,7.5,-120,100,-124,-1.5,135,3.5,Angel Stadium,8,4
2014-05-18,2014,TOR,TEX,2,6,-121,-1.5,135,9.0,-125,105,111,1.5,-155,4.93,Rangers Ballpark,8,-4
2014-05-18,2014,TEX,TOR,6,2,111,1.5,-155,9.0,-125,105,-121,-1.5,135,4.27,Rangers Ballpark,8,4
2014-05-18,2014,NYM,WSH,3,6,150,1.5,-155,6.5,-123,103,-170,-1.5,135,2.6,Nationals Park,9,-3
2014-05-19,2014,MIL,ATL,3,9,109,1.5,-210,7.0,105,-125,-119,-1.5,180,3.35,Turner Field,12,-6
2014-05-19,2014,WSH,CIN,3,4,-175,-1.5,125,6.5,-103,-117,155,1.5,-145,4.14,Nationals Park,7,-1
2014-05-19,2014,DET,CLE,4,5,107,1.5,-210,7.0,-115,-105,-117,-1.5,180,3.38,Progressive Field,9,-1
2014-05-19,2014,KC,CWS,6,7,-200,-1.5,-101,8.5,-125,105,170,1.5,-119,5.67,Kauffman Stadium,13,-1
2014-05-19,2014,CLE,DET,5,4,-117,-1.5,180,7.0,-115,-105,107,1.5,-210,3.77,Progressive Field,9,1
2014-05-19,2014,LAA,HOU,2,5,-195,-1.5,105,7.5,105,-125,175,1.5,-125,4.96,Angel Stadium,7,-3
2014-05-19,2014,CWS,KC,7,6,170,1.5,-119,8.5,-125,105,-200,-1.5,-101,3.15,Kauffman Stadium,13,1
2014-05-19,2014,HOU,LAA,5,2,175,1.5,-125,7.5,105,-125,-195,-1.5,105,2.73,Angel Stadium,7,3
2014-05-19,2014,ATL,MIL,9,3,-119,-1.5,180,7.0,105,-125,109,1.5,-210,3.8,Turner Field,12,6
2014-05-19,2014,CIN,WSH,4,3,155,1.5,-145,6.5,-103,-117,-175,-1.5,125,2.55,Nationals Park,7,1
2014-05-20,2014,STL,ARI,5,0,-190,-1.5,115,7.5,100,-120,170,1.5,-135,4.91,Busch Stadium,5,5
2014-05-20,2014,MIL,ATL,0,5,125,1.5,-190,6.5,-115,-105,-140,-1.5,160,2.89,Turner Field,5,-5
2014-05-20,2014,PIT,BAL,2,9,-148,-1.5,155,7.0,-120,100,133,1.5,-175,4.18,PNC Park,11,-7
2014-05-20,2014,TOR,BOS,7,4,119,1.5,-160,9.5,-115,-105,-134,-1.5,141,4.34,Fenway Park,11,3
2014-05-20,2014,NYY,CHC,1,6,-172,-1.5,-105,8.5,-105,-115,152,1.5,-115,5.38,Wrigley Field,7,-5
2014-05-20,2014,WSH,CIN,9,4,-103,1.5,-175,6.5,105,-125,-107,-1.5,155,3.3,Nationals Park,13,5
2014-05-20,2014,DET,CLE,2,6,-126,-1.5,125,8.0,-105,-115,116,1.5,-145,4.46,Progressive Field,8,-4
2014-05-20,2014,SF,COL,4,5,-101,-1.5,150,9.5,-120,100,-109,1.5,-170,4.77,Coors Field,9,-1
2014-05-20,2014,KC,CWS,6,7,-175,-1.5,120,8.5,-115,-105,155,1.5,-140,5.41,Kauffman Stadium,13,-1
2014-05-20,2014,CLE,DET,6,2,116,1.5,-145,8.0,-105,-115,-126,-1.5,125,3.7,Progressive Field,8,4
2014-05-20,2014,LAA,HOU,9,3,-175,-1.5,120,8.0,-105,-115,155,1.5,-140,5.09,Angel Stadium,12,6
2014-05-20,2014,CWS,KC,7,6,155,1.5,-140,8.5,-115,-105,-175,-1.5,120,3.33,Kauffman Stadium,13,1
2014-05-20,2014,HOU,LAA,3,9,155,1.5,-140,8.0,-105,-115,-175,-1.5,120,3.14,Angel Stadium,12,-6
2014-05-20,2014,NYM,LAD,4,9,114,1.5,-150,7.0,-125,105,-124,-1.5,130,3.27,Citi Field,13,-5
2014-05-20,2014,PHI,MIA,6,5,105,1.5,-215,7.5,100,-120,-115,-1.5,185,3.66,Marlins Park,11,1
2014-05-20,2014,ATL,MIL,5,0,-140,-1.5,160,6.5,-115,-105,125,1.5,-190,3.79,Turner Field,5,5
2014-05-20,2014,SD,MIN,3,5,-182,-1.5,120,7.0,-110,-110,162,1.5,-140,4.52,PETCO Park,8,-2
2014-05-20,2014,LAD,NYM,9,4,-124,-1.5,130,7.0,-125,105,114,1.5,-150,3.88,Citi Field,13,5
2014-05-20,2014,CHC,NYY,6,1,152,1.5,-115,8.5,-105,-115,-172,-1.5,-105,3.37,Wrigley Field,7,5
2014-05-20,2014,TB,OAK,0,3,100,1.5,-170,7.5,100,-120,-110,-1.5,150,3.75,Tropicana Field,3,-3
2014-05-20,2014,MIA,PHI,5,6,-115,-1.5,185,7.5,100,-120,105,1.5,-215,4.01,Marlins Park,11,-1
2014-05-20,2014,BAL,PIT,9,2,133,1.5,-175,7.0,-120,100,-148,-1.5,155,3.0,PNC Park,11,7
2014-05-20,2014,MIN,SD,5,3,162,1.5,-140,7.0,-110,-110,-182,-1.5,120,2.67,PETCO Park,8,2
2014-05-20,2014,TEX,SEA,2,6,102,1.5,-165,8.5,-120,100,-112,-1.5,145,4.21,Rangers Ballpark,8,-4
2014-05-20,2014,COL,SF,5,4,-109,1.5,-170,9.5,-120,100,-101,-1.5,150,4.95,Coors Field,9,1
2014-05-20,2014,ARI,STL,0,5,170,1.5,-135,7.5,100,-120,-190,-1.5,115,2.78,Busch Stadium,5,-5
2014-05-20,2014,OAK,TB,3,0,-110,-1.5,150,7.5,100,-120,100,1.5,-170,3.93,Tropicana Field,3,3
2014-05-20,2014,SEA,TEX,6,2,-112,-1.5,145,8.5,-120,100,102,1.5,-165,4.49,Rangers Ballpark,8,4
2014-05-20,2014,BOS,TOR,4,7,-134,-1.5,141,9.5,-115,-105,119,1.5,-160,5.44,Fenway Park,11,-3
2014-05-20,2014,CIN,WSH,4,9,-107,-1.5,155,6.5,105,-125,-103,1.5,-175,3.36,Nationals Park,13,-5
2014-05-21,2014,STL,ARI,3,2,-160,-1.5,135,7.0,-105,-115,145,1.5,-155,4.31,Busch Stadium,5,1
2014-05-21,2014,MIL,ATL,6,1,119,1.5,-190,6.5,-110,-110,-134,-1.5,160,2.97,Turner Field,7,5
2014-05-21,2014,PIT,BAL,9,8,-120,-1.5,170,7.5,-115,-105,110,1.5,-200,4.09,PNC Park,17,1
2014-05-21,2014,TOR,BOS,6,4,102,1.5,-200,9.0,-110,-110,-112,-1.5,170,4.46,Fenway Park,10,2
2014-05-21,2014,NYY,CHC,4,2,-103,1.5,-210,7.5,-120,100,-107,-1.5,180,3.81,Wrigley Field,6,2
2014-05-21,2014,WSH,CIN,1,2,-140,-1.5,160,7.0,-120,100,125,1.5,-180,4.08,Nationals Park,3,-1
2014-05-21,2014,DET,CLE,10,11,-151,-1.5,110,7.5,-115,-105,136,1.5,-130,4.51,Progressive Field,21,-1
2014-05-21,2014,SF,COL,5,1,119,1.5,-175,10.0,-115,-105,-129,-1.5,155,4.57,Coors Field,6,4
2014-05-21,2014,KC,CWS,3,1,-118,-1.5,180,8.0,-120,100,108,1.5,-210,4.33,Kauffman Stadium,4,2
2014-05-21,2014,CLE,DET,11,10,136,1.5,-130,7.5,-115,-105,-151,-1.5,110,3.18,Progressive Field,21,1
2014-05-21,2014,LAA,HOU,2,1,-166,-1.5,120,7.5,-115,-105,151,1.5,-140,4.68,Angel Stadium,3,1
2014-05-21,2014,CWS,KC,1,3,108,1.5,-210,8.0,-120,100,-118,-1.5,180,3.85,Kauffman Stadium,4,-2
2014-05-21,2014,HOU,LAA,1,2,151,1.5,-140,7.5,-115,-105,-166,-1.5,120,2.99,Angel Stadium,3,-1
2014-05-21,2014,NYM,LAD,3,4,113,1.5,-155,7.0,-110,-110,-123,-1.5,135,3.29,Citi Field,7,-1
2014-05-21,2014,PHI,MIA,5,14,130,1.5,-175,7.5,-110,-110,-145,-1.5,155,3.26,Marlins Park,19,-9
2014-05-21,2014,ATL,MIL,1,6,-134,-1.5,160,6.5,-110,-110,119,1.5,-190,3.72,Turner Field,7,-5
2014-05-21,2014,SD,MIN,0,2,-133,-1.5,165,6.5,-108,-112,118,1.5,-195,3.71,PETCO Park,2,-2
2014-05-21,2014,LAD,NYM,4,3,-123,-1.5,135,7.0,-110,-110,113,1.5,-155,3.86,Citi Field,7,1
2014-05-21,2014,CHC,NYY,2,4,-107,-1.5,180,7.5,-120,100,-103,1.5,-210,3.88,Wrigley Field,6,-2
2014-05-21,2014,TB,OAK,2,3,102,1.5,-160,7.5,-115,-105,-112,-1.5,140,3.71,Tropicana Field,5,-1
2014-05-21,2014,MIA,PHI,14,5,-145,-1.5,155,7.5,-110,-110,130,1.5,-175,4.44,Marlins Park,19,9
2014-05-21,2014,BAL,PIT,8,9,110,1.5,-200,7.5,-115,-105,-120,-1.5,170,3.57,PNC Park,17,-1
2014-05-21,2014,MIN,SD,2,0,118,1.5,-195,6.5,-108,-112,-133,-1.5,165,2.98,PETCO Park,2,2
2014-05-21,2014,TEX,SEA,4,3,-150,-1.5,140,9.0,-115,-105,135,1.5,-160,5.4,Rangers Ballpark,7,1
2014-05-21,2014,COL,SF,1,5,-129,-1.5,155,10.0,-115,-105,119,1.5,-175,5.63,Coors Field,6,-4
2014-05-21,2014,ARI,STL,2,3,145,1.5,-155,7.0,-105,-115,-160,-1.5,135,2.86,Busch Stadium,5,-1
2014-05-21,2014,OAK,TB,3,2,-112,-1.5,140,7.5,-115,-105,102,1.5,-160,3.96,Tropicana Field,5,1
2014-05-21,2014,SEA,TEX,3,4,135,1.5,-160,9.0,-115,-105,-150,-1.5,140,3.83,Rangers Ballpark,7,-1
2014-05-21,2014,BOS,TOR,4,6,-112,-1.5,170,9.0,-110,-110,102,1.5,-200,4.75,Fenway Park,10,-2
2014-05-21,2014,CIN,WSH,2,1,125,1.5,-180,7.0,-120,100,-140,-1.5,160,3.11,Nationals Park,3,1
2014-05-22,2014,STL,ARI,4,2,-156,-1.5,150,7.0,-115,-105,141,1.5,-170,4.27,Busch Stadium,6,2
2014-05-22,2014,MIL,ATL,4,5,127,1.5,-190,7.0,-120,100,-142,-1.5,160,3.08,Turner Field,9,-1
2014-05-22,2014,CLE,BAL,8,7,130,1.5,-165,9.0,105,-125,-145,-1.5,145,3.91,Camden Yards,15,1
2014-05-22,2014,TOR,BOS,7,2,135,1.5,-160,8.5,-113,-107,-150,-1.5,140,3.62,Fenway Park,9,5
2014-05-22,2014,SD,CHC,1,5,-140,-1.5,165,7.0,105,-125,125,1.5,-195,4.08,PETCO Park,6,-4
2014-05-22,2014,BAL,CLE,7,8,-145,-1.5,145,9.0,105,-125,130,1.5,-165,5.33,Camden Yards,15,-1
2014-05-22,2014,SF,COL,4,2,111,1.5,-190,9.5,105,-125,-121,-1.5,160,4.5,Coors Field,6,2
2014-05-22,2014,NYY,CWS,2,3,136,1.5,-160,7.0,-125,105,-151,-1.5,140,2.97,Guaranteed Rate Field,5,-1
2014-05-22,2014,TEX,DET,9,2,-117,-1.5,140,7.5,-110,-110,107,1.5,-165,4.04,Comerica Park,11,7
2014-05-22,2014,SEA,HOU,3,1,-164,-1.5,135,7.5,-115,-105,149,1.5,-155,4.66,T-Mobile Park,4,2
2014-05-22,2014,NYM,LAD,5,3,135,1.5,-135,7.0,-115,-105,-150,-1.5,115,2.98,Citi Field,8,2
2014-05-22,2014,PHI,MIA,3,4,-108,-1.5,155,7.0,105,-125,-102,1.5,-175,3.63,Marlins Park,7,-1
2014-05-22,2014,ATL,MIL,5,4,-142,-1.5,160,7.0,-120,100,127,1.5,-190,4.11,Turner Field,9,1
2014-05-22,2014,LAD,NYM,3,5,-150,-1.5,115,7.0,-115,-105,135,1.5,-135,4.2,Citi Field,8,-2
2014-05-22,2014,CWS,NYY,3,2,-151,-1.5,140,7.0,-125,105,136,1.5,-160,4.21,Guaranteed Rate Field,5,1
2014-05-22,2014,TB,OAK,5,2,-107,-1.5,190,7.0,-110,-110,-103,1.5,-230,3.62,Tropicana Field,7,3
2014-05-22,2014,MIA,PHI,4,3,-102,1.5,-175,7.0,105,-125,-108,-1.5,155,3.53,Marlins Park,7,1
2014-05-22,2014,WSH,PIT,1,3,111,1.5,-205,7.5,-105,-115,-121,-1.5,175,3.55,PNC Park,4,-2
2014-05-22,2014,CHC,SD,5,1,125,1.5,-195,7.0,105,-125,-140,-1.5,165,3.11,PETCO Park,6,4
2014-05-22,2014,HOU,SEA,1,3,149,1.5,-155,7.5,-115,-105,-164,-1.5,135,3.01,T-Mobile Park,4,-2
2014-05-22,2014,COL,SF,2,4,-121,-1.5,160,9.5,105,-125,111,1.5,-190,5.2,Coors Field,6,-2
2014-05-22,2014,ARI,STL,2,4,141,1.5,-170,7.0,-115,-105,-156,-1.5,150,2.9,Busch Stadium,6,-2
2014-05-22,2014,OAK,TB,2,5,-103,1.5,-230,7.0,-110,-110,-107,-1.5,190,3.55,Tropicana Field,7,-3
2014-05-22,2014,DET,TEX,2,9,107,1.5,-165,7.5,-110,-110,-117,-1.5,140,3.62,Comerica Park,11,-7
2014-05-22,2014,BOS,TOR,2,7,-150,-1.5,140,8.5,-113,-107,135,1.5,-160,5.1,Fenway Park,9,-5
2014-05-22,2014,PIT,WSH,3,1,-121,-1.5,175,7.5,-105,-115,111,1.5,-205,4.11,PNC Park,4,2
2014-05-23,2014,COL,ATL,2,3,125,1.5,-175,7.5,105,-125,-140,-1.5,155,3.33,Turner Field,5,-1
2014-05-23,2014,CLE,BAL,4,8,118,1.5,-175,8.5,-113,-107,-133,-1.5,155,3.9,Camden Yards,12,-4
2014-05-23,2014,TB,BOS,1,0,-108,-1.5,190,7.0,-115,-105,-102,1.5,-230,3.63,Tropicana Field,1,1
2014-05-23,2014,SD,CHC,11,1,-132,-1.5,175,6.5,-125,105,117,1.5,-205,3.7,PETCO Park,12,10
2014-05-23,2014,STL,CIN,3,5,-101,1.5,-215,7.0,-120,100,-109,-1.5,185,3.52,Great American Ballpark,8,-2
2014-05-23,2014,BAL,CLE,8,4,-133,-1.5,155,8.5,-113,-107,118,1.5,-175,4.85,Camden Yards,12,4
2014-05-23,2014,ATL,COL,3,2,-140,-1.5,155,7.5,105,-125,125,1.5,-175,4.38,Turner Field,5,1
2014-05-23,2014,NYY,CWS,5,6,-144,-1.5,115,8.5,-105,-115,129,1.5,-135,5.02,Guaranteed Rate Field,11,-1
2014-05-23,2014,TEX,DET,2,7,170,1.5,-130,8.0,-120,100,-190,-1.5,110,2.96,Comerica Park,9,-5
2014-05-23,2014,SEA,HOU,6,1,-250,-1.5,-110,6.5,-115,-105,210,1.5,-110,4.64,T-Mobile Park,7,5
2014-05-23,2014,LAA,KC,6,1,-160,-1.5,140,7.0,-120,100,145,1.5,-160,4.31,Angel Stadium,7,5
2014-05-23,2014,KC,LAA,1,6,145,1.5,-160,7.0,-120,100,-160,-1.5,140,2.86,Angel Stadium,7,-5
2014-05-23,2014,PHI,LAD,0,2,152,1.5,-115,7.0,-115,-105,-172,-1.5,-105,2.78,Citizens Bank Park,2,-2
2014-05-23,2014,MIL,MIA,9,5,106,1.5,-210,7.0,-125,105,-116,-1.5,180,3.4,Marlins Park,14,4
2014-05-23,2014,MIA,MIL,5,9,-116,-1.5,180,7.0,-125,105,106,1.5,-210,3.76,Marlins Park,14,-4
2014-05-23,2014,SF,MIN,6,2,-160,-1.5,140,7.0,-125,105,145,1.5,-160,4.31,AT&T Park,8,4
2014-05-23,2014,CWS,NYY,6,5,129,1.5,-135,8.5,-105,-115,-144,-1.5,115,3.71,Guaranteed Rate Field,11,1
2014-05-23,2014,TOR,OAK,3,2,107,1.5,-150,9.5,-102,-118,-117,-1.5,130,4.59,Rogers Centre,5,1
2014-05-23,2014,LAD,PHI,2,0,-172,-1.5,-105,7.0,-115,-105,152,1.5,-115,4.43,Citizens Bank Park,2,2
2014-05-23,2014,WSH,PIT,3,4,115,1.5,-205,7.0,105,-125,-125,-1.5,175,3.26,PNC Park,7,-1
2014-05-23,2014,CHC,SD,1,11,117,1.5,-205,6.5,-125,105,-132,-1.5,175,3.0,PETCO Park,12,-10
2014-05-23,2014,HOU,SEA,1,6,210,1.5,-110,6.5,-115,-105,-250,-1.5,-110,2.1,T-Mobile Park,7,-5
2014-05-23,2014,MIN,SF,2,6,145,1.5,-160,7.0,-125,105,-160,-1.5,140,2.86,AT&T Park,8,-4
2014-05-23,2014,CIN,STL,5,3,-109,-1.5,185,7.0,-120,100,-101,1.5,-215,3.65,Great American Ballpark,8,2
2014-05-23,2014,BOS,TB,0,1,-102,1.5,-230,7.0,-115,-105,-108,-1.5,190,3.53,Tropicana Field,1,-1
2014-05-23,2014,DET,TEX,7,2,-190,-1.5,110,8.0,-120,100,170,1.5,-130,5.24,Comerica Park,9,5
2014-05-23,2014,OAK,TOR,2,3,-117,-1.5,130,9.5,-102,-118,107,1.5,-150,5.12,Rogers Centre,5,-1
2014-05-23,2014,PIT,WSH,4,3,-125,-1.5,175,7.0,105,-125,115,1.5,-205,3.89,PNC Park,7,1
2014-05-24,2014,NYM,ARI,2,3,-115,-1.5,185,7.0,-120,100,105,1.5,-215,3.74,Citi Field,5,-1
2014-05-24,2014,COL,ATL,3,1,141,1.5,-165,7.5,-107,-113,-156,-1.5,145,3.11,Turner Field,4,2
2014-05-24,2014,CLE,BAL,9,0,-106,-1.5,150,8.0,-105,-115,-104,1.5,-170,4.12,Camden Yards,9,9
2014-05-24,2014,TB,BOS,6,5,-160,-1.5,135,6.5,-118,-102,145,1.5,-155,4.0,Tropicana Field,11,1
2014-05-24,2014,SD,CHC,2,3,-105,-1.5,190,6.5,-125,105,-105,1.5,-230,3.33,PETCO Park,5,-1
2014-05-24,2014,STL,CIN,6,3,-123,-1.5,140,7.0,-120,100,113,1.5,-160,3.86,Great American Ballpark,9,3
2014-05-24,2014,BAL,CLE,0,9,-104,1.5,-170,8.0,-105,-115,-106,-1.5,150,4.08,Camden Yards,9,-9
2014-05-24,2014,ATL,COL,1,3,-156,-1.5,145,7.5,-107,-113,141,1.5,-165,4.57,Turner Field,4,-2
2014-05-24,2014,NYY,CWS,4,3,-124,-1.5,135,9.0,105,-125,114,1.5,-155,4.98,Guaranteed Rate Field,7,1
2014-05-24,2014,TEX,DET,12,2,153,1.5,-145,9.0,-105,-115,-173,-1.5,125,3.56,Comerica Park,14,10
2014-05-24,2014,SEA,HOU,4,9,-115,-1.5,180,7.5,-105,-115,105,1.5,-210,4.01,T-Mobile Park,13,-5
2014-05-24,2014,LAA,KC,4,7,-105,-1.5,190,7.5,100,-120,-105,1.5,-230,3.84,Angel Stadium,11,-3
2014-05-24,2014,KC,LAA,7,4,-105,1.5,-230,7.5,100,-120,-105,-1.5,190,3.84,Angel Stadium,11,3
2014-05-24,2014,PHI,LAD,5,3,116,1.5,-145,8.5,-120,100,-131,-1.5,125,3.94,Citizens Bank Park,8,2
2014-05-24,2014,MIL,MIA,1,2,-105,1.5,-215,8.0,100,-120,-105,-1.5,185,4.1,Marlins Park,3,-1
2014-05-24,2014,MIA,MIL,2,1,-105,-1.5,185,8.0,100,-120,-105,1.5,-215,4.1,Marlins Park,3,1
2014-05-24,2014,SF,MIN,2,1,-140,-1.5,155,7.5,105,-125,125,1.5,-175,4.38,AT&T Park,3,1
2014-05-24,2014,ARI,NYM,3,2,105,1.5,-215,7.0,-120,100,-115,-1.5,185,3.41,Citi Field,5,1
2014-05-24,2014,CWS,NYY,3,4,114,1.5,-155,9.0,105,-125,-124,-1.5,135,4.21,Guaranteed Rate Field,7,-1
2014-05-24,2014,TOR,OAK,5,2,-106,-1.5,185,9.0,100,-120,-104,1.5,-215,4.63,Rogers Centre,7,3
2014-05-24,2014,LAD,PHI,3,5,-131,-1.5,125,8.5,-120,100,116,1.5,-145,4.82,Citizens Bank Park,8,-2
2014-05-24,2014,WSH,PIT,2,3,-110,1.5,-230,6.5,100,-120,100,-1.5,190,3.4,PNC Park,5,-1
2014-05-24,2014,CHC,SD,3,2,-105,1.5,-230,6.5,-125,105,-105,-1.5,190,3.33,PETCO Park,5,1
2014-05-24,2014,HOU,SEA,9,4,105,1.5,-210,7.5,-105,-115,-115,-1.5,180,3.66,T-Mobile Park,13,5
2014-05-24,2014,MIN,SF,1,2,125,1.5,-175,7.5,105,-125,-140,-1.5,155,3.33,AT&T Park,3,-1
2014-05-24,2014,CIN,STL,3,6,113,1.5,-160,7.0,-120,100,-123,-1.5,140,3.29,Great American Ballpark,9,-3
2014-05-24,2014,BOS,TB,5,6,145,1.5,-155,6.5,-118,-102,-160,-1.5,135,2.65,Tropicana Field,11,-1
2014-05-24,2014,DET,TEX,2,12,-173,-1.5,125,9.0,-105,-115,153,1.5,-145,5.7,Comerica Park,14,-10
2014-05-24,2014,OAK,TOR,2,5,-104,1.5,-215,9.0,100,-120,-106,-1.5,185,4.59,Rogers Centre,7,-3
2014-05-24,2014,PIT,WSH,3,2,100,-1.5,190,6.5,100,-120,-110,1.5,-230,3.25,PNC Park,5,1
2014-05-25,2014,NYM,ARI,1,2,101,1.5,-170,7.0,-120,100,-111,-1.5,150,3.48,Citi Field,3,-1
2014-05-25,2014,NYM,ARI,4,2,-121,-1.5,170,7.5,-110,-110,111,1.5,-200,4.11,Citi Field,6,2
2014-05-25,2014,COL,ATL,0,7,154,1.5,-150,7.0,-126,106,-169,-1.5,130,2.76,Turner Field,7,-7
2014-05-25,2014,CLE,BAL,2,4,102,1.5,-210,8.5,-120,100,-112,-1.5,180,4.21,Camden Yards,6,-2
2014-05-25,2014,TB,BOS,8,5,-121,-1.5,170,7.5,100,-120,111,1.5,-200,4.11,Tropicana Field,13,3
2014-05-25,2014,SD,CHC,4,3,-141,-1.5,165,6.5,100,-120,126,1.5,-195,3.8,PETCO Park,7,1
2014-05-25,2014,STL,CIN,4,0,-141,-1.5,125,6.5,-123,103,126,1.5,-145,3.8,Great American Ballpark,4,4
2014-05-25,2014,BAL,CLE,4,2,-112,-1.5,180,8.5,-120,100,102,1.5,-210,4.49,Camden Yards,6,2
2014-05-25,2014,ATL,COL,7,0,-169,-1.5,130,7.0,-126,106,154,1.5,-150,4.4,Turner Field,7,7
2014-05-25,2014,NYY,CWS,7,1,-195,-1.5,-125,7.5,-120,100,175,1.5,105,4.96,Guaranteed Rate Field,8,6
2014-05-25,2014,TEX,DET,12,4,149,1.5,-145,8.5,-120,100,-164,-1.5,125,3.41,Comerica Park,16,8
2014-05-25,2014,SEA,HOU,1,4,-139,-1.5,175,6.5,105,-125,124,1.5,-205,3.78,T-Mobile Park,5,-3
2014-05-25,2014,LAA,KC,4,3,-159,-1.5,140,8.0,-110,-110,144,1.5,-160,4.91,Angel Stadium,7,1
2014-05-25,2014,KC,LAA,3,4,144,1.5,-160,8.0,-110,-110,-159,-1.5,140,3.28,Angel Stadium,7,-1
2014-05-25,2014,PHI,LAD,0,6,103,1.5,-165,7.5,-105,-115,-113,-1.5,145,3.69,Citizens Bank Park,6,-6
2014-05-25,2014,MIL,MIA,7,1,-126,-1.5,135,8.0,100,-120,116,1.5,-155,4.46,Marlins Park,8,6
2014-05-25,2014,MIA,MIL,1,7,116,1.5,-155,8.0,100,-120,-126,-1.5,135,3.7,Marlins Park,8,-6
2014-05-25,2014,SF,MIN,8,1,-180,-1.5,125,7.0,-120,100,160,1.5,-145,4.5,AT&T Park,9,7
2014-05-25,2014,ARI,NYM,2,1,-111,-1.5,150,7.0,-120,100,101,1.5,-170,3.68,Citi Field,3,1
2014-05-25,2014,ARI,NYM,2,4,111,1.5,-200,7.5,-110,-110,-121,-1.5,170,3.55,Citi Field,6,-2
2014-05-25,2014,CWS,NYY,1,7,175,1.5,105,7.5,-120,100,-195,-1.5,-125,2.73,Guaranteed Rate Field,8,-6
2014-05-25,2014,TOR,OAK,3,1,104,1.5,-155,9.5,-120,100,-114,-1.5,135,4.66,Rogers Centre,4,2
2014-05-25,2014,LAD,PHI,6,0,-113,-1.5,145,7.5,-105,-115,103,1.5,-165,3.98,Citizens Bank Park,6,6
2014-05-25,2014,WSH,PIT,5,2,110,1.5,-215,7.0,-105,-115,-120,-1.5,185,3.33,PNC Park,7,3
2014-05-25,2014,CHC,SD,3,4,126,1.5,-195,6.5,100,-120,-141,-1.5,165,2.88,PETCO Park,7,-1
2014-05-25,2014,HOU,SEA,4,1,124,1.5,-205,6.5,105,-125,-139,-1.5,175,2.9,T-Mobile Park,5,3
2014-05-25,2014,MIN,SF,1,8,160,1.5,-145,7.0,-120,100,-180,-1.5,125,2.69,AT&T Park,9,-7
2014-05-25,2014,CIN,STL,0,4,126,1.5,-145,6.5,-123,103,-141,-1.5,125,2.88,Great American Ballpark,4,-4
2014-05-25,2014,BOS,TB,5,8,111,1.5,-200,7.5,100,-120,-121,-1.5,170,3.55,Tropicana Field,13,-3
2014-05-25,2014,DET,TEX,4,12,-164,-1.5,125,8.5,-120,100,149,1.5,-145,5.28,Comerica Park,16,-8
2014-05-25,2014,OAK,TOR,1,3,-114,-1.5,135,9.5,-120,100,104,1.5,-155,5.06,Rogers Centre,4,-2
2014-05-25,2014,PIT,WSH,2,5,-120,-1.5,185,7.0,-105,-115,110,1.5,-215,3.82,PNC Park,7,-3
2014-05-26,2014,SD,ARI,5,7,114,1.5,-200,8.0,100,-120,-124,-1.5,170,3.74,Chase Field,12,-2
2014-05-26,2014,BOS,ATL,8,6,117,1.5,-195,7.0,-115,-105,-132,-1.5,165,3.23,Turner Field,14,2
2014-05-26,2014,MIL,BAL,6,7,-162,-1.5,135,7.5,100,-120,147,1.5,-155,4.64,Miller Park,13,-1
2014-05-26,2014,ATL,BOS,6,8,-132,-1.5,165,7.0,-115,-105,117,1.5,-195,3.98,Turner Field,14,-2
2014-05-26,2014,SF,CHC,4,8,-127,-1.5,175,7.0,105,-125,117,1.5,-205,3.92,AT&T Park,12,-4
2014-05-26,2014,LAD,CIN,4,3,-120,-1.5,190,6.0,-105,-115,110,1.5,-230,3.27,Dodger Stadium,7,1
2014-05-26,2014,CWS,CLE,6,2,-118,-1.5,175,8.5,-125,105,108,1.5,-205,4.6,Guaranteed Rate Field,8,4
2014-05-26,2014,PHI,COL,9,0,-104,-1.5,180,9.0,-125,105,-106,1.5,-210,4.59,Citizens Bank Park,9,9
2014-05-26,2014,CLE,CWS,2,6,108,1.5,-205,8.5,-125,105,-118,-1.5,175,4.09,Guaranteed Rate Field,8,-4
2014-05-26,2014,OAK,DET,10,0,-133,-1.5,160,8.0,-120,100,118,1.5,-190,4.57,Oakland Coliseum,10,10
2014-05-26,2014,KC,HOU,2,9,-191,-1.5,120,7.5,-115,-105,171,1.5,-140,4.92,Kauffman Stadium,11,-7
2014-05-26,2014,HOU,KC,9,2,171,1.5,-140,7.5,-115,-105,-191,-1.5,120,2.77,Kauffman Stadium,11,7
2014-05-26,2014,SEA,LAA,5,1,136,1.5,-125,7.5,-110,-110,-151,-1.5,105,3.18,T-Mobile Park,6,4
2014-05-26,2014,CIN,LAD,3,4,110,1.5,-230,6.0,-105,-115,-120,-1.5,190,2.86,Dodger Stadium,7,-1
2014-05-26,2014,WSH,MIA,2,3,-143,-1.5,160,7.5,-110,-110,128,1.5,-190,4.41,Nationals Park,5,-1
2014-05-26,2014,BAL,MIL,7,6,147,1.5,-155,7.5,100,-120,-162,-1.5,135,3.04,Miller Park,13,1
2014-05-26,2014,TEX,MIN,7,2,-122,-1.5,135,9.0,-125,105,112,1.5,-155,4.95,Target Field,9,5
2014-05-26,2014,PIT,NYM,5,3,-108,-1.5,150,7.5,100,-120,-102,1.5,-170,3.89,Citi Field,8,2
2014-05-26,2014,STL,NYY,4,6,-193,-1.5,125,7.0,-105,-115,173,1.5,-145,4.61,Busch Stadium,10,-2
2014-05-26,2014,DET,OAK,0,10,118,1.5,-190,8.0,-120,100,-133,-1.5,160,3.67,Oakland Coliseum,10,-10
2014-05-26,2014,COL,PHI,0,9,-106,1.5,-210,9.0,-125,105,-104,-1.5,180,4.63,Citizens Bank Park,9,-9
2014-05-26,2014,NYM,PIT,3,5,-102,1.5,-170,7.5,100,-120,-108,-1.5,150,3.79,Citi Field,8,-2
2014-05-26,2014,ARI,SD,7,5,-124,-1.5,170,8.0,100,-120,114,1.5,-200,4.43,Chase Field,12,2
2014-05-26,2014,LAA,SEA,1,5,-151,-1.5,105,7.5,-110,-110,136,1.5,-125,4.51,T-Mobile Park,6,-4
2014-05-26,2014,CHC,SF,8,4,117,1.5,-205,7.0,105,-125,-127,-1.5,175,3.23,AT&T Park,12,4
2014-05-26,2014,NYY,STL,6,4,173,1.5,-145,7.0,-105,-115,-193,-1.5,125,2.56,Busch Stadium,10,2
2014-05-26,2014,TOR,TB,10,5,-145,-1.5,145,9.0,-115,-105,130,1.5,-165,5.33,Rogers Centre,15,5
2014-05-26,2014,MIN,TEX,2,7,112,1.5,-155,9.0,-125,105,-122,-1.5,135,4.25,Target Field,9,-5
2014-05-26,2014,TB,TOR,5,10,130,1.5,-165,9.0,-115,-105,-145,-1.5,145,3.91,Rogers Centre,15,-5
2014-05-26,2014,MIA,WSH,3,2,128,1.5,-190,7.5,-110,-110,-143,-1.5,160,3.29,Nationals Park,5,1
2014-05-27,2014,SD,ARI,4,3,115,1.5,-190,9.0,-115,-105,-130,-1.5,160,4.19,Chase Field,7,1
2014-05-27,2014,BOS,ATL,6,3,-101,1.5,-220,7.0,-105,-115,-109,-1.5,190,3.52,Turner Field,9,3
2014-05-27,2014,MIL,BAL,7,6,-128,-1.5,170,8.0,-120,100,118,1.5,-200,4.49,Miller Park,13,1
2014-05-27,2014,ATL,BOS,3,6,-109,-1.5,190,7.0,-105,-115,-101,1.5,-220,3.65,Turner Field,9,-3
2014-05-27,2014,SF,CHC,4,0,-171,-1.5,135,6.5,-125,105,151,1.5,-155,4.1,AT&T Park,4,4
2014-05-27,2014,LAD,CIN,6,3,-182,-1.5,130,6.5,-115,-105,162,1.5,-150,4.2,Dodger Stadium,9,3
2014-05-27,2014,CWS,CLE,2,1,-173,-1.5,125,7.5,105,-125,153,1.5,-145,4.75,Guaranteed Rate Field,3,1
2014-05-27,2014,PHI,COL,2,6,-116,-1.5,180,7.5,100,-120,106,1.5,-210,4.03,Citizens Bank Park,8,-4
2014-05-27,2014,CLE,CWS,1,2,153,1.5,-145,7.5,105,-125,-173,-1.5,125,2.96,Guaranteed Rate Field,3,-1
2014-05-27,2014,OAK,DET,5,6,-130,-1.5,170,7.0,100,-120,115,1.5,-200,3.96,Oakland Coliseum,11,-1
2014-05-27,2014,KC,HOU,0,3,-131,-1.5,160,8.5,-103,-117,116,1.5,-190,4.82,Kauffman Stadium,3,-3
2014-05-27,2014,HOU,KC,3,0,116,1.5,-190,8.5,-103,-117,-131,-1.5,160,3.94,Kauffman Stadium,3,3
2014-05-27,2014,SEA,LAA,4,6,115,1.5,-150,7.0,-125,105,-130,-1.5,130,3.26,T-Mobile Park,10,-2
2014-05-27,2014,CIN,LAD,3,6,162,1.5,-150,6.5,-115,-105,-182,-1.5,130,2.48,Dodger Stadium,9,-3
2014-05-27,2014,BAL,MIL,6,7,118,1.5,-200,8.0,-120,100,-128,-1.5,170,3.67,Miller Park,13,-1
2014-05-27,2014,TEX,MIN,3,4,110,1.5,-200,8.5,-120,100,-120,-1.5,170,4.05,Target Field,7,-1
2014-05-27,2014,PIT,NYM,2,4,-116,-1.5,145,7.5,-120,100,106,1.5,-165,4.03,Citi Field,6,-2
2014-05-27,2014,STL,NYY,6,0,-152,-1.5,140,7.5,-112,-108,137,1.5,-160,4.52,Busch Stadium,6,6
2014-05-27,2014,DET,OAK,6,5,115,1.5,-200,7.0,100,-120,-130,-1.5,170,3.26,Oakland Coliseum,11,1
2014-05-27,2014,COL,PHI,6,2,106,1.5,-210,7.5,100,-120,-116,-1.5,180,3.64,Citizens Bank Park,8,4
2014-05-27,2014,NYM,PIT,4,2,106,1.5,-165,7.5,-120,100,-116,-1.5,145,3.64,Citi Field,6,2
2014-05-27,2014,ARI,SD,3,4,-130,-1.5,160,9.0,-115,-105,115,1.5,-190,5.09,Chase Field,7,-1
2014-05-27,2014,LAA,SEA,6,4,-130,-1.5,130,7.0,-125,105,115,1.5,-150,3.96,T-Mobile Park,10,2
2014-05-27,2014,CHC,SF,0,4,151,1.5,-155,6.5,-125,105,-171,-1.5,135,2.59,AT&T Park,4,-4
2014-05-27,2014,NYY,STL,0,6,137,1.5,-160,7.5,-112,-108,-152,-1.5,140,3.16,Busch Stadium,6,-6
2014-05-27,2014,TOR,TB,9,6,-105,-1.5,180,8.5,-120,100,-105,1.5,-210,4.35,Rogers Centre,15,3
2014-05-27,2014,MIN,TEX,4,3,-120,-1.5,170,8.5,-120,100,110,1.5,-200,4.64,Target Field,7,1
2014-05-27,2014,TB,TOR,6,9,-105,1.5,-210,8.5,-120,100,-105,-1.5,180,4.35,Rogers Centre,15,-3
2014-05-28,2014,SD,ARI,6,12,106,1.5,-205,9.0,-105,-115,-116,-1.5,175,4.37,Chase Field,18,-6
2014-05-28,2014,BOS,ATL,4,0,-140,-1.5,150,8.0,100,-120,125,1.5,-170,4.67,Fenway Park,4,4
2014-05-28,2014,MIL,BAL,8,3,-128,-1.5,170,8.0,-110,-110,118,1.5,-200,4.49,Miller Park,11,5
2014-05-28,2014,ATL,BOS,0,4,125,1.5,-170,8.0,100,-120,-140,-1.5,150,3.56,Fenway Park,4,-4
2014-05-28,2014,SF,CHC,5,0,-155,-1.5,145,7.5,100,-120,140,1.5,-165,4.56,AT&T Park,5,5
2014-05-28,2014,LAD,CIN,2,3,-200,-1.5,115,6.0,100,-120,170,1.5,-135,4.0,Dodger Stadium,5,-1
2014-05-28,2014,CWS,CLE,3,2,111,1.5,-160,9.0,-115,-105,-121,-1.5,140,4.27,Guaranteed Rate Field,5,1
2014-05-28,2014,PHI,COL,6,3,-130,-1.5,160,8.0,100,-120,115,1.5,-190,4.52,Citizens Bank Park,9,3
2014-05-28,2014,CLE,CWS,2,3,-121,-1.5,140,9.0,-115,-105,111,1.5,-160,4.93,Guaranteed Rate Field,5,-1
2014-05-28,2014,OAK,DET,3,1,-130,-1.5,170,7.5,100,-120,115,1.5,-200,4.24,Oakland Coliseum,4,2
2014-05-28,2014,KC,HOU,3,9,-142,-1.5,140,8.5,-118,-102,127,1.5,-160,4.99,Kauffman Stadium,12,-6
2014-05-28,2014,HOU,KC,9,3,127,1.5,-160,8.5,-118,-102,-142,-1.5,140,3.74,Kauffman Stadium,12,6
2014-05-28,2014,SEA,LAA,3,1,-124,-1.5,175,6.5,-110,-110,114,1.5,-205,3.6,T-Mobile Park,4,2
2014-05-28,2014,CIN,LAD,3,2,170,1.5,-135,6.0,100,-120,-200,-1.5,115,2.22,Dodger Stadium,5,1
2014-05-28,2014,WSH,MIA,5,8,-145,-1.5,150,7.5,-105,-115,130,1.5,-170,4.44,Nationals Park,13,-3
2014-05-28,2014,BAL,MIL,3,8,118,1.5,-200,8.0,-110,-110,-128,-1.5,170,3.67,Miller Park,11,-5
2014-05-28,2014,TEX,MIN,1,0,-101,1.5,-210,9.0,-110,-110,-109,-1.5,180,4.52,Target Field,1,1
2014-05-28,2014,PIT,NYM,0,5,-104,-1.5,160,7.0,105,-125,-106,1.5,-180,3.57,Citi Field,5,-5
2014-05-28,2014,STL,NYY,4,7,-131,-1.5,165,7.0,-105,-115,116,1.5,-195,3.97,Busch Stadium,11,-3
2014-05-28,2014,DET,OAK,1,3,115,1.5,-200,7.5,100,-120,-130,-1.5,170,3.49,Oakland Coliseum,4,-2
2014-05-28,2014,COL,PHI,3,6,115,1.5,-190,8.0,100,-120,-130,-1.5,160,3.72,Citizens Bank Park,9,-3
2014-05-28,2014,NYM,PIT,5,0,-106,1.5,-180,7.0,105,-125,-104,-1.5,160,3.6,Citi Field,5,5
2014-05-28,2014,ARI,SD,12,6,-116,-1.5,175,9.0,-105,-115,106,1.5,-205,4.83,Chase Field,18,6
2014-05-28,2014,LAA,SEA,1,3,114,1.5,-205,6.5,-110,-110,-124,-1.5,175,3.04,T-Mobile Park,4,-2
2014-05-28,2014,CHC,SF,0,5,140,1.5,-165,7.5,100,-120,-155,-1.5,145,3.13,AT&T Park,5,-5
2014-05-28,2014,NYY,STL,7,4,116,1.5,-195,7.0,-105,-115,-131,-1.5,165,3.24,Busch Stadium,11,3
2014-05-28,2014,TOR,TB,3,2,-109,-1.5,177,9.0,-110,-110,-101,1.5,-206,4.69,Rogers Centre,5,1
2014-05-28,2014,MIN,TEX,0,1,-109,-1.5,180,9.0,-110,-110,-101,1.5,-210,4.69,Target Field,1,-1
2014-05-28,2014,TB,TOR,2,3,-101,1.5,-206,9.0,-110,-110,-109,-1.5,177,4.52,Rogers Centre,5,-1
2014-05-28,2014,MIA,WSH,8,5,130,1.5,-170,7.5,-105,-115,-145,-1.5,150,3.26,Nationals Park,13,3
2014-05-29,2014,CIN,ARI,0,4,118,1.5,-190,8.5,100,-120,-128,-1.5,160,3.9,Chase Field,4,-4
2014-05-29,2014,BOS,ATL,4,3,107,1.5,-160,8.0,-110,-110,-117,-1.5,140,3.86,Fenway Park,7,1
2014-05-29,2014,HOU,BAL,3,1,110,1.5,-160,9.0,-125,105,-120,-1.5,140,4.29,Minute Maid Park,4,2
2014-05-29,2014,ATL,BOS,3,4,-117,-1.5,140,8.0,-110,-110,107,1.5,-160,4.31,Fenway Park,7,-1
2014-05-29,2014,ARI,CIN,4,0,-128,-1.5,160,8.5,100,-120,118,1.5,-190,4.77,Chase Field,4,4
2014-05-29,2014,OAK,DET,4,5,-143,-1.5,150,8.0,-115,-105,128,1.5,-170,4.71,Oakland Coliseum,9,-1
2014-05-29,2014,BAL,HOU,1,3,-120,-1.5,140,9.0,-125,105,110,1.5,-160,4.91,Minute Maid Park,4,-2
2014-05-29,2014,TOR,KC,6,8,-128,-1.5,160,8.0,-110,-110,118,1.5,-190,4.49,Rogers Centre,14,-2
2014-05-29,2014,SEA,LAA,5,7,112,1.5,-160,8.0,100,-120,-122,-1.5,140,3.77,T-Mobile Park,12,-2
2014-05-29,2014,PIT,LAD,6,3,100,1.5,-215,7.0,-115,-105,-110,-1.5,185,3.5,Dodger Stadium,9,3
2014-05-29,2014,TEX,MIN,5,4,112,1.5,-190,8.5,-125,105,-122,-1.5,160,4.01,Target Field,9,1
2014-05-29,2014,PHI,NYM,1,4,100,1.5,-170,7.5,-107,-113,-110,-1.5,150,3.75,Citizens Bank Park,5,-3
2014-05-29,2014,DET,OAK,5,4,128,1.5,-170,8.0,-115,-105,-143,-1.5,150,3.51,Oakland Coliseum,9,1
2014-05-29,2014,NYM,PHI,4,1,-110,-1.5,150,7.5,-107,-113,100,1.5,-170,3.93,Citizens Bank Park,5,3
2014-05-29,2014,LAD,PIT,3,6,-110,-1.5,185,7.0,-115,-105,100,1.5,-215,3.67,Dodger Stadium,9,-3
2014-05-29,2014,LAA,SEA,7,5,-122,-1.5,140,8.0,100,-120,112,1.5,-160,4.4,T-Mobile Park,12,2
2014-05-29,2014,STL,SF,5,6,-150,-1.5,145,7.5,105,-125,135,1.5,-165,4.5,Busch Stadium,11,-1
2014-05-29,2014,SF,STL,6,5,135,1.5,-165,7.5,105,-125,-150,-1.5,145,3.19,Busch Stadium,11,1
2014-05-29,2014,MIN,TEX,4,5,-122,-1.5,160,8.5,-125,105,112,1.5,-190,4.67,Target Field,9,-1
2014-05-29,2014,KC,TOR,8,6,118,1.5,-190,8.0,-110,-110,-128,-1.5,160,3.67,Rogers Centre,14,2
2014-05-30,2014,CIN,ARI,6,4,107,1.5,-205,8.5,-110,-110,-117,-1.5,175,4.11,Chase Field,10,2
2014-05-30,2014,MIA,ATL,2,3,115,1.5,-150,7.5,105,-125,-130,-1.5,130,3.49,Marlins Park,5,-1
2014-05-30,2014,HOU,BAL,2,1,100,1.5,-160,9.0,100,-120,-110,-1.5,140,4.5,Minute Maid Park,3,1
2014-05-30,2014,TB,BOS,2,3,-145,-1.5,110,8.0,102,-122,130,1.5,-130,4.73,Fenway Park,5,-1
2014-05-30,2014,MIL,CHC,11,5,-171,-1.5,130,8.0,-105,-115,151,1.5,-150,5.05,Miller Park,16,6
2014-05-30,2014,ARI,CIN,4,6,-117,-1.5,175,8.5,-110,-110,107,1.5,-205,4.58,Chase Field,10,-2
2014-05-30,2014,COL,CLE,2,5,150,1.5,-150,7.5,-110,-110,-165,-1.5,130,3.0,Progressive Field,7,-3
2014-05-30,2014,CLE,COL,5,2,-165,-1.5,130,7.5,-110,-110,150,1.5,-150,4.67,Progressive Field,7,3
2014-05-30,2014,SD,CWS,4,1,-123,-1.5,130,8.0,-115,-105,113,1.5,-150,4.41,Guaranteed Rate Field,5,3
2014-05-30,2014,SEA,DET,3,6,-109,-1.5,190,7.0,-115,-105,-101,1.5,-220,3.65,T-Mobile Park,9,-3
2014-05-30,2014,BAL,HOU,1,2,-110,-1.5,140,9.0,100,-120,100,1.5,-160,4.71,Minute Maid Park,3,-1
2014-05-30,2014,TOR,KC,1,6,-125,-1.5,160,8.5,-120,100,115,1.5,-190,4.72,Rogers Centre,7,-5
2014-05-30,2014,OAK,LAA,9,5,-118,-1.5,175,7.5,-115,-105,108,1.5,-205,4.06,Oakland Coliseum,14,4
2014-05-30,2014,PIT,LAD,2,1,-101,1.5,-220,7.0,-120,100,-109,-1.5,190,3.52,Dodger Stadium,3,1
2014-05-30,2014,ATL,MIA,3,2,-130,-1.5,130,7.5,105,-125,115,1.5,-150,4.24,Marlins Park,5,1
2014-05-30,2014,CHC,MIL,5,11,151,1.5,-150,8.0,-105,-115,-171,-1.5,130,3.19,Miller Park,16,-6
2014-05-30,2014,NYY,MIN,1,6,-145,-1.5,145,9.0,-105,-115,130,1.5,-165,5.33,Yankee Stadium,7,-5
2014-05-30,2014,PHI,NYM,6,5,-134,-1.5,160,7.5,-115,-105,119,1.5,-190,4.29,Citizens Bank Park,11,1
2014-05-30,2014,MIN,NYY,6,1,130,1.5,-165,9.0,-105,-115,-145,-1.5,145,3.91,Yankee Stadium,7,5
2014-05-30,2014,LAA,OAK,5,9,108,1.5,-205,7.5,-115,-105,-118,-1.5,175,3.61,Oakland Coliseum,14,-4
2014-05-30,2014,NYM,PHI,5,6,119,1.5,-190,7.5,-115,-105,-134,-1.5,160,3.42,Citizens Bank Park,11,-1
2014-05-30,2014,LAD,PIT,1,2,-109,-1.5,190,7.0,-120,100,-101,1.5,-220,3.65,Dodger Stadium,3,-1
2014-05-30,2014,CWS,SD,1,4,113,1.5,-150,8.0,-115,-105,-123,-1.5,130,3.76,Guaranteed Rate Field,5,-3
2014-05-30,2014,DET,SEA,6,3,-101,1.5,-220,7.0,-115,-105,-109,-1.5,190,3.52,T-Mobile Park,9,3
2014-05-30,2014,STL,SF,4,9,-150,-1.5,155,6.5,-110,-110,135,1.5,-175,3.9,Busch Stadium,13,-5
2014-05-30,2014,SF,STL,9,4,135,1.5,-175,6.5,-110,-110,-150,-1.5,155,2.77,Busch Stadium,13,5
2014-05-30,2014,BOS,TB,3,2,130,1.5,-130,8.0,102,-122,-145,-1.5,110,3.48,Fenway Park,5,1
2014-05-30,2014,WSH,TEX,9,2,-174,-1.5,125,7.0,105,-125,154,1.5,-145,4.45,Nationals Park,11,7
2014-05-30,2014,KC,TOR,6,1,115,1.5,-190,8.5,-120,100,-125,-1.5,160,3.95,Rogers Centre,7,5
2014-05-30,2014,TEX,WSH,2,9,154,1.5,-145,7.0,105,-125,-174,-1.5,125,2.76,Nationals Park,11,-7
2014-05-31,2014,CIN,ARI,5,0,113,1.5,-210,7.5,-105,-115,-123,-1.5,180,3.52,Chase Field,5,5
2014-05-31,2014,MIA,ATL,5,9,104,1.5,-165,8.0,-105,-115,-114,-1.5,145,3.92,Marlins Park,14,-4
2014-05-31,2014,HOU,BAL,1,4,-113,-1.5,170,8.0,-115,-105,103,1.5,-200,4.24,Minute Maid Park,5,-3
2014-05-31,2014,TB,BOS,1,7,-105,-1.5,150,8.5,-110,-110,-105,1.5,-170,4.35,Fenway Park,8,-6
2014-05-31,2014,MIL,CHC,0,8,-145,-1.5,150,7.5,-105,-115,130,1.5,-170,4.44,Miller Park,8,-8
2014-05-31,2014,ARI,CIN,0,5,-123,-1.5,180,7.5,-105,-115,113,1.5,-210,4.14,Chase Field,5,-5
2014-05-31,2014,COL,CLE,6,7,115,1.5,-190,8.5,-110,-110,-130,-1.5,160,3.95,Progressive Field,13,-1
2014-05-31,2014,CLE,COL,7,6,-130,-1.5,160,8.5,-110,-110,115,1.5,-190,4.8,Progressive Field,13,1
2014-05-31,2014,SD,CWS,4,2,-132,-1.5,125,8.5,-107,-113,117,1.5,-145,4.84,Guaranteed Rate Field,6,2
2014-05-31,2014,SEA,DET,3,2,136,1.5,-135,7.5,-115,-105,-151,-1.5,115,3.18,T-Mobile Park,5,1
2014-05-31,2014,BAL,HOU,4,1,103,1.5,-200,8.0,-115,-105,-113,-1.5,170,3.94,Minute Maid Park,5,3
2014-05-31,2014,TOR,KC,12,2,-170,-1.5,120,9.0,-124,104,150,1.5,-140,5.67,Rogers Centre,14,10
2014-05-31,2014,OAK,LAA,11,3,-134,-1.5,160,7.5,-105,-115,119,1.5,-190,4.29,Oakland Coliseum,14,8
2014-05-31,2014,PIT,LAD,2,12,136,1.5,-165,7.0,-110,-110,-151,-1.5,145,2.97,Dodger Stadium,14,-10
2014-05-31,2014,ATL,MIA,9,5,-114,-1.5,145,8.0,-105,-115,104,1.5,-165,4.26,Marlins Park,14,4
2014-05-31,2014,CHC,MIL,8,0,130,1.5,-170,7.5,-105,-115,-145,-1.5,150,3.26,Miller Park,8,8
2014-05-31,2014,NYY,MIN,3,1,-280,-1.5,-130,8.5,-110,-110,240,1.5,110,6.26,Yankee Stadium,4,2
2014-05-31,2014,PHI,NYM,4,5,-113,-1.5,185,8.0,-110,-110,103,1.5,-215,4.24,Citizens Bank Park,9,-1
2014-05-31,2014,MIN,NYY,1,3,240,1.5,110,8.5,-110,-110,-280,-1.5,-130,2.5,Yankee Stadium,4,-2
2014-05-31,2014,LAA,OAK,3,11,119,1.5,-190,7.5,-105,-115,-134,-1.5,160,3.42,Oakland Coliseum,14,-8
2014-05-31,2014,NYM,PHI,5,4,103,1.5,-215,8.0,-110,-110,-113,-1.5,185,3.94,Citizens Bank Park,9,1
2014-05-31,2014,LAD,PIT,12,2,-151,-1.5,145,7.0,-110,-110,136,1.5,-165,4.21,Dodger Stadium,14,10
2014-05-31,2014,CWS,SD,2,4,117,1.5,-145,8.5,-107,-113,-132,-1.5,125,3.92,Guaranteed Rate Field,6,-2
2014-05-31,2014,DET,SEA,2,3,-151,-1.5,115,7.5,-115,-105,136,1.5,-135,4.51,T-Mobile Park,5,-1
2014-05-31,2014,STL,SF,2,0,-195,-1.5,115,7.5,105,-125,175,1.5,-135,4.96,Busch Stadium,2,2
2014-05-31,2014,SF,STL,0,2,175,1.5,-135,7.5,105,-125,-195,-1.5,115,2.73,Busch Stadium,2,-2
2014-05-31,2014,BOS,TB,7,1,-105,1.5,-170,8.5,-110,-110,-105,-1.5,150,4.35,Fenway Park,8,6
2014-05-31,2014,WSH,TEX,10,2,-126,-1.5,170,7.0,-110,-110,116,1.5,-200,3.9,Nationals Park,12,8
2014-05-31,2014,KC,TOR,2,12,150,1.5,-140,9.0,-124,104,-170,-1.5,120,3.6,Rogers Centre,14,-10
2014-05-31,2014,TEX,WSH,2,10,116,1.5,-200,7.0,-110,-110,-126,-1.5,170,3.24,Nationals Park,12,-8
2014-06-01,2014,CIN,ARI,4,3,125,1.5,-175,8.0,-119,-101,-140,-1.5,155,3.56,Chase Field,7,1
2014-06-01,2014,MIA,ATL,2,4,-120,-1.5,176,7.5,108,-128,110,1.5,-207,4.09,Marlins Park,6,-2
2014-06-01,2014,HOU,BAL,4,9,104,1.5,-165,9.0,-105,-115,-114,-1.5,145,4.41,Minute Maid Park,13,-5
2014-06-01,2014,TB,BOS,0,4,148,1.5,-150,8.0,-115,-105,-163,-1.5,130,3.23,Fenway Park,4,-4
2014-06-01,2014,MIL,CHC,9,0,-148,-1.5,150,7.0,-125,105,133,1.5,-170,4.18,Miller Park,9,9
2014-06-01,2014,ARI,CIN,3,4,-140,-1.5,155,8.0,-119,-101,125,1.5,-175,4.67,Chase Field,7,-1
2014-06-01,2014,COL,CLE,4,6,113,1.5,-190,9.0,-105,-115,-123,-1.5,160,4.23,Progressive Field,10,-2
2014-06-01,2014,CLE,COL,6,4,-123,-1.5,160,9.0,-105,-115,113,1.5,-190,4.96,Progressive Field,10,2
2014-06-01,2014,SD,CWS,1,4,170,1.5,-135,8.0,-115,-105,-190,-1.5,115,2.96,Guaranteed Rate Field,5,-3
2014-06-01,2014,SEA,DET,4,0,143,1.5,-125,7.5,105,-125,-158,-1.5,105,3.09,T-Mobile Park,4,4
2014-06-01,2014,BAL,HOU,9,4,-114,-1.5,145,9.0,-105,-115,104,1.5,-165,4.79,Minute Maid Park,13,5
2014-06-01,2014,TOR,KC,4,0,-154,-1.5,125,9.0,-103,-117,139,1.5,-145,5.46,Rogers Centre,4,4
2014-06-01,2014,OAK,LAA,6,3,-153,-1.5,140,7.5,-105,-115,138,1.5,-160,4.54,Oakland Coliseum,9,3
2014-06-01,2014,PIT,LAD,5,3,175,1.5,-135,7.0,-125,105,-195,-1.5,115,2.55,Dodger Stadium,8,2
2014-06-01,2014,ATL,MIA,4,2,110,1.5,-207,7.5,108,-128,-120,-1.5,176,3.57,Marlins Park,6,2
2014-06-01,2014,CHC,MIL,0,9,133,1.5,-170,7.0,-125,105,-148,-1.5,150,3.0,Miller Park,9,-9
2014-06-01,2014,NYY,MIN,2,7,-131,-1.5,155,8.5,-110,-110,116,1.5,-175,4.82,Yankee Stadium,9,-5
2014-06-01,2014,PHI,NYM,3,4,-133,-1.5,165,7.0,-110,-110,118,1.5,-195,4.0,Citizens Bank Park,7,-1
2014-06-01,2014,MIN,NYY,7,2,116,1.5,-175,8.5,-110,-110,-131,-1.5,155,3.94,Yankee Stadium,9,5
2014-06-01,2014,LAA,OAK,3,6,138,1.5,-160,7.5,-105,-115,-153,-1.5,140,3.15,Oakland Coliseum,9,-3
2014-06-01,2014,NYM,PHI,4,3,118,1.5,-195,7.0,-110,-110,-133,-1.5,165,3.21,Citizens Bank Park,7,1
2014-06-01,2014,LAD,PIT,3,5,-195,-1.5,115,7.0,-125,105,175,1.5,-135,4.63,Dodger Stadium,8,-2
2014-06-01,2014,CWS,SD,4,1,-190,-1.5,115,8.0,-115,-105,170,1.5,-135,5.24,Guaranteed Rate Field,5,3
2014-06-01,2014,DET,SEA,0,4,-158,-1.5,105,7.5,105,-125,143,1.5,-125,4.59,T-Mobile Park,4,-4
2014-06-01,2014,STL,SF,0,8,-107,-1.5,190,7.5,100,-120,-103,1.5,-230,3.88,Busch Stadium,8,-8
2014-06-01,2014,SF,STL,8,0,-103,1.5,-230,7.5,100,-120,-107,-1.5,190,3.81,Busch Stadium,8,8
2014-06-01,2014,BOS,TB,4,0,-163,-1.5,130,8.0,-115,-105,148,1.5,-150,4.96,Fenway Park,4,4
2014-06-01,2014,WSH,TEX,0,2,112,1.5,-165,6.5,-105,-115,-122,-1.5,145,3.07,Nationals Park,2,-2
2014-06-01,2014,KC,TOR,0,4,139,1.5,-145,9.0,-103,-117,-154,-1.5,125,3.77,Rogers Centre,4,-4
2014-06-01,2014,TEX,WSH,2,0,-122,-1.5,145,6.5,-105,-115,112,1.5,-165,3.57,Nationals Park,2,2
2014-06-02,2014,CLE,BOS,3,2,108,1.5,-155,8.0,-120,100,-118,-1.5,135,3.85,Progressive Field,5,1
2014-06-02,2014,BOS,CLE,2,3,-118,-1.5,135,8.0,-120,100,108,1.5,-155,4.33,Progressive Field,5,-1
2014-06-02,2014,LAD,CWS,5,2,-200,-1.5,110,6.0,-105,-115,170,1.5,-130,4.0,Dodger Stadium,7,3
2014-06-02,2014,STL,KC,0,6,-148,-1.5,150,7.5,-120,100,133,1.5,-170,4.48,Busch Stadium,6,-6
2014-06-02,2014,CWS,LAD,2,5,170,1.5,-130,6.0,-105,-115,-200,-1.5,110,2.22,Dodger Stadium,7,-3
2014-06-02,2014,TB,MIA,1,3,-140,-1.5,120,7.0,-115,-105,125,1.5,-140,4.08,Marlins Park,4,-2
2014-06-02,2014,MIN,MIL,2,6,152,1.5,-140,8.5,-110,-110,-172,-1.5,120,3.37,Miller Park,8,-4
2014-06-02,2014,MIL,MIN,6,2,-172,-1.5,120,8.5,-110,-110,152,1.5,-140,5.38,Miller Park,8,4
2014-06-02,2014,PHI,NYM,2,11,100,1.5,-160,8.5,-110,-110,-110,-1.5,140,4.25,Citizens Bank Park,13,-9
2014-06-02,2014,SEA,NYY,10,2,-131,-1.5,125,7.5,-105,-115,116,1.5,-145,4.25,Yankee Stadium,12,8
2014-06-02,2014,NYM,PHI,11,2,-110,-1.5,140,8.5,-110,-110,100,1.5,-160,4.45,Citizens Bank Park,13,9
2014-06-02,2014,SD,PIT,3,10,-118,-1.5,185,7.0,100,-120,108,1.5,-215,3.79,PETCO Park,13,-7
2014-06-02,2014,PIT,SD,10,3,108,1.5,-215,7.0,100,-120,-118,-1.5,185,3.37,PETCO Park,13,7
2014-06-02,2014,NYY,SEA,2,10,116,1.5,-145,7.5,-105,-115,-131,-1.5,125,3.47,Yankee Stadium,12,-8
2014-06-02,2014,KC,STL,6,0,133,1.5,-170,7.5,-120,100,-148,-1.5,150,3.22,Busch Stadium,6,6
2014-06-02,2014,MIA,TB,3,1,125,1.5,-140,7.0,-115,-105,-140,-1.5,120,3.11,Marlins Park,4,2
2014-06-03,2014,COL,ARI,2,4,-168,-1.5,110,10.5,-103,-117,153,1.5,-130,6.58,Coors Field,6,-2
2014-06-03,2014,SEA,ATL,7,5,151,1.5,-150,7.5,-119,-101,-171,-1.5,130,2.99,Turner Field,12,2
2014-06-03,2014,TEX,BAL,3,8,-109,-1.5,175,9.5,-110,-110,-101,1.5,-205,4.95,Rangers Ballpark,11,-5
2014-06-03,2014,CLE,BOS,5,3,-118,-1.5,170,8.5,-110,-110,108,1.5,-200,4.6,Progressive Field,8,2
2014-06-03,2014,NYM,CHC,1,2,102,1.5,-210,7.5,-120,100,-112,-1.5,180,3.71,Wrigley Field,3,-1
2014-06-03,2014,SF,CIN,3,8,117,1.5,-200,7.5,-110,-110,-132,-1.5,170,3.46,Great American Ballpark,11,-5
2014-06-03,2014,BOS,CLE,3,5,108,1.5,-200,8.5,-110,-110,-118,-1.5,170,4.09,Progressive Field,8,-2
2014-06-03,2014,ARI,COL,4,2,153,1.5,-130,10.5,-103,-117,-168,-1.5,110,4.15,Coors Field,6,2
2014-06-03,2014,LAD,CWS,1,4,-175,-1.5,120,7.5,-110,-110,155,1.5,-140,4.77,Dodger Stadium,5,-3
2014-06-03,2014,TOR,DET,5,3,130,1.5,-165,9.0,-104,-116,-145,-1.5,145,3.91,Comerica Park,8,2
2014-06-03,2014,LAA,HOU,2,7,-134,-1.5,120,9.0,105,-125,119,1.5,-140,5.15,Minute Maid Park,9,-5
2014-06-03,2014,STL,KC,7,8,-121,-1.5,175,7.0,-105,-115,111,1.5,-205,3.83,Busch Stadium,15,-1
2014-06-03,2014,HOU,LAA,7,2,119,1.5,-140,9.0,105,-125,-134,-1.5,120,4.11,Minute Maid Park,9,5
2014-06-03,2014,CWS,LAD,4,1,155,1.5,-140,7.5,-110,-110,-175,-1.5,120,2.94,Dodger Stadium,5,3
2014-06-03,2014,TB,MIA,0,1,-117,-1.5,150,7.0,-105,-115,107,1.5,-170,3.77,Marlins Park,1,-1
2014-06-03,2014,MIN,MIL,6,4,139,1.5,-160,8.5,-111,-109,-154,-1.5,140,3.56,Miller Park,10,2
2014-06-03,2014,MIL,MIN,4,6,-154,-1.5,140,8.5,-111,-109,139,1.5,-160,5.15,Miller Park,10,-2
2014-06-03,2014,CHC,NYM,2,1,-112,-1.5,180,7.5,-120,100,102,1.5,-210,3.96,Wrigley Field,3,1
2014-06-03,2014,OAK,NYY,5,2,-117,-1.5,135,8.5,-113,-107,107,1.5,-155,4.58,Yankee Stadium,7,3
2014-06-03,2014,NYY,OAK,2,5,107,1.5,-155,8.5,-113,-107,-117,-1.5,135,4.11,Yankee Stadium,7,-3
2014-06-03,2014,WSH,PHI,7,0,-210,-1.5,105,8.0,-110,-110,180,1.5,-125,5.42,Nationals Park,7,7
2014-06-03,2014,SD,PIT,1,4,116,1.5,-160,6.5,-115,-105,-126,-1.5,140,3.01,PETCO Park,5,-3
2014-06-03,2014,PIT,SD,4,1,-126,-1.5,140,6.5,-115,-105,116,1.5,-160,3.62,PETCO Park,5,3
2014-06-03,2014,ATL,SEA,5,7,-171,-1.5,130,7.5,-119,-101,151,1.5,-150,4.73,Turner Field,12,-2
2014-06-03,2014,CIN,SF,8,3,-132,-1.5,170,7.5,-110,-110,117,1.5,-200,4.27,Great American Ballpark,11,5
2014-06-03,2014,KC,STL,8,7,111,1.5,-205,7.0,-105,-115,-121,-1.5,175,3.32,Busch Stadium,15,1
2014-06-03,2014,MIA,TB,1,0,107,1.5,-170,7.0,-105,-115,-117,-1.5,150,3.38,Marlins Park,1,1
2014-06-03,2014,BAL,TEX,8,3,-101,1.5,-205,9.5,-110,-110,-109,-1.5,175,4.77,Rangers Ballpark,11,5
2014-06-03,2014,DET,TOR,3,5,-145,-1.5,145,9.0,-104,-116,130,1.5,-165,5.33,Comerica Park,8,-2
2014-06-03,2014,PHI,WSH,0,7,180,1.5,-125,8.0,-110,-110,-210,-1.5,105,2.86,Nationals Park,7,-7
2014-06-04,2014,COL,ARI,8,16,-132,-1.5,150,10.5,-105,-115,117,1.5,-170,5.97,Coors Field,24,-8
2014-06-04,2014,SEA,ATL,2,0,125,1.5,-175,6.5,-125,105,-140,-1.5,155,2.89,Turner Field,2,2
2014-06-04,2014,TEX,BAL,5,6,100,1.5,-160,9.5,-105,-115,-110,-1.5,140,4.75,Rangers Ballpark,11,-1
2014-06-04,2014,CLE,BOS,7,4,-147,-1.5,145,7.5,-105,-115,132,1.5,-165,4.46,Progressive Field,11,3
2014-06-04,2014,NYM,CHC,4,5,112,1.5,-205,7.0,-105,-115,-122,-1.5,175,3.3,Wrigley Field,9,-1
2014-06-04,2014,SF,CIN,3,2,101,1.5,-215,8.0,-110,-110,-111,-1.5,185,3.98,Great American Ballpark,5,1
2014-06-04,2014,BOS,CLE,4,7,132,1.5,-165,7.5,-105,-115,-147,-1.5,145,3.23,Progressive Field,11,-3
2014-06-04,2014,ARI,COL,16,8,117,1.5,-170,10.5,-105,-115,-132,-1.5,150,4.84,Coors Field,24,8
2014-06-04,2014,LAD,CWS,1,2,-183,-1.5,120,7.5,-105,-115,163,1.5,-140,4.85,Dodger Stadium,3,-1
2014-06-04,2014,TOR,DET,8,2,-101,1.5,-215,9.0,-115,-105,-109,-1.5,185,4.52,Comerica Park,10,6
2014-06-04,2014,LAA,HOU,4,0,-120,-1.5,131,9.0,-104,-116,110,1.5,-151,4.91,Minute Maid Park,4,4
2014-06-04,2014,STL,KC,5,2,-124,-1.5,130,7.0,-120,100,114,1.5,-150,3.88,Kauffman Stadium,7,3
2014-06-04,2014,HOU,LAA,0,4,110,1.5,-151,9.0,-104,-116,-120,-1.5,131,4.29,Minute Maid Park,4,-4
2014-06-04,2014,CWS,LAD,2,1,163,1.5,-140,7.5,-105,-115,-183,-1.5,120,2.85,Dodger Stadium,3,1
2014-06-04,2014,TB,MIA,4,5,-225,-1.5,100,7.0,100,-120,195,1.5,-120,4.85,Tropicana Field,9,-1
2014-06-04,2014,MIN,MIL,6,4,112,1.5,-155,8.5,-120,100,-122,-1.5,135,4.01,Target Field,10,2
2014-06-04,2014,MIL,MIN,4,6,-122,-1.5,135,8.5,-120,100,112,1.5,-155,4.67,Target Field,10,-2
2014-06-04,2014,CHC,NYM,5,4,-122,-1.5,175,7.0,-105,-115,112,1.5,-205,3.85,Wrigley Field,9,1
2014-06-04,2014,OAK,NYY,7,4,-134,-1.5,115,9.0,-105,-115,119,1.5,-135,5.15,Yankee Stadium,11,3
2014-06-04,2014,NYY,OAK,4,7,119,1.5,-135,9.0,-105,-115,-134,-1.5,115,4.11,Yankee Stadium,11,-3
2014-06-04,2014,WSH,PHI,8,4,-200,-1.5,115,7.0,-115,-105,170,1.5,-135,4.67,Nationals Park,12,4
2014-06-04,2014,SD,PIT,3,2,-115,-1.5,190,6.5,-108,-112,105,1.5,-230,3.48,PETCO Park,5,1
2014-06-04,2014,PIT,SD,2,3,105,1.5,-230,6.5,-108,-112,-115,-1.5,190,3.17,PETCO Park,5,-1
2014-06-04,2014,ATL,SEA,0,2,-140,-1.5,155,6.5,-125,105,125,1.5,-175,3.79,Turner Field,2,-2
2014-06-04,2014,CIN,SF,2,3,-111,-1.5,185,8.0,-110,-110,101,1.5,-215,4.21,Great American Ballpark,5,-1
2014-06-04,2014,KC,STL,2,5,114,1.5,-150,7.0,-120,100,-124,-1.5,130,3.27,Kauffman Stadium,7,-3
2014-06-04,2014,MIA,TB,5,4,195,1.5,-120,7.0,100,-120,-225,-1.5,100,2.37,Tropicana Field,9,1
2014-06-04,2014,BAL,TEX,6,5,-110,-1.5,140,9.5,-105,-115,100,1.5,-160,4.98,Rangers Ballpark,11,1
2014-06-04,2014,DET,TOR,2,8,-109,-1.5,185,9.0,-115,-105,-101,1.5,-215,4.69,Comerica Park,10,-6
2014-06-04,2014,PHI,WSH,4,8,170,1.5,-135,7.0,-115,-105,-200,-1.5,115,2.59,Nationals Park,12,-4
2014-06-05,2014,COL,ARI,7,12,-130,-1.5,150,10.0,100,-120,115,1.5,-170,5.65,Coors Field,19,-5
2014-06-05,2014,TEX,BAL,8,6,-109,-1.5,175,9.5,-109,-111,-101,1.5,-205,4.95,Rangers Ballpark,14,2
2014-06-05,2014,NYM,CHC,4,7,108,1.5,-210,7.5,100,-120,-118,-1.5,180,3.61,Wrigley Field,11,-3
2014-06-05,2014,SF,CIN,6,1,-126,-1.5,135,7.0,100,-120,116,1.5,-155,3.9,Great American Ballpark,7,5
2014-06-05,2014,ARI,COL,12,7,115,1.5,-170,10.0,100,-120,-130,-1.5,150,4.65,Coors Field,19,5
2014-06-05,2014,TOR,DET,7,3,153,1.5,-140,9.0,-120,100,-168,-1.5,120,3.56,Comerica Park,10,4
2014-06-05,2014,LAA,HOU,5,8,-143,-1.5,110,9.5,-101,-119,128,1.5,-130,5.59,Minute Maid Park,13,-3
2014-06-05,2014,STL,KC,2,3,-107,-1.5,150,7.5,105,-125,-103,1.5,-170,3.88,Kauffman Stadium,5,-1
2014-06-05,2014,HOU,LAA,8,5,128,1.5,-130,9.5,-101,-119,-143,-1.5,110,4.17,Minute Maid Park,13,3
2014-06-05,2014,TB,MIA,6,11,-176,-1.5,120,7.5,-105,-115,156,1.5,-140,4.78,Tropicana Field,17,-5
2014-06-05,2014,MIN,MIL,5,8,117,1.5,-145,9.0,-105,-115,-132,-1.5,125,4.15,Target Field,13,-3
2014-06-05,2014,MIL,MIN,8,5,-132,-1.5,125,9.0,-105,-115,117,1.5,-145,5.12,Target Field,13,3
2014-06-05,2014,CHC,NYM,7,4,-118,-1.5,180,7.5,100,-120,108,1.5,-210,4.06,Wrigley Field,11,3
2014-06-05,2014,OAK,NYY,1,2,135,1.5,-160,8.0,-105,-115,-150,-1.5,140,3.4,Yankee Stadium,3,-1
2014-06-05,2014,NYY,OAK,2,1,-150,-1.5,140,8.0,-105,-115,135,1.5,-160,4.8,Yankee Stadium,3,1
2014-06-05,2014,WSH,PHI,4,2,-215,-1.5,-101,7.5,100,-120,185,1.5,-119,5.12,Nationals Park,6,2
2014-06-05,2014,CIN,SF,1,6,116,1.5,-155,7.0,100,-120,-126,-1.5,135,3.24,Great American Ballpark,7,-5
2014-06-05,2014,KC,STL,3,2,-103,1.5,-170,7.5,105,-125,-107,-1.5,150,3.81,Kauffman Stadium,5,1
2014-06-05,2014,MIA,TB,11,6,156,1.5,-140,7.5,-105,-115,-176,-1.5,120,2.93,Tropicana Field,17,5
2014-06-05,2014,BAL,TEX,6,8,-101,1.5,-205,9.5,-109,-111,-109,-1.5,175,4.77,Rangers Ballpark,14,-2
2014-06-05,2014,DET,TOR,3,7,-168,-1.5,120,9.0,-120,100,153,1.5,-140,5.64,Comerica Park,10,-4
2014-06-05,2014,PHI,WSH,2,4,185,1.5,-119,7.5,100,-120,-215,-1.5,-101,2.63,Nationals Park,6,-2
2014-06-06,2014,ATL,ARI,5,2,-114,-1.5,140,7.5,100,-120,104,1.5,-160,4.0,Chase Field,7,3
2014-06-06,2014,ARI,ATL,2,5,104,1.5,-160,7.5,100,-120,-114,-1.5,140,3.68,Chase Field,7,-3
2014-06-06,2014,OAK,BAL,4,3,-109,-1.5,145,9.0,-105,-115,-101,1.5,-165,4.69,Camden Yards,7,1
2014-06-06,2014,DET,BOS,6,2,-149,-1.5,150,8.0,-113,-107,134,1.5,-170,4.79,Comerica Park,8,4
2014-06-06,2014,MIA,CHC,3,5,113,1.5,-200,7.0,-105,-115,-123,-1.5,170,3.29,Wrigley Field,8,-2
2014-06-06,2014,PHI,CIN,8,0,116,1.5,-200,6.5,-113,-107,-131,-1.5,170,3.01,Great American Ballpark,8,8
2014-06-06,2014,TEX,CLE,6,4,-160,-1.5,130,8.0,-110,-110,145,1.5,-150,4.92,Rangers Ballpark,10,2
2014-06-06,2014,LAD,COL,7,2,-120,-1.5,130,10.0,-120,100,110,1.5,-150,5.45,Coors Field,9,5
2014-06-06,2014,LAA,CWS,8,4,-205,-1.5,100,8.5,-115,-105,175,1.5,-120,5.71,Angel Stadium,12,4
2014-06-06,2014,BOS,DET,2,6,134,1.5,-170,8.0,-113,-107,-149,-1.5,150,3.42,Comerica Park,8,-4
2014-06-06,2014,MIN,HOU,4,5,-114,-1.5,180,8.0,-120,100,104,1.5,-210,4.26,Target Field,9,-1
2014-06-06,2014,NYY,KC,4,2,-112,-1.5,145,8.0,-110,-110,102,1.5,-165,4.23,Kauffman Stadium,6,2
2014-06-06,2014,CWS,LAA,4,8,175,1.5,-120,8.5,-115,-105,-205,-1.5,100,3.09,Angel Stadium,12,-4
2014-06-06,2014,COL,LAD,2,7,110,1.5,-150,10.0,-120,100,-120,-1.5,130,4.76,Coors Field,9,-5
2014-06-06,2014,CHC,MIA,5,3,-123,-1.5,170,7.0,-105,-115,113,1.5,-200,3.86,Wrigley Field,8,2
2014-06-06,2014,PIT,MIL,15,5,-101,1.5,-165,7.5,-102,-118,-109,-1.5,145,3.77,PNC Park,20,10
2014-06-06,2014,HOU,MIN,5,4,104,1.5,-210,8.0,-120,100,-114,-1.5,180,3.92,Target Field,9,1
2014-06-06,2014,SF,NYM,4,2,-157,-1.5,140,7.0,105,-125,142,1.5,-160,4.28,AT&T Park,6,2
2014-06-06,2014,KC,NYY,2,4,102,1.5,-165,8.0,-110,-110,-112,-1.5,145,3.96,Kauffman Stadium,6,-2
2014-06-06,2014,BAL,OAK,3,4,-101,1.5,-165,9.0,-105,-115,-109,-1.5,145,4.52,Camden Yards,7,-1
2014-06-06,2014,CIN,PHI,0,8,-131,-1.5,170,6.5,-113,-107,116,1.5,-200,3.69,Great American Ballpark,8,-8
2014-06-06,2014,MIL,PIT,5,15,-109,-1.5,145,7.5,-102,-118,-101,1.5,-165,3.91,PNC Park,20,-10
2014-06-06,2014,WSH,SD,6,0,105,1.5,-220,7.0,110,-130,-115,-1.5,190,3.41,PETCO Park,6,6
2014-06-06,2014,TB,SEA,4,0,-150,-1.5,140,8.0,-110,-110,135,1.5,-160,4.8,Tropicana Field,4,4
2014-06-06,2014,NYM,SF,2,4,142,1.5,-160,7.0,105,-125,-157,-1.5,140,2.89,AT&T Park,6,-2
2014-06-06,2014,TOR,STL,3,1,-157,-1.5,135,9.5,-110,-110,142,1.5,-155,5.8,Rogers Centre,4,2
2014-06-06,2014,SEA,TB,0,4,135,1.5,-160,8.0,-110,-110,-150,-1.5,140,3.4,Tropicana Field,4,-4
2014-06-06,2014,CLE,TEX,4,6,145,1.5,-150,8.0,-110,-110,-160,-1.5,130,3.27,Rangers Ballpark,10,-2
2014-06-06,2014,STL,TOR,1,3,142,1.5,-155,9.5,-110,-110,-157,-1.5,135,3.93,Rogers Centre,4,-2
2014-06-06,2014,SD,WSH,0,6,-115,-1.5,190,7.0,110,-130,105,1.5,-220,3.74,PETCO Park,6,-6
2014-06-07,2014,ATL,ARI,3,4,-119,-1.5,150,8.0,-115,-105,109,1.5,-170,4.35,Chase Field,7,-1
2014-06-07,2014,ARI,ATL,4,3,109,1.5,-170,8.0,-115,-105,-119,-1.5,150,3.83,Chase Field,7,1
2014-06-07,2014,OAK,BAL,3,6,-129,-1.5,120,8.5,-110,-110,119,1.5,-140,4.79,Camden Yards,9,-3
2014-06-07,2014,DET,BOS,8,6,-126,-1.5,165,7.5,-105,-115,116,1.5,-195,4.18,Comerica Park,14,2
2014-06-07,2014,MIA,CHC,2,5,128,1.5,-175,7.5,-112,-108,-143,-1.5,155,3.29,Wrigley Field,7,-3
2014-06-07,2014,PHI,CIN,5,6,130,1.5,-175,8.0,-103,-117,-145,-1.5,155,3.48,Great American Ballpark,11,-1
2014-06-07,2014,TEX,CLE,3,8,-109,-1.5,175,9.5,-120,100,-101,1.5,-205,4.95,Rangers Ballpark,11,-5
2014-06-07,2014,LAD,COL,4,5,-131,-1.5,120,9.5,-115,-105,116,1.5,-140,5.39,Coors Field,9,-1
2014-06-07,2014,LAA,CWS,6,5,107,1.5,-160,7.0,-115,-105,-117,-1.5,140,3.38,Angel Stadium,11,1
2014-06-07,2014,BOS,DET,6,8,116,1.5,-195,7.5,-105,-115,-126,-1.5,165,3.47,Comerica Park,14,-2
2014-06-07,2014,MIN,HOU,8,0,-119,-1.5,170,8.5,-120,100,109,1.5,-200,4.62,Target Field,8,8
2014-06-07,2014,NYY,KC,4,8,108,1.5,-205,8.0,-116,-104,-118,-1.5,175,3.85,Kauffman Stadium,12,-4
2014-06-07,2014,CWS,LAA,5,6,-117,-1.5,140,7.0,-115,-105,107,1.5,-160,3.77,Angel Stadium,11,-1
2014-06-07,2014,COL,LAD,5,4,116,1.5,-140,9.5,-115,-105,-131,-1.5,120,4.4,Coors Field,9,1
2014-06-07,2014,CHC,MIA,5,2,-143,-1.5,155,7.5,-112,-108,128,1.5,-175,4.41,Wrigley Field,7,3
2014-06-07,2014,PIT,MIL,3,9,-114,-1.5,180,8.0,102,-122,104,1.5,-210,4.26,PNC Park,12,-6
2014-06-07,2014,HOU,MIN,0,8,109,1.5,-200,8.5,-120,100,-119,-1.5,170,4.07,Target Field,8,-8
2014-06-07,2014,SF,NYM,5,4,-164,-1.5,145,6.5,-125,105,149,1.5,-165,4.04,AT&T Park,9,1
2014-06-07,2014,KC,NYY,8,4,-118,-1.5,175,8.0,-116,-104,108,1.5,-205,4.33,Kauffman Stadium,12,4
2014-06-07,2014,BAL,OAK,6,3,119,1.5,-140,8.5,-110,-110,-129,-1.5,120,3.88,Camden Yards,9,3
2014-06-07,2014,CIN,PHI,6,5,-145,-1.5,155,8.0,-103,-117,130,1.5,-175,4.73,Great American Ballpark,11,1
2014-06-07,2014,MIL,PIT,9,3,104,1.5,-210,8.0,102,-122,-114,-1.5,180,3.92,PNC Park,12,6
2014-06-07,2014,WSH,SD,3,4,115,1.5,-195,6.5,-120,100,-130,-1.5,165,3.02,PETCO Park,7,-1
2014-06-07,2014,TB,SEA,4,7,-157,-1.5,145,7.0,100,-120,142,1.5,-165,4.28,Tropicana Field,11,-3
2014-06-07,2014,NYM,SF,4,5,149,1.5,-165,6.5,-125,105,-164,-1.5,145,2.61,AT&T Park,9,-1
2014-06-07,2014,TOR,STL,0,5,-160,-1.5,125,9.5,105,-125,145,1.5,-145,5.85,Rogers Centre,5,-5
2014-06-07,2014,SEA,TB,7,4,142,1.5,-165,7.0,100,-120,-157,-1.5,145,2.89,Tropicana Field,11,3
2014-06-07,2014,CLE,TEX,8,3,-101,1.5,-205,9.5,-120,100,-109,-1.5,175,4.77,Rangers Ballpark,11,5
2014-06-07,2014,STL,TOR,5,0,145,1.5,-145,9.5,105,-125,-160,-1.5,125,3.88,Rogers Centre,5,5
2014-06-07,2014,SD,WSH,4,3,-130,-1.5,165,6.5,-120,100,115,1.5,-195,3.67,PETCO Park,7,1
2014-06-08,2014,ATL,ARI,5,6,-105,-1.5,155,8.5,100,-120,-105,1.5,-175,4.35,Chase Field,11,-1
2014-06-08,2014,ARI,ATL,6,5,-105,1.5,-175,8.5,100,-120,-105,-1.5,155,4.35,Chase Field,11,1
2014-06-08,2014,OAK,BAL,11,1,-126,-1.5,125,9.0,-102,-118,116,1.5,-145,5.02,Camden Yards,12,10
2014-06-08,2014,DET,BOS,3,5,-129,-1.5,160,7.5,-110,-110,119,1.5,-190,4.22,Comerica Park,8,-2
2014-06-08,2014,MIA,CHC,4,3,-107,-1.5,155,6.5,-115,-105,-103,1.5,-175,3.36,Wrigley Field,7,1
2014-06-08,2014,PHI,CIN,1,4,150,1.5,-150,7.5,-110,-110,-165,-1.5,130,3.0,Great American Ballpark,5,-3
2014-06-08,2014,TEX,CLE,2,3,108,-1.5,170,9.5,-105,-115,-118,1.5,-200,4.57,Rangers Ballpark,5,-1
2014-06-08,2014,LAD,COL,6,1,-127,-1.5,121,8.5,103,-123,117,1.5,-141,4.76,Coors Field,7,5
2014-06-08,2014,LAA,CWS,4,2,-161,-1.5,130,8.5,100,-120,146,1.5,-150,5.24,Angel Stadium,6,2
2014-06-08,2014,BOS,DET,5,3,119,1.5,-190,7.5,-110,-110,-129,-1.5,160,3.42,Comerica Park,8,2
2014-06-08,2014,MIN,HOU,5,14,-113,-1.5,175,8.0,-105,-115,103,1.5,-205,4.24,Target Field,19,-9
2014-06-08,2014,NYY,KC,1,2,116,1.5,-200,7.0,-125,105,-126,-1.5,170,3.24,Kauffman Stadium,3,-1
2014-06-08,2014,CWS,LAA,2,4,146,1.5,-150,8.5,100,-120,-161,-1.5,130,3.46,Angel Stadium,6,-2
2014-06-08,2014,COL,LAD,1,6,117,1.5,-141,8.5,103,-123,-127,-1.5,121,3.92,Coors Field,7,-5
2014-06-08,2014,CHC,MIA,3,4,-103,1.5,-175,6.5,-115,-105,-107,-1.5,155,3.3,Wrigley Field,7,-1
2014-06-08,2014,PIT,MIL,0,1,105,1.5,-160,8.5,-114,-106,-115,-1.5,140,4.15,PNC Park,1,-1
2014-06-08,2014,HOU,MIN,14,5,103,1.5,-205,8.0,-105,-115,-113,-1.5,175,3.94,Target Field,19,9
2014-06-08,2014,SF,NYM,6,4,-121,-1.5,175,7.5,-110,-110,111,1.5,-205,4.11,AT&T Park,10,2
2014-06-08,2014,KC,NYY,2,1,-126,-1.5,170,7.0,-125,105,116,1.5,-200,3.9,Kauffman Stadium,3,1
2014-06-08,2014,BAL,OAK,1,11,116,1.5,-145,9.0,-102,-118,-126,-1.5,125,4.17,Camden Yards,12,-10
2014-06-08,2014,CIN,PHI,4,1,-165,-1.5,130,7.5,-110,-110,150,1.5,-150,4.67,Great American Ballpark,5,3
2014-06-08,2014,MIL,PIT,1,0,-115,-1.5,140,8.5,-114,-106,105,1.5,-160,4.55,PNC Park,1,1
2014-06-08,2014,WSH,SD,6,0,-122,-1.5,140,7.5,113,-133,112,1.5,-160,4.12,PETCO Park,6,6
2014-06-08,2014,TB,SEA,0,5,109,1.5,-160,6.5,100,-120,-119,-1.5,140,3.11,Tropicana Field,5,-5
2014-06-08,2014,NYM,SF,4,6,111,1.5,-205,7.5,-110,-110,-121,-1.5,175,3.55,AT&T Park,10,-2
2014-06-08,2014,TOR,STL,0,5,-132,-1.5,155,9.0,-105,-115,117,1.5,-175,5.12,Rogers Centre,5,-5
2014-06-08,2014,SEA,TB,5,0,-119,-1.5,140,6.5,100,-120,109,1.5,-160,3.53,Tropicana Field,5,5
2014-06-08,2014,CLE,TEX,3,2,-118,1.5,-200,9.5,-105,-115,108,-1.5,170,5.14,Rangers Ballpark,5,1
2014-06-08,2014,STL,TOR,5,0,117,1.5,-175,9.0,-105,-115,-132,-1.5,155,4.15,Rogers Centre,5,5
2014-06-08,2014,SD,WSH,0,6,112,1.5,-160,7.5,113,-133,-122,-1.5,140,3.54,PETCO Park,6,-6
2014-06-09,2014,HOU,ARI,4,3,133,1.5,-165,8.5,-110,-110,-148,-1.5,145,3.65,Chase Field,7,1
2014-06-09,2014,COL,ATL,1,3,118,1.5,-140,10.0,-105,-115,-128,-1.5,120,4.59,Coors Field,4,-2
2014-06-09,2014,BOS,BAL,0,4,-102,1.5,-210,8.5,-115,-105,-108,-1.5,180,4.29,Camden Yards,4,-4
2014-06-09,2014,BAL,BOS,4,0,-108,-1.5,180,8.5,-115,-105,-102,1.5,-210,4.41,Camden Yards,4,4
2014-06-09,2014,PIT,CHC,6,2,-149,-1.5,140,7.5,105,-125,134,1.5,-160,4.49,PNC Park,8,4
2014-06-09,2014,LAD,CIN,6,2,106,1.5,-210,8.0,-110,-110,-116,-1.5,180,3.88,Great American Ballpark,8,4
2014-06-09,2014,TEX,CLE,7,17,100,1.5,-160,9.5,-110,-110,-110,-1.5,140,4.75,Rangers Ballpark,24,-10
2014-06-09,2014,ATL,COL,3,1,-128,-1.5,120,10.0,-105,-115,118,1.5,-140,5.61,Coors Field,4,2
2014-06-09,2014,DET,CWS,5,6,-126,-1.5,130,8.5,-116,-104,116,1.5,-150,4.74,Guaranteed Rate Field,11,-1
2014-06-09,2014,CWS,DET,6,5,116,1.5,-150,8.5,-116,-104,-126,-1.5,130,3.94,Guaranteed Rate Field,11,1
2014-06-09,2014,ARI,HOU,3,4,-148,-1.5,145,8.5,-110,-110,133,1.5,-165,5.07,Chase Field,7,-1
2014-06-09,2014,OAK,LAA,1,4,113,1.5,-195,8.5,-105,-115,-123,-1.5,165,3.99,Angel Stadium,5,-3
2014-06-09,2014,CIN,LAD,2,6,-116,-1.5,180,8.0,-110,-110,106,1.5,-210,4.3,Great American Ballpark,8,-4
2014-06-09,2014,TOR,MIN,5,4,-181,-1.5,110,9.5,-110,-110,161,1.5,-130,6.12,Rogers Centre,9,1
2014-06-09,2014,LAA,OAK,4,1,-123,-1.5,165,8.5,-105,-115,113,1.5,-195,4.69,Angel Stadium,5,3
2014-06-09,2014,CHC,PIT,2,6,134,1.5,-160,7.5,105,-125,-149,-1.5,140,3.21,PNC Park,8,-4
2014-06-09,2014,TB,SEA,0,3,-210,-1.5,105,7.0,-110,-110,180,1.5,-125,4.74,Tropicana Field,3,-3
2014-06-09,2014,WSH,SF,9,2,-127,-1.5,140,6.5,-120,100,117,1.5,-160,3.64,AT&T Park,11,7
2014-06-09,2014,SEA,TB,3,0,180,1.5,-125,7.0,-110,-110,-210,-1.5,105,2.5,Tropicana Field,3,3
2014-06-09,2014,CLE,TEX,17,7,-110,-1.5,140,9.5,-110,-110,100,1.5,-160,4.98,Rangers Ballpark,24,10
2014-06-09,2014,MIN,TOR,4,5,161,1.5,-130,9.5,-110,-110,-181,-1.5,110,3.64,Rogers Centre,9,-1
2014-06-09,2014,SF,WSH,2,9,117,1.5,-160,6.5,-120,100,-127,-1.5,140,3.0,AT&T Park,11,-7
2014-06-10,2014,HOU,ARI,1,4,119,1.5,-170,9.0,100,-120,-134,-1.5,150,4.11,Chase Field,5,-3
2014-06-10,2014,COL,ATL,10,13,108,1.5,-140,10.0,-115,-105,-118,-1.5,120,4.81,Coors Field,23,-3
2014-06-10,2014,BOS,BAL,1,0,110,1.5,-195,9.0,100,-120,-120,-1.5,165,4.29,Camden Yards,1,1
2014-06-10,2014,BAL,BOS,0,1,-120,-1.5,165,9.0,100,-120,110,1.5,-195,4.91,Camden Yards,1,-1
2014-06-10,2014,PIT,CHC,3,7,-179,-1.5,125,7.5,100,-120,159,1.5,-145,4.81,PNC Park,10,-4
2014-06-10,2014,LAD,CIN,6,1,119,1.5,-200,8.0,-110,-110,-134,-1.5,170,3.65,Great American Ballpark,7,5
2014-06-10,2014,KC,CLE,9,5,100,1.5,-170,7.0,100,-120,-110,-1.5,150,3.5,Kauffman Stadium,14,4
2014-06-10,2014,ATL,COL,13,10,-118,-1.5,120,10.0,-115,-105,108,1.5,-140,5.41,Coors Field,23,3
2014-06-10,2014,ARI,HOU,4,1,-134,-1.5,150,9.0,100,-120,119,1.5,-170,5.15,Chase Field,5,3
2014-06-10,2014,CLE,KC,5,9,-110,-1.5,150,7.0,100,-120,100,1.5,-170,3.67,Kauffman Stadium,14,-4
2014-06-10,2014,OAK,LAA,1,2,-118,-1.5,140,8.5,-115,-105,108,1.5,-160,4.6,Angel Stadium,3,-1
2014-06-10,2014,CIN,LAD,1,6,-134,-1.5,170,8.0,-110,-110,119,1.5,-200,4.58,Great American Ballpark,7,-5
2014-06-10,2014,TEX,MIA,5,8,-162,-1.5,125,9.0,-115,-105,147,1.5,-145,5.56,Rangers Ballpark,13,-3
2014-06-10,2014,NYM,MIL,6,2,117,1.5,-155,7.5,-115,-105,-132,-1.5,135,3.46,Citi Field,8,4
2014-06-10,2014,TOR,MIN,0,4,-192,-1.5,105,10.0,-105,-115,172,1.5,-125,6.58,Rogers Centre,4,-4
2014-06-10,2014,MIL,NYM,2,6,-132,-1.5,135,7.5,-115,-105,117,1.5,-155,4.27,Citi Field,8,-4
2014-06-10,2014,SEA,NYY,2,3,-147,-1.5,150,7.0,110,-130,132,1.5,-170,4.17,T-Mobile Park,5,-1
2014-06-10,2014,LAA,OAK,2,1,108,1.5,-160,8.5,-115,-105,-118,-1.5,140,4.09,Angel Stadium,3,1
2014-06-10,2014,SD,PHI,2,5,-114,-1.5,140,7.5,-105,-115,104,1.5,-160,4.0,Citizens Bank Park,7,-3
2014-06-10,2014,CHC,PIT,7,3,159,1.5,-145,7.5,100,-120,-179,-1.5,125,2.9,PNC Park,10,4
2014-06-10,2014,PHI,SD,5,2,104,1.5,-160,7.5,-105,-115,-114,-1.5,140,3.68,Citizens Bank Park,7,3
2014-06-10,2014,NYY,SEA,3,2,132,1.5,-170,7.0,110,-130,-147,-1.5,150,3.02,T-Mobile Park,5,1
2014-06-10,2014,WSH,SF,2,1,118,1.5,-200,6.5,-110,-110,-133,-1.5,170,2.98,AT&T Park,3,1
2014-06-10,2014,TB,STL,0,1,119,1.5,-145,6.5,-120,100,-129,-1.5,125,2.97,Tropicana Field,1,-1
2014-06-10,2014,STL,TB,1,0,-129,-1.5,125,6.5,-120,100,119,1.5,-145,3.66,Tropicana Field,1,1
2014-06-10,2014,MIA,TEX,8,5,147,1.5,-145,9.0,-115,-105,-162,-1.5,125,3.64,Rangers Ballpark,13,3
2014-06-10,2014,MIN,TOR,4,0,172,1.5,-125,10.0,-105,-115,-192,-1.5,105,3.68,Rogers Centre,4,4
2014-06-10,2014,SF,WSH,1,2,-133,-1.5,170,6.5,-110,-110,118,1.5,-200,3.71,AT&T Park,3,-1
2014-06-11,2014,HOU,ARI,5,1,-121,-1.5,170,7.5,-106,-114,111,1.5,-200,4.11,Minute Maid Park,6,4
2014-06-11,2014,COL,ATL,8,2,119,1.5,-135,10.0,-120,100,-134,-1.5,115,4.57,Coors Field,10,6
2014-06-11,2014,BOS,BAL,0,6,118,1.5,-180,8.5,-113,-107,-133,-1.5,160,3.9,Camden Yards,6,-6
2014-06-11,2014,BAL,BOS,6,0,-133,-1.5,160,8.5,-113,-107,118,1.5,-180,4.85,Camden Yards,6,6
2014-06-11,2014,PIT,CHC,4,2,-134,-1.5,165,7.5,105,-125,119,1.5,-195,4.29,PNC Park,6,2
2014-06-11,2014,LAD,CIN,0,5,126,1.5,-195,7.0,100,-120,-141,-1.5,165,3.1,Great American Ballpark,5,-5
2014-06-11,2014,KC,CLE,4,1,-117,-1.5,170,8.0,-110,-110,107,1.5,-200,4.31,Kauffman Stadium,5,3
2014-06-11,2014,ATL,COL,2,8,-134,-1.5,115,10.0,-120,100,119,1.5,-135,5.73,Coors Field,10,-6
2014-06-11,2014,DET,CWS,2,8,-150,-1.5,110,9.0,-105,-115,135,1.5,-130,5.4,Guaranteed Rate Field,10,-6
2014-06-11,2014,CWS,DET,8,2,135,1.5,-130,9.0,-105,-115,-150,-1.5,110,3.83,Guaranteed Rate Field,10,6
2014-06-11,2014,ARI,HOU,1,5,111,1.5,-200,7.5,-106,-114,-121,-1.5,170,3.55,Minute Maid Park,6,-4
2014-06-11,2014,CLE,KC,1,4,107,1.5,-200,8.0,-110,-110,-117,-1.5,170,3.86,Kauffman Stadium,5,-3
2014-06-11,2014,OAK,LAA,7,1,125,1.5,-175,8.0,-105,-115,-140,-1.5,155,3.56,Angel Stadium,8,6
2014-06-11,2014,CIN,LAD,5,0,-141,-1.5,165,7.0,100,-120,126,1.5,-195,4.1,Great American Ballpark,5,5
2014-06-11,2014,TEX,MIA,6,0,-240,-1.5,-110,8.5,-110,-110,200,1.5,-110,6.0,Rangers Ballpark,6,6
2014-06-11,2014,NYM,MIL,1,3,105,1.5,-160,7.0,-105,-115,-115,-1.5,140,3.41,Citi Field,4,-2
2014-06-11,2014,TOR,MIN,2,7,-160,-1.5,125,9.0,100,-120,145,1.5,-145,5.54,Rogers Centre,9,-5
2014-06-11,2014,MIL,NYM,3,1,-115,-1.5,140,7.0,-105,-115,105,1.5,-160,3.74,Citi Field,4,2
2014-06-11,2014,SEA,NYY,2,4,170,1.5,-101,7.0,-110,-110,-190,-1.5,-119,2.59,T-Mobile Park,6,-2
2014-06-11,2014,LAA,OAK,1,7,-140,-1.5,155,8.0,-105,-115,125,1.5,-175,4.67,Angel Stadium,8,-6
2014-06-11,2014,SD,PHI,0,3,114,1.5,-210,7.0,105,-125,-124,-1.5,180,3.27,Citizens Bank Park,3,-3
2014-06-11,2014,CHC,PIT,2,4,119,1.5,-195,7.5,105,-125,-134,-1.5,165,3.42,PNC Park,6,-2
2014-06-11,2014,PHI,SD,3,0,-124,-1.5,180,7.0,105,-125,114,1.5,-210,3.88,Citizens Bank Park,3,3
2014-06-11,2014,NYY,SEA,4,2,-190,-1.5,-119,7.0,-110,-110,170,1.5,-101,4.59,T-Mobile Park,6,2
2014-06-11,2014,WSH,SF,6,2,107,1.5,-230,6.5,-105,-115,-117,-1.5,190,3.14,AT&T Park,8,4
2014-06-11,2014,TB,STL,6,3,108,1.5,-160,7.0,-110,-110,-118,-1.5,140,3.37,Tropicana Field,9,3
2014-06-11,2014,STL,TB,3,6,-118,-1.5,140,7.0,-110,-110,108,1.5,-160,3.79,Tropicana Field,9,-3
2014-06-11,2014,MIA,TEX,0,6,200,1.5,-110,8.5,-110,-110,-240,-1.5,-110,2.83,Rangers Ballpark,6,-6
2014-06-11,2014,MIN,TOR,7,2,145,1.5,-145,9.0,100,-120,-160,-1.5,125,3.67,Rogers Centre,9,5
2014-06-11,2014,SF,WSH,2,6,-117,-1.5,190,6.5,-105,-115,107,1.5,-230,3.5,AT&T Park,8,-4
2014-06-12,2014,HOU,ARI,5,4,104,1.5,-165,9.0,-110,-110,-114,-1.5,145,4.41,Minute Maid Park,9,1
2014-06-12,2014,COL,ATL,10,3,-102,1.5,-165,9.5,100,-120,-108,-1.5,145,4.8,Coors Field,13,7
2014-06-12,2014,TOR,BAL,2,4,-101,1.5,-205,9.0,-125,105,-109,-1.5,175,4.52,Camden Yards,6,-2
2014-06-12,2014,CLE,BOS,2,5,147,1.5,-150,8.5,-105,-115,-162,-1.5,130,3.44,Fenway Park,7,-3
2014-06-12,2014,PIT,CHC,4,0,-120,-1.5,185,7.0,-110,-110,110,1.5,-215,3.82,PNC Park,4,4
2014-06-12,2014,LAD,CIN,1,4,-123,-1.5,135,7.5,-105,-115,113,1.5,-155,4.14,Great American Ballpark,5,-3
2014-06-12,2014,BOS,CLE,5,2,-162,-1.5,130,8.5,-105,-115,147,1.5,-150,5.26,Fenway Park,7,3
2014-06-12,2014,ATL,COL,3,10,-108,-1.5,145,9.5,100,-120,-102,1.5,-165,4.93,Coors Field,13,-7
2014-06-12,2014,DET,CWS,4,0,109,1.5,-215,7.5,105,-125,-119,-1.5,185,3.59,Guaranteed Rate Field,4,4
2014-06-12,2014,CWS,DET,0,4,-119,-1.5,185,7.5,105,-125,109,1.5,-215,4.08,Guaranteed Rate Field,4,-4
2014-06-12,2014,ARI,HOU,4,5,-114,-1.5,145,9.0,-110,-110,104,1.5,-165,4.79,Minute Maid Park,9,-1
2014-06-12,2014,CIN,LAD,4,1,113,1.5,-155,7.5,-105,-115,-123,-1.5,135,3.52,Great American Ballpark,5,3
2014-06-12,2014,NYM,MIL,1,5,118,1.5,-145,7.0,-120,100,-133,-1.5,125,3.21,Citi Field,6,-4
2014-06-12,2014,MIL,NYM,5,1,-133,-1.5,125,7.0,-120,100,118,1.5,-145,4.0,Citi Field,6,4
2014-06-12,2014,SEA,NYY,3,6,-112,-1.5,185,7.0,-110,-110,102,1.5,-215,3.7,T-Mobile Park,9,-3
2014-06-12,2014,SD,PHI,3,7,-110,-1.5,145,8.0,-110,-110,100,1.5,-165,4.19,Citizens Bank Park,10,-4
2014-06-12,2014,CHC,PIT,0,4,110,1.5,-215,7.0,-110,-110,-120,-1.5,185,3.33,PNC Park,4,-4
2014-06-12,2014,PHI,SD,7,3,100,1.5,-165,8.0,-110,-110,-110,-1.5,145,4.0,Citizens Bank Park,10,4
2014-06-12,2014,NYY,SEA,6,3,102,1.5,-215,7.0,-110,-110,-112,-1.5,185,3.47,T-Mobile Park,9,3
2014-06-12,2014,WSH,SF,1,7,141,1.5,-165,7.0,-110,-110,-156,-1.5,145,2.9,AT&T Park,8,-6
2014-06-12,2014,BAL,TOR,4,2,-109,-1.5,175,9.0,-125,105,-101,1.5,-205,4.69,Camden Yards,6,2
2014-06-12,2014,SF,WSH,7,1,-156,-1.5,145,7.0,-110,-110,141,1.5,-165,4.27,AT&T Park,8,6
2014-06-13,2014,LAD,ARI,4,3,-215,-1.5,105,6.5,100,-120,185,1.5,-125,4.44,Dodger Stadium,7,1
2014-06-13,2014,LAA,ATL,3,4,-108,-1.5,150,7.5,-110,-110,-102,1.5,-170,3.89,Turner Field,7,-1
2014-06-13,2014,TOR,BAL,4,0,-110,-1.5,145,9.0,-120,100,100,1.5,-165,4.71,Camden Yards,4,4
2014-06-13,2014,CLE,BOS,3,10,119,1.5,-170,8.5,-105,-115,-134,-1.5,150,3.88,Fenway Park,13,-7
2014-06-13,2014,PHI,CHC,1,2,-107,-1.5,190,8.0,-120,100,-103,1.5,-230,4.14,Citizens Bank Park,3,-1
2014-06-13,2014,MIL,CIN,5,6,-116,-1.5,180,7.5,-110,-110,106,1.5,-210,4.03,Miller Park,11,-1
2014-06-13,2014,BOS,CLE,10,3,-134,-1.5,150,8.5,-105,-115,119,1.5,-170,4.87,Fenway Park,13,7
2014-06-13,2014,SF,COL,4,7,-128,-1.5,170,7.0,-120,100,118,1.5,-200,3.93,AT&T Park,11,-3
2014-06-13,2014,KC,CWS,7,2,116,1.5,-195,7.5,-110,-110,-126,-1.5,165,3.47,Guaranteed Rate Field,9,5
2014-06-13,2014,MIN,DET,2,0,144,1.5,-147,9.0,-116,-104,-159,-1.5,127,3.69,Comerica Park,2,2
2014-06-13,2014,TB,HOU,6,1,-128,-1.5,130,7.5,-105,-115,118,1.5,-150,4.21,Minute Maid Park,7,5
2014-06-13,2014,CWS,KC,2,7,-126,-1.5,165,7.5,-110,-110,116,1.5,-195,4.18,Guaranteed Rate Field,9,-5
2014-06-13,2014,ATL,LAA,4,3,-102,1.5,-170,7.5,-110,-110,-108,-1.5,150,3.79,Turner Field,7,1
2014-06-13,2014,ARI,LAD,3,4,185,1.5,-125,6.5,100,-120,-215,-1.5,105,2.28,Dodger Stadium,7,-1
2014-06-13,2014,PIT,MIA,8,6,117,1.5,-195,7.5,100,-120,-132,-1.5,165,3.46,Marlins Park,14,2
2014-06-13,2014,CIN,MIL,6,5,106,1.5,-210,7.5,-110,-110,-116,-1.5,180,3.64,Miller Park,11,1
2014-06-13,2014,DET,MIN,0,2,-159,-1.5,127,9.0,-116,-104,144,1.5,-147,5.53,Comerica Park,2,-2
2014-06-13,2014,SD,NYM,2,6,-106,-1.5,155,6.5,-105,-115,-104,1.5,-175,3.34,Citi Field,8,-4
2014-06-13,2014,OAK,NYY,0,7,-200,-1.5,110,7.5,100,-120,170,1.5,-130,5.0,Oakland Coliseum,7,-7
2014-06-13,2014,NYY,OAK,7,0,170,1.5,-130,7.5,100,-120,-200,-1.5,110,2.78,Oakland Coliseum,7,7
2014-06-13,2014,CHC,PHI,2,1,-103,1.5,-230,8.0,-120,100,-107,-1.5,190,4.06,Citizens Bank Park,3,1
2014-06-13,2014,MIA,PIT,6,8,-132,-1.5,165,7.5,100,-120,117,1.5,-195,4.27,Marlins Park,14,-2
2014-06-13,2014,NYM,SD,6,2,-104,1.5,-175,6.5,-105,-115,-106,-1.5,155,3.31,Citi Field,8,4
2014-06-13,2014,TEX,SEA,1,0,170,1.5,-130,6.5,100,-120,-200,-1.5,110,2.41,T-Mobile Park,1,1
2014-06-13,2014,COL,SF,7,4,118,1.5,-200,7.0,-120,100,-128,-1.5,170,3.21,AT&T Park,11,3
2014-06-13,2014,WSH,STL,0,1,112,1.5,-210,7.0,-120,100,-122,-1.5,180,3.3,Busch Stadium,1,-1
2014-06-13,2014,HOU,TB,1,6,118,1.5,-150,7.5,-105,-115,-128,-1.5,130,3.44,Minute Maid Park,7,-5
2014-06-13,2014,SEA,TEX,0,1,-200,-1.5,110,6.5,100,-120,170,1.5,-130,4.33,T-Mobile Park,1,-1
2014-06-13,2014,BAL,TOR,0,4,100,1.5,-165,9.0,-120,100,-110,-1.5,145,4.5,Camden Yards,4,-4
2014-06-13,2014,STL,WSH,1,0,-122,-1.5,180,7.0,-120,100,112,1.5,-210,3.85,Busch Stadium,1,1
2014-06-14,2014,LAD,ARI,6,4,-132,-1.5,160,7.0,-120,100,117,1.5,-190,3.98,Dodger Stadium,10,2
2014-06-14,2014,LAA,ATL,11,6,-116,-1.5,140,7.5,103,-123,106,1.5,-160,4.03,Turner Field,17,5
2014-06-14,2014,TOR,BAL,2,3,-109,-1.5,145,9.0,102,-122,-101,1.5,-165,4.69,Camden Yards,5,-1
2014-06-14,2014,CLE,BOS,3,2,134,1.5,-160,9.5,-105,-115,-149,-1.5,140,4.06,Fenway Park,5,1
2014-06-14,2014,PHI,CHC,7,4,-121,-1.5,165,8.0,-111,-109,111,1.5,-195,4.38,Citizens Bank Park,11,3
2014-06-14,2014,MIL,CIN,4,2,-123,-1.5,170,7.5,-107,-113,113,1.5,-200,4.14,Miller Park,6,2
2014-06-14,2014,BOS,CLE,2,3,-149,-1.5,140,9.5,-105,-115,134,1.5,-160,5.68,Fenway Park,5,-1
2014-06-14,2014,SF,COL,4,5,-163,-1.5,135,7.5,100,-120,148,1.5,-155,4.65,AT&T Park,9,-1
2014-06-14,2014,KC,CWS,9,1,-134,-1.5,130,8.5,-110,-110,119,1.5,-150,4.87,Guaranteed Rate Field,10,8
2014-06-14,2014,MIN,DET,9,12,177,1.5,-120,8.5,-110,-110,-197,-1.5,100,3.07,Comerica Park,21,-3
2014-06-14,2014,TB,HOU,3,7,-143,-1.5,115,8.0,-105,-115,128,1.5,-135,4.71,Minute Maid Park,10,-4
2014-06-14,2014,CWS,KC,1,9,119,1.5,-150,8.5,-110,-110,-134,-1.5,130,3.88,Guaranteed Rate Field,10,-8
2014-06-14,2014,ATL,LAA,6,11,106,1.5,-160,7.5,103,-123,-116,-1.5,140,3.64,Turner Field,17,-5
2014-06-14,2014,ARI,LAD,4,6,117,1.5,-190,7.0,-120,100,-132,-1.5,160,3.23,Dodger Stadium,10,-2
2014-06-14,2014,PIT,MIA,8,6,-119,-1.5,135,7.5,-110,-110,109,1.5,-155,4.08,Marlins Park,14,2
2014-06-14,2014,CIN,MIL,2,4,113,1.5,-200,7.5,-107,-113,-123,-1.5,170,3.52,Miller Park,6,-2
2014-06-14,2014,DET,MIN,12,9,-197,-1.5,100,8.5,-110,-110,177,1.5,-120,5.64,Comerica Park,21,3
2014-06-14,2014,SD,NYM,5,0,122,1.5,-190,7.0,-120,100,-137,-1.5,160,3.15,Citi Field,5,5
2014-06-14,2014,OAK,NYY,5,1,-152,-1.5,135,7.0,-120,100,137,1.5,-155,4.22,Oakland Coliseum,6,4
2014-06-14,2014,NYY,OAK,1,5,137,1.5,-155,7.0,-120,100,-152,-1.5,135,2.95,Oakland Coliseum,6,-4
2014-06-14,2014,CHC,PHI,4,7,111,1.5,-195,8.0,-111,-109,-121,-1.5,165,3.79,Citizens Bank Park,11,-3
2014-06-14,2014,MIA,PIT,6,8,109,1.5,-155,7.5,-110,-110,-119,-1.5,135,3.59,Marlins Park,14,-2
2014-06-14,2014,NYM,SD,0,5,-137,-1.5,160,7.0,-120,100,122,1.5,-190,4.05,Citi Field,5,-5
2014-06-14,2014,TEX,SEA,4,3,-108,1.5,-230,7.0,-125,105,-102,-1.5,190,3.63,T-Mobile Park,7,1
2014-06-14,2014,COL,SF,5,4,148,1.5,-155,7.5,100,-120,-163,-1.5,135,3.02,AT&T Park,9,1
2014-06-14,2014,WSH,STL,1,4,-125,-1.5,130,7.0,-105,-115,115,1.5,-150,3.89,Busch Stadium,5,-3
2014-06-14,2014,HOU,TB,7,3,128,1.5,-135,8.0,-105,-115,-143,-1.5,115,3.51,Minute Maid Park,10,4
2014-06-14,2014,SEA,TEX,3,4,-102,-1.5,190,7.0,-125,105,-108,1.5,-230,3.53,T-Mobile Park,7,-1
2014-06-14,2014,BAL,TOR,3,2,-101,1.5,-165,9.0,102,-122,-109,-1.5,145,4.52,Camden Yards,5,1
2014-06-14,2014,STL,WSH,4,1,115,1.5,-150,7.0,-105,-115,-125,-1.5,130,3.26,Busch Stadium,5,3
2014-06-15,2014,LAD,ARI,3,6,-150,-1.5,145,7.5,105,-125,135,1.5,-165,4.5,Dodger Stadium,9,-3
2014-06-15,2014,LAA,ATL,3,7,109,1.5,-205,8.0,100,-120,-119,-1.5,175,3.83,Turner Field,10,-4
2014-06-15,2014,TOR,BAL,5,2,105,1.5,-200,9.0,-120,100,-115,-1.5,170,4.39,Camden Yards,7,3
2014-06-15,2014,CLE,BOS,3,2,-109,-1.5,150,8.5,-115,-105,-101,1.5,-170,4.43,Fenway Park,5,1
2014-06-15,2014,PHI,CHC,0,3,-126,-1.5,172,8.0,-105,-115,116,1.5,-202,4.46,Citizens Bank Park,3,-3
2014-06-15,2014,MIL,CIN,4,13,-123,-1.5,170,8.0,-105,-115,113,1.5,-200,4.41,Miller Park,17,-9
2014-06-15,2014,BOS,CLE,2,3,-101,1.5,-170,8.5,-115,-105,-109,-1.5,150,4.27,Fenway Park,5,-1
2014-06-15,2014,SF,COL,7,8,-190,-1.5,110,7.0,-110,-110,170,1.5,-130,4.59,AT&T Park,15,-1
2014-06-15,2014,KC,CWS,6,3,-152,-1.5,100,8.0,-120,100,137,1.5,-120,4.83,Guaranteed Rate Field,9,3
2014-06-15,2014,MIN,DET,3,4,133,1.5,-165,9.0,-110,-110,-148,-1.5,145,3.86,Comerica Park,7,-1
2014-06-15,2014,TB,HOU,4,3,-160,-1.5,100,7.5,-120,100,145,1.5,-120,4.62,Minute Maid Park,7,1
2014-06-15,2014,CWS,KC,3,6,137,1.5,-120,8.0,-120,100,-152,-1.5,100,3.38,Guaranteed Rate Field,9,-3
2014-06-15,2014,ATL,LAA,7,3,-119,-1.5,175,8.0,100,-120,109,1.5,-205,4.35,Turner Field,10,4
2014-06-15,2014,ARI,LAD,6,3,135,1.5,-165,7.5,105,-125,-150,-1.5,145,3.19,Dodger Stadium,9,3
2014-06-15,2014,PIT,MIA,2,3,-105,-1.5,151,7.5,-107,-113,-105,1.5,-171,3.84,Marlins Park,5,-1
2014-06-15,2014,CIN,MIL,13,4,113,1.5,-200,8.0,-105,-115,-123,-1.5,170,3.76,Miller Park,17,9
2014-06-15,2014,DET,MIN,4,3,-148,-1.5,145,9.0,-110,-110,133,1.5,-165,5.37,Comerica Park,7,1
2014-06-15,2014,SD,NYM,1,3,-120,-1.5,145,7.0,-120,100,110,1.5,-165,3.82,Citi Field,4,-2
2014-06-15,2014,OAK,NYY,10,5,-160,-1.5,130,8.0,-105,-115,145,1.5,-150,4.92,Oakland Coliseum,15,5
2014-06-15,2014,NYY,OAK,5,10,145,1.5,-150,8.0,-105,-115,-160,-1.5,130,3.27,Oakland Coliseum,15,-5
2014-06-15,2014,CHC,PHI,3,0,116,1.5,-202,8.0,-105,-115,-126,-1.5,172,3.7,Citizens Bank Park,3,3
2014-06-15,2014,MIA,PIT,3,2,-105,1.5,-171,7.5,-107,-113,-105,-1.5,151,3.84,Marlins Park,5,1
2014-06-15,2014,NYM,SD,3,1,110,1.5,-165,7.0,-120,100,-120,-1.5,145,3.33,Citi Field,4,2
2014-06-15,2014,TEX,SEA,1,5,157,1.5,-145,7.0,-125,105,-177,-1.5,125,2.72,T-Mobile Park,6,-4
2014-06-15,2014,COL,SF,8,7,170,1.5,-130,7.0,-110,-110,-190,-1.5,110,2.59,AT&T Park,15,1
2014-06-15,2014,WSH,STL,2,5,103,1.5,-230,7.5,-110,-110,-113,-1.5,190,3.69,Busch Stadium,7,-3
2014-06-15,2014,HOU,TB,3,4,145,1.5,-120,7.5,-120,100,-160,-1.5,100,3.06,Minute Maid Park,7,-1
2014-06-15,2014,SEA,TEX,5,1,-177,-1.5,125,7.0,-125,105,157,1.5,-145,4.47,T-Mobile Park,6,4
2014-06-15,2014,BAL,TOR,2,5,-115,-1.5,170,9.0,-120,100,105,1.5,-200,4.81,Camden Yards,7,-3
2014-06-15,2014,STL,WSH,5,2,-113,-1.5,190,7.5,-110,-110,103,1.5,-230,3.98,Busch Stadium,7,3
2014-06-16,2014,MIL,ARI,9,3,113,1.5,-195,8.5,-120,100,-123,-1.5,165,3.99,Chase Field,12,6
2014-06-16,2014,PHI,ATL,6,1,119,1.5,-205,6.5,-122,102,-129,-1.5,175,2.97,Turner Field,7,5
2014-06-16,2014,TB,BAL,5,4,-127,-1.5,170,7.0,-116,-104,117,1.5,-200,3.92,Tropicana Field,9,1
2014-06-16,2014,MIN,BOS,0,1,155,1.5,-135,9.0,-120,100,-175,-1.5,115,3.53,Fenway Park,1,-1
2014-06-16,2014,MIA,CHC,4,5,-101,1.5,-170,7.0,-115,-105,-109,-1.5,150,3.52,Marlins Park,9,-1
2014-06-16,2014,LAA,CLE,3,4,-109,-1.5,145,9.5,105,-125,-101,1.5,-165,4.95,Progressive Field,7,-1
2014-06-16,2014,LAD,COL,6,1,-155,-1.5,140,7.0,-115,-105,140,1.5,-160,4.25,Dodger Stadium,7,5
2014-06-16,2014,KC,DET,11,8,124,1.5,-165,8.5,-120,100,-139,-1.5,145,3.79,Comerica Park,19,3
2014-06-16,2014,DET,KC,8,11,-139,-1.5,145,8.5,-120,100,124,1.5,-165,4.94,Comerica Park,19,-3
2014-06-16,2014,CLE,LAA,4,3,-101,1.5,-165,9.5,105,-125,-109,-1.5,145,4.77,Progressive Field,7,1
2014-06-16,2014,COL,LAD,1,6,140,1.5,-160,7.0,-115,-105,-155,-1.5,140,2.92,Dodger Stadium,7,-5
2014-06-16,2014,CHC,MIA,5,4,-109,-1.5,150,7.0,-115,-105,-101,1.5,-170,3.65,Marlins Park,9,1
2014-06-16,2014,ARI,MIL,3,9,-123,-1.5,165,8.5,-120,100,113,1.5,-195,4.69,Chase Field,12,-6
2014-06-16,2014,BOS,MIN,1,0,-175,-1.5,115,9.0,-120,100,155,1.5,-135,5.73,Fenway Park,1,1
2014-06-16,2014,STL,NYM,6,2,-160,-1.5,135,8.5,-110,-110,145,1.5,-155,5.23,Busch Stadium,8,4
2014-06-16,2014,TEX,OAK,14,8,154,1.5,-140,8.0,100,-120,-174,-1.5,120,3.15,Oakland Coliseum,22,6
2014-06-16,2014,ATL,PHI,1,6,-129,-1.5,175,6.5,-122,102,119,1.5,-205,3.66,Turner Field,7,-5
2014-06-16,2014,SEA,SD,5,1,117,1.5,-155,7.0,-125,105,-127,-1.5,135,3.23,T-Mobile Park,6,4
2014-06-16,2014,SD,SEA,1,5,-127,-1.5,135,7.0,-125,105,117,1.5,-155,3.92,T-Mobile Park,6,-4
2014-06-16,2014,NYM,STL,2,6,145,1.5,-155,8.5,-110,-110,-160,-1.5,135,3.47,Busch Stadium,8,-4
2014-06-16,2014,BAL,TB,4,5,117,1.5,-200,7.0,-116,-104,-127,-1.5,170,3.23,Tropicana Field,9,-1
2014-06-16,2014,OAK,TEX,8,14,-174,-1.5,120,8.0,100,-120,154,1.5,-140,5.08,Oakland Coliseum,22,-6
2014-06-17,2014,MIL,ARI,7,5,-123,-1.5,130,9.0,-105,-115,113,1.5,-150,4.96,Chase Field,12,2
2014-06-17,2014,PHI,ATL,5,2,157,1.5,-140,7.0,-125,105,-177,-1.5,120,2.72,Turner Field,7,3
2014-06-17,2014,TB,BAL,5,7,-118,-1.5,170,7.5,-110,-110,108,1.5,-200,4.06,Tropicana Field,12,-2
2014-06-17,2014,MIN,BOS,1,2,150,1.5,-145,8.5,-120,100,-165,-1.5,125,3.4,Fenway Park,3,-1
2014-06-17,2014,MIA,CHC,6,5,100,1.5,-165,7.0,107,-127,-110,-1.5,145,3.5,Marlins Park,11,1
2014-06-17,2014,PIT,CIN,5,6,107,1.5,-160,7.0,-125,105,-117,-1.5,140,3.38,PNC Park,11,-1
2014-06-17,2014,LAA,CLE,9,3,110,1.5,-200,9.5,-110,-110,-120,-1.5,170,4.52,Progressive Field,12,6
2014-06-17,2014,LAD,COL,4,2,-175,-1.5,125,7.0,-105,-115,155,1.5,-145,4.45,Dodger Stadium,6,2
2014-06-17,2014,SF,CWS,2,8,-115,-1.5,140,9.0,100,-120,105,1.5,-160,4.81,Guaranteed Rate Field,10,-6
2014-06-17,2014,KC,DET,11,4,135,1.5,-160,8.0,-110,-110,-150,-1.5,140,3.4,Comerica Park,15,7
2014-06-17,2014,WSH,HOU,6,5,-153,-1.5,145,7.5,-120,100,138,1.5,-165,4.54,Nationals Park,11,1
2014-06-17,2014,DET,KC,4,11,-150,-1.5,140,8.0,-110,-110,135,1.5,-160,4.8,Comerica Park,15,-7
2014-06-17,2014,CLE,LAA,3,9,-120,-1.5,170,9.5,-110,-110,110,1.5,-200,5.18,Progressive Field,12,-6
2014-06-17,2014,COL,LAD,2,4,155,1.5,-145,7.0,-105,-115,-175,-1.5,125,2.75,Dodger Stadium,6,-2
2014-06-17,2014,CHC,MIA,5,6,-110,-1.5,145,7.0,107,-127,100,1.5,-165,3.67,Marlins Park,11,-1
2014-06-17,2014,ARI,MIL,5,7,113,1.5,-150,9.0,-105,-115,-123,-1.5,130,4.23,Chase Field,12,-2
2014-06-17,2014,BOS,MIN,2,1,-165,-1.5,125,8.5,-120,100,150,1.5,-145,5.29,Fenway Park,3,1
2014-06-17,2014,STL,NYM,5,2,-175,-1.5,125,7.5,105,-125,155,1.5,-145,4.77,Busch Stadium,7,3
2014-06-17,2014,TOR,NYY,1,3,157,1.5,-135,8.0,-105,-115,-177,-1.5,115,3.11,Yankee Stadium,4,-2
2014-06-17,2014,TEX,OAK,6,10,-109,-1.5,150,7.0,100,-120,-101,1.5,-170,3.65,Oakland Coliseum,16,-4
2014-06-17,2014,ATL,PHI,2,5,-177,-1.5,120,7.0,-125,105,157,1.5,-140,4.47,Turner Field,7,-3
2014-06-17,2014,CIN,PIT,6,5,-117,-1.5,140,7.0,-125,105,107,1.5,-160,3.77,PNC Park,11,1
2014-06-17,2014,SEA,SD,6,1,-130,-1.5,160,7.0,-110,-110,115,1.5,-190,3.96,T-Mobile Park,7,5
2014-06-17,2014,SD,SEA,1,6,115,1.5,-190,7.0,-110,-110,-130,-1.5,160,3.26,T-Mobile Park,7,-5
2014-06-17,2014,CWS,SF,8,2,105,1.5,-160,9.0,100,-120,-115,-1.5,140,4.39,Guaranteed Rate Field,10,6
2014-06-17,2014,NYM,STL,2,5,155,1.5,-145,7.5,105,-125,-175,-1.5,125,2.94,Busch Stadium,7,-3
2014-06-17,2014,BAL,TB,7,5,108,1.5,-200,7.5,-110,-110,-118,-1.5,170,3.61,Tropicana Field,12,2
2014-06-17,2014,OAK,TEX,10,6,-101,1.5,-170,7.0,100,-120,-109,-1.5,150,3.52,Oakland Coliseum,16,4
2014-06-17,2014,NYY,TOR,3,1,-177,-1.5,115,8.0,-105,-115,157,1.5,-135,5.11,Yankee Stadium,4,2
2014-06-17,2014,HOU,WSH,5,6,138,1.5,-165,7.5,-120,100,-153,-1.5,145,3.15,Nationals Park,11,-1
2014-06-18,2014,MIL,ARI,3,4,-110,-1.5,145,9.0,-125,105,100,1.5,-165,4.71,Chase Field,7,-1
2014-06-18,2014,PHI,ATL,10,5,170,1.5,-140,7.5,-105,-115,-190,-1.5,120,2.78,Turner Field,15,5
2014-06-18,2014,TB,BAL,0,2,-144,-1.5,150,7.0,-120,100,129,1.5,-170,4.13,Tropicana Field,2,-2
2014-06-18,2014,MIN,BOS,1,2,174,1.5,-125,9.0,-110,-110,-194,-1.5,105,3.28,Fenway Park,3,-1
2014-06-18,2014,MIA,CHC,1,6,-126,-1.5,175,7.0,100,-120,116,1.5,-205,3.9,Marlins Park,7,-5
2014-06-18,2014,PIT,CIN,4,11,-132,-1.5,160,8.0,-120,100,117,1.5,-190,4.55,PNC Park,15,-7
2014-06-18,2014,LAD,COL,8,0,-215,-1.5,104,6.5,100,-120,185,1.5,-124,4.44,Dodger Stadium,8,8
2014-06-18,2014,SF,CWS,6,7,136,1.5,-175,7.0,-110,-110,-151,-1.5,155,2.97,Guaranteed Rate Field,13,-1
2014-06-18,2014,KC,DET,2,1,125,1.5,-175,8.5,-115,-105,-140,-1.5,155,3.78,Comerica Park,3,1
2014-06-18,2014,WSH,HOU,6,5,-170,-1.5,120,8.0,-120,100,150,1.5,-140,5.04,Nationals Park,11,1
2014-06-18,2014,DET,KC,1,2,-140,-1.5,155,8.5,-115,-105,125,1.5,-175,4.96,Comerica Park,3,-1
2014-06-18,2014,COL,LAD,0,8,185,1.5,-124,6.5,100,-120,-215,-1.5,104,2.28,Dodger Stadium,8,-8
2014-06-18,2014,CHC,MIA,6,1,116,1.5,-205,7.0,100,-120,-126,-1.5,175,3.24,Marlins Park,7,5
2014-06-18,2014,ARI,MIL,4,3,100,1.5,-165,9.0,-125,105,-110,-1.5,145,4.5,Chase Field,7,1
2014-06-18,2014,BOS,MIN,2,1,-194,-1.5,105,9.0,-110,-110,174,1.5,-125,5.94,Fenway Park,3,1
2014-06-18,2014,STL,NYM,2,3,-140,-1.5,155,7.5,-120,100,125,1.5,-175,4.38,Busch Stadium,5,-1
2014-06-18,2014,TOR,NYY,3,7,103,1.5,-210,9.0,-114,-106,-113,-1.5,180,4.43,Yankee Stadium,10,-4
2014-06-18,2014,TEX,OAK,2,4,160,1.5,-135,8.0,100,-120,-180,-1.5,115,3.08,Oakland Coliseum,6,-2
2014-06-18,2014,ATL,PHI,5,10,-190,-1.5,120,7.5,-105,-115,170,1.5,-140,4.91,Turner Field,15,-5
2014-06-18,2014,CIN,PIT,11,4,117,1.5,-190,8.0,-120,100,-132,-1.5,160,3.69,PNC Park,15,7
2014-06-18,2014,SEA,SD,1,2,-141,-1.5,125,6.0,-117,-103,126,1.5,-145,3.51,PETCO Park,3,-1
2014-06-18,2014,SD,SEA,2,1,126,1.5,-145,6.0,-117,-103,-141,-1.5,125,2.65,PETCO Park,3,1
2014-06-18,2014,CWS,SF,7,6,-151,-1.5,155,7.0,-110,-110,136,1.5,-175,4.21,Guaranteed Rate Field,13,1
2014-06-18,2014,NYM,STL,3,2,125,1.5,-175,7.5,-120,100,-140,-1.5,155,3.33,Busch Stadium,5,1
2014-06-18,2014,BAL,TB,2,0,129,1.5,-170,7.0,-120,100,-144,-1.5,150,3.06,Tropicana Field,2,2
2014-06-18,2014,OAK,TEX,4,2,-180,-1.5,115,8.0,100,-120,160,1.5,-135,5.14,Oakland Coliseum,6,2
2014-06-18,2014,NYY,TOR,7,3,-113,-1.5,180,9.0,-114,-106,103,1.5,-210,4.77,Yankee Stadium,10,4
2014-06-18,2014,HOU,WSH,5,6,150,1.5,-140,8.0,-120,100,-170,-1.5,120,3.2,Nationals Park,11,-1
2014-06-19,2014,MIL,ARI,4,1,101,1.5,-215,7.5,-120,100,-111,-1.5,185,3.73,Chase Field,5,3
2014-06-19,2014,WSH,ATL,0,3,-139,-1.5,155,7.5,108,-128,124,1.5,-175,4.36,Nationals Park,3,-3
2014-06-19,2014,OAK,BOS,4,2,-170,-1.5,125,7.5,105,-125,150,1.5,-145,4.72,Oakland Coliseum,6,2
2014-06-19,2014,PIT,CIN,4,3,103,1.5,-170,7.0,-120,100,-113,-1.5,150,3.45,PNC Park,7,1
2014-06-19,2014,LAA,CLE,3,5,-124,-1.5,135,8.5,-110,-110,114,1.5,-155,4.71,Progressive Field,8,-2
2014-06-19,2014,MIN,CWS,4,2,-104,1.5,-170,8.5,-105,-115,-106,-1.5,150,4.33,Target Field,6,2
2014-06-19,2014,KC,DET,1,2,150,1.5,-150,8.0,100,-120,-165,-1.5,130,3.2,Comerica Park,3,-1
2014-06-19,2014,TB,HOU,5,0,-161,-1.5,140,7.0,-115,-105,146,1.5,-160,4.32,Tropicana Field,5,5
2014-06-19,2014,DET,KC,2,1,-165,-1.5,130,8.0,100,-120,150,1.5,-150,4.98,Comerica Park,3,1
2014-06-19,2014,CLE,LAA,5,3,114,1.5,-155,8.5,-110,-110,-124,-1.5,135,3.97,Progressive Field,8,2
2014-06-19,2014,NYM,MIA,1,0,118,1.5,-190,7.5,105,-125,-133,-1.5,160,3.44,Marlins Park,1,1
2014-06-19,2014,ARI,MIL,1,4,-111,-1.5,185,7.5,-120,100,101,1.5,-215,3.95,Chase Field,5,-3
2014-06-19,2014,CWS,MIN,2,4,-106,-1.5,150,8.5,-105,-115,-104,1.5,-170,4.37,Target Field,6,-2
2014-06-19,2014,MIA,NYM,0,1,-133,-1.5,160,7.5,105,-125,118,1.5,-190,4.28,Marlins Park,1,-1
2014-06-19,2014,TOR,NYY,4,6,-109,-1.5,140,9.0,-110,-110,-101,1.5,-160,4.69,Yankee Stadium,10,-2
2014-06-19,2014,BOS,OAK,2,4,150,1.5,-145,7.5,105,-125,-170,-1.5,125,3.0,Oakland Coliseum,6,-2
2014-06-19,2014,STL,PHI,1,4,-167,-1.5,120,8.0,-120,100,152,1.5,-140,5.0,Busch Stadium,5,-3
2014-06-19,2014,CIN,PIT,3,4,-113,-1.5,150,7.0,-120,100,103,1.5,-170,3.71,PNC Park,7,-1
2014-06-19,2014,SEA,SD,1,4,132,1.5,-190,7.0,-116,-104,-147,-1.5,160,3.02,PETCO Park,5,-3
2014-06-19,2014,SD,SEA,4,1,-147,-1.5,160,7.0,-116,-104,132,1.5,-190,4.17,PETCO Park,5,3
2014-06-19,2014,PHI,STL,4,1,152,1.5,-140,8.0,-120,100,-167,-1.5,120,3.17,Busch Stadium,5,3
2014-06-19,2014,HOU,TB,0,5,146,1.5,-160,7.0,-115,-105,-161,-1.5,140,2.85,Tropicana Field,5,-5
2014-06-19,2014,NYY,TOR,6,4,-101,1.5,-160,9.0,-110,-110,-109,-1.5,140,4.52,Yankee Stadium,10,2
2014-06-19,2014,ATL,WSH,3,0,124,1.5,-175,7.5,108,-128,-139,-1.5,155,3.35,Nationals Park,3,3
2014-06-20,2014,SF,ARI,1,4,108,1.5,-200,8.5,-113,-107,-118,-1.5,170,4.09,Chase Field,5,-3
2014-06-20,2014,WSH,ATL,4,6,-150,-1.5,140,7.0,-110,-110,135,1.5,-160,4.2,Nationals Park,10,-2
2014-06-20,2014,NYY,BAL,5,3,-147,-1.5,137,8.5,-115,-105,132,1.5,-156,5.06,Yankee Stadium,8,2
2014-06-20,2014,OAK,BOS,4,3,-165,-1.5,130,8.5,-115,-105,150,1.5,-150,5.29,Oakland Coliseum,7,1
2014-06-20,2014,PIT,CHC,3,6,-124,-1.5,125,8.5,-120,100,114,1.5,-145,4.71,Wrigley Field,9,-3
2014-06-20,2014,TOR,CIN,14,9,135,1.5,-155,8.5,-120,100,-150,-1.5,135,3.62,Great American Ballpark,23,5
2014-06-20,2014,DET,CLE,6,4,139,1.5,-150,8.0,-105,-115,-154,-1.5,130,3.35,Progressive Field,10,2
2014-06-20,2014,MIL,COL,13,10,-102,1.5,-205,11.0,-105,-115,-108,-1.5,175,5.55,Coors Field,23,3
2014-06-20,2014,MIN,CWS,5,4,-150,-1.5,140,9.0,-110,-110,135,1.5,-160,5.4,Target Field,9,1
2014-06-20,2014,CLE,DET,4,6,-154,-1.5,130,8.0,-105,-115,139,1.5,-150,4.85,Progressive Field,10,-2
2014-06-20,2014,TB,HOU,1,3,-180,-1.5,115,7.0,105,-125,160,1.5,-135,4.5,Tropicana Field,4,-2
2014-06-20,2014,SEA,KC,7,5,126,1.5,-175,7.5,102,-122,-141,-1.5,155,3.32,Kauffman Stadium,12,2
2014-06-20,2014,TEX,LAA,3,7,173,1.5,-130,8.5,-115,-105,-193,-1.5,110,3.11,Angel Stadium,10,-4
2014-06-20,2014,SD,LAD,6,5,-114,-1.5,190,7.0,-105,-115,104,1.5,-230,3.73,PETCO Park,11,1
2014-06-20,2014,NYM,MIA,2,3,137,1.5,-168,7.5,-111,-109,-152,-1.5,149,3.16,Marlins Park,5,-1
2014-06-20,2014,COL,MIL,10,13,-108,-1.5,175,11.0,-105,-115,-102,1.5,-205,5.71,Coors Field,23,-3
2014-06-20,2014,CWS,MIN,4,5,135,1.5,-160,9.0,-110,-110,-150,-1.5,140,3.83,Target Field,9,-1
2014-06-20,2014,MIA,NYM,3,2,-152,-1.5,149,7.5,-111,-109,137,1.5,-168,4.52,Marlins Park,5,1
2014-06-20,2014,BAL,NYY,3,5,132,1.5,-156,8.5,-115,-105,-147,-1.5,137,3.66,Yankee Stadium,8,-2
2014-06-20,2014,BOS,OAK,3,4,150,1.5,-150,8.5,-115,-105,-165,-1.5,130,3.4,Oakland Coliseum,7,-1
2014-06-20,2014,STL,PHI,1,5,-181,-1.5,120,7.5,-115,-105,161,1.5,-140,4.83,Busch Stadium,6,-4
2014-06-20,2014,CHC,PIT,6,3,114,1.5,-145,8.5,-120,100,-124,-1.5,125,3.97,Wrigley Field,9,3
2014-06-20,2014,LAD,SD,5,6,104,1.5,-230,7.0,-105,-115,-114,-1.5,190,3.43,PETCO Park,11,-1
2014-06-20,2014,KC,SEA,5,7,-141,-1.5,155,7.5,102,-122,126,1.5,-175,4.39,Kauffman Stadium,12,-2
2014-06-20,2014,ARI,SF,4,1,-118,-1.5,170,8.5,-113,-107,108,1.5,-200,4.6,Chase Field,5,3
2014-06-20,2014,PHI,STL,5,1,161,1.5,-140,7.5,-115,-105,-181,-1.5,120,2.87,Busch Stadium,6,4
2014-06-20,2014,HOU,TB,3,1,160,1.5,-135,7.0,105,-125,-180,-1.5,115,2.69,Tropicana Field,4,2
2014-06-20,2014,LAA,TEX,7,3,-193,-1.5,110,8.5,-115,-105,173,1.5,-130,5.6,Angel Stadium,10,4
2014-06-20,2014,CIN,TOR,9,14,-150,-1.5,135,8.5,-120,100,135,1.5,-155,5.1,Great American Ballpark,23,-5
2014-06-20,2014,ATL,WSH,6,4,135,1.5,-160,7.0,-110,-110,-150,-1.5,140,2.98,Nationals Park,10,2
2014-06-21,2014,SF,ARI,6,4,113,1.5,-200,8.0,-120,100,-123,-1.5,170,3.76,Chase Field,10,2
2014-06-21,2014,WSH,ATL,3,0,-112,-1.5,190,7.0,-113,-107,102,1.5,-230,3.7,Nationals Park,3,3
2014-06-21,2014,NYY,BAL,1,6,104,1.5,-160,9.0,100,-120,-114,-1.5,140,4.41,Yankee Stadium,7,-5
2014-06-21,2014,OAK,BOS,2,1,-144,-1.5,145,8.0,-113,-107,129,1.5,-165,4.72,Oakland Coliseum,3,1
2014-06-21,2014,PIT,CHC,5,3,-115,-1.5,140,8.5,100,-120,105,1.5,-160,4.55,Wrigley Field,8,2
2014-06-21,2014,TOR,CIN,1,11,114,1.5,-200,9.0,-105,-115,-124,-1.5,170,4.21,Great American Ballpark,12,-10
2014-06-21,2014,DET,CLE,5,4,-106,-1.5,145,8.5,-110,-110,-104,1.5,-165,4.37,Progressive Field,9,1
2014-06-21,2014,MIL,COL,9,4,-145,-1.5,105,12.0,100,-120,130,1.5,-125,7.1,Coors Field,13,5
2014-06-21,2014,MIN,CWS,4,3,-127,-1.5,160,9.5,-102,-118,117,1.5,-190,5.31,Target Field,7,1
2014-06-21,2014,CLE,DET,4,5,-104,1.5,-165,8.5,-110,-110,-106,-1.5,145,4.33,Progressive Field,9,-1
2014-06-21,2014,TB,HOU,8,0,-195,-1.5,110,7.5,-105,-115,175,1.5,-130,4.96,Tropicana Field,8,8
2014-06-21,2014,SEA,KC,2,1,158,1.5,-130,9.0,105,-125,-178,-1.5,110,3.49,Kauffman Stadium,3,1
2014-06-21,2014,TEX,LAA,2,3,170,1.5,-125,8.5,-110,-110,-200,-1.5,105,3.15,Angel Stadium,5,-1
2014-06-21,2014,SD,LAD,2,4,-101,1.5,-165,6.5,100,-120,-109,-1.5,145,3.27,PETCO Park,6,-2
2014-06-21,2014,NYM,MIA,4,0,100,1.5,-215,7.5,-110,-110,-110,-1.5,185,3.75,Marlins Park,4,4
2014-06-21,2014,COL,MIL,4,9,130,1.5,-125,12.0,100,-120,-145,-1.5,105,5.22,Coors Field,13,-5
2014-06-21,2014,CWS,MIN,3,4,117,1.5,-190,9.5,-102,-118,-127,-1.5,160,4.38,Target Field,7,-1
2014-06-21,2014,MIA,NYM,0,4,-110,-1.5,185,7.5,-110,-110,100,1.5,-215,3.93,Marlins Park,4,-4
2014-06-21,2014,BAL,NYY,6,1,-114,-1.5,140,9.0,100,-120,104,1.5,-160,4.79,Yankee Stadium,7,5
2014-06-21,2014,BOS,OAK,1,2,129,1.5,-165,8.0,-113,-107,-144,-1.5,145,3.49,Oakland Coliseum,3,-1
2014-06-21,2014,STL,PHI,4,1,-145,-1.5,155,7.0,-115,-105,130,1.5,-175,4.14,Busch Stadium,5,3
2014-06-21,2014,CHC,PIT,3,5,105,1.5,-160,8.5,100,-120,-115,-1.5,140,4.15,Wrigley Field,8,-2
2014-06-21,2014,LAD,SD,4,2,-109,-1.5,145,6.5,100,-120,-101,1.5,-165,3.39,PETCO Park,6,2
2014-06-21,2014,KC,SEA,1,2,-178,-1.5,110,9.0,105,-125,158,1.5,-130,5.76,Kauffman Stadium,3,-1
2014-06-21,2014,ARI,SF,4,6,-123,-1.5,170,8.0,-120,100,113,1.5,-200,4.41,Chase Field,10,-2
2014-06-21,2014,PHI,STL,1,4,130,1.5,-175,7.0,-115,-105,-145,-1.5,155,3.04,Busch Stadium,5,-3
2014-06-21,2014,HOU,TB,0,8,175,1.5,-130,7.5,-105,-115,-195,-1.5,110,2.73,Tropicana Field,8,-8
2014-06-21,2014,LAA,TEX,3,2,-200,-1.5,105,8.5,-110,-110,170,1.5,-125,5.67,Angel Stadium,5,1
2014-06-21,2014,CIN,TOR,11,1,-124,-1.5,170,9.0,-105,-115,114,1.5,-200,4.98,Great American Ballpark,12,10
2014-06-21,2014,ATL,WSH,0,3,102,1.5,-230,7.0,-113,-107,-112,-1.5,190,3.47,Nationals Park,3,-3
2014-06-22,2014,SF,ARI,4,1,-126,-1.5,115,8.0,100,-120,116,1.5,-135,4.46,Chase Field,5,3
2014-06-22,2014,WSH,ATL,4,1,-119,-1.5,175,7.0,-125,105,109,1.5,-205,3.8,Nationals Park,5,3
2014-06-22,2014,NYY,BAL,0,8,-235,-1.5,-114,7.5,-115,-105,205,1.5,-106,5.26,Yankee Stadium,8,-8
2014-06-22,2014,OAK,BOS,6,7,-120,-1.5,170,7.5,100,-120,110,1.5,-200,4.09,Oakland Coliseum,13,-1
2014-06-22,2014,PIT,CHC,2,1,109,1.5,-205,7.0,-125,105,-119,-1.5,175,3.35,Wrigley Field,3,1
2014-06-22,2014,TOR,CIN,3,4,123,1.5,-170,7.5,-115,-105,-138,-1.5,150,3.36,Great American Ballpark,7,-1
2014-06-22,2014,DET,CLE,10,4,-106,-1.5,145,8.0,-115,-105,-104,1.5,-165,4.12,Progressive Field,14,6
2014-06-22,2014,MIL,COL,6,5,-124,-1.5,125,11.0,-110,-110,114,1.5,-145,6.09,Coors Field,11,1
2014-06-22,2014,MIN,CWS,6,5,-150,-1.5,140,8.0,-115,-105,135,1.5,-160,4.8,Target Field,11,1
2014-06-22,2014,CLE,DET,4,10,-104,1.5,-165,8.0,-115,-105,-106,-1.5,145,4.08,Progressive Field,14,-6
2014-06-22,2014,TB,HOU,5,2,-129,-1.5,165,7.0,-120,100,119,1.5,-195,3.94,Tropicana Field,7,3
2014-06-22,2014,SEA,KC,2,1,125,1.5,-170,8.5,-114,-106,-140,-1.5,150,3.78,Kauffman Stadium,3,1
2014-06-22,2014,TEX,LAA,2,5,-114,-1.5,150,7.0,-112,-108,104,1.5,-170,3.73,Angel Stadium,7,-3
2014-06-22,2014,SD,LAD,1,2,147,1.5,-119,7.0,-115,-105,-162,-1.5,-101,2.83,PETCO Park,3,-1
2014-06-22,2014,NYM,MIA,11,5,106,1.5,-205,7.5,105,-125,-116,-1.5,175,3.64,Marlins Park,16,6
2014-06-22,2014,COL,MIL,5,6,114,1.5,-145,11.0,-110,-110,-124,-1.5,125,5.14,Coors Field,11,-1
2014-06-22,2014,CWS,MIN,5,6,135,1.5,-160,8.0,-115,-105,-150,-1.5,140,3.4,Target Field,11,-1
2014-06-22,2014,MIA,NYM,5,11,-116,-1.5,175,7.5,105,-125,106,1.5,-205,4.03,Marlins Park,16,-6
2014-06-22,2014,BAL,NYY,8,0,205,1.5,-106,7.5,-115,-105,-235,-1.5,-114,2.46,Yankee Stadium,8,8
2014-06-22,2014,BOS,OAK,7,6,110,1.5,-200,7.5,100,-120,-120,-1.5,170,3.57,Oakland Coliseum,13,1
2014-06-22,2014,STL,PHI,5,3,-155,-1.5,135,8.5,-120,100,140,1.5,-155,5.17,Busch Stadium,8,2
2014-06-22,2014,CHC,PIT,1,2,-119,-1.5,175,7.0,-125,105,109,1.5,-205,3.8,Wrigley Field,3,-1
2014-06-22,2014,LAD,SD,2,1,-162,-1.5,-101,7.0,-115,-105,147,1.5,-119,4.33,PETCO Park,3,1
2014-06-22,2014,KC,SEA,1,2,-140,-1.5,150,8.5,-114,-106,125,1.5,-170,4.96,Kauffman Stadium,3,-1
2014-06-22,2014,ARI,SF,1,4,116,1.5,-135,8.0,100,-120,-126,-1.5,115,3.7,Chase Field,5,-3
2014-06-22,2014,PHI,STL,3,5,140,1.5,-155,8.5,-120,100,-155,-1.5,135,3.54,Busch Stadium,8,-2
2014-06-22,2014,HOU,TB,2,5,119,1.5,-195,7.0,-120,100,-129,-1.5,165,3.2,Tropicana Field,7,-3
2014-06-22,2014,LAA,TEX,5,2,104,1.5,-170,7.0,-112,-108,-114,-1.5,150,3.43,Angel Stadium,7,3
2014-06-22,2014,CIN,TOR,4,3,-138,-1.5,150,7.5,-115,-105,123,1.5,-170,4.35,Great American Ballpark,7,1
2014-06-22,2014,ATL,WSH,1,4,109,1.5,-205,7.0,-125,105,-119,-1.5,175,3.35,Nationals Park,5,-3
2014-06-23,2014,CWS,BAL,4,6,-110,-1.5,145,7.0,-125,105,100,1.5,-165,3.67,Camden Yards,10,-2
2014-06-23,2014,SEA,BOS,12,3,-145,-1.5,155,6.0,-110,-110,130,1.5,-175,3.55,T-Mobile Park,15,9
2014-06-23,2014,CIN,CHC,6,1,101,1.5,-210,8.5,-115,-105,-111,-1.5,180,4.23,Wrigley Field,7,5
2014-06-23,2014,CHC,CIN,1,6,-111,-1.5,180,8.5,-115,-105,101,1.5,-210,4.47,Wrigley Field,7,-5
2014-06-23,2014,STL,COL,8,0,-105,-1.5,145,10.0,-110,-110,-105,1.5,-165,5.12,Coors Field,8,8
2014-06-23,2014,BAL,CWS,6,4,100,1.5,-165,7.0,-125,105,-110,-1.5,145,3.5,Camden Yards,10,2
2014-06-23,2014,LAD,KC,3,5,-104,1.5,-230,7.5,100,-120,-106,-1.5,190,3.82,Kauffman Stadium,8,-2
2014-06-23,2014,KC,LAD,5,3,-106,-1.5,190,7.5,100,-120,-104,1.5,-230,3.86,Kauffman Stadium,8,2
2014-06-23,2014,PHI,MIA,0,4,-106,-1.5,185,8.5,-105,-115,-104,1.5,-215,4.37,Citizens Bank Park,4,-4
2014-06-23,2014,WSH,MIL,3,0,125,1.5,-170,8.5,-110,-110,-140,-1.5,150,3.78,Miller Park,3,3
2014-06-23,2014,TOR,NYY,8,3,-124,-1.5,160,9.0,-105,-115,114,1.5,-190,4.98,Rogers Centre,11,5
2014-06-23,2014,MIA,PHI,4,0,-104,1.5,-215,8.5,-105,-115,-106,-1.5,185,4.33,Citizens Bank Park,4,4
2014-06-23,2014,TB,PIT,1,8,-158,-1.5,140,7.0,-125,105,143,1.5,-160,4.29,Tropicana Field,9,-7
2014-06-23,2014,SF,SD,0,6,-163,-1.5,130,7.0,-110,-110,148,1.5,-150,4.34,AT&T Park,6,-6
2014-06-23,2014,BOS,SEA,3,12,130,1.5,-175,6.0,-110,-110,-145,-1.5,155,2.61,T-Mobile Park,15,-9
2014-06-23,2014,SD,SF,6,0,148,1.5,-150,7.0,-110,-110,-163,-1.5,130,2.82,AT&T Park,6,6
2014-06-23,2014,COL,STL,0,8,-105,1.5,-165,10.0,-110,-110,-105,-1.5,145,5.12,Coors Field,8,-8
2014-06-23,2014,PIT,TB,8,1,143,1.5,-160,7.0,-125,105,-158,-1.5,140,2.88,Tropicana Field,9,7
2014-06-23,2014,NYY,TOR,3,8,114,1.5,-190,9.0,-105,-115,-124,-1.5,160,4.21,Rogers Centre,11,-5
2014-06-23,2014,MIL,WSH,0,3,-140,-1.5,150,8.5,-110,-110,125,1.5,-170,4.96,Miller Park,3,-3
2014-06-24,2014,CLE,ARI,8,9,119,1.5,-195,8.0,-115,-105,-129,-1.5,165,3.65,Chase Field,17,-1
2014-06-24,2014,HOU,ATL,2,3,109,1.5,-155,8.5,-125,105,-119,-1.5,135,4.07,Minute Maid Park,5,-1
2014-06-24,2014,CWS,BAL,4,2,114,1.5,-195,8.5,-110,-110,-124,-1.5,165,3.97,Camden Yards,6,2
2014-06-24,2014,SEA,BOS,8,2,-103,1.5,-165,7.5,-115,-105,-107,-1.5,145,3.81,T-Mobile Park,10,6
2014-06-24,2014,CIN,CHC,3,7,-119,-1.5,145,7.0,-125,105,109,1.5,-165,3.8,Wrigley Field,10,-4
2014-06-24,2014,CHC,CIN,7,3,109,1.5,-165,7.0,-125,105,-119,-1.5,145,3.35,Wrigley Field,10,4
2014-06-24,2014,ARI,CLE,9,8,-129,-1.5,165,8.0,-115,-105,119,1.5,-195,4.51,Chase Field,17,1
2014-06-24,2014,STL,COL,5,10,110,1.5,-195,10.5,100,-120,-120,-1.5,165,5.0,Coors Field,15,-5
2014-06-24,2014,BAL,CWS,2,4,-124,-1.5,165,8.5,-110,-110,114,1.5,-195,4.71,Camden Yards,6,-2
2014-06-24,2014,TEX,DET,2,8,103,1.5,-155,9.5,-115,-105,-113,-1.5,135,4.68,Rangers Ballpark,10,-6
2014-06-24,2014,ATL,HOU,3,2,-119,-1.5,135,8.5,-125,105,109,1.5,-155,4.62,Minute Maid Park,5,1
2014-06-24,2014,LAD,KC,2,0,-150,-1.5,115,7.0,-110,-110,135,1.5,-135,4.2,Kauffman Stadium,2,2
2014-06-24,2014,MIN,LAA,6,8,155,1.5,-140,8.0,100,-120,-175,-1.5,120,3.14,Angel Stadium,14,-2
2014-06-24,2014,KC,LAD,0,2,135,1.5,-135,7.0,-110,-110,-150,-1.5,115,2.98,Kauffman Stadium,2,-2
2014-06-24,2014,PHI,MIA,7,4,110,1.5,-155,8.0,-115,-105,-120,-1.5,135,3.81,Citizens Bank Park,11,3
2014-06-24,2014,WSH,MIL,4,2,105,1.5,-210,7.5,-110,-110,-115,-1.5,180,3.66,Miller Park,6,2
2014-06-24,2014,LAA,MIN,8,6,-175,-1.5,120,8.0,100,-120,155,1.5,-140,5.09,Angel Stadium,14,2
2014-06-24,2014,OAK,NYM,1,10,-125,-1.5,130,7.0,-102,-118,115,1.5,-150,3.89,Citi Field,11,-9
2014-06-24,2014,TOR,NYY,7,6,-129,-1.5,160,9.0,105,-125,119,1.5,-190,5.07,Rogers Centre,13,1
2014-06-24,2014,NYM,OAK,10,1,115,1.5,-150,7.0,-102,-118,-125,-1.5,130,3.26,Citi Field,11,9
2014-06-24,2014,MIA,PHI,4,7,-120,-1.5,135,8.0,-115,-105,110,1.5,-155,4.36,Citizens Bank Park,11,-3
2014-06-24,2014,TB,PIT,5,6,-126,-1.5,170,7.0,-120,100,116,1.5,-200,3.9,Tropicana Field,11,-1
2014-06-24,2014,SF,SD,2,7,-148,-1.5,145,6.5,-110,-110,133,1.5,-165,3.88,AT&T Park,9,-5
2014-06-24,2014,BOS,SEA,2,8,-107,-1.5,145,7.5,-115,-105,-103,1.5,-165,3.88,T-Mobile Park,10,-6
2014-06-24,2014,SD,SF,7,2,133,1.5,-165,6.5,-110,-110,-148,-1.5,145,2.79,AT&T Park,9,5
2014-06-24,2014,COL,STL,10,5,-120,-1.5,165,10.5,100,-120,110,1.5,-195,5.73,Coors Field,15,5
2014-06-24,2014,PIT,TB,6,5,116,1.5,-200,7.0,-120,100,-126,-1.5,170,3.24,Tropicana Field,11,1
2014-06-24,2014,DET,TEX,8,2,-113,-1.5,135,9.5,-115,-105,103,1.5,-155,5.04,Rangers Ballpark,10,6
2014-06-24,2014,NYY,TOR,6,7,119,1.5,-190,9.0,105,-125,-129,-1.5,160,4.11,Rogers Centre,13,-1
2014-06-24,2014,MIL,WSH,2,4,-115,-1.5,180,7.5,-110,-110,105,1.5,-210,4.01,Miller Park,6,-2
2014-06-25,2014,CLE,ARI,6,1,-143,-1.5,115,8.0,-110,-110,128,1.5,-135,4.71,Chase Field,7,5
2014-06-25,2014,HOU,ATL,0,4,113,1.5,-150,7.5,-120,100,-123,-1.5,130,3.52,Minute Maid Park,4,-4
2014-06-25,2014,CWS,BAL,4,5,129,1.5,-160,9.0,-120,100,-144,-1.5,140,3.93,Camden Yards,9,-1
2014-06-25,2014,SEA,BOS,4,5,-126,-1.5,160,7.5,-105,-115,116,1.5,-190,4.18,T-Mobile Park,9,-1
2014-06-25,2014,CIN,CHC,4,1,-145,-1.5,120,7.0,105,-125,130,1.5,-140,4.14,Wrigley Field,5,3
2014-06-25,2014,CHC,CIN,1,4,130,1.5,-140,7.0,105,-125,-145,-1.5,120,3.04,Wrigley Field,5,-3
2014-06-25,2014,ARI,CLE,1,6,128,1.5,-135,8.0,-110,-110,-143,-1.5,115,3.51,Chase Field,7,-5
2014-06-25,2014,STL,COL,9,6,-132,-1.5,120,11.5,100,-120,117,1.5,-140,6.54,Coors Field,15,3
2014-06-25,2014,BAL,CWS,5,4,-144,-1.5,140,9.0,-120,100,129,1.5,-160,5.31,Camden Yards,9,1
2014-06-25,2014,TEX,DET,6,8,125,1.5,-130,9.0,-105,-115,-140,-1.5,110,4.0,Rangers Ballpark,14,-2
2014-06-25,2014,ATL,HOU,4,0,-123,-1.5,130,7.5,-120,100,113,1.5,-150,4.14,Minute Maid Park,4,4
2014-06-25,2014,LAD,KC,5,4,146,1.5,-150,8.0,-109,-111,-161,-1.5,130,3.25,Kauffman Stadium,9,1
2014-06-25,2014,MIN,LAA,2,6,175,1.5,-130,8.0,-119,-101,-195,-1.5,110,2.91,Angel Stadium,8,-4
2014-06-25,2014,KC,LAD,4,5,-161,-1.5,130,8.0,-109,-111,146,1.5,-150,4.93,Kauffman Stadium,9,-1
2014-06-25,2014,PHI,MIA,2,3,-110,-1.5,185,8.0,-134,114,100,1.5,-215,4.19,Citizens Bank Park,5,-1
2014-06-25,2014,WSH,MIL,2,9,-145,-1.5,115,7.0,-120,100,130,1.5,-135,4.14,Miller Park,11,-7
2014-06-25,2014,LAA,MIN,6,2,-195,-1.5,110,8.0,-119,-101,175,1.5,-130,5.29,Angel Stadium,8,4
2014-06-25,2014,OAK,NYM,8,5,-111,-1.5,145,8.0,-110,-110,101,1.5,-165,4.21,Citi Field,13,3
2014-06-25,2014,TOR,NYY,3,5,-115,-1.5,175,9.0,-115,-105,105,1.5,-205,4.81,Rogers Centre,8,-2
2014-06-25,2014,NYM,OAK,5,8,101,1.5,-165,8.0,-110,-110,-111,-1.5,145,3.98,Citi Field,13,-3
2014-06-25,2014,MIA,PHI,3,2,100,1.5,-215,8.0,-134,114,-110,-1.5,185,4.0,Citizens Bank Park,5,1
2014-06-25,2014,TB,PIT,5,1,-164,-1.5,130,6.5,-127,107,149,1.5,-150,4.04,Tropicana Field,6,4
2014-06-25,2014,SF,SD,4,0,-112,-1.5,185,7.0,-101,-119,102,1.5,-215,3.7,AT&T Park,4,4
2014-06-25,2014,BOS,SEA,5,4,116,1.5,-190,7.5,-105,-115,-126,-1.5,160,3.47,T-Mobile Park,9,1
2014-06-25,2014,SD,SF,0,4,102,1.5,-215,7.0,-101,-119,-112,-1.5,185,3.47,AT&T Park,4,-4
2014-06-25,2014,COL,STL,6,9,117,1.5,-140,11.5,100,-120,-132,-1.5,120,5.3,Coors Field,15,-3
2014-06-25,2014,PIT,TB,1,5,149,1.5,-150,6.5,-127,107,-164,-1.5,130,2.61,Tropicana Field,6,-4
2014-06-25,2014,DET,TEX,8,6,-140,-1.5,110,9.0,-105,-115,125,1.5,-130,5.25,Rangers Ballpark,14,2
2014-06-25,2014,NYY,TOR,5,3,105,1.5,-205,9.0,-115,-105,-115,-1.5,175,4.39,Rogers Centre,8,2
2014-06-25,2014,MIL,WSH,9,2,130,1.5,-135,7.0,-120,100,-145,-1.5,115,3.04,Miller Park,11,7
2014-06-26,2014,HOU,ATL,6,1,100,1.5,-170,8.5,-105,-115,-110,-1.5,150,4.25,Minute Maid Park,7,5
2014-06-26,2014,WSH,CHC,3,5,-140,-1.5,115,7.0,-120,100,125,1.5,-135,4.08,Wrigley Field,8,-2
2014-06-26,2014,SF,CIN,1,3,106,1.5,-170,7.0,-110,-110,-116,-1.5,150,3.4,AT&T Park,4,-2
2014-06-26,2014,MIL,COL,7,4,-220,-1.5,-105,9.0,-115,-105,190,1.5,-115,6.19,Miller Park,11,3
2014-06-26,2014,TOR,CWS,7,0,-190,-1.5,100,10.0,-106,-114,170,1.5,-120,6.55,Rogers Centre,7,7
2014-06-26,2014,TEX,DET,0,6,104,1.5,-155,10.0,-120,100,-114,-1.5,135,4.9,Rangers Ballpark,6,-6
2014-06-26,2014,ATL,HOU,1,6,-110,-1.5,150,8.5,-105,-115,100,1.5,-170,4.45,Minute Maid Park,7,-5
2014-06-26,2014,MIN,LAA,4,6,179,1.5,-130,8.5,-115,-105,-199,-1.5,110,3.05,Angel Stadium,10,-2
2014-06-26,2014,STL,LAD,0,1,-113,-1.5,155,6.5,-105,-115,103,1.5,-175,3.45,Dodger Stadium,1,-1
2014-06-26,2014,PHI,MIA,5,3,-170,-1.5,140,7.0,-125,105,150,1.5,-160,4.41,Citizens Bank Park,8,2
2014-06-26,2014,COL,MIL,4,7,190,1.5,-115,9.0,-115,-105,-220,-1.5,-105,3.1,Miller Park,11,-3
2014-06-26,2014,LAA,MIN,6,4,-199,-1.5,110,8.5,-115,-105,179,1.5,-130,5.66,Angel Stadium,10,2
2014-06-26,2014,PIT,NYM,5,2,-170,-1.5,125,8.0,-120,100,150,1.5,-145,5.04,PNC Park,7,3
2014-06-26,2014,MIA,PHI,3,5,150,1.5,-160,7.0,-125,105,-170,-1.5,140,2.8,Citizens Bank Park,8,-2
2014-06-26,2014,NYM,PIT,2,5,150,1.5,-145,8.0,-120,100,-170,-1.5,125,3.2,PNC Park,7,-3
2014-06-26,2014,CIN,SF,3,1,-116,-1.5,150,7.0,-110,-110,106,1.5,-170,3.76,AT&T Park,4,2
2014-06-26,2014,LAD,STL,1,0,103,1.5,-175,6.5,-105,-115,-113,-1.5,155,3.2,Dodger Stadium,1,1
2014-06-26,2014,DET,TEX,6,0,-114,-1.5,135,10.0,-120,100,104,1.5,-155,5.33,Rangers Ballpark,6,6
2014-06-26,2014,CWS,TOR,0,7,170,1.5,-120,10.0,-106,-114,-190,-1.5,100,3.7,Rogers Centre,7,-7
2014-06-26,2014,CHC,WSH,5,3,125,1.5,-135,7.0,-120,100,-140,-1.5,115,3.11,Wrigley Field,8,2
2014-06-27,2014,SD,ARI,1,2,-124,-1.5,175,6.5,100,-120,114,1.5,-205,3.6,PETCO Park,3,-1
2014-06-27,2014,PHI,ATL,2,4,129,1.5,-135,7.5,-110,-110,-144,-1.5,115,3.28,Citizens Bank Park,6,-2
2014-06-27,2014,TB,BAL,5,2,119,1.5,-165,8.5,-105,-115,-134,-1.5,145,3.88,Camden Yards,7,3
2014-06-27,2014,TB,BAL,1,4,-110,-1.5,150,8.0,-115,-105,100,1.5,-170,4.19,Camden Yards,5,-3
2014-06-27,2014,NYY,BOS,6,0,-123,-1.5,170,9.0,100,-120,113,1.5,-200,4.96,Yankee Stadium,6,6
2014-06-27,2014,WSH,CHC,2,7,-119,-1.5,140,7.5,-115,-105,109,1.5,-160,4.08,Wrigley Field,9,-5
2014-06-27,2014,SF,CIN,2,6,-119,-1.5,190,5.5,-115,-105,109,1.5,-230,2.99,AT&T Park,8,-4
2014-06-27,2014,SEA,CLE,3,2,112,1.5,-155,8.0,-115,-105,-122,-1.5,135,3.77,T-Mobile Park,5,1
2014-06-27,2014,MIL,COL,3,2,-195,-1.5,-101,9.0,-120,100,175,1.5,-119,5.95,Miller Park,5,1
2014-06-27,2014,TOR,CWS,4,5,-153,-1.5,130,8.5,-110,-110,138,1.5,-150,5.14,Rogers Centre,9,-1
2014-06-27,2014,HOU,DET,4,3,127,1.5,-140,8.5,-120,100,-142,-1.5,120,3.74,Minute Maid Park,7,1
2014-06-27,2014,DET,HOU,3,4,-142,-1.5,120,8.5,-120,100,127,1.5,-140,4.99,Minute Maid Park,7,-1
2014-06-27,2014,LAA,KC,6,8,115,1.5,-200,8.5,-110,-110,-125,-1.5,170,3.95,Kauffman Stadium,14,-2
2014-06-27,2014,KC,LAA,8,6,-125,-1.5,170,8.5,-110,-110,115,1.5,-200,4.72,Kauffman Stadium,14,2
2014-06-27,2014,STL,LAD,3,1,115,1.5,-191,7.0,100,-120,-130,-1.5,161,3.26,Dodger Stadium,4,2
2014-06-27,2014,OAK,MIA,9,5,-161,-1.5,-110,8.0,-105,-115,146,1.5,-110,4.93,Marlins Park,14,4
2014-06-27,2014,COL,MIL,2,3,175,1.5,-119,9.0,-120,100,-195,-1.5,-101,3.27,Miller Park,5,-1
2014-06-27,2014,TEX,MIN,5,4,-134,-1.5,150,9.5,100,-120,119,1.5,-170,5.44,Rangers Ballpark,9,1
2014-06-27,2014,PIT,NYM,3,2,-145,-1.5,150,8.0,-105,-115,130,1.5,-170,4.73,PNC Park,5,1
2014-06-27,2014,BOS,NYY,0,6,113,1.5,-200,9.0,100,-120,-123,-1.5,170,4.23,Yankee Stadium,6,-6
2014-06-27,2014,MIA,OAK,5,9,146,1.5,-110,8.0,-105,-115,-161,-1.5,-110,3.25,Marlins Park,14,-4
2014-06-27,2014,ATL,PHI,4,2,-144,-1.5,115,7.5,-110,-110,129,1.5,-135,4.43,Citizens Bank Park,6,2
2014-06-27,2014,NYM,PIT,2,3,130,1.5,-170,8.0,-105,-115,-145,-1.5,150,3.48,PNC Park,5,-1
2014-06-27,2014,ARI,SD,2,1,114,1.5,-205,6.5,100,-120,-124,-1.5,175,3.04,PETCO Park,3,1
2014-06-27,2014,CLE,SEA,2,3,-122,-1.5,135,8.0,-115,-105,112,1.5,-155,4.4,T-Mobile Park,5,-1
2014-06-27,2014,CIN,SF,6,2,109,1.5,-230,5.5,-115,-105,-119,-1.5,190,2.63,AT&T Park,8,4
2014-06-27,2014,LAD,STL,1,3,-130,-1.5,161,7.0,100,-120,115,1.5,-191,3.96,Dodger Stadium,4,-2
2014-06-27,2014,BAL,TB,2,5,-134,-1.5,145,8.5,-105,-115,119,1.5,-165,4.87,Camden Yards,7,-3
2014-06-27,2014,BAL,TB,4,1,100,1.5,-170,8.0,-115,-105,-110,-1.5,150,4.0,Camden Yards,5,3
2014-06-27,2014,MIN,TEX,4,5,119,1.5,-170,9.5,100,-120,-134,-1.5,150,4.34,Rangers Ballpark,9,-1
2014-06-27,2014,CWS,TOR,5,4,138,1.5,-150,8.5,-110,-110,-153,-1.5,130,3.57,Rogers Centre,9,1
2014-06-27,2014,CHC,WSH,7,2,109,1.5,-160,7.5,-115,-105,-119,-1.5,140,3.59,Wrigley Field,9,5
2014-06-28,2014,SD,ARI,1,3,-112,-1.5,190,7.0,100,-120,102,1.5,-230,3.7,PETCO Park,4,-2
2014-06-28,2014,PHI,ATL,3,10,117,1.5,-140,8.0,105,-125,-127,-1.5,120,3.69,Citizens Bank Park,13,-7
2014-06-28,2014,PHI,ATL,1,5,117,1.5,-145,8.5,-110,-110,-127,-1.5,125,3.92,Citizens Bank Park,6,-4
2014-06-28,2014,TB,BAL,5,4,131,1.5,-160,8.5,-105,-115,-146,-1.5,140,3.68,Camden Yards,9,1
2014-06-28,2014,NYY,BOS,1,2,-152,-1.5,140,7.0,-105,-115,137,1.5,-160,4.22,Yankee Stadium,3,-1
2014-06-28,2014,WSH,CHC,3,0,-161,-1.5,105,9.0,-110,-110,146,1.5,-125,5.55,Wrigley Field,3,3
2014-06-28,2014,WSH,CHC,7,2,116,1.5,-190,8.5,-110,-110,-131,-1.5,160,3.94,Wrigley Field,9,5
2014-06-28,2014,SF,CIN,3,7,100,1.5,-170,7.0,105,-125,-110,-1.5,150,3.5,AT&T Park,10,-4
2014-06-28,2014,SEA,CLE,0,5,-124,-1.5,170,7.5,105,-125,114,1.5,-200,4.15,T-Mobile Park,5,-5
2014-06-28,2014,MIL,COL,7,4,-145,-1.5,145,9.0,100,-120,130,1.5,-165,5.33,Miller Park,11,3
2014-06-28,2014,TOR,CWS,3,4,110,1.5,-165,7.5,-105,-115,-120,-1.5,145,3.57,Rogers Centre,7,-1
2014-06-28,2014,HOU,DET,3,4,160,1.5,-119,8.0,-110,-110,-180,-1.5,-102,3.08,Minute Maid Park,7,-1
2014-06-28,2014,DET,HOU,4,3,-180,-1.5,-102,8.0,-110,-110,160,1.5,-119,5.14,Minute Maid Park,7,1
2014-06-28,2014,LAA,KC,6,2,118,1.5,-190,8.5,-118,-102,-133,-1.5,160,3.9,Kauffman Stadium,8,4
2014-06-28,2014,KC,LAA,2,6,-133,-1.5,160,8.5,-118,-102,118,1.5,-190,4.85,Kauffman Stadium,8,-4
2014-06-28,2014,STL,LAD,1,9,127,1.5,-190,6.5,-125,105,-142,-1.5,160,2.86,Dodger Stadium,10,-8
2014-06-28,2014,OAK,MIA,7,6,-157,-1.5,-101,7.0,-125,105,142,1.5,-119,4.28,Marlins Park,13,1
2014-06-28,2014,COL,MIL,4,7,130,1.5,-165,9.0,100,-120,-145,-1.5,145,3.91,Miller Park,11,-3
2014-06-28,2014,TEX,MIN,5,0,-172,-1.5,125,7.5,-105,-115,152,1.5,-145,4.74,Rangers Ballpark,5,5
2014-06-28,2014,PIT,NYM,3,5,-164,-1.5,160,7.5,-115,-105,149,1.5,-190,4.66,PNC Park,8,-2
2014-06-28,2014,BOS,NYY,2,1,137,1.5,-160,7.0,-105,-115,-152,-1.5,140,2.95,Yankee Stadium,3,1
2014-06-28,2014,MIA,OAK,6,7,142,1.5,-119,7.0,-125,105,-157,-1.5,-101,2.89,Marlins Park,13,-1
2014-06-28,2014,ATL,PHI,10,3,-127,-1.5,120,8.0,105,-125,117,1.5,-140,4.48,Citizens Bank Park,13,7
2014-06-28,2014,ATL,PHI,5,1,-127,-1.5,125,8.5,-110,-110,117,1.5,-145,4.76,Citizens Bank Park,6,4
2014-06-28,2014,NYM,PIT,5,3,149,1.5,-190,7.5,-115,-105,-164,-1.5,160,3.01,PNC Park,8,2
2014-06-28,2014,ARI,SD,3,1,102,1.5,-230,7.0,100,-120,-112,-1.5,190,3.47,PETCO Park,4,2
2014-06-28,2014,CLE,SEA,5,0,114,1.5,-200,7.5,105,-125,-124,-1.5,170,3.5,T-Mobile Park,5,5
2014-06-28,2014,CIN,SF,7,3,-110,-1.5,150,7.0,105,-125,100,1.5,-170,3.67,AT&T Park,10,4
2014-06-28,2014,LAD,STL,9,1,-142,-1.5,160,6.5,-125,105,127,1.5,-190,3.81,Dodger Stadium,10,8
2014-06-28,2014,BAL,TB,4,5,-146,-1.5,140,8.5,-105,-115,131,1.5,-160,5.04,Camden Yards,9,-1
2014-06-28,2014,MIN,TEX,0,5,152,1.5,-145,7.5,-105,-115,-172,-1.5,125,2.98,Rangers Ballpark,5,-5
2014-06-28,2014,CWS,TOR,4,3,-120,-1.5,145,7.5,-105,-115,110,1.5,-165,4.09,Rogers Centre,7,1
2014-06-28,2014,CHC,WSH,0,3,146,1.5,-125,9.0,-110,-110,-161,-1.5,105,3.66,Wrigley Field,3,-3
2014-06-28,2014,CHC,WSH,2,7,-131,-1.5,160,8.5,-110,-110,116,1.5,-190,4.82,Wrigley Field,9,-5
2014-06-29,2014,SD,ARI,2,1,-115,-1.5,185,7.0,-105,-115,105,1.5,-215,3.74,PETCO Park,3,1
2014-06-29,2014,PHI,ATL,2,3,108,1.5,-155,8.0,-110,-110,-118,-1.5,135,3.85,Citizens Bank Park,5,-1
2014-06-29,2014,TB,BAL,12,7,-115,-1.5,145,8.0,-120,100,105,1.5,-165,4.28,Camden Yards,19,5
2014-06-29,2014,NYY,BOS,5,8,-108,-1.5,195,7.5,-115,-105,-102,1.5,-235,3.89,Yankee Stadium,13,-3
2014-06-29,2014,SF,CIN,0,4,-127,-1.5,180,7.0,105,-125,117,1.5,-210,3.92,AT&T Park,4,-4
2014-06-29,2014,SEA,CLE,3,0,-171,-1.5,125,6.5,-120,100,151,1.5,-145,4.1,T-Mobile Park,3,3
2014-06-29,2014,MIL,COL,4,10,-156,-1.5,130,8.5,-113,-107,141,1.5,-150,5.18,Miller Park,14,-6
2014-06-29,2014,TOR,CWS,0,4,-126,-1.5,160,8.5,-110,-110,116,1.5,-190,4.74,Rogers Centre,4,-4
2014-06-29,2014,HOU,DET,6,4,118,1.5,-145,8.5,-110,-110,-128,-1.5,125,3.9,Minute Maid Park,10,2
2014-06-29,2014,DET,HOU,4,6,-128,-1.5,125,8.5,-110,-110,118,1.5,-145,4.77,Minute Maid Park,10,-2
2014-06-29,2014,LAA,KC,4,5,-115,-1.5,140,8.5,-120,100,105,1.5,-160,4.55,Kauffman Stadium,9,-1
2014-06-29,2014,KC,LAA,5,4,105,1.5,-160,8.5,-120,100,-115,-1.5,140,4.15,Kauffman Stadium,9,1
2014-06-29,2014,STL,LAD,0,6,180,1.5,-125,6.5,-120,100,-210,-1.5,105,2.32,Dodger Stadium,6,-6
2014-06-29,2014,OAK,MIA,4,3,-116,-1.5,135,7.5,103,-123,106,1.5,-155,4.03,Marlins Park,7,1
2014-06-29,2014,COL,MIL,10,4,141,1.5,-150,8.5,-113,-107,-156,-1.5,130,3.53,Miller Park,14,6
2014-06-29,2014,TEX,MIN,2,3,-122,-1.5,160,9.0,-125,105,112,1.5,-190,4.95,Rangers Ballpark,5,-1
2014-06-29,2014,PIT,NYM,5,2,-123,-1.5,180,7.5,100,-120,113,1.5,-210,4.14,PNC Park,7,3
2014-06-29,2014,BOS,NYY,8,5,-102,1.5,-235,7.5,-115,-105,-108,-1.5,195,3.79,Yankee Stadium,13,3
2014-06-29,2014,MIA,OAK,3,4,106,1.5,-155,7.5,103,-123,-116,-1.5,135,3.64,Marlins Park,7,-1
2014-06-29,2014,ATL,PHI,3,2,-118,-1.5,135,8.0,-110,-110,108,1.5,-155,4.33,Citizens Bank Park,5,1
2014-06-29,2014,NYM,PIT,2,5,113,1.5,-210,7.5,100,-120,-123,-1.5,180,3.52,PNC Park,7,-3
2014-06-29,2014,ARI,SD,1,2,105,1.5,-215,7.0,-105,-115,-115,-1.5,185,3.41,PETCO Park,3,-1
2014-06-29,2014,CLE,SEA,0,3,151,1.5,-145,6.5,-120,100,-171,-1.5,125,2.59,T-Mobile Park,3,-3
2014-06-29,2014,CIN,SF,4,0,117,1.5,-210,7.0,105,-125,-127,-1.5,180,3.23,AT&T Park,4,4
2014-06-29,2014,LAD,STL,6,0,-210,-1.5,105,6.5,-120,100,180,1.5,-125,4.4,Dodger Stadium,6,6
2014-06-29,2014,BAL,TB,7,12,105,1.5,-165,8.0,-120,100,-115,-1.5,145,3.9,Camden Yards,19,-5
2014-06-29,2014,MIN,TEX,3,2,112,1.5,-190,9.0,-125,105,-122,-1.5,160,4.25,Rangers Ballpark,5,1
2014-06-29,2014,CWS,TOR,4,0,116,1.5,-190,8.5,-110,-110,-126,-1.5,160,3.94,Rogers Centre,4,4
2014-06-30,2014,NYM,ATL,3,5,155,1.5,-145,7.0,-110,-110,-175,-1.5,125,2.75,Turner Field,8,-2
2014-06-30,2014,TEX,BAL,1,7,115,1.5,-175,9.0,-110,-110,-130,-1.5,155,4.19,Camden Yards,8,-6
2014-06-30,2014,CHC,BOS,2,0,147,1.5,-150,9.0,-105,-115,-162,-1.5,130,3.64,Fenway Park,2,2
2014-06-30,2014,BOS,CHC,0,2,-162,-1.5,130,9.0,-105,-115,147,1.5,-150,5.56,Fenway Park,2,-2
2014-06-30,2014,SD,CIN,1,0,-105,-1.5,195,6.5,-105,-115,-105,1.5,-235,3.33,PETCO Park,1,1
2014-06-30,2014,LAD,CLE,1,0,115,1.5,-150,7.0,100,-120,-130,-1.5,130,3.26,Dodger Stadium,1,1
2014-06-30,2014,WSH,COL,7,3,-250,-1.5,-125,8.5,-110,-110,210,1.5,105,6.07,Nationals Park,10,4
2014-06-30,2014,OAK,DET,4,5,115,1.5,-190,9.0,-105,-115,-130,-1.5,160,4.19,Comerica Park,9,-1
2014-06-30,2014,SEA,HOU,10,4,-106,-1.5,155,7.5,-118,-102,-104,1.5,-175,3.86,Minute Maid Park,14,6
2014-06-30,2014,MIN,KC,1,6,125,1.5,-140,8.5,100,-120,-140,-1.5,120,3.78,Target Field,7,-5
2014-06-30,2014,CLE,LAD,0,1,-130,-1.5,130,7.0,100,-120,115,1.5,-150,3.96,Dodger Stadium,1,-1
2014-06-30,2014,KC,MIN,6,1,-140,-1.5,120,8.5,100,-120,125,1.5,-140,4.96,Target Field,7,5
2014-06-30,2014,ATL,NYM,5,3,-175,-1.5,125,7.0,-110,-110,155,1.5,-145,4.45,Turner Field,8,2
2014-06-30,2014,TB,NYY,4,3,104,1.5,-210,8.0,-120,100,-114,-1.5,180,3.92,Yankee Stadium,7,1
2014-06-30,2014,DET,OAK,5,4,-130,-1.5,160,9.0,-105,-115,115,1.5,-190,5.09,Comerica Park,9,1
2014-06-30,2014,CIN,SD,0,1,-105,1.5,-235,6.5,-105,-115,-105,-1.5,195,3.33,PETCO Park,1,-1
2014-06-30,2014,HOU,SEA,4,10,-104,1.5,-175,7.5,-118,-102,-106,-1.5,155,3.82,Minute Maid Park,14,-6
2014-06-30,2014,NYY,TB,3,4,-114,-1.5,180,8.0,-120,100,104,1.5,-210,4.26,Yankee Stadium,7,-1
2014-06-30,2014,BAL,TEX,7,1,-130,-1.5,155,9.0,-110,-110,115,1.5,-175,5.09,Camden Yards,8,6
2014-06-30,2014,COL,WSH,3,7,210,1.5,105,8.5,-110,-110,-250,-1.5,-125,2.74,Nationals Park,10,-4
2014-07-01,2014,PIT,ARI,3,2,-141,-1.5,155,8.0,-120,100,126,1.5,-175,4.68,PNC Park,5,1
2014-07-01,2014,NYM,ATL,4,5,160,1.5,-140,7.5,-110,-110,-180,-1.5,120,2.88,Turner Field,9,-1
2014-07-01,2014,TEX,BAL,3,8,143,1.5,-155,9.0,-107,-113,-158,-1.5,135,3.7,Camden Yards,11,-5
2014-07-01,2014,CHC,BOS,2,1,156,1.5,-140,9.5,-115,-105,-176,-1.5,120,3.71,Fenway Park,3,1
2014-07-01,2014,BOS,CHC,1,2,-176,-1.5,120,9.5,-115,-105,156,1.5,-140,6.06,Fenway Park,3,-1
2014-07-01,2014,SD,CIN,8,2,-102,1.5,-190,6.0,-115,-105,-108,-1.5,160,3.03,PETCO Park,10,6
2014-07-01,2014,LAD,CLE,3,10,-130,-1.5,170,7.0,100,-120,115,1.5,-200,3.96,Dodger Stadium,13,-7
2014-07-01,2014,WSH,COL,7,1,-245,-1.5,-120,8.0,-118,-102,205,1.5,100,5.68,Nationals Park,8,6
2014-07-01,2014,LAA,CWS,8,4,-170,-1.5,-115,9.5,-113,-107,150,1.5,-105,5.98,Guaranteed Rate Field,12,4
2014-07-01,2014,LAA,CWS,7,5,-174,-1.5,-110,9.5,-120,100,154,1.5,-110,6.03,Guaranteed Rate Field,12,2
2014-07-01,2014,OAK,DET,0,3,111,1.5,-195,9.5,-105,-115,-121,-1.5,165,4.5,Comerica Park,3,-3
2014-07-01,2014,SEA,HOU,13,2,-130,-1.5,125,7.5,-115,-105,115,1.5,-145,4.24,Minute Maid Park,15,11
2014-07-01,2014,MIN,KC,10,2,131,1.5,-135,7.5,100,-120,-146,-1.5,115,3.25,Target Field,12,8
2014-07-01,2014,CWS,LAA,4,8,150,1.5,-105,9.5,-113,-107,-170,-1.5,-115,3.8,Guaranteed Rate Field,12,-4
2014-07-01,2014,CWS,LAA,5,7,154,1.5,-110,9.5,-120,100,-174,-1.5,-110,3.74,Guaranteed Rate Field,12,-2
2014-07-01,2014,CLE,LAD,10,3,115,1.5,-200,7.0,100,-120,-130,-1.5,170,3.26,Dodger Stadium,13,7
2014-07-01,2014,PHI,MIA,4,5,135,1.5,-165,7.5,-106,-114,-150,-1.5,145,3.19,Marlins Park,9,-1
2014-07-01,2014,TOR,MIL,4,1,-144,-1.5,140,10.5,-105,-115,129,1.5,-160,6.2,Rogers Centre,5,3
2014-07-01,2014,KC,MIN,2,10,-146,-1.5,115,7.5,100,-120,131,1.5,-135,4.45,Target Field,12,-8
2014-07-01,2014,ATL,NYM,5,4,-180,-1.5,120,7.5,-110,-110,160,1.5,-140,4.82,Turner Field,9,1
2014-07-01,2014,TB,NYY,2,1,-124,-1.5,130,7.5,-107,-113,114,1.5,-150,4.15,Yankee Stadium,3,1
2014-07-01,2014,DET,OAK,3,0,-121,-1.5,165,9.5,-105,-115,111,1.5,-195,5.2,Comerica Park,3,3
2014-07-01,2014,MIA,PHI,5,4,-150,-1.5,145,7.5,-106,-114,135,1.5,-165,4.5,Marlins Park,9,1
2014-07-01,2014,ARI,PIT,2,3,126,1.5,-175,8.0,-120,100,-141,-1.5,155,3.54,PNC Park,5,-1
2014-07-01,2014,CIN,SD,2,8,-108,-1.5,160,6.0,-115,-105,-102,1.5,-190,3.12,PETCO Park,10,-6
2014-07-01,2014,HOU,SEA,2,13,115,1.5,-145,7.5,-115,-105,-130,-1.5,125,3.49,Minute Maid Park,15,-11
2014-07-01,2014,STL,SF,0,5,100,1.5,-215,7.0,-110,-110,-110,-1.5,185,3.5,AT&T Park,5,-5
2014-07-01,2014,SF,STL,5,0,-110,-1.5,185,7.0,-110,-110,100,1.5,-215,3.67,AT&T Park,5,5
2014-07-01,2014,NYY,TB,1,2,114,1.5,-150,7.5,-107,-113,-124,-1.5,130,3.5,Yankee Stadium,3,-1
2014-07-01,2014,BAL,TEX,8,3,-158,-1.5,135,9.0,-107,-113,143,1.5,-155,5.51,Camden Yards,11,5
2014-07-01,2014,MIL,TOR,1,4,129,1.5,-160,10.5,-105,-115,-144,-1.5,140,4.59,Rogers Centre,5,-3
2014-07-01,2014,COL,WSH,1,7,205,1.5,100,8.0,-118,-102,-245,-1.5,-120,2.62,Nationals Park,8,-6
2014-07-02,2014,PIT,ARI,5,1,-170,-1.5,125,8.0,-115,-105,150,1.5,-145,5.04,PNC Park,6,4
2014-07-02,2014,NYM,ATL,1,3,170,1.5,-130,7.0,-115,-105,-200,-1.5,110,2.59,Turner Field,4,-2
2014-07-02,2014,TEX,BAL,4,6,116,1.5,-162,9.0,-125,105,-131,-1.5,143,4.17,Camden Yards,10,-2
2014-07-02,2014,CHC,BOS,16,9,170,1.5,-130,9.0,-125,105,-190,-1.5,110,3.33,Fenway Park,25,7
2014-07-02,2014,BOS,CHC,9,16,-190,-1.5,110,9.0,-125,105,170,1.5,-130,5.9,Fenway Park,25,-7
2014-07-02,2014,SD,CIN,3,0,108,1.5,-170,5.5,100,-120,-118,-1.5,150,2.64,PETCO Park,3,3
2014-07-02,2014,LAD,CLE,4,5,-140,-1.5,160,7.0,-124,104,125,1.5,-190,4.08,Dodger Stadium,9,-1
2014-07-02,2014,WSH,COL,4,3,-190,-1.5,105,8.5,-115,-105,170,1.5,-125,5.57,Nationals Park,7,1
2014-07-02,2014,LAA,CWS,2,3,-158,-1.5,100,9.0,100,-120,143,1.5,-120,5.51,Guaranteed Rate Field,5,-1
2014-07-02,2014,OAK,DET,3,9,114,1.5,-200,9.0,105,-125,-124,-1.5,170,4.21,Comerica Park,12,-6
2014-07-02,2014,SEA,HOU,5,2,-108,-1.5,150,8.5,-120,100,-102,1.5,-170,4.41,Minute Maid Park,7,3
2014-07-02,2014,MIN,KC,0,4,126,1.5,-130,7.5,-115,-105,-141,-1.5,110,3.32,Target Field,4,-4
2014-07-02,2014,CWS,LAA,3,2,143,1.5,-120,9.0,100,-120,-158,-1.5,100,3.7,Guaranteed Rate Field,5,1
2014-07-02,2014,CLE,LAD,5,4,125,1.5,-190,7.0,-124,104,-140,-1.5,160,3.11,Dodger Stadium,9,1
2014-07-02,2014,PHI,MIA,0,5,-112,-1.5,155,7.0,100,-120,102,1.5,-175,3.7,Marlins Park,5,-5
2014-07-02,2014,TOR,MIL,7,4,-127,-1.5,165,9.5,-105,-115,117,1.5,-195,5.31,Rogers Centre,11,3
2014-07-02,2014,KC,MIN,4,0,-141,-1.5,110,7.5,-115,-105,126,1.5,-130,4.39,Target Field,4,4
2014-07-02,2014,ATL,NYM,3,1,-200,-1.5,110,7.0,-115,-105,170,1.5,-130,4.67,Turner Field,4,2
2014-07-02,2014,TB,NYY,6,3,-110,-1.5,140,9.0,-105,-115,100,1.5,-160,4.71,Yankee Stadium,9,3
2014-07-02,2014,DET,OAK,9,3,-124,-1.5,170,9.0,105,-125,114,1.5,-200,4.98,Comerica Park,12,6
2014-07-02,2014,MIA,PHI,5,0,102,1.5,-175,7.0,100,-120,-112,-1.5,155,3.47,Marlins Park,5,5
2014-07-02,2014,ARI,PIT,1,5,150,1.5,-145,8.0,-115,-105,-170,-1.5,125,3.2,PNC Park,6,-4
2014-07-02,2014,CIN,SD,0,3,-118,-1.5,150,5.5,100,-120,108,1.5,-170,2.98,PETCO Park,3,-3
2014-07-02,2014,HOU,SEA,2,5,-102,1.5,-170,8.5,-120,100,-108,-1.5,150,4.29,Minute Maid Park,7,-3
2014-07-02,2014,STL,SF,2,0,-150,-1.5,115,6.0,-110,-110,135,1.5,-135,3.6,AT&T Park,2,2
2014-07-02,2014,SF,STL,0,2,135,1.5,-135,6.0,-110,-110,-150,-1.5,115,2.55,AT&T Park,2,-2
2014-07-02,2014,NYY,TB,3,6,100,1.5,-160,9.0,-105,-115,-110,-1.5,140,4.5,Yankee Stadium,9,-3
2014-07-02,2014,BAL,TEX,6,4,-131,-1.5,143,9.0,-125,105,116,1.5,-162,5.1,Camden Yards,10,2
2014-07-02,2014,MIL,TOR,4,7,117,1.5,-195,9.5,-105,-115,-127,-1.5,165,4.38,Rogers Centre,11,-3
2014-07-02,2014,COL,WSH,3,4,170,1.5,-125,8.5,-115,-105,-190,-1.5,105,3.15,Nationals Park,7,-1
2014-07-03,2014,PIT,ARI,2,10,-155,-1.5,140,7.5,-105,-115,140,1.5,-160,4.56,PNC Park,12,-8
2014-07-03,2014,TEX,BAL,2,5,150,1.5,-140,9.0,-120,100,-170,-1.5,120,3.6,Camden Yards,7,-3
2014-07-03,2014,LAD,COL,3,2,-144,-1.5,100,10.5,-115,-105,129,1.5,-120,6.2,Coors Field,5,1
2014-07-03,2014,TB,DET,1,8,173,1.5,-120,8.0,-110,-110,-203,-1.5,100,2.93,Comerica Park,9,-7
2014-07-03,2014,LAA,HOU,5,2,-195,-1.5,-101,8.5,100,-120,175,1.5,-119,5.62,Angel Stadium,7,3
2014-07-03,2014,HOU,LAA,2,5,175,1.5,-119,8.5,100,-120,-195,-1.5,-101,3.09,Angel Stadium,7,-3
2014-07-03,2014,COL,LAD,2,3,129,1.5,-120,10.5,-115,-105,-144,-1.5,100,4.59,Coors Field,5,-1
2014-07-03,2014,PHI,MIA,5,4,126,1.5,-190,7.5,-105,-115,-141,-1.5,160,3.32,Marlins Park,9,1
2014-07-03,2014,NYY,MIN,7,4,-157,-1.5,105,6.5,-120,100,142,1.5,-125,3.97,Target Field,11,3
2014-07-03,2014,MIN,NYY,4,7,142,1.5,-125,6.5,-120,100,-157,-1.5,105,2.69,Target Field,11,-3
2014-07-03,2014,TOR,OAK,1,4,118,1.5,-175,8.0,100,-120,-133,-1.5,155,3.67,Oakland Coliseum,5,-3
2014-07-03,2014,MIA,PHI,4,5,-141,-1.5,160,7.5,-105,-115,126,1.5,-190,4.39,Marlins Park,9,-1
2014-07-03,2014,ARI,PIT,10,2,140,1.5,-160,7.5,-105,-115,-155,-1.5,140,3.13,PNC Park,12,8
2014-07-03,2014,STL,SF,7,2,145,1.5,-155,6.5,-110,-110,-160,-1.5,135,2.65,AT&T Park,9,5
2014-07-03,2014,SF,STL,2,7,-160,-1.5,135,6.5,-110,-110,145,1.5,-155,4.0,AT&T Park,9,-5
2014-07-03,2014,DET,TB,8,1,-203,-1.5,100,8.0,-110,-110,173,1.5,-120,5.36,Comerica Park,9,7
2014-07-03,2014,BAL,TEX,5,2,-170,-1.5,120,9.0,-120,100,150,1.5,-140,5.67,Camden Yards,7,3
2014-07-03,2014,OAK,TOR,4,1,-133,-1.5,155,8.0,100,-120,118,1.5,-175,4.57,Oakland Coliseum,5,3
2014-07-04,2014,ATL,ARI,5,2,-165,-1.5,135,7.0,100,-120,150,1.5,-155,4.36,Turner Field,7,3
2014-07-04,2014,ARI,ATL,2,5,150,1.5,-155,7.0,100,-120,-165,-1.5,135,2.8,Turner Field,7,-3
2014-07-04,2014,WSH,CHC,2,7,-155,-1.5,140,7.0,-110,-110,140,1.5,-160,4.25,Nationals Park,9,-5
2014-07-04,2014,MIL,CIN,2,4,108,1.5,-210,7.5,-115,-105,-118,-1.5,180,3.61,Great American Ballpark,6,-2
2014-07-04,2014,KC,CLE,7,1,100,1.5,-215,7.0,-125,105,-110,-1.5,185,3.5,Progressive Field,8,6
2014-07-04,2014,LAD,COL,9,0,-210,-1.5,-140,9.0,-125,105,180,1.5,120,6.1,Coors Field,9,9
2014-07-04,2014,SEA,CWS,1,7,155,1.5,-140,7.0,-105,-115,-175,-1.5,120,2.75,Guaranteed Rate Field,8,-6
2014-07-04,2014,TB,DET,6,3,110,1.5,-200,8.0,100,-120,-120,-1.5,170,3.81,Comerica Park,9,3
2014-07-04,2014,LAA,HOU,7,6,-190,-1.5,110,8.0,-110,-110,170,1.5,-130,5.24,Angel Stadium,13,1
2014-07-04,2014,CLE,KC,1,7,-110,-1.5,185,7.0,-125,105,100,1.5,-215,3.67,Progressive Field,8,-6
2014-07-04,2014,HOU,LAA,6,7,170,1.5,-130,8.0,-110,-110,-190,-1.5,110,2.96,Angel Stadium,13,-1
2014-07-04,2014,COL,LAD,0,9,180,1.5,120,9.0,-125,105,-210,-1.5,-140,3.21,Coors Field,9,-9
2014-07-04,2014,STL,MIA,3,2,-145,-1.5,155,7.5,100,-120,130,1.5,-175,4.44,Busch Stadium,5,1
2014-07-04,2014,CIN,MIL,4,2,-118,-1.5,180,7.5,-115,-105,108,1.5,-210,4.06,Great American Ballpark,6,2
2014-07-04,2014,NYY,MIN,6,5,-102,1.5,-205,8.0,100,-120,-108,-1.5,175,4.04,Target Field,11,1
2014-07-04,2014,TEX,NYM,5,6,-151,-1.5,120,6.0,-105,-115,136,1.5,-140,3.61,Citi Field,11,-1
2014-07-04,2014,MIN,NYY,5,6,-108,-1.5,175,8.0,100,-120,-102,1.5,-205,4.15,Target Field,11,-1
2014-07-04,2014,TOR,OAK,0,1,115,1.5,-195,8.0,100,-120,-125,-1.5,165,3.72,Oakland Coliseum,1,-1
2014-07-04,2014,PIT,PHI,8,2,-200,-1.5,110,7.5,-110,-110,170,1.5,-130,5.0,PNC Park,10,6
2014-07-04,2014,PHI,PIT,2,8,170,1.5,-130,7.5,-110,-110,-200,-1.5,110,2.78,PNC Park,10,-6
2014-07-04,2014,SF,SD,0,2,-108,-1.5,155,7.0,-105,-115,-102,1.5,-175,3.63,PETCO Park,2,-2
2014-07-04,2014,CWS,SEA,7,1,-175,-1.5,120,7.0,-105,-115,155,1.5,-140,4.45,Guaranteed Rate Field,8,6
2014-07-04,2014,SD,SF,2,0,-102,1.5,-175,7.0,-105,-115,-108,-1.5,155,3.53,PETCO Park,2,2
2014-07-04,2014,MIA,STL,2,3,130,1.5,-175,7.5,100,-120,-145,-1.5,155,3.26,Busch Stadium,5,-1
2014-07-04,2014,DET,TB,3,6,-120,-1.5,170,8.0,100,-120,110,1.5,-200,4.36,Comerica Park,9,-3
2014-07-04,2014,NYM,TEX,6,5,136,1.5,-140,6.0,-105,-115,-151,-1.5,120,2.54,Citi Field,11,1
2014-07-04,2014,OAK,TOR,1,0,-125,-1.5,165,8.0,100,-120,115,1.5,-195,4.44,Oakland Coliseum,1,1
2014-07-04,2014,CHC,WSH,7,2,140,1.5,-160,7.0,-110,-110,-155,-1.5,140,2.92,Nationals Park,9,5
2014-07-05,2014,ATL,ARI,10,4,-147,-1.5,155,7.0,-112,-108,132,1.5,-175,4.17,Turner Field,14,6
2014-07-05,2014,ARI,ATL,4,10,132,1.5,-175,7.0,-112,-108,-147,-1.5,155,3.02,Turner Field,14,-6
2014-07-05,2014,BOS,BAL,3,2,-154,-1.5,140,8.5,-120,100,139,1.5,-160,5.15,Fenway Park,5,1
2014-07-05,2014,BOS,BAL,4,7,-170,-1.5,120,9.0,100,-120,150,1.5,-140,5.67,Fenway Park,11,-3
2014-07-05,2014,BAL,BOS,2,3,139,1.5,-160,8.5,-120,100,-154,-1.5,140,3.56,Fenway Park,5,-1
2014-07-05,2014,BAL,BOS,7,4,150,1.5,-140,9.0,100,-120,-170,-1.5,120,3.6,Fenway Park,11,3
2014-07-05,2014,WSH,CHC,13,0,-201,-1.5,100,7.5,-110,-110,171,1.5,-120,5.01,Nationals Park,13,13
2014-07-05,2014,MIL,CIN,1,0,114,1.5,-200,7.5,105,-125,-124,-1.5,170,3.5,Great American Ballpark,1,1
2014-07-05,2014,KC,CLE,3,7,107,1.5,-200,8.0,100,-120,-117,-1.5,170,3.86,Progressive Field,10,-4
2014-07-05,2014,LAD,COL,7,8,-104,-1.5,145,11.0,105,-125,-106,1.5,-165,5.61,Coors Field,15,-1
2014-07-05,2014,SEA,CWS,3,2,-150,-1.5,110,7.0,105,-125,135,1.5,-130,4.2,Guaranteed Rate Field,5,1
2014-07-05,2014,TB,DET,7,2,116,1.5,-195,7.5,-118,-102,-126,-1.5,165,3.47,Comerica Park,9,5
2014-07-05,2014,LAA,HOU,11,5,-195,-1.5,110,8.5,-105,-115,175,1.5,-130,5.62,Angel Stadium,16,6
2014-07-05,2014,CLE,KC,7,3,-117,-1.5,170,8.0,100,-120,107,1.5,-200,4.31,Progressive Field,10,4
2014-07-05,2014,HOU,LAA,5,11,175,1.5,-130,8.5,-105,-115,-195,-1.5,110,3.09,Angel Stadium,16,-6
2014-07-05,2014,COL,LAD,8,7,-106,1.5,-165,11.0,105,-125,-104,-1.5,145,5.66,Coors Field,15,1
2014-07-05,2014,STL,MIA,5,6,-152,-1.5,150,7.5,-105,-115,137,1.5,-170,4.52,Busch Stadium,11,-1
2014-07-05,2014,CIN,MIL,0,1,-124,-1.5,170,7.5,105,-125,114,1.5,-200,4.15,Great American Ballpark,1,-1
2014-07-05,2014,NYY,MIN,1,2,100,1.5,-210,8.5,100,-120,-110,-1.5,180,4.25,Target Field,3,-1
2014-07-05,2014,TEX,NYM,5,3,105,1.5,-205,7.0,-117,-103,-115,-1.5,175,3.41,Citi Field,8,2
2014-07-05,2014,MIN,NYY,2,1,-110,-1.5,180,8.5,100,-120,100,1.5,-210,4.45,Target Field,3,1
2014-07-05,2014,TOR,OAK,1,5,135,1.5,-170,7.0,-125,105,-150,-1.5,150,2.98,Oakland Coliseum,6,-4
2014-07-05,2014,PIT,PHI,3,2,-184,-1.5,115,8.0,100,-120,164,1.5,-135,5.18,PNC Park,5,1
2014-07-05,2014,PHI,PIT,2,3,164,1.5,-135,8.0,100,-120,-184,-1.5,115,3.03,PNC Park,5,-1
2014-07-05,2014,SF,SD,5,3,-140,-1.5,130,6.5,-125,105,125,1.5,-150,3.79,PETCO Park,8,2
2014-07-05,2014,CWS,SEA,2,3,135,1.5,-130,7.0,105,-125,-150,-1.5,110,2.98,Guaranteed Rate Field,5,-1
2014-07-05,2014,SD,SF,3,5,125,1.5,-150,6.5,-125,105,-140,-1.5,130,2.89,PETCO Park,8,-2
2014-07-05,2014,MIA,STL,6,5,137,1.5,-170,7.5,-105,-115,-152,-1.5,150,3.16,Busch Stadium,11,1
2014-07-05,2014,DET,TB,2,7,-126,-1.5,165,7.5,-118,-102,116,1.5,-195,4.18,Comerica Park,9,-5
2014-07-05,2014,NYM,TEX,3,5,-115,-1.5,175,7.0,-117,-103,105,1.5,-205,3.74,Citi Field,8,-2
2014-07-05,2014,OAK,TOR,5,1,-150,-1.5,150,7.0,-125,105,135,1.5,-170,4.2,Oakland Coliseum,6,4
2014-07-05,2014,CHC,WSH,0,13,171,1.5,-120,7.5,-110,-110,-201,-1.5,100,2.77,Nationals Park,13,-13
2014-07-06,2014,ATL,ARI,1,3,-173,-1.5,125,6.5,-120,100,153,1.5,-145,4.12,Turner Field,4,-2
2014-07-06,2014,ARI,ATL,3,1,153,1.5,-145,6.5,-120,100,-173,-1.5,125,2.57,Turner Field,4,2
2014-07-06,2014,BOS,BAL,6,7,-134,-1.5,155,9.0,100,-120,119,1.5,-175,5.15,Fenway Park,13,-1
2014-07-06,2014,BAL,BOS,7,6,119,1.5,-175,9.0,100,-120,-134,-1.5,155,4.11,Fenway Park,13,1
2014-07-06,2014,WSH,CHC,2,1,-181,-1.5,130,7.0,-105,-115,161,1.5,-150,4.51,Nationals Park,3,1
2014-07-06,2014,MIL,CIN,2,4,110,1.5,-200,7.5,-118,-102,-120,-1.5,170,3.57,Great American Ballpark,6,-2
2014-07-06,2014,KC,CLE,1,4,142,1.5,-165,7.0,-110,-110,-157,-1.5,145,2.89,Progressive Field,5,-3
2014-07-06,2014,LAD,COL,8,2,-118,-1.5,125,11.0,105,-125,108,1.5,-145,5.95,Coors Field,10,6
2014-07-06,2014,SEA,CWS,0,1,-140,-1.5,115,9.5,-117,-103,125,1.5,-135,5.54,Guaranteed Rate Field,1,-1
2014-07-06,2014,TB,DET,7,3,-114,-1.5,145,7.5,-115,-105,104,1.5,-165,4.0,Comerica Park,10,4
2014-07-06,2014,LAA,HOU,6,1,-230,-1.5,-115,7.5,-120,100,200,1.5,-105,5.23,Angel Stadium,7,5
2014-07-06,2014,CLE,KC,4,1,-157,-1.5,145,7.0,-110,-110,142,1.5,-165,4.28,Progressive Field,5,3
2014-07-06,2014,HOU,LAA,1,6,200,1.5,-105,7.5,-120,100,-230,-1.5,-115,2.5,Angel Stadium,7,-5
2014-07-06,2014,COL,LAD,2,8,108,1.5,-145,11.0,105,-125,-118,-1.5,125,5.29,Coors Field,10,-6
2014-07-06,2014,STL,MIA,4,8,-115,-1.5,179,8.0,-120,100,105,1.5,-209,4.28,Busch Stadium,12,-4
2014-07-06,2014,CIN,MIL,4,2,-120,-1.5,170,7.5,-118,-102,110,1.5,-200,4.09,Great American Ballpark,6,2
2014-07-06,2014,NYY,MIN,9,7,-140,-1.5,120,9.0,100,-120,125,1.5,-140,5.25,Target Field,16,2
2014-07-06,2014,TEX,NYM,4,8,115,1.5,-200,7.5,-105,-115,-125,-1.5,170,3.49,Citi Field,12,-4
2014-07-06,2014,MIN,NYY,7,9,125,1.5,-140,9.0,100,-120,-140,-1.5,120,4.0,Target Field,16,-2
2014-07-06,2014,TOR,OAK,2,4,130,1.5,-165,7.5,-112,-108,-145,-1.5,145,3.26,Oakland Coliseum,6,-2
2014-07-06,2014,PIT,PHI,6,2,-160,-1.5,135,7.5,105,-125,145,1.5,-155,4.62,PNC Park,8,4
2014-07-06,2014,PHI,PIT,2,6,145,1.5,-155,7.5,105,-125,-160,-1.5,135,3.06,PNC Park,8,-4
2014-07-06,2014,SF,SD,5,3,128,1.5,-195,6.5,-115,-105,-143,-1.5,165,2.85,PETCO Park,8,2
2014-07-06,2014,CWS,SEA,1,0,125,1.5,-135,9.5,-117,-103,-140,-1.5,115,4.22,Guaranteed Rate Field,1,1
2014-07-06,2014,SD,SF,3,5,-143,-1.5,165,6.5,-115,-105,128,1.5,-195,3.83,PETCO Park,8,-2
2014-07-06,2014,MIA,STL,8,4,105,1.5,-209,8.0,-120,100,-115,-1.5,179,3.9,Busch Stadium,12,4
2014-07-06,2014,DET,TB,3,7,104,1.5,-165,7.5,-115,-105,-114,-1.5,145,3.68,Comerica Park,10,-4
2014-07-06,2014,NYM,TEX,8,4,-125,-1.5,170,7.5,-105,-115,115,1.5,-200,4.17,Citi Field,12,4
2014-07-06,2014,OAK,TOR,4,2,-145,-1.5,145,7.5,-112,-108,130,1.5,-165,4.44,Oakland Coliseum,6,2
2014-07-06,2014,CHC,WSH,1,2,161,1.5,-150,7.0,-105,-115,-181,-1.5,130,2.68,Nationals Park,3,-1
2014-07-07,2014,MIA,ARI,1,9,105,1.5,-205,9.0,100,-120,-115,-1.5,175,4.39,Chase Field,10,-8
2014-07-07,2014,NYM,ATL,4,3,110,1.5,-165,7.5,-115,-105,-120,-1.5,145,3.57,Citi Field,7,1
2014-07-07,2014,WSH,BAL,2,8,-199,-1.5,120,8.0,100,-120,179,1.5,-140,5.32,Nationals Park,10,-6
2014-07-07,2014,CWS,BOS,4,0,185,1.5,-110,10.0,-105,-115,-215,-1.5,-110,3.51,Fenway Park,4,4
2014-07-07,2014,CIN,CHC,9,3,-158,-1.5,135,7.5,-120,100,143,1.5,-155,4.59,Great American Ballpark,12,6
2014-07-07,2014,CHC,CIN,3,9,143,1.5,-155,7.5,-120,100,-158,-1.5,135,3.09,Great American Ballpark,12,-6
2014-07-07,2014,NYY,CLE,5,3,142,1.5,-150,9.0,-115,-105,-157,-1.5,130,3.72,Progressive Field,8,2
2014-07-07,2014,SD,COL,6,1,100,1.5,-200,10.5,-105,-115,-110,-1.5,170,5.25,Coors Field,7,5
2014-07-07,2014,BOS,CWS,0,4,-215,-1.5,-110,10.0,-105,-115,185,1.5,-110,6.83,Fenway Park,4,-4
2014-07-07,2014,TEX,HOU,7,12,-147,-1.5,135,9.5,100,-120,132,1.5,-155,5.65,Rangers Ballpark,19,-5
2014-07-07,2014,TB,KC,0,6,-127,-1.5,170,6.5,-123,103,117,1.5,-200,3.64,Tropicana Field,6,-6
2014-07-07,2014,TOR,LAA,2,5,164,1.5,-135,8.5,-125,105,-184,-1.5,115,3.22,Angel Stadium,7,-3
2014-07-07,2014,ARI,MIA,9,1,-115,-1.5,175,9.0,100,-120,105,1.5,-205,4.81,Chase Field,10,8
2014-07-07,2014,PHI,MIL,3,2,126,1.5,-190,8.0,-120,100,-141,-1.5,160,3.54,Miller Park,5,1
2014-07-07,2014,SEA,MIN,2,0,-208,-1.5,100,7.5,100,-120,178,1.5,-120,5.06,T-Mobile Park,2,2
2014-07-07,2014,ATL,NYM,3,4,-120,-1.5,145,7.5,-115,-105,110,1.5,-165,4.09,Citi Field,7,-1
2014-07-07,2014,CLE,NYY,3,5,-157,-1.5,130,9.0,-115,-105,142,1.5,-150,5.5,Progressive Field,8,-2
2014-07-07,2014,SF,OAK,0,5,151,1.5,-145,7.5,-103,-117,-171,-1.5,125,2.99,Oakland Coliseum,5,-5
2014-07-07,2014,MIL,PHI,2,3,-141,-1.5,160,8.0,-120,100,126,1.5,-190,4.68,Miller Park,5,-1
2014-07-07,2014,STL,PIT,2,0,-193,-1.5,125,7.5,-105,-115,173,1.5,-145,4.94,Busch Stadium,2,2
2014-07-07,2014,COL,SD,1,6,-110,-1.5,170,10.5,-105,-115,100,1.5,-200,5.5,Coors Field,7,-5
2014-07-07,2014,MIN,SEA,0,2,178,1.5,-120,7.5,100,-120,-208,-1.5,100,2.7,T-Mobile Park,2,-2
2014-07-07,2014,OAK,SF,5,0,-171,-1.5,125,7.5,-103,-117,151,1.5,-145,4.73,Oakland Coliseum,5,5
2014-07-07,2014,PIT,STL,0,2,173,1.5,-145,7.5,-105,-115,-193,-1.5,125,2.75,Busch Stadium,2,-2
2014-07-07,2014,KC,TB,6,0,117,1.5,-200,6.5,-123,103,-127,-1.5,170,3.0,Tropicana Field,6,6
2014-07-07,2014,HOU,TEX,12,7,132,1.5,-155,9.5,100,-120,-147,-1.5,135,4.09,Rangers Ballpark,19,5
2014-07-07,2014,LAA,TOR,5,2,-184,-1.5,115,8.5,-125,105,164,1.5,-135,5.51,Angel Stadium,7,3
2014-07-07,2014,BAL,WSH,8,2,179,1.5,-140,8.0,100,-120,-199,-1.5,120,2.87,Nationals Park,10,6
2014-07-08,2014,MIA,ARI,2,1,112,1.5,-200,8.5,-102,-118,-122,-1.5,170,4.01,Chase Field,3,1
2014-07-08,2014,NYM,ATL,8,3,133,1.5,-130,7.0,100,-120,-148,-1.5,110,3.0,Citi Field,11,5
2014-07-08,2014,CWS,BOS,8,3,152,1.5,-130,9.5,-115,-105,-172,-1.5,110,3.77,Fenway Park,11,5
2014-07-08,2014,CIN,CHC,4,2,-230,-1.5,-110,7.0,100,-120,200,1.5,-110,4.88,Great American Ballpark,6,2
2014-07-08,2014,CIN,CHC,6,5,100,1.5,-165,8.0,-120,100,-110,-1.5,145,4.0,Great American Ballpark,11,1
2014-07-08,2014,CHC,CIN,2,4,200,1.5,-110,7.0,100,-120,-230,-1.5,-110,2.33,Great American Ballpark,6,-2
2014-07-08,2014,CHC,CIN,5,6,-110,-1.5,145,8.0,-120,100,100,1.5,-165,4.19,Great American Ballpark,11,-1
2014-07-08,2014,NYY,CLE,3,5,-158,-1.5,-105,7.5,-115,-105,143,1.5,-115,4.59,Progressive Field,8,-2
2014-07-08,2014,SD,COL,1,2,-115,-1.5,135,10.0,-115,-105,105,1.5,-155,5.35,Coors Field,3,-1
2014-07-08,2014,BOS,CWS,3,8,-172,-1.5,110,9.5,-115,-105,152,1.5,-130,6.01,Fenway Park,11,-5
2014-07-08,2014,LAD,DET,5,14,112,1.5,-200,8.5,-120,100,-122,-1.5,170,4.01,Comerica Park,19,-9
2014-07-08,2014,TEX,HOU,3,8,-149,-1.5,135,9.5,100,-120,134,1.5,-155,5.68,Rangers Ballpark,11,-5
2014-07-08,2014,TB,KC,4,3,105,1.5,-165,7.0,105,-125,-115,-1.5,145,3.41,Tropicana Field,7,1
2014-07-08,2014,TOR,LAA,4,0,159,1.5,-135,8.0,-115,-105,-179,-1.5,115,3.09,Angel Stadium,4,4
2014-07-08,2014,DET,LAD,14,5,-122,-1.5,170,8.5,-120,100,112,1.5,-200,4.67,Comerica Park,19,9
2014-07-08,2014,ARI,MIA,1,2,-122,-1.5,170,8.5,-102,-118,112,1.5,-200,4.67,Chase Field,3,-1
2014-07-08,2014,PHI,MIL,9,7,160,1.5,-135,8.5,-105,-115,-180,-1.5,115,3.27,Miller Park,16,2
2014-07-08,2014,SEA,MIN,0,2,-110,-1.5,195,7.0,-125,105,100,1.5,-235,3.67,T-Mobile Park,2,-2
2014-07-08,2014,ATL,NYM,3,8,-148,-1.5,110,7.0,100,-120,133,1.5,-130,4.18,Citi Field,11,-5
2014-07-08,2014,CLE,NYY,5,3,143,1.5,-115,7.5,-115,-105,-158,-1.5,-105,3.09,Progressive Field,8,2
2014-07-08,2014,SF,OAK,1,6,134,1.5,-170,6.5,-110,-110,-149,-1.5,150,2.78,Oakland Coliseum,7,-5
2014-07-08,2014,MIL,PHI,7,9,-180,-1.5,115,8.5,-105,-115,160,1.5,-135,5.46,Miller Park,16,-2
2014-07-08,2014,STL,PIT,5,4,-109,-1.5,185,8.0,-115,-105,-101,1.5,-215,4.17,Busch Stadium,9,1
2014-07-08,2014,COL,SD,2,1,105,1.5,-155,10.0,-115,-105,-115,-1.5,135,4.88,Coors Field,3,1
2014-07-08,2014,MIN,SEA,2,0,100,1.5,-235,7.0,-125,105,-110,-1.5,195,3.5,T-Mobile Park,2,2
2014-07-08,2014,OAK,SF,6,1,-149,-1.5,150,6.5,-110,-110,134,1.5,-170,3.89,Oakland Coliseum,7,5
2014-07-08,2014,PIT,STL,4,5,-101,1.5,-215,8.0,-115,-105,-109,-1.5,185,4.02,Busch Stadium,9,-1
2014-07-08,2014,KC,TB,3,4,-115,-1.5,145,7.0,105,-125,105,1.5,-165,3.74,Tropicana Field,7,-1
2014-07-08,2014,HOU,TEX,8,3,134,1.5,-155,9.5,100,-120,-149,-1.5,135,4.06,Rangers Ballpark,11,5
2014-07-08,2014,LAA,TOR,0,4,-179,-1.5,115,8.0,-115,-105,159,1.5,-135,5.13,Angel Stadium,4,-4
2014-07-09,2014,MIA,ARI,3,4,102,1.5,-215,7.5,-115,-105,-112,-1.5,185,3.71,Chase Field,7,-1
2014-07-09,2014,NYM,ATL,4,1,116,1.5,-155,7.0,-110,-110,-126,-1.5,135,3.24,Citi Field,5,3
2014-07-09,2014,WSH,BAL,6,2,-105,-1.5,150,8.5,-110,-110,-105,1.5,-170,4.35,Camden Yards,8,4
2014-07-09,2014,CWS,BOS,4,5,-114,-1.5,145,7.5,-112,-108,104,1.5,-165,4.0,Fenway Park,9,-1
2014-07-09,2014,CIN,CHC,4,1,-155,-1.5,135,7.5,-105,-115,140,1.5,-155,4.56,Great American Ballpark,5,3
2014-07-09,2014,CHC,CIN,1,4,140,1.5,-155,7.5,-105,-115,-155,-1.5,135,3.13,Great American Ballpark,5,-3
2014-07-09,2014,NYY,CLE,5,4,117,1.5,-195,8.0,-105,-115,-127,-1.5,165,3.69,Progressive Field,9,1
2014-07-09,2014,SD,COL,3,6,119,1.5,-165,11.0,-120,100,-129,-1.5,145,5.02,Coors Field,9,-3
2014-07-09,2014,BOS,CWS,5,4,104,1.5,-165,7.5,-112,-108,-114,-1.5,145,3.68,Fenway Park,9,1
2014-07-09,2014,LAD,DET,1,4,100,1.5,-215,7.0,-120,100,-110,-1.5,185,3.5,Comerica Park,5,-3
2014-07-09,2014,TEX,HOU,4,8,-218,-1.5,-110,7.5,-108,-112,188,1.5,-110,5.14,Rangers Ballpark,12,-4
2014-07-09,2014,TB,KC,4,5,-120,-1.5,180,6.5,-107,-113,110,1.5,-210,3.55,Tropicana Field,9,-1
2014-07-09,2014,TOR,LAA,7,8,133,1.5,-170,7.5,-110,-110,-148,-1.5,150,3.22,Angel Stadium,15,-1
2014-07-09,2014,DET,LAD,4,1,-110,-1.5,185,7.0,-120,100,100,1.5,-215,3.67,Comerica Park,5,3
2014-07-09,2014,ARI,MIA,4,3,-112,-1.5,185,7.5,-115,-105,102,1.5,-215,3.96,Chase Field,7,1
2014-07-09,2014,PHI,MIL,4,1,170,1.5,-130,8.0,-115,-105,-190,-1.5,110,2.96,Miller Park,5,3
2014-07-09,2014,SEA,MIN,1,8,-150,-1.5,145,7.5,-110,-110,135,1.5,-165,4.5,T-Mobile Park,9,-7
2014-07-09,2014,ATL,NYM,1,4,-126,-1.5,135,7.0,-110,-110,116,1.5,-155,3.9,Citi Field,5,-3
2014-07-09,2014,CLE,NYY,4,5,-127,-1.5,165,8.0,-105,-115,117,1.5,-195,4.48,Progressive Field,9,-1
2014-07-09,2014,SF,OAK,5,2,113,1.5,-155,7.0,105,-125,-123,-1.5,135,3.29,AT&T Park,7,3
2014-07-09,2014,MIL,PHI,1,4,-190,-1.5,110,8.0,-115,-105,170,1.5,-130,5.24,Miller Park,5,-3
2014-07-09,2014,STL,PIT,5,2,-136,-1.5,155,7.5,-110,-110,121,1.5,-175,4.32,Busch Stadium,7,3
2014-07-09,2014,COL,SD,6,3,-129,-1.5,145,11.0,-120,100,119,1.5,-165,6.2,Coors Field,9,3
2014-07-09,2014,MIN,SEA,8,1,135,1.5,-165,7.5,-110,-110,-150,-1.5,145,3.19,T-Mobile Park,9,7
2014-07-09,2014,OAK,SF,2,5,-123,-1.5,135,7.0,105,-125,113,1.5,-155,3.86,AT&T Park,7,-3
2014-07-09,2014,PIT,STL,2,5,121,1.5,-175,7.5,-110,-110,-136,-1.5,155,3.39,Busch Stadium,7,-3
2014-07-09,2014,KC,TB,5,4,110,1.5,-210,6.5,-107,-113,-120,-1.5,180,3.1,Tropicana Field,9,1
2014-07-09,2014,HOU,TEX,8,4,188,1.5,-110,7.5,-108,-112,-218,-1.5,-110,2.6,Rangers Ballpark,12,4
2014-07-09,2014,LAA,TOR,8,7,-148,-1.5,150,7.5,-110,-110,133,1.5,-170,4.48,Angel Stadium,15,1
2014-07-09,2014,BAL,WSH,2,6,-105,1.5,-170,8.5,-110,-110,-105,-1.5,150,4.35,Camden Yards,8,-4
2014-07-10,2014,NYM,ATL,1,3,-124,-1.5,180,7.0,-101,-119,114,1.5,-210,3.88,Citi Field,4,-2
2014-07-10,2014,WSH,BAL,3,4,-113,-1.5,140,8.0,-118,-102,103,1.5,-160,4.24,Camden Yards,7,-1
2014-07-10,2014,CWS,BOS,3,4,149,1.5,-149,8.0,100,-120,-164,-1.5,129,3.21,Fenway Park,7,-1
2014-07-10,2014,CIN,CHC,4,6,-130,-1.5,160,7.0,-112,-108,115,1.5,-180,3.96,Great American Ballpark,10,-2
2014-07-10,2014,CHC,CIN,6,4,115,1.5,-180,7.0,-112,-108,-130,-1.5,160,3.26,Great American Ballpark,10,2
2014-07-10,2014,NYY,CLE,3,9,137,1.5,-165,8.0,-115,-105,-152,-1.5,145,3.38,Progressive Field,12,-6
2014-07-10,2014,BOS,CWS,4,3,-164,-1.5,129,8.0,100,-120,149,1.5,-149,4.97,Fenway Park,7,1
2014-07-10,2014,KC,DET,4,16,-109,-1.5,185,8.0,-120,100,-101,1.5,-215,4.17,Kauffman Stadium,20,-12
2014-07-10,2014,DET,KC,16,4,-101,1.5,-215,8.0,-120,100,-109,-1.5,185,4.02,Kauffman Stadium,20,12
2014-07-10,2014,TEX,LAA,6,15,118,1.5,-135,9.5,-107,-113,-128,-1.5,115,4.36,Rangers Ballpark,21,-9
2014-07-10,2014,SD,LAD,1,2,240,1.5,115,6.0,-125,105,-280,-1.5,-135,1.76,Dodger Stadium,3,-1
2014-07-10,2014,PHI,MIL,9,1,200,1.5,-110,8.0,-115,-105,-230,-1.5,-110,2.67,Miller Park,10,8
2014-07-10,2014,SEA,MIN,2,4,-155,-1.5,135,7.5,-115,-105,140,1.5,-155,4.56,T-Mobile Park,6,-2
2014-07-10,2014,ATL,NYM,3,1,114,1.5,-210,7.0,-101,-119,-124,-1.5,180,3.27,Citi Field,4,2
2014-07-10,2014,CLE,NYY,9,3,-152,-1.5,145,8.0,-115,-105,137,1.5,-165,4.83,Progressive Field,12,6
2014-07-10,2014,SF,OAK,1,6,-101,1.5,-175,7.0,-105,-115,-109,-1.5,155,3.52,AT&T Park,7,-5
2014-07-10,2014,MIL,PHI,1,9,-230,-1.5,-110,8.0,-115,-105,200,1.5,-110,5.58,Miller Park,10,-8
2014-07-10,2014,STL,PIT,1,9,-106,-1.5,190,8.0,-120,100,-104,1.5,-230,4.12,Busch Stadium,10,-8
2014-07-10,2014,LAD,SD,2,1,-280,-1.5,-135,6.0,-125,105,240,1.5,115,4.42,Dodger Stadium,3,1
2014-07-10,2014,MIN,SEA,4,2,140,1.5,-155,7.5,-115,-105,-155,-1.5,135,3.13,T-Mobile Park,6,2
2014-07-10,2014,OAK,SF,6,1,-109,-1.5,155,7.0,-105,-115,-101,1.5,-175,3.65,AT&T Park,7,5
2014-07-10,2014,PIT,STL,9,1,-104,1.5,-230,8.0,-120,100,-106,-1.5,190,4.08,Busch Stadium,10,8
2014-07-10,2014,LAA,TEX,15,6,-128,-1.5,115,9.5,-107,-113,118,1.5,-135,5.33,Rangers Ballpark,21,9
2014-07-10,2014,BAL,WSH,4,3,103,1.5,-160,8.0,-118,-102,-113,-1.5,140,3.94,Camden Yards,7,1
2014-07-11,2014,SF,ARI,5,0,-123,-1.5,180,7.0,-125,105,113,1.5,-210,3.86,AT&T Park,5,5
2014-07-11,2014,CHC,ATL,5,4,-110,-1.5,195,7.5,100,-120,100,1.5,-235,3.93,Wrigley Field,9,1
2014-07-11,2014,NYY,BAL,2,3,-107,-1.5,150,8.5,-112,-108,-103,1.5,-170,4.39,Camden Yards,5,-1
2014-07-11,2014,HOU,BOS,3,8,115,1.5,-145,7.5,-105,-115,-130,-1.5,125,3.49,Minute Maid Park,11,-5
2014-07-11,2014,ATL,CHC,4,5,100,1.5,-235,7.5,100,-120,-110,-1.5,195,3.75,Wrigley Field,9,-1
2014-07-11,2014,PIT,CIN,5,6,-109,-1.5,150,7.5,-108,-112,-101,1.5,-170,3.91,Great American Ballpark,11,-1
2014-07-11,2014,CWS,CLE,4,7,200,1.5,-110,7.5,-120,100,-230,-1.5,-110,2.5,Progressive Field,11,-3
2014-07-11,2014,MIN,COL,2,6,170,1.5,-120,10.0,-105,-115,-190,-1.5,100,3.7,Coors Field,8,-4
2014-07-11,2014,CLE,CWS,7,4,-230,-1.5,-110,7.5,-120,100,200,1.5,-110,5.23,Progressive Field,11,3
2014-07-11,2014,KC,DET,1,2,111,1.5,-150,8.5,-113,-107,-121,-1.5,130,4.03,Kauffman Stadium,3,-1
2014-07-11,2014,BOS,HOU,8,3,-130,-1.5,125,7.5,-105,-115,115,1.5,-145,4.24,Minute Maid Park,11,5
2014-07-11,2014,DET,KC,2,1,-121,-1.5,130,8.5,-113,-107,111,1.5,-150,4.65,Kauffman Stadium,3,1
2014-07-11,2014,TEX,LAA,0,3,172,1.5,105,9.5,105,-125,-192,-1.5,-125,3.49,Rangers Ballpark,3,-3
2014-07-11,2014,SD,LAD,6,3,-101,1.5,-235,7.0,105,-125,-109,-1.5,195,3.52,Dodger Stadium,9,3
2014-07-11,2014,NYM,MIA,7,1,-117,-1.5,180,7.0,100,-120,107,1.5,-210,3.77,Citi Field,8,6
2014-07-11,2014,STL,MIL,7,6,125,1.5,-175,8.0,-110,-110,-140,-1.5,155,3.56,Miller Park,13,1
2014-07-11,2014,COL,MIN,6,2,-190,-1.5,100,10.0,-105,-115,170,1.5,-120,6.55,Coors Field,8,4
2014-07-11,2014,MIA,NYM,1,7,107,1.5,-210,7.0,100,-120,-117,-1.5,180,3.38,Citi Field,8,-6
2014-07-11,2014,BAL,NYY,3,2,-103,1.5,-170,8.5,-112,-108,-107,-1.5,150,4.31,Camden Yards,5,1
2014-07-11,2014,SEA,OAK,3,2,-142,-1.5,160,6.0,-130,110,127,1.5,-190,3.52,T-Mobile Park,5,1
2014-07-11,2014,WSH,PHI,2,6,-154,-1.5,105,7.5,105,-125,139,1.5,-125,4.55,Citizens Bank Park,8,-4
2014-07-11,2014,CIN,PIT,6,5,-101,1.5,-170,7.5,-108,-112,-109,-1.5,150,3.77,Great American Ballpark,11,1
2014-07-11,2014,LAD,SD,3,6,-109,-1.5,195,7.0,105,-125,-101,1.5,-235,3.65,Dodger Stadium,9,-3
2014-07-11,2014,OAK,SEA,2,3,127,1.5,-190,6.0,-130,110,-142,-1.5,160,2.64,T-Mobile Park,5,-1
2014-07-11,2014,ARI,SF,0,5,113,1.5,-210,7.0,-125,105,-123,-1.5,180,3.29,AT&T Park,5,-5
2014-07-11,2014,MIL,STL,6,7,-140,-1.5,155,8.0,-110,-110,125,1.5,-175,4.67,Miller Park,13,-1
2014-07-11,2014,TOR,TB,8,5,115,1.5,-200,7.0,-125,105,-130,-1.5,170,3.26,Tropicana Field,13,3
2014-07-11,2014,LAA,TEX,3,0,-192,-1.5,-125,9.5,105,-125,172,1.5,105,6.25,Rangers Ballpark,3,3
2014-07-11,2014,TB,TOR,5,8,-130,-1.5,170,7.0,-125,105,115,1.5,-200,3.96,Tropicana Field,13,-3
2014-07-11,2014,PHI,WSH,6,2,139,1.5,-125,7.5,105,-125,-154,-1.5,105,3.14,Citizens Bank Park,8,4
2014-07-12,2014,SF,ARI,0,2,-120,-1.5,180,7.0,110,-130,110,1.5,-210,3.82,AT&T Park,2,-2
2014-07-12,2014,CHC,ATL,6,11,118,1.5,-145,9.0,100,-120,-128,-1.5,125,4.13,Wrigley Field,17,-5
2014-07-12,2014,NYY,BAL,3,0,130,1.5,-160,9.0,-125,105,-145,-1.5,140,3.91,Camden Yards,3,3
2014-07-12,2014,HOU,BOS,3,2,116,1.5,-155,8.0,-120,100,-131,-1.5,135,3.7,Minute Maid Park,5,1
2014-07-12,2014,ATL,CHC,11,6,-128,-1.5,125,9.0,100,-120,118,1.5,-145,5.05,Wrigley Field,17,5
2014-07-12,2014,PIT,CIN,6,5,101,1.5,-215,7.5,-115,-105,-111,-1.5,185,3.73,Great American Ballpark,11,1
2014-07-12,2014,CWS,CLE,6,2,171,1.5,-125,9.0,-115,-105,-191,-1.5,105,3.32,Progressive Field,8,4
2014-07-12,2014,MIN,COL,9,3,155,1.5,-120,10.5,-125,105,-175,-1.5,100,4.12,Coors Field,12,6
2014-07-12,2014,CLE,CWS,2,6,-191,-1.5,105,9.0,-115,-105,171,1.5,-125,5.91,Progressive Field,8,-4
2014-07-12,2014,KC,DET,1,5,-132,-1.5,165,8.0,-120,100,117,1.5,-195,4.55,Kauffman Stadium,6,-4
2014-07-12,2014,BOS,HOU,2,3,-131,-1.5,135,8.0,-120,100,116,1.5,-155,4.54,Minute Maid Park,5,-1
2014-07-12,2014,DET,KC,5,1,117,1.5,-195,8.0,-120,100,-132,-1.5,165,3.69,Kauffman Stadium,6,4
2014-07-12,2014,TEX,LAA,2,5,146,1.5,-110,9.5,-115,-105,-161,-1.5,-110,3.86,Rangers Ballpark,7,-3
2014-07-12,2014,SD,LAD,0,1,-109,-1.5,150,7.0,-115,-105,-101,1.5,-170,3.65,Dodger Stadium,1,-1
2014-07-12,2014,NYM,MIA,5,4,-115,-1.5,180,8.0,100,-120,105,1.5,-210,4.28,Citi Field,9,1
2014-07-12,2014,STL,MIL,10,2,-121,-1.5,140,7.5,100,-120,111,1.5,-160,4.11,Miller Park,12,8
2014-07-12,2014,COL,MIN,3,9,-175,-1.5,100,10.5,-125,105,155,1.5,-120,6.68,Coors Field,12,-6
2014-07-12,2014,MIA,NYM,4,5,105,1.5,-210,8.0,100,-120,-115,-1.5,180,3.9,Citi Field,9,-1
2014-07-12,2014,BAL,NYY,0,3,-145,-1.5,140,9.0,-125,105,130,1.5,-160,5.33,Camden Yards,3,-3
2014-07-12,2014,SEA,OAK,6,2,-104,1.5,-190,7.0,-113,-107,-106,-1.5,160,3.57,T-Mobile Park,8,4
2014-07-12,2014,WSH,PHI,5,3,-130,-1.5,130,7.0,-110,-110,115,1.5,-150,3.96,Citizens Bank Park,8,2
2014-07-12,2014,CIN,PIT,5,6,-111,-1.5,185,7.5,-115,-105,101,1.5,-215,3.95,Great American Ballpark,11,-1
2014-07-12,2014,LAD,SD,1,0,-101,1.5,-170,7.0,-115,-105,-109,-1.5,150,3.52,Dodger Stadium,1,1
2014-07-12,2014,OAK,SEA,2,6,-106,-1.5,160,7.0,-113,-107,-104,1.5,-190,3.6,T-Mobile Park,8,-4
2014-07-12,2014,ARI,SF,2,0,110,1.5,-210,7.0,110,-130,-120,-1.5,180,3.33,AT&T Park,2,2
2014-07-12,2014,MIL,STL,2,10,111,1.5,-160,7.5,100,-120,-121,-1.5,140,3.55,Miller Park,12,-8
2014-07-12,2014,TOR,TB,3,10,112,1.5,-200,7.5,105,-125,-122,-1.5,170,3.54,Tropicana Field,13,-7
2014-07-12,2014,LAA,TEX,5,2,-161,-1.5,-110,9.5,-115,-105,146,1.5,-110,5.86,Rangers Ballpark,7,3
2014-07-12,2014,TB,TOR,10,3,-122,-1.5,170,7.5,105,-125,112,1.5,-200,4.12,Tropicana Field,13,7
2014-07-12,2014,PHI,WSH,3,5,115,1.5,-150,7.0,-110,-110,-130,-1.5,130,3.26,Citizens Bank Park,8,-2
2014-07-13,2014,SF,ARI,8,4,-192,-1.5,125,6.5,-112,-108,172,1.5,-145,4.27,AT&T Park,12,4
2014-07-13,2014,CHC,ATL,7,10,144,1.5,-120,8.0,-105,-115,-159,-1.5,100,3.28,Wrigley Field,17,-3
2014-07-13,2014,NYY,BAL,1,3,132,1.5,-155,8.5,-105,-115,-147,-1.5,135,3.66,Camden Yards,4,-2
2014-07-13,2014,HOU,BOS,0,11,115,1.5,-145,8.0,-120,100,-130,-1.5,125,3.72,Minute Maid Park,11,-11
2014-07-13,2014,ATL,CHC,10,7,-159,-1.5,100,8.0,-105,-115,144,1.5,-120,4.91,Wrigley Field,17,3
2014-07-13,2014,PIT,CIN,3,6,113,1.5,-205,7.0,-110,-110,-123,-1.5,175,3.29,Great American Ballpark,9,-3
2014-07-13,2014,CWS,CLE,2,3,150,1.5,-140,8.5,-115,-105,-170,-1.5,120,3.4,Progressive Field,5,-1
2014-07-13,2014,MIN,COL,13,5,119,1.5,-175,9.5,-110,-110,-129,-1.5,155,4.34,Coors Field,18,8
2014-07-13,2014,CLE,CWS,3,2,-170,-1.5,120,8.5,-115,-105,150,1.5,-140,5.35,Progressive Field,5,1
2014-07-13,2014,KC,DET,5,2,119,1.5,-140,8.5,-112,-108,-134,-1.5,120,3.88,Kauffman Stadium,7,3
2014-07-13,2014,BOS,HOU,11,0,-130,-1.5,125,8.0,-120,100,115,1.5,-145,4.52,Minute Maid Park,11,11
2014-07-13,2014,DET,KC,2,5,-134,-1.5,120,8.5,-112,-108,119,1.5,-140,4.87,Kauffman Stadium,7,-3
2014-07-13,2014,TEX,LAA,7,10,139,1.5,-115,10.0,-111,-109,-154,-1.5,-105,4.18,Rangers Ballpark,17,-3
2014-07-13,2014,SD,LAD,0,1,133,1.5,-175,6.5,-116,-104,-148,-1.5,155,2.79,Dodger Stadium,1,-1
2014-07-13,2014,NYM,MIA,9,1,-155,-1.5,135,8.0,100,-120,140,1.5,-155,4.86,Citi Field,10,8
2014-07-13,2014,STL,MIL,2,11,100,1.5,-215,8.5,-120,100,-110,-1.5,185,4.25,Miller Park,13,-9
2014-07-13,2014,COL,MIN,5,13,-129,-1.5,155,9.5,-110,-110,119,1.5,-175,5.35,Coors Field,18,-8
2014-07-13,2014,MIA,NYM,1,9,140,1.5,-155,8.0,100,-120,-155,-1.5,135,3.33,Citi Field,10,-8
2014-07-13,2014,BAL,NYY,3,1,-147,-1.5,135,8.5,-105,-115,132,1.5,-155,5.06,Camden Yards,4,2
2014-07-13,2014,SEA,OAK,1,4,135,1.5,-125,7.5,-118,-102,-150,-1.5,105,3.19,T-Mobile Park,5,-3
2014-07-13,2014,WSH,PHI,10,3,-142,-1.5,115,8.5,-120,100,127,1.5,-135,4.99,Citizens Bank Park,13,7
2014-07-13,2014,CIN,PIT,6,3,-123,-1.5,175,7.0,-110,-110,113,1.5,-205,3.86,Great American Ballpark,9,3
2014-07-13,2014,LAD,SD,1,0,-148,-1.5,155,6.5,-116,-104,133,1.5,-175,3.88,Dodger Stadium,1,1
2014-07-13,2014,OAK,SEA,4,1,-150,-1.5,105,7.5,-118,-102,135,1.5,-125,4.5,T-Mobile Park,5,3
2014-07-13,2014,ARI,SF,4,8,172,1.5,-145,6.5,-112,-108,-192,-1.5,125,2.39,AT&T Park,12,-4
2014-07-13,2014,MIL,STL,11,2,-110,-1.5,185,8.5,-120,100,100,1.5,-215,4.45,Miller Park,13,9
2014-07-13,2014,TOR,TB,0,3,164,1.5,-145,6.5,-105,-115,-184,-1.5,125,2.46,Tropicana Field,3,-3
2014-07-13,2014,LAA,TEX,10,7,-154,-1.5,-105,10.0,-111,-109,139,1.5,-115,6.06,Rangers Ballpark,17,3
2014-07-13,2014,TB,TOR,3,0,-184,-1.5,125,6.5,-105,-115,164,1.5,-145,4.21,Tropicana Field,3,3
2014-07-13,2014,PHI,WSH,3,10,127,1.5,-135,8.5,-120,100,-142,-1.5,115,3.74,Citizens Bank Park,13,-7
2014-07-18,2014,CHC,ARI,4,5,119,1.5,-190,8.5,-115,-105,-129,-1.5,160,3.88,Chase Field,9,-1
2014-07-18,2014,PHI,ATL,4,6,157,1.5,-145,7.0,100,-120,-177,-1.5,125,2.72,Turner Field,10,-2
2014-07-18,2014,OAK,BAL,5,4,-163,-1.5,120,7.0,-125,105,148,1.5,-140,4.34,Oakland Coliseum,9,1
2014-07-18,2014,KC,BOS,4,5,115,1.5,-195,8.0,-105,-115,-125,-1.5,165,3.72,Fenway Park,9,-1
2014-07-18,2014,ARI,CHC,5,4,-129,-1.5,160,8.5,-115,-105,119,1.5,-190,4.79,Chase Field,9,1
2014-07-18,2014,NYY,CIN,4,3,-140,-1.5,160,8.0,-110,-110,125,1.5,-190,4.67,Yankee Stadium,7,1
2014-07-18,2014,DET,CLE,3,9,-174,-1.5,120,8.5,-120,100,154,1.5,-140,5.4,Comerica Park,12,-6
2014-07-18,2014,PIT,COL,4,2,-152,-1.5,145,7.5,-115,-105,137,1.5,-165,4.52,PNC Park,6,2
2014-07-18,2014,HOU,CWS,2,3,148,1.5,-140,8.5,-105,-115,-163,-1.5,120,3.43,Guaranteed Rate Field,5,-1
2014-07-18,2014,CLE,DET,9,3,154,1.5,-140,8.5,-120,100,-174,-1.5,120,3.35,Comerica Park,12,6
2014-07-18,2014,CWS,HOU,3,2,-163,-1.5,120,8.5,-105,-115,148,1.5,-140,5.27,Guaranteed Rate Field,5,1
2014-07-18,2014,BOS,KC,5,4,-125,-1.5,165,8.0,-105,-115,115,1.5,-195,4.44,Fenway Park,9,1
2014-07-18,2014,SEA,LAA,2,3,126,1.5,-170,7.5,100,-120,-141,-1.5,150,3.32,Angel Stadium,5,-1
2014-07-18,2014,STL,LAD,3,2,-130,-1.5,170,8.0,100,-120,115,1.5,-200,4.52,Busch Stadium,5,1
2014-07-18,2014,SF,MIA,9,1,-127,-1.5,140,7.0,-120,100,117,1.5,-160,3.92,Marlins Park,10,8
2014-07-18,2014,WSH,MIL,2,4,-179,-1.5,120,7.0,-120,100,159,1.5,-140,4.49,Nationals Park,6,-2
2014-07-18,2014,TB,MIN,6,2,-120,-1.5,140,8.0,-115,-105,110,1.5,-160,4.36,Target Field,8,4
2014-07-18,2014,SD,NYM,4,5,-130,-1.5,180,6.5,100,-120,115,1.5,-210,3.67,PETCO Park,9,-1
2014-07-18,2014,CIN,NYY,3,4,125,1.5,-190,8.0,-110,-110,-140,-1.5,160,3.56,Yankee Stadium,7,-1
2014-07-18,2014,BAL,OAK,4,5,148,1.5,-140,7.0,-125,105,-163,-1.5,120,2.82,Oakland Coliseum,9,-1
2014-07-18,2014,ATL,PHI,6,4,-177,-1.5,125,7.0,100,-120,157,1.5,-145,4.47,Turner Field,10,2
2014-07-18,2014,COL,PIT,2,4,137,1.5,-165,7.5,-115,-105,-152,-1.5,145,3.16,PNC Park,6,-2
2014-07-18,2014,NYM,SD,5,4,115,1.5,-210,6.5,100,-120,-130,-1.5,180,3.02,PETCO Park,9,1
2014-07-18,2014,LAA,SEA,3,2,-141,-1.5,150,7.5,100,-120,126,1.5,-170,4.39,Angel Stadium,5,1
2014-07-18,2014,MIA,SF,1,9,117,1.5,-160,7.0,-120,100,-127,-1.5,140,3.23,Marlins Park,10,-8
2014-07-18,2014,LAD,STL,2,3,115,1.5,-200,8.0,100,-120,-130,-1.5,170,3.72,Busch Stadium,5,-1
2014-07-18,2014,MIN,TB,2,6,110,1.5,-160,8.0,-115,-105,-120,-1.5,140,3.81,Target Field,8,-4
2014-07-18,2014,TOR,TEX,1,5,-103,1.5,-170,7.5,-105,-115,-107,-1.5,150,3.81,Rogers Centre,6,-4
2014-07-18,2014,TEX,TOR,5,1,-107,-1.5,150,7.5,-105,-115,-103,1.5,-170,3.88,Rogers Centre,6,4
2014-07-18,2014,MIL,WSH,4,2,159,1.5,-140,7.0,-120,100,-179,-1.5,120,2.7,Nationals Park,6,2
2014-07-19,2014,CHC,ARI,3,9,137,1.5,-170,8.0,-115,-105,-152,-1.5,150,3.38,Chase Field,12,-6
2014-07-19,2014,PHI,ATL,2,1,-105,1.5,-230,7.0,105,-125,-105,-1.5,190,3.59,Turner Field,3,1
2014-07-19,2014,OAK,BAL,4,8,-156,-1.5,135,7.5,100,-120,141,1.5,-155,4.57,Oakland Coliseum,12,-4
2014-07-19,2014,KC,BOS,1,2,116,1.5,-210,8.0,-110,-110,-131,-1.5,180,3.7,Fenway Park,3,-1
2014-07-19,2014,ARI,CHC,9,3,-152,-1.5,150,8.0,-115,-105,137,1.5,-170,4.83,Chase Field,12,6
2014-07-19,2014,NYY,CIN,7,1,-158,-1.5,145,7.5,-105,-115,143,1.5,-165,4.59,Yankee Stadium,8,6
2014-07-19,2014,DET,CLE,2,6,125,1.5,-145,8.5,-120,100,-140,-1.5,125,3.78,Comerica Park,8,-4
2014-07-19,2014,DET,CLE,2,5,-195,-1.5,105,8.5,-120,100,175,1.5,-125,5.62,Comerica Park,7,-3
2014-07-19,2014,PIT,COL,3,2,-153,-1.5,135,7.5,100,-120,138,1.5,-155,4.54,PNC Park,5,1
2014-07-19,2014,HOU,CWS,3,4,-107,-1.5,150,8.5,-110,-110,-103,1.5,-170,4.39,Guaranteed Rate Field,7,-1
2014-07-19,2014,CLE,DET,6,2,-140,-1.5,125,8.5,-120,100,125,1.5,-145,4.96,Comerica Park,8,4
2014-07-19,2014,CLE,DET,5,2,175,1.5,-125,8.5,-120,100,-195,-1.5,105,3.09,Comerica Park,7,3
2014-07-19,2014,CWS,HOU,4,3,-103,1.5,-170,8.5,-110,-110,-107,-1.5,150,4.31,Guaranteed Rate Field,7,1
2014-07-19,2014,BOS,KC,2,1,-131,-1.5,180,8.0,-110,-110,116,1.5,-210,4.54,Fenway Park,3,1
2014-07-19,2014,SEA,LAA,3,2,-105,-1.5,160,6.5,-120,100,-105,1.5,-190,3.33,Angel Stadium,5,1
2014-07-19,2014,STL,LAD,4,2,134,1.5,-135,7.5,100,-120,-149,-1.5,115,3.21,Busch Stadium,6,2
2014-07-19,2014,SF,MIA,5,3,-114,-1.5,155,7.0,-120,100,104,1.5,-175,3.73,Marlins Park,8,2
2014-07-19,2014,WSH,MIL,8,3,-124,-1.5,165,7.5,-110,-110,114,1.5,-195,4.15,Nationals Park,11,5
2014-07-19,2014,TB,MIN,5,1,-148,-1.5,110,7.0,-110,-110,133,1.5,-130,4.18,Target Field,6,4
2014-07-19,2014,SD,NYM,6,0,-134,-1.5,170,6.0,-120,100,119,1.5,-200,3.44,PETCO Park,6,6
2014-07-19,2014,CIN,NYY,1,7,143,1.5,-165,7.5,-105,-115,-158,-1.5,145,3.09,Yankee Stadium,8,-6
2014-07-19,2014,BAL,OAK,8,4,141,1.5,-155,7.5,100,-120,-156,-1.5,135,3.11,Oakland Coliseum,12,4
2014-07-19,2014,ATL,PHI,1,2,-105,-1.5,190,7.0,105,-125,-105,1.5,-230,3.59,Turner Field,3,-1
2014-07-19,2014,COL,PIT,2,3,138,1.5,-155,7.5,100,-120,-153,-1.5,135,3.15,PNC Park,5,-1
2014-07-19,2014,NYM,SD,0,6,119,1.5,-200,6.0,-120,100,-134,-1.5,170,2.74,PETCO Park,6,-6
2014-07-19,2014,LAA,SEA,2,3,-105,1.5,-190,6.5,-120,100,-105,-1.5,160,3.33,Angel Stadium,5,-1
2014-07-19,2014,MIA,SF,3,5,104,1.5,-175,7.0,-120,100,-114,-1.5,155,3.43,Marlins Park,8,-2
2014-07-19,2014,LAD,STL,2,4,-149,-1.5,115,7.5,100,-120,134,1.5,-135,4.49,Busch Stadium,6,-2
2014-07-19,2014,MIN,TB,1,5,133,1.5,-130,7.0,-110,-110,-148,-1.5,110,3.0,Target Field,6,-4
2014-07-19,2014,TOR,TEX,4,1,-170,-1.5,110,9.0,100,-120,150,1.5,-130,5.67,Rogers Centre,5,3
2014-07-19,2014,TEX,TOR,1,4,150,1.5,-130,9.0,100,-120,-170,-1.5,110,3.6,Rogers Centre,5,-3
2014-07-19,2014,MIL,WSH,3,8,114,1.5,-195,7.5,-110,-110,-124,-1.5,165,3.5,Nationals Park,11,-5
2014-07-20,2014,CHC,ARI,2,3,103,1.5,-215,7.5,-105,-115,-113,-1.5,185,3.69,Chase Field,5,-1
2014-07-20,2014,PHI,ATL,2,8,173,1.5,-130,7.0,-105,-115,-193,-1.5,110,2.56,Turner Field,10,-6
2014-07-20,2014,OAK,BAL,10,2,-149,-1.5,140,7.5,105,-125,134,1.5,-160,4.49,Oakland Coliseum,12,8
2014-07-20,2014,KC,BOS,0,6,144,1.5,-160,7.0,-105,-115,-159,-1.5,140,2.87,Fenway Park,6,-6
2014-07-20,2014,ARI,CHC,3,2,-113,-1.5,185,7.5,-105,-115,103,1.5,-215,3.98,Chase Field,5,1
2014-07-20,2014,NYY,CIN,3,2,-122,-1.5,175,7.0,105,-125,112,1.5,-205,3.85,Yankee Stadium,5,1
2014-07-20,2014,DET,CLE,5,1,-120,-1.5,160,9.0,-115,-105,110,1.5,-190,4.91,Comerica Park,6,4
2014-07-20,2014,PIT,COL,5,3,-180,-1.5,130,7.5,-110,-110,160,1.5,-150,4.82,PNC Park,8,2
2014-07-20,2014,HOU,CWS,11,7,117,1.5,-175,9.0,100,-120,-127,-1.5,155,4.15,Guaranteed Rate Field,18,4
2014-07-20,2014,CLE,DET,1,5,110,1.5,-190,9.0,-115,-105,-120,-1.5,160,4.29,Comerica Park,6,-4
2014-07-20,2014,CWS,HOU,7,11,-127,-1.5,155,9.0,100,-120,117,1.5,-175,5.04,Guaranteed Rate Field,18,-4
2014-07-20,2014,BOS,KC,6,0,-159,-1.5,140,7.0,-105,-115,144,1.5,-160,4.3,Fenway Park,6,6
2014-07-20,2014,SEA,LAA,5,6,163,1.5,-140,8.5,-115,-105,-183,-1.5,120,3.23,Angel Stadium,11,-1
2014-07-20,2014,STL,LAD,3,4,160,1.5,-120,6.5,103,-123,-180,-1.5,100,2.5,Busch Stadium,7,-1
2014-07-20,2014,SF,MIA,2,3,-128,-1.5,130,7.5,-110,-110,118,1.5,-150,4.21,Marlins Park,5,-1
2014-07-20,2014,WSH,MIL,5,4,-125,-1.5,165,7.5,-110,-110,115,1.5,-195,4.17,Nationals Park,9,1
2014-07-20,2014,TB,MIN,5,3,-131,-1.5,120,8.5,-110,-110,116,1.5,-140,4.82,Target Field,8,2
2014-07-20,2014,SD,NYM,2,1,103,1.5,-175,7.0,-110,-110,-113,-1.5,155,3.45,PETCO Park,3,1
2014-07-20,2014,CIN,NYY,2,3,112,1.5,-205,7.0,105,-125,-122,-1.5,175,3.3,Yankee Stadium,5,-1
2014-07-20,2014,BAL,OAK,2,10,134,1.5,-160,7.5,105,-125,-149,-1.5,140,3.21,Oakland Coliseum,12,-8
2014-07-20,2014,ATL,PHI,8,2,-193,-1.5,110,7.0,-105,-115,173,1.5,-130,4.61,Turner Field,10,6
2014-07-20,2014,COL,PIT,3,5,160,1.5,-150,7.5,-110,-110,-180,-1.5,130,2.88,PNC Park,8,-2
2014-07-20,2014,NYM,SD,1,2,-113,-1.5,155,7.0,-110,-110,103,1.5,-175,3.71,PETCO Park,3,-1
2014-07-20,2014,LAA,SEA,6,5,-183,-1.5,120,8.5,-115,-105,163,1.5,-140,5.5,Angel Stadium,11,1
2014-07-20,2014,MIA,SF,3,2,118,1.5,-150,7.5,-110,-110,-128,-1.5,130,3.44,Marlins Park,5,1
2014-07-20,2014,LAD,STL,4,3,-180,-1.5,100,6.5,103,-123,160,1.5,-120,4.18,Busch Stadium,7,1
2014-07-20,2014,MIN,TB,3,5,116,1.5,-140,8.5,-110,-110,-131,-1.5,120,3.94,Target Field,8,-2
2014-07-20,2014,TOR,TEX,9,6,-170,-1.5,115,8.5,-110,-110,150,1.5,-135,5.35,Rogers Centre,15,3
2014-07-20,2014,TEX,TOR,6,9,150,1.5,-135,8.5,-110,-110,-170,-1.5,115,3.4,Rogers Centre,15,-3
2014-07-20,2014,MIL,WSH,4,5,115,1.5,-195,7.5,-110,-110,-125,-1.5,165,3.49,Nationals Park,9,-1
2014-07-21,2014,DET,ARI,4,3,-130,-1.5,120,9.0,-105,-115,115,1.5,-140,5.09,Chase Field,7,1
2014-07-21,2014,MIA,ATL,3,1,175,1.5,-130,7.0,-105,-115,-195,-1.5,110,2.55,Turner Field,4,2
2014-07-21,2014,LAA,BAL,2,4,-135,-1.5,150,8.5,-110,-110,120,1.5,-170,4.88,Angel Stadium,6,-2
2014-07-21,2014,TOR,BOS,1,14,-109,1.5,-190,8.0,-110,-110,-101,-1.5,160,4.17,Rogers Centre,15,-13
2014-07-21,2014,MIL,CIN,5,2,-152,-1.5,135,8.0,-105,-115,137,1.5,-155,4.83,Miller Park,7,3
2014-07-21,2014,MIN,CLE,4,3,100,1.5,-165,9.5,100,-120,-110,-1.5,145,4.75,Target Field,7,1
2014-07-21,2014,WSH,COL,7,2,-141,-1.5,105,11.0,-110,-110,126,1.5,-125,6.44,Coors Field,9,5
2014-07-21,2014,KC,CWS,1,3,158,1.5,-140,7.0,-115,-105,-178,-1.5,120,2.71,Guaranteed Rate Field,4,-2
2014-07-21,2014,ARI,DET,3,4,115,1.5,-140,9.0,-105,-115,-130,-1.5,120,4.19,Chase Field,7,-1
2014-07-21,2014,CWS,KC,3,1,-178,-1.5,120,7.0,-115,-105,158,1.5,-140,4.48,Guaranteed Rate Field,4,2
2014-07-21,2014,BAL,LAA,4,2,120,1.5,-170,8.5,-110,-110,-135,-1.5,150,3.86,Angel Stadium,6,2
2014-07-21,2014,PIT,LAD,2,5,-114,-1.5,175,7.5,100,-120,104,1.5,-205,4.0,PNC Park,7,-3
2014-07-21,2014,ATL,MIA,1,3,-195,-1.5,110,7.0,-105,-115,175,1.5,-130,4.63,Turner Field,4,-2
2014-07-21,2014,CIN,MIL,2,5,137,1.5,-155,8.0,-105,-115,-152,-1.5,135,3.38,Miller Park,7,-3
2014-07-21,2014,CLE,MIN,3,4,-110,-1.5,145,9.5,100,-120,100,1.5,-165,4.98,Target Field,7,-1
2014-07-21,2014,SEA,NYM,5,2,-122,-1.5,160,7.0,-115,-105,112,1.5,-190,3.85,T-Mobile Park,7,3
2014-07-21,2014,TEX,NYY,4,2,143,1.5,-140,8.5,-115,-105,-158,-1.5,120,3.5,Yankee Stadium,6,2
2014-07-21,2014,SF,PHI,7,4,118,1.5,-195,7.0,-115,-105,-128,-1.5,165,3.21,Citizens Bank Park,11,3
2014-07-21,2014,LAD,PIT,5,2,104,1.5,-205,7.5,100,-120,-114,-1.5,175,3.68,PNC Park,7,3
2014-07-21,2014,NYM,SEA,2,5,112,1.5,-190,7.0,-115,-105,-122,-1.5,160,3.3,T-Mobile Park,7,-3
2014-07-21,2014,PHI,SF,4,7,-128,-1.5,165,7.0,-115,-105,118,1.5,-195,3.93,Citizens Bank Park,11,-3
2014-07-21,2014,NYY,TEX,2,4,-158,-1.5,120,8.5,-115,-105,143,1.5,-140,5.21,Yankee Stadium,6,-2
2014-07-21,2014,BOS,TOR,14,1,-101,-1.5,160,8.0,-110,-110,-109,1.5,-190,4.02,Rogers Centre,15,13
2014-07-21,2014,COL,WSH,2,7,126,1.5,-125,11.0,-110,-110,-141,-1.5,105,4.87,Coors Field,9,-5
2014-07-22,2014,DET,ARI,4,5,-115,-1.5,145,8.5,-115,-105,105,1.5,-165,4.55,Chase Field,9,-1
2014-07-22,2014,MIA,ATL,6,5,161,1.5,-140,7.5,-110,-110,-181,-1.5,120,2.87,Turner Field,11,1
2014-07-22,2014,LAA,BAL,2,4,-140,-1.5,145,9.0,100,-120,125,1.5,-165,5.25,Angel Stadium,6,-2
2014-07-22,2014,TOR,BOS,7,3,104,1.5,-170,8.5,-120,100,-114,-1.5,150,4.17,Rogers Centre,10,4
2014-07-22,2014,SD,CHC,0,6,115,1.5,-174,9.5,-115,-105,-130,-1.5,154,4.42,Wrigley Field,6,-6
2014-07-22,2014,MIL,CIN,4,3,-129,-1.5,160,8.0,-105,-115,119,1.5,-180,4.51,Miller Park,7,1
2014-07-22,2014,MIN,CLE,2,8,128,1.5,-145,9.0,100,-120,-143,-1.5,125,3.95,Target Field,10,-6
2014-07-22,2014,WSH,COL,7,4,-195,-1.5,-125,11.0,100,-120,175,1.5,105,7.27,Coors Field,11,3
2014-07-22,2014,KC,CWS,7,1,-150,-1.5,110,9.0,-115,-105,135,1.5,-130,5.4,Guaranteed Rate Field,8,6
2014-07-22,2014,ARI,DET,5,4,105,1.5,-165,8.5,-115,-105,-115,-1.5,145,4.15,Chase Field,9,1
2014-07-22,2014,OAK,HOU,2,3,-265,-1.5,-125,7.0,-115,-105,225,1.5,105,5.08,Oakland Coliseum,5,-1
2014-07-22,2014,CWS,KC,1,7,135,1.5,-130,9.0,-115,-105,-150,-1.5,110,3.83,Guaranteed Rate Field,8,-6
2014-07-22,2014,BAL,LAA,4,2,125,1.5,-165,9.0,100,-120,-140,-1.5,145,4.0,Angel Stadium,6,2
2014-07-22,2014,PIT,LAD,12,7,-114,-1.5,180,8.0,-115,-105,104,1.5,-210,4.26,PNC Park,19,5
2014-07-22,2014,ATL,MIA,5,6,-181,-1.5,120,7.5,-110,-110,161,1.5,-140,4.83,Turner Field,11,-1
2014-07-22,2014,CIN,MIL,3,4,119,1.5,-180,8.0,-105,-115,-129,-1.5,160,3.65,Miller Park,7,-1
2014-07-22,2014,CLE,MIN,8,2,-143,-1.5,125,9.0,100,-120,128,1.5,-145,5.3,Target Field,10,6
2014-07-22,2014,SEA,NYM,1,3,-113,-1.5,185,7.0,-120,100,103,1.5,-215,3.71,T-Mobile Park,4,-2
2014-07-22,2014,TEX,NYY,1,2,160,1.5,-130,9.0,100,-120,-180,-1.5,110,3.46,Yankee Stadium,3,-1
2014-07-22,2014,HOU,OAK,3,2,225,1.5,105,7.0,-115,-105,-265,-1.5,-125,2.15,Oakland Coliseum,5,1
2014-07-22,2014,SF,PHI,9,6,-114,-1.5,145,8.5,-115,-105,104,1.5,-165,4.53,Citizens Bank Park,15,3
2014-07-22,2014,LAD,PIT,7,12,104,1.5,-210,8.0,-115,-105,-114,-1.5,180,3.92,PNC Park,19,-5
2014-07-22,2014,CHC,SD,6,0,-130,-1.5,154,9.5,-115,-105,115,1.5,-174,5.37,Wrigley Field,6,6
2014-07-22,2014,NYM,SEA,3,1,103,1.5,-215,7.0,-120,100,-113,-1.5,185,3.45,T-Mobile Park,4,2
2014-07-22,2014,PHI,SF,6,9,104,1.5,-165,8.5,-115,-105,-114,-1.5,145,4.17,Citizens Bank Park,15,-3
2014-07-22,2014,TB,STL,7,2,132,1.5,-170,7.0,-105,-115,-147,-1.5,150,3.02,Busch Stadium,9,5
2014-07-22,2014,STL,TB,2,7,-147,-1.5,150,7.0,-105,-115,132,1.5,-170,4.17,Busch Stadium,9,-5
2014-07-22,2014,NYY,TEX,2,1,-180,-1.5,110,9.0,100,-120,160,1.5,-130,5.79,Yankee Stadium,3,1
2014-07-22,2014,BOS,TOR,3,7,-114,-1.5,150,8.5,-120,100,104,1.5,-170,4.53,Rogers Centre,10,-4
2014-07-22,2014,COL,WSH,4,7,175,1.5,105,11.0,100,-120,-195,-1.5,-125,4.0,Coors Field,11,-3
2014-07-23,2014,DET,ARI,11,5,-140,-1.5,110,8.5,-105,-115,125,1.5,-130,4.96,Chase Field,16,6
2014-07-23,2014,MIA,ATL,1,6,157,1.5,-145,7.0,-120,100,-177,-1.5,125,2.72,Turner Field,7,-5
2014-07-23,2014,LAA,BAL,3,2,-170,-1.5,120,8.5,-110,-110,150,1.5,-140,5.35,Angel Stadium,5,1
2014-07-23,2014,TOR,BOS,6,4,102,1.5,-165,8.5,-110,-110,-112,-1.5,145,4.21,Rogers Centre,10,2
2014-07-23,2014,SD,CHC,8,3,101,1.5,-230,6.5,-105,-115,-111,-1.5,190,3.23,Wrigley Field,11,5
2014-07-23,2014,MIL,CIN,5,1,-145,-1.5,150,7.5,-105,-115,130,1.5,-170,4.44,Miller Park,6,4
2014-07-23,2014,MIN,CLE,3,1,134,1.5,-130,8.0,-115,-105,-149,-1.5,110,3.42,Target Field,4,2
2014-07-23,2014,WSH,COL,4,6,-140,-1.5,110,9.5,-115,-105,125,1.5,-130,5.54,Coors Field,10,-2
2014-07-23,2014,KC,CWS,2,1,100,1.5,-215,7.0,-120,100,-110,-1.5,185,3.5,Guaranteed Rate Field,3,1
2014-07-23,2014,ARI,DET,5,11,125,1.5,-130,8.5,-105,-115,-140,-1.5,110,3.78,Chase Field,16,-6
2014-07-23,2014,OAK,HOU,9,7,-265,-1.5,-125,8.0,106,-126,225,1.5,105,5.81,Oakland Coliseum,16,2
2014-07-23,2014,CWS,KC,1,2,-110,-1.5,185,7.0,-120,100,100,1.5,-215,3.67,Guaranteed Rate Field,3,-1
2014-07-23,2014,BAL,LAA,2,3,150,1.5,-140,8.5,-110,-110,-170,-1.5,120,3.4,Angel Stadium,5,-1
2014-07-23,2014,PIT,LAD,6,1,-163,-1.5,140,7.5,-105,-115,148,1.5,-160,4.65,PNC Park,7,5
2014-07-23,2014,ATL,MIA,6,1,-177,-1.5,125,7.0,-120,100,157,1.5,-145,4.47,Turner Field,7,5
2014-07-23,2014,CIN,MIL,1,5,130,1.5,-170,7.5,-105,-115,-145,-1.5,150,3.26,Miller Park,6,-4
2014-07-23,2014,CLE,MIN,1,3,-149,-1.5,110,8.0,-115,-105,134,1.5,-130,4.79,Target Field,4,-2
2014-07-23,2014,SEA,NYM,2,3,-130,-1.5,165,7.0,-110,-110,115,1.5,-195,3.96,T-Mobile Park,5,-1
2014-07-23,2014,TEX,NYY,1,2,-118,-1.5,150,7.0,-120,100,108,1.5,-170,3.79,Yankee Stadium,3,-1
2014-07-23,2014,HOU,OAK,7,9,225,1.5,105,8.0,106,-126,-265,-1.5,-125,2.46,Oakland Coliseum,16,-2
2014-07-23,2014,SF,PHI,3,1,-143,-1.5,125,7.5,-105,-115,128,1.5,-145,4.41,Citizens Bank Park,4,2
2014-07-23,2014,LAD,PIT,1,6,148,1.5,-160,7.5,-105,-115,-163,-1.5,140,3.02,PNC Park,7,-5
2014-07-23,2014,CHC,SD,3,8,-111,-1.5,190,6.5,-105,-115,101,1.5,-230,3.42,Wrigley Field,11,-5
2014-07-23,2014,NYM,SEA,3,2,115,1.5,-195,7.0,-110,-110,-130,-1.5,165,3.26,T-Mobile Park,5,1
2014-07-23,2014,PHI,SF,1,3,128,1.5,-145,7.5,-105,-115,-143,-1.5,125,3.29,Citizens Bank Park,4,-2
2014-07-23,2014,TB,STL,3,0,-120,-1.5,140,7.0,-110,-110,110,1.5,-160,3.82,Busch Stadium,3,3
2014-07-23,2014,STL,TB,0,3,110,1.5,-160,7.0,-110,-110,-120,-1.5,140,3.33,Busch Stadium,3,-3
2014-07-23,2014,NYY,TEX,2,1,108,1.5,-170,7.0,-120,100,-118,-1.5,150,3.37,Yankee Stadium,3,1
2014-07-23,2014,BOS,TOR,4,6,-112,-1.5,145,8.5,-110,-110,102,1.5,-165,4.49,Rogers Centre,10,-2
2014-07-23,2014,COL,WSH,6,4,125,1.5,-130,9.5,-115,-105,-140,-1.5,110,4.22,Coors Field,10,2
2014-07-24,2014,MIA,ATL,3,2,119,1.5,-195,7.5,-110,-110,-129,-1.5,165,3.42,Turner Field,5,1
2014-07-24,2014,SEA,BAL,0,4,-145,-1.5,165,6.5,-115,-105,130,1.5,-195,3.85,T-Mobile Park,4,-4
2014-07-24,2014,TOR,BOS,8,0,-108,-1.5,180,8.5,-102,-118,-102,1.5,-210,4.41,Rogers Centre,8,8
2014-07-24,2014,SD,CHC,13,3,-119,-1.5,135,7.0,-105,-115,109,1.5,-155,3.8,Wrigley Field,16,10
2014-07-24,2014,KC,CLE,2,1,-119,-1.5,185,7.0,-115,-105,109,1.5,-215,3.8,Kauffman Stadium,3,1
2014-07-24,2014,MIN,CWS,2,5,-165,-1.5,120,8.5,-115,-105,150,1.5,-140,5.29,Target Field,7,-3
2014-07-24,2014,LAA,DET,4,6,-121,-1.5,175,7.5,-110,-110,111,1.5,-205,4.11,Angel Stadium,10,-2
2014-07-24,2014,OAK,HOU,13,1,-270,-1.5,-125,8.0,-115,-105,230,1.5,105,5.84,Oakland Coliseum,14,12
2014-07-24,2014,CLE,KC,1,2,109,1.5,-215,7.0,-115,-105,-119,-1.5,185,3.35,Kauffman Stadium,3,-1
2014-07-24,2014,DET,LAA,6,4,111,1.5,-205,7.5,-110,-110,-121,-1.5,175,3.55,Angel Stadium,10,2
2014-07-24,2014,ATL,MIA,2,3,-129,-1.5,165,7.5,-110,-110,119,1.5,-195,4.22,Turner Field,5,-1
2014-07-24,2014,NYM,MIL,1,9,135,1.5,-165,8.0,-110,-110,-150,-1.5,145,3.4,Miller Park,10,-8
2014-07-24,2014,CWS,MIN,5,2,150,1.5,-140,8.5,-115,-105,-165,-1.5,120,3.4,Target Field,7,3
2014-07-24,2014,MIL,NYM,9,1,-150,-1.5,145,8.0,-110,-110,135,1.5,-165,4.8,Miller Park,10,8
2014-07-24,2014,TEX,NYY,2,4,162,1.5,-130,8.5,100,-120,-182,-1.5,110,3.24,Yankee Stadium,6,-2
2014-07-24,2014,HOU,OAK,1,13,230,1.5,105,8.0,-115,-105,-270,-1.5,-125,2.42,Oakland Coliseum,14,-12
2014-07-24,2014,SF,PHI,1,2,115,1.5,-200,7.0,100,-120,-125,-1.5,170,3.26,Citizens Bank Park,3,-1
2014-07-24,2014,CHC,SD,3,13,109,1.5,-155,7.0,-105,-115,-119,-1.5,135,3.35,Wrigley Field,16,-10
2014-07-24,2014,BAL,SEA,4,0,130,1.5,-195,6.5,-115,-105,-145,-1.5,165,2.83,T-Mobile Park,4,4
2014-07-24,2014,PHI,SF,2,1,-125,-1.5,170,7.0,100,-120,115,1.5,-200,3.89,Citizens Bank Park,3,1
2014-07-24,2014,NYY,TEX,4,2,-182,-1.5,110,8.5,100,-120,162,1.5,-130,5.49,Yankee Stadium,6,2
2014-07-24,2014,BOS,TOR,0,8,-102,1.5,-210,8.5,-102,-118,-108,-1.5,180,4.29,Rogers Centre,8,-8
2014-07-25,2014,PHI,ARI,9,5,112,1.5,-145,7.5,100,-120,-122,-1.5,125,3.54,Citizens Bank Park,14,4
2014-07-25,2014,SD,ATL,5,2,159,1.5,-155,6.5,-125,105,-179,-1.5,135,2.51,Turner Field,7,3
2014-07-25,2014,SEA,BAL,1,2,-195,-1.5,120,6.0,-110,-110,175,1.5,-140,3.97,T-Mobile Park,3,-1
2014-07-25,2014,TB,BOS,6,4,-144,-1.5,165,6.0,-120,100,129,1.5,-195,3.54,Tropicana Field,10,2
2014-07-25,2014,STL,CHC,6,7,-113,-1.5,145,9.5,-105,-115,103,1.5,-165,5.04,Wrigley Field,13,-1
2014-07-25,2014,WSH,CIN,4,1,-121,-1.5,135,7.5,100,-120,111,1.5,-155,4.11,Great American Ballpark,5,3
2014-07-25,2014,KC,CLE,6,4,-121,-1.5,170,9.0,-105,-115,111,1.5,-200,4.93,Kauffman Stadium,10,2
2014-07-25,2014,PIT,COL,1,8,-114,-1.5,130,10.0,-105,-115,104,1.5,-150,5.33,Coors Field,9,-7
2014-07-25,2014,MIN,CWS,5,9,-123,-1.5,160,9.0,-110,-110,113,1.5,-190,4.96,Target Field,14,-4
2014-07-25,2014,LAA,DET,2,1,-131,-1.5,145,8.5,-125,105,116,1.5,-165,4.82,Angel Stadium,3,1
2014-07-25,2014,MIA,HOU,2,0,117,1.5,-175,8.5,-110,-110,-132,-1.5,155,3.92,Minute Maid Park,2,2
2014-07-25,2014,CLE,KC,4,6,111,1.5,-200,9.0,-105,-115,-121,-1.5,170,4.27,Kauffman Stadium,10,-2
2014-07-25,2014,DET,LAA,1,2,116,1.5,-165,8.5,-125,105,-131,-1.5,145,3.94,Angel Stadium,3,-1
2014-07-25,2014,SF,LAD,1,8,119,1.5,-160,6.5,-120,100,-129,-1.5,140,2.97,AT&T Park,9,-7
2014-07-25,2014,HOU,MIA,0,2,-132,-1.5,155,8.5,-110,-110,117,1.5,-175,4.84,Minute Maid Park,2,-2
2014-07-25,2014,NYM,MIL,3,2,116,1.5,-195,8.0,-105,-115,-126,-1.5,165,3.7,Miller Park,5,1
2014-07-25,2014,CWS,MIN,9,5,113,1.5,-190,9.0,-110,-110,-123,-1.5,160,4.23,Target Field,14,4
2014-07-25,2014,MIL,NYM,2,3,-126,-1.5,165,8.0,-105,-115,116,1.5,-195,4.46,Miller Park,5,-1
2014-07-25,2014,TOR,NYY,4,6,116,1.5,-200,8.0,-110,-110,-126,-1.5,170,3.7,Yankee Stadium,10,-2
2014-07-25,2014,TEX,OAK,4,1,155,1.5,-110,10.0,-110,-110,-175,-1.5,-110,3.92,Rangers Ballpark,5,3
2014-07-25,2014,ARI,PHI,5,9,-122,-1.5,125,7.5,100,-120,112,1.5,-145,4.12,Citizens Bank Park,14,-4
2014-07-25,2014,COL,PIT,8,1,104,1.5,-150,10.0,-105,-115,-114,-1.5,130,4.9,Coors Field,9,7
2014-07-25,2014,ATL,SD,2,5,-179,-1.5,135,6.5,-125,105,159,1.5,-155,4.17,Turner Field,7,-3
2014-07-25,2014,BAL,SEA,2,1,175,1.5,-140,6.0,-110,-110,-195,-1.5,120,2.18,T-Mobile Park,3,1
2014-07-25,2014,LAD,SF,8,1,-129,-1.5,140,6.5,-120,100,119,1.5,-160,3.66,AT&T Park,9,7
2014-07-25,2014,CHC,STL,7,6,103,1.5,-165,9.5,-105,-115,-113,-1.5,145,4.68,Wrigley Field,13,1
2014-07-25,2014,BOS,TB,4,6,129,1.5,-195,6.0,-120,100,-144,-1.5,165,2.62,Tropicana Field,10,-2
2014-07-25,2014,OAK,TEX,1,4,-175,-1.5,-110,10.0,-110,-110,155,1.5,-110,6.36,Rangers Ballpark,5,-3
2014-07-25,2014,NYY,TOR,6,4,-126,-1.5,170,8.0,-110,-110,116,1.5,-200,4.46,Yankee Stadium,10,2
2014-07-25,2014,CIN,WSH,1,4,111,1.5,-155,7.5,100,-120,-121,-1.5,135,3.55,Great American Ballpark,5,-3
2014-07-26,2014,PHI,ARI,6,10,-152,-1.5,145,7.0,-105,-115,137,1.5,-165,4.22,Citizens Bank Park,16,-4
2014-07-26,2014,SD,ATL,3,5,169,1.5,-140,7.0,-115,-105,-189,-1.5,120,2.6,Turner Field,8,-2
2014-07-26,2014,SEA,BAL,4,3,-107,-1.5,190,7.5,100,-120,-103,1.5,-230,3.88,T-Mobile Park,7,1
2014-07-26,2014,TB,BOS,3,0,-106,1.5,-175,7.0,-114,-106,-104,-1.5,155,3.6,Tropicana Field,3,3
2014-07-26,2014,STL,CHC,6,3,116,1.5,-200,9.0,-105,-115,-126,-1.5,170,4.17,Wrigley Field,9,3
2014-07-26,2014,WSH,CIN,0,1,-113,-1.5,148,7.0,105,-125,103,1.5,-168,3.71,Great American Ballpark,1,-1
2014-07-26,2014,KC,CLE,7,5,-108,-1.5,180,9.0,-125,105,-102,1.5,-210,4.67,Kauffman Stadium,12,2
2014-07-26,2014,PIT,COL,1,8,-115,-1.5,130,10.0,-115,-105,105,1.5,-150,5.35,Coors Field,9,-7
2014-07-26,2014,MIN,CWS,0,7,162,1.5,-115,7.5,-105,-115,-182,-1.5,-105,2.86,Target Field,7,-7
2014-07-26,2014,LAA,DET,4,0,-113,-1.5,165,8.5,-110,-110,103,1.5,-195,4.51,Angel Stadium,4,4
2014-07-26,2014,MIA,HOU,7,3,-109,-1.5,150,8.5,-120,100,-101,1.5,-170,4.43,Minute Maid Park,10,4
2014-07-26,2014,CLE,KC,5,7,-102,1.5,-210,9.0,-125,105,-108,-1.5,180,4.54,Kauffman Stadium,12,-2
2014-07-26,2014,DET,LAA,0,4,103,1.5,-195,8.5,-110,-110,-113,-1.5,165,4.19,Angel Stadium,4,-4
2014-07-26,2014,SF,LAD,0,5,176,1.5,-115,6.5,100,-120,-196,-1.5,-105,2.36,AT&T Park,5,-5
2014-07-26,2014,HOU,MIA,3,7,-101,1.5,-170,8.5,-120,100,-109,-1.5,150,4.27,Minute Maid Park,10,-4
2014-07-26,2014,NYM,MIL,2,5,147,1.5,-150,8.5,-125,105,-162,-1.5,130,3.44,Miller Park,7,-3
2014-07-26,2014,CWS,MIN,7,0,-182,-1.5,-105,7.5,-105,-115,162,1.5,-115,4.84,Target Field,7,7
2014-07-26,2014,MIL,NYM,5,2,-162,-1.5,130,8.5,-125,105,147,1.5,-150,5.26,Miller Park,7,3
2014-07-26,2014,TOR,NYY,6,4,125,1.5,-190,8.5,-120,100,-140,-1.5,160,3.78,Yankee Stadium,10,2
2014-07-26,2014,TEX,OAK,1,5,175,1.5,110,9.5,105,-125,-195,-1.5,-130,3.45,Rangers Ballpark,6,-4
2014-07-26,2014,ARI,PHI,10,6,137,1.5,-165,7.0,-105,-115,-152,-1.5,145,2.95,Citizens Bank Park,16,4
2014-07-26,2014,COL,PIT,8,1,105,1.5,-150,10.0,-115,-105,-115,-1.5,130,4.88,Coors Field,9,7
2014-07-26,2014,ATL,SD,5,3,-189,-1.5,120,7.0,-115,-105,169,1.5,-140,4.58,Turner Field,8,2
2014-07-26,2014,BAL,SEA,3,4,-103,1.5,-230,7.5,100,-120,-107,-1.5,190,3.81,T-Mobile Park,7,-1
2014-07-26,2014,LAD,SF,5,0,-196,-1.5,-105,6.5,100,-120,176,1.5,-115,4.3,AT&T Park,5,5
2014-07-26,2014,CHC,STL,3,6,-126,-1.5,170,9.0,-105,-115,116,1.5,-200,5.02,Wrigley Field,9,-3
2014-07-26,2014,BOS,TB,0,3,-104,-1.5,155,7.0,-114,-106,-106,1.5,-175,3.57,Tropicana Field,3,-3
2014-07-26,2014,OAK,TEX,5,1,-195,-1.5,-130,9.5,105,-125,175,1.5,110,6.28,Rangers Ballpark,6,4
2014-07-26,2014,NYY,TOR,4,6,-140,-1.5,160,8.5,-120,100,125,1.5,-190,4.96,Yankee Stadium,10,-2
2014-07-26,2014,CIN,WSH,1,0,103,1.5,-168,7.0,105,-125,-113,-1.5,148,3.45,Great American Ballpark,1,1
2014-07-27,2014,PHI,ARI,4,2,112,1.5,-155,8.5,-125,105,-122,-1.5,135,4.01,Citizens Bank Park,6,2
2014-07-27,2014,SD,ATL,3,8,150,1.5,-145,7.5,-110,-110,-170,-1.5,125,3.0,Turner Field,11,-5
2014-07-27,2014,SEA,BAL,2,3,-115,-1.5,185,7.5,100,-120,105,1.5,-215,4.01,T-Mobile Park,5,-1
2014-07-27,2014,TB,BOS,2,3,-141,-1.5,155,7.0,-120,100,126,1.5,-175,4.1,Tropicana Field,5,-1
2014-07-27,2014,STL,CHC,1,0,-150,-1.5,105,8.0,100,-120,135,1.5,-125,4.8,Wrigley Field,1,1
2014-07-27,2014,WSH,CIN,4,2,-122,-1.5,130,8.0,-115,-105,112,1.5,-150,4.4,Great American Ballpark,6,2
2014-07-27,2014,KC,CLE,3,10,-112,-1.5,175,8.0,-115,-105,102,1.5,-205,4.23,Kauffman Stadium,13,-7
2014-07-27,2014,PIT,COL,7,5,-119,-1.5,130,10.5,100,-120,109,1.5,-150,5.71,Coors Field,12,2
2014-07-27,2014,MIN,CWS,4,3,-130,-1.5,155,9.0,-110,-110,115,1.5,-175,5.09,Target Field,7,1
2014-07-27,2014,LAA,DET,2,1,-124,-1.5,155,9.0,100,-120,114,1.5,-175,4.98,Angel Stadium,3,1
2014-07-27,2014,MIA,HOU,4,2,111,1.5,-195,8.0,-110,-110,-121,-1.5,165,3.79,Minute Maid Park,6,2
2014-07-27,2014,CLE,KC,10,3,102,1.5,-205,8.0,-115,-105,-112,-1.5,175,3.96,Kauffman Stadium,13,7
2014-07-27,2014,DET,LAA,1,2,114,1.5,-175,9.0,100,-120,-124,-1.5,155,4.21,Angel Stadium,3,-1
2014-07-27,2014,SF,LAD,3,4,113,1.5,-150,7.0,100,-120,-123,-1.5,130,3.29,AT&T Park,7,-1
2014-07-27,2014,HOU,MIA,2,4,-121,-1.5,165,8.0,-110,-110,111,1.5,-195,4.38,Minute Maid Park,6,-2
2014-07-27,2014,NYM,MIL,2,0,119,1.5,-190,8.0,-120,100,-129,-1.5,160,3.65,Miller Park,2,2
2014-07-27,2014,CWS,MIN,3,4,115,1.5,-175,9.0,-110,-110,-130,-1.5,155,4.19,Target Field,7,-1
2014-07-27,2014,MIL,NYM,0,2,-129,-1.5,160,8.0,-120,100,119,1.5,-190,4.51,Miller Park,2,-2
2014-07-27,2014,TOR,NYY,5,4,110,1.5,-175,9.0,-125,105,-120,-1.5,155,4.29,Yankee Stadium,9,1
2014-07-27,2014,TEX,OAK,3,9,175,1.5,110,9.0,100,-120,-205,-1.5,-130,3.27,Rangers Ballpark,12,-6
2014-07-27,2014,ARI,PHI,2,4,-122,-1.5,135,8.5,-125,105,112,1.5,-155,4.67,Citizens Bank Park,6,-2
2014-07-27,2014,COL,PIT,5,7,109,1.5,-150,10.5,100,-120,-119,-1.5,130,5.02,Coors Field,12,-2
2014-07-27,2014,ATL,SD,8,3,-170,-1.5,125,7.5,-110,-110,150,1.5,-145,4.72,Turner Field,11,5
2014-07-27,2014,BAL,SEA,3,2,105,1.5,-215,7.5,100,-120,-115,-1.5,185,3.66,T-Mobile Park,5,1
2014-07-27,2014,LAD,SF,4,3,-123,-1.5,130,7.0,100,-120,113,1.5,-150,3.86,AT&T Park,7,1
2014-07-27,2014,CHC,STL,0,1,135,1.5,-125,8.0,100,-120,-150,-1.5,105,3.4,Wrigley Field,1,-1
2014-07-27,2014,BOS,TB,3,2,126,1.5,-175,7.0,-120,100,-141,-1.5,155,3.1,Tropicana Field,5,1
2014-07-27,2014,OAK,TEX,9,3,-205,-1.5,-130,9.0,100,-120,175,1.5,110,6.05,Rangers Ballpark,12,6
2014-07-27,2014,NYY,TOR,4,5,-120,-1.5,155,9.0,-125,105,110,1.5,-175,4.91,Yankee Stadium,9,-1
2014-07-27,2014,CIN,WSH,2,4,112,1.5,-150,8.0,-115,-105,-122,-1.5,130,3.77,Great American Ballpark,6,-2
2014-07-28,2014,CIN,ARI,1,2,-143,-1.5,155,7.0,-110,-110,128,1.5,-175,4.12,Great American Ballpark,3,-1
2014-07-28,2014,SD,ATL,0,2,171,1.5,-120,7.5,-120,100,-201,-1.5,100,2.77,Turner Field,2,-2
2014-07-28,2014,TOR,BOS,14,1,130,1.5,-165,9.0,-125,105,-145,-1.5,145,3.91,Fenway Park,15,13
2014-07-28,2014,COL,CHC,1,4,126,1.5,-190,7.5,-105,-115,-141,-1.5,160,3.32,Wrigley Field,5,-3
2014-07-28,2014,ARI,CIN,2,1,128,1.5,-175,7.0,-110,-110,-143,-1.5,155,3.07,Great American Ballpark,3,1
2014-07-28,2014,CHC,COL,4,1,-141,-1.5,160,7.5,-105,-115,126,1.5,-190,4.39,Wrigley Field,5,3
2014-07-28,2014,OAK,HOU,3,7,-195,-1.5,-125,8.0,-120,100,175,1.5,105,5.29,Minute Maid Park,10,-4
2014-07-28,2014,WSH,MIA,6,7,-135,-1.5,115,7.0,-125,105,120,1.5,-135,4.02,Marlins Park,13,-1
2014-07-28,2014,TB,MIL,2,1,-145,-1.5,155,7.0,103,-123,130,1.5,-175,4.14,Tropicana Field,3,1
2014-07-28,2014,PHI,NYM,1,7,124,1.5,-190,7.5,100,-120,-139,-1.5,160,3.35,Citi Field,8,-6
2014-07-28,2014,TEX,NYY,4,2,-153,-1.5,135,7.5,-110,-110,138,1.5,-155,4.54,Rangers Ballpark,6,2
2014-07-28,2014,HOU,OAK,7,3,175,1.5,105,8.0,-120,100,-195,-1.5,-125,2.91,Minute Maid Park,10,4
2014-07-28,2014,NYM,PHI,7,1,-139,-1.5,160,7.5,100,-120,124,1.5,-190,4.36,Citi Field,8,6
2014-07-28,2014,SF,PIT,0,5,-150,-1.5,140,6.5,100,-120,135,1.5,-160,3.9,AT&T Park,5,-5
2014-07-28,2014,ATL,SD,2,0,-201,-1.5,100,7.5,-120,100,171,1.5,-120,5.01,Turner Field,2,2
2014-07-28,2014,PIT,SF,5,0,135,1.5,-160,6.5,100,-120,-150,-1.5,140,2.77,AT&T Park,5,5
2014-07-28,2014,MIL,TB,1,2,130,1.5,-175,7.0,103,-123,-145,-1.5,155,3.04,Tropicana Field,3,-1
2014-07-28,2014,NYY,TEX,2,4,138,1.5,-155,7.5,-110,-110,-153,-1.5,135,3.15,Rangers Ballpark,6,-2
2014-07-28,2014,BOS,TOR,1,14,-145,-1.5,145,9.0,-125,105,130,1.5,-165,5.33,Fenway Park,15,-13
2014-07-28,2014,MIA,WSH,7,6,120,1.5,-135,7.0,-125,105,-135,-1.5,115,3.18,Marlins Park,13,1
2014-07-29,2014,CIN,ARI,3,0,-120,-1.5,170,7.0,-120,100,110,1.5,-200,3.82,Great American Ballpark,3,3
2014-07-29,2014,LAD,ATL,8,4,-149,-1.5,155,7.5,100,-120,134,1.5,-175,4.49,Dodger Stadium,12,4
2014-07-29,2014,LAA,BAL,6,7,-132,-1.5,125,8.5,-105,-115,117,1.5,-145,4.84,Camden Yards,13,-1
2014-07-29,2014,TOR,BOS,4,2,-105,1.5,-215,8.0,-115,-105,-105,-1.5,185,4.1,Fenway Park,6,2
2014-07-29,2014,COL,CHC,3,4,-105,1.5,-230,8.0,-115,-105,-105,-1.5,190,4.1,Wrigley Field,7,-1
2014-07-29,2014,ARI,CIN,0,3,110,1.5,-200,7.0,-120,100,-120,-1.5,170,3.33,Great American Ballpark,3,-3
2014-07-29,2014,SEA,CLE,5,2,105,1.5,-210,7.5,-115,-105,-115,-1.5,180,3.66,Progressive Field,7,3
2014-07-29,2014,CHC,COL,4,3,-105,-1.5,190,8.0,-115,-105,-105,1.5,-230,4.1,Wrigley Field,7,1
2014-07-29,2014,DET,CWS,4,11,-162,-1.5,130,8.0,-105,-115,147,1.5,-150,4.95,Comerica Park,15,-7
2014-07-29,2014,CWS,DET,11,4,147,1.5,-150,8.0,-105,-115,-162,-1.5,130,3.24,Comerica Park,15,7
2014-07-29,2014,OAK,HOU,7,4,-202,-1.5,-130,8.0,-110,-110,172,1.5,110,5.35,Minute Maid Park,11,3
2014-07-29,2014,MIN,KC,2,1,175,1.5,-125,7.5,105,-125,-205,-1.5,105,2.73,Kauffman Stadium,3,1
2014-07-29,2014,BAL,LAA,7,6,117,1.5,-145,8.5,-105,-115,-132,-1.5,125,3.92,Camden Yards,13,1
2014-07-29,2014,ATL,LAD,4,8,134,1.5,-175,7.5,100,-120,-149,-1.5,155,3.21,Dodger Stadium,12,-4
2014-07-29,2014,WSH,MIA,0,3,-134,-1.5,120,7.0,-101,-119,119,1.5,-140,4.01,Marlins Park,3,-3
2014-07-29,2014,TB,MIL,5,1,-162,-1.5,140,7.0,-105,-115,147,1.5,-160,4.33,Tropicana Field,6,4
2014-07-29,2014,KC,MIN,1,2,-205,-1.5,105,7.5,105,-125,175,1.5,-125,5.04,Kauffman Stadium,3,-1
2014-07-29,2014,PHI,NYM,6,0,-126,-1.5,135,6.5,-127,107,116,1.5,-155,3.62,Citi Field,6,6
2014-07-29,2014,TEX,NYY,11,12,159,1.5,-105,9.0,-110,-110,-179,-1.5,-115,3.47,Rangers Ballpark,23,-1
2014-07-29,2014,HOU,OAK,4,7,172,1.5,110,8.0,-110,-110,-202,-1.5,-130,2.94,Minute Maid Park,11,-3
2014-07-29,2014,NYM,PHI,0,6,116,1.5,-155,6.5,-127,107,-126,-1.5,135,3.01,Citi Field,6,-6
2014-07-29,2014,SF,PIT,1,3,-119,-1.5,180,6.5,-120,100,109,1.5,-210,3.53,AT&T Park,4,-2
2014-07-29,2014,STL,SD,1,3,104,1.5,-245,6.0,-115,-105,-114,-1.5,205,2.94,PETCO Park,4,-2
2014-07-29,2014,CLE,SEA,2,5,-115,-1.5,180,7.5,-115,-105,105,1.5,-210,4.01,Progressive Field,7,-3
2014-07-29,2014,PIT,SF,3,1,109,1.5,-210,6.5,-120,100,-119,-1.5,180,3.11,AT&T Park,4,2
2014-07-29,2014,SD,STL,3,1,-114,-1.5,205,6.0,-115,-105,104,1.5,-245,3.2,PETCO Park,4,2
2014-07-29,2014,MIL,TB,1,5,147,1.5,-160,7.0,-105,-115,-162,-1.5,140,2.83,Tropicana Field,6,-4
2014-07-29,2014,NYY,TEX,12,11,-179,-1.5,-115,9.0,-110,-110,159,1.5,-105,5.77,Rangers Ballpark,23,1
2014-07-29,2014,BOS,TOR,2,4,-105,-1.5,185,8.0,-115,-105,-105,1.5,-215,4.1,Fenway Park,6,-2
2014-07-29,2014,MIA,WSH,3,0,119,1.5,-140,7.0,-101,-119,-134,-1.5,120,3.2,Marlins Park,3,3
2014-07-30,2014,CIN,ARI,4,5,-104,1.5,-175,7.0,-110,-110,-106,-1.5,155,3.57,Great American Ballpark,9,-1
2014-07-30,2014,LAD,ATL,3,2,-175,-1.5,125,6.5,-108,-112,155,1.5,-145,4.14,Dodger Stadium,5,1
2014-07-30,2014,LAA,BAL,3,4,-141,-1.5,120,8.0,-105,-115,126,1.5,-140,4.68,Camden Yards,7,-1
2014-07-30,2014,TOR,BOS,6,1,104,1.5,-200,8.5,-120,100,-114,-1.5,170,4.17,Fenway Park,7,5
2014-07-30,2014,COL,CHC,6,4,-108,-1.5,155,7.5,106,-126,-102,1.5,-175,3.89,Wrigley Field,10,2
2014-07-30,2014,ARI,CIN,5,4,-106,-1.5,155,7.0,-110,-110,-104,1.5,-175,3.6,Great American Ballpark,9,1
2014-07-30,2014,SEA,CLE,0,2,-109,-1.5,160,6.0,-110,-110,-101,1.5,-190,3.13,Progressive Field,2,-2
2014-07-30,2014,CHC,COL,4,6,-102,1.5,-175,7.5,106,-126,-108,-1.5,155,3.79,Wrigley Field,10,-2
2014-07-30,2014,DET,CWS,7,2,-240,-1.5,-115,8.5,100,-120,200,1.5,-105,6.0,Comerica Park,9,5
2014-07-30,2014,CWS,DET,2,7,200,1.5,-105,8.5,100,-120,-240,-1.5,-115,2.83,Comerica Park,9,-5
2014-07-30,2014,OAK,HOU,1,8,-145,-1.5,110,8.0,100,-120,130,1.5,-130,4.73,Minute Maid Park,9,-7
2014-07-30,2014,MIN,KC,2,3,145,1.5,-155,7.0,-115,-105,-160,-1.5,135,2.86,Kauffman Stadium,5,-1
2014-07-30,2014,BAL,LAA,4,3,126,1.5,-140,8.0,-105,-115,-141,-1.5,120,3.54,Camden Yards,7,1
2014-07-30,2014,ATL,LAD,2,3,155,1.5,-145,6.5,-108,-112,-175,-1.5,125,2.55,Dodger Stadium,5,-1
2014-07-30,2014,WSH,MIA,4,3,-149,-1.5,120,7.5,105,-125,134,1.5,-140,4.49,Marlins Park,7,1
2014-07-30,2014,TB,MIL,0,5,-178,-1.5,125,7.0,110,-130,158,1.5,-145,4.48,Tropicana Field,5,-5
2014-07-30,2014,KC,MIN,3,2,-160,-1.5,135,7.0,-115,-105,145,1.5,-155,4.31,Kauffman Stadium,5,1
2014-07-30,2014,PHI,NYM,2,11,154,1.5,-150,7.0,-120,100,-174,-1.5,130,2.76,Citi Field,13,-9
2014-07-30,2014,TEX,NYY,3,2,118,1.5,-140,9.0,-105,-115,-128,-1.5,120,4.13,Rangers Ballpark,5,1
2014-07-30,2014,HOU,OAK,8,1,130,1.5,-130,8.0,100,-120,-145,-1.5,110,3.48,Minute Maid Park,9,7
2014-07-30,2014,NYM,PHI,11,2,-174,-1.5,130,7.0,-120,100,154,1.5,-150,4.45,Citi Field,13,9
2014-07-30,2014,SF,PIT,7,5,-117,-1.5,190,7.0,-115,-105,107,1.5,-230,3.77,AT&T Park,12,2
2014-07-30,2014,STL,SD,1,12,106,1.5,-215,6.5,-118,-102,-116,-1.5,185,3.16,PETCO Park,13,-11
2014-07-30,2014,CLE,SEA,2,0,-101,1.5,-190,6.0,-110,-110,-109,-1.5,160,3.01,Progressive Field,2,2
2014-07-30,2014,PIT,SF,5,7,107,1.5,-230,7.0,-115,-105,-117,-1.5,190,3.38,AT&T Park,12,-2
2014-07-30,2014,SD,STL,12,1,-116,-1.5,185,6.5,-118,-102,106,1.5,-215,3.49,PETCO Park,13,11
2014-07-30,2014,MIL,TB,5,0,158,1.5,-145,7.0,110,-130,-178,-1.5,125,2.71,Tropicana Field,5,5
2014-07-30,2014,NYY,TEX,2,3,-128,-1.5,120,9.0,-105,-115,118,1.5,-140,5.05,Rangers Ballpark,5,-1
2014-07-30,2014,BOS,TOR,1,6,-114,-1.5,170,8.5,-120,100,104,1.5,-200,4.53,Fenway Park,7,-5
2014-07-30,2014,MIA,WSH,3,4,134,1.5,-140,7.5,105,-125,-149,-1.5,120,3.21,Marlins Park,7,-1
2014-07-31,2014,PIT,ARI,4,7,-130,-1.5,125,8.5,-120,100,115,1.5,-145,4.8,Chase Field,11,-3
2014-07-31,2014,LAD,ATL,2,1,-215,-1.5,105,6.0,105,-125,185,1.5,-125,4.1,Dodger Stadium,3,1
2014-07-31,2014,LAA,BAL,1,0,-115,-1.5,145,9.0,100,-120,105,1.5,-165,4.81,Camden Yards,1,1
2014-07-31,2014,COL,CHC,1,3,175,1.5,-119,8.5,-125,105,-205,-1.5,-101,3.09,Wrigley Field,4,-2
2014-07-31,2014,MIA,CIN,1,3,104,1.5,-190,6.5,-105,-115,-114,-1.5,160,3.19,Marlins Park,4,-2
2014-07-31,2014,SEA,CLE,6,5,126,1.5,-165,8.5,-110,-110,-141,-1.5,145,3.76,Progressive Field,11,1
2014-07-31,2014,CHC,COL,3,1,-205,-1.5,-101,8.5,-125,105,175,1.5,-119,5.71,Wrigley Field,4,2
2014-07-31,2014,DET,CWS,4,7,-195,-1.5,105,9.0,100,-120,175,1.5,-125,5.95,Comerica Park,11,-3
2014-07-31,2014,CWS,DET,7,4,175,1.5,-125,9.0,100,-120,-195,-1.5,105,3.27,Comerica Park,11,3
2014-07-31,2014,TOR,HOU,6,5,-153,-1.5,110,9.0,100,-120,138,1.5,-130,5.44,Minute Maid Park,11,1
2014-07-31,2014,MIN,KC,3,6,180,1.5,-110,7.5,-123,103,-210,-1.5,-110,2.68,Kauffman Stadium,9,-3
2014-07-31,2014,BAL,LAA,0,1,105,1.5,-165,9.0,100,-120,-115,-1.5,145,4.39,Camden Yards,1,-1
2014-07-31,2014,ATL,LAD,1,2,185,1.5,-125,6.0,105,-125,-215,-1.5,105,2.11,Dodger Stadium,3,-1
2014-07-31,2014,CIN,MIA,3,1,-114,-1.5,160,6.5,-105,-115,104,1.5,-190,3.46,Marlins Park,4,2
2014-07-31,2014,KC,MIN,6,3,-210,-1.5,-110,7.5,-123,103,180,1.5,-110,5.08,Kauffman Stadium,9,3
2014-07-31,2014,WSH,PHI,4,10,-176,-1.5,120,7.0,105,-125,156,1.5,-140,4.46,Nationals Park,14,-6
2014-07-31,2014,ARI,PIT,7,4,115,1.5,-145,8.5,-120,100,-130,-1.5,125,3.95,Chase Field,11,3
2014-07-31,2014,STL,SD,6,2,-113,-1.5,150,7.5,-105,-115,103,1.5,-170,3.98,PETCO Park,8,4
2014-07-31,2014,CLE,SEA,5,6,-141,-1.5,145,8.5,-110,-110,126,1.5,-165,4.97,Progressive Field,11,-1
2014-07-31,2014,SD,STL,2,6,103,1.5,-170,7.5,-105,-115,-113,-1.5,150,3.69,PETCO Park,8,-4
2014-07-31,2014,HOU,TOR,5,6,138,1.5,-130,9.0,100,-120,-153,-1.5,110,3.78,Minute Maid Park,11,-1
2014-07-31,2014,PHI,WSH,10,4,156,1.5,-140,7.0,105,-125,-176,-1.5,120,2.73,Nationals Park,14,6
2014-08-01,2014,PIT,ARI,9,4,-122,-1.5,135,8.5,-120,100,112,1.5,-155,4.67,Chase Field,13,5
2014-08-01,2014,SD,ATL,10,1,119,1.5,-155,7.0,110,-130,-129,-1.5,135,3.2,PETCO Park,11,9
2014-08-01,2014,SEA,BAL,1,2,115,1.5,-175,8.0,100,-120,-130,-1.5,155,3.72,Camden Yards,3,-1
2014-08-01,2014,NYY,BOS,3,4,115,1.5,-190,9.0,-125,105,-130,-1.5,160,4.19,Fenway Park,7,-1
2014-08-01,2014,LAD,CHC,2,8,-146,-1.5,149,7.5,-105,-115,131,1.5,-168,4.45,Dodger Stadium,10,-6
2014-08-01,2014,MIA,CIN,2,5,-111,-1.5,190,7.0,-110,-110,101,1.5,-230,3.68,Marlins Park,7,-3
2014-08-01,2014,TEX,CLE,2,12,154,1.5,-140,8.0,-120,100,-174,-1.5,120,3.15,Progressive Field,14,-10
2014-08-01,2014,DET,COL,4,2,-235,-1.5,-117,9.5,100,-120,205,1.5,-103,6.66,Comerica Park,6,2
2014-08-01,2014,MIN,CWS,8,10,240,1.5,115,7.5,-105,-115,-280,-1.5,-135,2.21,Guaranteed Rate Field,18,-2
2014-08-01,2014,COL,DET,2,4,205,1.5,-103,9.5,100,-120,-235,-1.5,-117,3.11,Comerica Park,6,-2
2014-08-01,2014,TOR,HOU,1,3,109,1.5,-205,8.0,-110,-110,-119,-1.5,175,3.83,Minute Maid Park,4,-2
2014-08-01,2014,OAK,KC,0,1,-235,-1.5,-120,7.0,-125,105,205,1.5,100,4.91,Oakland Coliseum,1,-1
2014-08-01,2014,TB,LAA,3,5,-112,-1.5,190,7.5,-105,-115,102,1.5,-230,3.96,Tropicana Field,8,-2
2014-08-01,2014,CHC,LAD,8,2,131,1.5,-168,7.5,-105,-115,-146,-1.5,149,3.25,Dodger Stadium,10,6
2014-08-01,2014,CIN,MIA,5,2,101,1.5,-230,7.0,-110,-110,-111,-1.5,190,3.48,Marlins Park,7,3
2014-08-01,2014,STL,MIL,4,7,-162,-1.5,130,7.0,-105,-115,147,1.5,-150,4.33,Busch Stadium,11,-3
2014-08-01,2014,CWS,MIN,10,8,-280,-1.5,-135,7.5,-105,-115,240,1.5,115,5.53,Guaranteed Rate Field,18,2
2014-08-01,2014,SF,NYM,5,1,106,1.5,-215,7.0,101,-121,-116,-1.5,185,3.4,Citi Field,6,4
2014-08-01,2014,BOS,NYY,4,3,-130,-1.5,160,9.0,-125,105,115,1.5,-190,5.09,Fenway Park,7,1
2014-08-01,2014,KC,OAK,1,0,205,1.5,100,7.0,-125,105,-235,-1.5,-120,2.3,Oakland Coliseum,1,1
2014-08-01,2014,WSH,PHI,1,2,-220,-1.5,-110,8.0,100,-120,190,1.5,-110,5.5,Nationals Park,3,-1
2014-08-01,2014,ARI,PIT,4,9,112,1.5,-155,8.5,-120,100,-122,-1.5,135,4.01,Chase Field,13,-5
2014-08-01,2014,ATL,SD,1,10,-129,-1.5,135,7.0,110,-130,119,1.5,-155,3.94,PETCO Park,11,-9
2014-08-01,2014,BAL,SEA,2,1,-130,-1.5,155,8.0,100,-120,115,1.5,-175,4.52,Camden Yards,3,1
2014-08-01,2014,NYM,SF,1,5,-116,-1.5,185,7.0,101,-121,106,1.5,-215,3.76,Citi Field,6,-4
2014-08-01,2014,MIL,STL,7,4,147,1.5,-150,7.0,-105,-115,-162,-1.5,130,2.83,Busch Stadium,11,3
2014-08-01,2014,LAA,TB,5,3,102,1.5,-230,7.5,-105,-115,-112,-1.5,190,3.71,Tropicana Field,8,2
2014-08-01,2014,CLE,TEX,12,2,-174,-1.5,120,8.0,-120,100,154,1.5,-140,5.08,Progressive Field,14,10
2014-08-01,2014,HOU,TOR,3,1,-119,-1.5,175,8.0,-110,-110,109,1.5,-205,4.35,Minute Maid Park,4,2
2014-08-01,2014,PHI,WSH,2,1,190,1.5,-110,8.0,100,-120,-220,-1.5,-110,2.76,Nationals Park,3,1
2014-08-02,2014,PIT,ARI,8,3,-126,-1.5,130,8.0,-115,-105,116,1.5,-150,4.46,Chase Field,11,5
2014-08-02,2014,SD,ATL,3,2,107,1.5,-175,6.5,-110,-110,-117,-1.5,155,3.14,PETCO Park,5,1
2014-08-02,2014,SEA,BAL,6,3,105,1.5,-200,8.0,-105,-115,-115,-1.5,170,3.9,Camden Yards,9,3
2014-08-02,2014,NYY,BOS,6,4,104,1.5,-200,8.5,-105,-115,-114,-1.5,170,4.17,Fenway Park,10,2
2014-08-02,2014,LAD,CHC,5,2,-195,-1.5,114,7.0,105,-125,175,1.5,-133,4.63,Dodger Stadium,7,3
2014-08-02,2014,MIA,CIN,2,1,-114,-1.5,180,7.0,105,-125,104,1.5,-210,3.73,Marlins Park,3,1
2014-08-02,2014,TEX,CLE,0,2,150,1.5,-150,8.5,-115,-105,-170,-1.5,130,3.4,Progressive Field,2,-2
2014-08-02,2014,DET,COL,11,5,-230,-1.5,-115,9.0,105,-125,200,1.5,-105,6.27,Comerica Park,16,6
2014-08-02,2014,MIN,CWS,8,6,108,1.5,-195,9.0,-105,-115,-118,-1.5,165,4.33,Guaranteed Rate Field,14,2
2014-08-02,2014,COL,DET,5,11,200,1.5,-105,9.0,105,-125,-230,-1.5,-115,3.0,Comerica Park,16,-6
2014-08-02,2014,TOR,HOU,2,8,-130,-1.5,125,8.0,-112,-108,115,1.5,-145,4.52,Minute Maid Park,10,-6
2014-08-02,2014,OAK,KC,8,3,-179,-1.5,110,6.5,-125,105,159,1.5,-130,4.17,Oakland Coliseum,11,5
2014-08-02,2014,TB,LAA,10,3,-115,-1.5,180,7.5,100,-120,105,1.5,-210,4.01,Tropicana Field,13,7
2014-08-02,2014,CHC,LAD,2,5,175,1.5,-133,7.0,105,-125,-195,-1.5,114,2.55,Dodger Stadium,7,-3
2014-08-02,2014,CIN,MIA,1,2,104,1.5,-210,7.0,105,-125,-114,-1.5,180,3.43,Marlins Park,3,-1
2014-08-02,2014,STL,MIL,9,7,102,1.5,-170,7.5,-103,-117,-112,-1.5,150,3.71,Busch Stadium,16,2
2014-08-02,2014,CWS,MIN,6,8,-118,-1.5,165,9.0,-105,-115,108,1.5,-195,4.87,Guaranteed Rate Field,14,-2
2014-08-02,2014,SF,NYM,2,4,110,1.5,-210,6.5,-115,-105,-120,-1.5,180,3.1,Citi Field,6,-2
2014-08-02,2014,BOS,NYY,4,6,-114,-1.5,170,8.5,-105,-115,104,1.5,-200,4.53,Fenway Park,10,-2
2014-08-02,2014,KC,OAK,3,8,159,1.5,-130,6.5,-125,105,-179,-1.5,110,2.51,Oakland Coliseum,11,-5
2014-08-02,2014,WSH,PHI,11,0,-184,-1.5,120,7.0,-115,-105,164,1.5,-140,4.54,Nationals Park,11,11
2014-08-02,2014,ARI,PIT,3,8,116,1.5,-150,8.0,-115,-105,-126,-1.5,130,3.7,Chase Field,11,-5
2014-08-02,2014,ATL,SD,2,3,-117,-1.5,155,6.5,-110,-110,107,1.5,-175,3.5,PETCO Park,5,-1
2014-08-02,2014,BAL,SEA,3,6,-115,-1.5,170,8.0,-105,-115,105,1.5,-200,4.28,Camden Yards,9,-3
2014-08-02,2014,NYM,SF,4,2,-120,-1.5,180,6.5,-115,-105,110,1.5,-210,3.55,Citi Field,6,2
2014-08-02,2014,MIL,STL,7,9,-112,-1.5,150,7.5,-103,-117,102,1.5,-170,3.96,Busch Stadium,16,-2
2014-08-02,2014,LAA,TB,3,10,105,1.5,-210,7.5,100,-120,-115,-1.5,180,3.66,Tropicana Field,13,-7
2014-08-02,2014,CLE,TEX,2,0,-170,-1.5,130,8.5,-115,-105,150,1.5,-150,5.35,Progressive Field,2,2
2014-08-02,2014,HOU,TOR,8,2,115,1.5,-145,8.0,-112,-108,-130,-1.5,125,3.72,Minute Maid Park,10,6
2014-08-02,2014,PHI,WSH,0,11,164,1.5,-140,7.0,-115,-105,-184,-1.5,120,2.65,Nationals Park,11,-11
2014-08-03,2014,PIT,ARI,2,3,-171,-1.5,-118,7.5,-115,-105,151,1.5,-103,4.73,Chase Field,5,-1
2014-08-03,2014,SD,ATL,4,3,-132,-1.5,175,6.5,-120,100,117,1.5,-205,3.7,PETCO Park,7,1
2014-08-03,2014,SEA,BAL,0,1,-123,-1.5,130,7.5,108,-128,113,1.5,-150,4.14,Camden Yards,1,-1
2014-08-03,2014,NYY,BOS,8,7,-110,-1.5,140,8.5,-120,100,100,1.5,-160,4.45,Fenway Park,15,1
2014-08-03,2014,LAD,CHC,3,7,-193,-1.5,110,8.0,100,-120,173,1.5,-130,5.27,Dodger Stadium,10,-4
2014-08-03,2014,MIA,CIN,3,7,100,1.5,-175,7.0,-115,-105,-110,-1.5,155,3.5,Marlins Park,10,-4
2014-08-03,2014,TEX,CLE,3,4,-115,-1.5,135,7.0,100,-120,105,1.5,-155,3.74,Progressive Field,7,-1
2014-08-03,2014,DET,COL,4,0,-231,-1.5,-115,8.5,-115,-105,201,1.5,-105,5.93,Comerica Park,4,4
2014-08-03,2014,MIN,CWS,16,3,135,1.5,-160,8.0,-110,-110,-150,-1.5,140,3.4,Guaranteed Rate Field,19,13
2014-08-03,2014,COL,DET,0,4,201,1.5,-105,8.5,-115,-105,-231,-1.5,-115,2.82,Comerica Park,4,-4
2014-08-03,2014,TOR,HOU,1,6,-161,-1.5,-110,8.5,103,-123,146,1.5,-110,5.24,Minute Maid Park,7,-5
2014-08-03,2014,OAK,KC,2,4,-160,-1.5,140,6.5,-123,103,145,1.5,-160,4.0,Oakland Coliseum,6,-2
2014-08-03,2014,TB,LAA,5,7,-107,-1.5,185,7.0,-125,105,-103,1.5,-215,3.62,Tropicana Field,12,-2
2014-08-03,2014,CHC,LAD,7,3,173,1.5,-130,8.0,100,-120,-193,-1.5,110,2.93,Dodger Stadium,10,4
2014-08-03,2014,CIN,MIA,7,3,-110,-1.5,155,7.0,-115,-105,100,1.5,-175,3.67,Marlins Park,10,4
2014-08-03,2014,STL,MIL,3,2,-133,-1.5,160,7.5,100,-120,118,1.5,-190,4.28,Busch Stadium,5,1
2014-08-03,2014,CWS,MIN,3,16,-150,-1.5,140,8.0,-110,-110,135,1.5,-160,4.8,Guaranteed Rate Field,19,-13
2014-08-03,2014,SF,NYM,9,0,-126,-1.5,140,6.5,-110,-110,116,1.5,-160,3.62,Citi Field,9,9
2014-08-03,2014,BOS,NYY,7,8,100,1.5,-160,8.5,-120,100,-110,-1.5,140,4.25,Fenway Park,15,-1
2014-08-03,2014,KC,OAK,4,2,145,1.5,-160,6.5,-123,103,-160,-1.5,140,2.65,Oakland Coliseum,6,2
2014-08-03,2014,WSH,PHI,4,0,-146,-1.5,160,6.5,-104,-116,131,1.5,-190,3.86,Nationals Park,4,4
2014-08-03,2014,ARI,PIT,3,2,151,1.5,-103,7.5,-115,-105,-171,-1.5,-118,2.99,Chase Field,5,1
2014-08-03,2014,ATL,SD,3,4,117,1.5,-205,6.5,-120,100,-132,-1.5,175,3.0,PETCO Park,7,-1
2014-08-03,2014,BAL,SEA,1,0,113,1.5,-150,7.5,108,-128,-123,-1.5,130,3.52,Camden Yards,1,1
2014-08-03,2014,NYM,SF,0,9,116,1.5,-160,6.5,-110,-110,-126,-1.5,140,3.01,Citi Field,9,-9
2014-08-03,2014,MIL,STL,2,3,118,1.5,-190,7.5,100,-120,-133,-1.5,160,3.44,Busch Stadium,5,-1
2014-08-03,2014,LAA,TB,7,5,-103,1.5,-215,7.0,-125,105,-107,-1.5,185,3.55,Tropicana Field,12,2
2014-08-03,2014,CLE,TEX,4,3,105,1.5,-155,7.0,100,-120,-115,-1.5,135,3.41,Progressive Field,7,1
2014-08-03,2014,HOU,TOR,6,1,146,1.5,-110,8.5,103,-123,-161,-1.5,-110,3.46,Minute Maid Park,7,5
2014-08-03,2014,PHI,WSH,0,4,131,1.5,-190,6.5,-104,-116,-146,-1.5,160,2.81,Nationals Park,4,-4
2014-08-04,2014,WSH,BAL,3,7,-140,-1.5,155,7.0,-120,100,125,1.5,-175,4.08,Nationals Park,10,-4
2014-08-04,2014,CLE,CIN,7,1,-215,-1.5,100,7.0,105,-125,185,1.5,-120,4.78,Progressive Field,8,6
2014-08-04,2014,CIN,CLE,1,7,185,1.5,-120,7.0,105,-125,-215,-1.5,100,2.46,Progressive Field,8,-6
2014-08-04,2014,TEX,CWS,3,5,125,1.5,-165,9.5,100,-120,-140,-1.5,145,4.22,Guaranteed Rate Field,8,-2
2014-08-04,2014,NYY,DET,2,1,105,1.5,-160,7.5,-115,-105,-115,-1.5,140,3.66,Yankee Stadium,3,1
2014-08-04,2014,LAD,LAA,0,5,-115,-1.5,195,6.5,105,-125,105,1.5,-235,3.48,Dodger Stadium,5,-5
2014-08-04,2014,LAA,LAD,5,0,105,1.5,-235,6.5,105,-125,-115,-1.5,195,3.17,Dodger Stadium,5,5
2014-08-04,2014,SF,NYM,4,3,-126,-1.5,130,7.0,-105,-115,116,1.5,-150,3.9,Citi Field,7,1
2014-08-04,2014,DET,NYY,1,2,-115,-1.5,140,7.5,-115,-105,105,1.5,-160,4.01,Yankee Stadium,3,-1
2014-08-04,2014,TB,OAK,2,3,117,1.5,-205,6.5,-125,105,-132,-1.5,175,3.0,Oakland Coliseum,5,-1
2014-08-04,2014,NYM,SF,3,4,116,1.5,-150,7.0,-105,-115,-126,-1.5,130,3.24,Citi Field,7,-1
2014-08-04,2014,OAK,TB,3,2,-132,-1.5,175,6.5,-125,105,117,1.5,-205,3.7,Oakland Coliseum,5,1
2014-08-04,2014,CWS,TEX,5,3,-140,-1.5,145,9.5,100,-120,125,1.5,-165,5.54,Guaranteed Rate Field,8,2
2014-08-04,2014,BAL,WSH,7,3,125,1.5,-175,7.0,-120,100,-140,-1.5,155,3.11,Nationals Park,10,4
2014-08-05,2014,KC,ARI,12,2,-125,-1.5,130,7.0,100,-120,115,1.5,-150,3.89,Chase Field,14,10
2014-08-05,2014,SEA,ATL,4,2,-180,-1.5,130,6.0,105,-125,160,1.5,-150,3.86,T-Mobile Park,6,2
2014-08-05,2014,TOR,BAL,3,9,-105,-1.5,180,9.0,-110,-110,-105,1.5,-210,4.61,Rogers Centre,12,-6
2014-08-05,2014,STL,BOS,3,2,-155,-1.5,140,7.5,-115,-105,140,1.5,-160,4.56,Busch Stadium,5,1
2014-08-05,2014,COL,CHC,5,6,-128,-1.5,150,10.0,-105,-115,118,1.5,-170,5.61,Coors Field,11,-1
2014-08-05,2014,CLE,CIN,2,9,-127,-1.5,170,7.0,110,-130,117,1.5,-200,3.92,Progressive Field,11,-7
2014-08-05,2014,CIN,CLE,9,2,117,1.5,-200,7.0,110,-130,-127,-1.5,170,3.23,Progressive Field,11,7
2014-08-05,2014,CHC,COL,6,5,118,1.5,-170,10.0,-105,-115,-128,-1.5,150,4.59,Coors Field,11,1
2014-08-05,2014,TEX,CWS,16,0,-101,1.5,-200,8.5,-120,100,-109,-1.5,170,4.27,Guaranteed Rate Field,16,16
2014-08-05,2014,NYY,DET,3,4,105,1.5,-155,7.5,105,-125,-115,-1.5,135,3.66,Yankee Stadium,7,-1
2014-08-05,2014,PHI,HOU,2,1,-108,1.5,-170,7.5,-115,-105,-102,-1.5,150,3.89,Citizens Bank Park,3,1
2014-08-05,2014,ARI,KC,2,12,115,1.5,-150,7.0,100,-120,-125,-1.5,130,3.26,Chase Field,14,-10
2014-08-05,2014,LAD,LAA,5,4,-210,-1.5,110,6.5,105,-125,180,1.5,-130,4.4,Dodger Stadium,9,1
2014-08-05,2014,LAA,LAD,4,5,180,1.5,-130,6.5,105,-125,-210,-1.5,110,2.32,Dodger Stadium,9,-1
2014-08-05,2014,PIT,MIA,3,6,-128,-1.5,170,7.5,-105,-115,118,1.5,-200,4.21,PNC Park,9,-3
2014-08-05,2014,SF,MIL,3,4,120,1.5,-175,8.0,-115,-105,-135,-1.5,155,3.64,Miller Park,7,-1
2014-08-05,2014,SD,MIN,1,3,118,1.5,-200,7.5,100,-120,-128,-1.5,170,3.44,Target Field,4,-2
2014-08-05,2014,WSH,NYM,1,6,-158,-1.5,145,7.5,100,-120,143,1.5,-165,4.59,Nationals Park,7,-5
2014-08-05,2014,DET,NYY,4,3,-115,-1.5,135,7.5,105,-125,105,1.5,-155,4.01,Yankee Stadium,7,1
2014-08-05,2014,TB,OAK,0,3,108,1.5,-210,7.5,105,-125,-118,-1.5,180,3.61,Oakland Coliseum,3,-3
2014-08-05,2014,HOU,PHI,1,2,-102,-1.5,150,7.5,-115,-105,-108,1.5,-170,3.79,Citizens Bank Park,3,-1
2014-08-05,2014,MIA,PIT,6,3,118,1.5,-200,7.5,-105,-115,-128,-1.5,170,3.44,PNC Park,9,3
2014-08-05,2014,MIN,SD,3,1,-128,-1.5,170,7.5,100,-120,118,1.5,-200,4.21,Target Field,4,2
2014-08-05,2014,ATL,SEA,2,4,160,1.5,-150,6.0,105,-125,-180,-1.5,130,2.31,T-Mobile Park,6,-2
2014-08-05,2014,MIL,SF,4,3,-135,-1.5,155,8.0,-115,-105,120,1.5,-175,4.6,Miller Park,7,1
2014-08-05,2014,BOS,STL,2,3,140,1.5,-160,7.5,-115,-105,-155,-1.5,140,3.13,Busch Stadium,5,-1
2014-08-05,2014,OAK,TB,3,0,-118,-1.5,180,7.5,105,-125,108,1.5,-210,4.06,Oakland Coliseum,3,3
2014-08-05,2014,CWS,TEX,0,16,-109,-1.5,170,8.5,-120,100,-101,1.5,-200,4.43,Guaranteed Rate Field,16,-16
2014-08-05,2014,BAL,TOR,9,3,-105,1.5,-210,9.0,-110,-110,-105,-1.5,180,4.61,Rogers Centre,12,6
2014-08-05,2014,NYM,WSH,6,1,143,1.5,-165,7.5,100,-120,-158,-1.5,145,3.09,Nationals Park,7,5
2014-08-06,2014,KC,ARI,4,3,-148,-1.5,105,8.0,100,-120,133,1.5,-125,4.77,Chase Field,7,1
2014-08-06,2014,SEA,ATL,7,3,105,1.5,-170,7.0,105,-125,-115,-1.5,150,3.41,T-Mobile Park,10,4
2014-08-06,2014,TOR,BAL,5,1,104,1.5,-160,8.5,-105,-115,-114,-1.5,140,4.17,Rogers Centre,6,4
2014-08-06,2014,STL,BOS,1,2,-134,-1.5,159,8.0,-101,-119,119,1.5,-189,4.58,Busch Stadium,3,-1
2014-08-06,2014,COL,CHC,13,4,112,1.5,-145,9.5,-120,100,-122,-1.5,125,4.48,Coors Field,17,9
2014-08-06,2014,CLE,CIN,3,8,-105,-1.5,155,7.5,100,-120,-105,1.5,-175,3.84,Great American Ballpark,11,-5
2014-08-06,2014,CIN,CLE,8,3,-105,1.5,-175,7.5,100,-120,-105,-1.5,155,3.84,Great American Ballpark,11,5
2014-08-06,2014,CHC,COL,4,13,-122,-1.5,125,9.5,-120,100,112,1.5,-145,5.22,Coors Field,17,-9
2014-08-06,2014,TEX,CWS,3,1,205,1.5,101,7.5,100,-120,-235,-1.5,-121,2.46,Guaranteed Rate Field,4,2
2014-08-06,2014,NYY,DET,5,1,-109,-1.5,180,9.0,-105,-115,-101,1.5,-210,4.69,Yankee Stadium,6,4
2014-08-06,2014,PHI,HOU,10,3,-140,-1.5,150,8.5,-105,-115,125,1.5,-170,4.96,Citizens Bank Park,13,7
2014-08-06,2014,ARI,KC,3,4,133,1.5,-125,8.0,100,-120,-148,-1.5,105,3.43,Chase Field,7,-1
2014-08-06,2014,LAD,LAA,2,1,145,1.5,-145,8.5,100,-120,-160,-1.5,125,3.47,Angel Stadium,3,1
2014-08-06,2014,LAA,LAD,1,2,-160,-1.5,125,8.5,100,-120,145,1.5,-145,5.23,Angel Stadium,3,-1
2014-08-06,2014,PIT,MIA,7,3,-130,-1.5,165,7.5,108,-128,115,1.5,-195,4.24,PNC Park,10,4
2014-08-06,2014,SF,MIL,7,4,119,1.5,-195,8.0,100,-120,-129,-1.5,165,3.65,Miller Park,11,3
2014-08-06,2014,SD,MIN,5,4,-105,-1.5,155,8.0,-120,100,-105,1.5,-175,4.1,Target Field,9,1
2014-08-06,2014,WSH,NYM,7,1,-154,-1.5,145,7.0,-125,105,139,1.5,-165,4.24,Nationals Park,8,6
2014-08-06,2014,DET,NYY,1,5,-101,1.5,-210,9.0,-105,-115,-109,-1.5,180,4.52,Yankee Stadium,6,-4
2014-08-06,2014,TB,OAK,7,3,175,1.5,-125,7.0,-120,100,-195,-1.5,105,2.55,Oakland Coliseum,10,4
2014-08-06,2014,HOU,PHI,3,10,125,1.5,-170,8.5,-105,-115,-140,-1.5,150,3.78,Citizens Bank Park,13,-7
2014-08-06,2014,MIA,PIT,3,7,115,1.5,-195,7.5,108,-128,-130,-1.5,165,3.49,PNC Park,10,-4
2014-08-06,2014,MIN,SD,4,5,-105,1.5,-175,8.0,-120,100,-105,-1.5,155,4.1,Target Field,9,-1
2014-08-06,2014,ATL,SEA,3,7,-115,-1.5,150,7.0,105,-125,105,1.5,-170,3.74,T-Mobile Park,10,-4
2014-08-06,2014,MIL,SF,4,7,-129,-1.5,165,8.0,100,-120,119,1.5,-195,4.51,Miller Park,11,-3
2014-08-06,2014,BOS,STL,2,1,119,1.5,-189,8.0,-101,-119,-134,-1.5,159,3.65,Busch Stadium,3,1
2014-08-06,2014,OAK,TB,3,7,-195,-1.5,105,7.0,-120,100,175,1.5,-125,4.63,Oakland Coliseum,10,-4
2014-08-06,2014,CWS,TEX,1,3,-235,-1.5,-121,7.5,100,-120,205,1.5,101,5.26,Guaranteed Rate Field,4,-2
2014-08-06,2014,BAL,TOR,1,5,-114,-1.5,140,8.5,-105,-115,104,1.5,-160,4.53,Rogers Centre,6,-4
2014-08-06,2014,NYM,WSH,1,7,139,1.5,-165,7.0,-125,105,-154,-1.5,145,2.93,Nationals Park,8,-6
2014-08-07,2014,KC,ARI,6,2,-110,-1.5,155,8.0,-120,100,100,1.5,-175,4.19,Chase Field,8,4
2014-08-07,2014,TOR,BAL,1,2,-118,-1.5,165,9.0,-110,-110,108,1.5,-195,4.87,Rogers Centre,3,-1
2014-08-07,2014,STL,BOS,5,2,-171,-1.5,125,7.0,-125,105,151,1.5,-145,4.42,Busch Stadium,7,3
2014-08-07,2014,COL,CHC,2,6,-119,-1.5,165,10.5,-107,-113,109,1.5,-195,5.71,Coors Field,8,-4
2014-08-07,2014,CLE,CIN,0,4,108,1.5,-205,7.5,-105,-115,-118,-1.5,175,3.61,Great American Ballpark,4,-4
2014-08-07,2014,CIN,CLE,4,0,-118,-1.5,175,7.5,-105,-115,108,1.5,-205,4.06,Great American Ballpark,4,4
2014-08-07,2014,CHC,COL,6,2,109,1.5,-195,10.5,-107,-113,-119,-1.5,165,5.02,Coors Field,8,4
2014-08-07,2014,SEA,CWS,13,3,-195,-1.5,115,7.5,105,-125,175,1.5,-135,4.96,T-Mobile Park,16,10
2014-08-07,2014,NYY,DET,1,0,-115,-1.5,175,8.0,-115,-105,105,1.5,-205,4.28,Yankee Stadium,1,1
2014-08-07,2014,PHI,HOU,6,5,-105,1.5,-170,8.0,-110,-110,-105,-1.5,150,4.1,Citizens Bank Park,11,1
2014-08-07,2014,ARI,KC,2,6,100,1.5,-175,8.0,-120,100,-110,-1.5,155,4.0,Chase Field,8,-4
2014-08-07,2014,LAD,LAA,7,0,-107,-1.5,155,8.0,100,-120,-103,1.5,-175,4.14,Angel Stadium,7,7
2014-08-07,2014,LAA,LAD,0,7,-103,1.5,-175,8.0,100,-120,-107,-1.5,155,4.06,Angel Stadium,7,-7
2014-08-07,2014,PIT,MIA,7,2,-140,-1.5,155,8.0,100,-120,125,1.5,-175,4.67,PNC Park,9,5
2014-08-07,2014,SF,MIL,1,3,116,1.5,-195,8.0,-105,-115,-131,-1.5,165,3.7,Miller Park,4,-2
2014-08-07,2014,OAK,MIN,3,0,-275,-1.5,-125,7.5,100,-120,235,1.5,105,5.5,Oakland Coliseum,3,3
2014-08-07,2014,WSH,NYM,5,3,-163,-1.5,140,7.0,-110,-110,148,1.5,-160,4.34,Nationals Park,8,2
2014-08-07,2014,DET,NYY,0,1,105,1.5,-205,8.0,-115,-105,-115,-1.5,175,3.9,Yankee Stadium,1,-1
2014-08-07,2014,MIN,OAK,0,3,235,1.5,105,7.5,100,-120,-275,-1.5,-125,2.24,Oakland Coliseum,3,-3
2014-08-07,2014,HOU,PHI,5,6,-105,-1.5,150,8.0,-110,-110,-105,1.5,-170,4.1,Citizens Bank Park,11,-1
2014-08-07,2014,MIA,PIT,2,7,125,1.5,-175,8.0,100,-120,-140,-1.5,155,3.56,PNC Park,9,-5
2014-08-07,2014,CWS,SEA,3,13,175,1.5,-135,7.5,105,-125,-195,-1.5,115,2.73,T-Mobile Park,16,-10
2014-08-07,2014,MIL,SF,3,1,-131,-1.5,165,8.0,-105,-115,116,1.5,-195,4.54,Miller Park,4,2
2014-08-07,2014,BOS,STL,2,5,151,1.5,-145,7.0,-125,105,-171,-1.5,125,2.79,Busch Stadium,7,-3
2014-08-07,2014,BAL,TOR,2,1,108,1.5,-195,9.0,-110,-110,-118,-1.5,165,4.33,Rogers Centre,3,1
2014-08-07,2014,NYM,WSH,3,5,148,1.5,-160,7.0,-110,-110,-163,-1.5,140,2.82,Nationals Park,8,-2
2014-08-08,2014,COL,ARI,3,5,113,1.5,-200,8.0,-105,-115,-123,-1.5,170,3.76,Chase Field,8,-2
2014-08-08,2014,WSH,ATL,6,7,-115,-1.5,145,6.5,-114,-106,105,1.5,-165,3.48,Turner Field,13,-1
2014-08-08,2014,STL,BAL,2,12,115,1.5,-190,8.0,-120,100,-125,-1.5,160,3.72,Camden Yards,14,-10
2014-08-08,2014,LAA,BOS,2,4,-195,-1.5,106,8.5,-120,100,175,1.5,-126,5.62,Angel Stadium,6,-2
2014-08-08,2014,TB,CHC,4,3,-124,-1.5,135,7.0,-125,105,114,1.5,-155,3.88,Wrigley Field,7,1
2014-08-08,2014,MIA,CIN,2,1,115,1.5,-200,7.0,-120,100,-130,-1.5,170,3.26,Great American Ballpark,3,1
2014-08-08,2014,NYY,CLE,10,6,-143,-1.5,165,8.5,-128,108,128,1.5,-186,5.0,Yankee Stadium,16,4
2014-08-08,2014,ARI,COL,5,3,-123,-1.5,170,8.0,-105,-115,113,1.5,-200,4.41,Chase Field,8,2
2014-08-08,2014,SEA,CWS,4,1,-171,-1.5,135,6.5,105,-125,151,1.5,-155,4.1,T-Mobile Park,5,3
2014-08-08,2014,TOR,DET,4,5,116,1.5,-145,8.0,100,-120,-131,-1.5,125,3.7,Rogers Centre,9,-1
2014-08-08,2014,TEX,HOU,3,4,105,1.5,-205,8.5,-115,-105,-115,-1.5,175,4.15,Minute Maid Park,7,-1
2014-08-08,2014,SF,KC,2,4,102,1.5,-225,7.0,-110,-110,-112,-1.5,195,3.47,Kauffman Stadium,6,-2
2014-08-08,2014,BOS,LAA,4,2,175,1.5,-126,8.5,-120,100,-195,-1.5,106,3.09,Angel Stadium,6,2
2014-08-08,2014,MIL,LAD,9,3,-150,-1.5,145,8.5,-105,-115,135,1.5,-165,5.1,Miller Park,12,6
2014-08-08,2014,CIN,MIA,1,2,-130,-1.5,170,7.0,-120,100,115,1.5,-200,3.96,Great American Ballpark,3,-1
2014-08-08,2014,LAD,MIL,3,9,135,1.5,-165,8.5,-105,-115,-150,-1.5,145,3.62,Miller Park,12,-6
2014-08-08,2014,OAK,MIN,6,5,-220,-1.5,-105,7.0,-110,-110,190,1.5,-115,4.81,Oakland Coliseum,11,1
2014-08-08,2014,PHI,NYM,4,5,-102,1.5,-170,7.5,-112,-108,-108,-1.5,150,3.79,Citizens Bank Park,9,-1
2014-08-08,2014,CLE,NYY,6,10,128,1.5,-186,8.5,-128,108,-143,-1.5,165,3.73,Yankee Stadium,16,-4
2014-08-08,2014,MIN,OAK,5,6,190,1.5,-115,7.0,-110,-110,-220,-1.5,-105,2.41,Oakland Coliseum,11,-1
2014-08-08,2014,NYM,PHI,5,4,-108,-1.5,150,7.5,-112,-108,-102,1.5,-170,3.89,Citizens Bank Park,9,1
2014-08-08,2014,SD,PIT,1,2,108,1.5,-205,7.0,-120,100,-118,-1.5,175,3.37,PNC Park,3,-1
2014-08-08,2014,PIT,SD,2,1,-118,-1.5,175,7.0,-120,100,108,1.5,-205,3.79,PNC Park,3,1
2014-08-08,2014,CWS,SEA,1,4,151,1.5,-155,6.5,105,-125,-171,-1.5,135,2.59,T-Mobile Park,5,-3
2014-08-08,2014,KC,SF,4,2,-112,-1.5,195,7.0,-110,-110,102,1.5,-225,3.7,Kauffman Stadium,6,2
2014-08-08,2014,BAL,STL,12,2,-125,-1.5,160,8.0,-120,100,115,1.5,-190,4.44,Camden Yards,14,10
2014-08-08,2014,CHC,TB,3,4,114,1.5,-155,7.0,-125,105,-124,-1.5,135,3.27,Wrigley Field,7,-1
2014-08-08,2014,HOU,TEX,4,3,-115,-1.5,175,8.5,-115,-105,105,1.5,-205,4.55,Minute Maid Park,7,1
2014-08-08,2014,DET,TOR,5,4,-131,-1.5,125,8.0,100,-120,116,1.5,-145,4.54,Rogers Centre,9,1
2014-08-08,2014,ATL,WSH,7,6,105,1.5,-165,6.5,-114,-106,-115,-1.5,145,3.17,Turner Field,13,1
2014-08-09,2014,COL,ARI,4,14,-110,-1.5,150,8.0,-105,-115,100,1.5,-170,4.19,Chase Field,18,-10
2014-08-09,2014,WSH,ATL,4,1,-116,-1.5,140,7.5,105,-125,106,1.5,-160,4.03,Turner Field,5,3
2014-08-09,2014,STL,BAL,3,10,-105,-1.5,145,8.5,-105,-115,-105,1.5,-165,4.35,Camden Yards,13,-7
2014-08-09,2014,LAA,BOS,5,4,-201,-1.5,-105,7.5,-110,-110,171,1.5,-115,5.01,Angel Stadium,9,1
2014-08-09,2014,TB,CHC,4,0,-140,-1.5,120,7.0,-105,-115,125,1.5,-140,4.08,Wrigley Field,4,4
2014-08-09,2014,MIA,CIN,4,3,121,1.5,-175,8.0,-115,-105,-136,-1.5,155,3.62,Great American Ballpark,7,1
2014-08-09,2014,NYY,CLE,0,3,100,1.5,-165,7.5,117,-137,-110,-1.5,145,3.75,Yankee Stadium,3,-3
2014-08-09,2014,ARI,COL,14,4,100,1.5,-170,8.0,-105,-115,-110,-1.5,150,4.0,Chase Field,18,10
2014-08-09,2014,SEA,CWS,1,2,-195,-1.5,110,7.5,-102,-118,175,1.5,-130,4.96,T-Mobile Park,3,-1
2014-08-09,2014,TOR,DET,3,2,107,1.5,-155,7.5,-120,100,-117,-1.5,135,3.62,Rogers Centre,5,1
2014-08-09,2014,TEX,HOU,3,8,-190,-1.5,-120,7.0,-120,100,170,1.5,100,4.59,Minute Maid Park,11,-5
2014-08-09,2014,SF,KC,0,5,135,1.5,-165,7.0,-120,100,-150,-1.5,145,2.98,Kauffman Stadium,5,-5
2014-08-09,2014,BOS,LAA,4,5,171,1.5,-115,7.5,-110,-110,-201,-1.5,-105,2.77,Angel Stadium,9,-1
2014-08-09,2014,MIL,LAD,4,1,115,1.5,-150,7.5,-102,-118,-130,-1.5,130,3.49,Miller Park,5,3
2014-08-09,2014,CIN,MIA,3,4,-136,-1.5,155,8.0,-115,-105,121,1.5,-175,4.61,Great American Ballpark,7,-1
2014-08-09,2014,LAD,MIL,1,4,-130,-1.5,130,7.5,-102,-118,115,1.5,-150,4.24,Miller Park,5,-3
2014-08-09,2014,OAK,MIN,9,4,-250,-1.5,-114,7.0,-126,106,210,1.5,-106,5.0,Oakland Coliseum,13,5
2014-08-09,2014,PHI,NYM,1,2,-180,-1.5,125,7.0,-110,-110,160,1.5,-145,4.5,Citizens Bank Park,3,-1
2014-08-09,2014,CLE,NYY,3,0,-110,-1.5,145,7.5,117,-137,100,1.5,-165,3.93,Yankee Stadium,3,3
2014-08-09,2014,MIN,OAK,4,9,210,1.5,-106,7.0,-126,106,-250,-1.5,-114,2.26,Oakland Coliseum,13,-5
2014-08-09,2014,NYM,PHI,2,1,160,1.5,-145,7.0,-110,-110,-180,-1.5,125,2.69,Citizens Bank Park,3,1
2014-08-09,2014,SD,PIT,2,1,157,1.5,-145,7.0,-120,100,-177,-1.5,125,2.72,PNC Park,3,1
2014-08-09,2014,PIT,SD,1,2,-177,-1.5,125,7.0,-120,100,157,1.5,-145,4.47,PNC Park,3,-1
2014-08-09,2014,CWS,SEA,2,1,175,1.5,-130,7.5,-102,-118,-195,-1.5,110,2.73,T-Mobile Park,3,1
2014-08-09,2014,KC,SF,5,0,-150,-1.5,145,7.0,-120,100,135,1.5,-165,4.2,Kauffman Stadium,5,5
2014-08-09,2014,BAL,STL,10,3,-105,1.5,-165,8.5,-105,-115,-105,-1.5,145,4.35,Camden Yards,13,7
2014-08-09,2014,CHC,TB,0,4,125,1.5,-140,7.0,-105,-115,-140,-1.5,120,3.11,Wrigley Field,4,-4
2014-08-09,2014,HOU,TEX,8,3,170,1.5,100,7.0,-120,100,-190,-1.5,-120,2.59,Minute Maid Park,11,5
2014-08-09,2014,DET,TOR,2,3,-117,-1.5,135,7.5,-120,100,107,1.5,-155,4.04,Rogers Centre,5,-1
2014-08-09,2014,ATL,WSH,1,4,106,1.5,-160,7.5,105,-125,-116,-1.5,140,3.64,Turner Field,5,-3
2014-08-10,2014,COL,ARI,5,3,145,1.5,-155,8.0,-115,-105,-160,-1.5,135,3.27,Chase Field,8,2
2014-08-10,2014,WSH,ATL,1,3,108,1.5,-230,6.5,-115,-105,-118,-1.5,190,3.13,Turner Field,4,-2
2014-08-10,2014,STL,BAL,8,3,113,1.5,-190,8.0,-123,103,-123,-1.5,160,3.76,Camden Yards,11,5
2014-08-10,2014,LAA,BOS,1,3,-155,-1.5,130,8.5,-111,-109,140,1.5,-150,5.17,Angel Stadium,4,-2
2014-08-10,2014,TB,CHC,2,3,-160,-1.5,105,7.0,-110,-110,145,1.5,-125,4.31,Wrigley Field,5,-1
2014-08-10,2014,MIA,CIN,2,7,179,1.5,-135,7.0,110,-130,-199,-1.5,115,2.51,Great American Ballpark,9,-5
2014-08-10,2014,NYY,CLE,1,4,-140,-1.5,150,8.5,-110,-110,125,1.5,-170,4.96,Yankee Stadium,5,-3
2014-08-10,2014,ARI,COL,3,5,-160,-1.5,135,8.0,-115,-105,145,1.5,-155,4.92,Chase Field,8,-2
2014-08-10,2014,SEA,CWS,4,2,-159,-1.5,130,8.0,-105,-115,144,1.5,-150,4.91,T-Mobile Park,6,2
2014-08-10,2014,TOR,DET,6,5,142,1.5,-119,8.0,100,-120,-157,-1.5,-101,3.31,Rogers Centre,11,1
2014-08-10,2014,TEX,HOU,6,2,130,1.5,-170,8.5,-108,-112,-145,-1.5,150,3.7,Minute Maid Park,8,4
2014-08-10,2014,SF,KC,4,7,146,1.5,-150,7.5,-102,-118,-161,-1.5,130,3.05,Kauffman Stadium,11,-3
2014-08-10,2014,BOS,LAA,3,1,140,1.5,-150,8.5,-111,-109,-155,-1.5,130,3.54,Angel Stadium,4,2
2014-08-10,2014,MIL,LAD,1,5,141,1.5,-120,7.0,100,-120,-156,-1.5,100,2.9,Miller Park,6,-4
2014-08-10,2014,CIN,MIA,7,2,-199,-1.5,115,7.0,110,-130,179,1.5,-135,4.66,Great American Ballpark,9,5
2014-08-10,2014,LAD,MIL,5,1,-156,-1.5,100,7.0,100,-120,141,1.5,-120,4.27,Miller Park,6,4
2014-08-10,2014,OAK,MIN,1,6,-180,-1.5,125,7.0,-125,105,160,1.5,-145,4.5,Oakland Coliseum,7,-5
2014-08-10,2014,PHI,NYM,7,6,106,1.5,-160,8.0,100,-120,-116,-1.5,140,3.88,Citizens Bank Park,13,1
2014-08-10,2014,CLE,NYY,4,1,125,1.5,-170,8.5,-110,-110,-140,-1.5,150,3.78,Yankee Stadium,5,3
2014-08-10,2014,MIN,OAK,6,1,160,1.5,-145,7.0,-125,105,-180,-1.5,125,2.69,Oakland Coliseum,7,5
2014-08-10,2014,NYM,PHI,6,7,-116,-1.5,140,8.0,100,-120,106,1.5,-160,4.3,Citizens Bank Park,13,-1
2014-08-10,2014,SD,PIT,8,2,108,1.5,-230,7.0,100,-120,-118,-1.5,190,3.37,PNC Park,10,6
2014-08-10,2014,PIT,SD,2,8,-118,-1.5,190,7.0,100,-120,108,1.5,-230,3.79,PNC Park,10,-6
2014-08-10,2014,CWS,SEA,2,4,144,1.5,-150,8.0,-105,-115,-159,-1.5,130,3.28,T-Mobile Park,6,-2
2014-08-10,2014,KC,SF,7,4,-161,-1.5,130,7.5,-102,-118,146,1.5,-150,4.63,Kauffman Stadium,11,3
2014-08-10,2014,BAL,STL,3,8,-123,-1.5,160,8.0,-123,103,113,1.5,-190,4.41,Camden Yards,11,-5
2014-08-10,2014,CHC,TB,3,2,145,1.5,-125,7.0,-110,-110,-160,-1.5,105,2.86,Wrigley Field,5,1
2014-08-10,2014,HOU,TEX,2,6,-145,-1.5,150,8.5,-108,-112,130,1.5,-170,5.03,Minute Maid Park,8,-4
2014-08-10,2014,DET,TOR,5,6,-157,-1.5,-101,8.0,100,-120,142,1.5,-119,4.89,Rogers Centre,11,-1
2014-08-10,2014,ATL,WSH,3,1,-118,-1.5,190,6.5,-115,-105,108,1.5,-230,3.52,Turner Field,4,2
2014-08-11,2014,LAD,ATL,6,2,170,1.5,-140,7.5,-115,-105,-190,-1.5,120,2.78,Turner Field,8,4
2014-08-11,2014,NYY,BAL,3,11,109,1.5,-200,8.5,-105,-115,-119,-1.5,170,4.07,Camden Yards,14,-8
2014-08-11,2014,MIL,CHC,3,1,-105,-1.5,150,7.5,105,-125,-105,1.5,-170,3.84,Wrigley Field,4,2
2014-08-11,2014,SD,COL,4,3,-171,-1.5,140,6.5,-110,-110,151,1.5,-160,4.1,PETCO Park,7,1
2014-08-11,2014,PIT,DET,11,6,-105,1.5,-170,7.5,105,-125,-105,-1.5,150,3.84,PNC Park,17,5
2014-08-11,2014,MIN,HOU,4,2,-111,-1.5,140,8.5,100,-120,101,1.5,-160,4.47,Minute Maid Park,6,2
2014-08-11,2014,OAK,KC,2,3,102,1.5,-230,7.0,-108,-112,-112,-1.5,190,3.47,Kauffman Stadium,5,-1
2014-08-11,2014,ATL,LAD,2,6,-190,-1.5,120,7.5,-115,-105,170,1.5,-140,4.91,Turner Field,8,-4
2014-08-11,2014,STL,MIA,5,6,-103,1.5,-230,7.5,-115,-105,-107,-1.5,190,3.81,Marlins Park,11,-1
2014-08-11,2014,CHC,MIL,1,3,-105,1.5,-170,7.5,105,-125,-105,-1.5,150,3.84,Wrigley Field,4,-2
2014-08-11,2014,HOU,MIN,2,4,101,1.5,-160,8.5,100,-120,-111,-1.5,140,4.23,Minute Maid Park,6,-2
2014-08-11,2014,PHI,NYM,3,5,114,1.5,-150,8.0,-120,100,-124,-1.5,130,3.74,Citizens Bank Park,8,-2
2014-08-11,2014,BAL,NYY,11,3,-119,-1.5,170,8.5,-105,-115,109,1.5,-200,4.62,Camden Yards,14,8
2014-08-11,2014,KC,OAK,3,2,-112,-1.5,190,7.0,-108,-112,102,1.5,-230,3.7,Kauffman Stadium,5,1
2014-08-11,2014,NYM,PHI,5,3,-124,-1.5,130,8.0,-120,100,114,1.5,-150,4.43,Citizens Bank Park,8,2
2014-08-11,2014,DET,PIT,6,11,-105,-1.5,150,7.5,105,-125,-105,1.5,-170,3.84,PNC Park,17,-5
2014-08-11,2014,COL,SD,3,4,151,1.5,-160,6.5,-110,-110,-171,-1.5,140,2.59,PETCO Park,7,-1
2014-08-11,2014,TOR,SEA,1,11,210,1.5,-105,6.5,-125,105,-250,-1.5,-115,2.1,T-Mobile Park,12,-10
2014-08-11,2014,MIA,STL,6,5,-107,-1.5,190,7.5,-115,-105,-103,1.5,-230,3.88,Marlins Park,11,1
2014-08-11,2014,TEX,TB,0,7,109,1.5,-155,8.5,-125,105,-119,-1.5,135,4.07,Rangers Ballpark,7,-7
2014-08-11,2014,TB,TEX,7,0,-119,-1.5,135,8.5,-125,105,109,1.5,-155,4.62,Rangers Ballpark,7,7
2014-08-11,2014,SEA,TOR,11,1,-250,-1.5,-115,6.5,-125,105,210,1.5,-105,4.64,T-Mobile Park,12,10
2014-08-12,2014,LAD,ATL,4,2,117,1.5,-200,8.0,100,-120,-127,-1.5,170,3.69,Turner Field,6,2
2014-08-12,2014,CIN,BOS,2,3,-127,-1.5,170,7.5,-102,-118,117,1.5,-200,4.2,Great American Ballpark,5,-1
2014-08-12,2014,MIL,CHC,0,3,-118,-1.5,140,7.5,-110,-110,108,1.5,-160,4.06,Wrigley Field,3,-3
2014-08-12,2014,BOS,CIN,3,2,117,1.5,-200,7.5,-102,-118,-127,-1.5,170,3.46,Great American Ballpark,5,1
2014-08-12,2014,SD,COL,4,1,-128,-1.5,170,7.0,107,-127,118,1.5,-200,3.93,PETCO Park,5,3
2014-08-12,2014,SF,CWS,2,3,111,1.5,-155,6.0,100,-120,-121,-1.5,135,2.84,AT&T Park,5,-1
2014-08-12,2014,PIT,DET,4,2,-119,-1.5,170,8.5,-110,-110,109,1.5,-200,4.62,PNC Park,6,2
2014-08-12,2014,MIN,HOU,4,10,132,1.5,-165,7.5,-105,-115,-147,-1.5,145,3.23,Minute Maid Park,14,-6
2014-08-12,2014,OAK,KC,11,3,-143,-1.5,115,7.0,-105,-115,128,1.5,-135,4.12,Kauffman Stadium,14,8
2014-08-12,2014,PHI,LAA,2,7,210,1.5,101,8.5,-108,-112,-250,-1.5,-122,2.74,Angel Stadium,9,-5
2014-08-12,2014,ATL,LAD,2,4,-127,-1.5,170,8.0,100,-120,117,1.5,-200,4.48,Turner Field,6,-2
2014-08-12,2014,STL,MIA,0,3,-133,-1.5,120,7.0,-120,100,118,1.5,-140,4.0,Marlins Park,3,-3
2014-08-12,2014,CHC,MIL,3,0,108,1.5,-160,7.5,-110,-110,-118,-1.5,140,3.61,Wrigley Field,3,3
2014-08-12,2014,HOU,MIN,10,4,-147,-1.5,145,7.5,-105,-115,132,1.5,-165,4.46,Minute Maid Park,14,6
2014-08-12,2014,WSH,NYM,7,1,-128,-1.5,125,7.0,-120,100,118,1.5,-145,3.93,Citi Field,8,6
2014-08-12,2014,KC,OAK,3,11,128,1.5,-135,7.0,-105,-115,-143,-1.5,115,3.07,Kauffman Stadium,14,-8
2014-08-12,2014,LAA,PHI,7,2,-250,-1.5,-122,8.5,-108,-112,210,1.5,101,6.07,Angel Stadium,9,5
2014-08-12,2014,DET,PIT,2,4,109,1.5,-200,8.5,-110,-110,-119,-1.5,170,4.07,PNC Park,6,-2
2014-08-12,2014,COL,SD,1,4,118,1.5,-200,7.0,107,-127,-128,-1.5,170,3.21,PETCO Park,5,-3
2014-08-12,2014,TOR,SEA,3,6,107,1.5,-190,8.0,103,-123,-117,-1.5,160,3.86,T-Mobile Park,9,-3
2014-08-12,2014,CWS,SF,3,2,-121,-1.5,135,6.0,100,-120,111,1.5,-155,3.29,AT&T Park,5,1
2014-08-12,2014,MIA,STL,3,0,118,1.5,-140,7.0,-120,100,-133,-1.5,120,3.21,Marlins Park,3,3
2014-08-12,2014,TEX,TB,3,2,101,1.5,-160,9.0,-115,-105,-111,-1.5,140,4.48,Rangers Ballpark,5,1
2014-08-12,2014,TB,TEX,2,3,-111,-1.5,140,9.0,-115,-105,101,1.5,-160,4.73,Rangers Ballpark,5,-1
2014-08-12,2014,SEA,TOR,6,3,-117,-1.5,160,8.0,103,-123,107,1.5,-190,4.31,T-Mobile Park,9,3
2014-08-12,2014,NYM,WSH,1,7,118,1.5,-145,7.0,-120,100,-128,-1.5,125,3.21,Citi Field,8,-6
2014-08-13,2014,CLE,ARI,3,2,-156,-1.5,140,8.0,-110,-110,141,1.5,-160,4.88,Progressive Field,5,1
2014-08-13,2014,CLE,ARI,0,1,-175,-1.5,110,7.5,105,-125,155,1.5,-130,4.77,Progressive Field,1,-1
2014-08-13,2014,LAD,ATL,2,3,117,1.5,-205,6.5,-115,-105,-127,-1.5,175,3.0,Turner Field,5,-1
2014-08-13,2014,NYY,BAL,3,5,100,1.5,-205,8.0,-105,-115,-110,-1.5,175,4.0,Camden Yards,8,-2
2014-08-13,2014,CIN,BOS,4,5,-132,-1.5,165,7.0,-120,100,117,1.5,-195,3.98,Great American Ballpark,9,-1
2014-08-13,2014,MIL,CHC,2,4,-123,-1.5,135,7.5,-119,-101,113,1.5,-155,4.14,Wrigley Field,6,-2
2014-08-13,2014,BOS,CIN,5,4,117,1.5,-195,7.0,-120,100,-132,-1.5,165,3.23,Great American Ballpark,9,1
2014-08-13,2014,ARI,CLE,2,3,141,1.5,-160,8.0,-110,-110,-156,-1.5,140,3.32,Progressive Field,5,-1
2014-08-13,2014,ARI,CLE,1,0,155,1.5,-130,7.5,105,-125,-175,-1.5,110,2.94,Progressive Field,1,1
2014-08-13,2014,SD,COL,5,3,-150,-1.5,150,6.5,-120,100,135,1.5,-170,3.9,PETCO Park,8,2
2014-08-13,2014,SF,CWS,7,1,-118,-1.5,185,7.0,100,-120,108,1.5,-215,3.79,AT&T Park,8,6
2014-08-13,2014,PIT,DET,4,8,107,1.5,-200,9.0,100,-120,-117,-1.5,170,4.35,Comerica Park,12,-4
2014-08-13,2014,MIN,HOU,3,1,-109,-1.5,150,8.0,100,-120,-101,1.5,-170,4.17,Minute Maid Park,4,2
2014-08-13,2014,OAK,KC,0,3,-104,1.5,-230,7.0,-120,100,-106,-1.5,190,3.57,Kauffman Stadium,3,-3
2014-08-13,2014,PHI,LAA,3,4,170,1.5,-120,8.0,100,-120,-200,-1.5,100,2.96,Angel Stadium,7,-1
2014-08-13,2014,ATL,LAD,3,2,-127,-1.5,175,6.5,-115,-105,117,1.5,-205,3.64,Turner Field,5,1
2014-08-13,2014,STL,MIA,5,2,102,1.5,-205,8.0,-120,100,-112,-1.5,175,3.96,Marlins Park,7,3
2014-08-13,2014,CHC,MIL,4,2,113,1.5,-155,7.5,-119,-101,-123,-1.5,135,3.52,Wrigley Field,6,2
2014-08-13,2014,HOU,MIN,1,3,-101,1.5,-170,8.0,100,-120,-109,-1.5,150,4.02,Minute Maid Park,4,-2
2014-08-13,2014,WSH,NYM,3,2,-115,-1.5,145,7.0,100,-120,105,1.5,-165,3.74,Citi Field,5,1
2014-08-13,2014,BAL,NYY,5,3,-110,-1.5,175,8.0,-105,-115,100,1.5,-205,4.19,Camden Yards,8,2
2014-08-13,2014,KC,OAK,3,0,-106,-1.5,190,7.0,-120,100,-104,1.5,-230,3.6,Kauffman Stadium,3,3
2014-08-13,2014,LAA,PHI,4,3,-200,-1.5,100,8.0,100,-120,170,1.5,-120,5.33,Angel Stadium,7,1
2014-08-13,2014,DET,PIT,8,4,-117,-1.5,170,9.0,100,-120,107,1.5,-200,4.85,Comerica Park,12,4
2014-08-13,2014,COL,SD,3,5,135,1.5,-170,6.5,-120,100,-150,-1.5,150,2.77,PETCO Park,8,-2
2014-08-13,2014,TOR,SEA,0,2,141,1.5,-165,6.5,-110,-110,-156,-1.5,145,2.7,T-Mobile Park,2,-2
2014-08-13,2014,CWS,SF,1,7,108,1.5,-215,7.0,100,-120,-118,-1.5,185,3.37,AT&T Park,8,-6
2014-08-13,2014,MIA,STL,2,5,-112,-1.5,175,8.0,-120,100,102,1.5,-205,4.23,Marlins Park,7,-3
2014-08-13,2014,TEX,TB,1,10,125,1.5,-130,8.5,-120,100,-140,-1.5,110,3.78,Rangers Ballpark,11,-9
2014-08-13,2014,TB,TEX,10,1,-140,-1.5,110,8.5,-120,100,125,1.5,-130,4.96,Rangers Ballpark,11,9
2014-08-13,2014,SEA,TOR,2,0,-156,-1.5,145,6.5,-110,-110,141,1.5,-165,3.96,T-Mobile Park,2,2
2014-08-13,2014,NYM,WSH,2,3,105,1.5,-165,7.0,100,-120,-115,-1.5,145,3.41,Citi Field,5,-1
2014-08-14,2014,MIA,ARI,5,4,-113,-1.5,185,7.5,-110,-110,103,1.5,-215,3.98,Marlins Park,9,1
2014-08-14,2014,LAD,ATL,6,4,119,1.5,-190,7.5,-105,-115,-134,-1.5,160,3.42,Turner Field,10,2
2014-08-14,2014,HOU,BOS,4,9,151,1.5,-140,9.0,-105,-115,-166,-1.5,120,3.59,Fenway Park,13,-5
2014-08-14,2014,MIL,CHC,6,2,-125,-1.5,135,7.0,-105,-115,115,1.5,-155,3.89,Wrigley Field,8,4
2014-08-14,2014,COL,CIN,7,3,-129,-1.5,170,9.0,-120,100,119,1.5,-200,5.07,Coors Field,10,4
2014-08-14,2014,CIN,COL,3,7,119,1.5,-200,9.0,-120,100,-129,-1.5,170,4.11,Coors Field,10,-4
2014-08-14,2014,PIT,DET,2,5,170,1.5,-119,7.5,-119,-101,-200,-1.5,-101,2.78,Comerica Park,7,-3
2014-08-14,2014,BOS,HOU,9,4,-166,-1.5,120,9.0,-105,-115,151,1.5,-140,5.62,Fenway Park,13,5
2014-08-14,2014,OAK,KC,3,7,-105,1.5,-230,7.0,-105,-115,-105,-1.5,190,3.59,Kauffman Stadium,10,-4
2014-08-14,2014,ATL,LAD,4,6,-134,-1.5,160,7.5,-105,-115,119,1.5,-190,4.29,Turner Field,10,-2
2014-08-14,2014,ARI,MIA,4,5,103,1.5,-215,7.5,-110,-110,-113,-1.5,185,3.69,Marlins Park,9,-1
2014-08-14,2014,CHC,MIL,2,6,115,1.5,-155,7.0,-105,-115,-125,-1.5,135,3.26,Wrigley Field,8,-4
2014-08-14,2014,WSH,NYM,4,1,-150,-1.5,110,7.0,110,-130,135,1.5,-130,4.2,Citi Field,5,3
2014-08-14,2014,KC,OAK,7,3,-105,-1.5,190,7.0,-105,-115,-105,1.5,-230,3.59,Kauffman Stadium,10,4
2014-08-14,2014,DET,PIT,5,2,-200,-1.5,-101,7.5,-119,-101,170,1.5,-119,5.0,Comerica Park,7,3
2014-08-14,2014,STL,SD,4,3,-201,-1.5,120,7.5,-101,-119,171,1.5,-140,5.01,Busch Stadium,7,1
2014-08-14,2014,SD,STL,3,4,171,1.5,-140,7.5,-101,-119,-201,-1.5,120,2.77,Busch Stadium,7,-1
2014-08-14,2014,TEX,TB,3,6,113,1.5,-150,8.5,-123,103,-123,-1.5,130,3.99,Rangers Ballpark,9,-3
2014-08-14,2014,TB,TEX,6,3,-123,-1.5,130,8.5,-123,103,113,1.5,-150,4.69,Rangers Ballpark,9,3
2014-08-14,2014,NYM,WSH,1,4,135,1.5,-130,7.0,110,-130,-150,-1.5,110,2.98,Citi Field,5,-3
2014-08-15,2014,MIA,ARI,2,3,-134,-1.5,165,7.0,-120,100,119,1.5,-195,4.01,Marlins Park,5,-1
2014-08-15,2014,OAK,ATL,2,7,127,1.5,-200,7.0,-120,100,-142,-1.5,170,3.08,Turner Field,9,-5
2014-08-15,2014,CLE,BAL,2,1,-154,-1.5,140,6.5,-126,106,139,1.5,-160,3.94,Progressive Field,3,1
2014-08-15,2014,HOU,BOS,5,3,138,1.5,-165,8.0,-110,-110,-153,-1.5,145,3.36,Fenway Park,8,2
2014-08-15,2014,NYM,CHC,3,2,-152,-1.5,150,7.0,-120,100,137,1.5,-170,4.22,Citi Field,5,1
2014-08-15,2014,COL,CIN,2,3,134,1.5,-119,9.0,100,-120,-149,-1.5,-101,3.85,Coors Field,5,-1
2014-08-15,2014,BAL,CLE,1,2,139,1.5,-160,6.5,-126,106,-154,-1.5,140,2.72,Progressive Field,3,-1
2014-08-15,2014,CIN,COL,3,2,-149,-1.5,-101,9.0,100,-120,134,1.5,-119,5.39,Coors Field,5,1
2014-08-15,2014,TOR,CWS,5,11,-144,-1.5,105,9.0,103,-123,129,1.5,-125,5.31,Guaranteed Rate Field,16,-6
2014-08-15,2014,SEA,DET,7,2,119,1.5,-190,8.5,-109,-111,-129,-1.5,160,3.88,Comerica Park,9,5
2014-08-15,2014,BOS,HOU,3,5,-153,-1.5,145,8.0,-110,-110,138,1.5,-165,4.84,Fenway Park,8,-2
2014-08-15,2014,MIN,KC,5,6,127,1.5,-130,8.0,-105,-115,-142,-1.5,110,3.52,Target Field,11,-1
2014-08-15,2014,TEX,LAA,4,5,175,1.5,125,9.5,-115,-105,-195,-1.5,-145,3.45,Rangers Ballpark,9,-1
2014-08-15,2014,MIL,LAD,6,3,161,1.5,-150,6.5,-125,105,-181,-1.5,130,2.49,Dodger Stadium,9,3
2014-08-15,2014,ARI,MIA,3,2,119,1.5,-195,7.0,-120,100,-134,-1.5,165,3.2,Marlins Park,5,1
2014-08-15,2014,LAD,MIL,3,6,-181,-1.5,130,6.5,-125,105,161,1.5,-150,4.19,Dodger Stadium,9,-3
2014-08-15,2014,KC,MIN,6,5,-142,-1.5,110,8.0,-105,-115,127,1.5,-130,4.69,Target Field,11,1
2014-08-15,2014,CHC,NYM,2,3,137,1.5,-170,7.0,-120,100,-152,-1.5,150,2.95,Citi Field,5,-1
2014-08-15,2014,TB,NYY,5,0,-126,-1.5,170,6.5,-125,105,116,1.5,-200,3.62,Tropicana Field,5,5
2014-08-15,2014,ATL,OAK,7,2,-142,-1.5,170,7.0,-120,100,127,1.5,-200,4.11,Turner Field,9,5
2014-08-15,2014,SF,PHI,3,5,-152,-1.5,160,5.5,-105,-115,137,1.5,-190,3.32,AT&T Park,8,-2
2014-08-15,2014,WSH,PIT,5,4,-156,-1.5,140,7.5,-101,-119,141,1.5,-160,4.57,Nationals Park,9,1
2014-08-15,2014,STL,SD,4,2,-140,-1.5,170,7.0,110,-130,125,1.5,-200,4.08,Busch Stadium,6,2
2014-08-15,2014,DET,SEA,2,7,-129,-1.5,160,8.5,-109,-111,119,1.5,-190,4.79,Comerica Park,9,-5
2014-08-15,2014,PHI,SF,5,3,137,1.5,-190,5.5,-105,-115,-152,-1.5,160,2.32,AT&T Park,8,2
2014-08-15,2014,SD,STL,2,4,125,1.5,-200,7.0,110,-130,-140,-1.5,170,3.11,Busch Stadium,6,-2
2014-08-15,2014,NYY,TB,0,5,116,1.5,-200,6.5,-125,105,-126,-1.5,170,3.01,Tropicana Field,5,-5
2014-08-15,2014,LAA,TEX,5,4,-195,-1.5,-145,9.5,-115,-105,175,1.5,125,6.28,Rangers Ballpark,9,1
2014-08-15,2014,CWS,TOR,11,5,129,1.5,-125,9.0,103,-123,-144,-1.5,105,3.93,Guaranteed Rate Field,16,6
2014-08-15,2014,PIT,WSH,4,5,141,1.5,-160,7.5,-101,-119,-156,-1.5,140,3.11,Nationals Park,9,-1
2014-08-16,2014,MIA,ARI,2,1,-146,-1.5,149,7.0,100,-120,131,1.5,-169,4.15,Marlins Park,3,1
2014-08-16,2014,OAK,ATL,3,4,-111,-1.5,150,7.0,-115,-105,101,1.5,-170,3.68,Turner Field,7,-1
2014-08-16,2014,CLE,BAL,6,0,-149,-1.5,150,8.0,-110,-110,134,1.5,-170,4.79,Progressive Field,6,6
2014-08-16,2014,HOU,BOS,7,10,161,1.5,-130,9.0,-125,105,-181,-1.5,110,3.45,Fenway Park,17,-3
2014-08-16,2014,NYM,CHC,7,3,-140,-1.5,145,7.0,-125,105,125,1.5,-165,4.08,Citi Field,10,4
2014-08-16,2014,BAL,CLE,0,6,134,1.5,-170,8.0,-110,-110,-149,-1.5,150,3.42,Progressive Field,6,-6
2014-08-16,2014,TOR,CWS,6,3,-139,-1.5,110,9.5,-109,-111,124,1.5,-130,5.53,Guaranteed Rate Field,9,3
2014-08-16,2014,SEA,DET,2,4,-108,-1.5,155,6.5,-113,-107,-102,1.5,-175,3.38,Comerica Park,6,-2
2014-08-16,2014,BOS,HOU,10,7,-181,-1.5,110,9.0,-125,105,161,1.5,-130,5.8,Fenway Park,17,3
2014-08-16,2014,MIN,KC,4,1,101,1.5,-165,7.5,-109,-111,-111,-1.5,145,3.73,Target Field,5,3
2014-08-16,2014,TEX,LAA,4,5,140,1.5,-120,9.5,-115,-105,-155,-1.5,100,3.96,Rangers Ballpark,9,-1
2014-08-16,2014,MIL,LAD,3,2,170,1.5,-135,6.0,-115,-105,-200,-1.5,115,2.22,Dodger Stadium,5,1
2014-08-16,2014,ARI,MIA,1,2,131,1.5,-169,7.0,100,-120,-146,-1.5,149,3.03,Marlins Park,3,-1
2014-08-16,2014,LAD,MIL,2,3,-200,-1.5,115,6.0,-115,-105,170,1.5,-135,4.0,Dodger Stadium,5,-1
2014-08-16,2014,KC,MIN,1,4,-111,-1.5,145,7.5,-109,-111,101,1.5,-165,3.95,Target Field,5,-3
2014-08-16,2014,CHC,NYM,3,7,125,1.5,-165,7.0,-125,105,-140,-1.5,145,3.11,Citi Field,10,-4
2014-08-16,2014,TB,NYY,2,3,-145,-1.5,150,7.0,110,-130,130,1.5,-170,4.14,Tropicana Field,5,-1
2014-08-16,2014,ATL,OAK,4,3,101,1.5,-170,7.0,-115,-105,-111,-1.5,150,3.48,Turner Field,7,1
2014-08-16,2014,SF,PHI,6,5,-205,-1.5,105,7.5,100,-120,175,1.5,-125,5.04,AT&T Park,11,1
2014-08-16,2014,WSH,PIT,4,3,-151,-1.5,141,7.5,-103,-117,136,1.5,-161,4.51,Nationals Park,7,1
2014-08-16,2014,STL,SD,5,9,-130,-1.5,170,7.5,103,-123,115,1.5,-200,4.24,Busch Stadium,14,-4
2014-08-16,2014,DET,SEA,4,2,-102,1.5,-175,6.5,-113,-107,-108,-1.5,155,3.28,Comerica Park,6,2
2014-08-16,2014,PHI,SF,5,6,175,1.5,-125,7.5,100,-120,-205,-1.5,105,2.73,AT&T Park,11,-1
2014-08-16,2014,SD,STL,9,5,115,1.5,-200,7.5,103,-123,-130,-1.5,170,3.49,Busch Stadium,14,4
2014-08-16,2014,NYY,TB,3,2,130,1.5,-170,7.0,110,-130,-145,-1.5,150,3.04,Tropicana Field,5,1
2014-08-16,2014,LAA,TEX,5,4,-155,-1.5,100,9.5,-115,-105,140,1.5,-120,5.77,Rangers Ballpark,9,1
2014-08-16,2014,CWS,TOR,3,6,124,1.5,-130,9.5,-109,-111,-139,-1.5,110,4.24,Guaranteed Rate Field,9,-3
2014-08-16,2014,PIT,WSH,3,4,136,1.5,-161,7.5,-103,-117,-151,-1.5,141,3.18,Nationals Park,7,-1
2014-08-17,2014,MIA,ARI,10,3,-145,-1.5,150,7.0,-115,-105,130,1.5,-170,4.14,Marlins Park,13,7
2014-08-17,2014,OAK,ATL,3,4,-140,-1.5,120,7.0,110,-130,125,1.5,-140,4.08,Turner Field,7,-1
2014-08-17,2014,CLE,BAL,1,4,-128,-1.5,165,8.0,100,-120,118,1.5,-195,4.49,Progressive Field,5,-3
2014-08-17,2014,HOU,BOS,8,1,113,1.5,-190,9.0,-105,-115,-123,-1.5,160,4.23,Fenway Park,9,7
2014-08-17,2014,NYM,CHC,1,2,103,1.5,-175,7.0,-102,-118,-113,-1.5,155,3.45,Citi Field,3,-1
2014-08-17,2014,COL,CIN,10,9,-106,1.5,-160,9.5,-115,-105,-104,-1.5,140,4.89,Coors Field,19,1
2014-08-17,2014,COL,CIN,10,5,-135,-1.5,160,10.5,100,-120,120,1.5,-190,6.03,Coors Field,15,5
2014-08-17,2014,BAL,CLE,4,1,118,1.5,-195,8.0,100,-120,-128,-1.5,165,3.67,Progressive Field,5,3
2014-08-17,2014,CIN,COL,9,10,-104,-1.5,140,9.5,-115,-105,-106,1.5,-160,4.84,Coors Field,19,-1
2014-08-17,2014,CIN,COL,5,10,120,1.5,-190,10.5,100,-120,-135,-1.5,160,4.77,Coors Field,15,-5
2014-08-17,2014,TOR,CWS,5,7,-140,-1.5,115,9.5,-110,-110,125,1.5,-135,5.54,Guaranteed Rate Field,12,-2
2014-08-17,2014,SEA,DET,8,1,107,1.5,-195,8.5,-125,105,-117,-1.5,165,4.11,Comerica Park,9,7
2014-08-17,2014,BOS,HOU,1,8,-123,-1.5,160,9.0,-105,-115,113,1.5,-190,4.96,Fenway Park,9,-7
2014-08-17,2014,MIN,KC,6,12,-103,1.5,-170,8.0,-115,-105,-107,-1.5,150,4.06,Target Field,18,-6
2014-08-17,2014,TEX,LAA,3,2,125,1.5,-130,9.5,-110,-110,-140,-1.5,110,4.22,Rangers Ballpark,5,1
2014-08-17,2014,MIL,LAD,7,2,-105,1.5,-240,7.5,-120,100,-105,-1.5,200,3.84,Dodger Stadium,9,5
2014-08-17,2014,ARI,MIA,3,10,130,1.5,-170,7.0,-115,-105,-145,-1.5,150,3.04,Marlins Park,13,-7
2014-08-17,2014,LAD,MIL,2,7,-105,-1.5,200,7.5,-120,100,-105,1.5,-240,3.84,Dodger Stadium,9,-5
2014-08-17,2014,KC,MIN,12,6,-107,-1.5,150,8.0,-115,-105,-103,1.5,-170,4.14,Target Field,18,6
2014-08-17,2014,CHC,NYM,2,1,-113,-1.5,155,7.0,-102,-118,103,1.5,-175,3.71,Citi Field,3,1
2014-08-17,2014,TB,NYY,2,4,-108,-1.5,190,7.0,-120,100,-102,1.5,-230,3.63,Tropicana Field,6,-2
2014-08-17,2014,ATL,OAK,4,3,125,1.5,-140,7.0,110,-130,-140,-1.5,120,3.11,Turner Field,7,1
2014-08-17,2014,SF,PHI,5,2,-150,-1.5,143,7.5,-101,-119,135,1.5,-163,4.5,AT&T Park,7,3
2014-08-17,2014,WSH,PIT,6,5,-155,-1.5,135,8.0,-105,-115,140,1.5,-155,4.86,Nationals Park,11,1
2014-08-17,2014,STL,SD,7,6,-215,-1.5,105,7.0,-110,-110,185,1.5,-125,4.78,Busch Stadium,13,1
2014-08-17,2014,DET,SEA,1,8,-117,-1.5,165,8.5,-125,105,107,1.5,-195,4.58,Comerica Park,9,-7
2014-08-17,2014,PHI,SF,2,5,135,1.5,-163,7.5,-101,-119,-150,-1.5,143,3.19,AT&T Park,7,-3
2014-08-17,2014,SD,STL,6,7,185,1.5,-125,7.0,-110,-110,-215,-1.5,105,2.46,Busch Stadium,13,-1
2014-08-17,2014,NYY,TB,4,2,-102,1.5,-230,7.0,-120,100,-108,-1.5,190,3.53,Tropicana Field,6,2
2014-08-17,2014,LAA,TEX,2,3,-140,-1.5,110,9.5,-110,-110,125,1.5,-130,5.54,Rangers Ballpark,5,-1
2014-08-17,2014,CWS,TOR,7,5,125,1.5,-135,9.5,-110,-110,-140,-1.5,115,4.22,Guaranteed Rate Field,12,2
2014-08-17,2014,PIT,WSH,5,6,140,1.5,-155,8.0,-105,-115,-155,-1.5,135,3.33,Nationals Park,11,-1
2014-08-18,2014,WSH,ARI,5,4,-260,-1.5,-130,7.0,-120,100,220,1.5,110,5.06,Nationals Park,9,1
2014-08-18,2014,PIT,ATL,3,7,-101,1.5,-170,7.5,100,-120,-109,-1.5,150,3.77,PNC Park,10,-4
2014-08-18,2014,CWS,BAL,2,8,-158,-1.5,130,7.5,105,-125,143,1.5,-150,4.59,Guaranteed Rate Field,10,-6
2014-08-18,2014,LAA,BOS,4,2,102,1.5,-210,10.0,100,-120,-112,-1.5,180,4.95,Fenway Park,6,2
2014-08-18,2014,NYM,CHC,1,4,-112,-1.5,185,7.0,-110,-110,102,1.5,-215,3.7,Citi Field,5,-3
2014-08-18,2014,STL,CIN,6,5,-127,-1.5,170,8.0,-120,100,117,1.5,-200,4.48,Busch Stadium,11,1
2014-08-18,2014,BAL,CWS,8,2,143,1.5,-150,7.5,105,-125,-158,-1.5,130,3.09,Guaranteed Rate Field,10,6
2014-08-18,2014,MIN,KC,4,6,147,1.5,-119,8.0,-120,100,-162,-1.5,-101,3.24,Target Field,10,-2
2014-08-18,2014,BOS,LAA,2,4,-112,-1.5,180,10.0,100,-120,102,1.5,-210,5.28,Fenway Park,6,-2
2014-08-18,2014,KC,MIN,6,4,-162,-1.5,-101,8.0,-120,100,147,1.5,-119,4.95,Target Field,10,2
2014-08-18,2014,CHC,NYM,4,1,102,1.5,-215,7.0,-110,-110,-112,-1.5,185,3.47,Citi Field,5,3
2014-08-18,2014,SEA,PHI,1,4,-145,-1.5,105,8.5,100,-120,130,1.5,-125,5.03,Citizens Bank Park,5,-3
2014-08-18,2014,ATL,PIT,7,3,-109,-1.5,150,7.5,100,-120,-101,1.5,-170,3.91,PNC Park,10,4
2014-08-18,2014,PHI,SEA,4,1,130,1.5,-125,8.5,100,-120,-145,-1.5,105,3.7,Citizens Bank Park,5,3
2014-08-18,2014,CIN,STL,5,6,117,1.5,-200,8.0,-120,100,-127,-1.5,170,3.69,Busch Stadium,11,-1
2014-08-18,2014,ARI,WSH,4,5,220,1.5,110,7.0,-120,100,-260,-1.5,-130,2.19,Nationals Park,9,-1
2014-08-19,2014,WSH,ARI,8,1,-230,-1.5,-110,7.0,-110,-110,200,1.5,-110,4.88,Nationals Park,9,7
2014-08-19,2014,PIT,ATL,3,11,-164,-1.5,125,7.5,-110,-110,149,1.5,-145,4.66,PNC Park,14,-8
2014-08-19,2014,CWS,BAL,1,5,-110,-1.5,185,8.5,-120,100,100,1.5,-215,4.45,Guaranteed Rate Field,6,-4
2014-08-19,2014,LAA,BOS,4,3,-125,-1.5,125,9.5,100,-120,115,1.5,-145,5.28,Fenway Park,7,1
2014-08-19,2014,SF,CHC,1,2,-110,-1.5,150,8.5,-120,100,100,1.5,-170,4.45,Wrigley Field,3,-1
2014-08-19,2014,STL,CIN,5,4,-170,-1.5,130,8.0,100,-120,150,1.5,-150,5.04,Busch Stadium,9,1
2014-08-19,2014,MIN,CLE,5,7,100,1.5,-165,8.5,-120,100,-110,-1.5,145,4.25,Target Field,12,-2
2014-08-19,2014,KC,COL,7,4,-145,-1.5,115,9.5,-120,100,130,1.5,-135,5.62,Coors Field,11,3
2014-08-19,2014,BAL,CWS,5,1,100,1.5,-215,8.5,-120,100,-110,-1.5,185,4.25,Guaranteed Rate Field,6,4
2014-08-19,2014,TB,DET,6,8,103,1.5,-165,6.5,-104,-116,-113,-1.5,145,3.2,Tropicana Field,14,-2
2014-08-19,2014,NYY,HOU,4,7,-168,-1.5,120,8.5,-105,-115,153,1.5,-140,5.33,Yankee Stadium,11,-3
2014-08-19,2014,COL,KC,4,7,130,1.5,-135,9.5,-120,100,-145,-1.5,115,4.13,Coors Field,11,-3
2014-08-19,2014,BOS,LAA,3,4,115,1.5,-145,9.5,100,-120,-125,-1.5,125,4.42,Fenway Park,7,-1
2014-08-19,2014,SD,LAD,6,8,-105,1.5,-235,7.0,-107,-113,-105,-1.5,195,3.59,Dodger Stadium,14,-2
2014-08-19,2014,TEX,MIA,3,4,126,1.5,-175,8.0,100,-120,-141,-1.5,155,3.54,Marlins Park,7,-1
2014-08-19,2014,TOR,MIL,1,6,135,1.5,-160,9.0,100,-120,-150,-1.5,140,3.83,Miller Park,7,-5
2014-08-19,2014,CLE,MIN,7,5,-110,-1.5,145,8.5,-120,100,100,1.5,-165,4.45,Target Field,12,2
2014-08-19,2014,OAK,NYM,6,2,-240,-1.5,-110,7.0,-125,105,200,1.5,-110,4.94,Oakland Coliseum,8,4
2014-08-19,2014,HOU,NYY,7,4,153,1.5,-140,8.5,-105,-115,-168,-1.5,120,3.36,Yankee Stadium,11,3
2014-08-19,2014,NYM,OAK,2,6,200,1.5,-110,7.0,-125,105,-240,-1.5,-110,2.33,Oakland Coliseum,8,-4
2014-08-19,2014,SEA,PHI,5,2,-154,-1.5,100,7.5,100,-120,139,1.5,-120,4.55,Citizens Bank Park,7,3
2014-08-19,2014,ATL,PIT,11,3,149,1.5,-145,7.5,-110,-110,-164,-1.5,125,3.01,PNC Park,14,8
2014-08-19,2014,LAD,SD,8,6,-105,-1.5,195,7.0,-107,-113,-105,1.5,-235,3.59,Dodger Stadium,14,2
2014-08-19,2014,PHI,SEA,2,5,139,1.5,-120,7.5,100,-120,-154,-1.5,100,3.14,Citizens Bank Park,7,-3
2014-08-19,2014,CHC,SF,2,1,100,1.5,-170,8.5,-120,100,-110,-1.5,150,4.25,Wrigley Field,3,1
2014-08-19,2014,CIN,STL,4,5,150,1.5,-150,8.0,100,-120,-170,-1.5,130,3.2,Busch Stadium,9,-1
2014-08-19,2014,DET,TB,8,6,-113,-1.5,145,6.5,-104,-116,103,1.5,-165,3.45,Tropicana Field,14,2
2014-08-19,2014,MIA,TEX,4,3,-141,-1.5,155,8.0,100,-120,126,1.5,-175,4.68,Marlins Park,7,1
2014-08-19,2014,MIL,TOR,6,1,-150,-1.5,140,9.0,100,-120,135,1.5,-160,5.4,Miller Park,7,5
2014-08-19,2014,ARI,WSH,1,8,200,1.5,-110,7.0,-110,-110,-230,-1.5,-110,2.33,Nationals Park,9,-7
2014-08-20,2014,WSH,ARI,3,2,-178,-1.5,125,7.0,-130,110,158,1.5,-145,4.48,Nationals Park,5,1
2014-08-20,2014,PIT,ATL,3,2,-114,-1.5,185,7.0,-126,106,104,1.5,-215,3.73,PNC Park,5,1
2014-08-20,2014,CWS,BAL,3,4,140,1.5,-120,8.5,-120,100,-155,-1.5,100,3.54,Guaranteed Rate Field,7,-1
2014-08-20,2014,LAA,BOS,8,3,-125,-1.5,120,8.5,-110,-110,115,1.5,-140,4.72,Fenway Park,11,5
2014-08-20,2014,SF,CHC,8,3,-129,-1.5,125,8.5,-124,104,119,1.5,-145,4.79,Wrigley Field,11,5
2014-08-20,2014,STL,CIN,7,3,-105,-1.5,195,6.5,-115,-105,-105,1.5,-235,3.33,Busch Stadium,10,4
2014-08-20,2014,MIN,CLE,0,5,101,1.5,-165,8.5,-110,-110,-111,-1.5,145,4.23,Target Field,5,-5
2014-08-20,2014,KC,COL,2,5,-110,-1.5,140,9.5,-105,-115,100,1.5,-160,4.98,Coors Field,7,-3
2014-08-20,2014,BAL,CWS,4,3,-155,-1.5,100,8.5,-120,100,140,1.5,-120,5.17,Guaranteed Rate Field,7,1
2014-08-20,2014,TB,DET,0,6,-128,-1.5,170,7.0,-115,-105,118,1.5,-200,3.93,Tropicana Field,6,-6
2014-08-20,2014,NYY,HOU,2,5,-215,-1.5,-110,8.5,-115,-105,185,1.5,-110,5.8,Yankee Stadium,7,-3
2014-08-20,2014,COL,KC,5,2,100,1.5,-160,9.5,-105,-115,-110,-1.5,140,4.75,Coors Field,7,3
2014-08-20,2014,BOS,LAA,3,8,115,1.5,-140,8.5,-110,-110,-125,-1.5,120,3.95,Fenway Park,11,-5
2014-08-20,2014,SD,LAD,4,1,122,1.5,-190,7.5,-110,-110,-137,-1.5,160,3.38,Dodger Stadium,5,3
2014-08-20,2014,TEX,MIA,5,4,133,1.5,-150,7.5,-105,-115,-148,-1.5,130,3.22,Marlins Park,9,1
2014-08-20,2014,TOR,MIL,9,5,109,1.5,-205,8.5,-118,-102,-119,-1.5,175,4.07,Miller Park,14,4
2014-08-20,2014,CLE,MIN,5,0,-111,-1.5,145,8.5,-110,-110,101,1.5,-165,4.47,Target Field,5,5
2014-08-20,2014,OAK,NYM,5,8,-190,-1.5,120,7.0,-130,110,170,1.5,-140,4.59,Oakland Coliseum,13,-3
2014-08-20,2014,HOU,NYY,5,2,185,1.5,-110,8.5,-115,-105,-215,-1.5,-110,2.98,Yankee Stadium,7,3
2014-08-20,2014,NYM,OAK,8,5,170,1.5,-140,7.0,-130,110,-190,-1.5,120,2.59,Oakland Coliseum,13,3
2014-08-20,2014,SEA,PHI,3,4,111,1.5,-209,6.5,-110,-110,-121,-1.5,179,3.08,Citizens Bank Park,7,-1
2014-08-20,2014,ATL,PIT,2,3,104,1.5,-215,7.0,-126,106,-114,-1.5,185,3.43,PNC Park,5,-1
2014-08-20,2014,LAD,SD,1,4,-137,-1.5,160,7.5,-110,-110,122,1.5,-190,4.34,Dodger Stadium,5,-3
2014-08-20,2014,PHI,SEA,4,3,-121,-1.5,179,6.5,-110,-110,111,1.5,-209,3.56,Citizens Bank Park,7,1
2014-08-20,2014,CHC,SF,3,8,119,1.5,-145,8.5,-124,104,-129,-1.5,125,3.88,Wrigley Field,11,-5
2014-08-20,2014,CIN,STL,3,7,-105,1.5,-235,6.5,-115,-105,-105,-1.5,195,3.33,Busch Stadium,10,-4
2014-08-20,2014,DET,TB,6,0,118,1.5,-200,7.0,-115,-105,-128,-1.5,170,3.21,Tropicana Field,6,6
2014-08-20,2014,MIA,TEX,4,5,-148,-1.5,130,7.5,-105,-115,133,1.5,-150,4.48,Marlins Park,9,-1
2014-08-20,2014,MIL,TOR,5,9,-119,-1.5,175,8.5,-118,-102,109,1.5,-205,4.62,Miller Park,14,-4
2014-08-20,2014,ARI,WSH,2,3,158,1.5,-145,7.0,-130,110,-178,-1.5,125,2.71,Nationals Park,5,-1
2014-08-21,2014,WSH,ARI,1,0,-204,-1.5,125,7.5,-110,-110,174,1.5,-145,5.03,Nationals Park,1,1
2014-08-21,2014,CIN,ATL,0,8,164,1.5,-115,8.0,-110,-110,-184,-1.5,-105,3.03,Great American Ballpark,8,-8
2014-08-21,2014,LAA,BOS,2,0,-130,-1.5,114,9.0,-110,-110,115,1.5,-133,5.09,Fenway Park,2,2
2014-08-21,2014,SF,CHC,5,3,-171,-1.5,100,8.5,100,-120,151,1.5,-120,5.36,Wrigley Field,8,2
2014-08-21,2014,ATL,CIN,8,0,-184,-1.5,-105,8.0,-110,-110,164,1.5,-115,5.18,Great American Ballpark,8,8
2014-08-21,2014,MIN,CLE,4,1,125,1.5,-140,7.0,-125,105,-140,-1.5,120,3.11,Target Field,5,3
2014-08-21,2014,TB,DET,1,0,-109,-1.5,190,6.5,100,-120,-101,1.5,-230,3.39,Tropicana Field,1,1
2014-08-21,2014,NYY,HOU,3,0,-171,-1.5,125,7.5,-110,-110,151,1.5,-145,4.73,Yankee Stadium,3,3
2014-08-21,2014,BOS,LAA,0,2,115,1.5,-133,9.0,-110,-110,-130,-1.5,114,4.19,Fenway Park,2,-2
2014-08-21,2014,SD,LAD,1,2,205,1.5,-114,5.5,-110,-110,-245,-1.5,-106,1.8,Dodger Stadium,3,-1
2014-08-21,2014,CLE,MIN,1,4,-140,-1.5,120,7.0,-125,105,125,1.5,-140,4.08,Target Field,5,-3
2014-08-21,2014,HOU,NYY,0,3,151,1.5,-145,7.5,-110,-110,-171,-1.5,125,2.99,Yankee Stadium,3,-3
2014-08-21,2014,LAD,SD,2,1,-245,-1.5,-106,5.5,-110,-110,205,1.5,-114,3.91,Dodger Stadium,3,1
2014-08-21,2014,CHC,SF,3,5,151,1.5,-120,8.5,100,-120,-171,-1.5,100,3.39,Wrigley Field,8,-2
2014-08-21,2014,DET,TB,0,1,-101,1.5,-230,6.5,100,-120,-109,-1.5,190,3.27,Tropicana Field,1,-1
2014-08-21,2014,ARI,WSH,0,1,174,1.5,-145,7.5,-110,-110,-204,-1.5,125,2.74,Nationals Park,1,-1
2014-08-22,2014,SD,ARI,1,5,110,1.5,-205,8.5,100,-120,-120,-1.5,175,4.05,Chase Field,6,-4
2014-08-22,2014,CIN,ATL,1,3,-108,-1.5,186,7.5,-110,-110,-102,1.5,-217,3.89,Great American Ballpark,4,-2
2014-08-22,2014,CHC,BAL,4,1,-107,-1.5,185,7.5,100,-120,-103,1.5,-215,3.88,Wrigley Field,5,3
2014-08-22,2014,SEA,BOS,5,3,-180,-1.5,-119,7.5,-110,-110,160,1.5,-101,4.82,Fenway Park,8,2
2014-08-22,2014,BAL,CHC,1,4,-103,1.5,-215,7.5,100,-120,-107,-1.5,185,3.81,Wrigley Field,5,-3
2014-08-22,2014,ATL,CIN,3,1,-102,1.5,-217,7.5,-110,-110,-108,-1.5,186,3.79,Great American Ballpark,4,2
2014-08-22,2014,HOU,CLE,5,1,188,1.5,-110,8.5,-103,-117,-218,-1.5,-110,2.95,Progressive Field,6,4
2014-08-22,2014,MIA,COL,13,5,-120,-1.5,125,10.5,-110,-110,110,1.5,-145,5.73,Coors Field,18,8
2014-08-22,2014,NYY,CWS,4,3,-191,-1.5,110,8.0,-120,100,171,1.5,-130,5.25,Yankee Stadium,7,1
2014-08-22,2014,MIN,DET,20,6,-105,-1.5,185,9.0,-120,100,-105,1.5,-215,4.61,Target Field,26,14
2014-08-22,2014,CLE,HOU,1,5,-218,-1.5,-110,8.5,-103,-117,188,1.5,-110,5.83,Progressive Field,6,-4
2014-08-22,2014,TEX,KC,3,6,115,1.5,-145,9.0,-110,-110,-130,-1.5,125,4.19,Rangers Ballpark,9,-3
2014-08-22,2014,OAK,LAA,5,3,-150,-1.5,145,7.5,110,-130,135,1.5,-165,4.5,Oakland Coliseum,8,2
2014-08-22,2014,NYM,LAD,2,6,118,1.5,-200,7.5,-107,-113,-128,-1.5,170,3.44,Dodger Stadium,8,-4
2014-08-22,2014,COL,MIA,5,13,110,1.5,-145,10.5,-110,-110,-120,-1.5,125,5.0,Coors Field,18,-8
2014-08-22,2014,PIT,MIL,8,3,138,1.5,-165,8.5,-125,105,-153,-1.5,145,3.57,Miller Park,11,5
2014-08-22,2014,DET,MIN,6,20,-105,1.5,-215,9.0,-120,100,-105,-1.5,185,4.61,Target Field,26,-14
2014-08-22,2014,LAD,NYM,6,2,-128,-1.5,170,7.5,-107,-113,118,1.5,-200,4.21,Dodger Stadium,8,4
2014-08-22,2014,CWS,NYY,3,4,171,1.5,-130,8.0,-120,100,-191,-1.5,110,2.95,Yankee Stadium,7,-1
2014-08-22,2014,LAA,OAK,3,5,135,1.5,-165,7.5,110,-130,-150,-1.5,145,3.19,Oakland Coliseum,8,-2
2014-08-22,2014,STL,PHI,4,5,-162,-1.5,100,7.5,-120,100,147,1.5,-120,4.64,Citizens Bank Park,9,-1
2014-08-22,2014,MIL,PIT,3,8,-153,-1.5,145,8.5,-125,105,138,1.5,-165,5.14,Miller Park,11,-5
2014-08-22,2014,ARI,SD,5,1,-120,-1.5,175,8.5,100,-120,110,1.5,-205,4.64,Chase Field,6,4
2014-08-22,2014,BOS,SEA,3,5,160,1.5,-101,7.5,-110,-110,-180,-1.5,-119,2.88,Fenway Park,8,-2
2014-08-22,2014,WSH,SF,3,10,-147,-1.5,150,7.0,-130,110,132,1.5,-170,4.17,Nationals Park,13,-7
2014-08-22,2014,PHI,STL,5,4,147,1.5,-120,7.5,-120,100,-162,-1.5,100,3.04,Citizens Bank Park,9,1
2014-08-22,2014,TOR,TB,0,8,-119,-1.5,175,8.5,-119,-101,109,1.5,-205,4.62,Rogers Centre,8,-8
2014-08-22,2014,KC,TEX,6,3,-130,-1.5,125,9.0,-110,-110,115,1.5,-145,5.09,Rangers Ballpark,9,3
2014-08-22,2014,TB,TOR,8,0,109,1.5,-205,8.5,-119,-101,-119,-1.5,175,4.07,Rogers Centre,8,8
2014-08-22,2014,SF,WSH,10,3,132,1.5,-170,7.0,-130,110,-147,-1.5,150,3.02,Nationals Park,13,7
2014-08-23,2014,SD,ARI,2,5,-113,-1.5,145,7.5,-103,-117,103,1.5,-165,3.98,Chase Field,7,-3
2014-08-23,2014,CIN,ATL,1,0,115,1.5,-150,7.5,-101,-119,-125,-1.5,130,3.49,Great American Ballpark,1,1
2014-08-23,2014,CHC,BAL,7,2,100,1.5,-170,7.0,-115,-105,-110,-1.5,150,3.5,Wrigley Field,9,5
2014-08-23,2014,SEA,BOS,7,3,115,1.5,-190,8.5,-110,-110,-125,-1.5,160,3.95,Fenway Park,10,4
2014-08-23,2014,BAL,CHC,2,7,-110,-1.5,150,7.0,-115,-105,100,1.5,-170,3.67,Wrigley Field,9,-5
2014-08-23,2014,ATL,CIN,0,1,-125,-1.5,130,7.5,-101,-119,115,1.5,-150,4.17,Great American Ballpark,1,-1
2014-08-23,2014,HOU,CLE,2,3,131,1.5,-160,7.5,102,-122,-146,-1.5,141,3.25,Progressive Field,5,-1
2014-08-23,2014,MIA,COL,4,5,-101,1.5,-200,10.5,-110,-110,-109,-1.5,170,5.28,Coors Field,9,-1
2014-08-23,2014,NYY,CWS,5,3,-235,-1.5,-110,9.0,100,-120,205,1.5,-110,6.31,Yankee Stadium,8,2
2014-08-23,2014,MIN,DET,12,4,-116,-1.5,170,9.0,-120,100,106,1.5,-200,4.83,Target Field,16,8
2014-08-23,2014,MIN,DET,6,8,116,1.5,-135,9.0,-105,-115,-131,-1.5,115,4.17,Target Field,14,-2
2014-08-23,2014,CLE,HOU,3,2,-146,-1.5,141,7.5,102,-122,131,1.5,-160,4.45,Progressive Field,5,1
2014-08-23,2014,TEX,KC,3,6,110,1.5,-150,9.0,-120,100,-120,-1.5,130,4.29,Rangers Ballpark,9,-3
2014-08-23,2014,OAK,LAA,2,1,-170,-1.5,130,7.0,-125,105,150,1.5,-150,4.41,Oakland Coliseum,3,1
2014-08-23,2014,NYM,LAD,4,7,142,1.5,-175,6.5,100,-120,-157,-1.5,155,2.69,Dodger Stadium,11,-3
2014-08-23,2014,COL,MIA,5,4,-109,-1.5,170,10.5,-110,-110,-101,1.5,-200,5.48,Coors Field,9,1
2014-08-23,2014,PIT,MIL,10,2,115,1.5,-200,8.5,-118,-102,-125,-1.5,170,3.95,Miller Park,12,8
2014-08-23,2014,DET,MIN,4,12,106,1.5,-200,9.0,-120,100,-116,-1.5,170,4.37,Target Field,16,-8
2014-08-23,2014,DET,MIN,8,6,-131,-1.5,115,9.0,-105,-115,116,1.5,-135,5.1,Target Field,14,2
2014-08-23,2014,LAD,NYM,7,4,-157,-1.5,155,6.5,100,-120,142,1.5,-175,3.97,Dodger Stadium,11,3
2014-08-23,2014,CWS,NYY,3,5,205,1.5,-110,9.0,100,-120,-235,-1.5,-110,2.95,Yankee Stadium,8,-2
2014-08-23,2014,LAA,OAK,1,2,150,1.5,-150,7.0,-125,105,-170,-1.5,130,2.8,Oakland Coliseum,3,-1
2014-08-23,2014,STL,PHI,6,5,-116,-1.5,145,8.0,-110,-110,106,1.5,-165,4.3,Citizens Bank Park,11,1
2014-08-23,2014,MIL,PIT,2,10,-125,-1.5,170,8.5,-118,-102,115,1.5,-200,4.72,Miller Park,12,-8
2014-08-23,2014,ARI,SD,5,2,103,1.5,-165,7.5,-103,-117,-113,-1.5,145,3.69,Chase Field,7,3
2014-08-23,2014,BOS,SEA,3,7,-125,-1.5,160,8.5,-110,-110,115,1.5,-190,4.72,Fenway Park,10,-4
2014-08-23,2014,WSH,SF,6,2,-191,-1.5,115,7.5,100,-120,171,1.5,-135,4.92,Nationals Park,8,4
2014-08-23,2014,PHI,STL,5,6,106,1.5,-165,8.0,-110,-110,-116,-1.5,145,3.88,Citizens Bank Park,11,-1
2014-08-23,2014,TOR,TB,5,4,-115,-1.5,175,9.0,-105,-115,105,1.5,-205,4.81,Rogers Centre,9,1
2014-08-23,2014,KC,TEX,6,3,-120,-1.5,130,9.0,-120,100,110,1.5,-150,4.91,Rangers Ballpark,9,3
2014-08-23,2014,TB,TOR,4,5,105,1.5,-205,9.0,-105,-115,-115,-1.5,175,4.39,Rogers Centre,9,-1
2014-08-23,2014,SF,WSH,2,6,171,1.5,-135,7.5,100,-120,-191,-1.5,115,2.77,Nationals Park,8,-4
2014-08-24,2014,SD,ARI,7,4,-110,-1.5,150,7.5,-120,100,100,1.5,-170,3.93,Chase Field,11,3
2014-08-24,2014,CIN,ATL,5,3,103,1.5,-160,7.5,-105,-115,-113,-1.5,140,3.69,Great American Ballpark,8,2
2014-08-24,2014,CHC,BAL,2,1,105,1.5,-165,8.0,-115,-105,-115,-1.5,145,3.9,Wrigley Field,3,1
2014-08-24,2014,SEA,BOS,8,6,-150,-1.5,100,8.5,100,-120,135,1.5,-120,5.1,Fenway Park,14,2
2014-08-24,2014,BAL,CHC,1,2,-115,-1.5,145,8.0,-115,-105,105,1.5,-165,4.28,Wrigley Field,3,-1
2014-08-24,2014,ATL,CIN,3,5,-113,-1.5,140,7.5,-105,-115,103,1.5,-160,3.98,Great American Ballpark,8,-2
2014-08-24,2014,HOU,CLE,1,3,129,1.5,-170,7.5,-110,-110,-144,-1.5,150,3.28,Progressive Field,4,-2
2014-08-24,2014,MIA,COL,4,7,107,1.5,-195,11.0,100,-120,-117,-1.5,165,5.31,Coors Field,11,-3
2014-08-24,2014,NYY,CWS,7,4,101,1.5,-165,7.0,100,-120,-111,-1.5,145,3.48,Yankee Stadium,11,3
2014-08-24,2014,MIN,DET,4,13,125,1.5,-135,7.5,-120,100,-140,-1.5,115,3.33,Target Field,17,-9
2014-08-24,2014,CLE,HOU,3,1,-144,-1.5,150,7.5,-110,-110,129,1.5,-170,4.43,Progressive Field,4,2
2014-08-24,2014,TEX,KC,3,1,145,1.5,-118,9.0,100,-120,-160,-1.5,-102,3.67,Rangers Ballpark,4,2
2014-08-24,2014,OAK,LAA,4,9,-117,-1.5,170,7.5,-115,-105,107,1.5,-200,4.04,Oakland Coliseum,13,-5
2014-08-24,2014,NYM,LAD,11,3,104,1.5,-215,8.0,-108,-112,-114,-1.5,185,3.92,Dodger Stadium,14,8
2014-08-24,2014,COL,MIA,7,4,-117,-1.5,165,11.0,100,-120,107,1.5,-195,5.93,Coors Field,11,3
2014-08-24,2014,PIT,MIL,3,4,116,1.5,-175,8.5,-110,-110,-131,-1.5,155,3.94,Miller Park,7,-1
2014-08-24,2014,DET,MIN,13,4,-140,-1.5,115,7.5,-120,100,125,1.5,-135,4.38,Target Field,17,9
2014-08-24,2014,LAD,NYM,3,11,-114,-1.5,185,8.0,-108,-112,104,1.5,-215,4.26,Dodger Stadium,14,-8
2014-08-24,2014,CWS,NYY,4,7,-111,-1.5,145,7.0,100,-120,101,1.5,-165,3.68,Yankee Stadium,11,-3
2014-08-24,2014,LAA,OAK,9,4,107,1.5,-200,7.5,-115,-105,-117,-1.5,170,3.62,Oakland Coliseum,13,5
2014-08-24,2014,STL,PHI,1,7,-124,-1.5,135,8.5,-105,-115,114,1.5,-155,4.71,Citizens Bank Park,8,-6
2014-08-24,2014,MIL,PIT,4,3,-131,-1.5,155,8.5,-110,-110,116,1.5,-175,4.82,Miller Park,7,1
2014-08-24,2014,ARI,SD,4,7,100,1.5,-170,7.5,-120,100,-110,-1.5,150,3.75,Chase Field,11,-3
2014-08-24,2014,BOS,SEA,6,8,135,1.5,-120,8.5,100,-120,-150,-1.5,100,3.62,Fenway Park,14,-2
2014-08-24,2014,WSH,SF,14,6,-157,-1.5,140,7.0,-105,-115,142,1.5,-160,4.28,Nationals Park,20,8
2014-08-24,2014,PHI,STL,7,1,114,1.5,-155,8.5,-105,-115,-124,-1.5,135,3.97,Citizens Bank Park,8,6
2014-08-24,2014,TOR,TB,1,2,-110,-1.5,185,8.5,-110,-110,100,1.5,-215,4.45,Rogers Centre,3,-1
2014-08-24,2014,KC,TEX,1,3,-160,-1.5,-102,9.0,100,-120,145,1.5,-118,5.54,Rangers Ballpark,4,-2
2014-08-24,2014,TB,TOR,2,1,100,1.5,-215,8.5,-110,-110,-110,-1.5,185,4.25,Rogers Centre,3,1
2014-08-24,2014,SF,WSH,6,14,142,1.5,-160,7.0,-105,-115,-157,-1.5,140,2.89,Nationals Park,20,-8
2014-08-25,2014,TB,BAL,1,9,101,1.5,-200,7.5,-105,-115,-111,-1.5,170,3.73,Camden Yards,10,-8
2014-08-25,2014,TOR,BOS,3,4,-118,-1.5,170,9.0,-105,-115,108,1.5,-200,4.87,Rogers Centre,7,-1
2014-08-25,2014,SF,COL,2,3,-200,-1.5,115,7.5,110,-130,170,1.5,-135,5.0,AT&T Park,5,-1
2014-08-25,2014,OAK,HOU,8,2,-170,-1.5,-110,8.5,-115,-105,150,1.5,-110,5.35,Minute Maid Park,10,6
2014-08-25,2014,NYY,KC,8,1,115,1.5,-190,7.5,-115,-105,-130,-1.5,160,3.49,Kauffman Stadium,9,7
2014-08-25,2014,MIA,LAA,7,1,153,1.5,-140,8.5,-118,-102,-168,-1.5,120,3.36,Angel Stadium,8,6
2014-08-25,2014,LAA,MIA,1,7,-168,-1.5,120,8.5,-118,-102,153,1.5,-140,5.33,Angel Stadium,8,-6
2014-08-25,2014,SD,MIL,1,10,125,1.5,-140,7.0,-121,101,-140,-1.5,120,3.11,PETCO Park,11,-9
2014-08-25,2014,KC,NYY,1,8,-130,-1.5,160,7.5,-115,-105,115,1.5,-190,4.24,Kauffman Stadium,9,-7
2014-08-25,2014,HOU,OAK,2,8,150,1.5,-110,8.5,-115,-105,-170,-1.5,-110,3.4,Minute Maid Park,10,-6
2014-08-25,2014,WSH,PHI,2,3,-126,-1.5,115,8.0,-115,-105,116,1.5,-135,4.46,Citizens Bank Park,5,-1
2014-08-25,2014,STL,PIT,3,2,126,1.5,-175,7.5,-103,-117,-141,-1.5,155,3.32,PNC Park,5,1
2014-08-25,2014,MIL,SD,10,1,-140,-1.5,120,7.0,-121,101,125,1.5,-140,4.08,PETCO Park,11,9
2014-08-25,2014,TEX,SEA,2,0,160,1.5,-125,8.0,-105,-115,-180,-1.5,105,3.08,T-Mobile Park,2,2
2014-08-25,2014,COL,SF,3,2,170,1.5,-135,7.5,110,-130,-200,-1.5,115,2.78,AT&T Park,5,1
2014-08-25,2014,PIT,STL,2,3,-141,-1.5,155,7.5,-103,-117,126,1.5,-175,4.39,PNC Park,5,-1
2014-08-25,2014,BAL,TB,9,1,-111,-1.5,170,7.5,-105,-115,101,1.5,-200,3.95,Camden Yards,10,8
2014-08-25,2014,SEA,TEX,0,2,-180,-1.5,105,8.0,-105,-115,160,1.5,-125,5.14,T-Mobile Park,2,-2
2014-08-25,2014,BOS,TOR,4,3,108,1.5,-200,9.0,-105,-115,-118,-1.5,170,4.33,Rogers Centre,7,1
2014-08-25,2014,PHI,WSH,3,2,116,1.5,-135,8.0,-115,-105,-126,-1.5,115,3.7,Citizens Bank Park,5,1
2014-08-26,2014,LAD,ARI,9,5,-106,-1.5,145,8.5,-125,105,-104,1.5,-165,4.37,Chase Field,14,4
2014-08-26,2014,NYM,ATL,3,2,135,1.5,-130,7.0,100,-120,-150,-1.5,110,2.98,Citi Field,5,1
2014-08-26,2014,TB,BAL,2,4,100,1.5,-215,7.5,110,-130,-110,-1.5,185,3.75,Camden Yards,6,-2
2014-08-26,2014,TOR,BOS,7,11,-155,-1.5,135,9.0,105,-125,140,1.5,-155,5.47,Rogers Centre,18,-4
2014-08-26,2014,CIN,CHC,0,3,-176,-1.5,125,7.0,-115,-105,156,1.5,-145,4.46,Great American Ballpark,3,-3
2014-08-26,2014,CHC,CIN,3,0,156,1.5,-145,7.0,-115,-105,-176,-1.5,125,2.73,Great American Ballpark,3,3
2014-08-26,2014,CWS,CLE,6,8,-154,-1.5,140,8.0,-110,-110,139,1.5,-160,4.85,Guaranteed Rate Field,14,-2
2014-08-26,2014,SF,COL,3,0,-240,-1.5,-105,6.5,100,-120,200,1.5,-115,4.59,AT&T Park,3,3
2014-08-26,2014,CLE,CWS,8,6,139,1.5,-160,8.0,-110,-110,-154,-1.5,140,3.35,Guaranteed Rate Field,14,2
2014-08-26,2014,NYY,DET,2,5,-110,-1.5,150,8.0,-110,-110,100,1.5,-170,4.19,Comerica Park,7,-3
2014-08-26,2014,OAK,HOU,2,4,-112,-1.5,140,8.0,-115,-105,102,1.5,-160,4.23,Minute Maid Park,6,-2
2014-08-26,2014,MIN,KC,1,2,154,1.5,-140,8.0,-115,-105,-174,-1.5,120,3.15,Kauffman Stadium,3,-1
2014-08-26,2014,MIA,LAA,2,8,160,1.5,-135,8.0,100,-120,-180,-1.5,115,3.08,Angel Stadium,10,-6
2014-08-26,2014,ARI,LAD,5,9,-104,1.5,-165,8.5,-125,105,-106,-1.5,145,4.33,Chase Field,14,-4
2014-08-26,2014,LAA,MIA,8,2,-180,-1.5,115,8.0,100,-120,160,1.5,-135,5.14,Angel Stadium,10,6
2014-08-26,2014,SD,MIL,4,1,-110,-1.5,195,6.5,-110,-110,100,1.5,-235,3.4,PETCO Park,5,3
2014-08-26,2014,KC,MIN,2,1,-174,-1.5,120,8.0,-115,-105,154,1.5,-140,5.08,Kauffman Stadium,3,1
2014-08-26,2014,ATL,NYM,2,3,-150,-1.5,110,7.0,100,-120,135,1.5,-130,4.2,Citi Field,5,-1
2014-08-26,2014,DET,NYY,5,2,100,1.5,-170,8.0,-110,-110,-110,-1.5,150,4.0,Comerica Park,7,3
2014-08-26,2014,HOU,OAK,4,2,102,1.5,-160,8.0,-115,-105,-112,-1.5,140,3.96,Minute Maid Park,6,2
2014-08-26,2014,WSH,PHI,3,4,-108,-1.5,150,7.0,105,-125,-102,1.5,-170,3.63,Citizens Bank Park,7,-1
2014-08-26,2014,STL,PIT,2,5,115,1.5,-195,7.5,-110,-110,-130,-1.5,165,3.49,PNC Park,7,-3
2014-08-26,2014,MIL,SD,1,4,100,1.5,-235,6.5,-110,-110,-110,-1.5,195,3.25,PETCO Park,5,-3
2014-08-26,2014,TEX,SEA,0,5,185,1.5,-115,7.5,105,-125,-215,-1.5,-105,2.63,T-Mobile Park,5,-5
2014-08-26,2014,COL,SF,0,3,200,1.5,-115,6.5,100,-120,-240,-1.5,-105,2.17,AT&T Park,3,-3
2014-08-26,2014,PIT,STL,5,2,-130,-1.5,165,7.5,-110,-110,115,1.5,-195,4.24,PNC Park,7,3
2014-08-26,2014,BAL,TB,4,2,-110,-1.5,185,7.5,110,-130,100,1.5,-215,3.93,Camden Yards,6,2
2014-08-26,2014,SEA,TEX,5,0,-215,-1.5,-105,7.5,105,-125,185,1.5,-115,5.12,T-Mobile Park,5,5
2014-08-26,2014,BOS,TOR,11,7,140,1.5,-155,9.0,105,-125,-155,-1.5,135,3.75,Rogers Centre,18,4
2014-08-26,2014,PHI,WSH,4,3,-102,1.5,-170,7.0,105,-125,-108,-1.5,150,3.53,Citizens Bank Park,7,1
2014-08-27,2014,LAD,ARI,3,1,-230,-1.5,-133,7.0,-105,-115,200,1.5,114,4.88,Chase Field,4,2
2014-08-27,2014,NYM,ATL,2,3,109,1.5,-160,6.5,-115,-105,-119,-1.5,140,3.11,Citi Field,5,-1
2014-08-27,2014,TB,BAL,3,1,-105,-1.5,150,8.0,-110,-110,-105,1.5,-170,4.1,Camden Yards,4,2
2014-08-27,2014,TOR,BOS,5,2,-140,-1.5,150,9.0,-110,-110,125,1.5,-170,5.25,Rogers Centre,7,3
2014-08-27,2014,CIN,CHC,7,5,-159,-1.5,125,7.5,-117,-103,144,1.5,-145,4.6,Great American Ballpark,12,2
2014-08-27,2014,CHC,CIN,5,7,144,1.5,-145,7.5,-117,-103,-159,-1.5,125,3.07,Great American Ballpark,12,-2
2014-08-27,2014,CWS,CLE,3,2,160,1.5,105,7.5,-115,-105,-180,-1.5,-125,2.88,Guaranteed Rate Field,5,1
2014-08-27,2014,SF,COL,4,2,-210,-1.5,-101,7.0,-105,-115,180,1.5,-119,4.74,AT&T Park,6,2
2014-08-27,2014,CLE,CWS,2,3,-180,-1.5,-125,7.5,-115,-105,160,1.5,105,4.82,Guaranteed Rate Field,5,-1
2014-08-27,2014,NYY,DET,8,4,147,1.5,-150,7.5,-112,-108,-162,-1.5,130,3.04,Comerica Park,12,4
2014-08-27,2014,OAK,HOU,5,4,-175,-1.5,-115,9.0,-105,-115,155,1.5,-105,5.73,Minute Maid Park,9,1
2014-08-27,2014,MIN,KC,1,6,109,1.5,-210,7.5,-110,-110,-119,-1.5,180,3.59,Kauffman Stadium,7,-5
2014-08-27,2014,MIA,LAA,1,6,136,1.5,-160,8.0,-115,-105,-151,-1.5,140,3.39,Angel Stadium,7,-5
2014-08-27,2014,ARI,LAD,1,3,200,1.5,114,7.0,-105,-115,-230,-1.5,-133,2.33,Chase Field,4,-2
2014-08-27,2014,LAA,MIA,6,1,-151,-1.5,140,8.0,-115,-105,136,1.5,-160,4.81,Angel Stadium,7,5
2014-08-27,2014,SD,MIL,3,2,126,1.5,-140,7.0,-115,-105,-141,-1.5,120,3.1,PETCO Park,5,1
2014-08-27,2014,KC,MIN,6,1,-119,-1.5,180,7.5,-110,-110,109,1.5,-210,4.08,Kauffman Stadium,7,5
2014-08-27,2014,ATL,NYM,3,2,-119,-1.5,140,6.5,-115,-105,109,1.5,-160,3.53,Citi Field,5,1
2014-08-27,2014,DET,NYY,4,8,-162,-1.5,130,7.5,-112,-108,147,1.5,-150,4.64,Comerica Park,12,-4
2014-08-27,2014,HOU,OAK,4,5,155,1.5,-105,9.0,-105,-115,-175,-1.5,-115,3.53,Minute Maid Park,9,-1
2014-08-27,2014,WSH,PHI,4,8,-150,-1.5,-103,8.0,-120,100,135,1.5,-117,4.8,Citizens Bank Park,12,-4
2014-08-27,2014,STL,PIT,1,3,-106,-1.5,150,7.5,105,-125,-104,1.5,-170,3.86,PNC Park,4,-2
2014-08-27,2014,MIL,SD,2,3,-141,-1.5,120,7.0,-115,-105,126,1.5,-140,4.1,PETCO Park,5,-1
2014-08-27,2014,TEX,SEA,12,4,153,1.5,-145,7.5,-105,-115,-173,-1.5,125,2.96,T-Mobile Park,16,8
2014-08-27,2014,COL,SF,2,4,180,1.5,-119,7.0,-105,-115,-210,-1.5,-101,2.5,AT&T Park,6,-2
2014-08-27,2014,PIT,STL,3,1,-104,1.5,-170,7.5,105,-125,-106,-1.5,150,3.82,PNC Park,4,2
2014-08-27,2014,BAL,TB,1,3,-105,1.5,-170,8.0,-110,-110,-105,-1.5,150,4.1,Camden Yards,4,-2
2014-08-27,2014,SEA,TEX,4,12,-173,-1.5,125,7.5,-105,-115,153,1.5,-145,4.75,T-Mobile Park,16,-8
2014-08-27,2014,BOS,TOR,2,5,125,1.5,-170,9.0,-110,-110,-140,-1.5,150,4.0,Rogers Centre,7,-3
2014-08-27,2014,PHI,WSH,8,4,135,1.5,-117,8.0,-120,100,-150,-1.5,-103,3.4,Citizens Bank Park,12,4
2014-08-28,2014,NYM,ATL,1,6,-102,1.5,-175,7.0,-115,-105,-108,-1.5,155,3.53,Citi Field,7,-5
2014-08-28,2014,TB,BAL,4,5,114,1.5,-200,8.0,-105,-115,-124,-1.5,170,3.74,Camden Yards,9,-1
2014-08-28,2014,CIN,CHC,7,2,-112,1.5,-170,7.0,-115,-105,102,-1.5,150,3.7,Great American Ballpark,9,5
2014-08-28,2014,CHC,CIN,2,7,102,-1.5,150,7.0,-115,-105,-112,1.5,-170,3.47,Great American Ballpark,9,-5
2014-08-28,2014,CWS,CLE,2,3,108,1.5,-155,8.0,-120,100,-118,-1.5,135,3.85,Guaranteed Rate Field,5,-1
2014-08-28,2014,SF,COL,4,1,-200,-1.5,104,7.0,110,-130,170,1.5,-124,4.67,AT&T Park,5,3
2014-08-28,2014,CLE,CWS,3,2,-118,-1.5,135,8.0,-120,100,108,1.5,-155,4.33,Guaranteed Rate Field,5,1
2014-08-28,2014,NYY,DET,2,3,-124,-1.5,130,8.5,-120,100,114,1.5,-150,4.71,Comerica Park,5,-1
2014-08-28,2014,TEX,HOU,2,4,125,1.5,-190,8.0,-110,-110,-140,-1.5,160,3.56,Minute Maid Park,6,-2
2014-08-28,2014,MIN,KC,11,5,152,1.5,-150,8.0,-120,100,-167,-1.5,130,3.17,Kauffman Stadium,16,6
2014-08-28,2014,OAK,LAA,3,4,-102,1.5,-215,8.0,-105,-115,-108,-1.5,185,4.04,Angel Stadium,7,-1
2014-08-28,2014,KC,MIN,5,11,-167,-1.5,130,8.0,-120,100,152,1.5,-150,5.0,Kauffman Stadium,16,-6
2014-08-28,2014,ATL,NYM,6,1,-108,-1.5,155,7.0,-115,-105,-102,1.5,-175,3.63,Citi Field,7,5
2014-08-28,2014,DET,NYY,3,2,114,1.5,-150,8.5,-120,100,-124,-1.5,130,3.97,Comerica Park,5,1
2014-08-28,2014,LAA,OAK,4,3,-108,-1.5,185,8.0,-105,-115,-102,1.5,-215,4.15,Angel Stadium,7,1
2014-08-28,2014,COL,SF,1,4,170,1.5,-124,7.0,110,-130,-200,-1.5,104,2.59,AT&T Park,5,-3
2014-08-28,2014,BAL,TB,5,4,-124,-1.5,170,8.0,-105,-115,114,1.5,-200,4.43,Camden Yards,9,1
2014-08-28,2014,HOU,TEX,4,2,-140,-1.5,160,8.0,-110,-110,125,1.5,-190,4.67,Minute Maid Park,6,2
2014-08-29,2014,COL,ARI,2,5,136,1.5,-165,8.5,-110,-110,-151,-1.5,145,3.6,Chase Field,7,-3
2014-08-29,2014,MIA,ATL,2,5,150,1.5,-170,7.0,-125,105,-170,-1.5,150,2.8,Turner Field,7,-3
2014-08-29,2014,MIN,BAL,1,9,153,1.5,-135,8.5,-120,100,-173,-1.5,115,3.36,Camden Yards,10,-8
2014-08-29,2014,TB,BOS,4,8,-172,-1.5,115,7.5,-110,-110,152,1.5,-135,4.74,Tropicana Field,12,-4
2014-08-29,2014,STL,CHC,2,7,-150,-1.5,145,8.0,-115,-105,135,1.5,-165,4.8,Busch Stadium,9,-5
2014-08-29,2014,PIT,CIN,2,1,-141,-1.5,160,7.5,107,-127,126,1.5,-190,4.39,PNC Park,3,1
2014-08-29,2014,KC,CLE,1,6,-140,-1.5,155,7.5,-120,100,125,1.5,-175,4.38,Kauffman Stadium,7,-5
2014-08-29,2014,ARI,COL,5,2,-151,-1.5,145,8.5,-110,-110,136,1.5,-165,5.11,Chase Field,7,3
2014-08-29,2014,DET,CWS,7,1,-140,-1.5,110,9.0,-120,100,125,1.5,-130,5.25,Guaranteed Rate Field,8,6
2014-08-29,2014,CWS,DET,1,7,125,1.5,-130,9.0,-120,100,-140,-1.5,110,4.0,Guaranteed Rate Field,8,-6
2014-08-29,2014,TEX,HOU,13,6,116,1.5,-200,8.5,100,-120,-126,-1.5,170,3.94,Minute Maid Park,19,7
2014-08-29,2014,CLE,KC,6,1,125,1.5,-175,7.5,-120,100,-140,-1.5,155,3.33,Kauffman Stadium,7,5
2014-08-29,2014,OAK,LAA,0,4,-114,-1.5,145,7.0,-125,105,104,1.5,-165,3.73,Angel Stadium,4,-4
2014-08-29,2014,SD,LAD,3,2,-109,-1.5,190,7.0,109,-129,-101,1.5,-230,3.65,PETCO Park,5,1
2014-08-29,2014,ATL,MIA,5,2,-170,-1.5,150,7.0,-125,105,150,1.5,-170,4.41,Turner Field,7,3
2014-08-29,2014,SF,MIL,13,2,-115,-1.5,185,7.0,-115,-105,105,1.5,-215,3.74,AT&T Park,15,11
2014-08-29,2014,BAL,MIN,9,1,-173,-1.5,115,8.5,-120,100,153,1.5,-135,5.39,Camden Yards,10,8
2014-08-29,2014,PHI,NYM,1,4,132,1.5,-175,7.0,-105,-115,-147,-1.5,155,3.02,Citi Field,5,-3
2014-08-29,2014,TOR,NYY,3,6,-121,-1.5,170,8.5,-125,105,111,1.5,-200,4.65,Rogers Centre,9,-3
2014-08-29,2014,LAA,OAK,4,0,104,1.5,-165,7.0,-125,105,-114,-1.5,145,3.43,Angel Stadium,4,4
2014-08-29,2014,NYM,PHI,4,1,-147,-1.5,155,7.0,-105,-115,132,1.5,-175,4.17,Citi Field,5,3
2014-08-29,2014,CIN,PIT,1,2,126,1.5,-190,7.5,107,-127,-141,-1.5,160,3.32,PNC Park,3,-1
2014-08-29,2014,LAD,SD,2,3,-101,1.5,-230,7.0,109,-129,-109,-1.5,190,3.52,PETCO Park,5,-1
2014-08-29,2014,WSH,SEA,8,3,149,1.5,-170,6.0,107,-127,-164,-1.5,150,2.41,T-Mobile Park,11,5
2014-08-29,2014,MIL,SF,2,13,105,1.5,-215,7.0,-115,-105,-115,-1.5,185,3.41,AT&T Park,15,-11
2014-08-29,2014,CHC,STL,7,2,135,1.5,-165,8.0,-115,-105,-150,-1.5,145,3.4,Busch Stadium,9,5
2014-08-29,2014,BOS,TB,8,4,152,1.5,-135,7.5,-110,-110,-172,-1.5,115,2.98,Tropicana Field,12,4
2014-08-29,2014,HOU,TEX,6,13,-126,-1.5,170,8.5,100,-120,116,1.5,-200,4.74,Minute Maid Park,19,-7
2014-08-29,2014,NYY,TOR,6,3,111,1.5,-200,8.5,-125,105,-121,-1.5,170,4.03,Rogers Centre,9,3
2014-08-29,2014,SEA,WSH,3,8,-164,-1.5,150,6.0,107,-127,149,1.5,-170,3.73,T-Mobile Park,11,-5
2014-08-30,2014,COL,ARI,2,0,117,1.5,-190,8.0,100,-120,-132,-1.5,160,3.69,Chase Field,2,2
2014-08-30,2014,MIA,ATL,4,0,117,1.5,-195,7.5,-107,-113,-132,-1.5,165,3.46,Turner Field,4,4
2014-08-30,2014,MIN,BAL,2,3,130,1.5,-160,8.0,-120,100,-145,-1.5,140,3.48,Camden Yards,5,-1
2014-08-30,2014,TB,BOS,7,0,-162,-1.5,130,7.5,-120,100,147,1.5,-150,4.64,Tropicana Field,7,7
2014-08-30,2014,STL,CHC,1,5,-180,-1.5,120,7.5,-110,-110,160,1.5,-140,4.82,Busch Stadium,6,-4
2014-08-30,2014,STL,CHC,13,2,-127,-1.5,170,7.5,-110,-110,117,1.5,-200,4.2,Busch Stadium,15,11
2014-08-30,2014,PIT,CIN,3,2,-144,-1.5,140,8.0,-108,-112,129,1.5,-160,4.72,PNC Park,5,1
2014-08-30,2014,KC,CLE,2,3,-144,-1.5,155,7.5,-113,-107,129,1.5,-175,4.43,Kauffman Stadium,5,-1
2014-08-30,2014,ARI,COL,0,2,-132,-1.5,160,8.0,100,-120,117,1.5,-190,4.55,Chase Field,2,-2
2014-08-30,2014,DET,CWS,3,6,111,1.5,-230,7.0,-120,100,-121,-1.5,190,3.32,Guaranteed Rate Field,9,-3
2014-08-30,2014,DET,CWS,8,4,-110,-1.5,145,9.5,-115,-105,100,1.5,-165,4.98,Guaranteed Rate Field,12,4
2014-08-30,2014,CWS,DET,6,3,-121,-1.5,190,7.0,-120,100,111,1.5,-230,3.83,Guaranteed Rate Field,9,3
2014-08-30,2014,CWS,DET,4,8,100,1.5,-165,9.5,-115,-105,-110,-1.5,145,4.75,Guaranteed Rate Field,12,-4
2014-08-30,2014,TEX,HOU,0,2,105,1.5,-200,8.5,-115,-105,-115,-1.5,170,4.15,Minute Maid Park,2,-2
2014-08-30,2014,CLE,KC,3,2,129,1.5,-175,7.5,-113,-107,-144,-1.5,155,3.28,Kauffman Stadium,5,1
2014-08-30,2014,OAK,LAA,0,2,-118,-1.5,135,8.0,-105,-115,108,1.5,-155,4.33,Angel Stadium,2,-2
2014-08-30,2014,SD,LAD,2,1,125,1.5,-145,6.5,100,-120,-140,-1.5,125,2.89,PETCO Park,3,1
2014-08-30,2014,ATL,MIA,0,4,-132,-1.5,165,7.5,-107,-113,117,1.5,-195,4.27,Turner Field,4,-4
2014-08-30,2014,SF,MIL,3,1,-103,1.5,-170,7.0,105,-125,-107,-1.5,150,3.55,AT&T Park,4,2
2014-08-30,2014,BAL,MIN,3,2,-145,-1.5,140,8.0,-120,100,130,1.5,-160,4.73,Camden Yards,5,1
2014-08-30,2014,PHI,NYM,7,2,142,1.5,-160,7.0,-105,-115,-157,-1.5,140,2.89,Citi Field,9,5
2014-08-30,2014,TOR,NYY,2,0,103,1.5,-165,8.5,-118,-102,-113,-1.5,145,4.19,Rogers Centre,2,2
2014-08-30,2014,LAA,OAK,2,0,108,1.5,-155,8.0,-105,-115,-118,-1.5,135,3.85,Angel Stadium,2,2
2014-08-30,2014,NYM,PHI,2,7,-157,-1.5,140,7.0,-105,-115,142,1.5,-160,4.28,Citi Field,9,-5
2014-08-30,2014,CIN,PIT,2,3,129,1.5,-160,8.0,-108,-112,-144,-1.5,140,3.49,PNC Park,5,-1
2014-08-30,2014,LAD,SD,1,2,-140,-1.5,125,6.5,100,-120,125,1.5,-145,3.79,PETCO Park,3,-1
2014-08-30,2014,WSH,SEA,3,1,-118,-1.5,150,6.5,-110,-110,108,1.5,-170,3.52,T-Mobile Park,4,2
2014-08-30,2014,MIL,SF,1,3,-107,-1.5,150,7.0,105,-125,-103,1.5,-170,3.62,AT&T Park,4,-2
2014-08-30,2014,CHC,STL,5,1,160,1.5,-140,7.5,-110,-110,-180,-1.5,120,2.88,Busch Stadium,6,4
2014-08-30,2014,CHC,STL,2,13,117,1.5,-200,7.5,-110,-110,-127,-1.5,170,3.46,Busch Stadium,15,-11
2014-08-30,2014,BOS,TB,0,7,147,1.5,-150,7.5,-120,100,-162,-1.5,130,3.04,Tropicana Field,7,-7
2014-08-30,2014,HOU,TEX,2,0,-115,-1.5,170,8.5,-115,-105,105,1.5,-200,4.55,Minute Maid Park,2,2
2014-08-30,2014,NYY,TOR,0,2,-113,-1.5,145,8.5,-118,-102,103,1.5,-165,4.51,Rogers Centre,2,-2
2014-08-30,2014,SEA,WSH,1,3,108,1.5,-170,6.5,-110,-110,-118,-1.5,150,3.13,T-Mobile Park,4,-2
2014-08-31,2014,COL,ARI,2,6,102,1.5,-210,7.5,-105,-115,-112,-1.5,180,3.71,Chase Field,8,-4
2014-08-31,2014,MIA,ATL,0,1,150,1.5,-160,7.0,-110,-110,-170,-1.5,140,2.8,Turner Field,1,-1
2014-08-31,2014,MIN,BAL,8,12,150,1.5,-145,8.0,-115,-105,-170,-1.5,125,3.2,Camden Yards,20,-4
2014-08-31,2014,TB,BOS,0,3,-155,-1.5,145,6.5,-125,105,140,1.5,-165,3.95,Tropicana Field,3,-3
2014-08-31,2014,STL,CHC,9,6,-190,-1.5,115,7.5,100,-120,170,1.5,-135,4.91,Busch Stadium,15,3
2014-08-31,2014,PIT,CIN,2,3,-131,-1.5,175,6.5,100,-120,116,1.5,-205,3.69,PNC Park,5,-1
2014-08-31,2014,KC,CLE,3,4,-153,-1.5,135,8.0,-120,100,138,1.5,-155,4.84,Kauffman Stadium,7,-1
2014-08-31,2014,ARI,COL,6,2,-112,-1.5,180,7.5,-105,-115,102,1.5,-210,3.96,Chase Field,8,4
2014-08-31,2014,DET,CWS,2,6,-105,-1.5,160,8.0,-101,-119,-105,1.5,-190,4.1,Guaranteed Rate Field,8,-4
2014-08-31,2014,CWS,DET,6,2,-105,1.5,-190,8.0,-101,-119,-105,-1.5,160,4.1,Guaranteed Rate Field,8,4
2014-08-31,2014,TEX,HOU,2,3,145,1.5,-145,8.0,-110,-110,-160,-1.5,125,3.27,Minute Maid Park,5,-1
2014-08-31,2014,CLE,KC,4,3,138,1.5,-155,8.0,-120,100,-153,-1.5,135,3.36,Kauffman Stadium,7,1
2014-08-31,2014,OAK,LAA,1,8,115,1.5,-200,8.0,-105,-115,-125,-1.5,170,3.72,Angel Stadium,9,-7
2014-08-31,2014,SD,LAD,1,7,151,1.5,-115,7.0,-106,-114,-171,-1.5,-105,2.79,PETCO Park,8,-6
2014-08-31,2014,ATL,MIA,1,0,-170,-1.5,140,7.0,-110,-110,150,1.5,-160,4.41,Turner Field,1,1
2014-08-31,2014,SF,MIL,15,5,-140,-1.5,165,7.0,110,-130,125,1.5,-195,4.08,AT&T Park,20,10
2014-08-31,2014,BAL,MIN,12,8,-170,-1.5,125,8.0,-115,-105,150,1.5,-145,5.04,Camden Yards,20,4
2014-08-31,2014,PHI,NYM,5,6,-105,-1.5,155,7.0,100,-120,-105,1.5,-175,3.59,Citi Field,11,-1
2014-08-31,2014,TOR,NYY,4,3,-103,1.5,-170,8.5,-110,-110,-107,-1.5,150,4.31,Rogers Centre,7,1
2014-08-31,2014,LAA,OAK,8,1,-125,-1.5,170,8.0,-105,-115,115,1.5,-200,4.44,Angel Stadium,9,7
2014-08-31,2014,NYM,PHI,6,5,-105,1.5,-175,7.0,100,-120,-105,-1.5,155,3.59,Citi Field,11,1
2014-08-31,2014,CIN,PIT,3,2,116,1.5,-205,6.5,100,-120,-131,-1.5,175,3.01,PNC Park,5,1
2014-08-31,2014,LAD,SD,7,1,-171,-1.5,-105,7.0,-106,-114,151,1.5,-115,4.42,PETCO Park,8,6
2014-08-31,2014,WSH,SEA,3,5,137,1.5,-190,6.5,100,-120,-152,-1.5,160,2.74,T-Mobile Park,8,-2
2014-08-31,2014,MIL,SF,5,15,125,1.5,-195,7.0,110,-130,-140,-1.5,165,3.11,AT&T Park,20,-10
2014-08-31,2014,CHC,STL,6,9,170,1.5,-135,7.5,100,-120,-190,-1.5,115,2.78,Busch Stadium,15,-3
2014-08-31,2014,BOS,TB,3,0,140,1.5,-165,6.5,-125,105,-155,-1.5,145,2.71,Tropicana Field,3,3
2014-08-31,2014,HOU,TEX,3,2,-160,-1.5,125,8.0,-110,-110,145,1.5,-145,4.92,Minute Maid Park,5,1
2014-08-31,2014,NYY,TOR,3,4,-107,-1.5,150,8.5,-110,-110,-103,1.5,-170,4.39,Rogers Centre,7,-1
2014-08-31,2014,SEA,WSH,5,3,-152,-1.5,160,6.5,100,-120,137,1.5,-190,3.92,T-Mobile Park,8,2
2014-09-01,2014,SD,ARI,3,1,-174,-1.5,135,6.5,100,-120,154,1.5,-155,4.13,PETCO Park,4,2
2014-09-01,2014,PHI,ATL,7,0,110,1.5,-215,6.5,100,-120,-120,-1.5,185,3.1,Turner Field,7,7
2014-09-01,2014,MIN,BAL,6,4,107,1.5,-205,8.0,-104,-116,-117,-1.5,175,3.86,Camden Yards,10,2
2014-09-01,2014,TB,BOS,4,3,-179,-1.5,121,7.0,-120,100,159,1.5,-142,4.49,Tropicana Field,7,1
2014-09-01,2014,MIL,CHC,2,4,-142,-1.5,115,10.0,-120,100,127,1.5,-135,5.87,Wrigley Field,6,-2
2014-09-01,2014,DET,CLE,12,1,107,1.5,-210,7.0,100,-120,-117,-1.5,180,3.38,Progressive Field,13,11
2014-09-01,2014,SF,COL,9,10,-134,-1.5,115,10.5,-110,-110,119,1.5,-135,6.01,Coors Field,19,-1
2014-09-01,2014,CLE,DET,1,12,-117,-1.5,180,7.0,100,-120,107,1.5,-210,3.77,Progressive Field,13,-11
2014-09-01,2014,TEX,KC,3,4,180,1.5,-120,8.0,-105,-115,-210,-1.5,100,2.86,Kauffman Stadium,7,-1
2014-09-01,2014,WSH,LAD,6,4,-120,-1.5,140,8.0,-120,100,110,1.5,-160,4.36,Dodger Stadium,10,2
2014-09-01,2014,NYM,MIA,6,9,114,1.5,-205,7.0,100,-120,-124,-1.5,175,3.27,Marlins Park,15,-3
2014-09-01,2014,CHC,MIL,4,2,127,1.5,-135,10.0,-120,100,-142,-1.5,115,4.41,Wrigley Field,6,2
2014-09-01,2014,BAL,MIN,4,6,-117,-1.5,175,8.0,-104,-116,107,1.5,-205,4.31,Camden Yards,10,-2
2014-09-01,2014,MIA,NYM,9,6,-124,-1.5,175,7.0,100,-120,114,1.5,-205,3.88,Marlins Park,15,3
2014-09-01,2014,SEA,OAK,1,6,135,1.5,-160,8.0,-120,100,-150,-1.5,140,3.4,Oakland Coliseum,7,-5
2014-09-01,2014,ATL,PHI,0,7,-120,-1.5,185,6.5,100,-120,110,1.5,-215,3.55,Turner Field,7,-7
2014-09-01,2014,STL,PIT,5,4,-107,-1.5,190,7.5,-110,-110,-103,1.5,-230,3.88,Busch Stadium,9,1
2014-09-01,2014,ARI,SD,1,3,154,1.5,-155,6.5,100,-120,-174,-1.5,135,2.56,PETCO Park,4,-2
2014-09-01,2014,OAK,SEA,6,1,-150,-1.5,140,8.0,-120,100,135,1.5,-160,4.8,Oakland Coliseum,7,5
2014-09-01,2014,COL,SF,10,9,119,1.5,-135,10.5,-110,-110,-134,-1.5,115,4.79,Coors Field,19,1
2014-09-01,2014,PIT,STL,4,5,-103,1.5,-230,7.5,-110,-110,-107,-1.5,190,3.81,Busch Stadium,9,-1
2014-09-01,2014,BOS,TB,3,4,159,1.5,-142,7.0,-120,100,-179,-1.5,121,2.7,Tropicana Field,7,-1
2014-09-01,2014,KC,TEX,4,3,-210,-1.5,100,8.0,-105,-115,180,1.5,-120,5.42,Kauffman Stadium,7,1
2014-09-01,2014,LAD,WSH,4,6,110,1.5,-160,8.0,-120,100,-120,-1.5,140,3.81,Dodger Stadium,10,-2
2014-09-02,2014,SD,ARI,2,1,103,1.5,-190,6.0,-118,-102,-113,-1.5,160,2.96,PETCO Park,3,1
2014-09-02,2014,PHI,ATL,4,0,170,1.5,-135,7.5,-110,-110,-190,-1.5,115,2.78,Turner Field,4,4
2014-09-02,2014,CIN,BAL,4,5,127,1.5,-175,7.5,-105,-115,-142,-1.5,155,3.3,Camden Yards,9,-1
2014-09-02,2014,NYY,BOS,4,9,-150,-1.5,135,9.0,-105,-115,135,1.5,-155,5.4,Yankee Stadium,13,-5
2014-09-02,2014,MIL,CHC,1,7,-105,1.5,-240,7.5,105,-125,-105,-1.5,200,3.84,Wrigley Field,8,-6
2014-09-02,2014,BAL,CIN,5,4,-142,-1.5,155,7.5,-105,-115,127,1.5,-175,4.4,Camden Yards,9,1
2014-09-02,2014,DET,CLE,4,2,131,1.5,-165,8.0,-120,100,-146,-1.5,145,3.46,Progressive Field,6,2
2014-09-02,2014,SF,COL,12,7,-145,-1.5,110,10.0,-110,-110,130,1.5,-130,5.92,Coors Field,19,5
2014-09-02,2014,MIN,CWS,3,6,-140,-1.5,150,8.5,-115,-105,125,1.5,-170,4.96,Target Field,9,-3
2014-09-02,2014,CLE,DET,2,4,-146,-1.5,145,8.0,-120,100,131,1.5,-165,4.75,Progressive Field,6,-2
2014-09-02,2014,LAA,HOU,3,8,-163,-1.5,-101,9.0,100,-120,148,1.5,-119,5.58,Minute Maid Park,11,-5
2014-09-02,2014,TEX,KC,1,2,132,1.5,-160,7.5,-120,100,-147,-1.5,140,3.23,Kauffman Stadium,3,-1
2014-09-02,2014,HOU,LAA,8,3,148,1.5,-119,9.0,100,-120,-163,-1.5,-101,3.63,Minute Maid Park,11,5
2014-09-02,2014,WSH,LAD,1,4,175,1.5,-145,6.0,100,-120,-205,-1.5,125,2.18,Dodger Stadium,5,-3
2014-09-02,2014,NYM,MIA,8,6,-105,-1.5,155,8.0,100,-120,-105,1.5,-175,4.1,Marlins Park,14,2
2014-09-02,2014,CHC,MIL,7,1,-105,-1.5,200,7.5,105,-125,-105,1.5,-240,3.84,Wrigley Field,8,6
2014-09-02,2014,CWS,MIN,6,3,125,1.5,-170,8.5,-115,-105,-140,-1.5,150,3.78,Target Field,9,3
2014-09-02,2014,MIA,NYM,6,8,-105,1.5,-175,8.0,100,-120,-105,-1.5,155,4.1,Marlins Park,14,-2
2014-09-02,2014,BOS,NYY,9,4,135,1.5,-155,9.0,-105,-115,-150,-1.5,135,3.83,Yankee Stadium,13,5
2014-09-02,2014,SEA,OAK,6,5,125,1.5,-200,7.0,-103,-117,-140,-1.5,170,3.11,Oakland Coliseum,11,1
2014-09-02,2014,ATL,PHI,0,4,-190,-1.5,115,7.5,-110,-110,170,1.5,-135,4.91,Turner Field,4,-4
2014-09-02,2014,STL,PIT,6,4,-146,-1.5,150,7.5,100,-120,131,1.5,-170,4.45,Busch Stadium,10,2
2014-09-02,2014,ARI,SD,1,2,-113,-1.5,160,6.0,-118,-102,103,1.5,-190,3.18,PETCO Park,3,-1
2014-09-02,2014,OAK,SEA,5,6,-140,-1.5,170,7.0,-103,-117,125,1.5,-200,4.08,Oakland Coliseum,11,-1
2014-09-02,2014,COL,SF,7,12,130,1.5,-130,10.0,-110,-110,-145,-1.5,110,4.35,Coors Field,19,-5
2014-09-02,2014,PIT,STL,4,6,131,1.5,-170,7.5,100,-120,-146,-1.5,150,3.25,Busch Stadium,10,-2
2014-09-02,2014,TOR,TB,8,2,110,1.5,-200,7.5,105,-125,-120,-1.5,170,3.57,Tropicana Field,10,6
2014-09-02,2014,KC,TEX,2,1,-147,-1.5,140,7.5,-120,100,132,1.5,-160,4.46,Kauffman Stadium,3,1
2014-09-02,2014,TB,TOR,2,8,-120,-1.5,170,7.5,105,-125,110,1.5,-200,4.09,Tropicana Field,10,-6
2014-09-02,2014,LAD,WSH,4,1,-205,-1.5,125,6.0,100,-120,175,1.5,-145,4.03,Dodger Stadium,5,3
2014-09-03,2014,SD,ARI,1,6,-130,-1.5,170,6.0,100,-120,115,1.5,-200,3.39,PETCO Park,7,-5
2014-09-03,2014,PHI,ATL,4,7,169,1.5,-135,7.0,-120,100,-189,-1.5,115,2.6,Turner Field,11,-3
2014-09-03,2014,CIN,BAL,0,6,140,1.5,-155,8.0,100,-120,-155,-1.5,135,3.33,Camden Yards,6,-6
2014-09-03,2014,NYY,BOS,5,1,-195,-1.5,110,9.0,105,-125,175,1.5,-130,5.95,Yankee Stadium,6,4
2014-09-03,2014,MIL,CHC,2,6,-109,-1.5,145,8.5,100,-120,-101,1.5,-165,4.43,Wrigley Field,8,-4
2014-09-03,2014,BAL,CIN,6,0,-155,-1.5,135,8.0,100,-120,140,1.5,-155,4.86,Camden Yards,6,6
2014-09-03,2014,DET,CLE,0,7,116,1.5,-200,8.0,-110,-110,-126,-1.5,170,3.7,Progressive Field,7,-7
2014-09-03,2014,SF,COL,2,9,-120,-1.5,120,11.0,-105,-115,110,1.5,-140,6.0,Coors Field,11,-7
2014-09-03,2014,MIN,CWS,11,4,-109,-1.5,180,9.0,-105,-115,-101,1.5,-210,4.69,Target Field,15,7
2014-09-03,2014,CLE,DET,7,0,-126,-1.5,170,8.0,-110,-110,116,1.5,-200,4.46,Progressive Field,7,7
2014-09-03,2014,LAA,HOU,1,4,-125,-1.5,125,8.0,-115,-105,115,1.5,-145,4.44,Minute Maid Park,5,-3
2014-09-03,2014,TEX,KC,1,4,161,1.5,-140,8.0,-110,-110,-181,-1.5,120,3.07,Kauffman Stadium,5,-3
2014-09-03,2014,HOU,LAA,4,1,115,1.5,-145,8.0,-115,-105,-125,-1.5,125,3.72,Minute Maid Park,5,3
2014-09-03,2014,WSH,LAD,8,5,-152,-1.5,105,7.5,-112,-108,137,1.5,-125,4.52,Dodger Stadium,13,3
2014-09-03,2014,NYM,MIA,4,3,100,1.5,-230,7.0,-110,-110,-110,-1.5,190,3.5,Marlins Park,7,1
2014-09-03,2014,CHC,MIL,6,2,-101,1.5,-165,8.5,100,-120,-109,-1.5,145,4.27,Wrigley Field,8,4
2014-09-03,2014,CWS,MIN,4,11,-101,1.5,-210,9.0,-105,-115,-109,-1.5,180,4.52,Target Field,15,-7
2014-09-03,2014,MIA,NYM,3,4,-110,-1.5,190,7.0,-110,-110,100,1.5,-230,3.67,Marlins Park,7,-1
2014-09-03,2014,BOS,NYY,1,5,175,1.5,-130,9.0,105,-125,-195,-1.5,110,3.27,Yankee Stadium,6,-4
2014-09-03,2014,SEA,OAK,2,1,112,1.5,-215,6.5,100,-120,-122,-1.5,180,3.07,Oakland Coliseum,3,1
2014-09-03,2014,ATL,PHI,7,4,-189,-1.5,115,7.0,-120,100,169,1.5,-135,4.58,Turner Field,11,3
2014-09-03,2014,STL,PIT,1,0,-105,-1.5,190,8.0,-120,100,-105,1.5,-230,4.1,Busch Stadium,1,1
2014-09-03,2014,ARI,SD,6,1,115,1.5,-200,6.0,100,-120,-130,-1.5,170,2.79,PETCO Park,7,5
2014-09-03,2014,OAK,SEA,1,2,-122,-1.5,180,6.5,100,-120,112,1.5,-215,3.57,Oakland Coliseum,3,-1
2014-09-03,2014,COL,SF,9,2,110,1.5,-140,11.0,-105,-115,-120,-1.5,120,5.24,Coors Field,11,7
2014-09-03,2014,PIT,STL,0,1,-105,1.5,-230,8.0,-120,100,-105,-1.5,190,4.1,Busch Stadium,1,-1
2014-09-03,2014,TOR,TB,7,4,107,1.5,-210,7.0,-105,-115,-117,-1.5,180,3.38,Tropicana Field,11,3
2014-09-03,2014,KC,TEX,4,1,-181,-1.5,120,8.0,-110,-110,161,1.5,-140,5.15,Kauffman Stadium,5,3
2014-09-03,2014,TB,TOR,4,7,-117,-1.5,180,7.0,-105,-115,107,1.5,-210,3.77,Tropicana Field,11,-3
2014-09-03,2014,LAD,WSH,5,8,137,1.5,-125,7.5,-112,-108,-152,-1.5,105,3.16,Dodger Stadium,13,-3
2014-09-04,2014,SD,ARI,1,5,-145,-1.5,160,6.0,-120,100,130,1.5,-190,3.55,PETCO Park,6,-4
2014-09-04,2014,CIN,BAL,7,9,173,1.5,-130,7.5,-104,-116,-203,-1.5,110,2.75,Camden Yards,16,-2
2014-09-04,2014,NYY,BOS,5,4,-149,-1.5,140,8.5,-110,-110,134,1.5,-160,5.09,Yankee Stadium,9,1
2014-09-04,2014,BAL,CIN,9,7,-203,-1.5,110,7.5,-104,-116,173,1.5,-130,5.02,Camden Yards,16,2
2014-09-04,2014,DET,CLE,11,4,-119,-1.5,135,7.5,-115,-105,109,1.5,-155,4.08,Progressive Field,15,7
2014-09-04,2014,CLE,DET,4,11,109,1.5,-155,7.5,-115,-105,-119,-1.5,135,3.59,Progressive Field,15,-7
2014-09-04,2014,MIN,LAA,4,5,119,1.5,-150,9.0,-105,-115,-129,-1.5,130,4.11,Target Field,9,-1
2014-09-04,2014,STL,MIL,3,2,-115,-1.5,150,8.5,-105,-115,105,1.5,-170,4.55,Miller Park,5,1
2014-09-04,2014,LAA,MIN,5,4,-129,-1.5,130,9.0,-105,-115,119,1.5,-150,5.07,Target Field,9,1
2014-09-04,2014,BOS,NYY,4,5,134,1.5,-160,8.5,-110,-110,-149,-1.5,140,3.63,Yankee Stadium,9,-1
2014-09-04,2014,ARI,SD,5,1,130,1.5,-190,6.0,-120,100,-145,-1.5,160,2.61,PETCO Park,6,4
2014-09-04,2014,TEX,SEA,2,10,113,1.5,-155,9.0,100,-120,-123,-1.5,135,4.23,Rangers Ballpark,12,-8
2014-09-04,2014,MIL,STL,2,3,105,1.5,-170,8.5,-105,-115,-115,-1.5,150,4.15,Miller Park,5,-1
2014-09-04,2014,TOR,TB,1,0,132,1.5,-165,7.5,100,-120,-147,-1.5,145,3.23,Tropicana Field,1,1
2014-09-04,2014,SEA,TEX,10,2,-123,-1.5,135,9.0,100,-120,113,1.5,-155,4.96,Rangers Ballpark,12,8
2014-09-04,2014,TB,TOR,0,1,-147,-1.5,145,7.5,100,-120,132,1.5,-165,4.46,Tropicana Field,1,-1
2014-09-05,2014,LAD,ARI,2,1,-163,-1.5,135,7.5,-115,-105,148,1.5,-155,4.65,Dodger Stadium,3,1
2014-09-05,2014,MIA,ATL,11,3,-118,-1.5,180,7.5,-112,-108,108,1.5,-210,4.06,Marlins Park,14,8
2014-09-05,2014,TB,BAL,3,0,-142,-1.5,160,7.0,110,-130,127,1.5,-190,4.11,Tropicana Field,3,3
2014-09-05,2014,TOR,BOS,8,9,-108,-1.5,140,10.0,100,-120,-102,1.5,-160,5.19,Fenway Park,17,-1
2014-09-05,2014,PIT,CHC,5,3,-131,-1.5,120,8.5,-120,100,116,1.5,-140,4.82,Wrigley Field,8,2
2014-09-05,2014,NYM,CIN,14,5,-104,1.5,-230,7.5,-112,-108,-106,-1.5,190,3.82,Great American Ballpark,19,9
2014-09-05,2014,CWS,CLE,1,2,-156,-1.5,105,7.0,-117,-103,141,1.5,-125,4.27,Progressive Field,3,-1
2014-09-05,2014,SD,COL,0,3,118,1.5,-170,9.5,100,-120,-128,-1.5,150,4.36,Coors Field,3,-3
2014-09-05,2014,CLE,CWS,2,1,141,1.5,-125,7.0,-117,-103,-156,-1.5,105,2.9,Progressive Field,3,1
2014-09-05,2014,SF,DET,8,2,125,1.5,-175,9.0,-101,-119,-140,-1.5,155,4.0,Comerica Park,10,6
2014-09-05,2014,OAK,HOU,3,4,-219,-1.5,-110,7.0,-127,107,189,1.5,-110,4.81,Oakland Coliseum,7,-1
2014-09-05,2014,NYY,KC,0,1,-120,-1.5,180,7.5,-105,-115,110,1.5,-210,4.09,Yankee Stadium,1,-1
2014-09-05,2014,MIN,LAA,6,7,134,1.5,-130,8.5,100,-120,-149,-1.5,110,3.63,Target Field,13,-1
2014-09-05,2014,ARI,LAD,1,2,148,1.5,-155,7.5,-115,-105,-163,-1.5,135,3.02,Dodger Stadium,3,-1
2014-09-05,2014,ATL,MIA,3,11,108,1.5,-210,7.5,-112,-108,-118,-1.5,180,3.61,Marlins Park,14,-8
2014-09-05,2014,STL,MIL,2,6,110,1.5,-215,7.5,-105,-115,-120,-1.5,185,3.57,Miller Park,8,-4
2014-09-05,2014,LAA,MIN,7,6,-149,-1.5,110,8.5,100,-120,134,1.5,-130,5.09,Target Field,13,1
2014-09-05,2014,CIN,NYM,5,14,-106,-1.5,190,7.5,-112,-108,-104,1.5,-230,3.86,Great American Ballpark,19,-9
2014-09-05,2014,KC,NYY,1,0,110,1.5,-210,7.5,-105,-115,-120,-1.5,180,3.57,Yankee Stadium,1,1
2014-09-05,2014,HOU,OAK,4,3,189,1.5,-110,7.0,-127,107,-219,-1.5,-110,2.42,Oakland Coliseum,7,1
2014-09-05,2014,WSH,PHI,8,9,-251,-1.5,-119,7.5,-120,100,211,1.5,-101,5.36,Nationals Park,17,-1
2014-09-05,2014,CHC,PIT,3,5,116,1.5,-140,8.5,-120,100,-131,-1.5,120,3.94,Wrigley Field,8,-2
2014-09-05,2014,COL,SD,3,0,-128,-1.5,150,9.5,100,-120,118,1.5,-170,5.33,Coors Field,3,3
2014-09-05,2014,TEX,SEA,5,7,170,1.5,-105,8.5,-110,-110,-190,-1.5,-115,3.15,Rangers Ballpark,12,-2
2014-09-05,2014,DET,SF,2,8,-140,-1.5,155,9.0,-101,-119,125,1.5,-175,5.25,Comerica Park,10,-6
2014-09-05,2014,MIL,STL,6,2,-120,-1.5,185,7.5,-105,-115,110,1.5,-215,4.09,Miller Park,8,4
2014-09-05,2014,BAL,TB,0,3,127,1.5,-190,7.0,110,-130,-142,-1.5,160,3.08,Tropicana Field,3,-3
2014-09-05,2014,SEA,TEX,7,5,-190,-1.5,-115,8.5,-110,-110,170,1.5,-105,5.57,Rangers Ballpark,12,2
2014-09-05,2014,BOS,TOR,9,8,-102,1.5,-160,10.0,100,-120,-108,-1.5,140,5.05,Fenway Park,17,1
2014-09-05,2014,PHI,WSH,9,8,211,1.5,-101,7.5,-120,100,-251,-1.5,-119,2.41,Nationals Park,17,1
2014-09-06,2014,LAD,ARI,5,2,-205,-1.5,114,7.0,105,-125,175,1.5,-134,4.7,Dodger Stadium,7,3
2014-09-06,2014,MIA,ATL,3,4,101,1.5,-165,7.0,100,-120,-111,-1.5,145,3.48,Marlins Park,7,-1
2014-09-06,2014,TB,BAL,3,2,-149,-1.5,155,7.0,-116,-104,134,1.5,-175,4.19,Tropicana Field,5,1
2014-09-06,2014,TOR,BOS,3,4,119,1.5,-170,9.5,-107,-113,-134,-1.5,150,4.34,Fenway Park,7,-1
2014-09-06,2014,PIT,CHC,5,0,-160,-1.5,100,7.0,-105,-115,145,1.5,-120,4.31,Wrigley Field,5,5
2014-09-06,2014,NYM,CIN,1,2,141,1.5,-165,7.0,105,-125,-156,-1.5,145,2.9,Great American Ballpark,3,-1
2014-09-06,2014,CWS,CLE,1,3,140,1.5,-160,7.0,122,-142,-155,-1.5,140,2.92,Progressive Field,4,-2
2014-09-06,2014,SD,COL,6,7,119,1.5,-170,9.0,-115,-105,-134,-1.5,150,4.11,Coors Field,13,-1
2014-09-06,2014,CLE,CWS,3,1,-155,-1.5,140,7.0,122,-142,140,1.5,-160,4.25,Progressive Field,4,2
2014-09-06,2014,SF,DET,5,4,125,1.5,-175,7.0,-115,-105,-140,-1.5,155,3.11,Comerica Park,9,1
2014-09-06,2014,OAK,HOU,4,3,-214,-1.5,-101,7.5,-110,-110,184,1.5,-119,5.11,Oakland Coliseum,7,1
2014-09-06,2014,NYY,KC,6,2,-120,-1.5,175,7.5,-105,-115,110,1.5,-205,4.09,Yankee Stadium,8,4
2014-09-06,2014,MIN,LAA,5,8,-108,-1.5,185,8.0,-110,-110,-102,1.5,-215,4.15,Target Field,13,-3
2014-09-06,2014,ARI,LAD,2,5,175,1.5,-134,7.0,105,-125,-205,-1.5,114,2.55,Dodger Stadium,7,-3
2014-09-06,2014,ATL,MIA,4,3,-111,-1.5,145,7.0,100,-120,101,1.5,-165,3.68,Marlins Park,7,1
2014-09-06,2014,STL,MIL,5,3,-108,-1.5,150,7.5,-110,-110,-102,1.5,-170,3.89,Miller Park,8,2
2014-09-06,2014,LAA,MIN,8,5,-102,1.5,-215,8.0,-110,-110,-108,-1.5,185,4.04,Target Field,13,3
2014-09-06,2014,CIN,NYM,2,1,-156,-1.5,145,7.0,105,-125,141,1.5,-165,4.27,Great American Ballpark,3,1
2014-09-06,2014,KC,NYY,2,6,110,1.5,-205,7.5,-105,-115,-120,-1.5,175,3.57,Yankee Stadium,8,-4
2014-09-06,2014,HOU,OAK,3,4,184,1.5,-119,7.5,-110,-110,-214,-1.5,-101,2.64,Oakland Coliseum,7,-1
2014-09-06,2014,WSH,PHI,1,3,-170,-1.5,125,8.0,-105,-115,150,1.5,-145,5.04,Nationals Park,4,-2
2014-09-06,2014,CHC,PIT,0,5,145,1.5,-120,7.0,-105,-115,-160,-1.5,100,2.86,Wrigley Field,5,-5
2014-09-06,2014,COL,SD,7,6,-134,-1.5,150,9.0,-115,-105,119,1.5,-170,5.15,Coors Field,13,1
2014-09-06,2014,TEX,SEA,2,4,125,1.5,-130,9.5,105,-125,-140,-1.5,110,4.22,Rangers Ballpark,6,-2
2014-09-06,2014,DET,SF,4,5,-140,-1.5,155,7.0,-115,-105,125,1.5,-175,4.08,Comerica Park,9,-1
2014-09-06,2014,MIL,STL,3,5,-102,1.5,-170,7.5,-110,-110,-108,-1.5,150,3.79,Miller Park,8,-2
2014-09-06,2014,BAL,TB,2,3,134,1.5,-175,7.0,-116,-104,-149,-1.5,155,2.99,Tropicana Field,5,-1
2014-09-06,2014,SEA,TEX,4,2,-140,-1.5,110,9.5,105,-125,125,1.5,-130,5.54,Rangers Ballpark,6,2
2014-09-06,2014,BOS,TOR,4,3,-134,-1.5,150,9.5,-107,-113,119,1.5,-170,5.44,Fenway Park,7,1
2014-09-06,2014,PHI,WSH,3,1,150,1.5,-145,8.0,-105,-115,-170,-1.5,125,3.2,Nationals Park,4,2
2014-09-07,2014,LAD,ARI,7,2,-240,-1.5,-119,7.0,-120,100,200,1.5,-101,4.94,Dodger Stadium,9,5
2014-09-07,2014,MIA,ATL,4,0,130,1.5,-135,7.0,-120,100,-145,-1.5,115,3.04,Marlins Park,4,4
2014-09-07,2014,TB,BAL,5,7,101,-1.5,190,7.5,105,-125,-111,1.5,-220,3.73,Tropicana Field,12,-2
2014-09-07,2014,TOR,BOS,3,1,-120,-1.5,135,8.5,-120,100,110,1.5,-155,4.64,Fenway Park,4,2
2014-09-07,2014,PIT,CHC,10,4,-161,-1.5,-105,8.0,-115,-105,146,1.5,-115,4.93,Wrigley Field,14,6
2014-09-07,2014,NYM,CIN,4,3,109,1.5,-215,7.0,110,-130,-119,-1.5,185,3.35,Great American Ballpark,7,1
2014-09-07,2014,CWS,CLE,0,2,171,1.5,-120,7.5,-105,-115,-201,-1.5,100,2.77,Progressive Field,2,-2
2014-09-07,2014,SD,COL,0,6,-132,-1.5,115,9.5,102,-122,117,1.5,-135,5.41,Coors Field,6,-6
2014-09-07,2014,CLE,CWS,2,0,-201,-1.5,100,7.5,-105,-115,171,1.5,-120,5.01,Progressive Field,2,2
2014-09-07,2014,SF,DET,1,6,113,1.5,-200,8.5,100,-120,-123,-1.5,170,3.99,Comerica Park,7,-5
2014-09-07,2014,OAK,HOU,3,4,-158,-1.5,140,7.5,-104,-116,143,1.5,-160,4.59,Oakland Coliseum,7,-1
2014-09-07,2014,NYY,KC,0,2,-108,-1.5,190,7.5,-105,-115,-102,1.5,-230,3.89,Yankee Stadium,2,-2
2014-09-07,2014,MIN,LAA,4,14,141,1.5,-120,9.5,100,-120,-156,-1.5,100,3.94,Target Field,18,-10
2014-09-07,2014,ARI,LAD,2,7,200,1.5,-101,7.0,-120,100,-240,-1.5,-119,2.33,Dodger Stadium,9,-5
2014-09-07,2014,ATL,MIA,0,4,-145,-1.5,115,7.0,-120,100,130,1.5,-135,4.14,Marlins Park,4,-4
2014-09-07,2014,STL,MIL,9,1,-123,-1.5,130,7.5,-115,-105,113,1.5,-150,4.14,Miller Park,10,8
2014-09-07,2014,LAA,MIN,14,4,-156,-1.5,100,9.5,100,-120,141,1.5,-120,5.79,Target Field,18,10
2014-09-07,2014,CIN,NYM,3,4,-119,-1.5,185,7.0,110,-130,109,1.5,-215,3.8,Great American Ballpark,7,-1
2014-09-07,2014,KC,NYY,2,0,-102,1.5,-230,7.5,-105,-115,-108,-1.5,190,3.79,Yankee Stadium,2,2
2014-09-07,2014,HOU,OAK,4,3,143,1.5,-160,7.5,-104,-116,-158,-1.5,140,3.09,Oakland Coliseum,7,1
2014-09-07,2014,WSH,PHI,3,2,-142,-1.5,160,6.5,-120,100,127,1.5,-190,3.81,Nationals Park,5,1
2014-09-07,2014,CHC,PIT,4,10,146,1.5,-115,8.0,-115,-105,-161,-1.5,-105,3.25,Wrigley Field,14,-6
2014-09-07,2014,COL,SD,6,0,117,1.5,-135,9.5,102,-122,-132,-1.5,115,4.38,Coors Field,6,6
2014-09-07,2014,TEX,SEA,1,0,116,1.5,-145,8.0,100,-120,-126,-1.5,125,3.7,Rangers Ballpark,1,1
2014-09-07,2014,DET,SF,6,1,-123,-1.5,170,8.5,100,-120,113,1.5,-200,4.69,Comerica Park,7,5
2014-09-07,2014,MIL,STL,1,9,113,1.5,-150,7.5,-115,-105,-123,-1.5,130,3.52,Miller Park,10,-8
2014-09-07,2014,BAL,TB,7,5,-111,1.5,-220,7.5,105,-125,101,-1.5,190,3.95,Tropicana Field,12,2
2014-09-07,2014,SEA,TEX,0,1,-126,-1.5,125,8.0,100,-120,116,1.5,-145,4.46,Rangers Ballpark,1,-1
2014-09-07,2014,BOS,TOR,1,3,110,1.5,-155,8.5,-120,100,-120,-1.5,135,4.05,Fenway Park,4,-2
2014-09-07,2014,PHI,WSH,2,3,127,1.5,-190,6.5,-120,100,-142,-1.5,160,2.86,Nationals Park,5,-1
2014-09-08,2014,WSH,ATL,2,1,-152,-1.5,150,7.0,100,-120,137,1.5,-170,4.22,Nationals Park,3,1
2014-09-08,2014,BOS,BAL,0,4,-120,-1.5,180,8.5,-110,-110,110,1.5,-210,4.64,Fenway Park,4,-4
2014-09-08,2014,BAL,BOS,4,0,110,1.5,-210,8.5,-110,-110,-120,-1.5,180,4.05,Fenway Park,4,4
2014-09-08,2014,TOR,CHC,8,0,-215,-1.5,-110,8.0,100,-120,185,1.5,-110,5.46,Rogers Centre,8,8
2014-09-08,2014,STL,CIN,5,0,-127,-1.5,125,8.0,100,-120,117,1.5,-145,4.48,Great American Ballpark,5,5
2014-09-08,2014,LAA,CLE,12,3,114,1.5,-190,7.5,-105,-115,-124,-1.5,160,3.5,Progressive Field,15,9
2014-09-08,2014,NYM,COL,3,2,-145,-1.5,150,7.0,-105,-115,130,1.5,-170,4.14,Citi Field,5,1
2014-09-08,2014,OAK,CWS,4,5,-170,-1.5,-114,8.5,-125,105,150,1.5,-106,5.35,Guaranteed Rate Field,9,-1
2014-09-08,2014,KC,DET,5,9,125,1.5,-165,8.0,-120,100,-140,-1.5,145,3.56,Comerica Park,14,-4
2014-09-08,2014,SEA,HOU,4,1,-310,-1.5,-130,6.5,-120,100,260,1.5,110,4.91,T-Mobile Park,5,3
2014-09-08,2014,DET,KC,9,5,-140,-1.5,145,8.0,-120,100,125,1.5,-165,4.67,Comerica Park,14,4
2014-09-08,2014,CLE,LAA,3,12,-124,-1.5,160,7.5,-105,-115,114,1.5,-190,4.15,Progressive Field,15,-9
2014-09-08,2014,SD,LAD,4,9,285,1.5,110,6.0,110,-130,-335,-1.5,-130,1.56,Dodger Stadium,13,-5
2014-09-08,2014,MIL,MIA,4,6,-190,-1.5,110,8.5,-115,-105,170,1.5,-130,5.57,Miller Park,10,-2
2014-09-08,2014,MIA,MIL,6,4,170,1.5,-130,8.5,-115,-105,-190,-1.5,110,3.15,Miller Park,10,2
2014-09-08,2014,COL,NYM,2,3,130,1.5,-170,7.0,-105,-115,-145,-1.5,150,3.04,Citi Field,5,-1
2014-09-08,2014,CWS,OAK,5,4,150,1.5,-106,8.5,-125,105,-170,-1.5,-114,3.4,Guaranteed Rate Field,9,1
2014-09-08,2014,PIT,PHI,6,4,-120,-1.5,145,8.5,-105,-115,110,1.5,-165,4.64,Citizens Bank Park,10,2
2014-09-08,2014,PHI,PIT,4,6,110,1.5,-165,8.5,-105,-115,-120,-1.5,145,4.05,Citizens Bank Park,10,-2
2014-09-08,2014,LAD,SD,9,4,-335,-1.5,-130,6.0,110,-130,285,1.5,110,4.62,Dodger Stadium,13,5
2014-09-08,2014,HOU,SEA,1,4,260,1.5,110,6.5,-120,100,-310,-1.5,-130,1.81,T-Mobile Park,5,-3
2014-09-08,2014,CIN,STL,0,5,117,1.5,-145,8.0,100,-120,-127,-1.5,125,3.69,Great American Ballpark,5,-5
2014-09-08,2014,CHC,TOR,0,8,185,1.5,-110,8.0,100,-120,-215,-1.5,-110,2.81,Rogers Centre,8,-8
2014-09-08,2014,ATL,WSH,1,2,137,1.5,-170,7.0,100,-120,-152,-1.5,150,2.95,Nationals Park,3,-1
2014-09-09,2014,SF,ARI,5,1,-172,-1.5,145,6.5,105,-125,152,1.5,-165,4.11,AT&T Park,6,4
2014-09-09,2014,WSH,ATL,6,4,-156,-1.5,145,7.0,110,-130,141,1.5,-165,4.27,Nationals Park,10,2
2014-09-09,2014,BOS,BAL,1,4,114,1.5,-150,9.0,-105,-115,-124,-1.5,130,4.21,Fenway Park,5,-3
2014-09-09,2014,BAL,BOS,4,1,-124,-1.5,130,9.0,-105,-115,114,1.5,-150,4.98,Fenway Park,5,3
2014-09-09,2014,TOR,CHC,9,2,-135,-1.5,155,7.5,-110,-110,120,1.5,-175,4.31,Rogers Centre,11,7
2014-09-09,2014,STL,CIN,5,9,-140,-1.5,120,7.0,-105,-115,125,1.5,-140,4.08,Great American Ballpark,14,-4
2014-09-09,2014,MIN,CLE,4,3,151,1.5,-140,9.0,100,-120,-171,-1.5,120,3.59,Progressive Field,7,1
2014-09-09,2014,NYM,COL,2,0,-182,-1.5,120,7.0,105,-125,162,1.5,-140,4.52,Citi Field,2,2
2014-09-09,2014,OAK,CWS,11,2,-200,-1.5,-125,8.5,100,-120,170,1.5,105,5.67,Guaranteed Rate Field,13,9
2014-09-09,2014,KC,DET,2,4,150,1.5,-145,7.5,-115,-105,-170,-1.5,125,3.0,Comerica Park,6,-2
2014-09-09,2014,SEA,HOU,1,2,-145,-1.5,155,7.0,110,-130,130,1.5,-175,4.14,T-Mobile Park,3,-1
2014-09-09,2014,DET,KC,4,2,-170,-1.5,125,7.5,-115,-105,150,1.5,-145,4.72,Comerica Park,6,2
2014-09-09,2014,TEX,LAA,3,9,130,1.5,-125,9.5,103,-123,-145,-1.5,105,4.13,Rangers Ballpark,12,-6
2014-09-09,2014,SD,LAD,6,3,110,1.5,-215,7.0,-125,105,-120,-1.5,185,3.33,Dodger Stadium,9,3
2014-09-09,2014,MIL,MIA,3,6,-141,-1.5,155,8.0,-110,-110,126,1.5,-175,4.68,Miller Park,9,-3
2014-09-09,2014,MIA,MIL,6,3,126,1.5,-175,8.0,-110,-110,-141,-1.5,155,3.54,Miller Park,9,3
2014-09-09,2014,CLE,MIN,3,4,-171,-1.5,120,9.0,100,-120,151,1.5,-140,5.68,Progressive Field,7,-1
2014-09-09,2014,COL,NYM,0,2,162,1.5,-140,7.0,105,-125,-182,-1.5,120,2.67,Citi Field,2,-2
2014-09-09,2014,TB,NYY,4,3,117,1.5,-200,7.0,-115,-105,-127,-1.5,170,3.23,Yankee Stadium,7,1
2014-09-09,2014,CWS,OAK,2,11,170,1.5,105,8.5,100,-120,-200,-1.5,-125,3.15,Guaranteed Rate Field,13,-9
2014-09-09,2014,PIT,PHI,3,4,-134,-1.5,120,8.0,-120,100,119,1.5,-140,4.58,Citizens Bank Park,7,-1
2014-09-09,2014,PHI,PIT,4,3,119,1.5,-140,8.0,-120,100,-134,-1.5,120,3.65,Citizens Bank Park,7,1
2014-09-09,2014,LAD,SD,3,6,-120,-1.5,185,7.0,-125,105,110,1.5,-215,3.82,Dodger Stadium,9,-3
2014-09-09,2014,HOU,SEA,2,1,130,1.5,-175,7.0,110,-130,-145,-1.5,155,3.04,T-Mobile Park,3,1
2014-09-09,2014,ARI,SF,1,5,152,1.5,-165,6.5,105,-125,-172,-1.5,145,2.58,AT&T Park,6,-4
2014-09-09,2014,CIN,STL,9,5,125,1.5,-140,7.0,-105,-115,-140,-1.5,120,3.11,Great American Ballpark,14,4
2014-09-09,2014,NYY,TB,3,4,-127,-1.5,170,7.0,-115,-105,117,1.5,-200,3.92,Yankee Stadium,7,-1
2014-09-09,2014,LAA,TEX,9,3,-145,-1.5,105,9.5,103,-123,130,1.5,-125,5.62,Rangers Ballpark,12,6
2014-09-09,2014,CHC,TOR,2,9,120,1.5,-175,7.5,-110,-110,-135,-1.5,155,3.41,Rogers Centre,11,-7
2014-09-09,2014,ATL,WSH,4,6,141,1.5,-165,7.0,110,-130,-156,-1.5,145,2.9,Nationals Park,10,-2
2014-09-10,2014,SF,ARI,5,0,-150,-1.5,145,6.5,100,-120,135,1.5,-165,3.9,AT&T Park,5,5
2014-09-10,2014,WSH,ATL,2,6,-195,-1.5,110,7.0,-120,100,175,1.5,-130,4.63,Nationals Park,8,-4
2014-09-10,2014,BOS,BAL,6,10,116,1.5,-140,8.5,-105,-115,-131,-1.5,120,3.94,Fenway Park,16,-4
2014-09-10,2014,BAL,BOS,10,6,-131,-1.5,120,8.5,-105,-115,116,1.5,-140,4.82,Fenway Park,16,4
2014-09-10,2014,TOR,CHC,11,1,-178,-1.5,120,8.0,-110,-110,158,1.5,-140,5.12,Rogers Centre,12,10
2014-09-10,2014,STL,CIN,2,4,-134,-1.5,125,8.0,-110,-110,119,1.5,-145,4.58,Great American Ballpark,6,-2
2014-09-10,2014,NYM,COL,2,0,-123,-1.5,180,7.0,111,-131,113,1.5,-210,3.86,Citi Field,2,2
2014-09-10,2014,OAK,CWS,1,2,-205,-1.5,-135,8.5,-115,-105,175,1.5,115,5.71,Guaranteed Rate Field,3,-1
2014-09-10,2014,KC,DET,3,0,106,1.5,-202,8.5,-110,-110,-116,-1.5,173,4.13,Comerica Park,3,3
2014-09-10,2014,SEA,HOU,2,5,-255,-1.5,-120,7.0,105,-125,215,1.5,100,5.03,T-Mobile Park,7,-3
2014-09-10,2014,DET,KC,0,3,-116,-1.5,173,8.5,-110,-110,106,1.5,-202,4.56,Comerica Park,3,-3
2014-09-10,2014,TEX,LAA,1,8,178,1.5,105,9.5,-102,-118,-198,-1.5,-125,3.42,Rangers Ballpark,9,-7
2014-09-10,2014,SD,LAD,0,4,136,1.5,-160,7.0,-115,-105,-151,-1.5,140,2.97,Dodger Stadium,4,-4
2014-09-10,2014,MIL,MIA,4,1,-125,-1.5,170,8.0,-120,100,115,1.5,-200,4.44,Miller Park,5,3
2014-09-10,2014,MIA,MIL,1,4,115,1.5,-200,8.0,-120,100,-125,-1.5,170,3.72,Miller Park,5,-3
2014-09-10,2014,COL,NYM,0,2,113,1.5,-210,7.0,111,-131,-123,-1.5,180,3.29,Citi Field,2,-2
2014-09-10,2014,TB,NYY,5,8,-108,-1.5,150,7.5,108,-128,-102,1.5,-170,3.89,Yankee Stadium,13,-3
2014-09-10,2014,CWS,OAK,2,1,175,1.5,115,8.5,-115,-105,-205,-1.5,-135,3.09,Guaranteed Rate Field,3,1
2014-09-10,2014,PIT,PHI,6,3,-150,-1.5,110,8.5,-105,-115,135,1.5,-130,5.1,Citizens Bank Park,9,3
2014-09-10,2014,PHI,PIT,3,6,135,1.5,-130,8.5,-105,-115,-150,-1.5,110,3.62,Citizens Bank Park,9,-3
2014-09-10,2014,LAD,SD,4,0,-151,-1.5,140,7.0,-115,-105,136,1.5,-160,4.21,Dodger Stadium,4,4
2014-09-10,2014,HOU,SEA,5,2,215,1.5,100,7.0,105,-125,-255,-1.5,-120,2.22,T-Mobile Park,7,3
2014-09-10,2014,ARI,SF,0,5,135,1.5,-165,6.5,100,-120,-150,-1.5,145,2.77,AT&T Park,5,-5
2014-09-10,2014,CIN,STL,4,2,119,1.5,-145,8.0,-110,-110,-134,-1.5,125,3.65,Great American Ballpark,6,2
2014-09-10,2014,NYY,TB,8,5,-102,1.5,-170,7.5,108,-128,-108,-1.5,150,3.79,Yankee Stadium,13,3
2014-09-10,2014,LAA,TEX,8,1,-198,-1.5,-125,9.5,-102,-118,178,1.5,105,6.31,Rangers Ballpark,9,7
2014-09-10,2014,CHC,TOR,1,11,158,1.5,-140,8.0,-110,-110,-178,-1.5,120,3.1,Rogers Centre,12,-10
2014-09-10,2014,ATL,WSH,6,2,175,1.5,-130,7.0,-120,100,-195,-1.5,110,2.55,Nationals Park,8,4
2014-09-11,2014,SF,ARI,6,2,-205,-1.5,105,7.0,-110,-110,175,1.5,-125,4.7,AT&T Park,8,4
2014-09-11,2014,KC,BOS,3,6,-124,-1.5,160,7.0,-125,105,114,1.5,-190,3.88,Kauffman Stadium,9,-3
2014-09-11,2014,STL,CIN,0,1,102,1.5,-215,7.0,104,-124,-112,-1.5,185,3.47,Great American Ballpark,1,-1
2014-09-11,2014,MIN,CLE,2,8,183,1.5,-115,7.0,100,-120,-213,-1.5,-105,2.47,Progressive Field,10,-6
2014-09-11,2014,MIN,CLE,0,2,146,1.5,-147,8.0,100,-120,-161,-1.5,128,3.25,Progressive Field,2,-2
2014-09-11,2014,OAK,CWS,0,1,137,1.5,-189,7.0,100,-120,-152,-1.5,159,2.95,Guaranteed Rate Field,1,-1
2014-09-11,2014,BOS,KC,6,3,114,1.5,-190,7.0,-125,105,-124,-1.5,160,3.27,Kauffman Stadium,9,3
2014-09-11,2014,TEX,LAA,3,7,170,1.5,105,9.0,100,-120,-190,-1.5,-125,3.33,Rangers Ballpark,10,-4
2014-09-11,2014,MIL,MIA,4,2,-154,-1.5,135,7.0,-105,-115,139,1.5,-155,4.24,Miller Park,6,2
2014-09-11,2014,MIA,MIL,2,4,139,1.5,-155,7.0,-105,-115,-154,-1.5,135,2.93,Miller Park,6,-2
2014-09-11,2014,CLE,MIN,8,2,-213,-1.5,-105,7.0,100,-120,183,1.5,-115,4.76,Progressive Field,10,6
2014-09-11,2014,CLE,MIN,2,0,-161,-1.5,128,8.0,100,-120,146,1.5,-147,4.93,Progressive Field,2,2
2014-09-11,2014,WSH,NYM,6,2,-120,-1.5,135,7.0,100,-120,110,1.5,-155,3.82,Citi Field,8,4
2014-09-11,2014,TB,NYY,4,5,-105,-1.5,150,7.0,-110,-110,-105,1.5,-170,3.59,Yankee Stadium,9,-1
2014-09-11,2014,CWS,OAK,1,0,-152,-1.5,159,7.0,100,-120,137,1.5,-189,4.22,Guaranteed Rate Field,1,1
2014-09-11,2014,PIT,PHI,4,1,-140,-1.5,115,7.5,-103,-117,125,1.5,-135,4.38,Citizens Bank Park,5,3
2014-09-11,2014,PHI,PIT,1,4,125,1.5,-135,7.5,-103,-117,-140,-1.5,115,3.33,Citizens Bank Park,5,-3
2014-09-11,2014,ARI,SF,2,6,175,1.5,-125,7.0,-110,-110,-205,-1.5,105,2.55,AT&T Park,8,-4
2014-09-11,2014,CIN,STL,1,0,-112,-1.5,185,7.0,104,-124,102,1.5,-215,3.7,Great American Ballpark,1,1
2014-09-11,2014,NYY,TB,5,4,-105,1.5,-170,7.0,-110,-110,-105,-1.5,150,3.59,Yankee Stadium,9,1
2014-09-11,2014,LAA,TEX,7,3,-190,-1.5,-125,9.0,100,-120,170,1.5,105,5.9,Rangers Ballpark,10,4
2014-09-11,2014,NYM,WSH,2,6,110,1.5,-155,7.0,100,-120,-120,-1.5,135,3.33,Citi Field,8,-4
2014-09-12,2014,SD,ARI,6,5,119,1.5,-190,7.5,105,-125,-134,-1.5,160,3.42,Chase Field,11,1
2014-09-12,2014,TEX,ATL,2,1,112,1.5,-155,7.0,-120,100,-122,-1.5,135,3.3,Rangers Ballpark,3,1
2014-09-12,2014,NYY,BAL,1,2,111,1.5,-190,7.5,100,-120,-121,-1.5,160,3.55,Camden Yards,3,-1
2014-09-12,2014,NYY,BAL,0,5,145,1.5,-145,8.0,-105,-115,-160,-1.5,125,3.27,Camden Yards,5,-5
2014-09-12,2014,KC,BOS,2,4,-210,-1.5,-101,7.0,100,-120,180,1.5,-119,4.74,Kauffman Stadium,6,-2
2014-09-12,2014,PIT,CHC,7,3,-228,-1.5,-105,6.5,-123,103,198,1.5,-115,4.52,PNC Park,10,4
2014-09-12,2014,MIL,CIN,3,2,-190,-1.5,100,8.0,-110,-110,170,1.5,-120,5.24,Miller Park,5,1
2014-09-12,2014,DET,CLE,7,2,-155,-1.5,140,7.0,105,-125,140,1.5,-160,4.25,Comerica Park,9,5
2014-09-12,2014,STL,COL,5,1,-250,-1.5,-110,6.5,-115,-105,210,1.5,-110,4.64,Busch Stadium,6,4
2014-09-12,2014,CLE,DET,2,7,140,1.5,-160,7.0,105,-125,-155,-1.5,140,2.92,Comerica Park,9,-5
2014-09-12,2014,LAA,HOU,11,3,-190,-1.5,105,9.0,105,-125,170,1.5,-125,5.9,Angel Stadium,14,8
2014-09-12,2014,BOS,KC,4,2,180,1.5,-119,7.0,100,-120,-210,-1.5,-101,2.5,Kauffman Stadium,6,2
2014-09-12,2014,HOU,LAA,3,11,170,1.5,-125,9.0,105,-125,-190,-1.5,105,3.33,Angel Stadium,14,-8
2014-09-12,2014,SF,LAD,9,0,-124,-1.5,185,6.5,105,-125,114,1.5,-215,3.6,AT&T Park,9,9
2014-09-12,2014,PHI,MIA,3,1,-158,-1.5,145,6.5,-105,-115,143,1.5,-165,3.98,Citizens Bank Park,4,2
2014-09-12,2014,CIN,MIL,2,3,170,1.5,-120,8.0,-110,-110,-190,-1.5,100,2.96,Miller Park,5,-1
2014-09-12,2014,WSH,NYM,3,4,-144,-1.5,115,6.5,-120,100,129,1.5,-135,3.84,Citi Field,7,-1
2014-09-12,2014,BAL,NYY,2,1,-121,-1.5,160,7.5,100,-120,111,1.5,-190,4.11,Camden Yards,3,1
2014-09-12,2014,BAL,NYY,5,0,-160,-1.5,125,8.0,-105,-115,145,1.5,-145,4.92,Camden Yards,5,5
2014-09-12,2014,SEA,OAK,4,2,-144,-1.5,160,7.0,-101,-119,129,1.5,-190,4.13,T-Mobile Park,6,2
2014-09-12,2014,MIA,PHI,1,3,143,1.5,-165,6.5,-105,-115,-158,-1.5,145,2.67,Citizens Bank Park,4,-2
2014-09-12,2014,CHC,PIT,3,7,198,1.5,-115,6.5,-123,103,-228,-1.5,-105,2.18,PNC Park,10,-4
2014-09-12,2014,ARI,SD,5,6,-134,-1.5,160,7.5,105,-125,119,1.5,-190,4.29,Chase Field,11,-1
2014-09-12,2014,OAK,SEA,2,4,129,1.5,-190,7.0,-101,-119,-144,-1.5,160,3.06,T-Mobile Park,6,-2
2014-09-12,2014,LAD,SF,0,9,114,1.5,-215,6.5,105,-125,-124,-1.5,185,3.04,AT&T Park,9,-9
2014-09-12,2014,COL,STL,1,5,210,1.5,-110,6.5,-115,-105,-250,-1.5,-110,2.1,Busch Stadium,6,-4
2014-09-12,2014,TOR,TB,0,1,-130,-1.5,150,8.5,-125,105,115,1.5,-170,4.8,Rogers Centre,1,-1
2014-09-12,2014,ATL,TEX,1,2,-122,-1.5,135,7.0,-120,100,112,1.5,-155,3.85,Rangers Ballpark,3,-1
2014-09-12,2014,TB,TOR,1,0,115,1.5,-170,8.5,-125,105,-130,-1.5,150,3.95,Rogers Centre,1,1
2014-09-12,2014,NYM,WSH,4,3,129,1.5,-135,6.5,-120,100,-144,-1.5,115,2.84,Citi Field,7,1
2014-09-13,2014,SD,ARI,4,10,-110,-1.5,150,7.0,105,-125,100,1.5,-170,3.67,Chase Field,14,-6
2014-09-13,2014,TEX,ATL,3,2,146,1.5,-110,7.5,-110,-110,-161,-1.5,-110,3.05,Rangers Ballpark,5,1
2014-09-13,2014,NYY,BAL,3,2,115,1.5,-190,7.5,-105,-115,-130,-1.5,160,3.49,Camden Yards,5,1
2014-09-13,2014,KC,BOS,7,1,-141,-1.5,150,7.0,-115,-105,126,1.5,-170,4.1,Kauffman Stadium,8,6
2014-09-13,2014,PIT,CHC,4,6,-215,-1.5,-101,7.0,102,-122,185,1.5,-119,4.78,PNC Park,10,-2
2014-09-13,2014,MIL,CIN,1,5,-214,-1.5,-101,8.5,-112,-108,184,1.5,-119,5.79,Miller Park,6,-4
2014-09-13,2014,DET,CLE,5,4,-109,-1.5,185,8.0,-106,-114,-101,1.5,-215,4.17,Comerica Park,9,1
2014-09-13,2014,STL,COL,5,4,-190,-1.5,110,7.0,102,-122,170,1.5,-130,4.59,Busch Stadium,9,1
2014-09-13,2014,MIN,CWS,1,5,-105,1.5,-230,7.0,110,-130,-105,-1.5,190,3.59,Guaranteed Rate Field,6,-4
2014-09-13,2014,MIN,CWS,6,7,113,1.5,-200,8.5,-110,-110,-123,-1.5,170,3.99,Guaranteed Rate Field,13,-1
2014-09-13,2014,CLE,DET,4,5,-101,1.5,-215,8.0,-106,-114,-109,-1.5,185,4.02,Comerica Park,9,-1
2014-09-13,2014,LAA,HOU,5,2,-235,-1.5,-119,8.5,-110,-110,205,1.5,-101,5.96,Angel Stadium,7,3
2014-09-13,2014,BOS,KC,1,7,126,1.5,-170,7.0,-115,-105,-141,-1.5,150,3.1,Kauffman Stadium,8,-6
2014-09-13,2014,HOU,LAA,2,5,205,1.5,-101,8.5,-110,-110,-235,-1.5,-119,2.79,Angel Stadium,7,-3
2014-09-13,2014,SF,LAD,0,17,102,1.5,-170,6.5,-110,-110,-112,-1.5,150,3.22,AT&T Park,17,-17
2014-09-13,2014,PHI,MIA,2,1,-117,-1.5,175,7.5,100,-120,107,1.5,-205,4.04,Citizens Bank Park,3,1
2014-09-13,2014,CIN,MIL,5,1,184,1.5,-119,8.5,-112,-108,-214,-1.5,-101,2.99,Miller Park,6,4
2014-09-13,2014,CWS,MIN,5,1,-105,-1.5,190,7.0,110,-130,-105,1.5,-230,3.59,Guaranteed Rate Field,6,4
2014-09-13,2014,CWS,MIN,7,6,-123,-1.5,170,8.5,-110,-110,113,1.5,-200,4.69,Guaranteed Rate Field,13,1
2014-09-13,2014,WSH,NYM,10,3,-130,-1.5,130,6.5,-105,-115,115,1.5,-145,3.67,Citi Field,13,7
2014-09-13,2014,BAL,NYY,2,3,-130,-1.5,160,7.5,-105,-115,115,1.5,-190,4.24,Camden Yards,5,-1
2014-09-13,2014,SEA,OAK,2,3,-156,-1.5,150,6.0,-120,100,141,1.5,-170,3.66,T-Mobile Park,5,-1
2014-09-13,2014,MIA,PHI,1,2,107,1.5,-205,7.5,100,-120,-117,-1.5,175,3.62,Citizens Bank Park,3,-1
2014-09-13,2014,CHC,PIT,6,4,185,1.5,-119,7.0,102,-122,-215,-1.5,-101,2.46,PNC Park,10,2
2014-09-13,2014,ARI,SD,10,4,100,1.5,-170,7.0,105,-125,-110,-1.5,150,3.5,Chase Field,14,6
2014-09-13,2014,OAK,SEA,3,2,141,1.5,-170,6.0,-120,100,-156,-1.5,150,2.49,T-Mobile Park,5,1
2014-09-13,2014,LAD,SF,17,0,-112,-1.5,150,6.5,-110,-110,102,1.5,-170,3.43,AT&T Park,17,17
2014-09-13,2014,COL,STL,4,5,170,1.5,-130,7.0,102,-122,-190,-1.5,110,2.59,Busch Stadium,9,-1
2014-09-13,2014,TOR,TB,6,3,-123,-1.5,165,8.0,100,-120,113,1.5,-195,4.41,Rogers Centre,9,3
2014-09-13,2014,ATL,TEX,2,3,-161,-1.5,-110,7.5,-110,-110,146,1.5,-110,4.63,Rangers Ballpark,5,-1
2014-09-13,2014,TB,TOR,3,6,113,1.5,-195,8.0,100,-120,-123,-1.5,165,3.76,Rogers Centre,9,-3
2014-09-13,2014,NYM,WSH,3,10,115,1.5,-145,6.5,-105,-115,-130,-1.5,130,3.02,Citi Field,13,-7
2014-09-14,2014,SD,ARI,6,8,107,1.5,-210,8.0,100,-120,-117,-1.5,180,3.86,Chase Field,14,-2
2014-09-14,2014,TEX,ATL,10,3,118,1.5,-145,7.5,-116,-104,-128,-1.5,125,3.44,Rangers Ballpark,13,7
2014-09-14,2014,NYY,BAL,2,3,115,1.5,-200,7.0,-115,-105,-125,-1.5,170,3.26,Camden Yards,5,-1
2014-09-14,2014,KC,BOS,4,8,-160,-1.5,125,7.0,-127,107,145,1.5,-145,4.31,Kauffman Stadium,12,-4
2014-09-14,2014,PIT,CHC,7,3,-205,-1.5,105,7.0,-120,100,175,1.5,-125,4.7,PNC Park,10,4
2014-09-14,2014,MIL,CIN,9,2,-150,-1.5,140,7.5,-105,-115,135,1.5,-160,4.5,Miller Park,11,7
2014-09-14,2014,DET,CLE,6,4,-134,-1.5,155,8.0,-120,100,119,1.5,-175,4.58,Comerica Park,10,2
2014-09-14,2014,STL,COL,4,1,-181,-1.5,115,7.5,-108,-112,161,1.5,-135,4.83,Busch Stadium,5,3
2014-09-14,2014,MIN,CWS,6,4,118,1.5,-194,8.5,-108,-112,-128,-1.5,163,3.9,Guaranteed Rate Field,10,2
2014-09-14,2014,CLE,DET,4,6,119,1.5,-175,8.0,-120,100,-134,-1.5,155,3.65,Comerica Park,10,-2
2014-09-14,2014,LAA,HOU,1,6,-164,-1.5,125,8.5,-110,-110,149,1.5,-145,5.28,Angel Stadium,7,-5
2014-09-14,2014,BOS,KC,8,4,145,1.5,-145,7.0,-127,107,-160,-1.5,125,2.86,Kauffman Stadium,12,4
2014-09-14,2014,HOU,LAA,6,1,149,1.5,-145,8.5,-110,-110,-164,-1.5,125,3.41,Angel Stadium,7,5
2014-09-14,2014,SF,LAD,2,4,155,1.5,-120,5.5,-105,-115,-175,-1.5,100,2.16,AT&T Park,6,-2
2014-09-14,2014,PHI,MIA,4,5,-105,-1.5,190,7.0,-125,105,-105,1.5,-230,3.59,Citizens Bank Park,9,-1
2014-09-14,2014,CIN,MIL,2,9,135,1.5,-160,7.5,-105,-115,-150,-1.5,140,3.19,Miller Park,11,-7
2014-09-14,2014,CWS,MIN,4,6,-128,-1.5,163,8.5,-108,-112,118,1.5,-194,4.77,Guaranteed Rate Field,10,-2
2014-09-14,2014,WSH,NYM,3,0,-163,-1.5,-101,6.0,-120,100,148,1.5,-119,3.72,Citi Field,3,3
2014-09-14,2014,BAL,NYY,3,2,-125,-1.5,170,7.0,-115,-105,115,1.5,-200,3.89,Camden Yards,5,1
2014-09-14,2014,SEA,OAK,0,4,144,1.5,-120,7.0,-110,-110,-159,-1.5,100,2.87,T-Mobile Park,4,-4
2014-09-14,2014,MIA,PHI,5,4,-105,1.5,-230,7.0,-125,105,-105,-1.5,190,3.59,Citizens Bank Park,9,1
2014-09-14,2014,CHC,PIT,3,7,175,1.5,-125,7.0,-120,100,-205,-1.5,105,2.55,PNC Park,10,-4
2014-09-14,2014,ARI,SD,8,6,-117,-1.5,180,8.0,100,-120,107,1.5,-210,4.31,Chase Field,14,2
2014-09-14,2014,OAK,SEA,4,0,-159,-1.5,100,7.0,-110,-110,144,1.5,-120,4.3,T-Mobile Park,4,4
2014-09-14,2014,LAD,SF,4,2,-175,-1.5,100,5.5,-105,-115,155,1.5,-120,3.5,AT&T Park,6,2
2014-09-14,2014,COL,STL,1,4,161,1.5,-135,7.5,-108,-112,-181,-1.5,115,2.87,Busch Stadium,5,-3
2014-09-14,2014,TOR,TB,5,6,-115,-1.5,180,8.0,101,-121,105,1.5,-210,4.28,Rogers Centre,11,-1
2014-09-14,2014,ATL,TEX,3,10,-128,-1.5,125,7.5,-116,-104,118,1.5,-145,4.21,Rangers Ballpark,13,-7
2014-09-14,2014,TB,TOR,6,5,105,1.5,-210,8.0,101,-121,-115,-1.5,180,3.9,Rogers Centre,11,1
2014-09-14,2014,NYM,WSH,0,3,148,1.5,-119,6.0,-120,100,-163,-1.5,-101,2.42,Citi Field,3,-3
2014-09-15,2014,SF,ARI,2,6,-105,-1.5,145,8.0,100,-120,-105,1.5,-165,4.1,Chase Field,8,-4
2014-09-15,2014,WSH,ATL,4,2,-144,-1.5,115,6.5,-107,-113,129,1.5,-135,3.84,Turner Field,6,2
2014-09-15,2014,TOR,BAL,2,5,111,1.5,-200,7.5,100,-120,-121,-1.5,170,3.55,Camden Yards,7,-3
2014-09-15,2014,CIN,CHC,0,1,118,1.5,-200,7.0,-120,100,-128,-1.5,170,3.21,Wrigley Field,1,-1
2014-09-15,2014,CHC,CIN,1,0,-128,-1.5,170,7.0,-120,100,118,1.5,-200,3.93,Wrigley Field,1,1
2014-09-15,2014,HOU,CLE,3,1,-122,-1.5,165,8.0,-105,-115,112,1.5,-195,4.4,Minute Maid Park,4,2
2014-09-15,2014,LAD,COL,11,3,-125,-1.5,125,11.0,-125,105,115,1.5,-145,6.11,Coors Field,14,8
2014-09-15,2014,KC,CWS,4,3,-235,-1.5,-120,7.0,-110,-110,205,1.5,100,4.91,Kauffman Stadium,7,1
2014-09-15,2014,MIN,DET,6,8,158,1.5,-101,7.5,-105,-115,-178,-1.5,-119,2.91,Target Field,14,-2
2014-09-15,2014,CLE,HOU,1,3,112,1.5,-195,8.0,-105,-115,-122,-1.5,165,3.77,Minute Maid Park,4,-2
2014-09-15,2014,CWS,KC,3,4,205,1.5,100,7.0,-110,-110,-235,-1.5,-120,2.3,Kauffman Stadium,7,-1
2014-09-15,2014,SEA,LAA,1,8,101,1.5,-215,7.5,-105,-115,-111,-1.5,185,3.73,Angel Stadium,9,-7
2014-09-15,2014,COL,LAD,3,11,115,1.5,-145,11.0,-125,105,-125,-1.5,125,5.12,Coors Field,14,-8
2014-09-15,2014,NYM,MIA,5,6,-160,-1.5,155,6.0,-110,-110,145,1.5,-175,3.69,Citi Field,11,-1
2014-09-15,2014,DET,MIN,8,6,-178,-1.5,-119,7.5,-105,-115,158,1.5,-101,4.8,Target Field,14,2
2014-09-15,2014,MIA,NYM,6,5,145,1.5,-175,6.0,-110,-110,-160,-1.5,155,2.45,Citi Field,11,1
2014-09-15,2014,TB,NYY,1,0,-110,-1.5,185,7.5,107,-127,100,1.5,-215,3.93,Tropicana Field,1,1
2014-09-15,2014,SD,PHI,1,0,-180,-1.5,125,6.5,-120,100,160,1.5,-145,4.18,PETCO Park,1,1
2014-09-15,2014,PHI,SD,0,1,160,1.5,-145,6.5,-120,100,-180,-1.5,125,2.5,PETCO Park,1,-1
2014-09-15,2014,LAA,SEA,8,1,-111,-1.5,185,7.5,-105,-115,101,1.5,-215,3.95,Angel Stadium,9,7
2014-09-15,2014,ARI,SF,6,2,-105,1.5,-165,8.0,100,-120,-105,-1.5,145,4.1,Chase Field,8,4
2014-09-15,2014,NYY,TB,0,1,100,1.5,-215,7.5,107,-127,-110,-1.5,185,3.75,Tropicana Field,1,-1
2014-09-15,2014,BAL,TOR,5,2,-121,-1.5,170,7.5,100,-120,111,1.5,-200,4.11,Camden Yards,7,3
2014-09-15,2014,ATL,WSH,2,4,129,1.5,-135,6.5,-107,-113,-144,-1.5,115,2.84,Turner Field,6,-2
2014-09-16,2014,SF,ARI,2,1,-120,-1.5,135,7.5,-105,-115,110,1.5,-155,4.09,Chase Field,3,1
2014-09-16,2014,WSH,ATL,3,0,-125,-1.5,130,7.5,108,-128,115,1.5,-150,4.17,Turner Field,3,3
2014-09-16,2014,TOR,BAL,2,8,-105,1.5,-210,8.0,-101,-119,-105,-1.5,180,4.1,Camden Yards,10,-6
2014-09-16,2014,PIT,BOS,4,0,-190,-1.5,105,7.5,-125,105,170,1.5,-125,4.91,PNC Park,4,4
2014-09-16,2014,CIN,CHC,0,7,-114,-1.5,160,6.0,100,-120,104,1.5,-190,3.2,Wrigley Field,7,-7
2014-09-16,2014,CHC,CIN,7,0,104,1.5,-190,6.0,100,-120,-114,-1.5,160,2.94,Wrigley Field,7,7
2014-09-16,2014,HOU,CLE,2,4,160,1.5,-101,7.5,-105,-115,-180,-1.5,-119,2.88,Minute Maid Park,6,-2
2014-09-16,2014,LAD,COL,4,10,-123,-1.5,120,11.0,104,-124,113,1.5,-140,6.07,Coors Field,14,-6
2014-09-16,2014,KC,CWS,5,7,-180,-1.5,115,7.5,-115,-105,160,1.5,-135,4.82,Kauffman Stadium,12,-2
2014-09-16,2014,MIN,DET,4,3,117,1.5,-155,8.0,-110,-110,-127,-1.5,135,3.69,Target Field,7,1
2014-09-16,2014,CLE,HOU,4,2,-180,-1.5,-119,7.5,-105,-115,160,1.5,-101,4.82,Minute Maid Park,6,2
2014-09-16,2014,CWS,KC,7,5,160,1.5,-135,7.5,-115,-105,-180,-1.5,115,2.88,Kauffman Stadium,12,2
2014-09-16,2014,SEA,LAA,13,2,130,1.5,-165,8.5,-120,100,-145,-1.5,145,3.7,Angel Stadium,15,11
2014-09-16,2014,COL,LAD,10,4,113,1.5,-140,11.0,104,-124,-123,-1.5,120,5.16,Coors Field,14,6
2014-09-16,2014,NYM,MIA,9,1,-143,-1.5,160,6.5,-105,-115,128,1.5,-190,3.83,Citi Field,10,8
2014-09-16,2014,STL,MIL,2,3,-155,-1.5,145,7.0,105,-125,140,1.5,-165,4.25,Busch Stadium,5,-1
2014-09-16,2014,DET,MIN,3,4,-127,-1.5,135,8.0,-110,-110,117,1.5,-155,4.48,Target Field,7,-1
2014-09-16,2014,MIA,NYM,1,9,128,1.5,-190,6.5,-105,-115,-143,-1.5,160,2.85,Citi Field,10,-8
2014-09-16,2014,TB,NYY,6,1,-130,-1.5,175,6.5,-120,100,115,1.5,-205,3.67,Tropicana Field,7,5
2014-09-16,2014,TEX,OAK,6,3,225,1.5,100,7.0,-125,105,-265,-1.5,-120,2.15,Oakland Coliseum,9,3
2014-09-16,2014,SD,PHI,5,4,-140,-1.5,170,6.5,-120,100,125,1.5,-200,3.79,PETCO Park,9,1
2014-09-16,2014,BOS,PIT,0,4,170,1.5,-125,7.5,-125,105,-190,-1.5,105,2.78,PNC Park,4,-4
2014-09-16,2014,PHI,SD,4,5,125,1.5,-200,6.5,-120,100,-140,-1.5,170,2.89,PETCO Park,9,-1
2014-09-16,2014,LAA,SEA,2,13,-145,-1.5,145,8.5,-120,100,130,1.5,-165,5.03,Angel Stadium,15,-11
2014-09-16,2014,ARI,SF,1,2,110,1.5,-155,7.5,-105,-115,-120,-1.5,135,3.57,Chase Field,3,-1
2014-09-16,2014,MIL,STL,3,2,140,1.5,-165,7.0,105,-125,-155,-1.5,145,2.92,Busch Stadium,5,1
2014-09-16,2014,NYY,TB,1,6,115,1.5,-205,6.5,-120,100,-130,-1.5,175,3.02,Tropicana Field,7,-5
2014-09-16,2014,OAK,TEX,3,6,-265,-1.5,-120,7.0,-125,105,225,1.5,100,5.08,Oakland Coliseum,9,-3
2014-09-16,2014,BAL,TOR,8,2,-105,-1.5,180,8.0,-101,-119,-105,1.5,-210,4.1,Camden Yards,10,6
2014-09-16,2014,ATL,WSH,0,3,115,1.5,-150,7.5,108,-128,-125,-1.5,130,3.49,Turner Field,3,-3
2014-09-17,2014,SF,ARI,4,2,-191,-1.5,-119,7.0,-130,110,171,1.5,-101,4.59,Chase Field,6,2
2014-09-17,2014,WSH,ATL,1,3,164,1.5,-135,6.5,-110,-110,-184,-1.5,115,2.46,Turner Field,4,-2
2014-09-17,2014,TOR,BAL,1,6,115,1.5,-195,8.0,100,-120,-125,-1.5,165,3.72,Camden Yards,7,-5
2014-09-17,2014,PIT,BOS,9,1,-175,-1.5,120,6.5,-125,105,155,1.5,-140,4.14,PNC Park,10,8
2014-09-17,2014,CIN,CHC,1,3,175,1.5,-130,7.0,-125,105,-195,-1.5,110,2.55,Wrigley Field,4,-2
2014-09-17,2014,CHC,CIN,3,1,-195,-1.5,110,7.0,-125,105,175,1.5,-130,4.63,Wrigley Field,4,2
2014-09-17,2014,HOU,CLE,0,2,112,1.5,-160,7.5,-110,-110,-122,-1.5,140,3.54,Minute Maid Park,2,-2
2014-09-17,2014,LAD,COL,2,16,100,1.5,-195,10.5,100,-120,-110,-1.5,165,5.25,Coors Field,18,-14
2014-09-17,2014,KC,CWS,6,2,-107,-1.5,190,6.5,105,-125,-103,1.5,-230,3.36,Kauffman Stadium,8,4
2014-09-17,2014,MIN,DET,8,4,152,1.5,-110,7.5,-110,-110,-172,-1.5,-110,2.98,Target Field,12,4
2014-09-17,2014,CLE,HOU,2,0,-122,-1.5,140,7.5,-110,-110,112,1.5,-160,4.12,Minute Maid Park,2,2
2014-09-17,2014,CWS,KC,2,6,-103,1.5,-230,6.5,105,-125,-107,-1.5,190,3.3,Kauffman Stadium,8,-4
2014-09-17,2014,SEA,LAA,0,5,110,1.5,-215,8.0,-105,-115,-120,-1.5,185,3.81,Angel Stadium,5,-5
2014-09-17,2014,COL,LAD,16,2,-110,-1.5,165,10.5,100,-120,100,1.5,-195,5.5,Coors Field,18,14
2014-09-17,2014,NYM,MIA,3,4,-129,-1.5,170,6.5,-122,102,119,1.5,-200,3.66,Citi Field,7,-1
2014-09-17,2014,STL,MIL,2,0,-150,-1.5,150,6.5,109,-129,135,1.5,-170,3.9,Busch Stadium,2,2
2014-09-17,2014,DET,MIN,4,8,-172,-1.5,-110,7.5,-110,-110,152,1.5,-110,4.74,Target Field,12,-4
2014-09-17,2014,MIA,NYM,4,3,119,1.5,-200,6.5,-122,102,-129,-1.5,170,2.97,Citi Field,7,1
2014-09-17,2014,TB,NYY,2,3,-139,-1.5,167,6.0,-120,100,124,1.5,-197,3.49,Tropicana Field,5,-1
2014-09-17,2014,TEX,OAK,6,1,170,1.5,-140,6.0,-110,-110,-190,-1.5,120,2.22,Oakland Coliseum,7,5
2014-09-17,2014,SD,PHI,2,5,132,1.5,-135,6.0,-115,-105,-147,-1.5,115,2.59,PETCO Park,7,-3
2014-09-17,2014,BOS,PIT,1,9,155,1.5,-140,6.5,-125,105,-175,-1.5,120,2.55,PNC Park,10,-8
2014-09-17,2014,PHI,SD,5,2,-147,-1.5,115,6.0,-115,-105,132,1.5,-135,3.57,PETCO Park,7,3
2014-09-17,2014,LAA,SEA,5,0,-120,-1.5,185,8.0,-105,-115,110,1.5,-215,4.36,Angel Stadium,5,5
2014-09-17,2014,ARI,SF,2,4,171,1.5,-101,7.0,-130,110,-191,-1.5,-119,2.58,Chase Field,6,-2
2014-09-17,2014,MIL,STL,0,2,135,1.5,-170,6.5,109,-129,-150,-1.5,150,2.77,Busch Stadium,2,-2
2014-09-17,2014,NYY,TB,3,2,124,1.5,-197,6.0,-120,100,-139,-1.5,167,2.68,Tropicana Field,5,1
2014-09-17,2014,OAK,TEX,1,6,-190,-1.5,120,6.0,-110,-110,170,1.5,-140,3.93,Oakland Coliseum,7,-5
2014-09-17,2014,BAL,TOR,6,1,-125,-1.5,165,8.0,100,-120,115,1.5,-195,4.44,Camden Yards,7,5
2014-09-17,2014,ATL,WSH,3,1,-184,-1.5,115,6.5,-110,-110,164,1.5,-135,4.21,Turner Field,4,2
2014-09-18,2014,COL,ARI,7,6,-121,-1.5,155,10.0,-120,100,111,1.5,-175,5.48,Coors Field,13,1
2014-09-18,2014,PIT,BOS,3,2,-245,-1.5,-115,7.5,100,-120,205,1.5,-105,5.33,PNC Park,5,1
2014-09-18,2014,LAD,CHC,8,4,-191,-1.5,-119,6.5,-120,100,171,1.5,-101,4.27,Wrigley Field,12,4
2014-09-18,2014,HOU,CLE,1,2,125,1.5,-135,8.0,-105,-115,-140,-1.5,115,3.56,Minute Maid Park,3,-1
2014-09-18,2014,ARI,COL,6,7,111,1.5,-175,10.0,-120,100,-121,-1.5,155,4.74,Coors Field,13,-1
2014-09-18,2014,CLE,HOU,2,1,-140,-1.5,115,8.0,-105,-115,125,1.5,-135,4.67,Minute Maid Park,3,1
2014-09-18,2014,SEA,LAA,3,1,-265,-1.5,-145,6.5,-110,-110,225,1.5,125,4.72,Angel Stadium,4,2
2014-09-18,2014,CHC,LAD,4,8,171,1.5,-101,6.5,-120,100,-191,-1.5,-119,2.4,Wrigley Field,12,-4
2014-09-18,2014,WSH,MIA,6,2,-162,-1.5,-105,7.0,-110,-110,147,1.5,-115,4.33,Marlins Park,8,4
2014-09-18,2014,STL,MIL,3,2,-134,-1.5,165,7.5,-110,-110,119,1.5,-195,4.29,Busch Stadium,5,1
2014-09-18,2014,TOR,NYY,2,3,115,1.5,-190,7.5,100,-120,-125,-1.5,160,3.49,Yankee Stadium,5,-1
2014-09-18,2014,TEX,OAK,7,2,255,1.5,110,7.5,-110,-110,-295,-1.5,-130,2.11,Oakland Coliseum,9,5
2014-09-18,2014,SD,PHI,7,3,-161,-1.5,145,6.5,-125,105,146,1.5,-165,4.01,PETCO Park,10,4
2014-09-18,2014,BOS,PIT,2,3,205,1.5,-105,7.5,100,-120,-245,-1.5,-115,2.46,PNC Park,5,-1
2014-09-18,2014,PHI,SD,3,7,146,1.5,-165,6.5,-125,105,-161,-1.5,145,2.64,PETCO Park,10,-4
2014-09-18,2014,LAA,SEA,1,3,225,1.5,125,6.5,-110,-110,-265,-1.5,-145,2.0,Angel Stadium,4,-2
2014-09-18,2014,MIL,STL,2,3,119,1.5,-195,7.5,-110,-110,-134,-1.5,165,3.42,Busch Stadium,5,-1
2014-09-18,2014,OAK,TEX,2,7,-295,-1.5,-130,7.5,-110,-110,255,1.5,110,5.6,Oakland Coliseum,9,-5
2014-09-18,2014,NYY,TOR,3,2,-125,-1.5,160,7.5,100,-120,115,1.5,-190,4.17,Yankee Stadium,5,1
2014-09-18,2014,MIA,WSH,2,6,147,1.5,-115,7.0,-110,-110,-162,-1.5,-105,2.83,Marlins Park,8,-4
2014-09-19,2014,COL,ARI,15,3,-113,-1.5,165,10.5,-110,-110,103,1.5,-195,5.57,Coors Field,18,12
2014-09-19,2014,NYM,ATL,5,0,125,1.5,-200,6.5,-105,-115,-140,-1.5,170,2.89,Turner Field,5,5
2014-09-19,2014,BOS,BAL,5,3,145,1.5,-150,7.5,-113,-107,-160,-1.5,130,3.06,Camden Yards,8,2
2014-09-19,2014,BAL,BOS,3,5,-160,-1.5,130,7.5,-113,-107,145,1.5,-150,4.62,Camden Yards,8,-2
2014-09-19,2014,LAD,CHC,14,5,-350,-1.5,-190,7.5,-110,-110,290,1.5,160,5.83,Wrigley Field,19,9
2014-09-19,2014,STL,CIN,2,1,-235,-1.5,-115,7.5,-105,-115,205,1.5,-105,5.26,Busch Stadium,3,1
2014-09-19,2014,MIN,CLE,5,4,-145,-1.5,140,8.0,-120,100,130,1.5,-160,4.73,Target Field,9,1
2014-09-19,2014,ARI,COL,3,15,103,1.5,-195,10.5,-110,-110,-113,-1.5,165,5.17,Coors Field,18,-12
2014-09-19,2014,TB,CWS,3,4,-132,-1.5,170,7.0,105,-125,117,1.5,-200,3.98,Tropicana Field,7,-1
2014-09-19,2014,KC,DET,1,10,-124,-1.5,160,8.0,-105,-115,114,1.5,-190,4.43,Kauffman Stadium,11,-9
2014-09-19,2014,SEA,HOU,10,5,-155,-1.5,105,8.5,100,-120,140,1.5,-125,5.17,Minute Maid Park,15,5
2014-09-19,2014,DET,KC,10,1,114,1.5,-190,8.0,-105,-115,-124,-1.5,160,3.74,Kauffman Stadium,11,9
2014-09-19,2014,TEX,LAA,12,3,171,1.5,-115,8.0,-105,-115,-201,-1.5,-105,2.95,Angel Stadium,15,9
2014-09-19,2014,CHC,LAD,5,14,290,1.5,160,7.5,-110,-110,-350,-1.5,-190,1.92,Wrigley Field,19,-9
2014-09-19,2014,WSH,MIA,3,2,-158,-1.5,105,7.5,105,-125,143,1.5,-125,4.59,Marlins Park,5,1
2014-09-19,2014,PIT,MIL,4,2,-125,-1.5,170,7.5,-105,-115,115,1.5,-200,4.17,PNC Park,6,2
2014-09-19,2014,CLE,MIN,4,5,130,1.5,-160,8.0,-120,100,-145,-1.5,140,3.48,Target Field,9,-1
2014-09-19,2014,ATL,NYM,0,5,-140,-1.5,170,6.5,-105,-115,125,1.5,-200,3.79,Turner Field,5,-5
2014-09-19,2014,TOR,NYY,3,5,126,1.5,-175,7.0,-125,105,-141,-1.5,155,3.1,Yankee Stadium,8,-2
2014-09-19,2014,PHI,OAK,1,3,255,1.5,110,7.0,-115,-105,-295,-1.5,-130,1.97,Oakland Coliseum,4,-2
2014-09-19,2014,OAK,PHI,3,1,-295,-1.5,-130,7.0,-115,-105,255,1.5,110,5.23,Oakland Coliseum,4,2
2014-09-19,2014,MIL,PIT,2,4,115,1.5,-200,7.5,-105,-115,-125,-1.5,170,3.49,PNC Park,6,-2
2014-09-19,2014,SF,SD,0,5,-125,-1.5,130,6.5,-120,100,115,1.5,-150,3.61,PETCO Park,5,-5
2014-09-19,2014,HOU,SEA,5,10,140,1.5,-125,8.5,100,-120,-155,-1.5,105,3.54,Minute Maid Park,15,-5
2014-09-19,2014,SD,SF,5,0,115,1.5,-150,6.5,-120,100,-125,-1.5,130,3.02,PETCO Park,5,5
2014-09-19,2014,CIN,STL,1,2,205,1.5,-105,7.5,-105,-115,-235,-1.5,-115,2.46,Busch Stadium,3,-1
2014-09-19,2014,CWS,TB,4,3,117,1.5,-200,7.0,105,-125,-132,-1.5,170,3.23,Tropicana Field,7,1
2014-09-19,2014,LAA,TEX,3,12,-201,-1.5,-105,8.0,-105,-115,171,1.5,-115,5.34,Angel Stadium,15,-9
2014-09-19,2014,NYY,TOR,5,3,-141,-1.5,155,7.0,-125,105,126,1.5,-175,4.1,Yankee Stadium,8,2
2014-09-19,2014,MIA,WSH,2,3,143,1.5,-125,7.5,105,-125,-158,-1.5,105,3.09,Marlins Park,5,-1
2014-09-20,2014,COL,ARI,5,1,-113,-1.5,165,10.5,-115,-105,103,1.5,-195,5.57,Coors Field,6,4
2014-09-20,2014,NYM,ATL,4,2,118,1.5,-200,7.0,-110,-110,-128,-1.5,170,3.21,Turner Field,6,2
2014-09-20,2014,BOS,BAL,2,7,140,1.5,-150,8.0,-105,-115,-155,-1.5,130,3.33,Camden Yards,9,-5
2014-09-20,2014,BAL,BOS,7,2,-155,-1.5,130,8.0,-105,-115,140,1.5,-150,4.86,Camden Yards,9,5
2014-09-20,2014,LAD,CHC,7,8,-121,-1.5,125,10.5,-125,105,111,1.5,-145,5.75,Wrigley Field,15,-1
2014-09-20,2014,STL,CIN,8,4,-150,-1.5,140,7.0,-120,100,135,1.5,-160,4.2,Busch Stadium,12,4
2014-09-20,2014,MIN,CLE,3,7,107,1.5,-155,8.5,-110,-110,-117,-1.5,135,4.11,Target Field,10,-4
2014-09-20,2014,ARI,COL,1,5,103,1.5,-195,10.5,-115,-105,-113,-1.5,165,5.17,Coors Field,6,-4
2014-09-20,2014,TB,CWS,3,1,-170,-1.5,125,7.0,-120,100,150,1.5,-145,4.41,Tropicana Field,4,2
2014-09-20,2014,KC,DET,2,3,-107,-1.5,190,7.0,-110,-110,-103,1.5,-230,3.62,Kauffman Stadium,5,-1
2014-09-20,2014,SEA,HOU,1,10,104,1.5,-215,7.5,-115,-105,-114,-1.5,185,3.68,Minute Maid Park,11,-9
2014-09-20,2014,DET,KC,3,2,-103,1.5,-230,7.0,-110,-110,-107,-1.5,190,3.55,Kauffman Stadium,5,1
2014-09-20,2014,TEX,LAA,5,8,190,1.5,-110,8.0,100,-120,-220,-1.5,-110,2.76,Angel Stadium,13,-3
2014-09-20,2014,CHC,LAD,8,7,111,1.5,-145,10.5,-125,105,-121,-1.5,125,4.98,Wrigley Field,15,1
2014-09-20,2014,WSH,MIA,3,2,-180,-1.5,-115,6.5,-118,-102,160,1.5,-105,4.18,Marlins Park,5,1
2014-09-20,2014,PIT,MIL,0,1,-123,-1.5,165,7.5,-110,-110,113,1.5,-195,4.14,PNC Park,1,-1
2014-09-20,2014,CLE,MIN,7,3,-117,-1.5,135,8.5,-110,-110,107,1.5,-155,4.58,Target Field,10,4
2014-09-20,2014,ATL,NYM,2,4,-128,-1.5,170,7.0,-110,-110,118,1.5,-200,3.93,Turner Field,6,-2
2014-09-20,2014,TOR,NYY,6,3,-124,-1.5,135,8.0,100,-120,114,1.5,-155,4.43,Yankee Stadium,9,3
2014-09-20,2014,PHI,OAK,3,0,205,1.5,100,8.0,-105,-115,-245,-1.5,-120,2.62,Oakland Coliseum,3,3
2014-09-20,2014,OAK,PHI,0,3,-245,-1.5,-120,8.0,-105,-115,205,1.5,100,5.68,Oakland Coliseum,3,-3
2014-09-20,2014,MIL,PIT,1,0,113,1.5,-195,7.5,-110,-110,-123,-1.5,165,3.52,PNC Park,1,1
2014-09-20,2014,SF,SD,2,3,-115,-1.5,150,6.0,-110,-110,105,1.5,-170,3.21,PETCO Park,5,-1
2014-09-20,2014,HOU,SEA,10,1,-114,-1.5,185,7.5,-115,-105,104,1.5,-215,4.0,Minute Maid Park,11,9
2014-09-20,2014,SD,SF,3,2,105,1.5,-170,6.0,-110,-110,-115,-1.5,150,2.93,PETCO Park,5,1
2014-09-20,2014,CIN,STL,4,8,135,1.5,-160,7.0,-120,100,-150,-1.5,140,2.98,Busch Stadium,12,-4
2014-09-20,2014,CWS,TB,1,3,150,1.5,-145,7.0,-120,100,-170,-1.5,125,2.8,Tropicana Field,4,-2
2014-09-20,2014,LAA,TEX,8,5,-220,-1.5,-110,8.0,100,-120,190,1.5,-110,5.5,Angel Stadium,13,3
2014-09-20,2014,NYY,TOR,3,6,114,1.5,-155,8.0,100,-120,-124,-1.5,135,3.74,Yankee Stadium,9,-3
2014-09-20,2014,MIA,WSH,2,3,160,1.5,-105,6.5,-118,-102,-180,-1.5,-115,2.5,Marlins Park,5,-1
2014-09-21,2014,COL,ARI,8,3,-105,1.5,-160,10.0,-111,-109,-105,-1.5,140,5.12,Coors Field,11,5
2014-09-21,2014,NYM,ATL,10,2,105,1.5,-230,6.5,-115,-105,-115,-1.5,190,3.17,Turner Field,12,8
2014-09-21,2014,BOS,BAL,3,2,130,1.5,-155,8.5,-104,-116,-145,-1.5,135,3.7,Camden Yards,5,1
2014-09-21,2014,BAL,BOS,2,3,-145,-1.5,135,8.5,-104,-116,130,1.5,-155,5.03,Camden Yards,5,-1
2014-09-21,2014,LAD,CHC,8,5,-140,-1.5,110,7.5,-110,-110,125,1.5,-130,4.38,Wrigley Field,13,3
2014-09-21,2014,STL,CIN,2,7,-190,-1.5,115,6.5,-110,-110,170,1.5,-135,4.26,Busch Stadium,9,-5
2014-09-21,2014,MIN,CLE,2,7,156,1.5,-112,7.5,101,-121,-176,-1.5,-108,2.93,Target Field,9,-5
2014-09-21,2014,ARI,COL,3,8,-105,-1.5,140,10.0,-111,-109,-105,1.5,-160,5.12,Coors Field,11,-5
2014-09-21,2014,TB,CWS,5,10,-174,-1.5,125,7.5,100,-120,154,1.5,-145,4.76,Tropicana Field,15,-5
2014-09-21,2014,KC,DET,5,2,-102,1.5,-165,7.5,-105,-115,-108,-1.5,145,3.79,Kauffman Stadium,7,3
2014-09-21,2014,SEA,HOU,3,8,-141,-1.5,110,7.5,103,-123,126,1.5,-130,4.39,Minute Maid Park,11,-5
2014-09-21,2014,DET,KC,2,5,-108,-1.5,145,7.5,-105,-115,-102,1.5,-165,3.89,Kauffman Stadium,7,-3
2014-09-21,2014,TEX,LAA,2,1,175,1.5,-115,8.0,100,-120,-205,-1.5,-105,2.91,Angel Stadium,3,1
2014-09-21,2014,CHC,LAD,5,8,125,1.5,-130,7.5,-110,-110,-140,-1.5,110,3.33,Wrigley Field,13,-3
2014-09-21,2014,WSH,MIA,2,1,-170,-1.5,100,7.0,105,-125,150,1.5,-120,4.41,Marlins Park,3,1
2014-09-21,2014,PIT,MIL,1,0,-140,-1.5,157,8.0,-120,100,125,1.5,-187,4.67,PNC Park,1,1
2014-09-21,2014,CLE,MIN,7,2,-176,-1.5,-108,7.5,101,-121,156,1.5,-112,4.78,Target Field,9,5
2014-09-21,2014,ATL,NYM,2,10,-115,-1.5,190,6.5,-115,-105,105,1.5,-230,3.48,Turner Field,12,-8
2014-09-21,2014,TOR,NYY,2,5,126,1.5,-168,7.0,-105,-115,-141,-1.5,148,3.1,Yankee Stadium,7,-3
2014-09-21,2014,PHI,OAK,6,8,173,1.5,-120,7.0,-125,105,-203,-1.5,100,2.56,Oakland Coliseum,14,-2
2014-09-21,2014,OAK,PHI,8,6,-203,-1.5,100,7.0,-125,105,173,1.5,-120,4.69,Oakland Coliseum,14,2
2014-09-21,2014,MIL,PIT,0,1,125,1.5,-187,8.0,-120,100,-140,-1.5,157,3.56,PNC Park,1,-1
2014-09-21,2014,SF,SD,2,8,100,1.5,-215,7.0,105,-125,-110,-1.5,185,3.5,PETCO Park,10,-6
2014-09-21,2014,HOU,SEA,8,3,126,1.5,-130,7.5,103,-123,-141,-1.5,110,3.32,Minute Maid Park,11,5
2014-09-21,2014,SD,SF,8,2,-110,-1.5,185,7.0,105,-125,100,1.5,-215,3.67,PETCO Park,10,6
2014-09-21,2014,CIN,STL,7,2,170,1.5,-135,6.5,-110,-110,-190,-1.5,115,2.41,Busch Stadium,9,5
2014-09-21,2014,CWS,TB,10,5,154,1.5,-145,7.5,100,-120,-174,-1.5,125,2.95,Tropicana Field,15,5
2014-09-21,2014,LAA,TEX,1,2,-205,-1.5,-105,8.0,100,-120,175,1.5,-115,5.38,Angel Stadium,3,-1
2014-09-21,2014,NYY,TOR,5,2,-141,-1.5,148,7.0,-105,-115,126,1.5,-168,4.1,Yankee Stadium,7,3
2014-09-21,2014,MIA,WSH,1,2,150,1.5,-120,7.0,105,-125,-170,-1.5,100,2.8,Marlins Park,3,-1
2014-09-22,2014,MIN,ARI,2,6,-124,-1.5,160,8.0,100,-120,114,1.5,-190,4.43,Target Field,8,-4
2014-09-22,2014,PIT,ATL,1,0,-155,-1.5,110,6.5,-130,110,140,1.5,-130,3.95,Turner Field,1,1
2014-09-22,2014,NYY,BAL,5,0,-122,-1.5,175,7.0,105,-125,112,1.5,-205,3.85,Yankee Stadium,5,5
2014-09-22,2014,STL,CHC,8,0,-175,-1.5,-119,7.0,-125,105,155,1.5,-101,4.45,Wrigley Field,8,8
2014-09-22,2014,KC,CLE,2,0,110,1.5,-205,6.5,105,-125,-120,-1.5,175,3.1,Progressive Field,2,2
2014-09-22,2014,SD,COL,1,0,-126,-1.5,185,6.5,-125,105,116,1.5,-215,3.62,PETCO Park,1,1
2014-09-22,2014,DET,CWS,0,2,-173,-1.5,115,9.0,-105,-115,153,1.5,-135,5.7,Comerica Park,2,-2
2014-09-22,2014,CWS,DET,2,0,153,1.5,-135,9.0,-105,-115,-173,-1.5,115,3.56,Comerica Park,2,2
2014-09-22,2014,TEX,HOU,4,3,-140,-1.5,150,7.5,-120,100,125,1.5,-170,4.38,Rangers Ballpark,7,1
2014-09-22,2014,CLE,KC,0,2,-120,-1.5,175,6.5,105,-125,110,1.5,-205,3.55,Progressive Field,2,-2
2014-09-22,2014,OAK,LAA,8,4,-146,-1.5,140,7.0,100,-120,131,1.5,-160,4.15,Oakland Coliseum,12,4
2014-09-22,2014,SF,LAD,5,2,102,1.5,-234,7.0,-125,105,-112,-1.5,194,3.47,Dodger Stadium,7,3
2014-09-22,2014,ARI,MIN,6,2,114,1.5,-190,8.0,100,-120,-124,-1.5,160,3.74,Target Field,8,4
2014-09-22,2014,BAL,NYY,0,5,112,1.5,-205,7.0,105,-125,-122,-1.5,175,3.3,Yankee Stadium,5,-5
2014-09-22,2014,LAA,OAK,4,8,131,1.5,-160,7.0,100,-120,-146,-1.5,140,3.03,Oakland Coliseum,12,-4
2014-09-22,2014,ATL,PIT,0,1,140,1.5,-130,6.5,-130,110,-155,-1.5,110,2.71,Turner Field,1,-1
2014-09-22,2014,COL,SD,0,1,116,1.5,-215,6.5,-125,105,-126,-1.5,185,3.01,PETCO Park,1,-1
2014-09-22,2014,TOR,SEA,14,4,-103,1.5,-170,7.5,-110,-110,-107,-1.5,150,3.81,Rogers Centre,18,10
2014-09-22,2014,LAD,SF,2,5,-112,-1.5,194,7.0,-125,105,102,1.5,-234,3.7,Dodger Stadium,7,-3
2014-09-22,2014,CHC,STL,0,8,155,1.5,-101,7.0,-125,105,-175,-1.5,-119,2.75,Wrigley Field,8,-8
2014-09-22,2014,HOU,TEX,3,4,125,1.5,-170,7.5,-120,100,-140,-1.5,150,3.33,Rangers Ballpark,7,-1
2014-09-22,2014,SEA,TOR,4,14,-107,-1.5,150,7.5,-110,-110,-103,1.5,-170,3.88,Rogers Centre,18,-10
2014-09-23,2014,MIN,ARI,6,3,-134,-1.5,160,8.0,-115,-105,119,1.5,-190,4.58,Target Field,9,3
2014-09-23,2014,PIT,ATL,3,2,-102,1.5,-230,6.0,100,-120,-108,-1.5,190,3.03,Turner Field,5,1
2014-09-23,2014,NYY,BAL,4,5,-179,-1.5,120,7.0,105,-125,159,1.5,-140,4.49,Yankee Stadium,9,-1
2014-09-23,2014,TB,BOS,6,2,-130,-1.5,125,7.5,105,-125,115,1.5,-145,4.24,Fenway Park,8,4
2014-09-23,2014,STL,CHC,3,4,-115,-1.5,150,7.5,100,-120,105,1.5,-170,4.01,Wrigley Field,7,-1
2014-09-23,2014,MIL,CIN,1,3,100,1.5,-230,6.0,100,-120,-110,-1.5,190,3.0,Great American Ballpark,4,-2
2014-09-23,2014,KC,CLE,7,1,114,1.5,-210,6.5,-107,-113,-124,-1.5,180,3.04,Progressive Field,8,6
2014-09-23,2014,SD,COL,2,3,-147,-1.5,168,6.0,-120,100,132,1.5,-198,3.57,PETCO Park,5,-1
2014-09-23,2014,DET,CWS,4,3,-320,-1.5,-150,8.0,100,-120,270,1.5,130,6.1,Comerica Park,7,1
2014-09-23,2014,CWS,DET,3,4,270,1.5,130,8.0,100,-120,-320,-1.5,-150,2.16,Comerica Park,7,-1
2014-09-23,2014,TEX,HOU,2,1,100,1.5,-170,9.0,100,-120,-110,-1.5,150,4.5,Rangers Ballpark,3,1
2014-09-23,2014,CLE,KC,1,7,-124,-1.5,180,6.5,-107,-113,114,1.5,-210,3.6,Progressive Field,8,-6
2014-09-23,2014,OAK,LAA,0,2,-160,-1.5,135,7.5,-105,-115,145,1.5,-155,4.62,Oakland Coliseum,2,-2
2014-09-23,2014,SF,LAD,2,4,116,1.5,-210,6.5,-105,-115,-126,-1.5,180,3.01,Dodger Stadium,6,-2
2014-09-23,2014,PHI,MIA,0,2,-153,-1.5,110,6.5,100,-120,138,1.5,-130,3.93,Marlins Park,2,-2
2014-09-23,2014,CIN,MIL,3,1,-110,-1.5,190,6.0,100,-120,100,1.5,-230,3.14,Great American Ballpark,4,2
2014-09-23,2014,ARI,MIN,3,6,119,1.5,-190,8.0,-115,-105,-134,-1.5,160,3.65,Target Field,9,-3
2014-09-23,2014,WSH,NYM,4,2,-179,-1.5,120,7.0,-120,100,159,1.5,-140,4.49,Nationals Park,6,2
2014-09-23,2014,BAL,NYY,5,4,159,1.5,-140,7.0,105,-125,-179,-1.5,120,2.7,Yankee Stadium,9,1
2014-09-23,2014,LAA,OAK,2,0,145,1.5,-155,7.5,-105,-115,-160,-1.5,135,3.06,Oakland Coliseum,2,2
2014-09-23,2014,MIA,PHI,2,0,138,1.5,-130,6.5,100,-120,-153,-1.5,110,2.73,Marlins Park,2,2
2014-09-23,2014,ATL,PIT,2,3,-108,-1.5,190,6.0,100,-120,-102,1.5,-230,3.12,Turner Field,5,-1
2014-09-23,2014,COL,SD,3,2,132,1.5,-198,6.0,-120,100,-147,-1.5,168,2.59,PETCO Park,5,1
2014-09-23,2014,TOR,SEA,10,2,160,1.5,-105,7.0,100,-120,-180,-1.5,-115,2.69,Rogers Centre,12,8
2014-09-23,2014,LAD,SF,4,2,-126,-1.5,180,6.5,-105,-115,116,1.5,-210,3.62,Dodger Stadium,6,2
2014-09-23,2014,CHC,STL,4,3,105,1.5,-170,7.5,100,-120,-115,-1.5,150,3.66,Wrigley Field,7,1
2014-09-23,2014,BOS,TB,2,6,115,1.5,-145,7.5,105,-125,-130,-1.5,125,3.49,Fenway Park,8,-4
2014-09-23,2014,HOU,TEX,1,2,-110,-1.5,150,9.0,100,-120,100,1.5,-170,4.71,Rangers Ballpark,3,-1
2014-09-23,2014,SEA,TOR,2,10,-180,-1.5,-115,7.0,100,-120,160,1.5,-105,4.5,Rogers Centre,12,-8
2014-09-23,2014,NYM,WSH,2,4,159,1.5,-140,7.0,-120,100,-179,-1.5,120,2.7,Nationals Park,6,-2
2014-09-24,2014,MIN,ARI,2,1,-174,-1.5,120,7.5,100,-120,154,1.5,-140,4.76,Target Field,3,1
2014-09-24,2014,PIT,ATL,2,6,116,1.5,-205,6.5,100,-120,-126,-1.5,175,3.01,Turner Field,8,-4
2014-09-24,2014,NYY,BAL,5,9,-128,-1.5,165,7.0,-104,-116,118,1.5,-195,3.93,Yankee Stadium,14,-4
2014-09-24,2014,TB,BOS,3,11,-167,-1.5,-110,7.5,-105,-115,152,1.5,-110,4.69,Fenway Park,14,-8
2014-09-24,2014,STL,CHC,1,3,-105,1.5,-232,7.0,105,-125,-105,-1.5,191,3.59,Wrigley Field,4,-2
2014-09-24,2014,MIL,CIN,5,0,-135,-1.5,120,7.5,115,-135,120,1.5,-140,4.31,Great American Ballpark,5,5
2014-09-24,2014,KC,CLE,4,6,-118,-1.5,140,7.0,113,-133,108,1.5,-160,3.79,Progressive Field,10,-2
2014-09-24,2014,SD,COL,4,3,-124,-1.5,180,7.0,-105,-115,114,1.5,-210,3.88,PETCO Park,7,1
2014-09-24,2014,DET,CWS,6,1,100,1.5,-175,7.0,-110,-110,-110,-1.5,155,3.5,Comerica Park,7,5
2014-09-24,2014,CWS,DET,1,6,-110,-1.5,155,7.0,-110,-110,100,1.5,-175,3.67,Comerica Park,7,-5
2014-09-24,2014,TEX,HOU,5,1,-112,-1.5,180,8.0,-120,100,102,1.5,-210,4.23,Rangers Ballpark,6,4
2014-09-24,2014,CLE,KC,6,4,108,1.5,-160,7.0,113,-133,-118,-1.5,140,3.37,Progressive Field,10,2
2014-09-24,2014,OAK,LAA,4,5,-195,-1.5,110,7.5,-110,-110,175,1.5,-132,4.96,Oakland Coliseum,9,-1
2014-09-24,2014,SF,LAD,1,9,220,1.5,105,6.0,-120,100,-260,-1.5,-125,1.88,Dodger Stadium,10,-8
2014-09-24,2014,PHI,MIA,2,1,109,1.5,-210,7.5,106,-126,-119,-1.5,180,3.59,Marlins Park,3,1
2014-09-24,2014,CIN,MIL,0,5,120,1.5,-140,7.5,115,-135,-135,-1.5,120,3.41,Great American Ballpark,5,-5
2014-09-24,2014,ARI,MIN,1,2,154,1.5,-140,7.5,100,-120,-174,-1.5,120,2.95,Target Field,3,-1
2014-09-24,2014,BAL,NYY,9,5,118,1.5,-195,7.0,-104,-116,-128,-1.5,165,3.21,Yankee Stadium,14,4
2014-09-24,2014,LAA,OAK,5,4,175,1.5,-132,7.5,-110,-110,-195,-1.5,110,2.73,Oakland Coliseum,9,1
2014-09-24,2014,MIA,PHI,1,2,-119,-1.5,180,7.5,106,-126,109,1.5,-210,4.08,Marlins Park,3,-1
2014-09-24,2014,ATL,PIT,6,2,-126,-1.5,175,6.5,100,-120,116,1.5,-205,3.62,Turner Field,8,4
2014-09-24,2014,COL,SD,3,4,114,1.5,-210,7.0,-105,-115,-124,-1.5,180,3.27,PETCO Park,7,-1
2014-09-24,2014,TOR,SEA,1,0,-119,-1.5,170,8.0,100,-120,109,1.5,-200,4.35,Rogers Centre,1,1
2014-09-24,2014,LAD,SF,9,1,-260,-1.5,-125,6.0,-120,100,220,1.5,105,4.33,Dodger Stadium,10,8
2014-09-24,2014,CHC,STL,3,1,-105,-1.5,191,7.0,105,-125,-105,1.5,-232,3.59,Wrigley Field,4,2
2014-09-24,2014,BOS,TB,11,3,152,1.5,-110,7.5,-105,-115,-167,-1.5,-110,2.98,Fenway Park,14,8
2014-09-24,2014,HOU,TEX,1,5,102,1.5,-210,8.0,-120,100,-112,-1.5,180,3.96,Rangers Ballpark,6,-4
2014-09-24,2014,SEA,TOR,0,1,109,1.5,-200,8.0,100,-120,-119,-1.5,170,3.83,Rogers Centre,1,-1
2014-09-25,2014,PIT,ATL,10,1,-127,-1.5,130,7.0,-120,100,117,1.5,-150,3.92,Turner Field,11,9
2014-09-25,2014,NYY,BAL,6,5,-140,-1.5,161,7.0,-110,-110,125,1.5,-190,4.08,Yankee Stadium,11,1
2014-09-25,2014,TB,BOS,1,11,-124,-1.5,130,8.0,-115,-105,114,1.5,-150,4.43,Fenway Park,12,-10
2014-09-25,2014,MIL,CIN,3,5,-170,-1.5,-105,8.0,-103,-117,150,1.5,-115,5.04,Great American Ballpark,8,-2
2014-09-25,2014,KC,CWS,6,3,-140,-1.5,120,7.0,105,-125,125,1.5,-140,4.08,Guaranteed Rate Field,9,3
2014-09-25,2014,MIN,DET,2,4,250,1.5,110,7.5,-115,-105,-290,-1.5,-130,2.14,Comerica Park,6,-2
2014-09-25,2014,CWS,KC,3,6,125,1.5,-140,7.0,105,-125,-140,-1.5,120,3.11,Guaranteed Rate Field,9,-3
2014-09-25,2014,PHI,MIA,4,6,116,1.5,-205,7.0,-125,105,-126,-1.5,175,3.24,Marlins Park,10,-2
2014-09-25,2014,CIN,MIL,5,3,150,1.5,-115,8.0,-103,-117,-170,-1.5,-105,3.2,Great American Ballpark,8,2
2014-09-25,2014,DET,MIN,4,2,-290,-1.5,-130,7.5,-115,-105,250,1.5,110,5.58,Comerica Park,6,2
2014-09-25,2014,WSH,NYM,4,7,-160,-1.5,130,7.0,-119,-101,145,1.5,-150,4.31,Nationals Park,11,-3
2014-09-25,2014,WSH,NYM,3,0,-170,-1.5,135,6.5,-115,-105,150,1.5,-155,4.09,Nationals Park,3,3
2014-09-25,2014,BAL,NYY,5,6,125,1.5,-190,7.0,-110,-110,-140,-1.5,161,3.11,Yankee Stadium,11,-1
2014-09-25,2014,TEX,OAK,2,1,132,1.5,-125,8.5,100,-120,-147,-1.5,105,3.66,Rangers Ballpark,3,1
2014-09-25,2014,MIA,PHI,6,4,-126,-1.5,175,7.0,-125,105,116,1.5,-205,3.9,Marlins Park,10,2
2014-09-25,2014,ATL,PIT,1,10,117,1.5,-150,7.0,-120,100,-127,-1.5,130,3.23,Turner Field,11,-9
2014-09-25,2014,SF,SD,9,8,-131,-1.5,175,6.0,-115,-105,116,1.5,-205,3.4,AT&T Park,17,1
2014-09-25,2014,TOR,SEA,5,7,116,1.5,-150,8.0,-108,-112,-126,-1.5,130,3.7,Rogers Centre,12,-2
2014-09-25,2014,SD,SF,8,9,116,1.5,-205,6.0,-115,-105,-131,-1.5,175,2.78,AT&T Park,17,-1
2014-09-25,2014,BOS,TB,11,1,114,1.5,-150,8.0,-115,-105,-124,-1.5,130,3.74,Fenway Park,12,10
2014-09-25,2014,OAK,TEX,1,2,-147,-1.5,105,8.5,100,-120,132,1.5,-125,5.06,Rangers Ballpark,3,-1
2014-09-25,2014,SEA,TOR,7,5,-126,-1.5,130,8.0,-108,-112,116,1.5,-150,4.46,Rogers Centre,12,2
2014-09-25,2014,NYM,WSH,7,4,145,1.5,-150,7.0,-119,-101,-160,-1.5,130,2.86,Nationals Park,11,3
2014-09-25,2014,NYM,WSH,0,3,150,1.5,-155,6.5,-115,-105,-170,-1.5,135,2.6,Nationals Park,3,-3
2014-09-26,2014,STL,ARI,7,6,-174,-1.5,-111,8.5,100,-120,154,1.5,-109,5.4,Chase Field,13,1
2014-09-26,2014,PHI,ATL,5,4,106,1.5,-160,7.5,109,-129,-116,-1.5,140,3.64,Citizens Bank Park,9,1
2014-09-26,2014,TOR,BAL,4,2,-129,-1.5,160,7.5,-105,-115,119,1.5,-190,4.22,Rogers Centre,6,2
2014-09-26,2014,NYY,BOS,3,2,125,1.5,-165,8.0,100,-120,-140,-1.5,145,3.56,Fenway Park,5,1
2014-09-26,2014,MIL,CHC,4,6,-144,-1.5,150,8.5,-105,-115,129,1.5,-170,5.02,Miller Park,10,-2
2014-09-26,2014,PIT,CIN,3,1,-158,-1.5,110,7.0,-120,100,143,1.5,-130,4.29,Great American Ballpark,4,2
2014-09-26,2014,TB,CLE,0,1,168,1.5,-135,6.5,-103,-117,-188,-1.5,115,2.43,Progressive Field,1,-1
2014-09-26,2014,LAD,COL,7,4,-157,-1.5,145,7.5,100,-120,142,1.5,-165,4.58,Dodger Stadium,11,3
2014-09-26,2014,KC,CWS,3,1,-142,-1.5,115,8.0,-110,-110,127,1.5,-135,4.69,Guaranteed Rate Field,4,2
2014-09-26,2014,MIN,DET,11,4,173,1.5,-110,8.5,-105,-115,-203,-1.5,-110,3.11,Comerica Park,15,7
2014-09-26,2014,NYM,HOU,1,3,-151,-1.5,145,7.0,-120,100,136,1.5,-165,4.21,Citi Field,4,-2
2014-09-26,2014,CWS,KC,1,3,127,1.5,-135,8.0,-110,-110,-142,-1.5,115,3.52,Guaranteed Rate Field,4,-2
2014-09-26,2014,SEA,LAA,4,3,-134,-1.5,165,7.0,106,-126,119,1.5,-195,4.01,T-Mobile Park,7,1
2014-09-26,2014,COL,LAD,4,7,142,1.5,-165,7.5,100,-120,-157,-1.5,145,3.1,Dodger Stadium,11,-3
2014-09-26,2014,WSH,MIA,4,0,-200,-1.5,100,7.0,-110,-110,170,1.5,-120,4.67,Nationals Park,4,4
2014-09-26,2014,WSH,MIA,7,15,-140,-1.5,155,7.0,-120,100,125,1.5,-175,4.08,Nationals Park,22,-8
2014-09-26,2014,CHC,MIL,6,4,129,1.5,-170,8.5,-105,-115,-144,-1.5,150,3.71,Miller Park,10,2
2014-09-26,2014,DET,MIN,4,11,-203,-1.5,-110,8.5,-105,-115,173,1.5,-110,5.69,Comerica Park,15,-7
2014-09-26,2014,HOU,NYM,3,1,136,1.5,-165,7.0,-120,100,-151,-1.5,145,2.97,Citi Field,4,2
2014-09-26,2014,BOS,NYY,2,3,-140,-1.5,145,8.0,100,-120,125,1.5,-165,4.67,Fenway Park,5,-1
2014-09-26,2014,TEX,OAK,2,6,154,1.5,-110,8.0,-120,100,-174,-1.5,-110,3.15,Rangers Ballpark,8,-4
2014-09-26,2014,ATL,PHI,4,5,-116,-1.5,140,7.5,109,-129,106,1.5,-160,4.03,Citizens Bank Park,9,-1
2014-09-26,2014,CIN,PIT,1,3,143,1.5,-130,7.0,-120,100,-158,-1.5,110,2.88,Great American Ballpark,4,-2
2014-09-26,2014,SF,SD,1,4,-113,-1.5,195,6.5,-110,-110,103,1.5,-235,3.45,AT&T Park,5,-3
2014-09-26,2014,LAA,SEA,3,4,119,1.5,-195,7.0,106,-126,-134,-1.5,165,3.2,T-Mobile Park,7,-1
2014-09-26,2014,SD,SF,4,1,103,1.5,-235,6.5,-110,-110,-113,-1.5,195,3.2,AT&T Park,5,3
2014-09-26,2014,ARI,STL,6,7,154,1.5,-109,8.5,100,-120,-174,-1.5,-111,3.35,Chase Field,13,-1
2014-09-26,2014,CLE,TB,1,0,-188,-1.5,115,6.5,-103,-117,168,1.5,-135,4.24,Progressive Field,1,1
2014-09-26,2014,OAK,TEX,6,2,-174,-1.5,-110,8.0,-120,100,154,1.5,-110,5.08,Rangers Ballpark,8,4
2014-09-26,2014,BAL,TOR,2,4,119,1.5,-190,7.5,-105,-115,-129,-1.5,160,3.42,Rogers Centre,6,-2
2014-09-26,2014,MIA,WSH,0,4,170,1.5,-120,7.0,-110,-110,-200,-1.5,100,2.59,Nationals Park,4,-4
2014-09-26,2014,MIA,WSH,15,7,125,1.5,-175,7.0,-120,100,-140,-1.5,155,3.11,Nationals Park,22,8
2014-09-27,2014,STL,ARI,2,5,-146,-1.5,110,7.5,-105,-115,131,1.5,-130,4.45,Chase Field,7,-3
2014-09-27,2014,PHI,ATL,2,4,-117,-1.5,180,7.5,-101,-119,107,1.5,-210,4.04,Citizens Bank Park,6,-2
2014-09-27,2014,TOR,BAL,4,2,-113,-1.5,170,8.0,-105,-115,103,1.5,-200,4.24,Rogers Centre,6,2
2014-09-27,2014,NYY,BOS,4,10,-133,-1.5,120,7.5,103,-123,118,1.5,-140,4.28,Fenway Park,14,-6
2014-09-27,2014,MIL,CHC,2,1,-164,-1.5,130,8.0,-105,-115,149,1.5,-150,4.97,Miller Park,3,1
2014-09-27,2014,PIT,CIN,6,10,-164,-1.5,105,7.0,105,-125,149,1.5,-125,4.35,Great American Ballpark,16,-4
2014-09-27,2014,TB,CLE,2,0,149,1.5,-150,7.0,100,-120,-164,-1.5,130,2.81,Progressive Field,2,2
2014-09-27,2014,LAD,COL,6,5,-190,-1.5,118,7.0,-120,100,170,1.5,-139,4.59,Dodger Stadium,11,1
2014-09-27,2014,KC,CWS,4,5,-159,-1.5,105,8.0,-110,-110,144,1.5,-125,4.91,Guaranteed Rate Field,9,-1
2014-09-27,2014,MIN,DET,12,3,151,1.5,-134,8.5,-115,-105,-171,-1.5,114,3.39,Comerica Park,15,9
2014-09-27,2014,NYM,HOU,2,1,-142,-1.5,150,7.5,109,-129,127,1.5,-170,4.4,Citi Field,3,1
2014-09-27,2014,CWS,KC,5,4,144,1.5,-125,8.0,-110,-110,-159,-1.5,105,3.28,Guaranteed Rate Field,9,1
2014-09-27,2014,SEA,LAA,2,1,-124,-1.5,170,7.0,-105,-115,114,1.5,-200,3.88,T-Mobile Park,3,1
2014-09-27,2014,COL,LAD,5,6,170,1.5,-139,7.0,-120,100,-190,-1.5,118,2.59,Dodger Stadium,11,-1
2014-09-27,2014,WSH,MIA,5,1,-250,-1.5,-115,6.5,-125,105,210,1.5,-105,4.64,Nationals Park,6,4
2014-09-27,2014,CHC,MIL,1,2,149,1.5,-150,8.0,-105,-115,-164,-1.5,130,3.21,Miller Park,3,-1
2014-09-27,2014,DET,MIN,3,12,-171,-1.5,114,8.5,-115,-105,151,1.5,-134,5.36,Comerica Park,15,-9
2014-09-27,2014,HOU,NYM,1,2,127,1.5,-170,7.5,109,-129,-142,-1.5,150,3.3,Citi Field,3,-1
2014-09-27,2014,BOS,NYY,10,4,118,1.5,-140,7.5,103,-123,-133,-1.5,120,3.44,Fenway Park,14,6
2014-09-27,2014,TEX,OAK,5,4,170,1.5,-105,8.0,-110,-110,-200,-1.5,-115,2.96,Rangers Ballpark,9,1
2014-09-27,2014,ATL,PHI,4,2,107,1.5,-210,7.5,-101,-119,-117,-1.5,180,3.62,Citizens Bank Park,6,2
2014-09-27,2014,CIN,PIT,10,6,149,1.5,-125,7.0,105,-125,-164,-1.5,105,2.81,Great American Ballpark,16,4
2014-09-27,2014,SF,SD,3,1,-155,-1.5,145,7.0,100,-120,140,1.5,-165,4.25,AT&T Park,4,2
2014-09-27,2014,LAA,SEA,1,2,114,1.5,-200,7.0,-105,-115,-124,-1.5,170,3.27,T-Mobile Park,3,-1
2014-09-27,2014,SD,SF,1,3,140,1.5,-165,7.0,100,-120,-155,-1.5,145,2.92,AT&T Park,4,-2
2014-09-27,2014,ARI,STL,5,2,131,1.5,-130,7.5,-105,-115,-146,-1.5,110,3.25,Chase Field,7,3
2014-09-27,2014,CLE,TB,0,2,-164,-1.5,130,7.0,100,-120,149,1.5,-150,4.35,Progressive Field,2,-2
2014-09-27,2014,OAK,TEX,4,5,-200,-1.5,-115,8.0,-110,-110,170,1.5,-105,5.33,Rangers Ballpark,9,-1
2014-09-27,2014,BAL,TOR,2,4,103,1.5,-200,8.0,-105,-115,-113,-1.5,170,3.94,Rogers Centre,6,-2
2014-09-27,2014,MIA,WSH,1,5,210,1.5,-105,6.5,-125,105,-250,-1.5,-115,2.1,Nationals Park,6,-4
2014-09-28,2014,STL,ARI,1,0,135,-1.5,105,8.5,-110,-110,-150,1.5,-125,3.62,Chase Field,1,1
2014-09-28,2014,PHI,ATL,1,2,-168,-1.5,130,6.5,-124,104,153,1.5,-150,4.07,Citizens Bank Park,3,-1
2014-09-28,2014,TOR,BAL,0,1,-119,-1.5,170,8.0,100,-120,109,1.5,-200,4.35,Rogers Centre,1,-1
2014-09-28,2014,NYY,BOS,9,5,108,1.5,-210,7.5,101,-121,-118,-1.5,180,3.61,Fenway Park,14,4
2014-09-28,2014,MIL,CHC,2,5,-171,-1.5,120,7.5,105,-125,151,1.5,-140,4.73,Miller Park,7,-3
2014-09-28,2014,PIT,CIN,1,4,-115,-1.5,150,6.5,-103,-117,105,1.5,-170,3.48,Great American Ballpark,5,-3
2014-09-28,2014,TB,CLE,2,7,-145,-1.5,125,6.5,-110,-110,130,1.5,-145,3.85,Progressive Field,9,-5
2014-09-28,2014,LAD,COL,10,5,-220,-1.5,-105,7.0,100,-120,190,1.5,-115,4.81,Dodger Stadium,15,5
2014-09-28,2014,KC,CWS,6,4,-190,-1.5,-120,7.5,-105,-115,170,1.5,100,4.91,Guaranteed Rate Field,10,2
2014-09-28,2014,MIN,DET,0,3,216,1.5,-101,7.5,100,-120,-256,-1.5,-119,2.37,Comerica Park,3,-3
2014-09-28,2014,NYM,HOU,8,3,-160,-1.5,140,7.0,-110,-110,145,1.5,-160,4.31,Citi Field,11,5
2014-09-28,2014,CWS,KC,4,6,170,1.5,100,7.5,-105,-115,-190,-1.5,-120,2.78,Guaranteed Rate Field,10,-2
2014-09-28,2014,SEA,LAA,4,1,-200,-1.5,110,7.0,110,-130,170,1.5,-130,4.67,T-Mobile Park,5,3
2014-09-28,2014,COL,LAD,5,10,190,1.5,-115,7.0,100,-120,-220,-1.5,-105,2.41,Dodger Stadium,15,-5
2014-09-28,2014,WSH,MIA,1,0,-196,-1.5,120,7.0,100,-120,176,1.5,-140,4.64,Nationals Park,1,1
2014-09-28,2014,CHC,MIL,5,2,151,1.5,-140,7.5,105,-125,-171,-1.5,120,2.99,Miller Park,7,3
2014-09-28,2014,DET,MIN,3,0,-256,-1.5,-119,7.5,100,-120,216,1.5,-101,5.39,Comerica Park,3,3
2014-09-28,2014,HOU,NYM,3,8,145,1.5,-160,7.0,-110,-110,-160,-1.5,140,2.86,Citi Field,11,-5
2014-09-28,2014,BOS,NYY,5,9,-118,-1.5,180,7.5,101,-121,108,1.5,-210,4.06,Fenway Park,14,-4
2014-09-28,2014,TEX,OAK,0,4,171,1.5,100,8.5,100,-120,-191,-1.5,-120,3.14,Rangers Ballpark,4,-4
2014-09-28,2014,ATL,PHI,2,1,153,1.5,-150,6.5,-124,104,-168,-1.5,130,2.57,Citizens Bank Park,3,1
2014-09-28,2014,CIN,PIT,4,1,105,1.5,-170,6.5,-103,-117,-115,-1.5,150,3.17,Great American Ballpark,5,3
2014-09-28,2014,SF,SD,9,3,-120,-1.5,175,7.5,100,-120,110,1.5,-205,4.09,AT&T Park,12,6
2014-09-28,2014,LAA,SEA,1,4,170,1.5,-130,7.0,110,-130,-200,-1.5,110,2.59,T-Mobile Park,5,-3
2014-09-28,2014,SD,SF,3,9,110,1.5,-205,7.5,100,-120,-120,-1.5,175,3.57,AT&T Park,12,-6
2014-09-28,2014,ARI,STL,0,1,-150,1.5,-125,8.5,-110,-110,135,-1.5,105,5.1,Chase Field,1,-1
2014-09-28,2014,CLE,TB,7,2,130,1.5,-145,6.5,-110,-110,-145,-1.5,125,2.83,Progressive Field,9,5
2014-09-28,2014,OAK,TEX,4,0,-191,-1.5,-120,8.5,100,-120,171,1.5,100,5.58,Rangers Ballpark,4,4
2014-09-28,2014,BAL,TOR,1,0,109,1.5,-200,8.0,100,-120,-119,-1.5,170,3.83,Rogers Centre,1,1
2014-09-28,2014,MIA,WSH,0,1,176,1.5,-140,7.0,100,-120,-196,-1.5,120,2.54,Nationals Park,1,-1
2015-04-05,2015,STL,CHC,3,0,-102,1.5,-220,7.0,-115,-105,-108,-1.5,190,3.53,Wrigley Field,3,3
2015-04-05,2015,CHC,STL,0,3,-108,-1.5,190,7.0,-115,-105,-102,1.5,-220,3.63,Wrigley Field,3,-3
2015-04-06,2015,SF,ARI,5,4,-143,-1.5,121,7.5,-110,-110,128,1.5,-141,4.41,Chase Field,9,1
2015-04-06,2015,MIA,ATL,1,2,-152,-1.5,150,7.0,-105,-115,137,1.5,-170,4.22,Marlins Park,3,-1
2015-04-06,2015,TB,BAL,2,6,-123,-1.5,175,7.0,-115,-105,113,1.5,-205,3.86,Tropicana Field,8,-4
2015-04-06,2015,PHI,BOS,0,8,-106,1.5,-175,7.5,100,-120,-104,-1.5,155,3.86,Citizens Bank Park,8,-8
2015-04-06,2015,PIT,CIN,2,5,113,1.5,-230,7.0,105,-125,-123,-1.5,190,3.29,Great American Ballpark,7,-3
2015-04-06,2015,HOU,CLE,2,0,100,1.5,-170,7.5,-104,-116,-110,-1.5,150,3.75,Minute Maid Park,2,2
2015-04-06,2015,MIL,COL,0,10,-153,-1.5,150,9.0,-110,-110,138,1.5,-170,5.44,Miller Park,10,-10
2015-04-06,2015,KC,CWS,10,1,-120,-1.5,180,7.5,100,-120,110,1.5,-210,4.09,Kauffman Stadium,11,9
2015-04-06,2015,MIN,DET,0,4,146,1.5,-148,8.0,-115,-105,-161,-1.5,128,3.25,Comerica Park,4,-4
2015-04-06,2015,CLE,HOU,0,2,-110,-1.5,150,7.5,-104,-116,100,1.5,-170,3.93,Minute Maid Park,2,-2
2015-04-06,2015,CWS,KC,1,10,110,1.5,-210,7.5,100,-120,-120,-1.5,180,3.57,Kauffman Stadium,11,-9
2015-04-06,2015,SEA,LAA,4,1,-155,-1.5,150,6.5,-125,105,140,1.5,-170,3.95,T-Mobile Park,5,3
2015-04-06,2015,SD,LAD,3,6,174,1.5,-140,6.0,-109,-111,-194,-1.5,120,2.19,Dodger Stadium,9,-3
2015-04-06,2015,ATL,MIA,2,1,137,1.5,-170,7.0,-105,-115,-152,-1.5,150,2.95,Marlins Park,3,1
2015-04-06,2015,COL,MIL,10,0,138,1.5,-170,9.0,-110,-110,-153,-1.5,150,3.78,Miller Park,10,10
2015-04-06,2015,DET,MIN,4,0,-161,-1.5,128,8.0,-115,-105,146,1.5,-148,4.93,Comerica Park,4,4
2015-04-06,2015,WSH,NYM,1,3,-170,-1.5,135,7.0,-115,-105,150,1.5,-155,4.41,Nationals Park,4,-2
2015-04-06,2015,TOR,NYY,6,1,125,1.5,-175,8.0,100,-120,-140,-1.5,155,3.56,Yankee Stadium,7,5
2015-04-06,2015,TEX,OAK,0,8,151,1.5,-150,7.0,-115,-105,-166,-1.5,130,2.79,Oakland Coliseum,8,-8
2015-04-06,2015,BOS,PHI,8,0,-104,-1.5,155,7.5,100,-120,-106,1.5,-175,3.82,Citizens Bank Park,8,8
2015-04-06,2015,CIN,PIT,5,2,-123,-1.5,190,7.0,105,-125,113,1.5,-230,3.86,Great American Ballpark,7,3
2015-04-06,2015,LAD,SD,6,3,-194,-1.5,120,6.0,-109,-111,174,1.5,-140,3.96,Dodger Stadium,9,3
2015-04-06,2015,LAA,SEA,1,4,140,1.5,-170,6.5,-125,105,-155,-1.5,150,2.71,T-Mobile Park,5,-3
2015-04-06,2015,ARI,SF,4,5,128,1.5,-141,7.5,-110,-110,-143,-1.5,121,3.29,Chase Field,9,-1
2015-04-06,2015,BAL,TB,6,2,113,1.5,-205,7.0,-115,-105,-123,-1.5,175,3.29,Tropicana Field,8,4
2015-04-06,2015,OAK,TEX,8,0,-166,-1.5,130,7.0,-115,-105,151,1.5,-150,4.37,Oakland Coliseum,8,8
2015-04-06,2015,NYY,TOR,1,6,-140,-1.5,155,8.0,100,-120,125,1.5,-175,4.67,Yankee Stadium,7,-5
2015-04-06,2015,NYM,WSH,3,1,150,1.5,-155,7.0,-115,-105,-170,-1.5,135,2.8,Nationals Park,4,2
2015-04-07,2015,SF,ARI,6,7,-105,-1.5,150,8.5,-110,-110,-105,1.5,-170,4.35,Chase Field,13,-1
2015-04-07,2015,MIA,ATL,2,12,-146,-1.5,160,7.0,-115,-105,131,1.5,-190,4.15,Marlins Park,14,-10
2015-04-07,2015,TB,BAL,5,6,-102,1.5,-170,7.0,-120,100,-108,-1.5,150,3.53,Tropicana Field,11,-1
2015-04-07,2015,MIL,COL,2,5,-123,-1.5,160,8.0,-115,-105,113,1.5,-190,4.41,Miller Park,7,-3
2015-04-07,2015,SEA,LAA,0,2,-120,-1.5,170,7.0,-110,-110,110,1.5,-200,3.82,T-Mobile Park,2,-2
2015-04-07,2015,SD,LAD,7,3,130,1.5,-190,6.5,-105,-115,-145,-1.5,160,2.83,Dodger Stadium,10,4
2015-04-07,2015,ATL,MIA,12,2,131,1.5,-190,7.0,-115,-105,-146,-1.5,160,3.03,Marlins Park,14,10
2015-04-07,2015,COL,MIL,5,2,113,1.5,-190,8.0,-115,-105,-123,-1.5,160,3.76,Miller Park,7,3
2015-04-07,2015,TEX,OAK,3,1,140,1.5,-155,7.0,-120,100,-155,-1.5,135,2.92,Oakland Coliseum,4,2
2015-04-07,2015,LAD,SD,3,7,-145,-1.5,160,6.5,-105,-115,130,1.5,-190,3.85,Dodger Stadium,10,-4
2015-04-07,2015,LAA,SEA,2,0,110,1.5,-200,7.0,-110,-110,-120,-1.5,170,3.33,T-Mobile Park,2,2
2015-04-07,2015,ARI,SF,7,6,-105,1.5,-170,8.5,-110,-110,-105,-1.5,150,4.35,Chase Field,13,1
2015-04-07,2015,BAL,TB,6,5,-108,-1.5,150,7.0,-120,100,-102,1.5,-170,3.63,Tropicana Field,11,1
2015-04-07,2015,OAK,TEX,1,3,-155,-1.5,135,7.0,-120,100,140,1.5,-155,4.25,Oakland Coliseum,4,-2
2015-04-08,2015,SF,ARI,5,2,106,1.5,-205,8.5,-120,100,-116,-1.5,175,4.13,Chase Field,7,3
2015-04-08,2015,MIA,ATL,0,2,-130,-1.5,160,7.5,101,-121,115,1.5,-190,4.24,Marlins Park,2,-2
2015-04-08,2015,TB,BAL,2,0,-112,-1.5,185,7.5,-115,-105,102,1.5,-215,3.96,Tropicana Field,2,2
2015-04-08,2015,PHI,BOS,4,2,125,1.5,-140,7.5,110,-130,-140,-1.5,120,3.33,Citizens Bank Park,6,2
2015-04-08,2015,STL,CHC,0,2,100,1.5,-230,6.0,-120,100,-110,-1.5,190,3.0,Wrigley Field,2,-2
2015-04-08,2015,PIT,CIN,4,5,-120,-1.5,145,7.5,-107,-113,110,1.5,-165,4.09,Great American Ballpark,9,-1
2015-04-08,2015,HOU,CLE,0,2,110,1.5,-150,8.5,-110,-110,-120,-1.5,130,4.05,Minute Maid Park,2,-2
2015-04-08,2015,MIL,COL,4,5,-131,-1.5,160,8.5,-115,-105,116,1.5,-190,4.82,Miller Park,9,-1
2015-04-08,2015,KC,CWS,7,5,-119,-1.5,170,7.5,-105,-115,109,1.5,-200,4.08,Kauffman Stadium,12,2
2015-04-08,2015,MIN,DET,0,11,150,1.5,-145,8.5,-114,-106,-170,-1.5,125,3.4,Comerica Park,11,-11
2015-04-08,2015,CLE,HOU,2,0,-120,-1.5,130,8.5,-110,-110,110,1.5,-150,4.64,Minute Maid Park,2,2
2015-04-08,2015,CWS,KC,5,7,109,1.5,-200,7.5,-105,-115,-119,-1.5,170,3.59,Kauffman Stadium,12,-2
2015-04-08,2015,SEA,LAA,3,5,-130,-1.5,170,7.0,105,-125,115,1.5,-200,3.96,T-Mobile Park,8,-2
2015-04-08,2015,SD,LAD,4,7,110,1.5,-230,7.0,105,-125,-120,-1.5,190,3.33,Dodger Stadium,11,-3
2015-04-08,2015,ATL,MIA,2,0,115,1.5,-190,7.5,101,-121,-130,-1.5,160,3.49,Marlins Park,2,2
2015-04-08,2015,COL,MIL,5,4,116,1.5,-190,8.5,-115,-105,-131,-1.5,160,3.94,Miller Park,9,1
2015-04-08,2015,DET,MIN,11,0,-170,-1.5,125,8.5,-114,-106,150,1.5,-145,5.35,Comerica Park,11,11
2015-04-08,2015,WSH,NYM,2,1,-135,-1.5,170,6.0,-120,100,120,1.5,-200,3.45,Nationals Park,3,1
2015-04-08,2015,TOR,NYY,3,4,117,1.5,-200,6.5,-121,101,-132,-1.5,170,3.0,Yankee Stadium,7,-1
2015-04-08,2015,TEX,OAK,0,10,145,1.5,-160,6.5,-121,101,-160,-1.5,140,2.65,Oakland Coliseum,10,-10
2015-04-08,2015,BOS,PHI,2,4,-140,-1.5,120,7.5,110,-130,125,1.5,-140,4.38,Citizens Bank Park,6,-2
2015-04-08,2015,CIN,PIT,5,4,110,1.5,-165,7.5,-107,-113,-120,-1.5,145,3.57,Great American Ballpark,9,1
2015-04-08,2015,LAD,SD,7,4,-120,-1.5,190,7.0,105,-125,110,1.5,-230,3.82,Dodger Stadium,11,3
2015-04-08,2015,LAA,SEA,5,3,115,1.5,-200,7.0,105,-125,-130,-1.5,170,3.26,T-Mobile Park,8,2
2015-04-08,2015,ARI,SF,2,5,-116,-1.5,175,8.5,-120,100,106,1.5,-205,4.56,Chase Field,7,-3
2015-04-08,2015,CHC,STL,2,0,-110,-1.5,190,6.0,-120,100,100,1.5,-230,3.14,Wrigley Field,2,2
2015-04-08,2015,BAL,TB,0,2,102,1.5,-215,7.5,-115,-105,-112,-1.5,185,3.71,Tropicana Field,2,-2
2015-04-08,2015,OAK,TEX,10,0,-160,-1.5,140,6.5,-121,101,145,1.5,-160,4.0,Oakland Coliseum,10,10
2015-04-08,2015,NYY,TOR,4,3,-132,-1.5,170,6.5,-121,101,117,1.5,-200,3.7,Yankee Stadium,7,1
2015-04-08,2015,NYM,WSH,1,2,120,1.5,-200,6.0,-120,100,-135,-1.5,170,2.73,Nationals Park,3,-1
2015-04-09,2015,PHI,BOS,2,6,115,1.5,-145,7.5,-105,-115,-125,-1.5,125,3.49,Citizens Bank Park,8,-4
2015-04-09,2015,PIT,CIN,2,3,-107,-1.5,150,8.0,-119,-101,-103,1.5,-170,4.14,Great American Ballpark,5,-1
2015-04-09,2015,HOU,CLE,1,5,-104,1.5,-170,9.0,-115,-105,-106,-1.5,150,4.59,Minute Maid Park,6,-4
2015-04-09,2015,KC,CWS,4,1,-134,-1.5,155,8.5,-120,100,119,1.5,-175,4.87,Kauffman Stadium,5,3
2015-04-09,2015,MIN,DET,1,7,126,1.5,-170,9.0,-105,-115,-141,-1.5,150,3.98,Comerica Park,8,-6
2015-04-09,2015,CLE,HOU,5,1,-106,-1.5,150,9.0,-115,-105,-104,1.5,-170,4.63,Minute Maid Park,6,4
2015-04-09,2015,CWS,KC,1,4,119,1.5,-175,8.5,-120,100,-134,-1.5,155,3.88,Kauffman Stadium,5,-3
2015-04-09,2015,DET,MIN,7,1,-141,-1.5,150,9.0,-105,-115,126,1.5,-170,5.27,Comerica Park,8,6
2015-04-09,2015,WSH,NYM,3,6,-114,-1.5,200,6.0,-115,-105,104,1.5,-240,3.2,Nationals Park,9,-3
2015-04-09,2015,TOR,NYY,6,3,-140,-1.5,120,7.5,105,-125,125,1.5,-140,4.38,Yankee Stadium,9,3
2015-04-09,2015,TEX,OAK,10,1,145,1.5,-156,7.5,-120,100,-160,-1.5,136,3.06,Oakland Coliseum,11,9
2015-04-09,2015,BOS,PHI,6,2,-125,-1.5,125,7.5,-105,-115,115,1.5,-145,4.17,Citizens Bank Park,8,4
2015-04-09,2015,CIN,PIT,3,2,-103,1.5,-170,8.0,-119,-101,-107,-1.5,150,4.06,Great American Ballpark,5,1
2015-04-09,2015,SF,SD,1,0,117,1.5,-205,7.0,110,-130,-127,-1.5,175,3.23,PETCO Park,1,1
2015-04-09,2015,SD,SF,0,1,-127,-1.5,175,7.0,110,-130,117,1.5,-205,3.92,PETCO Park,1,-1
2015-04-09,2015,OAK,TEX,1,10,-160,-1.5,136,7.5,-120,100,145,1.5,-156,4.62,Oakland Coliseum,11,-9
2015-04-09,2015,NYY,TOR,3,6,125,1.5,-140,7.5,105,-125,-140,-1.5,120,3.33,Yankee Stadium,9,-3
2015-04-09,2015,NYM,WSH,6,3,104,1.5,-240,6.0,-115,-105,-114,-1.5,200,2.94,Nationals Park,9,3
2015-04-10,2015,LAD,ARI,3,4,-119,-1.5,140,8.5,-115,-105,109,1.5,-160,4.62,Chase Field,7,-1
2015-04-10,2015,NYM,ATL,3,5,-115,-1.5,140,7.0,-120,100,105,1.5,-160,3.74,Turner Field,8,-2
2015-04-10,2015,TOR,BAL,12,5,104,1.5,-205,9.0,100,-120,-114,-1.5,175,4.41,Camden Yards,17,7
2015-04-10,2015,NYY,BOS,5,6,-108,-1.5,185,8.5,-110,-110,-102,1.5,-215,4.41,Yankee Stadium,11,-1
2015-04-10,2015,COL,CHC,5,1,-140,-1.5,150,10.0,-119,-101,125,1.5,-170,5.83,Coors Field,6,4
2015-04-10,2015,STL,CIN,4,5,-125,-1.5,125,8.0,-115,-105,115,1.5,-145,4.44,Great American Ballpark,9,-1
2015-04-10,2015,DET,CLE,8,4,114,1.5,-195,8.5,-113,-107,-124,-1.5,165,3.97,Progressive Field,12,4
2015-04-10,2015,CHC,COL,1,5,125,1.5,-170,10.0,-119,-101,-140,-1.5,150,4.44,Coors Field,6,-4
2015-04-10,2015,MIN,CWS,6,0,102,1.5,-210,9.0,-111,-109,-112,-1.5,180,4.46,Guaranteed Rate Field,6,6
2015-04-10,2015,CLE,DET,4,8,-124,-1.5,165,8.5,-113,-107,114,1.5,-195,4.71,Progressive Field,12,-4
2015-04-10,2015,TEX,HOU,1,5,-118,-1.5,180,8.0,100,-120,108,1.5,-210,4.33,Rangers Ballpark,6,-4
2015-04-10,2015,LAA,KC,2,4,-132,-1.5,160,7.5,100,-120,117,1.5,-190,4.27,Angel Stadium,6,-2
2015-04-10,2015,KC,LAA,4,2,117,1.5,-190,7.5,100,-120,-132,-1.5,160,3.46,Angel Stadium,6,2
2015-04-10,2015,ARI,LAD,4,3,109,1.5,-160,8.5,-115,-105,-119,-1.5,140,4.07,Chase Field,7,1
2015-04-10,2015,TB,MIA,9,10,111,1.5,-210,7.5,-110,-110,-121,-1.5,180,3.55,Marlins Park,19,-1
2015-04-10,2015,PIT,MIL,6,2,125,1.5,-190,7.5,-115,-105,-140,-1.5,160,3.33,Miller Park,8,4
2015-04-10,2015,CWS,MIN,0,6,-112,-1.5,180,9.0,-111,-109,102,1.5,-210,4.75,Guaranteed Rate Field,6,-6
2015-04-10,2015,ATL,NYM,5,3,105,1.5,-160,7.0,-120,100,-115,-1.5,140,3.41,Turner Field,8,2
2015-04-10,2015,BOS,NYY,6,5,-102,1.5,-215,8.5,-110,-110,-108,-1.5,185,4.29,Yankee Stadium,11,1
2015-04-10,2015,SEA,OAK,0,12,101,1.5,-230,7.0,105,-125,-111,-1.5,190,3.48,Oakland Coliseum,12,-12
2015-04-10,2015,WSH,PHI,1,4,-165,-1.5,-106,7.5,100,-120,150,1.5,-114,4.67,Citizens Bank Park,5,-3
2015-04-10,2015,MIL,PIT,2,6,-140,-1.5,160,7.5,-115,-105,125,1.5,-190,4.38,Miller Park,8,-4
2015-04-10,2015,SF,SD,0,1,107,1.5,-230,7.0,110,-130,-117,-1.5,190,3.38,PETCO Park,1,-1
2015-04-10,2015,OAK,SEA,12,0,-111,-1.5,190,7.0,105,-125,101,1.5,-230,3.68,Oakland Coliseum,12,12
2015-04-10,2015,SD,SF,1,0,-117,-1.5,190,7.0,110,-130,107,1.5,-230,3.77,PETCO Park,1,1
2015-04-10,2015,CIN,STL,5,4,115,1.5,-145,8.0,-115,-105,-125,-1.5,125,3.72,Great American Ballpark,9,1
2015-04-10,2015,MIA,TB,10,9,-121,-1.5,180,7.5,-110,-110,111,1.5,-210,4.11,Marlins Park,19,1
2015-04-10,2015,HOU,TEX,5,1,108,1.5,-210,8.0,100,-120,-118,-1.5,180,3.85,Rangers Ballpark,6,4
2015-04-10,2015,BAL,TOR,5,12,-114,-1.5,175,9.0,100,-120,104,1.5,-205,4.79,Camden Yards,17,-7
2015-04-10,2015,PHI,WSH,4,1,150,1.5,-114,7.5,100,-120,-165,-1.5,-106,3.0,Citizens Bank Park,5,3
2015-04-11,2015,LAD,ARI,0,6,-200,-1.5,-119,7.0,-125,105,170,1.5,-101,4.67,Chase Field,6,-6
2015-04-11,2015,NYM,ATL,3,5,107,1.5,-215,7.0,-105,-115,-117,-1.5,185,3.38,Turner Field,8,-2
2015-04-11,2015,TOR,BAL,1,7,-102,1.5,-215,8.0,-105,-115,-108,-1.5,185,4.04,Camden Yards,8,-6
2015-04-11,2015,NYY,BOS,4,8,-115,-1.5,171,8.5,-120,100,105,1.5,-200,4.55,Yankee Stadium,12,-4
2015-04-11,2015,COL,CHC,5,9,-110,-1.5,175,10.5,-115,-105,100,1.5,-205,5.5,Coors Field,14,-4
2015-04-11,2015,STL,CIN,4,1,107,1.5,-230,6.5,-105,-115,-117,-1.5,190,3.14,Great American Ballpark,5,3
2015-04-11,2015,DET,CLE,9,6,-107,-1.5,160,6.0,-120,100,-103,1.5,-190,3.1,Progressive Field,15,3
2015-04-11,2015,CHC,COL,9,5,100,1.5,-205,10.5,-115,-105,-110,-1.5,175,5.25,Coors Field,14,4
2015-04-11,2015,MIN,CWS,4,5,144,1.5,-155,8.5,-115,-105,-159,-1.5,135,3.48,Guaranteed Rate Field,9,-1
2015-04-11,2015,CLE,DET,6,9,-103,1.5,-190,6.0,-120,100,-107,-1.5,160,3.04,Progressive Field,15,-3
2015-04-11,2015,TEX,HOU,6,2,-123,-1.5,160,9.0,100,-120,113,1.5,-190,4.96,Rangers Ballpark,8,4
2015-04-11,2015,LAA,KC,4,6,-130,-1.5,165,7.5,100,-120,115,1.5,-195,4.24,Angel Stadium,10,-2
2015-04-11,2015,KC,LAA,6,4,115,1.5,-195,7.5,100,-120,-130,-1.5,165,3.49,Angel Stadium,10,2
2015-04-11,2015,ARI,LAD,6,0,170,1.5,-101,7.0,-125,105,-200,-1.5,-119,2.59,Chase Field,6,6
2015-04-11,2015,TB,MIA,2,0,-105,1.5,-230,7.5,100,-120,-105,-1.5,190,3.84,Marlins Park,2,2
2015-04-11,2015,PIT,MIL,0,6,119,1.5,-195,8.0,-111,-109,-129,-1.5,165,3.65,Miller Park,6,-6
2015-04-11,2015,CWS,MIN,5,4,-159,-1.5,135,8.5,-115,-105,144,1.5,-155,5.22,Guaranteed Rate Field,9,1
2015-04-11,2015,ATL,NYM,5,3,-117,-1.5,185,7.0,-105,-115,107,1.5,-215,3.77,Turner Field,8,2
2015-04-11,2015,BOS,NYY,8,4,105,1.5,-200,8.5,-120,100,-115,-1.5,171,4.15,Yankee Stadium,12,4
2015-04-11,2015,SEA,OAK,5,4,125,1.5,-190,7.5,105,-125,-140,-1.5,160,3.33,Oakland Coliseum,9,1
2015-04-11,2015,WSH,PHI,2,3,-105,-1.5,155,6.5,100,-120,-105,1.5,-175,3.33,Citizens Bank Park,5,-1
2015-04-11,2015,MIL,PIT,6,0,-129,-1.5,165,8.0,-111,-109,119,1.5,-195,4.51,Miller Park,6,6
2015-04-11,2015,SF,SD,2,10,-101,1.5,-230,6.0,100,-120,-109,-1.5,190,3.01,PETCO Park,12,-8
2015-04-11,2015,OAK,SEA,4,5,-140,-1.5,160,7.5,105,-125,125,1.5,-190,4.38,Oakland Coliseum,9,-1
2015-04-11,2015,SD,SF,10,2,-109,-1.5,190,6.0,100,-120,-101,1.5,-230,3.13,PETCO Park,12,8
2015-04-11,2015,CIN,STL,1,4,-117,-1.5,190,6.5,-105,-115,107,1.5,-230,3.5,Great American Ballpark,5,-3
2015-04-11,2015,MIA,TB,0,2,-105,-1.5,190,7.5,100,-120,-105,1.5,-230,3.84,Marlins Park,2,-2
2015-04-11,2015,HOU,TEX,2,6,113,1.5,-190,9.0,100,-120,-123,-1.5,160,4.23,Rangers Ballpark,8,-4
2015-04-11,2015,BAL,TOR,7,1,-108,-1.5,185,8.0,-105,-115,-102,1.5,-215,4.15,Camden Yards,8,6
2015-04-11,2015,PHI,WSH,3,2,-105,1.5,-175,6.5,100,-120,-105,-1.5,155,3.33,Citizens Bank Park,5,1
2015-04-12,2015,LAD,ARI,7,4,-144,-1.5,115,8.0,100,-120,129,1.5,-135,4.72,Chase Field,11,3
2015-04-12,2015,NYM,ATL,4,3,113,1.5,-205,6.5,-115,-105,-123,-1.5,175,3.05,Turner Field,7,1
2015-04-12,2015,TOR,BAL,10,7,108,1.5,-205,8.0,100,-120,-118,-1.5,175,3.85,Camden Yards,17,3
2015-04-12,2015,NYY,BOS,14,4,-117,-1.5,176,7.5,100,-120,107,1.5,-206,4.04,Yankee Stadium,18,10
2015-04-12,2015,COL,CHC,5,6,-110,-1.5,170,10.0,-110,-110,100,1.5,-200,5.24,Coors Field,11,-1
2015-04-12,2015,STL,CIN,7,5,-113,-1.5,145,7.5,100,-120,103,1.5,-165,3.98,Great American Ballpark,12,2
2015-04-12,2015,DET,CLE,8,5,-117,-1.5,140,8.0,100,-120,107,1.5,-160,4.31,Progressive Field,13,3
2015-04-12,2015,CHC,COL,6,5,100,1.5,-200,10.0,-110,-110,-110,-1.5,170,5.0,Coors Field,11,1
2015-04-12,2015,MIN,CWS,2,6,152,1.5,-145,7.5,-110,-110,-172,-1.5,125,2.98,Guaranteed Rate Field,8,-4
2015-04-12,2015,CLE,DET,5,8,107,1.5,-160,8.0,100,-120,-117,-1.5,140,3.86,Progressive Field,13,-3
2015-04-12,2015,TEX,HOU,4,6,114,1.5,-150,8.5,-105,-115,-124,-1.5,130,3.97,Rangers Ballpark,10,-2
2015-04-12,2015,LAA,KC,2,9,-116,-1.5,180,7.0,-115,-105,106,1.5,-210,3.76,Angel Stadium,11,-7
2015-04-12,2015,KC,LAA,9,2,106,1.5,-210,7.0,-115,-105,-116,-1.5,180,3.4,Angel Stadium,11,7
2015-04-12,2015,ARI,LAD,4,7,129,1.5,-135,8.0,100,-120,-144,-1.5,115,3.49,Chase Field,11,-3
2015-04-12,2015,TB,MIA,8,5,112,1.5,-205,7.5,110,-130,-122,-1.5,175,3.54,Marlins Park,13,3
2015-04-12,2015,PIT,MIL,10,2,100,1.5,-215,8.5,-125,105,-110,-1.5,185,4.25,Miller Park,12,8
2015-04-12,2015,CWS,MIN,6,2,-172,-1.5,125,7.5,-110,-110,152,1.5,-145,4.74,Guaranteed Rate Field,8,4
2015-04-12,2015,ATL,NYM,3,4,-123,-1.5,175,6.5,-115,-105,113,1.5,-205,3.59,Turner Field,7,-1
2015-04-12,2015,BOS,NYY,4,14,107,1.5,-206,7.5,100,-120,-117,-1.5,176,3.62,Yankee Stadium,18,-10
2015-04-12,2015,SEA,OAK,8,7,-140,-1.5,120,7.0,-110,-110,125,1.5,-140,4.08,Oakland Coliseum,15,1
2015-04-12,2015,WSH,PHI,4,3,-195,-1.5,-117,7.0,105,-125,175,1.5,-102,4.63,Citizens Bank Park,7,1
2015-04-12,2015,MIL,PIT,2,10,-110,-1.5,185,8.5,-125,105,100,1.5,-215,4.45,Miller Park,12,-8
2015-04-12,2015,SF,SD,4,6,125,1.5,-205,6.5,110,-130,-140,-1.5,175,2.89,PETCO Park,10,-2
2015-04-12,2015,OAK,SEA,7,8,125,1.5,-140,7.0,-110,-110,-140,-1.5,120,3.11,Oakland Coliseum,15,-1
2015-04-12,2015,SD,SF,6,4,-140,-1.5,175,6.5,110,-130,125,1.5,-205,3.79,PETCO Park,10,2
2015-04-12,2015,CIN,STL,5,7,103,1.5,-165,7.5,100,-120,-113,-1.5,145,3.69,Great American Ballpark,12,-2
2015-04-12,2015,MIA,TB,5,8,-122,-1.5,175,7.5,110,-130,112,1.5,-205,4.12,Marlins Park,13,-3
2015-04-12,2015,HOU,TEX,6,4,-124,-1.5,130,8.5,-105,-115,114,1.5,-150,4.71,Rangers Ballpark,10,2
2015-04-12,2015,BAL,TOR,7,10,-118,-1.5,175,8.0,100,-120,108,1.5,-205,4.33,Camden Yards,17,-3
2015-04-12,2015,PHI,WSH,3,4,175,1.5,-102,7.0,105,-125,-195,-1.5,-117,2.55,Citizens Bank Park,7,-1
2015-04-13,2015,SD,ARI,4,8,-165,-1.5,145,6.5,-105,-115,150,1.5,-165,4.05,PETCO Park,12,-4
2015-04-13,2015,MIA,ATL,2,3,-101,1.5,-230,7.0,-125,105,-109,-1.5,190,3.52,Turner Field,5,-1
2015-04-13,2015,NYY,BAL,6,5,101,1.5,-210,7.5,-114,-106,-111,-1.5,180,3.73,Camden Yards,11,1
2015-04-13,2015,WSH,BOS,4,9,125,1.5,-175,9.0,105,-125,-140,-1.5,155,4.0,Fenway Park,13,-5
2015-04-13,2015,CIN,CHC,6,7,132,1.5,-175,7.5,-105,-115,-147,-1.5,155,3.23,Wrigley Field,13,-1
2015-04-13,2015,CHC,CIN,7,6,-147,-1.5,155,7.5,-105,-115,132,1.5,-175,4.46,Wrigley Field,13,1
2015-04-13,2015,SF,COL,0,2,-133,-1.5,165,7.5,-120,100,118,1.5,-195,4.28,AT&T Park,2,-2
2015-04-13,2015,PIT,DET,5,4,-140,-1.5,160,7.5,105,-125,125,1.5,-190,4.38,PNC Park,9,1
2015-04-13,2015,OAK,HOU,8,1,-109,-1.5,140,8.5,-105,-115,-101,1.5,-160,4.43,Minute Maid Park,9,7
2015-04-13,2015,MIN,KC,3,12,118,1.5,-145,8.0,-105,-115,-128,-1.5,125,3.67,Target Field,15,-9
2015-04-13,2015,TEX,LAA,3,6,116,1.5,-140,9.0,-120,100,-131,-1.5,120,4.17,Rangers Ballpark,9,-3
2015-04-13,2015,SEA,LAD,5,6,111,1.5,-210,7.0,-115,-105,-121,-1.5,180,3.32,Dodger Stadium,11,-1
2015-04-13,2015,ATL,MIA,3,2,-109,-1.5,190,7.0,-125,105,-101,1.5,-230,3.65,Turner Field,5,1
2015-04-13,2015,STL,MIL,4,5,-170,-1.5,130,7.5,100,-120,150,1.5,-150,4.72,Busch Stadium,9,-1
2015-04-13,2015,KC,MIN,12,3,-128,-1.5,125,8.0,-105,-115,118,1.5,-145,4.49,Target Field,15,9
2015-04-13,2015,PHI,NYM,0,2,150,1.5,-150,7.0,-104,-116,-170,-1.5,130,2.8,Citi Field,2,-2
2015-04-13,2015,BAL,NYY,5,6,-111,-1.5,180,7.5,-114,-106,101,1.5,-210,3.95,Camden Yards,11,-1
2015-04-13,2015,HOU,OAK,1,8,-101,1.5,-160,8.5,-105,-115,-109,-1.5,140,4.27,Minute Maid Park,9,-7
2015-04-13,2015,NYM,PHI,2,0,-170,-1.5,130,7.0,-104,-116,150,1.5,-150,4.41,Citi Field,2,2
2015-04-13,2015,DET,PIT,4,5,125,1.5,-190,7.5,105,-125,-140,-1.5,160,3.33,PNC Park,9,-1
2015-04-13,2015,ARI,SD,8,4,150,1.5,-165,6.5,-105,-115,-165,-1.5,145,2.6,PETCO Park,12,4
2015-04-13,2015,LAD,SEA,6,5,-121,-1.5,180,7.0,-115,-105,111,1.5,-210,3.83,Dodger Stadium,11,1
2015-04-13,2015,COL,SF,2,0,118,1.5,-195,7.5,-120,100,-133,-1.5,165,3.44,AT&T Park,2,2
2015-04-13,2015,MIL,STL,5,4,150,1.5,-150,7.5,100,-120,-170,-1.5,130,3.0,Busch Stadium,9,1
2015-04-13,2015,TOR,TB,1,2,-140,-1.5,155,8.5,-120,100,125,1.5,-175,4.96,Rogers Centre,3,-1
2015-04-13,2015,LAA,TEX,6,3,-131,-1.5,120,9.0,-120,100,116,1.5,-140,5.1,Rangers Ballpark,9,3
2015-04-13,2015,TB,TOR,2,1,125,1.5,-175,8.5,-120,100,-140,-1.5,155,3.78,Rogers Centre,3,1
2015-04-13,2015,BOS,WSH,9,4,-140,-1.5,155,9.0,105,-125,125,1.5,-175,5.25,Fenway Park,13,5
2015-04-14,2015,SD,ARI,5,1,-129,-1.5,180,6.5,-110,-110,119,1.5,-210,3.66,PETCO Park,6,4
2015-04-14,2015,MIA,ATL,8,2,-114,-1.5,140,7.5,105,-125,104,1.5,-160,4.0,Turner Field,10,6
2015-04-14,2015,NYY,BAL,3,4,-101,1.5,-205,8.0,-105,-115,-109,-1.5,175,4.02,Camden Yards,7,-1
2015-04-14,2015,WSH,BOS,7,8,118,1.5,-190,8.5,-105,-115,-128,-1.5,160,3.9,Fenway Park,15,-1
2015-04-14,2015,CIN,CHC,3,2,131,1.5,-170,6.5,-125,105,-146,-1.5,150,2.81,Wrigley Field,5,1
2015-04-14,2015,CHC,CIN,2,3,-146,-1.5,150,6.5,-125,105,131,1.5,-170,3.86,Wrigley Field,5,-1
2015-04-14,2015,CWS,CLE,4,1,112,1.5,-200,6.5,-120,100,-122,-1.5,170,3.07,Progressive Field,5,3
2015-04-14,2015,SF,COL,1,4,-124,-1.5,185,7.0,105,-125,114,1.5,-215,3.88,AT&T Park,5,-3
2015-04-14,2015,CLE,CWS,1,4,-122,-1.5,170,6.5,-120,100,112,1.5,-200,3.57,Progressive Field,5,-3
2015-04-14,2015,PIT,DET,0,2,-113,-1.5,175,7.5,100,-120,103,1.5,-205,3.98,PNC Park,2,-2
2015-04-14,2015,OAK,HOU,4,0,101,1.5,-200,9.0,-115,-105,-111,-1.5,170,4.48,Minute Maid Park,4,4
2015-04-14,2015,TEX,LAA,8,2,104,1.5,-165,9.0,-115,-105,-114,-1.5,145,4.41,Rangers Ballpark,10,6
2015-04-14,2015,SEA,LAD,5,6,-115,-1.5,140,7.5,-105,-115,105,1.5,-160,4.01,Dodger Stadium,11,-1
2015-04-14,2015,ATL,MIA,2,8,104,1.5,-160,7.5,105,-125,-114,-1.5,140,3.68,Turner Field,10,-6
2015-04-14,2015,PHI,NYM,5,6,200,1.5,-120,6.5,-105,-115,-230,-1.5,100,2.17,Citi Field,11,-1
2015-04-14,2015,BAL,NYY,4,3,-109,-1.5,175,8.0,-105,-115,-101,1.5,-205,4.17,Camden Yards,7,1
2015-04-14,2015,HOU,OAK,0,4,-111,-1.5,170,9.0,-115,-105,101,1.5,-200,4.73,Minute Maid Park,4,-4
2015-04-14,2015,NYM,PHI,6,5,-230,-1.5,100,6.5,-105,-115,200,1.5,-120,4.53,Citi Field,11,1
2015-04-14,2015,DET,PIT,2,0,103,1.5,-205,7.5,100,-120,-113,-1.5,175,3.69,PNC Park,2,2
2015-04-14,2015,ARI,SD,1,5,119,1.5,-210,6.5,-110,-110,-129,-1.5,180,2.97,PETCO Park,6,-4
2015-04-14,2015,LAD,SEA,6,5,105,1.5,-160,7.5,-105,-115,-115,-1.5,140,3.66,Dodger Stadium,11,1
2015-04-14,2015,COL,SF,4,1,114,1.5,-215,7.0,105,-125,-124,-1.5,185,3.27,AT&T Park,5,3
2015-04-14,2015,TOR,TB,2,3,-145,-1.5,140,8.5,-106,-114,130,1.5,-160,5.03,Rogers Centre,5,-1
2015-04-14,2015,LAA,TEX,2,8,-114,-1.5,145,9.0,-115,-105,104,1.5,-165,4.79,Rangers Ballpark,10,-6
2015-04-14,2015,TB,TOR,3,2,130,1.5,-160,8.5,-106,-114,-145,-1.5,140,3.7,Rogers Centre,5,1
2015-04-14,2015,BOS,WSH,8,7,-128,-1.5,160,8.5,-105,-115,118,1.5,-190,4.77,Fenway Park,15,1
2015-04-15,2015,SD,ARI,3,2,-133,-1.5,175,6.5,100,-120,118,1.5,-205,3.71,PETCO Park,5,1
2015-04-15,2015,MIA,ATL,6,2,-130,-1.5,125,7.5,105,-125,115,1.5,-145,4.24,Turner Field,8,4
2015-04-15,2015,NYY,BAL,5,7,-105,-1.5,150,7.5,-105,-115,-105,1.5,-170,3.84,Camden Yards,12,-2
2015-04-15,2015,WSH,BOS,10,5,112,1.5,-190,9.0,-120,100,-122,-1.5,160,4.25,Fenway Park,15,5
2015-04-15,2015,CIN,CHC,0,5,131,1.5,-190,7.0,-115,-105,-146,-1.5,160,3.03,Wrigley Field,5,-5
2015-04-15,2015,CHC,CIN,5,0,-146,-1.5,160,7.0,-115,-105,131,1.5,-190,4.15,Wrigley Field,5,5
2015-04-15,2015,CWS,CLE,2,4,118,1.5,-180,7.5,105,-125,-133,-1.5,160,3.44,Progressive Field,6,-2
2015-04-15,2015,SF,COL,2,4,-103,1.5,-180,7.5,-110,-110,-107,-1.5,160,3.81,AT&T Park,6,-2
2015-04-15,2015,CLE,CWS,4,2,-133,-1.5,160,7.5,105,-125,118,1.5,-180,4.28,Progressive Field,6,2
2015-04-15,2015,PIT,DET,0,1,-144,-1.5,150,7.5,100,-120,129,1.5,-170,4.43,PNC Park,1,-1
2015-04-15,2015,OAK,HOU,1,6,-101,1.5,-230,7.5,-120,100,-109,-1.5,190,3.77,Minute Maid Park,7,-5
2015-04-15,2015,MIN,KC,3,1,114,1.5,-155,8.5,100,-120,-124,-1.5,135,3.97,Target Field,4,2
2015-04-15,2015,TEX,LAA,2,10,114,1.5,-145,9.0,-105,-115,-124,-1.5,125,4.21,Rangers Ballpark,12,-8
2015-04-15,2015,SEA,LAD,2,5,117,1.5,-200,7.5,-110,-110,-132,-1.5,170,3.46,Dodger Stadium,7,-3
2015-04-15,2015,ATL,MIA,2,6,115,1.5,-145,7.5,105,-125,-130,-1.5,125,3.49,Turner Field,8,-4
2015-04-15,2015,STL,MIL,4,2,-155,-1.5,145,7.0,-115,-105,140,1.5,-165,4.25,Busch Stadium,6,2
2015-04-15,2015,KC,MIN,1,3,-124,-1.5,135,8.5,100,-120,114,1.5,-155,4.71,Target Field,4,-2
2015-04-15,2015,PHI,NYM,1,6,145,1.5,-165,7.0,110,-130,-160,-1.5,145,2.86,Citi Field,7,-5
2015-04-15,2015,BAL,NYY,7,5,-105,1.5,-170,7.5,-105,-115,-105,-1.5,150,3.84,Camden Yards,12,2
2015-04-15,2015,HOU,OAK,6,1,-109,-1.5,190,7.5,-120,100,-101,1.5,-230,3.91,Minute Maid Park,7,5
2015-04-15,2015,NYM,PHI,6,1,-160,-1.5,145,7.0,110,-130,145,1.5,-165,4.31,Citi Field,7,5
2015-04-15,2015,DET,PIT,1,0,129,1.5,-170,7.5,100,-120,-144,-1.5,150,3.28,PNC Park,1,1
2015-04-15,2015,ARI,SD,2,3,118,1.5,-205,6.5,100,-120,-133,-1.5,175,2.98,PETCO Park,5,-1
2015-04-15,2015,LAD,SEA,5,2,-132,-1.5,170,7.5,-110,-110,117,1.5,-200,4.27,Dodger Stadium,7,3
2015-04-15,2015,COL,SF,4,2,-107,-1.5,160,7.5,-110,-110,-103,1.5,-180,3.88,AT&T Park,6,2
2015-04-15,2015,MIL,STL,2,4,140,1.5,-165,7.0,-115,-105,-155,-1.5,145,2.92,Busch Stadium,6,-2
2015-04-15,2015,TOR,TB,12,7,-133,-1.5,150,9.0,100,-120,118,1.5,-170,5.14,Rogers Centre,19,5
2015-04-15,2015,LAA,TEX,10,2,-124,-1.5,125,9.0,-105,-115,114,1.5,-145,4.98,Rangers Ballpark,12,8
2015-04-15,2015,TB,TOR,7,12,118,1.5,-170,9.0,100,-120,-133,-1.5,150,4.13,Rogers Centre,19,-5
2015-04-15,2015,BOS,WSH,5,10,-122,-1.5,160,9.0,-120,100,112,1.5,-190,4.95,Fenway Park,15,-5
2015-04-16,2015,SF,ARI,6,7,-171,-1.5,140,6.5,-101,-119,151,1.5,-160,4.1,AT&T Park,13,-1
2015-04-16,2015,MIN,KC,8,5,105,1.5,-165,7.5,-105,-115,-115,-1.5,145,3.66,Target Field,13,3
2015-04-16,2015,NYM,MIA,7,5,-105,-1.5,195,7.5,112,-132,-105,1.5,-235,3.84,Citi Field,12,2
2015-04-16,2015,STL,MIL,4,0,-140,-1.5,155,7.5,105,-125,125,1.5,-175,4.38,Busch Stadium,4,4
2015-04-16,2015,KC,MIN,5,8,-115,-1.5,145,7.5,-105,-115,105,1.5,-165,4.01,Target Field,13,-3
2015-04-16,2015,MIA,NYM,5,7,-105,1.5,-235,7.5,112,-132,-105,-1.5,195,3.84,Citi Field,12,-2
2015-04-16,2015,WSH,PHI,5,2,-140,-1.5,165,6.5,-110,-110,125,1.5,-195,3.79,Nationals Park,7,3
2015-04-16,2015,ARI,SF,7,6,151,1.5,-160,6.5,-101,-119,-171,-1.5,140,2.59,AT&T Park,13,1
2015-04-16,2015,MIL,STL,0,4,125,1.5,-175,7.5,105,-125,-140,-1.5,155,3.33,Busch Stadium,4,-4
2015-04-16,2015,TOR,TB,2,4,102,1.5,-160,8.5,-110,-110,-112,-1.5,140,4.21,Rogers Centre,6,-2
2015-04-16,2015,TB,TOR,4,2,-112,-1.5,140,8.5,-110,-110,102,1.5,-160,4.49,Rogers Centre,6,2
2015-04-16,2015,PHI,WSH,2,5,125,1.5,-195,6.5,-110,-110,-140,-1.5,165,2.89,Nationals Park,7,-3
2015-04-17,2015,SF,ARI,0,9,-145,-1.5,160,7.0,-105,-115,130,1.5,-190,4.14,AT&T Park,9,-9
2015-04-17,2015,TOR,ATL,7,8,-161,-1.5,135,7.5,-115,-105,146,1.5,-155,4.63,Rogers Centre,15,-1
2015-04-17,2015,BOS,BAL,3,2,-145,-1.5,140,9.0,-115,-105,130,1.5,-160,5.33,Fenway Park,5,1
2015-04-17,2015,BAL,BOS,2,3,130,1.5,-160,9.0,-115,-105,-145,-1.5,140,3.91,Fenway Park,5,-1
2015-04-17,2015,SD,CHC,5,4,105,1.5,-205,8.0,100,-120,-115,-1.5,175,3.9,Wrigley Field,9,1
2015-04-17,2015,STL,CIN,6,1,-116,-1.5,185,6.5,-120,100,106,1.5,-215,3.49,Busch Stadium,7,5
2015-04-17,2015,MIN,CLE,3,2,170,1.5,105,8.5,100,-120,-190,-1.5,-125,3.15,Target Field,5,1
2015-04-17,2015,LAD,COL,7,3,-275,-1.5,-115,6.5,-115,-105,235,1.5,-105,4.77,Dodger Stadium,10,4
2015-04-17,2015,DET,CWS,2,1,-165,-1.5,130,7.5,-120,100,150,1.5,-150,4.67,Comerica Park,3,1
2015-04-17,2015,CWS,DET,1,2,150,1.5,-150,7.5,-120,100,-165,-1.5,130,3.0,Comerica Park,3,-1
2015-04-17,2015,LAA,HOU,6,3,-119,-1.5,135,9.5,105,-125,109,1.5,-155,5.16,Minute Maid Park,9,3
2015-04-17,2015,OAK,KC,4,6,-117,-1.5,145,7.5,-115,-105,107,1.5,-165,4.04,Kauffman Stadium,10,-2
2015-04-17,2015,HOU,LAA,3,6,109,1.5,-155,9.5,105,-125,-119,-1.5,135,4.55,Minute Maid Park,9,-3
2015-04-17,2015,COL,LAD,3,7,235,1.5,-105,6.5,-115,-105,-275,-1.5,-115,1.94,Dodger Stadium,10,-4
2015-04-17,2015,NYM,MIA,4,1,-133,-1.5,170,7.5,-105,-115,118,1.5,-200,4.28,Citi Field,5,3
2015-04-17,2015,PIT,MIL,6,3,-120,-1.5,175,7.5,-110,-110,110,1.5,-205,4.09,PNC Park,9,3
2015-04-17,2015,CLE,MIN,2,3,-190,-1.5,-125,8.5,100,-120,170,1.5,105,5.57,Target Field,5,-1
2015-04-17,2015,MIA,NYM,1,4,118,1.5,-200,7.5,-105,-115,-133,-1.5,170,3.44,Citi Field,5,-3
2015-04-17,2015,TB,NYY,4,5,-110,-1.5,185,7.5,105,-125,100,1.5,-215,3.93,Tropicana Field,9,-1
2015-04-17,2015,KC,OAK,6,4,107,1.5,-165,7.5,-115,-105,-117,-1.5,145,3.62,Kauffman Stadium,10,2
2015-04-17,2015,WSH,PHI,7,2,-275,-1.5,-125,7.0,-110,-110,235,1.5,105,5.13,Nationals Park,9,5
2015-04-17,2015,MIL,PIT,3,6,110,1.5,-205,7.5,-110,-110,-120,-1.5,175,3.57,PNC Park,9,-3
2015-04-17,2015,CHC,SD,4,5,-115,-1.5,175,8.0,100,-120,105,1.5,-205,4.28,Wrigley Field,9,-1
2015-04-17,2015,TEX,SEA,3,1,139,1.5,-160,7.0,-110,-110,-154,-1.5,140,2.93,T-Mobile Park,4,2
2015-04-17,2015,ARI,SF,9,0,130,1.5,-190,7.0,-105,-115,-145,-1.5,160,3.04,AT&T Park,9,9
2015-04-17,2015,CIN,STL,1,6,106,1.5,-215,6.5,-120,100,-116,-1.5,185,3.16,Busch Stadium,7,-5
2015-04-17,2015,NYY,TB,5,4,100,1.5,-215,7.5,105,-125,-110,-1.5,185,3.75,Tropicana Field,9,1
2015-04-17,2015,SEA,TEX,1,3,-154,-1.5,140,7.0,-110,-110,139,1.5,-160,4.24,T-Mobile Park,4,-2
2015-04-17,2015,ATL,TOR,8,7,146,1.5,-155,7.5,-115,-105,-161,-1.5,135,3.05,Rogers Centre,15,1
2015-04-17,2015,PHI,WSH,2,7,235,1.5,105,7.0,-110,-110,-275,-1.5,-125,2.09,Nationals Park,9,-5
2015-04-18,2015,SF,ARI,4,1,-150,-1.5,150,7.0,-115,-105,135,1.5,-170,4.2,AT&T Park,5,3
2015-04-18,2015,TOR,ATL,6,5,-182,-1.5,115,8.5,100,-120,162,1.5,-135,5.49,Rogers Centre,11,1
2015-04-18,2015,BOS,BAL,1,4,-136,-1.5,160,8.5,-110,-110,121,1.5,-190,4.9,Fenway Park,5,-3
2015-04-18,2015,BAL,BOS,4,1,121,1.5,-190,8.5,-110,-110,-136,-1.5,160,3.85,Fenway Park,5,3
2015-04-18,2015,SD,CHC,6,7,105,1.5,-210,7.0,100,-120,-115,-1.5,180,3.41,Wrigley Field,13,-1
2015-04-18,2015,STL,CIN,5,2,-147,-1.5,150,7.0,-125,105,132,1.5,-170,4.17,Busch Stadium,7,3
2015-04-18,2015,MIN,CLE,2,4,-109,-1.5,185,8.5,-105,-115,-101,1.5,-215,4.43,Target Field,6,-2
2015-04-18,2015,LAD,COL,6,3,-180,-1.5,120,7.5,105,-125,160,1.5,-140,4.82,Dodger Stadium,9,3
2015-04-18,2015,DET,CWS,3,12,-116,-1.5,170,7.5,-115,-105,106,1.5,-200,4.03,Comerica Park,15,-9
2015-04-18,2015,CWS,DET,12,3,106,1.5,-200,7.5,-115,-105,-116,-1.5,170,3.64,Comerica Park,15,9
2015-04-18,2015,LAA,HOU,0,4,107,1.5,-205,8.5,-125,105,-117,-1.5,175,4.11,Minute Maid Park,4,-4
2015-04-18,2015,OAK,KC,5,0,115,1.5,-195,7.5,105,-125,-130,-1.5,165,3.49,Kauffman Stadium,5,5
2015-04-18,2015,HOU,LAA,4,0,-117,-1.5,175,8.5,-125,105,107,1.5,-205,4.58,Minute Maid Park,4,4
2015-04-18,2015,COL,LAD,3,6,160,1.5,-140,7.5,105,-125,-180,-1.5,120,2.88,Dodger Stadium,9,-3
2015-04-18,2015,NYM,MIA,5,4,-131,-1.5,170,7.0,-110,-110,116,1.5,-200,3.97,Citi Field,9,1
2015-04-18,2015,PIT,MIL,6,2,-144,-1.5,150,7.5,-115,-105,129,1.5,-170,4.43,PNC Park,8,4
2015-04-18,2015,CLE,MIN,4,2,-101,1.5,-215,8.5,-105,-115,-109,-1.5,185,4.27,Target Field,6,2
2015-04-18,2015,MIA,NYM,4,5,116,1.5,-200,7.0,-110,-110,-131,-1.5,170,3.24,Citi Field,9,-1
2015-04-18,2015,TB,NYY,0,9,-102,1.5,-170,7.0,100,-120,-108,-1.5,150,3.53,Tropicana Field,9,-9
2015-04-18,2015,KC,OAK,0,5,-130,-1.5,165,7.5,105,-125,115,1.5,-195,4.24,Kauffman Stadium,5,-5
2015-04-18,2015,WSH,PHI,3,5,-180,-1.5,120,7.5,100,-120,160,1.5,-140,4.82,Nationals Park,8,-2
2015-04-18,2015,MIL,PIT,2,6,129,1.5,-170,7.5,-115,-105,-144,-1.5,150,3.28,PNC Park,8,-4
2015-04-18,2015,CHC,SD,7,6,-115,-1.5,180,7.0,100,-120,105,1.5,-210,3.74,Wrigley Field,13,1
2015-04-18,2015,TEX,SEA,1,3,175,1.5,-130,7.0,100,-120,-205,-1.5,110,2.55,T-Mobile Park,4,-2
2015-04-18,2015,ARI,SF,1,4,135,1.5,-170,7.0,-115,-105,-150,-1.5,150,2.98,AT&T Park,5,-3
2015-04-18,2015,CIN,STL,2,5,132,1.5,-170,7.0,-125,105,-147,-1.5,150,3.02,Busch Stadium,7,-3
2015-04-18,2015,NYY,TB,9,0,-108,-1.5,150,7.0,100,-120,-102,1.5,-170,3.63,Tropicana Field,9,9
2015-04-18,2015,SEA,TEX,3,1,-205,-1.5,110,7.0,100,-120,175,1.5,-130,4.7,T-Mobile Park,4,2
2015-04-18,2015,ATL,TOR,5,6,162,1.5,-135,8.5,100,-120,-182,-1.5,115,3.24,Rogers Centre,11,-1
2015-04-18,2015,PHI,WSH,5,3,160,1.5,-140,7.5,100,-120,-180,-1.5,120,2.88,Nationals Park,8,2
2015-04-19,2015,SF,ARI,1,5,-147,-1.5,160,7.0,-120,100,132,1.5,-190,4.17,AT&T Park,6,-4
2015-04-19,2015,TOR,ATL,2,5,-175,-1.5,110,8.5,-117,-103,155,1.5,-130,5.41,Rogers Centre,7,-3
2015-04-19,2015,BOS,BAL,3,8,-140,-1.5,140,8.5,100,-120,125,1.5,-165,4.96,Fenway Park,11,-5
2015-04-19,2015,BAL,BOS,8,3,125,1.5,-165,8.5,100,-120,-140,-1.5,140,3.78,Fenway Park,11,5
2015-04-19,2015,SD,CHC,5,2,110,1.5,-210,7.0,105,-125,-120,-1.5,180,3.33,Wrigley Field,7,3
2015-04-19,2015,STL,CIN,2,1,-195,-1.5,110,7.0,-120,100,175,1.5,-130,4.63,Busch Stadium,3,1
2015-04-19,2015,MIN,CLE,7,2,101,1.5,-165,9.0,-115,-105,-111,-1.5,145,4.48,Target Field,9,5
2015-04-19,2015,LAD,COL,7,0,-170,-1.5,130,8.0,-120,100,150,1.5,-150,5.04,Dodger Stadium,7,7
2015-04-19,2015,DET,CWS,9,1,-140,-1.5,150,8.0,-115,-105,125,1.5,-170,4.67,Comerica Park,10,8
2015-04-19,2015,CWS,DET,1,9,125,1.5,-170,8.0,-115,-105,-140,-1.5,150,3.56,Comerica Park,10,-8
2015-04-19,2015,LAA,HOU,3,4,-115,-1.5,140,8.5,-105,-115,105,1.5,-160,4.55,Minute Maid Park,7,-1
2015-04-19,2015,OAK,KC,2,4,-116,-1.5,155,7.0,-105,-115,106,1.5,-175,3.76,Kauffman Stadium,6,-2
2015-04-19,2015,HOU,LAA,4,3,105,1.5,-160,8.5,-105,-115,-115,-1.5,140,4.15,Minute Maid Park,7,1
2015-04-19,2015,COL,LAD,0,7,150,1.5,-150,8.0,-120,100,-170,-1.5,130,3.2,Dodger Stadium,7,-7
2015-04-19,2015,NYM,MIA,7,6,-177,-1.5,135,6.5,105,-125,157,1.5,-155,4.15,Citi Field,13,1
2015-04-19,2015,PIT,MIL,5,2,-175,-1.5,125,7.0,100,-120,155,1.5,-145,4.45,PNC Park,7,3
2015-04-19,2015,CLE,MIN,2,7,-111,-1.5,145,9.0,-115,-105,101,1.5,-165,4.73,Target Field,9,-5
2015-04-19,2015,MIA,NYM,6,7,157,1.5,-155,6.5,105,-125,-177,-1.5,135,2.53,Citi Field,13,-1
2015-04-19,2015,TB,NYY,3,5,116,1.5,-150,7.0,-115,-105,-126,-1.5,130,3.24,Tropicana Field,8,-2
2015-04-19,2015,KC,OAK,4,2,106,1.5,-175,7.0,-105,-115,-116,-1.5,155,3.4,Kauffman Stadium,6,2
2015-04-19,2015,WSH,PHI,4,1,-235,-1.5,-105,7.0,-125,105,205,1.5,-115,4.91,Nationals Park,5,3
2015-04-19,2015,MIL,PIT,2,5,155,1.5,-145,7.0,100,-120,-175,-1.5,125,2.75,PNC Park,7,-3
2015-04-19,2015,CHC,SD,2,5,-120,-1.5,180,7.0,105,-125,110,1.5,-210,3.82,Wrigley Field,7,-3
2015-04-19,2015,TEX,SEA,10,11,150,1.5,-155,7.0,-110,-110,-170,-1.5,135,2.8,T-Mobile Park,21,-1
2015-04-19,2015,ARI,SF,5,1,132,1.5,-190,7.0,-120,100,-147,-1.5,160,3.02,AT&T Park,6,4
2015-04-19,2015,CIN,STL,1,2,175,1.5,-130,7.0,-120,100,-195,-1.5,110,2.55,Busch Stadium,3,-1
2015-04-19,2015,NYY,TB,5,3,-126,-1.5,130,7.0,-115,-105,116,1.5,-150,3.9,Tropicana Field,8,2
2015-04-19,2015,SEA,TEX,11,10,-170,-1.5,135,7.0,-110,-110,150,1.5,-155,4.41,T-Mobile Park,21,1
2015-04-19,2015,ATL,TOR,5,2,155,1.5,-130,8.5,-117,-103,-175,-1.5,110,3.33,Rogers Centre,7,3
2015-04-19,2015,PHI,WSH,1,4,205,1.5,-115,7.0,-125,105,-235,-1.5,-105,2.3,Nationals Park,5,-3
2015-04-20,2015,BOS,BAL,7,1,-128,-1.5,160,8.5,-105,-115,118,1.5,-190,4.77,Fenway Park,8,6
2015-04-20,2015,BAL,BOS,1,7,118,1.5,-190,8.5,-105,-115,-128,-1.5,160,3.9,Fenway Park,8,-6
2015-04-20,2015,PIT,CHC,2,5,-103,1.5,-170,7.0,-125,105,-107,-1.5,150,3.55,PNC Park,7,-3
2015-04-20,2015,MIL,CIN,1,6,-104,1.5,-170,7.5,-115,-105,-106,-1.5,150,3.82,Miller Park,7,-5
2015-04-20,2015,CWS,CLE,4,3,-110,-1.5,190,9.0,-125,105,100,1.5,-230,4.71,Guaranteed Rate Field,7,1
2015-04-20,2015,SD,COL,14,3,133,1.5,-160,9.5,-120,100,-148,-1.5,140,4.08,Coors Field,17,11
2015-04-20,2015,CLE,CWS,3,4,100,1.5,-230,9.0,-125,105,-110,-1.5,190,4.5,Guaranteed Rate Field,7,-1
2015-04-20,2015,NYY,DET,1,2,114,1.5,-195,9.0,-105,-115,-124,-1.5,165,4.21,Comerica Park,3,-1
2015-04-20,2015,SEA,HOU,5,7,-210,-1.5,100,7.5,-120,100,180,1.5,-120,5.08,T-Mobile Park,12,-2
2015-04-20,2015,MIN,KC,1,7,125,1.5,-170,8.0,-105,-115,-140,-1.5,150,3.56,Kauffman Stadium,8,-6
2015-04-20,2015,OAK,LAA,6,3,138,1.5,-160,7.5,-105,-115,-153,-1.5,140,3.15,Angel Stadium,9,3
2015-04-20,2015,CIN,MIL,6,1,-106,-1.5,150,7.5,-115,-105,-104,1.5,-170,3.86,Miller Park,7,5
2015-04-20,2015,KC,MIN,7,1,-140,-1.5,150,8.0,-105,-115,125,1.5,-170,4.67,Kauffman Stadium,8,6
2015-04-20,2015,DET,NYY,2,1,-124,-1.5,165,9.0,-105,-115,114,1.5,-195,4.98,Comerica Park,3,1
2015-04-20,2015,LAA,OAK,3,6,-153,-1.5,140,7.5,-105,-115,138,1.5,-160,4.54,Angel Stadium,9,-3
2015-04-20,2015,CHC,PIT,5,2,-107,-1.5,150,7.0,-125,105,-103,1.5,-170,3.62,PNC Park,7,3
2015-04-20,2015,COL,SD,3,14,-148,-1.5,140,9.5,-120,100,133,1.5,-160,5.67,Coors Field,17,-11
2015-04-20,2015,HOU,SEA,7,5,180,1.5,-120,7.5,-120,100,-210,-1.5,100,2.68,T-Mobile Park,12,2
2015-04-21,2015,TEX,ARI,7,1,130,1.5,-160,9.0,-120,100,-145,-1.5,140,3.91,Chase Field,8,6
2015-04-21,2015,NYM,ATL,7,1,-148,-1.5,145,7.0,-120,100,133,1.5,-165,4.18,Citi Field,8,6
2015-04-21,2015,TOR,BAL,13,6,-125,-1.5,160,9.0,-115,-105,115,1.5,-190,5.0,Rogers Centre,19,7
2015-04-21,2015,TB,BOS,0,1,-119,-1.5,165,7.5,-105,-115,109,1.5,-195,4.08,Tropicana Field,1,-1
2015-04-21,2015,PIT,CHC,8,9,-142,-1.5,145,7.5,100,-120,127,1.5,-165,4.4,PNC Park,17,-1
2015-04-21,2015,MIL,CIN,10,16,-126,-1.5,160,7.5,-110,-110,116,1.5,-190,4.18,Miller Park,26,-6
2015-04-21,2015,CWS,CLE,2,6,118,1.5,-150,8.5,-110,-110,-128,-1.5,130,3.9,Guaranteed Rate Field,8,-4
2015-04-21,2015,SD,COL,7,6,-102,1.5,-200,10.0,-114,-106,-108,-1.5,170,5.05,Coors Field,13,1
2015-04-21,2015,CLE,CWS,6,2,-128,-1.5,130,8.5,-110,-110,118,1.5,-150,4.77,Guaranteed Rate Field,8,4
2015-04-21,2015,NYY,DET,5,2,108,1.5,-205,8.0,-110,-110,-118,-1.5,175,3.85,Comerica Park,7,3
2015-04-21,2015,SEA,HOU,3,6,-125,-1.5,170,7.0,-105,-115,115,1.5,-200,3.89,T-Mobile Park,9,-3
2015-04-21,2015,MIN,KC,5,6,130,1.5,-170,8.0,100,-120,-145,-1.5,150,3.48,Kauffman Stadium,11,-1
2015-04-21,2015,OAK,LAA,1,14,108,1.5,-190,7.5,-115,-105,-118,-1.5,160,3.61,Angel Stadium,15,-13
2015-04-21,2015,SF,LAD,6,2,118,1.5,-140,7.0,-120,100,-133,-1.5,120,3.21,AT&T Park,8,4
2015-04-21,2015,PHI,MIA,7,3,107,1.5,-165,7.5,-110,-110,-117,-1.5,145,3.62,Citizens Bank Park,10,4
2015-04-21,2015,CIN,MIL,16,10,116,1.5,-190,7.5,-110,-110,-126,-1.5,160,3.47,Miller Park,26,6
2015-04-21,2015,KC,MIN,6,5,-145,-1.5,150,8.0,100,-120,130,1.5,-170,4.73,Kauffman Stadium,11,1
2015-04-21,2015,ATL,NYM,1,7,133,1.5,-165,7.0,-120,100,-148,-1.5,145,3.0,Citi Field,8,-6
2015-04-21,2015,DET,NYY,2,5,-118,-1.5,175,8.0,-110,-110,108,1.5,-205,4.33,Comerica Park,7,-3
2015-04-21,2015,LAA,OAK,14,1,-118,-1.5,160,7.5,-115,-105,108,1.5,-190,4.06,Angel Stadium,15,13
2015-04-21,2015,MIA,PHI,3,7,-117,-1.5,145,7.5,-110,-110,107,1.5,-165,4.04,Citizens Bank Park,10,-4
2015-04-21,2015,CHC,PIT,9,8,127,1.5,-165,7.5,100,-120,-142,-1.5,145,3.3,PNC Park,17,1
2015-04-21,2015,COL,SD,6,7,-108,-1.5,170,10.0,-114,-106,-102,1.5,-200,5.19,Coors Field,13,-1
2015-04-21,2015,HOU,SEA,6,3,115,1.5,-200,7.0,-105,-115,-125,-1.5,170,3.26,T-Mobile Park,9,3
2015-04-21,2015,LAD,SF,2,6,-133,-1.5,120,7.0,-120,100,118,1.5,-140,4.0,AT&T Park,8,-4
2015-04-21,2015,WSH,STL,2,1,-117,-1.5,185,7.0,105,-125,107,1.5,-215,3.77,Nationals Park,3,1
2015-04-21,2015,BOS,TB,1,0,109,1.5,-195,7.5,-105,-115,-119,-1.5,165,3.59,Tropicana Field,1,1
2015-04-21,2015,ARI,TEX,1,7,-145,-1.5,140,9.0,-120,100,130,1.5,-160,5.33,Chase Field,8,-6
2015-04-21,2015,BAL,TOR,6,13,115,1.5,-190,9.0,-115,-105,-125,-1.5,160,4.19,Rogers Centre,19,-7
2015-04-21,2015,STL,WSH,1,2,107,1.5,-215,7.0,105,-125,-117,-1.5,185,3.38,Nationals Park,3,-1
2015-04-22,2015,TEX,ARI,5,8,101,1.5,-210,8.5,-120,100,-111,-1.5,180,4.23,Chase Field,13,-3
2015-04-22,2015,NYM,ATL,3,2,-140,-1.5,160,7.5,-110,-110,125,1.5,-190,4.38,Citi Field,5,1
2015-04-22,2015,TOR,BAL,4,2,105,1.5,-160,9.0,-110,-110,-115,-1.5,140,4.39,Rogers Centre,6,2
2015-04-22,2015,TB,BOS,7,5,110,1.5,-155,7.5,-110,-110,-120,-1.5,135,3.57,Tropicana Field,12,2
2015-04-22,2015,PIT,CHC,4,3,-109,-1.5,190,7.5,-105,-115,-101,1.5,-230,3.91,PNC Park,7,1
2015-04-22,2015,MIL,CIN,1,2,119,1.5,-145,7.0,-120,100,-134,-1.5,125,3.2,Miller Park,3,-1
2015-04-22,2015,CWS,CLE,6,0,109,1.5,-160,7.5,-110,-110,-119,-1.5,140,3.59,Guaranteed Rate Field,6,6
2015-04-22,2015,SD,COL,4,5,-103,1.5,-200,10.5,100,-120,-107,-1.5,170,5.33,Coors Field,9,-1
2015-04-22,2015,CLE,CWS,0,6,-119,-1.5,140,7.5,-110,-110,109,1.5,-160,4.08,Guaranteed Rate Field,6,-6
2015-04-22,2015,NYY,DET,13,4,175,1.5,-130,7.5,-105,-115,-195,-1.5,110,2.73,Comerica Park,17,9
2015-04-22,2015,SEA,HOU,3,2,-164,-1.5,135,7.5,-110,-110,149,1.5,-155,4.66,T-Mobile Park,5,1
2015-04-22,2015,MIN,KC,3,0,131,1.5,-159,8.5,-110,-110,-146,-1.5,139,3.68,Kauffman Stadium,3,3
2015-04-22,2015,OAK,LAA,9,2,-105,-1.5,149,7.5,-105,-115,-105,1.5,-169,3.84,Angel Stadium,11,7
2015-04-22,2015,SF,LAD,3,2,126,1.5,-155,5.5,-109,-111,-141,-1.5,135,2.43,AT&T Park,5,1
2015-04-22,2015,PHI,MIA,1,6,-128,-1.5,175,7.0,-115,-105,118,1.5,-205,3.93,Citizens Bank Park,7,-5
2015-04-22,2015,CIN,MIL,2,1,-134,-1.5,125,7.0,-120,100,119,1.5,-145,4.01,Miller Park,3,1
2015-04-22,2015,KC,MIN,0,3,-146,-1.5,139,8.5,-110,-110,131,1.5,-159,5.04,Kauffman Stadium,3,-3
2015-04-22,2015,ATL,NYM,2,3,125,1.5,-190,7.5,-110,-110,-140,-1.5,160,3.33,Citi Field,5,-1
2015-04-22,2015,DET,NYY,4,13,-195,-1.5,110,7.5,-105,-115,175,1.5,-130,4.96,Comerica Park,17,-9
2015-04-22,2015,LAA,OAK,2,9,-105,1.5,-169,7.5,-105,-115,-105,-1.5,149,3.84,Angel Stadium,11,-7
2015-04-22,2015,MIA,PHI,6,1,118,1.5,-205,7.0,-115,-105,-128,-1.5,175,3.21,Citizens Bank Park,7,5
2015-04-22,2015,CHC,PIT,3,4,-101,1.5,-230,7.5,-105,-115,-109,-1.5,190,3.77,PNC Park,7,-1
2015-04-22,2015,COL,SD,5,4,-107,-1.5,170,10.5,100,-120,-103,1.5,-200,5.43,Coors Field,9,1
2015-04-22,2015,HOU,SEA,2,3,149,1.5,-155,7.5,-110,-110,-164,-1.5,135,3.01,T-Mobile Park,5,-1
2015-04-22,2015,LAD,SF,2,3,-141,-1.5,135,5.5,-109,-111,126,1.5,-155,3.22,AT&T Park,5,-1
2015-04-22,2015,WSH,STL,5,7,100,1.5,-170,7.0,-125,105,-110,-1.5,150,3.5,Nationals Park,12,-2
2015-04-22,2015,BOS,TB,5,7,-120,-1.5,135,7.5,-110,-110,110,1.5,-155,4.09,Tropicana Field,12,-2
2015-04-22,2015,ARI,TEX,8,5,-111,-1.5,180,8.5,-120,100,101,1.5,-210,4.47,Chase Field,13,3
2015-04-22,2015,BAL,TOR,2,4,-115,-1.5,140,9.0,-110,-110,105,1.5,-160,4.81,Rogers Centre,6,-2
2015-04-22,2015,STL,WSH,7,5,-110,-1.5,150,7.0,-125,105,100,1.5,-170,3.67,Nationals Park,12,2
2015-04-23,2015,NYM,ATL,6,3,-125,-1.5,175,7.0,105,-125,115,1.5,-205,3.89,Citi Field,9,3
2015-04-23,2015,TOR,BAL,7,6,-130,-1.5,180,8.0,-105,-115,115,1.5,-210,4.52,Rogers Centre,13,1
2015-04-23,2015,TB,BOS,2,1,-145,-1.5,170,7.5,105,-125,130,1.5,-200,4.44,Tropicana Field,3,1
2015-04-23,2015,PIT,CHC,5,4,105,1.5,-164,7.0,-115,-105,-115,-1.5,144,3.41,PNC Park,9,1
2015-04-23,2015,MIL,CIN,4,2,100,1.5,-165,8.0,-105,-115,-110,-1.5,145,4.0,Miller Park,6,2
2015-04-23,2015,SD,COL,1,2,101,1.5,-200,10.0,-115,-105,-111,-1.5,170,4.98,Coors Field,3,-1
2015-04-23,2015,KC,CWS,3,2,135,1.5,-175,7.0,110,-130,-150,-1.5,155,2.98,Guaranteed Rate Field,5,1
2015-04-23,2015,NYY,DET,2,1,-108,-1.5,150,7.0,-125,105,-102,1.5,-170,3.63,Comerica Park,3,1
2015-04-23,2015,CWS,KC,2,3,-150,-1.5,155,7.0,110,-130,135,1.5,-175,4.2,Guaranteed Rate Field,5,-1
2015-04-23,2015,OAK,LAA,0,2,120,1.5,-200,8.0,105,-125,-135,-1.5,170,3.64,Angel Stadium,2,-2
2015-04-23,2015,SF,LAD,3,2,102,1.5,-170,7.5,-110,-110,-112,-1.5,150,3.71,AT&T Park,5,1
2015-04-23,2015,PHI,MIA,1,9,115,1.5,-155,8.0,100,-120,-125,-1.5,135,3.72,Citizens Bank Park,10,-8
2015-04-23,2015,CIN,MIL,2,4,-110,-1.5,145,8.0,-105,-115,100,1.5,-165,4.19,Miller Park,6,-2
2015-04-23,2015,ATL,NYM,3,6,115,1.5,-205,7.0,105,-125,-125,-1.5,175,3.26,Citi Field,9,-3
2015-04-23,2015,DET,NYY,1,2,-102,1.5,-170,7.0,-125,105,-108,-1.5,150,3.53,Comerica Park,3,-1
2015-04-23,2015,LAA,OAK,2,0,-135,-1.5,170,8.0,105,-125,120,1.5,-200,4.6,Angel Stadium,2,2
2015-04-23,2015,MIA,PHI,9,1,-125,-1.5,135,8.0,100,-120,115,1.5,-155,4.44,Citizens Bank Park,10,8
2015-04-23,2015,CHC,PIT,4,5,-115,-1.5,144,7.0,-115,-105,105,1.5,-164,3.74,PNC Park,9,-1
2015-04-23,2015,COL,SD,2,1,-111,-1.5,170,10.0,-115,-105,101,1.5,-200,5.26,Coors Field,3,1
2015-04-23,2015,LAD,SF,2,3,-112,-1.5,150,7.5,-110,-110,102,1.5,-170,3.96,AT&T Park,5,-1
2015-04-23,2015,WSH,STL,1,4,-134,-1.5,170,6.5,100,-120,119,1.5,-200,3.72,Nationals Park,5,-3
2015-04-23,2015,BOS,TB,1,2,130,1.5,-200,7.5,105,-125,-145,-1.5,170,3.26,Tropicana Field,3,-1
2015-04-23,2015,BAL,TOR,6,7,115,1.5,-210,8.0,-105,-115,-130,-1.5,180,3.72,Rogers Centre,13,-1
2015-04-23,2015,STL,WSH,4,1,119,1.5,-200,6.5,100,-120,-134,-1.5,170,2.97,Nationals Park,5,3
2015-04-24,2015,PIT,ARI,4,1,-130,-1.5,130,8.0,-120,100,115,1.5,-150,4.52,Chase Field,5,3
2015-04-24,2015,PHI,ATL,1,0,107,1.5,-160,6.5,-108,-112,-117,-1.5,140,3.14,Citizens Bank Park,1,1
2015-04-24,2015,BOS,BAL,7,5,-110,-1.5,145,8.0,-115,-105,100,1.5,-165,4.19,Camden Yards,12,2
2015-04-24,2015,BAL,BOS,5,7,100,1.5,-165,8.0,-115,-105,-110,-1.5,145,4.0,Camden Yards,12,-2
2015-04-24,2015,CIN,CHC,3,7,-110,-1.5,190,7.0,-111,-109,100,1.5,-230,3.67,Great American Ballpark,10,-4
2015-04-24,2015,CHC,CIN,7,3,100,1.5,-230,7.0,-111,-109,-110,-1.5,190,3.5,Great American Ballpark,10,4
2015-04-24,2015,DET,CLE,1,13,-116,-1.5,170,8.0,-120,100,106,1.5,-200,4.3,Comerica Park,14,-12
2015-04-24,2015,SF,COL,4,6,-123,-1.5,125,10.5,-105,-115,113,1.5,-145,5.79,Coors Field,10,-2
2015-04-24,2015,KC,CWS,2,3,111,1.5,-205,7.5,-105,-115,-121,-1.5,175,3.55,Guaranteed Rate Field,5,-1
2015-04-24,2015,CLE,DET,13,1,106,1.5,-200,8.0,-120,100,-116,-1.5,170,3.88,Comerica Park,14,12
2015-04-24,2015,OAK,HOU,4,5,-134,-1.5,172,7.0,-110,-110,119,1.5,-202,4.01,Oakland Coliseum,9,-1
2015-04-24,2015,CWS,KC,3,2,-121,-1.5,175,7.5,-105,-115,111,1.5,-205,4.11,Guaranteed Rate Field,5,1
2015-04-24,2015,TEX,LAA,2,3,153,1.5,-140,8.0,-105,-115,-173,-1.5,120,3.16,Angel Stadium,5,-1
2015-04-24,2015,SD,LAD,0,3,110,1.5,-165,6.0,-105,-115,-120,-1.5,145,2.86,PETCO Park,3,-3
2015-04-24,2015,WSH,MIA,2,3,-125,-1.5,135,7.5,100,-120,115,1.5,-155,4.17,Marlins Park,5,-1
2015-04-24,2015,STL,MIL,3,0,-142,-1.5,110,7.5,-120,100,127,1.5,-130,4.4,Miller Park,3,3
2015-04-24,2015,SEA,MIN,2,0,-210,-1.5,110,6.5,-111,-109,180,1.5,-130,4.4,T-Mobile Park,2,2
2015-04-24,2015,NYY,NYM,6,1,-145,-1.5,155,7.0,100,-120,130,1.5,-175,4.14,Yankee Stadium,7,5
2015-04-24,2015,NYM,NYY,1,6,130,1.5,-175,7.0,100,-120,-145,-1.5,155,3.04,Yankee Stadium,7,-5
2015-04-24,2015,HOU,OAK,5,4,119,1.5,-202,7.0,-110,-110,-134,-1.5,172,3.2,Oakland Coliseum,9,1
2015-04-24,2015,ATL,PHI,0,1,-117,-1.5,140,6.5,-108,-112,107,1.5,-160,3.5,Citizens Bank Park,1,-1
2015-04-24,2015,ARI,PIT,1,4,115,1.5,-150,8.0,-120,100,-130,-1.5,130,3.72,Chase Field,5,-3
2015-04-24,2015,LAD,SD,3,0,-120,-1.5,145,6.0,-105,-115,110,1.5,-165,3.27,PETCO Park,3,3
2015-04-24,2015,MIN,SEA,0,2,180,1.5,-130,6.5,-111,-109,-210,-1.5,110,2.32,T-Mobile Park,2,-2
2015-04-24,2015,COL,SF,6,4,113,1.5,-145,10.5,-105,-115,-123,-1.5,125,4.93,Coors Field,10,2
2015-04-24,2015,MIL,STL,0,3,127,1.5,-130,7.5,-120,100,-142,-1.5,110,3.3,Miller Park,3,-3
2015-04-24,2015,TOR,TB,3,12,112,1.5,-200,7.5,-105,-115,-122,-1.5,170,3.54,Tropicana Field,15,-9
2015-04-24,2015,LAA,TEX,3,2,-173,-1.5,120,8.0,-105,-115,153,1.5,-140,5.07,Angel Stadium,5,1
2015-04-24,2015,TB,TOR,12,3,-122,-1.5,170,7.5,-105,-115,112,1.5,-200,4.12,Tropicana Field,15,9
2015-04-24,2015,MIA,WSH,3,2,115,1.5,-155,7.5,100,-120,-125,-1.5,135,3.49,Marlins Park,5,1
2015-04-25,2015,PIT,ARI,2,1,-128,-1.5,125,9.0,100,-120,118,1.5,-145,5.05,Chase Field,3,1
2015-04-25,2015,PHI,ATL,2,5,110,1.5,-160,7.5,-110,-110,-120,-1.5,140,3.57,Citizens Bank Park,7,-3
2015-04-25,2015,BOS,BAL,4,5,106,1.5,-210,8.5,-105,-115,-116,-1.5,180,4.13,Camden Yards,9,-1
2015-04-25,2015,BAL,BOS,5,4,-116,-1.5,180,8.5,-105,-115,106,1.5,-210,4.56,Camden Yards,9,1
2015-04-25,2015,DET,CLE,4,1,-161,-1.5,125,9.5,-105,-115,146,1.5,-145,5.86,Comerica Park,5,3
2015-04-25,2015,SF,COL,5,4,125,1.5,-165,9.5,-120,100,-140,-1.5,145,4.22,Coors Field,9,1
2015-04-25,2015,CLE,DET,1,4,146,1.5,-145,9.5,-105,-115,-161,-1.5,125,3.86,Comerica Park,5,-3
2015-04-25,2015,OAK,HOU,3,9,-110,-1.5,180,8.5,-105,-115,100,1.5,-210,4.45,Oakland Coliseum,12,-6
2015-04-25,2015,TEX,LAA,1,4,135,1.5,-165,7.5,-115,-105,-150,-1.5,145,3.19,Angel Stadium,5,-3
2015-04-25,2015,SD,LAD,8,11,112,1.5,-165,6.0,-120,100,-122,-1.5,145,2.83,PETCO Park,19,-3
2015-04-25,2015,WSH,MIA,0,8,-140,-1.5,115,7.5,100,-120,125,1.5,-135,4.38,Marlins Park,8,-8
2015-04-25,2015,STL,MIL,5,3,-163,-1.5,100,7.5,-115,-105,148,1.5,-120,4.65,Miller Park,8,2
2015-04-25,2015,SEA,MIN,5,8,-153,-1.5,145,7.5,-110,-110,138,1.5,-165,4.54,T-Mobile Park,13,-3
2015-04-25,2015,NYY,NYM,2,8,-122,-1.5,175,7.0,-125,105,112,1.5,-205,3.85,Yankee Stadium,10,-6
2015-04-25,2015,NYM,NYY,8,2,112,1.5,-205,7.0,-125,105,-122,-1.5,175,3.3,Yankee Stadium,10,6
2015-04-25,2015,HOU,OAK,9,3,100,1.5,-210,8.5,-105,-115,-110,-1.5,180,4.25,Oakland Coliseum,12,6
2015-04-25,2015,ATL,PHI,5,2,-120,-1.5,140,7.5,-110,-110,110,1.5,-160,4.09,Citizens Bank Park,7,3
2015-04-25,2015,ARI,PIT,1,2,118,1.5,-145,9.0,100,-120,-128,-1.5,125,4.13,Chase Field,3,-1
2015-04-25,2015,LAD,SD,11,8,-122,-1.5,145,6.0,-120,100,112,1.5,-165,3.3,PETCO Park,19,3
2015-04-25,2015,MIN,SEA,8,5,138,1.5,-165,7.5,-110,-110,-153,-1.5,145,3.15,T-Mobile Park,13,3
2015-04-25,2015,COL,SF,4,5,-140,-1.5,145,9.5,-120,100,125,1.5,-165,5.54,Coors Field,9,-1
2015-04-25,2015,MIL,STL,3,5,148,1.5,-120,7.5,-115,-105,-163,-1.5,100,3.02,Miller Park,8,-2
2015-04-25,2015,TOR,TB,2,4,-105,-1.5,155,8.5,-108,-112,-105,1.5,-175,4.35,Tropicana Field,6,-2
2015-04-25,2015,LAA,TEX,4,1,-150,-1.5,145,7.5,-115,-105,135,1.5,-165,4.5,Angel Stadium,5,3
2015-04-25,2015,TB,TOR,4,2,-105,1.5,-175,8.5,-108,-112,-105,-1.5,155,4.35,Tropicana Field,6,2
2015-04-25,2015,MIA,WSH,8,0,125,1.5,-135,7.5,100,-120,-140,-1.5,115,3.33,Marlins Park,8,8
2015-04-26,2015,PIT,ARI,8,0,-131,-1.5,120,8.5,-117,-103,116,1.5,-140,4.82,Chase Field,8,8
2015-04-26,2015,PHI,ATL,5,4,-107,-1.5,185,7.5,-120,100,-103,1.5,-215,3.88,Citizens Bank Park,9,1
2015-04-26,2015,BOS,BAL,7,18,-102,1.5,-230,8.5,-110,-110,-108,-1.5,190,4.29,Camden Yards,25,-11
2015-04-26,2015,BAL,BOS,18,7,-108,-1.5,190,8.5,-110,-110,-102,1.5,-230,4.41,Camden Yards,25,11
2015-04-26,2015,CIN,CHC,2,5,106,1.5,-165,7.0,100,-120,-116,-1.5,145,3.4,Great American Ballpark,7,-3
2015-04-26,2015,CHC,CIN,5,2,-116,-1.5,145,7.0,100,-120,106,1.5,-165,3.76,Great American Ballpark,7,3
2015-04-26,2015,DET,CLE,8,6,-105,1.5,-170,8.0,-110,-110,-105,-1.5,150,4.1,Comerica Park,14,2
2015-04-26,2015,KC,CWS,3,5,-115,-1.5,140,8.5,100,-120,105,1.5,-160,4.55,Guaranteed Rate Field,8,-2
2015-04-26,2015,CLE,DET,6,8,-105,-1.5,150,8.0,-110,-110,-105,1.5,-170,4.1,Comerica Park,14,-2
2015-04-26,2015,OAK,HOU,6,7,-171,-1.5,120,8.0,100,-120,151,1.5,-140,5.05,Oakland Coliseum,13,-1
2015-04-26,2015,CWS,KC,5,3,105,1.5,-160,8.5,100,-120,-115,-1.5,140,4.15,Guaranteed Rate Field,8,2
2015-04-26,2015,TEX,LAA,5,4,135,1.5,-160,8.0,-120,100,-150,-1.5,140,3.4,Angel Stadium,9,1
2015-04-26,2015,SD,LAD,3,1,-131,-1.5,170,7.5,105,-125,116,1.5,-200,4.25,PETCO Park,4,2
2015-04-26,2015,WSH,MIA,2,6,-116,-1.5,140,7.5,-110,-110,106,1.5,-159,4.03,Marlins Park,8,-4
2015-04-26,2015,STL,MIL,3,6,-118,-1.5,135,7.0,100,-120,108,1.5,-155,3.79,Miller Park,9,-3
2015-04-26,2015,SEA,MIN,2,4,-150,-1.5,140,7.5,-115,-105,135,1.5,-160,4.5,T-Mobile Park,6,-2
2015-04-26,2015,NYY,NYM,6,4,-160,-1.5,135,8.0,-115,-105,145,1.5,-155,4.92,Yankee Stadium,10,2
2015-04-26,2015,NYM,NYY,4,6,145,1.5,-155,8.0,-115,-105,-160,-1.5,135,3.27,Yankee Stadium,10,-2
2015-04-26,2015,HOU,OAK,7,6,151,1.5,-140,8.0,100,-120,-171,-1.5,120,3.19,Oakland Coliseum,13,1
2015-04-26,2015,ATL,PHI,4,5,-103,1.5,-215,7.5,-120,100,-107,-1.5,185,3.81,Citizens Bank Park,9,-1
2015-04-26,2015,ARI,PIT,0,8,116,1.5,-140,8.5,-117,-103,-131,-1.5,120,3.94,Chase Field,8,-8
2015-04-26,2015,LAD,SD,1,3,116,1.5,-200,7.5,105,-125,-131,-1.5,170,3.47,PETCO Park,4,-2
2015-04-26,2015,MIN,SEA,4,2,135,1.5,-160,7.5,-115,-105,-150,-1.5,140,3.19,T-Mobile Park,6,2
2015-04-26,2015,MIL,STL,6,3,108,1.5,-155,7.0,100,-120,-118,-1.5,135,3.37,Miller Park,9,3
2015-04-26,2015,TOR,TB,1,5,135,1.5,-170,7.0,-120,100,-150,-1.5,150,2.98,Tropicana Field,6,-4
2015-04-26,2015,LAA,TEX,4,5,-150,-1.5,140,8.0,-120,100,135,1.5,-160,4.8,Angel Stadium,9,-1
2015-04-26,2015,TB,TOR,5,1,-150,-1.5,150,7.0,-120,100,135,1.5,-170,4.2,Tropicana Field,6,4
2015-04-26,2015,MIA,WSH,6,2,106,1.5,-159,7.5,-110,-110,-116,-1.5,140,3.64,Marlins Park,8,4
2015-04-27,2015,COL,ARI,5,4,118,1.5,-180,8.5,-115,-105,-133,-1.5,160,3.9,Chase Field,9,1
2015-04-27,2015,WSH,ATL,4,8,-134,-1.5,125,7.0,-120,100,119,1.5,-145,4.01,Turner Field,12,-4
2015-04-27,2015,TOR,BOS,5,6,127,1.5,-160,9.5,-105,-115,-142,-1.5,140,4.19,Fenway Park,11,-1
2015-04-27,2015,PIT,CHC,0,4,109,1.5,-210,7.0,-115,-105,-119,-1.5,180,3.35,Wrigley Field,4,-4
2015-04-27,2015,MIL,CIN,6,9,111,1.5,-205,7.0,-125,105,-121,-1.5,175,3.32,Great American Ballpark,15,-3
2015-04-27,2015,KC,CLE,6,2,130,1.5,-180,6.5,-105,-115,-145,-1.5,160,2.83,Progressive Field,8,4
2015-04-27,2015,ARI,COL,4,5,-133,-1.5,160,8.5,-115,-105,118,1.5,-180,4.85,Chase Field,9,-1
2015-04-27,2015,MIN,DET,4,5,150,1.5,-120,8.0,100,-120,-170,-1.5,100,3.2,Target Field,9,-1
2015-04-27,2015,SD,HOU,4,9,-118,-1.5,192,6.0,-125,105,108,1.5,-232,3.25,PETCO Park,13,-5
2015-04-27,2015,CLE,KC,2,6,-145,-1.5,160,6.5,-105,-115,130,1.5,-180,3.85,Progressive Field,8,-4
2015-04-27,2015,SF,LAD,3,8,143,1.5,-170,7.5,-105,-115,-158,-1.5,150,3.09,Dodger Stadium,11,-5
2015-04-27,2015,NYM,MIA,3,1,128,1.5,-190,7.5,-120,100,-143,-1.5,160,3.29,Marlins Park,4,2
2015-04-27,2015,CIN,MIL,9,6,-121,-1.5,175,7.0,-125,105,111,1.5,-205,3.83,Great American Ballpark,15,3
2015-04-27,2015,DET,MIN,5,4,-170,-1.5,100,8.0,100,-120,150,1.5,-120,5.04,Target Field,9,1
2015-04-27,2015,MIA,NYM,1,3,-143,-1.5,160,7.5,-120,100,128,1.5,-190,4.41,Marlins Park,4,-2
2015-04-27,2015,TB,NYY,1,4,111,1.5,-200,8.5,-115,-105,-121,-1.5,170,4.03,Yankee Stadium,5,-3
2015-04-27,2015,STL,PHI,1,4,-146,-1.5,160,6.5,100,-120,131,1.5,-190,3.86,Busch Stadium,5,-3
2015-04-27,2015,CHC,PIT,4,0,-119,-1.5,180,7.0,-115,-105,109,1.5,-210,3.8,Wrigley Field,4,4
2015-04-27,2015,HOU,SD,9,4,108,1.5,-232,6.0,-125,105,-118,-1.5,192,2.88,PETCO Park,13,5
2015-04-27,2015,TEX,SEA,1,3,-114,-1.5,175,8.5,-120,100,104,1.5,-205,4.53,Rangers Ballpark,4,-2
2015-04-27,2015,LAD,SF,8,3,-158,-1.5,150,7.5,-105,-115,143,1.5,-170,4.59,Dodger Stadium,11,5
2015-04-27,2015,PHI,STL,4,1,131,1.5,-190,6.5,100,-120,-146,-1.5,160,2.81,Busch Stadium,5,3
2015-04-27,2015,NYY,TB,4,1,-121,-1.5,170,8.5,-115,-105,111,1.5,-200,4.65,Yankee Stadium,5,3
2015-04-27,2015,SEA,TEX,3,1,104,1.5,-205,8.5,-120,100,-114,-1.5,175,4.17,Rangers Ballpark,4,2
2015-04-27,2015,BOS,TOR,6,5,-142,-1.5,140,9.5,-105,-115,127,1.5,-160,5.57,Fenway Park,11,1
2015-04-27,2015,ATL,WSH,8,4,119,1.5,-145,7.0,-120,100,-134,-1.5,125,3.2,Turner Field,12,4
2015-04-28,2015,COL,ARI,5,12,104,1.5,-195,9.0,-115,-105,-114,-1.5,165,4.41,Chase Field,17,-7
2015-04-28,2015,WSH,ATL,13,12,102,1.5,-230,7.0,-115,-105,-112,-1.5,190,3.47,Turner Field,25,1
2015-04-28,2015,TOR,BOS,11,8,114,1.5,-195,8.5,-110,-110,-124,-1.5,165,3.97,Fenway Park,19,3
2015-04-28,2015,PIT,CHC,2,6,-110,-1.5,150,8.5,100,-120,100,1.5,-170,4.45,Wrigley Field,8,-4
2015-04-28,2015,MIL,CIN,2,4,175,1.5,-138,6.5,-125,105,-195,-1.5,118,2.36,Great American Ballpark,6,-2
2015-04-28,2015,KC,CLE,11,5,117,1.5,-190,7.5,-110,-110,-132,-1.5,160,3.46,Progressive Field,16,6
2015-04-28,2015,ARI,COL,12,5,-114,-1.5,165,9.0,-115,-105,104,1.5,-195,4.79,Chase Field,17,7
2015-04-28,2015,MIN,DET,3,2,125,1.5,-140,9.0,-105,-115,-140,-1.5,120,4.0,Target Field,5,1
2015-04-28,2015,SD,HOU,3,14,-160,-1.5,145,7.0,-105,-115,145,1.5,-165,4.31,PETCO Park,17,-11
2015-04-28,2015,CLE,KC,5,11,-132,-1.5,160,7.5,-110,-110,117,1.5,-190,4.27,Progressive Field,16,-6
2015-04-28,2015,OAK,LAA,6,2,-148,-1.5,140,7.5,105,-125,133,1.5,-160,4.48,Oakland Coliseum,8,4
2015-04-28,2015,SF,LAD,2,1,165,1.5,-150,6.0,100,-120,-185,-1.5,130,2.26,Dodger Stadium,3,1
2015-04-28,2015,NYM,MIA,3,4,111,1.5,-205,7.0,-125,105,-121,-1.5,175,3.32,Marlins Park,7,-1
2015-04-28,2015,CIN,MIL,4,2,-195,-1.5,118,6.5,-125,105,175,1.5,-138,4.3,Great American Ballpark,6,2
2015-04-28,2015,DET,MIN,2,3,-140,-1.5,120,9.0,-105,-115,125,1.5,-140,5.25,Target Field,5,-1
2015-04-28,2015,MIA,NYM,4,3,-121,-1.5,175,7.0,-125,105,111,1.5,-205,3.83,Marlins Park,7,1
2015-04-28,2015,TB,NYY,2,4,-103,1.5,-215,8.0,-110,-110,-107,-1.5,185,4.06,Yankee Stadium,6,-2
2015-04-28,2015,LAA,OAK,2,6,133,1.5,-160,7.5,105,-125,-148,-1.5,140,3.22,Oakland Coliseum,8,-4
2015-04-28,2015,STL,PHI,11,5,-215,-1.5,-105,7.0,-120,100,185,1.5,-115,4.78,Busch Stadium,16,6
2015-04-28,2015,CHC,PIT,6,2,100,1.5,-170,8.5,100,-120,-110,-1.5,150,4.25,Wrigley Field,8,4
2015-04-28,2015,HOU,SD,14,3,145,1.5,-165,7.0,-105,-115,-160,-1.5,145,2.86,PETCO Park,17,11
2015-04-28,2015,TEX,SEA,1,2,104,1.5,-160,9.0,105,-125,-114,-1.5,140,4.41,Rangers Ballpark,3,-1
2015-04-28,2015,LAD,SF,1,2,-185,-1.5,130,6.0,100,-120,165,1.5,-150,3.89,Dodger Stadium,3,-1
2015-04-28,2015,PHI,STL,5,11,185,1.5,-115,7.0,-120,100,-215,-1.5,-105,2.46,Busch Stadium,16,-6
2015-04-28,2015,NYY,TB,4,2,-107,-1.5,185,8.0,-110,-110,-103,1.5,-215,4.14,Yankee Stadium,6,2
2015-04-28,2015,SEA,TEX,2,1,-114,-1.5,140,9.0,105,-125,104,1.5,-160,4.79,Rangers Ballpark,3,1
2015-04-28,2015,BOS,TOR,8,11,-124,-1.5,165,8.5,-110,-110,114,1.5,-195,4.71,Fenway Park,19,-3
2015-04-28,2015,ATL,WSH,12,13,-112,-1.5,190,7.0,-115,-105,102,1.5,-230,3.7,Turner Field,25,-1
2015-04-29,2015,COL,ARI,1,9,103,1.5,-205,9.0,-105,-115,-113,-1.5,175,4.43,Chase Field,10,-8
2015-04-29,2015,WSH,ATL,13,4,-120,-1.5,140,7.0,-110,-110,110,1.5,-160,3.82,Turner Field,17,9
2015-04-29,2015,CWS,BAL,2,8,-105,-1.5,150,8.0,-120,100,-105,1.5,-170,4.1,Camden Yards,10,-6
2015-04-29,2015,TOR,BOS,1,4,144,1.5,-155,9.0,100,-120,-159,-1.5,135,3.69,Fenway Park,5,-3
2015-04-29,2015,PIT,CHC,8,1,-112,-1.5,150,7.0,105,-125,102,1.5,-170,3.7,Wrigley Field,9,7
2015-04-29,2015,MIL,CIN,8,3,110,1.5,-210,7.5,100,-120,-120,-1.5,180,3.57,Great American Ballpark,11,5
2015-04-29,2015,KC,CLE,5,7,102,1.5,-230,7.0,-105,-115,-112,-1.5,190,3.47,Progressive Field,12,-2
2015-04-29,2015,ARI,COL,9,1,-113,-1.5,175,9.0,-105,-115,103,1.5,-205,4.77,Chase Field,10,8
2015-04-29,2015,BAL,CWS,8,2,-105,1.5,-170,8.0,-120,100,-105,-1.5,150,4.1,Camden Yards,10,6
2015-04-29,2015,MIN,DET,7,10,-101,-1.5,185,8.5,-110,-110,-109,1.5,-215,4.27,Target Field,17,-3
2015-04-29,2015,SD,HOU,2,7,-119,-1.5,190,7.0,100,-120,109,1.5,-230,3.8,PETCO Park,9,-5
2015-04-29,2015,CLE,KC,7,5,-112,-1.5,190,7.0,-105,-115,102,1.5,-230,3.7,Progressive Field,12,2
2015-04-29,2015,OAK,LAA,3,6,-112,-1.5,190,7.5,-105,-115,102,1.5,-230,3.96,Oakland Coliseum,9,-3
2015-04-29,2015,SF,LAD,3,7,186,1.5,-115,7.0,-130,110,-216,-1.5,-105,2.45,Dodger Stadium,10,-4
2015-04-29,2015,NYM,MIA,3,7,-103,-1.5,155,7.5,-105,-115,-107,1.5,-175,3.81,Marlins Park,10,-4
2015-04-29,2015,CIN,MIL,3,8,-120,-1.5,180,7.5,100,-120,110,1.5,-210,4.09,Great American Ballpark,11,-5
2015-04-29,2015,DET,MIN,10,7,-109,1.5,-215,8.5,-110,-110,-101,-1.5,185,4.43,Target Field,17,3
2015-04-29,2015,MIA,NYM,7,3,-107,1.5,-175,7.5,-105,-115,-103,-1.5,155,3.88,Marlins Park,10,4
2015-04-29,2015,TB,NYY,3,2,127,1.5,-180,7.5,-113,-107,-142,-1.5,160,3.3,Yankee Stadium,5,1
2015-04-29,2015,LAA,OAK,6,3,102,1.5,-230,7.5,-105,-115,-112,-1.5,190,3.71,Oakland Coliseum,9,3
2015-04-29,2015,STL,PHI,5,2,-203,-1.5,110,7.0,-130,110,173,1.5,-130,4.69,Busch Stadium,7,3
2015-04-29,2015,CHC,PIT,1,8,102,1.5,-170,7.0,105,-125,-112,-1.5,150,3.47,Wrigley Field,9,-7
2015-04-29,2015,HOU,SD,7,2,109,1.5,-230,7.0,100,-120,-119,-1.5,190,3.35,PETCO Park,9,5
2015-04-29,2015,TEX,SEA,2,5,144,1.5,-115,8.0,100,-120,-159,-1.5,-105,3.28,Rangers Ballpark,7,-3
2015-04-29,2015,LAD,SF,7,3,-216,-1.5,-105,7.0,-130,110,186,1.5,-115,4.78,Dodger Stadium,10,4
2015-04-29,2015,PHI,STL,2,5,173,1.5,-130,7.0,-130,110,-203,-1.5,110,2.56,Busch Stadium,7,-3
2015-04-29,2015,NYY,TB,2,3,-142,-1.5,160,7.5,-113,-107,127,1.5,-180,4.4,Yankee Stadium,5,-1
2015-04-29,2015,SEA,TEX,5,2,-159,-1.5,-105,8.0,100,-120,144,1.5,-115,4.91,Rangers Ballpark,7,3
2015-04-29,2015,BOS,TOR,4,1,-159,-1.5,135,9.0,100,-120,144,1.5,-155,5.53,Fenway Park,5,3
2015-04-29,2015,ATL,WSH,4,13,110,1.5,-160,7.0,-110,-110,-120,-1.5,140,3.33,Turner Field,17,-9
2015-04-30,2015,CIN,ATL,5,1,-119,-1.5,150,7.0,-120,100,109,1.5,-170,3.8,Turner Field,6,4
2015-04-30,2015,ATL,CIN,1,5,109,1.5,-170,7.0,-120,100,-119,-1.5,150,3.35,Turner Field,6,-4
2015-04-30,2015,TOR,CLE,5,1,-134,-1.5,120,8.5,100,-120,119,1.5,-140,4.87,Progressive Field,6,4
2015-04-30,2015,MIN,CWS,12,2,137,1.5,-125,7.0,-125,105,-152,-1.5,105,2.95,Target Field,14,10
2015-04-30,2015,KC,DET,8,1,-121,-1.5,165,8.5,-115,-105,111,1.5,-195,4.65,Kauffman Stadium,9,7
2015-04-30,2015,SEA,HOU,2,3,-106,-1.5,155,9.0,105,-125,-104,1.5,-175,4.63,Minute Maid Park,5,-1
2015-04-30,2015,DET,KC,1,8,111,1.5,-195,8.5,-115,-105,-121,-1.5,165,4.03,Kauffman Stadium,9,-7
2015-04-30,2015,OAK,LAA,5,6,-119,-1.5,175,8.0,100,-120,109,1.5,-205,4.35,Oakland Coliseum,11,-1
2015-04-30,2015,CWS,MIN,2,12,-152,-1.5,105,7.0,-125,105,137,1.5,-125,4.22,Target Field,14,-10
2015-04-30,2015,WSH,NYM,8,2,-119,-1.5,155,6.5,100,-120,109,1.5,-175,3.53,Citi Field,10,6
2015-04-30,2015,LAA,OAK,6,5,109,1.5,-205,8.0,100,-120,-119,-1.5,175,3.83,Oakland Coliseum,11,1
2015-04-30,2015,STL,PHI,9,3,-240,-1.5,-105,7.5,-110,-110,200,1.5,-115,5.29,Busch Stadium,12,6
2015-04-30,2015,HOU,SEA,3,2,-104,1.5,-175,9.0,105,-125,-106,-1.5,155,4.59,Minute Maid Park,5,1
2015-04-30,2015,PHI,STL,3,9,200,1.5,-115,7.5,-110,-110,-240,-1.5,-105,2.5,Busch Stadium,12,-6
2015-04-30,2015,CLE,TOR,1,5,119,1.5,-140,8.5,100,-120,-134,-1.5,120,3.88,Progressive Field,6,-4
2015-04-30,2015,NYM,WSH,2,8,109,1.5,-175,6.5,100,-120,-119,-1.5,155,3.11,Citi Field,10,-6
2015-05-01,2015,LAD,ARI,8,0,-153,-1.5,135,7.5,-120,100,138,1.5,-155,4.54,Dodger Stadium,8,8
2015-05-01,2015,CIN,ATL,3,4,-121,-1.5,135,7.0,-120,100,111,1.5,-155,3.83,Turner Field,7,-1
2015-05-01,2015,TB,BAL,2,0,-105,-1.5,150,8.0,100,-120,-105,1.5,-170,4.1,Tropicana Field,2,2
2015-05-01,2015,NYY,BOS,3,2,109,1.5,-200,9.0,105,-125,-119,-1.5,170,4.31,Fenway Park,5,1
2015-05-01,2015,MIL,CHC,0,1,172,1.5,-135,7.5,100,-120,-192,-1.5,115,2.76,Wrigley Field,1,-1
2015-05-01,2015,ATL,CIN,4,3,111,1.5,-155,7.0,-120,100,-121,-1.5,135,3.32,Turner Field,7,1
2015-05-01,2015,TOR,CLE,4,9,125,1.5,-190,7.5,-105,-115,-140,-1.5,160,3.33,Progressive Field,13,-5
2015-05-01,2015,SD,COL,14,3,-144,-1.5,160,7.5,-115,-105,129,1.5,-190,4.43,PETCO Park,17,11
2015-05-01,2015,MIN,CWS,1,0,102,1.5,-165,8.5,100,-120,-112,-1.5,145,4.21,Target Field,1,1
2015-05-01,2015,KC,DET,4,1,-115,-1.5,175,8.5,-110,-110,105,1.5,-205,4.55,Kauffman Stadium,5,3
2015-05-01,2015,SEA,HOU,3,4,-109,-1.5,145,9.0,103,-123,-101,1.5,-165,4.69,Minute Maid Park,7,-1
2015-05-01,2015,DET,KC,1,4,105,1.5,-205,8.5,-110,-110,-115,-1.5,175,4.15,Kauffman Stadium,5,-3
2015-05-01,2015,SF,LAA,3,2,-113,-1.5,185,7.5,-105,-115,103,1.5,-215,3.98,AT&T Park,5,1
2015-05-01,2015,ARI,LAD,0,8,138,1.5,-155,7.5,-120,100,-153,-1.5,135,3.15,Dodger Stadium,8,-8
2015-05-01,2015,PHI,MIA,3,4,137,1.5,-165,8.0,-115,-105,-152,-1.5,145,3.38,Marlins Park,7,-1
2015-05-01,2015,CHC,MIL,1,0,-192,-1.5,115,7.5,100,-120,172,1.5,-135,4.93,Wrigley Field,1,1
2015-05-01,2015,CWS,MIN,0,1,-112,-1.5,145,8.5,100,-120,102,1.5,-165,4.49,Target Field,1,-1
2015-05-01,2015,WSH,NYM,0,4,104,1.5,-230,6.0,100,-120,-114,-1.5,190,2.94,Citi Field,4,-4
2015-05-01,2015,BOS,NYY,2,3,-119,-1.5,170,9.0,105,-125,109,1.5,-200,4.89,Fenway Park,5,-1
2015-05-01,2015,TEX,OAK,5,7,130,1.5,-130,8.5,100,-120,-145,-1.5,110,3.7,Rangers Ballpark,12,-2
2015-05-01,2015,MIA,PHI,4,3,-152,-1.5,145,8.0,-115,-105,137,1.5,-165,4.83,Marlins Park,7,1
2015-05-01,2015,STL,PIT,2,1,-147,-1.5,155,7.5,-105,-115,132,1.5,-175,4.46,Busch Stadium,3,1
2015-05-01,2015,COL,SD,3,14,129,1.5,-190,7.5,-115,-105,-144,-1.5,160,3.28,PETCO Park,17,-11
2015-05-01,2015,HOU,SEA,4,3,-101,1.5,-165,9.0,103,-123,-109,-1.5,145,4.52,Minute Maid Park,7,1
2015-05-01,2015,LAA,SF,2,3,103,1.5,-215,7.5,-105,-115,-113,-1.5,185,3.69,AT&T Park,5,-1
2015-05-01,2015,PIT,STL,1,2,132,1.5,-175,7.5,-105,-115,-147,-1.5,155,3.23,Busch Stadium,3,-1
2015-05-01,2015,BAL,TB,0,2,-105,1.5,-170,8.0,100,-120,-105,-1.5,150,4.1,Tropicana Field,2,-2
2015-05-01,2015,OAK,TEX,7,5,-145,-1.5,110,8.5,100,-120,130,1.5,-130,5.03,Rangers Ballpark,12,2
2015-05-01,2015,CLE,TOR,9,4,-140,-1.5,160,7.5,-105,-115,125,1.5,-190,4.38,Progressive Field,13,5
2015-05-01,2015,NYM,WSH,4,0,-114,-1.5,190,6.0,100,-120,104,1.5,-230,3.2,Citi Field,4,4
2015-05-02,2015,LAD,ARI,6,4,-150,-1.5,145,8.0,-110,-110,135,1.5,-165,4.8,Dodger Stadium,10,2
2015-05-02,2015,CIN,ATL,8,4,-112,-1.5,145,7.5,-120,100,102,1.5,-165,3.96,Turner Field,12,4
2015-05-02,2015,TB,BAL,0,4,-119,-1.5,135,7.0,-110,-110,109,1.5,-155,3.8,Tropicana Field,4,-4
2015-05-02,2015,NYY,BOS,4,2,117,1.5,-190,8.5,-110,-110,-132,-1.5,160,3.92,Fenway Park,6,2
2015-05-02,2015,MIL,CHC,6,1,156,1.5,-140,8.0,-115,-105,-176,-1.5,120,3.13,Wrigley Field,7,5
2015-05-02,2015,ATL,CIN,4,8,102,1.5,-165,7.5,-120,100,-112,-1.5,145,3.71,Turner Field,12,-4
2015-05-02,2015,TOR,CLE,11,4,163,1.5,-135,7.5,-120,100,-183,-1.5,115,2.85,Progressive Field,15,7
2015-05-02,2015,SD,COL,4,2,-140,-1.5,160,7.0,-130,110,125,1.5,-190,4.08,PETCO Park,6,2
2015-05-02,2015,MIN,CWS,5,3,-119,-1.5,160,9.5,-120,100,109,1.5,-190,5.16,Target Field,8,2
2015-05-02,2015,KC,DET,1,2,116,1.5,-155,7.5,105,-125,-126,-1.5,135,3.47,Kauffman Stadium,3,-1
2015-05-02,2015,SEA,HOU,4,11,127,1.5,-175,8.0,-105,-115,-142,-1.5,155,3.52,Minute Maid Park,15,-7
2015-05-02,2015,DET,KC,2,1,-126,-1.5,135,7.5,105,-125,116,1.5,-155,4.18,Kauffman Stadium,3,1
2015-05-02,2015,SF,LAA,5,4,-113,-1.5,180,7.5,102,-122,103,1.5,-210,3.98,AT&T Park,9,1
2015-05-02,2015,ARI,LAD,4,6,135,1.5,-165,8.0,-110,-110,-150,-1.5,145,3.4,Dodger Stadium,10,-2
2015-05-02,2015,PHI,MIA,0,7,100,1.5,-220,7.0,-110,-110,-110,-1.5,190,3.5,Marlins Park,7,-7
2015-05-02,2015,CHC,MIL,1,6,-176,-1.5,120,8.0,-115,-105,156,1.5,-140,5.1,Wrigley Field,7,-5
2015-05-02,2015,CWS,MIN,3,5,109,1.5,-190,9.5,-120,100,-119,-1.5,160,4.55,Target Field,8,-2
2015-05-02,2015,WSH,NYM,1,0,-133,-1.5,125,7.0,-110,-110,118,1.5,-145,4.0,Citi Field,1,1
2015-05-02,2015,BOS,NYY,2,4,-132,-1.5,160,8.5,-110,-110,117,1.5,-190,4.84,Fenway Park,6,-2
2015-05-02,2015,TEX,OAK,8,7,113,1.5,-155,8.5,-110,-110,-123,-1.5,135,3.99,Rangers Ballpark,15,1
2015-05-02,2015,MIA,PHI,7,0,-110,-1.5,190,7.0,-110,-110,100,1.5,-220,3.67,Marlins Park,7,7
2015-05-02,2015,STL,PIT,2,1,-108,-1.5,200,7.0,-125,105,-102,1.5,-240,3.63,Busch Stadium,3,1
2015-05-02,2015,COL,SD,2,4,125,1.5,-190,7.0,-130,110,-140,-1.5,160,3.11,PETCO Park,6,-2
2015-05-02,2015,HOU,SEA,11,4,-142,-1.5,155,8.0,-105,-115,127,1.5,-175,4.69,Minute Maid Park,15,7
2015-05-02,2015,LAA,SF,4,5,103,1.5,-210,7.5,102,-122,-113,-1.5,180,3.69,AT&T Park,9,-1
2015-05-02,2015,PIT,STL,1,2,-102,1.5,-240,7.0,-125,105,-108,-1.5,200,3.53,Busch Stadium,3,-1
2015-05-02,2015,BAL,TB,4,0,109,1.5,-155,7.0,-110,-110,-119,-1.5,135,3.35,Tropicana Field,4,4
2015-05-02,2015,OAK,TEX,7,8,-123,-1.5,135,8.5,-110,-110,113,1.5,-155,4.69,Rangers Ballpark,15,-1
2015-05-02,2015,CLE,TOR,4,11,-183,-1.5,115,7.5,-120,100,163,1.5,-135,4.85,Progressive Field,15,-7
2015-05-02,2015,NYM,WSH,0,1,118,1.5,-145,7.0,-110,-110,-133,-1.5,125,3.21,Citi Field,1,-1
2015-05-03,2015,LAD,ARI,1,0,-141,-1.5,155,7.5,-105,-115,126,1.5,-175,4.39,Dodger Stadium,1,1
2015-05-03,2015,CIN,ATL,0,5,-148,-1.5,115,6.5,-125,105,133,1.5,-135,3.88,Turner Field,5,-5
2015-05-03,2015,TB,BAL,2,4,-103,1.5,-215,7.5,-120,100,-107,-1.5,185,3.81,Tropicana Field,6,-2
2015-05-03,2015,NYY,BOS,8,5,130,1.5,-165,9.0,-110,-110,-145,-1.5,145,3.91,Fenway Park,13,3
2015-05-03,2015,MIL,CHC,5,3,132,1.5,-160,10.0,-120,100,-147,-1.5,140,4.31,Wrigley Field,8,2
2015-05-03,2015,ATL,CIN,5,0,133,1.5,-135,6.5,-125,105,-148,-1.5,115,2.79,Turner Field,5,5
2015-05-03,2015,TOR,CLE,7,10,112,1.5,-200,8.5,-115,-105,-122,-1.5,170,4.01,Progressive Field,17,-3
2015-05-03,2015,SD,COL,8,6,-200,-1.5,120,7.0,-120,100,170,1.5,-140,4.67,PETCO Park,14,2
2015-05-03,2015,MIN,CWS,13,3,-122,-1.5,170,10.0,-110,-110,112,1.5,-200,5.5,Target Field,16,10
2015-05-03,2015,KC,DET,4,6,108,1.5,-160,8.5,-118,-102,-118,-1.5,140,4.09,Kauffman Stadium,10,-2
2015-05-03,2015,SEA,HOU,6,7,-122,-1.5,131,9.0,-130,110,112,1.5,-150,4.95,Minute Maid Park,13,-1
2015-05-03,2015,DET,KC,6,4,-118,-1.5,140,8.5,-118,-102,108,1.5,-160,4.6,Kauffman Stadium,10,2
2015-05-03,2015,SF,LAA,5,0,-105,1.5,-170,7.5,-115,-105,-105,-1.5,150,3.84,AT&T Park,5,5
2015-05-03,2015,ARI,LAD,0,1,126,1.5,-175,7.5,-105,-115,-141,-1.5,155,3.32,Dodger Stadium,1,-1
2015-05-03,2015,PHI,MIA,6,2,155,1.5,-145,7.5,-111,-109,-175,-1.5,125,2.94,Marlins Park,8,4
2015-05-03,2015,CHC,MIL,3,5,-147,-1.5,140,10.0,-120,100,132,1.5,-160,5.95,Wrigley Field,8,-2
2015-05-03,2015,CWS,MIN,3,13,112,1.5,-200,10.0,-110,-110,-122,-1.5,170,4.72,Target Field,16,-10
2015-05-03,2015,WSH,NYM,1,0,-109,-1.5,150,7.5,102,-122,-101,1.5,-170,3.91,Citi Field,1,1
2015-05-03,2015,BOS,NYY,5,8,-145,-1.5,145,9.0,-110,-110,130,1.5,-165,5.33,Fenway Park,13,-3
2015-05-03,2015,TEX,OAK,1,7,104,1.5,-165,8.5,100,-120,-114,-1.5,145,4.17,Rangers Ballpark,8,-6
2015-05-03,2015,MIA,PHI,2,6,-175,-1.5,125,7.5,-111,-109,155,1.5,-145,4.77,Marlins Park,8,-4
2015-05-03,2015,STL,PIT,3,2,-152,-1.5,140,7.5,-120,100,137,1.5,-160,4.52,Busch Stadium,5,1
2015-05-03,2015,COL,SD,6,8,170,1.5,-140,7.0,-120,100,-200,-1.5,120,2.59,PETCO Park,14,-2
2015-05-03,2015,HOU,SEA,7,6,112,1.5,-150,9.0,-130,110,-122,-1.5,131,4.25,Minute Maid Park,13,1
2015-05-03,2015,LAA,SF,0,5,-105,-1.5,150,7.5,-115,-105,-105,1.5,-170,3.84,AT&T Park,5,-5
2015-05-03,2015,PIT,STL,2,3,137,1.5,-160,7.5,-120,100,-152,-1.5,140,3.16,Busch Stadium,5,-1
2015-05-03,2015,BAL,TB,4,2,-107,-1.5,185,7.5,-120,100,-103,1.5,-215,3.88,Tropicana Field,6,2
2015-05-03,2015,OAK,TEX,7,1,-114,-1.5,145,8.5,100,-120,104,1.5,-165,4.53,Rangers Ballpark,8,6
2015-05-03,2015,CLE,TOR,10,7,-122,-1.5,170,8.5,-115,-105,112,1.5,-200,4.67,Progressive Field,17,3
2015-05-03,2015,NYM,WSH,0,1,-101,1.5,-170,7.5,102,-122,-109,-1.5,150,3.77,Citi Field,1,-1
2015-05-04,2015,PHI,ATL,5,2,133,1.5,-175,7.0,100,-120,-148,-1.5,155,3.0,Turner Field,7,3
2015-05-04,2015,TB,BOS,5,1,125,1.5,-165,8.5,-125,105,-140,-1.5,145,3.78,Fenway Park,6,4
2015-05-04,2015,STL,CHC,10,9,-141,-1.5,160,7.5,-105,-115,126,1.5,-190,4.39,Busch Stadium,19,1
2015-05-04,2015,TEX,HOU,2,1,180,1.5,-115,8.5,-120,100,-210,-1.5,-105,3.04,Minute Maid Park,3,1
2015-05-04,2015,SEA,LAA,3,2,-140,-1.5,120,7.5,105,-125,125,1.5,-140,4.38,Angel Stadium,5,1
2015-05-04,2015,MIL,LAD,4,3,155,1.5,-105,7.0,-115,-105,-175,-1.5,-115,2.75,Miller Park,7,1
2015-05-04,2015,WSH,MIA,6,4,-160,-1.5,140,8.0,100,-120,145,1.5,-160,4.92,Nationals Park,10,2
2015-05-04,2015,LAD,MIL,3,4,-175,-1.5,-115,7.0,-115,-105,155,1.5,-105,4.45,Miller Park,7,-1
2015-05-04,2015,OAK,MIN,7,8,103,1.5,-215,8.0,-110,-110,-113,-1.5,185,3.94,Target Field,15,-1
2015-05-04,2015,TOR,NYY,3,1,-119,-1.5,170,8.5,100,-120,109,1.5,-200,4.62,Rogers Centre,4,2
2015-05-04,2015,MIN,OAK,8,7,-113,-1.5,185,8.0,-110,-110,103,1.5,-215,4.24,Target Field,15,1
2015-05-04,2015,ATL,PHI,2,5,-148,-1.5,155,7.0,100,-120,133,1.5,-175,4.18,Turner Field,7,-3
2015-05-04,2015,SF,SD,2,0,-150,-1.5,160,6.5,-105,-115,135,1.5,-190,3.9,AT&T Park,2,2
2015-05-04,2015,LAA,SEA,2,3,125,1.5,-140,7.5,105,-125,-140,-1.5,120,3.33,Angel Stadium,5,-1
2015-05-04,2015,SD,SF,0,2,135,1.5,-190,6.5,-105,-115,-150,-1.5,160,2.77,AT&T Park,2,-2
2015-05-04,2015,CHC,STL,9,10,126,1.5,-190,7.5,-105,-115,-141,-1.5,160,3.32,Busch Stadium,19,-1
2015-05-04,2015,BOS,TB,1,5,-140,-1.5,145,8.5,-125,105,125,1.5,-165,4.96,Fenway Park,6,-4
2015-05-04,2015,HOU,TEX,1,2,-210,-1.5,-105,8.5,-120,100,180,1.5,-115,5.76,Minute Maid Park,3,-1
2015-05-04,2015,NYY,TOR,1,3,109,1.5,-200,8.5,100,-120,-119,-1.5,170,4.07,Rogers Centre,4,-2
2015-05-04,2015,MIA,WSH,4,6,145,1.5,-160,8.0,100,-120,-160,-1.5,140,3.27,Nationals Park,10,-2
2015-05-05,2015,PHI,ATL,0,9,130,1.5,-175,7.5,105,-125,-145,-1.5,155,3.26,Turner Field,9,-9
2015-05-05,2015,NYM,BAL,3,2,-119,-1.5,185,7.0,-115,-105,109,1.5,-215,3.8,Citi Field,5,1
2015-05-05,2015,TB,BOS,0,2,105,1.5,-195,7.5,-110,-110,-115,-1.5,165,3.66,Fenway Park,2,-2
2015-05-05,2015,STL,CHC,7,4,-142,-1.5,145,8.0,-105,-115,127,1.5,-165,4.69,Busch Stadium,11,3
2015-05-05,2015,PIT,CIN,1,7,-142,-1.5,150,7.5,-110,-110,127,1.5,-170,4.4,PNC Park,8,-6
2015-05-05,2015,KC,CLE,5,3,-122,-1.5,165,7.5,105,-125,112,1.5,-195,4.12,Kauffman Stadium,8,2
2015-05-05,2015,DET,CWS,2,5,-103,1.5,-210,8.0,-115,-105,-107,-1.5,180,4.06,Guaranteed Rate Field,7,-3
2015-05-05,2015,CWS,DET,5,2,-107,-1.5,180,8.0,-115,-105,-103,1.5,-210,4.14,Guaranteed Rate Field,7,3
2015-05-05,2015,TEX,HOU,7,1,140,1.5,-150,8.5,-120,100,-155,-1.5,130,3.54,Minute Maid Park,8,6
2015-05-05,2015,CLE,KC,3,5,112,1.5,-195,7.5,105,-125,-122,-1.5,165,3.54,Kauffman Stadium,8,-2
2015-05-05,2015,SEA,LAA,4,5,125,1.5,-190,8.0,-105,-115,-140,-1.5,160,3.56,Angel Stadium,9,-1
2015-05-05,2015,MIL,LAD,2,8,125,1.5,-135,7.5,-110,-110,-140,-1.5,115,3.33,Miller Park,10,-6
2015-05-05,2015,WSH,MIA,1,2,-176,-1.5,130,7.0,-110,-110,156,1.5,-150,4.46,Nationals Park,3,-1
2015-05-05,2015,LAD,MIL,8,2,-140,-1.5,115,7.5,-110,-110,125,1.5,-135,4.38,Miller Park,10,6
2015-05-05,2015,OAK,MIN,2,1,-109,-1.5,145,8.5,100,-120,-101,1.5,-165,4.43,Target Field,3,1
2015-05-05,2015,BAL,NYM,2,3,109,1.5,-215,7.0,-115,-105,-119,-1.5,185,3.35,Citi Field,5,-1
2015-05-05,2015,TOR,NYY,3,6,105,1.5,-150,8.0,-105,-115,-115,-1.5,130,3.9,Rogers Centre,9,-3
2015-05-05,2015,MIN,OAK,1,2,-101,1.5,-165,8.5,100,-120,-109,-1.5,145,4.27,Target Field,3,-1
2015-05-05,2015,ATL,PHI,9,0,-145,-1.5,155,7.5,105,-125,130,1.5,-175,4.44,Turner Field,9,9
2015-05-05,2015,CIN,PIT,7,1,127,1.5,-170,7.5,-110,-110,-142,-1.5,150,3.3,PNC Park,8,6
2015-05-05,2015,SF,SD,6,0,105,1.5,-165,7.0,-115,-105,-115,-1.5,145,3.41,AT&T Park,6,6
2015-05-05,2015,LAA,SEA,5,4,-140,-1.5,160,8.0,-105,-115,125,1.5,-190,4.67,Angel Stadium,9,1
2015-05-05,2015,SD,SF,0,6,-115,-1.5,145,7.0,-115,-105,105,1.5,-165,3.74,AT&T Park,6,-6
2015-05-05,2015,CHC,STL,4,7,127,1.5,-165,8.0,-105,-115,-142,-1.5,145,3.52,Busch Stadium,11,-3
2015-05-05,2015,BOS,TB,2,0,-115,-1.5,165,7.5,-110,-110,105,1.5,-195,4.01,Fenway Park,2,2
2015-05-05,2015,HOU,TEX,1,7,-155,-1.5,130,8.5,-120,100,140,1.5,-150,5.17,Minute Maid Park,8,-6
2015-05-05,2015,NYY,TOR,6,3,-115,-1.5,130,8.0,-105,-115,105,1.5,-150,4.28,Rogers Centre,9,3
2015-05-05,2015,MIA,WSH,2,1,156,1.5,-150,7.0,-110,-110,-176,-1.5,130,2.73,Nationals Park,3,1
2015-05-06,2015,COL,ARI,7,13,-120,-1.5,159,10.5,-115,-105,110,1.5,-179,5.73,Coors Field,20,-6
2015-05-06,2015,COL,ARI,1,5,-130,-1.5,145,10.5,-110,-110,115,1.5,-165,5.93,Coors Field,6,-4
2015-05-06,2015,PHI,ATL,5,7,130,1.5,-170,7.5,105,-125,-145,-1.5,150,3.26,Turner Field,12,-2
2015-05-06,2015,NYM,BAL,5,1,-110,-1.5,195,6.5,-110,-110,100,1.5,-235,3.4,Citi Field,6,4
2015-05-06,2015,TB,BOS,5,3,114,1.5,-190,9.0,100,-120,-124,-1.5,160,4.21,Fenway Park,8,2
2015-05-06,2015,STL,CHC,5,6,-128,-1.5,175,7.0,-109,-111,118,1.5,-205,3.93,Busch Stadium,11,-1
2015-05-06,2015,PIT,CIN,0,3,-170,-1.5,125,7.0,100,-120,150,1.5,-145,4.41,PNC Park,3,-3
2015-05-06,2015,KC,CLE,3,10,-140,-1.5,160,7.0,-120,100,125,1.5,-190,4.08,Kauffman Stadium,13,-7
2015-05-06,2015,ARI,COL,13,7,110,1.5,-179,10.5,-115,-105,-120,-1.5,159,5.0,Coors Field,20,6
2015-05-06,2015,ARI,COL,5,1,115,1.5,-165,10.5,-110,-110,-130,-1.5,145,4.88,Coors Field,6,4
2015-05-06,2015,DET,CWS,6,7,135,1.5,-164,8.5,-116,-104,-150,-1.5,144,3.62,Guaranteed Rate Field,13,-1
2015-05-06,2015,CWS,DET,7,6,-150,-1.5,144,8.5,-116,-104,135,1.5,-164,5.1,Guaranteed Rate Field,13,1
2015-05-06,2015,TEX,HOU,11,3,117,1.5,-180,9.0,100,-120,-132,-1.5,160,4.15,Minute Maid Park,14,8
2015-05-06,2015,CLE,KC,10,3,125,1.5,-190,7.0,-120,100,-140,-1.5,160,3.11,Kauffman Stadium,13,7
2015-05-06,2015,SEA,LAA,3,4,135,1.5,-165,8.5,-110,-110,-150,-1.5,145,3.62,Angel Stadium,7,-1
2015-05-06,2015,MIL,LAD,6,3,108,1.5,-160,8.5,-115,-105,-118,-1.5,140,4.09,Miller Park,9,3
2015-05-06,2015,WSH,MIA,7,5,-213,-1.5,105,7.0,110,-130,183,1.5,-125,4.76,Nationals Park,12,2
2015-05-06,2015,LAD,MIL,3,6,-118,-1.5,140,8.5,-115,-105,108,1.5,-160,4.6,Miller Park,9,-3
2015-05-06,2015,OAK,MIN,0,13,-153,-1.5,103,8.0,-110,-110,138,1.5,-124,4.84,Target Field,13,-13
2015-05-06,2015,BAL,NYM,1,5,100,1.5,-235,6.5,-110,-110,-110,-1.5,195,3.25,Citi Field,6,-4
2015-05-06,2015,TOR,NYY,5,1,-134,-1.5,155,9.0,100,-120,119,1.5,-175,5.15,Rogers Centre,6,4
2015-05-06,2015,MIN,OAK,13,0,138,1.5,-124,8.0,-110,-110,-153,-1.5,103,3.36,Target Field,13,13
2015-05-06,2015,ATL,PHI,7,5,-145,-1.5,150,7.5,105,-125,130,1.5,-170,4.44,Turner Field,12,2
2015-05-06,2015,CIN,PIT,3,0,150,1.5,-145,7.0,100,-120,-170,-1.5,125,2.8,PNC Park,3,3
2015-05-06,2015,SF,SD,1,9,-129,-1.5,170,7.0,-105,-115,119,1.5,-200,3.94,AT&T Park,10,-8
2015-05-06,2015,LAA,SEA,4,3,-150,-1.5,145,8.5,-110,-110,135,1.5,-165,5.1,Angel Stadium,7,1
2015-05-06,2015,SD,SF,9,1,119,1.5,-200,7.0,-105,-115,-129,-1.5,170,3.2,AT&T Park,10,8
2015-05-06,2015,CHC,STL,6,5,118,1.5,-205,7.0,-109,-111,-128,-1.5,175,3.21,Busch Stadium,11,1
2015-05-06,2015,BOS,TB,3,5,-124,-1.5,160,9.0,100,-120,114,1.5,-190,4.98,Fenway Park,8,-2
2015-05-06,2015,HOU,TEX,3,11,-132,-1.5,160,9.0,100,-120,117,1.5,-180,5.12,Minute Maid Park,14,-8
2015-05-06,2015,NYY,TOR,1,5,119,1.5,-175,9.0,100,-120,-134,-1.5,155,4.11,Rogers Centre,6,-4
2015-05-06,2015,MIA,WSH,5,7,183,1.5,-125,7.0,110,-130,-213,-1.5,105,2.47,Nationals Park,12,-2
2015-05-07,2015,SD,ARI,0,11,109,1.5,-200,9.0,100,-120,-119,-1.5,170,4.31,Chase Field,11,-11
2015-05-07,2015,NYY,BAL,4,3,-130,-1.5,155,8.5,100,-120,115,1.5,-175,4.8,Yankee Stadium,7,1
2015-05-07,2015,STL,CHC,5,1,-114,-1.5,175,7.5,-110,-110,104,1.5,-205,4.0,Busch Stadium,6,4
2015-05-07,2015,PIT,CIN,7,2,-129,-1.5,165,7.0,-125,105,119,1.5,-195,3.94,PNC Park,9,5
2015-05-07,2015,KC,CLE,7,4,103,1.5,-159,7.5,-115,-105,-113,-1.5,139,3.69,Kauffman Stadium,11,3
2015-05-07,2015,DET,CWS,4,1,105,1.5,-195,10.0,100,-120,-115,-1.5,165,4.88,Guaranteed Rate Field,5,3
2015-05-07,2015,CWS,DET,1,4,-115,-1.5,165,10.0,100,-120,105,1.5,-195,5.35,Guaranteed Rate Field,5,-3
2015-05-07,2015,LAA,HOU,2,3,100,1.5,-165,7.5,100,-120,-110,-1.5,145,3.75,Angel Stadium,5,-1
2015-05-07,2015,CLE,KC,4,7,-113,-1.5,139,7.5,-115,-105,103,1.5,-159,3.98,Kauffman Stadium,11,-3
2015-05-07,2015,HOU,LAA,3,2,-110,-1.5,145,7.5,100,-120,100,1.5,-165,3.93,Angel Stadium,5,1
2015-05-07,2015,MIL,LAD,4,14,-102,1.5,-165,8.0,-120,100,-108,-1.5,145,4.04,Miller Park,18,-10
2015-05-07,2015,SF,MIA,2,7,-144,-1.5,160,7.0,-120,100,129,1.5,-180,4.13,AT&T Park,9,-5
2015-05-07,2015,LAD,MIL,14,4,-108,-1.5,145,8.0,-120,100,-102,1.5,-165,4.15,Miller Park,18,10
2015-05-07,2015,OAK,MIN,5,6,104,1.5,-210,8.0,-120,100,-114,-1.5,180,3.92,Target Field,11,-1
2015-05-07,2015,BAL,NYY,3,4,115,1.5,-175,8.5,100,-120,-130,-1.5,155,3.95,Yankee Stadium,7,-1
2015-05-07,2015,MIN,OAK,6,5,-114,-1.5,180,8.0,-120,100,104,1.5,-210,4.26,Target Field,11,1
2015-05-07,2015,CIN,PIT,2,7,119,1.5,-195,7.0,-125,105,-129,-1.5,165,3.2,PNC Park,9,-5
2015-05-07,2015,ARI,SD,11,0,-119,-1.5,170,9.0,100,-120,109,1.5,-200,4.89,Chase Field,11,11
2015-05-07,2015,MIA,SF,7,2,129,1.5,-180,7.0,-120,100,-144,-1.5,160,3.06,AT&T Park,9,5
2015-05-07,2015,CHC,STL,1,5,104,1.5,-205,7.5,-110,-110,-114,-1.5,175,3.68,Busch Stadium,6,-4
2015-05-07,2015,TEX,TB,5,4,150,1.5,-160,7.0,-125,105,-170,-1.5,140,2.8,Tropicana Field,9,1
2015-05-07,2015,TB,TEX,4,5,-170,-1.5,140,7.0,-125,105,150,1.5,-160,4.41,Tropicana Field,9,-1
2015-05-08,2015,SD,ARI,6,5,-118,-1.5,140,8.5,-115,-105,108,1.5,-160,4.6,Chase Field,11,1
2015-05-08,2015,WSH,ATL,9,2,-215,-1.5,105,7.5,-120,100,185,1.5,-125,5.12,Nationals Park,11,7
2015-05-08,2015,NYY,BAL,5,4,-117,-1.5,170,8.5,-110,-110,107,1.5,-200,4.58,Yankee Stadium,9,1
2015-05-08,2015,TOR,BOS,7,0,-134,-1.5,155,9.0,-125,105,119,1.5,-175,5.15,Rogers Centre,7,7
2015-05-08,2015,MIL,CHC,6,7,-110,-1.5,175,8.0,-120,100,100,1.5,-205,4.19,Miller Park,13,-1
2015-05-08,2015,MIN,CLE,9,3,152,1.5,-137,9.0,-120,100,-172,-1.5,118,3.57,Progressive Field,12,6
2015-05-08,2015,LAD,COL,2,1,-134,-1.5,110,10.0,-110,-110,119,1.5,-130,5.73,Coors Field,3,1
2015-05-08,2015,KC,DET,5,6,140,1.5,-160,7.5,-120,100,-155,-1.5,140,3.13,Comerica Park,11,-1
2015-05-08,2015,LAA,HOU,2,0,-125,-1.5,170,8.5,-105,-115,115,1.5,-200,4.72,Angel Stadium,2,2
2015-05-08,2015,DET,KC,6,5,-155,-1.5,140,7.5,-120,100,140,1.5,-160,4.56,Comerica Park,11,1
2015-05-08,2015,HOU,LAA,0,2,115,1.5,-200,8.5,-105,-115,-125,-1.5,170,3.95,Angel Stadium,2,-2
2015-05-08,2015,COL,LAD,1,2,119,1.5,-130,10.0,-110,-110,-134,-1.5,110,4.57,Coors Field,3,-1
2015-05-08,2015,SF,MIA,6,0,-105,-1.5,195,7.0,100,-120,-105,1.5,-235,3.59,AT&T Park,6,6
2015-05-08,2015,CHC,MIL,7,6,100,1.5,-205,8.0,-120,100,-110,-1.5,175,4.0,Miller Park,13,1
2015-05-08,2015,CLE,MIN,3,9,-172,-1.5,118,9.0,-120,100,152,1.5,-137,5.69,Progressive Field,12,-6
2015-05-08,2015,PHI,NYM,3,1,116,1.5,-155,7.0,105,-125,-131,-1.5,135,3.24,Citizens Bank Park,4,2
2015-05-08,2015,BAL,NYY,4,5,107,1.5,-200,8.5,-110,-110,-117,-1.5,170,4.11,Yankee Stadium,9,-1
2015-05-08,2015,SEA,OAK,4,3,109,1.5,-155,8.0,100,-120,-119,-1.5,135,3.83,T-Mobile Park,7,1
2015-05-08,2015,NYM,PHI,1,3,-131,-1.5,135,7.0,105,-125,116,1.5,-155,3.97,Citizens Bank Park,4,-2
2015-05-08,2015,STL,PIT,8,5,100,1.5,-230,7.0,-130,110,-110,-1.5,190,3.5,PNC Park,13,3
2015-05-08,2015,ARI,SD,5,6,108,1.5,-160,8.5,-115,-105,-118,-1.5,140,4.09,Chase Field,11,-1
2015-05-08,2015,OAK,SEA,3,4,-119,-1.5,135,8.0,100,-120,109,1.5,-155,4.35,T-Mobile Park,7,-1
2015-05-08,2015,MIA,SF,0,6,-105,1.5,-235,7.0,100,-120,-105,-1.5,195,3.59,AT&T Park,6,-6
2015-05-08,2015,PIT,STL,5,8,-110,-1.5,190,7.0,-130,110,100,1.5,-230,3.67,PNC Park,13,-3
2015-05-08,2015,TEX,TB,2,8,110,1.5,-205,7.5,-105,-115,-120,-1.5,175,3.57,Tropicana Field,10,-6
2015-05-08,2015,TB,TEX,8,2,-120,-1.5,175,7.5,-105,-115,110,1.5,-205,4.09,Tropicana Field,10,6
2015-05-08,2015,BOS,TOR,0,7,119,1.5,-175,9.0,-125,105,-134,-1.5,155,4.11,Rogers Centre,7,-7
2015-05-08,2015,ATL,WSH,2,9,185,1.5,-125,7.5,-120,100,-215,-1.5,105,2.63,Nationals Park,11,-7
2015-05-09,2015,SD,ARI,6,4,-101,1.5,-210,8.0,-115,-105,-109,-1.5,180,4.02,Chase Field,10,2
2015-05-09,2015,WSH,ATL,8,6,-150,-1.5,145,7.5,-113,-107,135,1.5,-165,4.5,Nationals Park,14,2
2015-05-09,2015,NYY,BAL,2,6,-117,-1.5,170,7.5,-120,100,107,1.5,-200,4.04,Yankee Stadium,8,-4
2015-05-09,2015,TOR,BOS,7,1,-117,-1.5,170,9.0,-120,100,107,1.5,-200,4.85,Rogers Centre,8,6
2015-05-09,2015,MIL,CHC,12,4,-105,1.5,-170,8.5,-110,-110,-105,-1.5,150,4.35,Miller Park,16,8
2015-05-09,2015,CWS,CIN,4,10,104,1.5,-165,7.5,100,-120,-114,-1.5,-170,3.68,Guaranteed Rate Field,14,-6
2015-05-09,2015,CWS,CIN,8,2,-141,-1.5,150,8.5,-110,-110,126,1.5,-150,4.97,Guaranteed Rate Field,10,6
2015-05-09,2015,MIN,CLE,7,4,115,1.5,-180,8.5,-115,-105,-130,-1.5,160,3.95,Progressive Field,11,3
2015-05-09,2015,CIN,CWS,10,4,-114,-1.5,-170,7.5,100,-120,104,1.5,-165,4.0,Guaranteed Rate Field,14,6
2015-05-09,2015,CIN,CWS,2,8,126,1.5,-150,8.5,-110,-110,-141,-1.5,150,3.76,Guaranteed Rate Field,10,-6
2015-05-09,2015,KC,DET,6,2,136,1.5,-160,8.5,-110,-110,-151,-1.5,140,3.6,Comerica Park,8,4
2015-05-09,2015,LAA,HOU,5,6,-105,-1.5,190,7.0,-115,-105,-105,1.5,-230,3.59,Angel Stadium,11,-1
2015-05-09,2015,DET,KC,2,6,-151,-1.5,140,8.5,-110,-110,136,1.5,-160,5.11,Comerica Park,8,-4
2015-05-09,2015,HOU,LAA,6,5,-105,1.5,-230,7.0,-115,-105,-105,-1.5,190,3.59,Angel Stadium,11,1
2015-05-09,2015,SF,MIA,2,6,-156,-1.5,160,7.0,105,-125,141,1.5,-190,4.27,AT&T Park,8,-4
2015-05-09,2015,CHC,MIL,4,12,-105,-1.5,150,8.5,-110,-110,-105,1.5,-170,4.35,Miller Park,16,-8
2015-05-09,2015,CLE,MIN,4,7,-130,-1.5,160,8.5,-115,-105,115,1.5,-180,4.8,Progressive Field,11,-3
2015-05-09,2015,PHI,NYM,2,3,103,1.5,-160,7.5,-112,-108,-113,-1.5,140,3.69,Citizens Bank Park,5,-1
2015-05-09,2015,BAL,NYY,6,2,107,1.5,-200,7.5,-120,100,-117,-1.5,170,3.62,Yankee Stadium,8,4
2015-05-09,2015,SEA,OAK,7,2,-134,-1.5,154,7.5,-120,100,119,1.5,-182,4.29,T-Mobile Park,9,5
2015-05-09,2015,NYM,PHI,3,2,-113,-1.5,140,7.5,-112,-108,103,1.5,-160,3.98,Citizens Bank Park,5,1
2015-05-09,2015,STL,PIT,5,7,107,1.5,-210,7.5,-120,100,-117,-1.5,180,3.62,PNC Park,12,-2
2015-05-09,2015,ARI,SD,4,6,-109,-1.5,180,8.0,-115,-105,-101,1.5,-210,4.17,Chase Field,10,-2
2015-05-09,2015,OAK,SEA,2,7,119,1.5,-182,7.5,-120,100,-134,-1.5,154,3.42,T-Mobile Park,9,-5
2015-05-09,2015,MIA,SF,6,2,141,1.5,-190,7.0,105,-125,-156,-1.5,160,2.9,AT&T Park,8,4
2015-05-09,2015,PIT,STL,7,5,-117,-1.5,180,7.5,-120,100,107,1.5,-210,4.04,PNC Park,12,2
2015-05-09,2015,TEX,TB,2,7,126,1.5,-175,8.0,-120,100,-141,-1.5,155,3.54,Tropicana Field,9,-5
2015-05-09,2015,TB,TEX,7,2,-141,-1.5,155,8.0,-120,100,126,1.5,-175,4.68,Tropicana Field,9,5
2015-05-09,2015,BOS,TOR,1,7,107,1.5,-200,9.0,-120,100,-117,-1.5,170,4.35,Rogers Centre,8,-6
2015-05-09,2015,ATL,WSH,6,8,135,1.5,-165,7.5,-113,-107,-150,-1.5,145,3.19,Nationals Park,14,-2
2015-05-10,2015,SD,ARI,1,2,-109,-1.5,150,8.5,100,-120,-101,1.5,-170,4.43,Chase Field,3,-1
2015-05-10,2015,WSH,ATL,5,4,-163,-1.5,135,7.5,-110,-110,148,1.5,-155,4.65,Nationals Park,9,1
2015-05-10,2015,NYY,BAL,6,2,-181,-1.5,115,8.0,-121,101,161,1.5,-135,5.15,Yankee Stadium,8,4
2015-05-10,2015,TOR,BOS,3,6,105,1.5,-160,9.0,100,-120,-115,-1.5,140,4.39,Rogers Centre,9,-3
2015-05-10,2015,MIL,CHC,3,2,100,1.5,-165,8.5,-110,-110,-110,-1.5,145,4.25,Miller Park,5,1
2015-05-10,2015,CWS,CIN,4,3,-115,-1.5,180,8.5,-120,100,105,1.5,-210,4.55,Guaranteed Rate Field,7,1
2015-05-10,2015,MIN,CLE,2,8,152,1.5,-138,8.0,-115,-105,-172,-1.5,118,3.17,Progressive Field,10,-6
2015-05-10,2015,LAD,COL,9,5,-163,-1.5,105,7.5,100,-120,148,1.5,-125,4.65,Coors Field,14,4
2015-05-10,2015,CIN,CWS,3,4,105,1.5,-210,8.5,-120,100,-115,-1.5,180,4.15,Guaranteed Rate Field,7,-1
2015-05-10,2015,KC,DET,2,1,-109,-1.5,150,8.5,100,-120,-101,1.5,-170,4.43,Comerica Park,3,1
2015-05-10,2015,LAA,HOU,3,1,-160,-1.5,135,8.5,-105,-115,145,1.5,-155,5.23,Angel Stadium,4,2
2015-05-10,2015,DET,KC,1,2,-101,1.5,-170,8.5,100,-120,-109,-1.5,150,4.27,Comerica Park,3,-1
2015-05-10,2015,HOU,LAA,1,3,145,1.5,-155,8.5,-105,-115,-160,-1.5,135,3.47,Angel Stadium,4,-2
2015-05-10,2015,COL,LAD,5,9,148,1.5,-125,7.5,100,-120,-163,-1.5,105,3.02,Coors Field,14,-4
2015-05-10,2015,SF,MIA,3,2,-107,-1.5,185,7.0,100,-120,-103,1.5,-215,3.62,AT&T Park,5,1
2015-05-10,2015,CHC,MIL,2,3,-110,-1.5,145,8.5,-110,-110,100,1.5,-165,4.45,Miller Park,5,-1
2015-05-10,2015,CLE,MIN,8,2,-172,-1.5,118,8.0,-115,-105,152,1.5,-138,5.06,Progressive Field,10,6
2015-05-10,2015,PHI,NYM,4,7,112,1.5,-150,8.0,-115,-105,-122,-1.5,130,3.77,Citizens Bank Park,11,-3
2015-05-10,2015,BAL,NYY,2,6,161,1.5,-135,8.0,-121,101,-181,-1.5,115,3.07,Yankee Stadium,8,-4
2015-05-10,2015,SEA,OAK,4,3,-170,-1.5,135,6.5,-120,100,150,1.5,-155,4.09,T-Mobile Park,7,1
2015-05-10,2015,NYM,PHI,7,4,-122,-1.5,130,8.0,-115,-105,112,1.5,-150,4.4,Citizens Bank Park,11,3
2015-05-10,2015,STL,PIT,3,4,-103,1.5,-215,7.5,-115,-105,-107,-1.5,185,3.81,PNC Park,7,-1
2015-05-10,2015,ARI,SD,2,1,-101,1.5,-170,8.5,100,-120,-109,-1.5,150,4.27,Chase Field,3,1
2015-05-10,2015,OAK,SEA,3,4,150,1.5,-155,6.5,-120,100,-170,-1.5,135,2.6,T-Mobile Park,7,-1
2015-05-10,2015,MIA,SF,2,3,-103,1.5,-215,7.0,100,-120,-107,-1.5,185,3.55,AT&T Park,5,-1
2015-05-10,2015,PIT,STL,4,3,-107,-1.5,185,7.5,-115,-105,-103,1.5,-215,3.88,PNC Park,7,1
2015-05-10,2015,TEX,TB,2,1,145,1.5,-155,7.0,-118,-102,-160,-1.5,135,2.86,Tropicana Field,3,1
2015-05-10,2015,TB,TEX,1,2,-160,-1.5,135,7.0,-118,-102,145,1.5,-155,4.31,Tropicana Field,3,-1
2015-05-10,2015,BOS,TOR,6,3,-115,-1.5,140,9.0,100,-120,105,1.5,-160,4.81,Rogers Centre,9,3
2015-05-10,2015,ATL,WSH,4,5,148,1.5,-155,7.5,-110,-110,-163,-1.5,135,3.02,Nationals Park,9,-1
2015-05-11,2015,WSH,ARI,11,1,-155,-1.5,100,8.0,-110,-110,140,1.5,-120,4.86,Chase Field,12,10
2015-05-11,2015,CIN,ATL,1,2,-140,-1.5,155,7.5,-105,-115,125,1.5,-175,4.38,Great American Ballpark,3,-1
2015-05-11,2015,TOR,BAL,2,5,110,1.5,-190,8.5,-120,100,-120,-1.5,160,4.05,Camden Yards,7,-3
2015-05-11,2015,OAK,BOS,4,5,-121,-1.5,170,7.5,-105,-115,111,1.5,-200,4.11,Oakland Coliseum,9,-1
2015-05-11,2015,NYM,CHC,3,4,135,1.5,-165,9.0,100,-120,-150,-1.5,145,3.83,Wrigley Field,7,-1
2015-05-11,2015,ATL,CIN,2,1,125,1.5,-175,7.5,-105,-115,-140,-1.5,155,3.33,Great American Ballpark,3,1
2015-05-11,2015,MIL,CWS,10,7,-110,-1.5,185,8.0,-115,-105,100,1.5,-215,4.19,Miller Park,17,3
2015-05-11,2015,TEX,KC,8,2,133,1.5,-130,8.0,100,-120,-148,-1.5,110,3.43,Rangers Ballpark,10,6
2015-05-11,2015,MIA,LAD,3,5,201,1.5,-115,7.0,-125,105,-231,-1.5,-105,2.33,Dodger Stadium,8,-2
2015-05-11,2015,LAD,MIA,5,3,-231,-1.5,-105,7.0,-125,105,201,1.5,-115,4.89,Dodger Stadium,8,2
2015-05-11,2015,CWS,MIL,7,10,100,1.5,-215,8.0,-115,-105,-110,-1.5,185,4.0,Miller Park,17,-3
2015-05-11,2015,CHC,NYM,4,3,-150,-1.5,145,9.0,100,-120,135,1.5,-165,5.4,Wrigley Field,7,1
2015-05-11,2015,TB,NYY,5,11,-111,-1.5,185,7.5,-105,-115,101,1.5,-215,3.95,Tropicana Field,16,-6
2015-05-11,2015,BOS,OAK,5,4,111,1.5,-200,7.5,-105,-115,-121,-1.5,170,3.55,Oakland Coliseum,9,1
2015-05-11,2015,PIT,PHI,4,3,-172,-1.5,-105,7.5,-120,100,152,1.5,-115,4.74,Citizens Bank Park,7,1
2015-05-11,2015,PHI,PIT,3,4,152,1.5,-115,7.5,-120,100,-172,-1.5,-105,2.98,Citizens Bank Park,7,-1
2015-05-11,2015,NYY,TB,11,5,101,1.5,-215,7.5,-105,-115,-111,-1.5,185,3.73,Tropicana Field,16,6
2015-05-11,2015,KC,TEX,2,8,-148,-1.5,110,8.0,100,-120,133,1.5,-130,4.77,Rangers Ballpark,10,-6
2015-05-11,2015,BAL,TOR,5,2,-120,-1.5,160,8.5,-120,100,110,1.5,-190,4.64,Camden Yards,7,3
2015-05-11,2015,ARI,WSH,1,11,140,1.5,-120,8.0,-110,-110,-155,-1.5,100,3.33,Chase Field,12,-10
2015-05-12,2015,WSH,ARI,6,14,-140,-1.5,115,8.5,-115,-105,125,1.5,-135,4.96,Chase Field,20,-8
2015-05-12,2015,CIN,ATL,4,3,-140,-1.5,160,8.0,-120,100,125,1.5,-190,4.67,Great American Ballpark,7,1
2015-05-12,2015,TOR,BAL,10,2,117,1.5,-175,9.5,-110,-110,-127,-1.5,155,4.38,Camden Yards,12,8
2015-05-12,2015,OAK,BOS,9,2,-118,-1.5,175,8.0,-110,-110,108,1.5,-205,4.33,Oakland Coliseum,11,7
2015-05-12,2015,NYM,CHC,1,6,130,1.5,-175,7.0,-105,-115,-145,-1.5,155,3.04,Wrigley Field,7,-5
2015-05-12,2015,ATL,CIN,3,4,125,1.5,-190,8.0,-120,100,-140,-1.5,160,3.56,Great American Ballpark,7,-1
2015-05-12,2015,STL,CLE,8,3,119,1.5,-175,7.5,-115,-105,-134,-1.5,155,3.42,Progressive Field,11,5
2015-05-12,2015,LAA,COL,5,2,-183,-1.5,110,8.0,-115,-105,163,1.5,-130,5.17,Angel Stadium,7,3
2015-05-12,2015,MIL,CWS,2,4,-101,1.5,-175,7.5,-105,-115,-109,-1.5,155,3.77,Miller Park,6,-2
2015-05-12,2015,MIN,DET,1,2,135,1.5,-155,9.0,-110,-110,-150,-1.5,135,3.83,Comerica Park,3,-1
2015-05-12,2015,SF,HOU,8,1,145,1.5,-145,8.0,-110,-110,-160,-1.5,125,3.27,Minute Maid Park,9,7
2015-05-12,2015,TEX,KC,6,7,118,1.5,-145,9.0,-101,-119,-133,-1.5,125,4.13,Rangers Ballpark,13,-1
2015-05-12,2015,COL,LAA,2,5,163,1.5,-130,8.0,-115,-105,-183,-1.5,110,3.04,Angel Stadium,7,-3
2015-05-12,2015,MIA,LAD,1,11,142,1.5,-160,7.5,-105,-115,-157,-1.5,140,3.1,Dodger Stadium,12,-10
2015-05-12,2015,LAD,MIA,11,1,-157,-1.5,140,7.5,-105,-115,142,1.5,-160,4.58,Dodger Stadium,12,10
2015-05-12,2015,CWS,MIL,4,2,-109,-1.5,155,7.5,-105,-115,-101,1.5,-175,3.91,Miller Park,6,2
2015-05-12,2015,DET,MIN,2,1,-150,-1.5,135,9.0,-110,-110,135,1.5,-155,5.4,Comerica Park,3,1
2015-05-12,2015,CHC,NYM,6,1,-145,-1.5,155,7.0,-105,-115,130,1.5,-175,4.14,Wrigley Field,7,5
2015-05-12,2015,TB,NYY,4,2,-123,-1.5,175,7.0,105,-125,113,1.5,-205,3.86,Tropicana Field,6,2
2015-05-12,2015,BOS,OAK,2,9,108,1.5,-205,8.0,-110,-110,-118,-1.5,175,3.85,Oakland Coliseum,11,-7
2015-05-12,2015,PIT,PHI,7,2,-150,-1.5,105,9.0,100,-120,135,1.5,-125,5.4,Citizens Bank Park,9,5
2015-05-12,2015,PHI,PIT,2,7,135,1.5,-125,9.0,100,-120,-150,-1.5,105,3.83,Citizens Bank Park,9,-5
2015-05-12,2015,SEA,SD,11,4,-135,-1.5,155,7.5,-111,-109,120,1.5,-175,4.31,T-Mobile Park,15,7
2015-05-12,2015,SD,SEA,4,11,120,1.5,-175,7.5,-111,-109,-135,-1.5,155,3.41,T-Mobile Park,15,-7
2015-05-12,2015,HOU,SF,1,8,-160,-1.5,125,8.0,-110,-110,145,1.5,-145,4.92,Minute Maid Park,9,-7
2015-05-12,2015,CLE,STL,3,8,-134,-1.5,155,7.5,-115,-105,119,1.5,-175,4.29,Progressive Field,11,-5
2015-05-12,2015,NYY,TB,2,4,113,1.5,-205,7.0,105,-125,-123,-1.5,175,3.29,Tropicana Field,6,-2
2015-05-12,2015,KC,TEX,7,6,-133,-1.5,125,9.0,-101,-119,118,1.5,-145,5.14,Rangers Ballpark,13,1
2015-05-12,2015,BAL,TOR,2,10,-127,-1.5,155,9.5,-110,-110,117,1.5,-175,5.31,Camden Yards,12,-8
2015-05-12,2015,ARI,WSH,14,6,125,1.5,-135,8.5,-115,-105,-140,-1.5,115,3.78,Chase Field,20,8
2015-05-13,2015,WSH,ARI,9,6,-123,-1.5,125,9.0,-115,-105,113,1.5,-145,4.96,Chase Field,15,3
2015-05-13,2015,CIN,ATL,5,1,-134,-1.5,160,7.5,100,-120,119,1.5,-190,4.29,Great American Ballpark,6,4
2015-05-13,2015,TOR,BAL,1,6,115,1.5,-190,9.0,100,-120,-125,-1.5,160,4.19,Camden Yards,7,-5
2015-05-13,2015,OAK,BOS,0,2,-141,-1.5,150,7.5,110,-130,126,1.5,-170,4.39,Oakland Coliseum,2,-2
2015-05-13,2015,NYM,CHC,1,2,-106,1.5,-240,6.5,105,-125,-104,-1.5,200,3.34,Wrigley Field,3,-1
2015-05-13,2015,ATL,CIN,1,5,119,1.5,-190,7.5,100,-120,-134,-1.5,160,3.42,Great American Ballpark,6,-4
2015-05-13,2015,STL,CLE,0,2,125,1.5,-175,7.0,100,-120,-140,-1.5,155,3.11,Progressive Field,2,-2
2015-05-13,2015,LAA,COL,2,1,-162,-1.5,125,8.0,100,-120,147,1.5,-145,4.95,Angel Stadium,3,1
2015-05-13,2015,MIL,CWS,2,4,-120,-1.5,175,7.0,-125,105,110,1.5,-205,3.82,Miller Park,6,-2
2015-05-13,2015,MIN,DET,6,2,111,1.5,-180,8.5,-105,-115,-121,-1.5,160,4.03,Comerica Park,8,4
2015-05-13,2015,SF,HOU,3,4,115,1.5,-175,8.5,-105,-115,-130,-1.5,155,3.95,Minute Maid Park,7,-1
2015-05-13,2015,TEX,KC,5,2,117,1.5,-150,8.0,-120,100,-127,-1.5,130,3.69,Rangers Ballpark,7,3
2015-05-13,2015,COL,LAA,1,2,147,1.5,-145,8.0,100,-120,-162,-1.5,125,3.24,Angel Stadium,3,-1
2015-05-13,2015,MIA,LAD,5,4,147,1.5,-155,7.5,-110,-110,-162,-1.5,135,3.04,Dodger Stadium,9,1
2015-05-13,2015,LAD,MIA,4,5,-162,-1.5,135,7.5,-110,-110,147,1.5,-155,4.64,Dodger Stadium,9,-1
2015-05-13,2015,CWS,MIL,4,2,110,1.5,-205,7.0,-125,105,-120,-1.5,175,3.33,Miller Park,6,2
2015-05-13,2015,DET,MIN,2,6,-121,-1.5,160,8.5,-105,-115,111,1.5,-180,4.65,Comerica Park,8,-4
2015-05-13,2015,CHC,NYM,2,1,-104,-1.5,200,6.5,105,-125,-106,1.5,-240,3.31,Wrigley Field,3,1
2015-05-13,2015,TB,NYY,3,2,-105,1.5,-170,7.5,107,-127,-105,-1.5,150,3.84,Tropicana Field,5,1
2015-05-13,2015,BOS,OAK,2,0,126,1.5,-170,7.5,110,-130,-141,-1.5,150,3.32,Oakland Coliseum,2,2
2015-05-13,2015,PIT,PHI,2,3,-127,-1.5,135,6.5,-120,100,117,1.5,-155,3.64,Citizens Bank Park,5,-1
2015-05-13,2015,PHI,PIT,3,2,117,1.5,-155,6.5,-120,100,-127,-1.5,135,3.0,Citizens Bank Park,5,1
2015-05-13,2015,SEA,SD,2,4,-142,-1.5,160,7.0,-115,-105,127,1.5,-190,4.11,T-Mobile Park,6,-2
2015-05-13,2015,SD,SEA,4,2,127,1.5,-190,7.0,-115,-105,-142,-1.5,160,3.08,T-Mobile Park,6,2
2015-05-13,2015,HOU,SF,4,3,-130,-1.5,155,8.5,-105,-115,115,1.5,-175,4.8,Minute Maid Park,7,1
2015-05-13,2015,CLE,STL,2,0,-140,-1.5,155,7.0,100,-120,125,1.5,-175,4.08,Progressive Field,2,2
2015-05-13,2015,NYY,TB,2,3,-105,-1.5,150,7.5,107,-127,-105,1.5,-170,3.84,Tropicana Field,5,-1
2015-05-13,2015,KC,TEX,2,5,-127,-1.5,130,8.0,-120,100,117,1.5,-150,4.48,Rangers Ballpark,7,-3
2015-05-13,2015,BAL,TOR,6,1,-125,-1.5,160,9.0,100,-120,115,1.5,-190,5.0,Camden Yards,7,5
2015-05-13,2015,ARI,WSH,6,9,113,1.5,-145,9.0,-115,-105,-123,-1.5,125,4.23,Chase Field,15,-3
2015-05-14,2015,SEA,BOS,1,2,-109,-1.5,183,7.5,-110,-110,-101,1.5,-221,3.91,T-Mobile Park,3,-1
2015-05-14,2015,NYM,CHC,5,6,134,1.5,-175,7.5,-110,-110,-149,-1.5,155,3.21,Wrigley Field,11,-1
2015-05-14,2015,SF,CIN,3,4,151,1.5,-155,7.0,100,-120,-171,-1.5,135,2.79,Great American Ballpark,7,-1
2015-05-14,2015,STL,CLE,2,1,-110,-1.5,150,7.5,-110,-110,100,1.5,-170,3.93,Progressive Field,3,1
2015-05-14,2015,LAD,COL,4,5,-215,-1.5,-102,7.5,-120,100,185,1.5,-118,5.12,Dodger Stadium,9,-1
2015-05-14,2015,MIN,DET,1,13,170,1.5,-130,8.0,-115,-105,-200,-1.5,110,2.96,Comerica Park,14,-12
2015-05-14,2015,TOR,HOU,4,6,-105,-1.5,155,9.0,-110,-110,-105,1.5,-175,4.61,Minute Maid Park,10,-2
2015-05-14,2015,TEX,KC,3,6,-104,1.5,-170,9.0,100,-120,-106,-1.5,150,4.59,Rangers Ballpark,9,-3
2015-05-14,2015,COL,LAD,5,4,185,1.5,-118,7.5,-120,100,-215,-1.5,-102,2.63,Dodger Stadium,9,1
2015-05-14,2015,DET,MIN,13,1,-200,-1.5,110,8.0,-115,-105,170,1.5,-130,5.33,Comerica Park,14,12
2015-05-14,2015,CHC,NYM,6,5,-149,-1.5,155,7.5,-110,-110,134,1.5,-175,4.49,Wrigley Field,11,1
2015-05-14,2015,TB,NYY,6,1,117,1.5,-145,7.5,-120,100,-132,-1.5,125,3.46,Tropicana Field,7,5
2015-05-14,2015,PIT,PHI,2,4,-122,-1.5,140,7.5,-110,-110,112,1.5,-160,4.12,Citizens Bank Park,6,-2
2015-05-14,2015,PHI,PIT,4,2,112,1.5,-160,7.5,-110,-110,-122,-1.5,140,3.54,Citizens Bank Park,6,2
2015-05-14,2015,WSH,SD,3,8,108,1.5,-215,6.5,-110,-110,-118,-1.5,185,3.13,PETCO Park,11,-5
2015-05-14,2015,BOS,SEA,2,1,-101,1.5,-221,7.5,-110,-110,-109,-1.5,183,3.77,T-Mobile Park,3,1
2015-05-14,2015,CIN,SF,4,3,-171,-1.5,135,7.0,100,-120,151,1.5,-155,4.42,Great American Ballpark,7,1
2015-05-14,2015,CLE,STL,1,2,100,1.5,-170,7.5,-110,-110,-110,-1.5,150,3.75,Progressive Field,3,-1
2015-05-14,2015,NYY,TB,1,6,-132,-1.5,125,7.5,-120,100,117,1.5,-145,4.27,Tropicana Field,7,-5
2015-05-14,2015,KC,TEX,6,3,-106,-1.5,150,9.0,100,-120,-104,1.5,-170,4.63,Rangers Ballpark,9,3
2015-05-14,2015,HOU,TOR,6,4,-105,1.5,-175,9.0,-110,-110,-105,-1.5,155,4.61,Minute Maid Park,10,2
2015-05-14,2015,SD,WSH,8,3,-118,-1.5,185,6.5,-110,-110,108,1.5,-215,3.52,PETCO Park,11,5
2015-05-15,2015,PHI,ARI,4,3,103,1.5,-160,7.5,-110,-110,-113,-1.5,140,3.69,Citizens Bank Park,7,1
2015-05-15,2015,MIA,ATL,3,5,-133,-1.5,160,7.5,100,-120,118,1.5,-190,4.28,Marlins Park,8,-2
2015-05-15,2015,LAA,BAL,3,1,102,1.5,-205,9.0,105,-125,-112,-1.5,175,4.46,Camden Yards,4,2
2015-05-15,2015,SEA,BOS,2,1,-111,-1.5,185,7.5,105,-125,101,1.5,-215,3.95,T-Mobile Park,3,1
2015-05-15,2015,PIT,CHC,10,11,116,1.5,-175,9.5,-115,-105,-131,-1.5,155,4.4,Wrigley Field,21,-1
2015-05-15,2015,SF,CIN,10,2,-131,-1.5,125,7.5,-103,-117,116,1.5,-145,4.25,Great American Ballpark,12,8
2015-05-15,2015,TEX,CLE,3,8,-135,-1.5,155,9.5,-105,-115,120,1.5,-175,5.46,Rangers Ballpark,11,-5
2015-05-15,2015,LAD,COL,6,4,-340,-1.5,-135,6.5,-120,100,290,1.5,115,5.02,Dodger Stadium,10,2
2015-05-15,2015,OAK,CWS,6,7,-121,-1.5,180,7.0,-115,-105,111,1.5,-210,3.83,Oakland Coliseum,13,-1
2015-05-15,2015,STL,DET,4,10,-143,-1.5,145,8.0,-110,-110,128,1.5,-165,4.71,Busch Stadium,14,-6
2015-05-15,2015,TOR,HOU,4,8,105,1.5,-200,8.5,-108,-112,-115,-1.5,170,4.15,Minute Maid Park,12,-4
2015-05-15,2015,NYY,KC,1,12,-116,-1.5,140,7.0,-118,-102,106,1.5,-160,3.76,Kauffman Stadium,13,-11
2015-05-15,2015,BAL,LAA,1,3,-112,-1.5,175,9.0,105,-125,102,1.5,-205,4.75,Camden Yards,4,-2
2015-05-15,2015,COL,LAD,4,6,290,1.5,115,6.5,-120,100,-340,-1.5,-135,1.67,Dodger Stadium,10,-2
2015-05-15,2015,ATL,MIA,5,3,118,1.5,-190,7.5,100,-120,-133,-1.5,160,3.44,Marlins Park,8,2
2015-05-15,2015,NYM,MIL,0,7,-123,-1.5,170,7.0,100,-120,113,1.5,-200,3.86,Citi Field,7,-7
2015-05-15,2015,TB,MIN,2,3,-110,-1.5,145,7.5,-107,-113,100,1.5,-165,3.93,Target Field,5,-1
2015-05-15,2015,MIL,NYM,7,0,113,1.5,-200,7.0,100,-120,-123,-1.5,170,3.29,Citi Field,7,7
2015-05-15,2015,KC,NYY,12,1,106,1.5,-160,7.0,-118,-102,-116,-1.5,140,3.4,Kauffman Stadium,13,11
2015-05-15,2015,CWS,OAK,7,6,111,1.5,-210,7.0,-115,-105,-121,-1.5,180,3.32,Oakland Coliseum,13,1
2015-05-15,2015,ARI,PHI,3,4,-113,-1.5,140,7.5,-110,-110,103,1.5,-160,3.98,Citizens Bank Park,7,-1
2015-05-15,2015,CHC,PIT,11,10,-131,-1.5,155,9.5,-115,-105,116,1.5,-175,5.39,Wrigley Field,21,1
2015-05-15,2015,WSH,SD,10,0,-133,-1.5,130,7.0,100,-120,118,1.5,-150,4.0,PETCO Park,10,10
2015-05-15,2015,BOS,SEA,1,2,101,1.5,-215,7.5,105,-125,-111,-1.5,185,3.73,T-Mobile Park,3,-1
2015-05-15,2015,CIN,SF,2,10,116,1.5,-145,7.5,-103,-117,-131,-1.5,125,3.47,Great American Ballpark,12,-8
2015-05-15,2015,DET,STL,10,4,128,1.5,-165,8.0,-110,-110,-143,-1.5,145,3.51,Busch Stadium,14,6
2015-05-15,2015,MIN,TB,3,2,100,1.5,-165,7.5,-107,-113,-110,-1.5,145,3.75,Target Field,5,1
2015-05-15,2015,CLE,TEX,8,3,120,1.5,-175,9.5,-105,-115,-135,-1.5,155,4.32,Rangers Ballpark,11,5
2015-05-15,2015,HOU,TOR,8,4,-115,-1.5,170,8.5,-108,-112,105,1.5,-200,4.55,Minute Maid Park,12,4
2015-05-15,2015,SD,WSH,0,10,118,1.5,-150,7.0,100,-120,-133,-1.5,130,3.21,PETCO Park,10,-10
2015-05-16,2015,PHI,ARI,7,5,109,1.5,-160,8.0,-115,-105,-119,-1.5,140,3.83,Citizens Bank Park,12,2
2015-05-16,2015,MIA,ATL,3,5,-126,-1.5,180,7.0,-125,105,116,1.5,-210,3.9,Marlins Park,8,-2
2015-05-16,2015,LAA,BAL,6,1,119,1.5,-190,9.0,100,-120,-129,-1.5,160,4.11,Camden Yards,7,5
2015-05-16,2015,SEA,BOS,2,4,-180,-1.5,130,6.5,105,-125,160,1.5,-150,4.18,T-Mobile Park,6,-2
2015-05-16,2015,PIT,CHC,1,4,-112,-1.5,150,8.5,-105,-115,102,1.5,-170,4.49,Wrigley Field,5,-3
2015-05-16,2015,SF,CIN,11,2,125,1.5,-170,8.0,-115,-105,-140,-1.5,150,3.56,Great American Ballpark,13,9
2015-05-16,2015,TEX,CLE,8,10,137,1.5,-125,9.0,-110,-110,-152,-1.5,105,3.8,Rangers Ballpark,18,-2
2015-05-16,2015,LAD,COL,1,7,-190,-1.5,115,6.5,-115,-105,170,1.5,-135,4.26,Dodger Stadium,8,-6
2015-05-16,2015,OAK,CWS,3,4,-151,-1.5,140,7.0,-120,100,136,1.5,-160,4.21,Oakland Coliseum,7,-1
2015-05-16,2015,STL,DET,3,4,-102,1.5,-175,7.5,-110,-110,-108,-1.5,155,3.79,Busch Stadium,7,-1
2015-05-16,2015,TOR,HOU,5,6,104,1.5,-205,9.0,100,-120,-114,-1.5,175,4.41,Minute Maid Park,11,-1
2015-05-16,2015,NYY,KC,5,1,119,1.5,-200,7.5,-110,-110,-129,-1.5,170,3.42,Kauffman Stadium,6,4
2015-05-16,2015,BAL,LAA,1,6,-129,-1.5,160,9.0,100,-120,119,1.5,-190,5.07,Camden Yards,7,-5
2015-05-16,2015,COL,LAD,7,1,170,1.5,-135,6.5,-115,-105,-190,-1.5,115,2.41,Dodger Stadium,8,6
2015-05-16,2015,ATL,MIA,5,3,116,1.5,-210,7.0,-125,105,-126,-1.5,180,3.24,Marlins Park,8,2
2015-05-16,2015,NYM,MIL,14,1,-134,-1.5,175,7.0,-110,-110,119,1.5,-205,4.01,Citi Field,15,13
2015-05-16,2015,TB,MIN,4,6,-105,1.5,-230,8.0,-115,-105,-105,-1.5,190,4.1,Target Field,10,-2
2015-05-16,2015,MIL,NYM,1,14,119,1.5,-205,7.0,-110,-110,-134,-1.5,175,3.2,Citi Field,15,-13
2015-05-16,2015,KC,NYY,1,5,-129,-1.5,170,7.5,-110,-110,119,1.5,-200,4.22,Kauffman Stadium,6,-4
2015-05-16,2015,CWS,OAK,4,3,136,1.5,-160,7.0,-120,100,-151,-1.5,140,2.97,Oakland Coliseum,7,1
2015-05-16,2015,ARI,PHI,5,7,-119,-1.5,140,8.0,-115,-105,109,1.5,-160,4.35,Citizens Bank Park,12,-2
2015-05-16,2015,CHC,PIT,4,1,102,1.5,-170,8.5,-105,-115,-112,-1.5,150,4.21,Wrigley Field,5,3
2015-05-16,2015,WSH,SD,4,1,-129,-1.5,130,6.0,-105,-115,119,1.5,-150,3.38,PETCO Park,5,3
2015-05-16,2015,BOS,SEA,4,2,160,1.5,-150,6.5,105,-125,-180,-1.5,130,2.5,T-Mobile Park,6,2
2015-05-16,2015,CIN,SF,2,11,-140,-1.5,150,8.0,-115,-105,125,1.5,-170,4.67,Great American Ballpark,13,-9
2015-05-16,2015,DET,STL,4,3,-108,-1.5,155,7.5,-110,-110,-102,1.5,-175,3.89,Busch Stadium,7,1
2015-05-16,2015,MIN,TB,6,4,-105,-1.5,190,8.0,-115,-105,-105,1.5,-230,4.1,Target Field,10,2
2015-05-16,2015,CLE,TEX,10,8,-152,-1.5,105,9.0,-110,-110,137,1.5,-125,5.43,Rangers Ballpark,18,2
2015-05-16,2015,HOU,TOR,6,5,-114,-1.5,175,9.0,100,-120,104,1.5,-205,4.79,Minute Maid Park,11,1
2015-05-16,2015,SD,WSH,1,4,119,1.5,-150,6.0,-105,-115,-129,-1.5,130,2.74,PETCO Park,5,-3
2015-05-17,2015,PHI,ARI,6,0,119,1.5,-135,8.0,-110,-110,-134,-1.5,115,3.65,Citizens Bank Park,6,6
2015-05-17,2015,MIA,ATL,0,6,-128,-1.5,185,7.0,-130,110,118,1.5,-215,3.93,Marlins Park,6,-6
2015-05-17,2015,LAA,BAL,0,3,-120,-1.5,130,8.5,100,-120,110,1.5,-150,4.64,Camden Yards,3,-3
2015-05-17,2015,SEA,BOS,5,0,-139,-1.5,156,7.5,-120,100,124,1.5,-176,4.36,T-Mobile Park,5,5
2015-05-17,2015,PIT,CHC,3,0,129,1.5,-165,10.0,105,-125,-144,-1.5,145,4.37,Wrigley Field,3,3
2015-05-17,2015,SF,CIN,9,8,-108,-1.5,150,8.5,100,-120,-102,1.5,-170,4.41,Great American Ballpark,17,1
2015-05-17,2015,TEX,CLE,5,1,125,1.5,-134,9.5,-105,-115,-140,-1.5,114,4.22,Rangers Ballpark,6,4
2015-05-17,2015,LAD,COL,1,0,-220,-1.5,-105,8.0,100,-120,190,1.5,-115,5.5,Dodger Stadium,1,1
2015-05-17,2015,OAK,CWS,3,7,-142,-1.5,160,7.0,-125,105,127,1.5,-180,4.11,Oakland Coliseum,10,-4
2015-05-17,2015,STL,DET,2,1,-154,-1.5,135,8.0,100,-120,139,1.5,-155,4.85,Busch Stadium,3,1
2015-05-17,2015,TOR,HOU,2,4,133,1.5,-160,8.0,-120,100,-148,-1.5,140,3.43,Minute Maid Park,6,-2
2015-05-17,2015,NYY,KC,0,6,111,1.5,-205,8.0,100,-120,-121,-1.5,175,3.79,Kauffman Stadium,6,-6
2015-05-17,2015,BAL,LAA,3,0,110,1.5,-150,8.5,100,-120,-120,-1.5,130,4.05,Camden Yards,3,3
2015-05-17,2015,COL,LAD,0,1,190,1.5,-115,8.0,100,-120,-220,-1.5,-105,2.76,Dodger Stadium,1,-1
2015-05-17,2015,ATL,MIA,6,0,118,1.5,-215,7.0,-130,110,-128,-1.5,185,3.21,Marlins Park,6,6
2015-05-17,2015,NYM,MIL,5,1,-134,-1.5,170,7.5,-110,-110,119,1.5,-200,4.29,Citi Field,6,4
2015-05-17,2015,TB,MIN,11,3,-125,-1.5,130,8.0,-120,100,115,1.5,-150,4.44,Target Field,14,8
2015-05-17,2015,MIL,NYM,1,5,119,1.5,-200,7.5,-110,-110,-134,-1.5,170,3.42,Citi Field,6,-4
2015-05-17,2015,KC,NYY,6,0,-121,-1.5,175,8.0,100,-120,111,1.5,-205,4.38,Kauffman Stadium,6,6
2015-05-17,2015,CWS,OAK,7,3,127,1.5,-180,7.0,-125,105,-142,-1.5,160,3.08,Oakland Coliseum,10,4
2015-05-17,2015,ARI,PHI,0,6,-134,-1.5,115,8.0,-110,-110,119,1.5,-135,4.58,Citizens Bank Park,6,-6
2015-05-17,2015,CHC,PIT,0,3,-144,-1.5,145,10.0,105,-125,129,1.5,-165,5.9,Wrigley Field,3,-3
2015-05-17,2015,WSH,SD,10,5,-127,-1.5,140,6.5,-120,100,117,1.5,-160,3.64,PETCO Park,15,5
2015-05-17,2015,BOS,SEA,0,5,124,1.5,-176,7.5,-120,100,-139,-1.5,156,3.35,T-Mobile Park,5,-5
2015-05-17,2015,CIN,SF,8,9,-102,1.5,-170,8.5,100,-120,-108,-1.5,150,4.29,Great American Ballpark,17,-1
2015-05-17,2015,DET,STL,1,2,139,1.5,-155,8.0,100,-120,-154,-1.5,135,3.35,Busch Stadium,3,-1
2015-05-17,2015,MIN,TB,3,11,115,1.5,-150,8.0,-120,100,-125,-1.5,130,3.72,Target Field,14,-8
2015-05-17,2015,CLE,TEX,1,5,-140,-1.5,114,9.5,-105,-115,125,1.5,-134,5.54,Rangers Ballpark,6,-4
2015-05-17,2015,HOU,TOR,4,2,-148,-1.5,140,8.0,-120,100,133,1.5,-160,4.77,Minute Maid Park,6,2
2015-05-17,2015,SD,WSH,5,10,117,1.5,-160,6.5,-120,100,-127,-1.5,140,3.0,PETCO Park,15,-5
2015-05-18,2015,MIA,ARI,2,3,-122,-1.5,160,8.0,-105,-115,112,1.5,-190,4.4,Marlins Park,5,-1
2015-05-18,2015,CWS,CLE,2,1,-150,-1.5,160,7.0,105,-125,135,1.5,-190,4.2,Guaranteed Rate Field,3,1
2015-05-18,2015,PHI,COL,4,3,-110,-1.5,145,9.0,-103,-117,100,1.5,-165,4.71,Coors Field,7,1
2015-05-18,2015,CLE,CWS,1,2,135,1.5,-190,7.0,105,-125,-150,-1.5,160,2.98,Guaranteed Rate Field,3,-1
2015-05-18,2015,MIL,DET,3,2,106,1.5,-195,9.0,-105,-115,-116,-1.5,166,4.37,Comerica Park,5,1
2015-05-18,2015,OAK,HOU,2,1,106,1.5,-205,8.5,100,-120,-116,-1.5,175,4.13,Minute Maid Park,3,1
2015-05-18,2015,TOR,LAA,10,6,-107,-1.5,170,9.5,-115,-105,-103,1.5,-200,4.91,Rogers Centre,16,4
2015-05-18,2015,ARI,MIA,3,2,112,1.5,-190,8.0,-105,-115,-122,-1.5,160,3.77,Marlins Park,5,1
2015-05-18,2015,DET,MIL,2,3,-116,-1.5,166,9.0,-105,-115,106,1.5,-195,4.83,Comerica Park,5,-1
2015-05-18,2015,STL,NYM,1,2,130,1.5,-200,6.0,-109,-111,-145,-1.5,170,2.61,Citi Field,3,-1
2015-05-18,2015,HOU,OAK,1,2,-116,-1.5,175,8.5,100,-120,106,1.5,-205,4.56,Minute Maid Park,3,-1
2015-05-18,2015,COL,PHI,3,4,100,1.5,-165,9.0,-103,-117,-110,-1.5,145,4.5,Coors Field,7,-1
2015-05-18,2015,NYM,STL,2,1,-145,-1.5,170,6.0,-109,-111,130,1.5,-200,3.55,Citi Field,3,1
2015-05-18,2015,LAA,TOR,6,10,-103,1.5,-200,9.5,-115,-105,-107,-1.5,170,4.82,Rogers Centre,16,-4
2015-05-19,2015,MIA,ARI,2,4,-134,-1.5,155,8.5,-110,-110,119,1.5,-175,4.87,Marlins Park,6,-2
2015-05-19,2015,TB,ATL,5,3,-106,-1.5,150,7.5,-110,-110,-104,1.5,-170,3.86,Turner Field,8,2
2015-05-19,2015,SEA,BAL,4,9,114,1.5,-195,8.5,-125,105,-124,-1.5,165,3.97,Camden Yards,13,-5
2015-05-19,2015,TEX,BOS,3,4,145,1.5,-140,9.0,-125,105,-160,-1.5,120,3.67,Fenway Park,7,-1
2015-05-19,2015,SD,CHC,4,3,-123,-1.5,190,6.5,-125,105,113,1.5,-230,3.59,PETCO Park,7,1
2015-05-19,2015,KC,CIN,3,0,-121,-1.5,180,6.5,-105,-115,111,1.5,-210,3.56,Kauffman Stadium,3,3
2015-05-19,2015,CWS,CLE,1,3,-146,-1.5,155,7.5,-102,-118,131,1.5,-175,4.45,Guaranteed Rate Field,4,-2
2015-05-19,2015,PHI,COL,5,6,106,1.5,-195,9.0,-110,-110,-116,-1.5,165,4.37,Coors Field,11,-1
2015-05-19,2015,CLE,CWS,3,1,131,1.5,-175,7.5,-102,-118,-146,-1.5,155,3.25,Guaranteed Rate Field,4,2
2015-05-19,2015,MIL,DET,8,1,144,1.5,-165,7.5,-115,-105,-159,-1.5,145,3.07,Comerica Park,9,7
2015-05-19,2015,OAK,HOU,4,6,-144,-1.5,110,8.5,-105,-115,129,1.5,-130,5.02,Minute Maid Park,10,-2
2015-05-19,2015,CIN,KC,0,3,111,1.5,-210,6.5,-105,-115,-121,-1.5,180,3.08,Kauffman Stadium,3,-3
2015-05-19,2015,TOR,LAA,2,3,-120,-1.5,155,10.0,-110,-110,110,1.5,-175,5.45,Rogers Centre,5,-1
2015-05-19,2015,SF,LAD,2,0,109,1.5,-160,7.0,-115,-105,-119,-1.5,140,3.35,AT&T Park,2,2
2015-05-19,2015,ARI,MIA,4,2,119,1.5,-175,8.5,-110,-110,-134,-1.5,155,3.88,Marlins Park,6,2
2015-05-19,2015,DET,MIL,1,8,-159,-1.5,145,7.5,-115,-105,144,1.5,-165,4.6,Comerica Park,9,-7
2015-05-19,2015,PIT,MIN,5,8,-163,-1.5,135,7.5,-105,-115,148,1.5,-155,4.65,PNC Park,13,-3
2015-05-19,2015,STL,NYM,10,2,-122,-1.5,145,7.5,-105,-115,112,1.5,-165,4.12,Citi Field,12,8
2015-05-19,2015,WSH,NYY,8,6,-128,-1.5,160,7.5,-116,-104,118,1.5,-190,4.21,Nationals Park,14,2
2015-05-19,2015,HOU,OAK,6,4,129,1.5,-130,8.5,-105,-115,-144,-1.5,110,3.71,Minute Maid Park,10,2
2015-05-19,2015,COL,PHI,6,5,-116,-1.5,165,9.0,-110,-110,106,1.5,-195,4.83,Coors Field,11,1
2015-05-19,2015,MIN,PIT,8,5,148,1.5,-155,7.5,-105,-115,-163,-1.5,135,3.02,PNC Park,13,3
2015-05-19,2015,CHC,SD,3,4,113,1.5,-230,6.5,-125,105,-123,-1.5,190,3.05,PETCO Park,7,-1
2015-05-19,2015,BAL,SEA,9,4,-124,-1.5,165,8.5,-125,105,114,1.5,-195,4.71,Camden Yards,13,5
2015-05-19,2015,LAD,SF,0,2,-119,-1.5,140,7.0,-115,-105,109,1.5,-160,3.8,AT&T Park,2,-2
2015-05-19,2015,NYM,STL,2,10,112,1.5,-165,7.5,-105,-115,-122,-1.5,145,3.54,Citi Field,12,-8
2015-05-19,2015,ATL,TB,3,5,-104,1.5,-170,7.5,-110,-110,-106,-1.5,150,3.82,Turner Field,8,-2
2015-05-19,2015,BOS,TEX,4,3,-160,-1.5,120,9.0,-125,105,145,1.5,-140,5.54,Fenway Park,7,1
2015-05-19,2015,LAA,TOR,3,2,110,1.5,-175,10.0,-110,-110,-120,-1.5,155,4.76,Rogers Centre,5,1
2015-05-19,2015,NYY,WSH,6,8,118,1.5,-190,7.5,-116,-104,-128,-1.5,160,3.44,Nationals Park,14,-2
2015-05-20,2015,MIA,ARI,1,6,-130,-1.5,170,7.5,100,-120,115,1.5,-200,4.24,Marlins Park,7,-5
2015-05-20,2015,TB,ATL,1,2,-130,-1.5,120,7.5,110,-130,115,1.5,-140,4.24,Turner Field,3,-1
2015-05-20,2015,SEA,BAL,4,2,125,1.5,-165,8.0,-105,-115,-140,-1.5,145,3.56,Camden Yards,6,2
2015-05-20,2015,TEX,BOS,2,1,150,1.5,-140,9.0,-105,-115,-170,-1.5,120,3.6,Fenway Park,3,1
2015-05-20,2015,SD,CHC,2,3,-141,-1.5,160,7.0,110,-130,126,1.5,-190,4.1,PETCO Park,5,-1
2015-05-20,2015,KC,CIN,7,1,-158,-1.5,140,7.5,-105,-115,143,1.5,-160,4.59,Kauffman Stadium,8,6
2015-05-20,2015,CWS,CLE,3,4,-161,-1.5,130,8.5,-115,-105,146,1.5,-150,5.24,Guaranteed Rate Field,7,-1
2015-05-20,2015,PHI,COL,4,2,119,1.5,-170,10.0,100,-120,-134,-1.5,150,4.57,Coors Field,6,2
2015-05-20,2015,CLE,CWS,4,3,146,1.5,-150,8.5,-115,-105,-161,-1.5,130,3.46,Guaranteed Rate Field,7,1
2015-05-20,2015,MIL,DET,2,5,126,1.5,-170,7.5,-120,100,-141,-1.5,150,3.32,Comerica Park,7,-3
2015-05-20,2015,OAK,HOU,1,6,136,1.5,-160,7.0,-125,105,-151,-1.5,140,2.97,Minute Maid Park,7,-5
2015-05-20,2015,CIN,KC,1,7,143,1.5,-160,7.5,-105,-115,-158,-1.5,140,3.09,Kauffman Stadium,8,-6
2015-05-20,2015,TOR,LAA,3,4,-128,-1.5,160,9.0,-110,-110,118,1.5,-190,5.05,Rogers Centre,7,-1
2015-05-20,2015,SF,LAD,4,0,125,1.5,-150,7.0,-108,-112,-140,-1.5,130,3.11,AT&T Park,4,4
2015-05-20,2015,ARI,MIA,6,1,115,1.5,-200,7.5,100,-120,-130,-1.5,170,3.49,Marlins Park,7,5
2015-05-20,2015,DET,MIL,5,2,-141,-1.5,150,7.5,-120,100,126,1.5,-170,4.39,Comerica Park,7,3
2015-05-20,2015,PIT,MIN,3,4,-141,-1.5,155,7.5,-110,-110,126,1.5,-175,4.39,PNC Park,7,-1
2015-05-20,2015,STL,NYM,9,0,-127,-1.5,130,7.0,110,-130,117,1.5,-150,3.92,Citi Field,9,9
2015-05-20,2015,WSH,NYY,3,2,-155,-1.5,156,7.0,-129,109,140,1.5,-176,4.25,Nationals Park,5,1
2015-05-20,2015,HOU,OAK,6,1,-151,-1.5,140,7.0,-125,105,136,1.5,-160,4.21,Minute Maid Park,7,5
2015-05-20,2015,COL,PHI,2,4,-134,-1.5,150,10.0,100,-120,119,1.5,-170,5.73,Coors Field,6,-2
2015-05-20,2015,MIN,PIT,4,3,126,1.5,-175,7.5,-110,-110,-141,-1.5,155,3.32,PNC Park,7,1
2015-05-20,2015,CHC,SD,3,2,126,1.5,-190,7.0,110,-130,-141,-1.5,160,3.1,PETCO Park,5,1
2015-05-20,2015,BAL,SEA,2,4,-140,-1.5,145,8.0,-105,-115,125,1.5,-165,4.67,Camden Yards,6,-2
2015-05-20,2015,LAD,SF,0,4,-140,-1.5,130,7.0,-108,-112,125,1.5,-150,4.08,AT&T Park,4,-4
2015-05-20,2015,NYM,STL,0,9,117,1.5,-150,7.0,110,-130,-127,-1.5,130,3.23,Citi Field,9,-9
2015-05-20,2015,ATL,TB,2,1,115,1.5,-140,7.5,110,-130,-130,-1.5,120,3.49,Turner Field,3,1
2015-05-20,2015,BOS,TEX,1,2,-170,-1.5,120,9.0,-105,-115,150,1.5,-140,5.67,Fenway Park,3,-1
2015-05-20,2015,LAA,TOR,4,3,118,1.5,-190,9.0,-110,-110,-128,-1.5,160,4.13,Rogers Centre,7,1
2015-05-20,2015,NYY,WSH,2,3,140,1.5,-176,7.0,-129,109,-155,-1.5,156,2.92,Nationals Park,5,-1
2015-05-21,2015,MIA,ARI,6,7,-142,-1.5,160,7.5,-105,-115,127,1.5,-180,4.4,Marlins Park,13,-1
2015-05-21,2015,MIL,ATL,1,10,110,1.5,-210,7.0,-120,100,-120,-1.5,180,3.33,Turner Field,11,-9
2015-05-21,2015,SEA,BAL,4,5,-103,1.5,-210,8.5,-110,-110,-107,-1.5,180,4.31,Camden Yards,9,-1
2015-05-21,2015,TEX,BOS,3,1,170,1.5,-130,9.0,105,-125,-190,-1.5,110,3.33,Fenway Park,4,2
2015-05-21,2015,SD,CHC,0,3,104,1.5,-165,7.0,-110,-110,-114,-1.5,145,3.43,PETCO Park,3,-3
2015-05-21,2015,CWS,CLE,2,5,116,1.5,-150,8.5,107,-127,-126,-1.5,130,3.94,Guaranteed Rate Field,7,-3
2015-05-21,2015,PHI,COL,3,7,150,1.5,-135,9.0,-121,101,-170,-1.5,115,3.6,Coors Field,10,-4
2015-05-21,2015,CLE,CWS,5,2,-126,-1.5,130,8.5,107,-127,116,1.5,-150,4.74,Guaranteed Rate Field,7,3
2015-05-21,2015,HOU,DET,5,6,138,1.5,-155,8.0,-105,-115,-153,-1.5,135,3.36,Comerica Park,11,-1
2015-05-21,2015,DET,HOU,6,5,-153,-1.5,135,8.0,-105,-115,138,1.5,-155,4.84,Comerica Park,11,1
2015-05-21,2015,TOR,LAA,8,4,102,1.5,-165,9.0,105,-125,-112,-1.5,145,4.46,Rogers Centre,12,4
2015-05-21,2015,SF,LAD,4,0,115,1.5,-160,5.5,-117,-103,-130,-1.5,140,2.56,AT&T Park,4,4
2015-05-21,2015,ARI,MIA,7,6,127,1.5,-180,7.5,-105,-115,-142,-1.5,160,3.3,Marlins Park,13,1
2015-05-21,2015,ATL,MIL,10,1,-120,-1.5,180,7.0,-120,100,110,1.5,-210,3.82,Turner Field,11,9
2015-05-21,2015,STL,NYM,0,5,-103,1.5,-230,7.0,105,-125,-107,-1.5,190,3.55,Citi Field,5,-5
2015-05-21,2015,TB,OAK,3,0,100,1.5,-180,7.0,-113,-107,-110,-1.5,160,3.5,Tropicana Field,3,3
2015-05-21,2015,COL,PHI,7,3,-170,-1.5,115,9.0,-121,101,150,1.5,-135,5.67,Coors Field,10,4
2015-05-21,2015,CHC,SD,3,0,-114,-1.5,145,7.0,-110,-110,104,1.5,-165,3.73,PETCO Park,3,3
2015-05-21,2015,BAL,SEA,5,4,-107,-1.5,180,8.5,-110,-110,-103,1.5,-210,4.39,Camden Yards,9,1
2015-05-21,2015,LAD,SF,0,4,-130,-1.5,140,5.5,-117,-103,115,1.5,-160,3.11,AT&T Park,4,-4
2015-05-21,2015,NYM,STL,5,0,-107,-1.5,190,7.0,105,-125,-103,1.5,-230,3.62,Citi Field,5,5
2015-05-21,2015,OAK,TB,0,3,-110,-1.5,160,7.0,-113,-107,100,1.5,-180,3.67,Tropicana Field,3,-3
2015-05-21,2015,BOS,TEX,1,3,-190,-1.5,110,9.0,105,-125,170,1.5,-130,5.9,Fenway Park,4,-2
2015-05-21,2015,LAA,TOR,4,8,-112,-1.5,145,9.0,105,-125,102,1.5,-165,4.75,Rogers Centre,12,-4
2015-05-22,2015,CHC,ARI,4,5,-118,-1.5,135,8.5,-110,-110,108,1.5,-155,4.6,Chase Field,9,-1
2015-05-22,2015,MIL,ATL,11,0,-126,-1.5,130,7.5,-105,-115,116,1.5,-150,4.18,Turner Field,11,11
2015-05-22,2015,MIA,BAL,5,8,-104,1.5,-170,7.5,100,-120,-106,-1.5,150,3.82,Marlins Park,13,-3
2015-05-22,2015,LAA,BOS,12,5,105,1.5,-205,8.5,-120,100,-115,-1.5,175,4.15,Fenway Park,17,7
2015-05-22,2015,ARI,CHC,5,4,108,1.5,-155,8.5,-110,-110,-118,-1.5,135,4.09,Chase Field,9,1
2015-05-22,2015,CLE,CIN,7,3,-171,-1.5,130,7.0,100,-120,151,1.5,-150,4.42,Progressive Field,10,4
2015-05-22,2015,CIN,CLE,3,7,151,1.5,-150,7.0,100,-120,-171,-1.5,130,2.79,Progressive Field,10,-4
2015-05-22,2015,SF,COL,11,8,-109,-1.5,145,10.0,-120,100,-101,1.5,-165,5.22,Coors Field,19,3
2015-05-22,2015,MIN,CWS,2,3,119,1.5,-190,8.0,105,-125,-134,-1.5,160,3.65,Guaranteed Rate Field,5,-1
2015-05-22,2015,HOU,DET,2,6,-111,-1.5,150,8.0,100,-120,101,1.5,-170,4.21,Comerica Park,8,-4
2015-05-22,2015,DET,HOU,6,2,101,1.5,-170,8.0,100,-120,-111,-1.5,150,3.98,Comerica Park,8,4
2015-05-22,2015,STL,KC,0,5,-101,1.5,-230,7.0,100,-120,-109,-1.5,190,3.52,Kauffman Stadium,5,-5
2015-05-22,2015,BOS,LAA,5,12,-115,-1.5,175,8.5,-120,100,105,1.5,-205,4.55,Fenway Park,17,-7
2015-05-22,2015,SD,LAD,1,2,170,1.5,-135,6.5,100,-120,-200,-1.5,115,2.41,Dodger Stadium,3,-1
2015-05-22,2015,BAL,MIA,8,5,-106,-1.5,150,7.5,100,-120,-104,1.5,-170,3.86,Marlins Park,13,3
2015-05-22,2015,ATL,MIL,0,11,116,1.5,-150,7.5,-105,-115,-126,-1.5,130,3.47,Turner Field,11,-11
2015-05-22,2015,CWS,MIN,3,2,-134,-1.5,160,8.0,105,-125,119,1.5,-190,4.58,Guaranteed Rate Field,5,1
2015-05-22,2015,PIT,NYM,4,1,-171,-1.5,145,6.5,-120,100,151,1.5,-165,4.1,PNC Park,5,3
2015-05-22,2015,TEX,NYY,10,9,170,1.5,-135,7.5,-115,-105,-190,-1.5,115,2.78,Yankee Stadium,19,1
2015-05-22,2015,TB,OAK,5,2,-134,-1.5,170,6.5,-110,-110,119,1.5,-200,3.72,Tropicana Field,7,3
2015-05-22,2015,WSH,PHI,2,1,-290,-1.5,-130,7.0,-125,105,250,1.5,110,5.21,Nationals Park,3,1
2015-05-22,2015,NYM,PIT,1,4,151,1.5,-165,6.5,-120,100,-171,-1.5,145,2.59,PNC Park,5,-3
2015-05-22,2015,LAD,SD,2,1,-200,-1.5,115,6.5,100,-120,170,1.5,-135,4.33,Dodger Stadium,3,1
2015-05-22,2015,TOR,SEA,3,4,140,1.5,-125,8.0,-120,100,-155,-1.5,105,3.33,Rogers Centre,7,-1
2015-05-22,2015,COL,SF,8,11,-101,1.5,-165,10.0,-120,100,-109,-1.5,145,5.02,Coors Field,19,-3
2015-05-22,2015,KC,STL,5,0,-109,-1.5,190,7.0,100,-120,-101,1.5,-230,3.65,Kauffman Stadium,5,5
2015-05-22,2015,OAK,TB,2,5,119,1.5,-200,6.5,-110,-110,-134,-1.5,170,2.97,Tropicana Field,7,-3
2015-05-22,2015,NYY,TEX,9,10,-190,-1.5,115,7.5,-115,-105,170,1.5,-135,4.91,Yankee Stadium,19,-1
2015-05-22,2015,SEA,TOR,4,3,-155,-1.5,105,8.0,-120,100,140,1.5,-125,4.86,Rogers Centre,7,1
2015-05-22,2015,PHI,WSH,1,2,250,1.5,110,7.0,-125,105,-290,-1.5,-130,2.0,Nationals Park,3,-1
2015-05-23,2015,CHC,ARI,9,6,-126,-1.5,130,8.0,-101,-119,116,1.5,-150,4.46,Chase Field,15,3
2015-05-23,2015,MIL,ATL,2,3,-114,-1.5,150,7.0,-110,-110,104,1.5,-170,3.73,Turner Field,5,-1
2015-05-23,2015,MIA,BAL,1,0,-103,1.5,-170,7.5,105,-125,-107,-1.5,150,3.81,Marlins Park,1,1
2015-05-23,2015,LAA,BOS,3,8,-103,1.5,-205,9.0,-127,107,-107,-1.5,175,4.57,Fenway Park,11,-5
2015-05-23,2015,ARI,CHC,6,9,116,1.5,-150,8.0,-101,-119,-126,-1.5,130,3.7,Chase Field,15,-3
2015-05-23,2015,CLE,CIN,2,1,-247,-1.5,-110,7.0,105,-125,207,1.5,-110,4.98,Progressive Field,3,1
2015-05-23,2015,CIN,CLE,1,2,207,1.5,-110,7.0,105,-125,-247,-1.5,-110,2.28,Progressive Field,3,-1
2015-05-23,2015,SF,COL,10,8,105,1.5,-190,10.0,-110,-110,-115,-1.5,160,4.88,Coors Field,18,2
2015-05-23,2015,SF,COL,3,5,-119,-1.5,130,10.0,-110,-110,109,1.5,-150,5.43,Coors Field,8,-2
2015-05-23,2015,MIN,CWS,4,3,152,1.5,-150,7.5,-115,-105,-172,-1.5,130,2.98,Guaranteed Rate Field,7,1
2015-05-23,2015,HOU,DET,3,2,100,1.5,-210,8.5,-105,-115,-110,-1.5,180,4.25,Comerica Park,5,1
2015-05-23,2015,DET,HOU,2,3,-110,-1.5,180,8.5,-105,-115,100,1.5,-210,4.45,Comerica Park,5,-1
2015-05-23,2015,STL,KC,2,3,114,1.5,-200,7.0,-110,-110,-124,-1.5,170,3.27,Kauffman Stadium,5,-1
2015-05-23,2015,BOS,LAA,8,3,-107,-1.5,175,9.0,-127,107,-103,1.5,-205,4.65,Fenway Park,11,5
2015-05-23,2015,SD,LAD,0,2,142,1.5,-160,7.0,-110,-110,-157,-1.5,140,2.89,Dodger Stadium,2,-2
2015-05-23,2015,BAL,MIA,0,1,-107,-1.5,150,7.5,105,-125,-103,1.5,-170,3.88,Marlins Park,1,-1
2015-05-23,2015,ATL,MIL,3,2,104,1.5,-170,7.0,-110,-110,-114,-1.5,150,3.43,Turner Field,5,1
2015-05-23,2015,CWS,MIN,3,4,-172,-1.5,130,7.5,-115,-105,152,1.5,-150,4.74,Guaranteed Rate Field,7,-1
2015-05-23,2015,PIT,NYM,8,2,-118,-1.5,190,6.5,-125,105,108,1.5,-230,3.52,PNC Park,10,6
2015-05-23,2015,TEX,NYY,15,4,152,1.5,-150,8.0,100,-120,-167,-1.5,130,3.17,Yankee Stadium,19,11
2015-05-23,2015,TB,OAK,0,5,-171,-1.5,130,7.0,-125,105,151,1.5,-150,4.42,Tropicana Field,5,-5
2015-05-23,2015,WSH,PHI,1,8,-140,-1.5,160,6.5,-115,-105,125,1.5,-190,3.79,Nationals Park,9,-7
2015-05-23,2015,NYM,PIT,2,8,108,1.5,-230,6.5,-125,105,-118,-1.5,190,3.13,PNC Park,10,-6
2015-05-23,2015,LAD,SD,2,0,-157,-1.5,140,7.0,-110,-110,142,1.5,-160,4.28,Dodger Stadium,2,2
2015-05-23,2015,TOR,SEA,2,3,-147,-1.5,152,8.5,-110,-110,132,1.5,-172,5.06,Rogers Centre,5,-1
2015-05-23,2015,COL,SF,8,10,-115,-1.5,160,10.0,-110,-110,105,1.5,-190,5.35,Coors Field,18,-2
2015-05-23,2015,COL,SF,5,3,109,1.5,-150,10.0,-110,-110,-119,-1.5,130,4.78,Coors Field,8,2
2015-05-23,2015,KC,STL,3,2,-124,-1.5,170,7.0,-110,-110,114,1.5,-200,3.88,Kauffman Stadium,5,1
2015-05-23,2015,OAK,TB,5,0,151,1.5,-150,7.0,-125,105,-171,-1.5,130,2.79,Tropicana Field,5,5
2015-05-23,2015,NYY,TEX,4,15,-167,-1.5,130,8.0,100,-120,152,1.5,-150,5.0,Yankee Stadium,19,-11
2015-05-23,2015,SEA,TOR,3,2,132,1.5,-172,8.5,-110,-110,-147,-1.5,152,3.66,Rogers Centre,5,1
2015-05-23,2015,PHI,WSH,8,1,125,1.5,-190,6.5,-115,-105,-140,-1.5,160,2.89,Nationals Park,9,7
2015-05-24,2015,CHC,ARI,3,4,-131,-1.5,130,8.5,-119,-101,116,1.5,-150,4.82,Chase Field,7,-1
2015-05-24,2015,MIL,ATL,1,2,-105,1.5,-230,7.0,-126,106,-105,-1.5,190,3.59,Turner Field,3,-1
2015-05-24,2015,MIA,BAL,5,2,-107,-1.5,185,7.0,-120,100,-103,1.5,-215,3.62,Marlins Park,7,3
2015-05-24,2015,LAA,BOS,1,6,119,1.5,-170,9.5,-120,100,-134,-1.5,150,4.34,Fenway Park,7,-5
2015-05-24,2015,ARI,CHC,4,3,116,1.5,-150,8.5,-119,-101,-131,-1.5,130,3.94,Chase Field,7,1
2015-05-24,2015,CLE,CIN,5,2,-181,-1.5,115,8.5,-125,105,161,1.5,-135,5.48,Progressive Field,7,3
2015-05-24,2015,CIN,CLE,2,5,161,1.5,-135,8.5,-125,105,-181,-1.5,115,3.26,Progressive Field,7,-3
2015-05-24,2015,SF,COL,2,11,-127,-1.5,125,10.5,100,-120,117,1.5,-145,5.87,Coors Field,13,-9
2015-05-24,2015,MIN,CWS,8,1,126,1.5,-165,8.0,-115,-105,-141,-1.5,145,3.54,Guaranteed Rate Field,9,7
2015-05-24,2015,HOU,DET,10,8,140,1.5,-160,8.5,-104,-116,-155,-1.5,140,3.54,Comerica Park,18,2
2015-05-24,2015,DET,HOU,8,10,-155,-1.5,140,8.5,-104,-116,140,1.5,-160,5.17,Comerica Park,18,-2
2015-05-24,2015,STL,KC,6,1,115,1.5,-200,7.0,-120,100,-130,-1.5,170,3.26,Kauffman Stadium,7,5
2015-05-24,2015,BOS,LAA,6,1,-134,-1.5,150,9.5,-120,100,119,1.5,-170,5.44,Fenway Park,7,5
2015-05-24,2015,SD,LAD,11,3,113,1.5,-230,7.0,-105,-115,-123,-1.5,190,3.29,Dodger Stadium,14,8
2015-05-24,2015,BAL,MIA,2,5,-103,1.5,-215,7.0,-120,100,-107,-1.5,185,3.55,Marlins Park,7,-3
2015-05-24,2015,ATL,MIL,2,1,-105,-1.5,190,7.0,-126,106,-105,1.5,-230,3.59,Turner Field,3,1
2015-05-24,2015,CWS,MIN,1,8,-141,-1.5,145,8.0,-115,-105,126,1.5,-165,4.68,Guaranteed Rate Field,9,-7
2015-05-24,2015,PIT,NYM,9,1,-191,-1.5,120,7.5,-105,-115,171,1.5,-140,4.92,PNC Park,10,8
2015-05-24,2015,TEX,NYY,5,2,152,1.5,-145,8.5,-110,-110,-172,-1.5,125,3.37,Yankee Stadium,7,3
2015-05-24,2015,TB,OAK,2,7,109,1.5,-165,6.5,-113,-107,-119,-1.5,145,3.11,Tropicana Field,9,-5
2015-05-24,2015,WSH,PHI,4,1,-176,-1.5,135,7.0,-110,-110,156,1.5,-155,4.46,Nationals Park,5,3
2015-05-24,2015,NYM,PIT,1,9,171,1.5,-140,7.5,-105,-115,-191,-1.5,120,2.77,PNC Park,10,-8
2015-05-24,2015,LAD,SD,3,11,-123,-1.5,190,7.0,-105,-115,113,1.5,-230,3.86,Dodger Stadium,14,-8
2015-05-24,2015,TOR,SEA,8,2,-105,1.5,-165,9.5,-101,-119,-105,-1.5,145,4.87,Rogers Centre,10,6
2015-05-24,2015,COL,SF,11,2,117,1.5,-145,10.5,100,-120,-127,-1.5,125,4.84,Coors Field,13,9
2015-05-24,2015,KC,STL,1,6,-130,-1.5,170,7.0,-120,100,115,1.5,-200,3.96,Kauffman Stadium,7,-5
2015-05-24,2015,OAK,TB,7,2,-119,-1.5,145,6.5,-113,-107,109,1.5,-165,3.53,Tropicana Field,9,5
2015-05-24,2015,NYY,TEX,2,5,-172,-1.5,125,8.5,-110,-110,152,1.5,-145,5.38,Yankee Stadium,7,-3
2015-05-24,2015,SEA,TOR,2,8,-105,-1.5,145,9.5,-101,-119,-105,1.5,-165,4.87,Rogers Centre,10,-6
2015-05-24,2015,PHI,WSH,1,4,156,1.5,-155,7.0,-110,-110,-176,-1.5,135,2.73,Nationals Park,5,-3
2015-05-25,2015,STL,ARI,3,2,-161,-1.5,135,7.5,-120,100,146,1.5,-155,4.63,Busch Stadium,5,1
2015-05-25,2015,LAD,ATL,6,3,-205,-1.5,110,7.0,-110,-110,175,1.5,-130,4.7,Dodger Stadium,9,3
2015-05-25,2015,HOU,BAL,3,4,-108,-1.5,150,8.0,-110,-110,-102,1.5,-170,4.15,Camden Yards,7,-1
2015-05-25,2015,MIN,BOS,7,2,105,1.5,-160,9.0,-110,-110,-115,-1.5,140,4.39,Target Field,9,5
2015-05-25,2015,WSH,CHC,2,1,102,1.5,-200,11.0,-107,-113,-112,-1.5,170,5.45,Wrigley Field,3,1
2015-05-25,2015,COL,CIN,5,4,130,1.5,-165,8.5,-107,-113,-145,-1.5,145,3.7,Great American Ballpark,9,1
2015-05-25,2015,TEX,CLE,10,8,126,1.5,-170,9.0,-120,100,-141,-1.5,150,3.98,Progressive Field,18,2
2015-05-25,2015,CIN,COL,4,5,-145,-1.5,145,8.5,-107,-113,130,1.5,-165,5.03,Great American Ballpark,9,-1
2015-05-25,2015,TOR,CWS,6,0,-161,-1.5,130,8.5,-115,-105,146,1.5,-150,5.24,Rogers Centre,6,6
2015-05-25,2015,OAK,DET,4,0,-130,-1.5,160,7.0,-125,105,115,1.5,-190,3.96,Oakland Coliseum,4,4
2015-05-25,2015,BAL,HOU,4,3,-102,1.5,-170,8.0,-110,-110,-108,-1.5,150,4.04,Camden Yards,7,1
2015-05-25,2015,NYY,KC,14,1,-120,-1.5,175,8.5,-115,-105,110,1.5,-205,4.64,Yankee Stadium,15,13
2015-05-25,2015,SD,LAA,3,4,116,1.5,-200,7.5,105,-125,-126,-1.5,170,3.47,Angel Stadium,7,-1
2015-05-25,2015,ATL,LAD,3,6,175,1.5,-130,7.0,-110,-110,-205,-1.5,110,2.55,Dodger Stadium,9,-3
2015-05-25,2015,PIT,MIA,4,2,-129,-1.5,165,7.5,-115,-105,119,1.5,-195,4.22,PNC Park,6,2
2015-05-25,2015,SF,MIL,8,4,115,1.5,-200,8.5,-115,-105,-125,-1.5,170,3.95,Miller Park,12,4
2015-05-25,2015,BOS,MIN,2,7,-115,-1.5,140,9.0,-110,-110,105,1.5,-160,4.81,Target Field,9,-5
2015-05-25,2015,PHI,NYM,3,6,145,1.5,-170,7.5,-105,-115,-160,-1.5,150,3.06,Citi Field,9,-3
2015-05-25,2015,KC,NYY,1,14,110,1.5,-205,8.5,-115,-105,-120,-1.5,175,4.05,Yankee Stadium,15,-13
2015-05-25,2015,DET,OAK,0,4,115,1.5,-190,7.0,-125,105,-130,-1.5,160,3.26,Oakland Coliseum,4,-4
2015-05-25,2015,NYM,PHI,6,3,-160,-1.5,150,7.5,-105,-115,145,1.5,-170,4.62,Citi Field,9,3
2015-05-25,2015,MIA,PIT,2,4,119,1.5,-195,7.5,-115,-105,-129,-1.5,165,3.42,PNC Park,6,-2
2015-05-25,2015,LAA,SD,4,3,-126,-1.5,170,7.5,105,-125,116,1.5,-200,4.18,Angel Stadium,7,1
2015-05-25,2015,TB,SEA,1,4,-144,-1.5,160,7.0,110,-130,129,1.5,-190,4.13,Tropicana Field,5,-3
2015-05-25,2015,MIL,SF,4,8,-125,-1.5,170,8.5,-115,-105,115,1.5,-200,4.72,Miller Park,12,-4
2015-05-25,2015,ARI,STL,2,3,146,1.5,-155,7.5,-120,100,-161,-1.5,135,3.05,Busch Stadium,5,-1
2015-05-25,2015,SEA,TB,4,1,129,1.5,-190,7.0,110,-130,-144,-1.5,160,3.06,Tropicana Field,5,3
2015-05-25,2015,CLE,TEX,8,10,-141,-1.5,150,9.0,-120,100,126,1.5,-170,5.27,Progressive Field,18,-2
2015-05-25,2015,CWS,TOR,0,6,146,1.5,-150,8.5,-115,-105,-161,-1.5,130,3.46,Rogers Centre,6,-6
2015-05-25,2015,CHC,WSH,1,2,-112,-1.5,170,11.0,-107,-113,102,1.5,-200,5.81,Wrigley Field,3,-1
2015-05-26,2015,STL,ARI,6,4,-170,-1.5,135,8.0,-105,-115,150,1.5,-155,5.04,Busch Stadium,10,2
2015-05-26,2015,LAD,ATL,8,0,-270,-1.5,-105,6.0,-105,-115,230,1.5,-115,4.38,Dodger Stadium,8,8
2015-05-26,2015,HOU,BAL,4,1,108,1.5,-190,8.5,-110,-110,-118,-1.5,160,4.09,Camden Yards,5,3
2015-05-26,2015,MIN,BOS,2,1,129,1.5,-131,8.5,-120,100,-144,-1.5,111,3.71,Target Field,3,1
2015-05-26,2015,WSH,CHC,2,3,100,1.5,-196,10.0,-120,100,-110,-1.5,166,5.0,Wrigley Field,5,-1
2015-05-26,2015,COL,CIN,1,2,128,1.5,-170,8.0,-120,100,-143,-1.5,150,3.51,Great American Ballpark,3,-1
2015-05-26,2015,TEX,CLE,4,3,142,1.5,-145,8.5,-120,100,-157,-1.5,125,3.51,Progressive Field,7,1
2015-05-26,2015,CIN,COL,2,1,-143,-1.5,150,8.0,-120,100,128,1.5,-170,4.71,Great American Ballpark,3,1
2015-05-26,2015,TOR,CWS,10,9,-156,-1.5,125,9.0,-110,-110,141,1.5,-145,5.48,Rogers Centre,19,1
2015-05-26,2015,OAK,DET,0,1,101,1.5,-170,6.5,-110,-110,-111,-1.5,150,3.23,Oakland Coliseum,1,-1
2015-05-26,2015,BAL,HOU,1,4,-118,-1.5,160,8.5,-110,-110,108,1.5,-190,4.6,Camden Yards,5,-3
2015-05-26,2015,NYY,KC,5,1,-101,1.5,-170,8.5,-105,-115,-109,-1.5,150,4.27,Yankee Stadium,6,4
2015-05-26,2015,SD,LAA,4,0,150,1.5,-145,8.5,100,-120,-170,-1.5,125,3.4,Angel Stadium,4,4
2015-05-26,2015,ATL,LAD,0,8,230,1.5,-115,6.0,-105,-115,-270,-1.5,-105,1.82,Dodger Stadium,8,-8
2015-05-26,2015,PIT,MIA,5,1,-144,-1.5,160,8.0,-110,-110,129,1.5,-190,4.72,PNC Park,6,4
2015-05-26,2015,SF,MIL,6,3,-128,-1.5,125,8.0,-105,-115,118,1.5,-145,4.49,Miller Park,9,3
2015-05-26,2015,BOS,MIN,1,2,-144,-1.5,111,8.5,-120,100,129,1.5,-131,5.02,Target Field,3,-1
2015-05-26,2015,PHI,NYM,4,5,164,1.5,-140,7.0,-115,-105,-184,-1.5,120,2.65,Citi Field,9,-1
2015-05-26,2015,KC,NYY,1,5,-109,-1.5,150,8.5,-105,-115,-101,1.5,-170,4.43,Yankee Stadium,6,-4
2015-05-26,2015,DET,OAK,1,0,-111,-1.5,150,6.5,-110,-110,101,1.5,-170,3.42,Oakland Coliseum,1,1
2015-05-26,2015,NYM,PHI,5,4,-184,-1.5,120,7.0,-115,-105,164,1.5,-140,4.54,Citi Field,9,1
2015-05-26,2015,MIA,PIT,1,5,129,1.5,-190,8.0,-110,-110,-144,-1.5,160,3.49,PNC Park,6,-4
2015-05-26,2015,LAA,SD,0,4,-170,-1.5,125,8.5,100,-120,150,1.5,-145,5.35,Angel Stadium,4,-4
2015-05-26,2015,TB,SEA,6,7,-112,-1.5,180,7.0,-110,-110,102,1.5,-210,3.7,Tropicana Field,13,-1
2015-05-26,2015,MIL,SF,3,6,118,1.5,-145,8.0,-105,-115,-128,-1.5,125,3.67,Miller Park,9,-3
2015-05-26,2015,ARI,STL,4,6,150,1.5,-155,8.0,-105,-115,-170,-1.5,135,3.2,Busch Stadium,10,-2
2015-05-26,2015,SEA,TB,7,6,102,1.5,-210,7.0,-110,-110,-112,-1.5,180,3.47,Tropicana Field,13,1
2015-05-26,2015,CLE,TEX,3,4,-157,-1.5,125,8.5,-120,100,142,1.5,-145,5.19,Progressive Field,7,-1
2015-05-26,2015,CWS,TOR,9,10,141,1.5,-145,9.0,-110,-110,-156,-1.5,125,3.73,Rogers Centre,19,-1
2015-05-26,2015,CHC,WSH,3,2,-110,-1.5,166,10.0,-120,100,100,1.5,-196,5.24,Wrigley Field,5,1
2015-05-27,2015,STL,ARI,4,3,-190,-1.5,120,7.0,-115,-105,170,1.5,-140,4.59,Busch Stadium,7,1
2015-05-27,2015,LAD,ATL,2,3,-177,-1.5,130,6.5,105,-125,157,1.5,-150,4.15,Dodger Stadium,5,-1
2015-05-27,2015,HOU,BAL,4,5,109,1.5,-200,7.5,-120,100,-119,-1.5,170,3.59,Camden Yards,9,-1
2015-05-27,2015,MIN,BOS,6,4,105,1.5,-160,9.0,104,-124,-115,-1.5,140,4.39,Target Field,10,2
2015-05-27,2015,WSH,CHC,3,0,-123,-1.5,135,6.5,-120,100,113,1.5,-155,3.59,Wrigley Field,3,3
2015-05-27,2015,COL,CIN,6,4,140,1.5,-160,8.0,-121,101,-155,-1.5,140,3.33,Great American Ballpark,10,2
2015-05-27,2015,TEX,CLE,3,12,137,1.5,-155,8.5,-106,-114,-152,-1.5,135,3.59,Progressive Field,15,-9
2015-05-27,2015,CIN,COL,4,6,-155,-1.5,140,8.0,-121,101,140,1.5,-160,4.86,Great American Ballpark,10,-2
2015-05-27,2015,TOR,CWS,3,5,-126,-1.5,165,9.0,100,-120,116,1.5,-195,5.02,Rogers Centre,8,-2
2015-05-27,2015,OAK,DET,2,3,-140,-1.5,155,7.5,-109,-111,125,1.5,-175,4.38,Oakland Coliseum,5,-1
2015-05-27,2015,BAL,HOU,5,4,-119,-1.5,170,7.5,-120,100,109,1.5,-200,4.08,Camden Yards,9,1
2015-05-27,2015,NYY,KC,4,2,-134,-1.5,155,7.5,-120,100,119,1.5,-175,4.29,Yankee Stadium,6,2
2015-05-27,2015,SD,LAA,5,4,148,1.5,-160,7.0,105,-125,-163,-1.5,140,2.82,Angel Stadium,9,1
2015-05-27,2015,ATL,LAD,3,2,157,1.5,-150,6.5,105,-125,-177,-1.5,130,2.53,Dodger Stadium,5,1
2015-05-27,2015,PIT,MIA,5,2,-205,-1.5,100,7.5,-110,-110,175,1.5,-120,5.04,PNC Park,7,3
2015-05-27,2015,SF,MIL,3,1,109,1.5,-205,8.5,-116,-104,-119,-1.5,175,4.07,Miller Park,4,2
2015-05-27,2015,BOS,MIN,4,6,-115,-1.5,140,9.0,104,-124,105,1.5,-160,4.81,Target Field,10,-2
2015-05-27,2015,PHI,NYM,0,7,151,1.5,-150,7.5,100,-120,-171,-1.5,130,2.99,Citi Field,7,-7
2015-05-27,2015,KC,NYY,2,4,119,1.5,-175,7.5,-120,100,-134,-1.5,155,3.42,Yankee Stadium,6,-2
2015-05-27,2015,DET,OAK,3,2,125,1.5,-175,7.5,-109,-111,-140,-1.5,155,3.33,Oakland Coliseum,5,1
2015-05-27,2015,NYM,PHI,7,0,-171,-1.5,130,7.5,100,-120,151,1.5,-150,4.73,Citi Field,7,7
2015-05-27,2015,MIA,PIT,2,5,175,1.5,-120,7.5,-110,-110,-205,-1.5,100,2.73,PNC Park,7,-3
2015-05-27,2015,LAA,SD,4,5,-163,-1.5,140,7.0,105,-125,148,1.5,-160,4.34,Angel Stadium,9,-1
2015-05-27,2015,TB,SEA,0,3,111,1.5,-170,6.0,-110,-110,-121,-1.5,150,2.84,Tropicana Field,3,-3
2015-05-27,2015,MIL,SF,1,3,-119,-1.5,175,8.5,-116,-104,109,1.5,-205,4.62,Miller Park,4,-2
2015-05-27,2015,ARI,STL,3,4,170,1.5,-140,7.0,-115,-105,-190,-1.5,120,2.59,Busch Stadium,7,-1
2015-05-27,2015,SEA,TB,3,0,-121,-1.5,150,6.0,-110,-110,111,1.5,-170,3.29,Tropicana Field,3,3
2015-05-27,2015,CLE,TEX,12,3,-152,-1.5,135,8.5,-106,-114,137,1.5,-155,5.13,Progressive Field,15,9
2015-05-27,2015,CWS,TOR,5,3,116,1.5,-195,9.0,100,-120,-126,-1.5,165,4.17,Rogers Centre,8,2
2015-05-27,2015,CHC,WSH,0,3,113,1.5,-155,6.5,-120,100,-123,-1.5,135,3.05,Wrigley Field,3,-3
2015-05-28,2015,SF,ATL,7,0,-130,-1.5,180,6.5,-110,-110,115,1.5,-210,3.67,AT&T Park,7,7
2015-05-28,2015,CWS,BAL,3,2,-129,-1.5,135,8.5,-115,-105,119,1.5,-155,4.79,Camden Yards,5,1
2015-05-28,2015,CWS,BAL,3,6,170,1.5,-130,8.5,-120,100,-190,-1.5,110,3.15,Camden Yards,9,-3
2015-05-28,2015,TEX,BOS,1,5,119,1.5,-145,9.0,100,-120,-129,-1.5,125,4.11,Rangers Ballpark,6,-4
2015-05-28,2015,SEA,CLE,3,5,108,1.5,-170,7.0,115,-135,-118,-1.5,150,3.37,T-Mobile Park,8,-2
2015-05-28,2015,BAL,CWS,2,3,119,1.5,-155,8.5,-115,-105,-129,-1.5,135,3.88,Camden Yards,5,-1
2015-05-28,2015,BAL,CWS,6,3,-190,-1.5,110,8.5,-120,100,170,1.5,-130,5.57,Camden Yards,9,3
2015-05-28,2015,LAA,DET,12,2,-113,-1.5,175,8.0,-119,-101,103,1.5,-205,4.24,Angel Stadium,14,10
2015-05-28,2015,DET,LAA,2,12,103,1.5,-205,8.0,-119,-101,-113,-1.5,175,3.94,Angel Stadium,14,-10
2015-05-28,2015,OAK,NYY,5,4,-103,1.5,-170,8.0,100,-120,-107,-1.5,150,4.06,Oakland Coliseum,9,1
2015-05-28,2015,NYY,OAK,4,5,-107,-1.5,150,8.0,100,-120,-103,1.5,-170,4.14,Oakland Coliseum,9,-1
2015-05-28,2015,SD,PIT,5,11,118,1.5,-155,6.5,-130,110,-128,-1.5,135,2.98,PETCO Park,16,-6
2015-05-28,2015,PIT,SD,11,5,-128,-1.5,135,6.5,-130,110,118,1.5,-155,3.65,PETCO Park,16,6
2015-05-28,2015,CLE,SEA,5,3,-118,-1.5,150,7.0,115,-135,108,1.5,-170,3.79,T-Mobile Park,8,2
2015-05-28,2015,ATL,SF,0,7,115,1.5,-210,6.5,-110,-110,-130,-1.5,180,3.02,AT&T Park,7,-7
2015-05-28,2015,BOS,TEX,5,1,-129,-1.5,125,9.0,100,-120,119,1.5,-145,5.07,Rangers Ballpark,6,4
2015-05-29,2015,MIL,ARI,5,7,-115,-1.5,180,8.0,-105,-115,105,1.5,-210,4.28,Miller Park,12,-2
2015-05-29,2015,SF,ATL,4,2,-153,-1.5,155,7.0,100,-120,138,1.5,-175,4.23,AT&T Park,6,2
2015-05-29,2015,TB,BAL,1,2,119,1.5,-190,7.5,-105,-115,-134,-1.5,160,3.42,Camden Yards,3,-1
2015-05-29,2015,TEX,BOS,7,4,-114,-1.5,175,9.0,-115,-105,104,1.5,-205,4.79,Rangers Ballpark,11,3
2015-05-29,2015,KC,CHC,8,4,129,1.5,-165,8.5,-110,-110,-144,-1.5,145,3.71,Wrigley Field,12,4
2015-05-29,2015,WSH,CIN,2,5,-122,-1.5,140,7.5,-113,-107,112,1.5,-160,4.12,Great American Ballpark,7,-3
2015-05-29,2015,SEA,CLE,2,1,-109,-1.5,185,8.0,-115,-105,-101,1.5,-215,4.17,T-Mobile Park,3,1
2015-05-29,2015,PHI,COL,1,4,-159,-1.5,145,7.0,-110,-110,144,1.5,-165,4.3,Citizens Bank Park,5,-3
2015-05-29,2015,HOU,CWS,3,6,-165,-1.5,130,8.5,-105,-115,150,1.5,-150,5.29,Minute Maid Park,9,-3
2015-05-29,2015,LAA,DET,2,0,107,1.5,-165,8.0,100,-120,-117,-1.5,145,3.86,Angel Stadium,2,2
2015-05-29,2015,CWS,HOU,6,3,150,1.5,-150,8.5,-105,-115,-165,-1.5,130,3.4,Minute Maid Park,9,3
2015-05-29,2015,CHC,KC,4,8,-144,-1.5,145,8.5,-110,-110,129,1.5,-165,5.02,Wrigley Field,12,-4
2015-05-29,2015,DET,LAA,0,2,-117,-1.5,145,8.0,100,-120,107,1.5,-165,4.31,Angel Stadium,2,-2
2015-05-29,2015,STL,LAD,3,0,-121,-1.5,179,7.5,105,-125,111,1.5,-209,4.11,Busch Stadium,3,3
2015-05-29,2015,NYM,MIA,3,4,-160,-1.5,145,6.5,-125,105,145,1.5,-165,4.0,Citi Field,7,-1
2015-05-29,2015,ARI,MIL,7,5,105,1.5,-210,8.0,-105,-115,-115,-1.5,180,3.9,Miller Park,12,2
2015-05-29,2015,TOR,MIN,6,4,105,1.5,-200,8.5,-110,-110,-115,-1.5,170,4.15,Target Field,10,2
2015-05-29,2015,MIA,NYM,4,3,145,1.5,-165,6.5,-125,105,-160,-1.5,145,2.65,Citi Field,7,1
2015-05-29,2015,OAK,NYY,6,2,-153,-1.5,150,6.5,-130,110,138,1.5,-170,3.93,Oakland Coliseum,8,4
2015-05-29,2015,NYY,OAK,2,6,138,1.5,-170,6.5,-130,110,-153,-1.5,150,2.73,Oakland Coliseum,8,-4
2015-05-29,2015,COL,PHI,4,1,144,1.5,-165,7.0,-110,-110,-159,-1.5,145,2.87,Citizens Bank Park,5,3
2015-05-29,2015,SD,PIT,6,2,-114,-1.5,190,6.5,100,-120,104,1.5,-230,3.46,PETCO Park,8,4
2015-05-29,2015,PIT,SD,2,6,104,1.5,-230,6.5,100,-120,-114,-1.5,190,3.19,PETCO Park,8,-4
2015-05-29,2015,CLE,SEA,1,2,-101,1.5,-215,8.0,-115,-105,-109,-1.5,185,4.02,T-Mobile Park,3,-1
2015-05-29,2015,ATL,SF,2,4,138,1.5,-175,7.0,100,-120,-153,-1.5,155,2.94,AT&T Park,6,-2
2015-05-29,2015,LAD,STL,0,3,111,1.5,-209,7.5,105,-125,-121,-1.5,179,3.55,Busch Stadium,3,-3
2015-05-29,2015,BAL,TB,2,1,-134,-1.5,160,7.5,-105,-115,119,1.5,-190,4.29,Camden Yards,3,1
2015-05-29,2015,BOS,TEX,4,7,104,1.5,-205,9.0,-115,-105,-114,-1.5,175,4.41,Rangers Ballpark,11,-3
2015-05-29,2015,MIN,TOR,4,6,-115,-1.5,170,8.5,-110,-110,105,1.5,-200,4.55,Target Field,10,-2
2015-05-29,2015,CIN,WSH,5,2,112,1.5,-160,7.5,-113,-107,-122,-1.5,140,3.54,Great American Ballpark,7,3
2015-05-30,2015,MIL,ARI,3,7,-134,-1.5,160,8.0,-116,-104,119,1.5,-180,4.58,Miller Park,10,-4
2015-05-30,2015,SF,ATL,0,8,-150,-1.5,150,7.0,-105,-115,135,1.5,-170,4.2,AT&T Park,8,-8
2015-05-30,2015,TB,BAL,3,0,118,1.5,-180,8.0,-110,-110,-133,-1.5,160,3.67,Camden Yards,3,3
2015-05-30,2015,TEX,BOS,8,0,118,1.5,-145,9.0,102,-122,-128,-1.5,125,4.13,Rangers Ballpark,8,8
2015-05-30,2015,WSH,CIN,5,8,-101,1.5,-215,7.5,-105,-115,-109,-1.5,185,3.77,Great American Ballpark,13,-3
2015-05-30,2015,SEA,CLE,3,4,-140,-1.5,155,8.0,-125,105,125,1.5,-175,4.67,T-Mobile Park,7,-1
2015-05-30,2015,PHI,COL,2,5,-133,-1.5,160,8.5,-101,-119,118,1.5,-180,4.85,Citizens Bank Park,7,-3
2015-05-30,2015,HOU,CWS,3,0,-155,-1.5,139,7.0,-105,-115,140,1.5,-159,4.25,Minute Maid Park,3,3
2015-05-30,2015,LAA,DET,8,6,-114,-1.5,180,7.5,-105,-115,104,1.5,-210,4.0,Angel Stadium,14,2
2015-05-30,2015,CWS,HOU,0,3,140,1.5,-159,7.0,-105,-115,-155,-1.5,139,2.92,Minute Maid Park,3,-3
2015-05-30,2015,DET,LAA,6,8,104,1.5,-210,7.5,-105,-115,-114,-1.5,180,3.68,Angel Stadium,14,-2
2015-05-30,2015,STL,LAD,1,5,-128,-1.5,165,7.0,-110,-110,118,1.5,-195,3.93,Busch Stadium,6,-4
2015-05-30,2015,NYM,MIA,5,9,-120,-1.5,180,7.5,-120,100,110,1.5,-210,4.09,Citi Field,14,-4
2015-05-30,2015,ARI,MIL,7,3,119,1.5,-180,8.0,-116,-104,-134,-1.5,160,3.65,Miller Park,10,4
2015-05-30,2015,TOR,MIN,2,3,-109,-1.5,150,8.5,-105,-115,-101,1.5,-170,4.43,Target Field,5,-1
2015-05-30,2015,MIA,NYM,9,5,110,1.5,-210,7.5,-120,100,-120,-1.5,180,3.57,Citi Field,14,4
2015-05-30,2015,OAK,NYY,3,5,-119,-1.5,180,7.0,-125,105,109,1.5,-210,3.8,Oakland Coliseum,8,-2
2015-05-30,2015,NYY,OAK,5,3,109,1.5,-210,7.0,-125,105,-119,-1.5,180,3.35,Oakland Coliseum,8,2
2015-05-30,2015,COL,PHI,5,2,118,1.5,-180,8.5,-101,-119,-133,-1.5,160,3.9,Citizens Bank Park,7,3
2015-05-30,2015,SD,PIT,2,5,-121,-1.5,180,6.5,-120,100,111,1.5,-210,3.56,PETCO Park,7,-3
2015-05-30,2015,PIT,SD,5,2,111,1.5,-210,6.5,-120,100,-121,-1.5,180,3.08,PETCO Park,7,3
2015-05-30,2015,CLE,SEA,4,3,125,1.5,-175,8.0,-125,105,-140,-1.5,155,3.56,T-Mobile Park,7,1
2015-05-30,2015,ATL,SF,8,0,135,1.5,-170,7.0,-105,-115,-150,-1.5,150,2.98,AT&T Park,8,8
2015-05-30,2015,LAD,STL,5,1,118,1.5,-195,7.0,-110,-110,-128,-1.5,165,3.21,Busch Stadium,6,4
2015-05-30,2015,BAL,TB,0,3,-133,-1.5,160,8.0,-110,-110,118,1.5,-180,4.57,Camden Yards,3,-3
2015-05-30,2015,BOS,TEX,0,8,-128,-1.5,125,9.0,102,-122,118,1.5,-145,5.05,Rangers Ballpark,8,-8
2015-05-30,2015,MIN,TOR,3,2,-101,1.5,-170,8.5,-105,-115,-109,-1.5,150,4.27,Target Field,5,1
2015-05-30,2015,CIN,WSH,8,5,-109,-1.5,185,7.5,-105,-115,-101,1.5,-215,3.91,Great American Ballpark,13,3
2015-05-31,2015,MIL,ARI,7,6,-101,1.5,-170,8.0,100,-120,-109,-1.5,150,4.02,Miller Park,13,1
2015-05-31,2015,SF,ATL,5,7,-217,-1.5,110,6.5,-120,100,187,1.5,-130,4.45,AT&T Park,12,-2
2015-05-31,2015,TB,BAL,9,5,-107,-1.5,150,8.0,-110,-110,-103,1.5,-170,4.14,Camden Yards,14,4
2015-05-31,2015,TEX,BOS,4,3,108,1.5,-160,8.5,-115,-105,-118,-1.5,140,4.09,Rangers Ballpark,7,1
2015-05-31,2015,KC,CHC,1,2,-110,-1.5,155,6.0,103,-123,100,1.5,-175,3.14,Wrigley Field,3,-1
2015-05-31,2015,WSH,CIN,2,8,-126,-1.5,130,8.0,-120,100,116,1.5,-150,4.46,Great American Ballpark,10,-6
2015-05-31,2015,SEA,CLE,3,6,-111,-1.5,185,7.0,-115,-105,101,1.5,-215,3.68,T-Mobile Park,9,-3
2015-05-31,2015,PHI,COL,1,4,-113,-1.5,180,8.5,-115,-105,103,1.5,-210,4.51,Citizens Bank Park,5,-3
2015-05-31,2015,HOU,CWS,0,6,-144,-1.5,140,8.5,-122,102,129,1.5,-160,5.02,Minute Maid Park,6,-6
2015-05-31,2015,LAA,DET,4,2,112,1.5,-155,7.0,-130,110,-122,-1.5,135,3.3,Angel Stadium,6,2
2015-05-31,2015,CWS,HOU,6,0,129,1.5,-160,8.5,-122,102,-144,-1.5,140,3.71,Minute Maid Park,6,6
2015-05-31,2015,CHC,KC,2,1,100,1.5,-175,6.0,103,-123,-110,-1.5,155,3.0,Wrigley Field,3,1
2015-05-31,2015,DET,LAA,2,4,-122,-1.5,135,7.0,-130,110,112,1.5,-155,3.85,Angel Stadium,6,-2
2015-05-31,2015,STL,LAD,3,1,-105,-1.5,190,7.0,-105,-115,-105,1.5,-230,3.59,Busch Stadium,4,2
2015-05-31,2015,NYM,MIA,4,3,-123,-1.5,170,7.5,100,-120,113,1.5,-200,4.14,Citi Field,7,1
2015-05-31,2015,ARI,MIL,6,7,-109,-1.5,150,8.0,100,-120,-101,1.5,-170,4.17,Miller Park,13,-1
2015-05-31,2015,TOR,MIN,5,6,-129,-1.5,120,8.0,102,-122,119,1.5,-140,4.51,Target Field,11,-1
2015-05-31,2015,MIA,NYM,3,4,113,1.5,-200,7.5,100,-120,-123,-1.5,170,3.52,Citi Field,7,-1
2015-05-31,2015,OAK,NYY,3,0,-127,-1.5,170,7.0,-115,-105,117,1.5,-200,3.92,Oakland Coliseum,3,3
2015-05-31,2015,NYY,OAK,0,3,117,1.5,-200,7.0,-115,-105,-127,-1.5,170,3.23,Oakland Coliseum,3,-3
2015-05-31,2015,COL,PHI,4,1,103,1.5,-210,8.5,-115,-105,-113,-1.5,180,4.19,Citizens Bank Park,5,3
2015-05-31,2015,SD,PIT,7,1,-114,-1.5,190,7.0,-132,112,104,1.5,-230,3.73,PETCO Park,8,6
2015-05-31,2015,PIT,SD,1,7,104,1.5,-230,7.0,-132,112,-114,-1.5,190,3.43,PETCO Park,8,-6
2015-05-31,2015,CLE,SEA,6,3,101,1.5,-215,7.0,-115,-105,-111,-1.5,185,3.48,T-Mobile Park,9,3
2015-05-31,2015,ATL,SF,7,5,187,1.5,-130,6.5,-120,100,-217,-1.5,110,2.26,AT&T Park,12,2
2015-05-31,2015,LAD,STL,1,3,-105,1.5,-230,7.0,-105,-115,-105,-1.5,190,3.59,Busch Stadium,4,-2
2015-05-31,2015,BAL,TB,5,9,-103,1.5,-170,8.0,-110,-110,-107,-1.5,150,4.06,Camden Yards,14,-4
2015-05-31,2015,BOS,TEX,3,4,-118,-1.5,140,8.5,-115,-105,108,1.5,-160,4.6,Rangers Ballpark,7,-1
2015-05-31,2015,MIN,TOR,6,5,119,1.5,-140,8.0,102,-122,-129,-1.5,120,3.65,Target Field,11,1
2015-05-31,2015,CIN,WSH,8,2,116,1.5,-150,8.0,-120,100,-126,-1.5,130,3.7,Great American Ballpark,10,6
2015-06-01,2015,ATL,ARI,8,1,-104,1.5,-215,9.0,-115,-105,-106,-1.5,185,4.59,Chase Field,9,7
2015-06-01,2015,ARI,ATL,1,8,-106,-1.5,185,9.0,-115,-105,-104,1.5,-215,4.63,Chase Field,9,-7
2015-06-01,2015,HOU,BAL,5,2,-104,1.5,-165,8.5,-120,100,-106,-1.5,145,4.33,Minute Maid Park,7,3
2015-06-01,2015,MIA,CHC,1,5,113,1.5,-160,8.0,-101,-119,-123,-1.5,140,3.76,Marlins Park,6,-4
2015-06-01,2015,LAD,COL,11,4,-215,-1.5,-135,9.5,-105,-115,185,1.5,115,6.48,Coors Field,15,7
2015-06-01,2015,BAL,HOU,2,5,-106,-1.5,145,8.5,-120,100,-104,1.5,-165,4.37,Minute Maid Park,7,-3
2015-06-01,2015,TB,LAA,3,7,138,1.5,-165,7.0,-105,-115,-153,-1.5,145,2.94,Angel Stadium,10,-4
2015-06-01,2015,COL,LAD,4,11,185,1.5,115,9.5,-105,-115,-215,-1.5,-135,3.33,Coors Field,15,-7
2015-06-01,2015,CHC,MIA,5,1,-123,-1.5,140,8.0,-101,-119,113,1.5,-160,4.41,Marlins Park,6,4
2015-06-01,2015,STL,MIL,0,1,-146,-1.5,160,7.0,110,-130,131,1.5,-180,4.15,Busch Stadium,1,-1
2015-06-01,2015,SD,NYM,0,7,-112,-1.5,190,6.0,110,-130,102,1.5,-230,3.17,PETCO Park,7,-7
2015-06-01,2015,SEA,NYY,2,7,-133,-1.5,175,6.0,-105,-115,118,1.5,-205,3.42,T-Mobile Park,9,-5
2015-06-01,2015,SF,PIT,3,4,125,1.5,-145,7.0,-110,-110,-140,-1.5,125,3.11,AT&T Park,7,-1
2015-06-01,2015,NYM,SD,7,0,102,1.5,-230,6.0,110,-130,-112,-1.5,190,2.97,PETCO Park,7,7
2015-06-01,2015,NYY,SEA,7,2,118,1.5,-205,6.0,-105,-115,-133,-1.5,175,2.75,T-Mobile Park,9,5
2015-06-01,2015,PIT,SF,4,3,-140,-1.5,125,7.0,-110,-110,125,1.5,-145,4.08,AT&T Park,7,1
2015-06-01,2015,MIL,STL,1,0,131,1.5,-180,7.0,110,-130,-146,-1.5,160,3.03,Busch Stadium,1,1
2015-06-01,2015,LAA,TB,7,3,-153,-1.5,145,7.0,-105,-115,138,1.5,-165,4.23,Angel Stadium,10,4
2015-06-02,2015,ATL,ARI,6,7,-111,-1.5,155,9.0,-115,-105,101,1.5,-175,4.73,Chase Field,13,-1
2015-06-02,2015,ARI,ATL,7,6,101,1.5,-175,9.0,-115,-105,-111,-1.5,155,4.48,Chase Field,13,1
2015-06-02,2015,HOU,BAL,6,4,-143,-1.5,150,8.5,-110,-110,128,1.5,-170,5.0,Minute Maid Park,10,2
2015-06-02,2015,MIN,BOS,0,1,170,1.5,-140,8.0,-105,-115,-190,-1.5,120,2.96,Fenway Park,1,-1
2015-06-02,2015,MIA,CHC,5,2,-109,1.5,-190,7.5,-115,-105,-101,-1.5,160,3.91,Marlins Park,7,3
2015-06-02,2015,PHI,CIN,5,4,158,1.5,-110,7.0,110,-130,-178,-1.5,-110,2.71,Citizens Bank Park,9,1
2015-06-02,2015,KC,CLE,1,2,118,1.5,-150,8.0,-115,-105,-128,-1.5,130,3.67,Kauffman Stadium,3,-1
2015-06-02,2015,LAD,COL,3,6,-108,-1.5,145,10.5,-110,-110,-102,1.5,-165,5.45,Coors Field,9,-3
2015-06-02,2015,LAD,COL,9,8,-193,-1.5,-120,10.5,-110,-110,173,1.5,100,6.92,Coors Field,17,1
2015-06-02,2015,TEX,CWS,15,2,-108,1.5,-175,8.5,-120,100,-102,-1.5,155,4.41,Rangers Ballpark,17,13
2015-06-02,2015,OAK,DET,5,3,116,1.5,-190,9.0,100,-120,-126,-1.5,160,4.17,Comerica Park,8,2
2015-06-02,2015,BAL,HOU,4,6,128,1.5,-170,8.5,-110,-110,-143,-1.5,150,3.73,Minute Maid Park,10,-2
2015-06-02,2015,CLE,KC,2,1,-128,-1.5,130,8.0,-115,-105,118,1.5,-150,4.49,Kauffman Stadium,3,1
2015-06-02,2015,TB,LAA,6,1,-120,-1.5,135,7.0,-125,105,110,1.5,-155,3.82,Angel Stadium,7,5
2015-06-02,2015,COL,LAD,6,3,-102,1.5,-165,10.5,-110,-110,-108,-1.5,145,5.3,Coors Field,9,3
2015-06-02,2015,COL,LAD,8,9,173,1.5,100,10.5,-110,-110,-193,-1.5,-120,3.85,Coors Field,17,-1
2015-06-02,2015,CHC,MIA,2,5,-101,-1.5,160,7.5,-115,-105,-109,1.5,-190,3.77,Marlins Park,7,-3
2015-06-02,2015,STL,MIL,1,0,-170,-1.5,130,7.5,105,-125,150,1.5,-150,4.72,Busch Stadium,1,1
2015-06-02,2015,BOS,MIN,1,0,-190,-1.5,120,8.0,-105,-115,170,1.5,-140,5.24,Fenway Park,1,1
2015-06-02,2015,SD,NYM,7,2,-114,-1.5,195,7.0,110,-130,104,1.5,-235,3.73,PETCO Park,9,5
2015-06-02,2015,SEA,NYY,3,5,-112,-1.5,185,7.0,-120,100,102,1.5,-215,3.7,T-Mobile Park,8,-2
2015-06-02,2015,DET,OAK,3,5,-126,-1.5,160,9.0,100,-120,116,1.5,-190,5.02,Comerica Park,8,-2
2015-06-02,2015,CIN,PHI,4,5,-178,-1.5,-110,7.0,110,-130,158,1.5,-110,4.48,Citizens Bank Park,9,-1
2015-06-02,2015,SF,PIT,4,7,-122,-1.5,174,6.5,-120,100,112,1.5,-204,3.57,AT&T Park,11,-3
2015-06-02,2015,NYM,SD,2,7,104,1.5,-235,7.0,110,-130,-114,-1.5,195,3.43,PETCO Park,9,-5
2015-06-02,2015,NYY,SEA,5,3,102,1.5,-215,7.0,-120,100,-112,-1.5,185,3.47,T-Mobile Park,8,2
2015-06-02,2015,PIT,SF,7,4,112,1.5,-204,6.5,-120,100,-122,-1.5,174,3.07,AT&T Park,11,3
2015-06-02,2015,MIL,STL,0,1,150,1.5,-150,7.5,105,-125,-170,-1.5,130,3.0,Busch Stadium,1,-1
2015-06-02,2015,LAA,TB,1,6,110,1.5,-155,7.0,-125,105,-120,-1.5,135,3.33,Angel Stadium,7,-5
2015-06-02,2015,CWS,TEX,2,15,-102,-1.5,155,8.5,-120,100,-108,1.5,-175,4.29,Rangers Ballpark,17,-13
2015-06-02,2015,WSH,TOR,2,0,-156,-1.5,145,7.5,-105,-115,141,1.5,-155,4.57,Nationals Park,2,2
2015-06-02,2015,WSH,TOR,3,7,-170,-1.5,135,6.5,-110,-110,150,1.5,-165,4.09,Nationals Park,10,-4
2015-06-02,2015,TOR,WSH,0,2,141,1.5,-155,7.5,-105,-115,-156,-1.5,145,3.11,Nationals Park,2,-2
2015-06-02,2015,TOR,WSH,7,3,150,1.5,-165,6.5,-110,-110,-170,-1.5,135,2.6,Nationals Park,10,4
2015-06-03,2015,ATL,ARI,8,9,135,1.5,-165,8.0,-115,-105,-150,-1.5,145,3.4,Chase Field,17,-1
2015-06-03,2015,ARI,ATL,9,8,-150,-1.5,145,8.0,-115,-105,135,1.5,-165,4.8,Chase Field,17,1
2015-06-03,2015,HOU,BAL,3,1,-124,-1.5,166,8.5,-115,-105,114,1.5,-195,4.71,Minute Maid Park,4,2
2015-06-03,2015,MIN,BOS,3,6,130,1.5,-160,8.0,-115,-105,-145,-1.5,140,3.48,Fenway Park,9,-3
2015-06-03,2015,MIN,BOS,2,0,132,1.5,-165,7.5,-105,-115,-147,-1.5,145,3.23,Fenway Park,2,2
2015-06-03,2015,MIA,CHC,7,3,104,1.5,-165,7.5,100,-120,-114,-1.5,145,3.68,Marlins Park,10,4
2015-06-03,2015,PHI,CIN,5,4,-132,-1.5,170,6.5,-105,-115,117,1.5,-200,3.7,Citizens Bank Park,9,1
2015-06-03,2015,KC,CLE,4,2,109,1.5,-155,7.0,-125,105,-119,-1.5,135,3.35,Kauffman Stadium,6,2
2015-06-03,2015,LAD,COL,6,7,-121,-1.5,125,10.5,100,-120,111,1.5,-145,5.75,Coors Field,13,-1
2015-06-03,2015,TEX,CWS,2,9,146,1.5,-125,8.0,105,-125,-161,-1.5,105,3.25,Rangers Ballpark,11,-7
2015-06-03,2015,OAK,DET,6,1,-102,1.5,-210,7.0,-115,-105,-108,-1.5,180,3.53,Comerica Park,7,5
2015-06-03,2015,BAL,HOU,1,3,114,1.5,-195,8.5,-115,-105,-124,-1.5,166,3.97,Minute Maid Park,4,-2
2015-06-03,2015,CLE,KC,2,4,-119,-1.5,135,7.0,-125,105,109,1.5,-155,3.8,Kauffman Stadium,6,-2
2015-06-03,2015,TB,LAA,6,5,105,1.5,-205,7.5,-101,-119,-115,-1.5,175,3.66,Angel Stadium,11,1
2015-06-03,2015,COL,LAD,7,6,111,1.5,-145,10.5,100,-120,-121,-1.5,125,4.98,Coors Field,13,1
2015-06-03,2015,CHC,MIA,3,7,-114,-1.5,145,7.5,100,-120,104,1.5,-165,4.0,Marlins Park,10,-4
2015-06-03,2015,STL,MIL,7,4,-176,-1.5,130,7.0,100,-120,156,1.5,-150,4.46,Busch Stadium,11,3
2015-06-03,2015,BOS,MIN,6,3,-145,-1.5,140,8.0,-115,-105,130,1.5,-160,4.73,Fenway Park,9,3
2015-06-03,2015,BOS,MIN,0,2,-147,-1.5,145,7.5,-105,-115,132,1.5,-165,4.46,Fenway Park,2,-2
2015-06-03,2015,SD,NYM,7,3,-152,-1.5,160,7.0,100,-120,137,1.5,-180,4.22,PETCO Park,10,4
2015-06-03,2015,SEA,NYY,1,3,-105,1.5,-190,7.0,-120,100,-105,-1.5,160,3.59,T-Mobile Park,4,-2
2015-06-03,2015,DET,OAK,1,6,-108,-1.5,180,7.0,-115,-105,-102,1.5,-210,3.63,Comerica Park,7,-5
2015-06-03,2015,CIN,PHI,4,5,117,1.5,-200,6.5,-105,-115,-132,-1.5,170,3.0,Citizens Bank Park,9,-1
2015-06-03,2015,SF,PIT,2,5,113,1.5,-155,7.0,105,-125,-123,-1.5,135,3.29,AT&T Park,7,-3
2015-06-03,2015,NYM,SD,3,7,137,1.5,-180,7.0,100,-120,-152,-1.5,160,2.95,PETCO Park,10,-4
2015-06-03,2015,NYY,SEA,3,1,-105,-1.5,160,7.0,-120,100,-105,1.5,-190,3.59,T-Mobile Park,4,2
2015-06-03,2015,PIT,SF,5,2,-123,-1.5,135,7.0,105,-125,113,1.5,-155,3.86,AT&T Park,7,3
2015-06-03,2015,MIL,STL,4,7,156,1.5,-150,7.0,100,-120,-176,-1.5,130,2.73,Busch Stadium,11,-3
2015-06-03,2015,LAA,TB,5,6,-115,-1.5,175,7.5,-101,-119,105,1.5,-205,4.01,Angel Stadium,11,-1
2015-06-03,2015,CWS,TEX,9,2,-161,-1.5,105,8.0,105,-125,146,1.5,-125,4.93,Rangers Ballpark,11,7
2015-06-03,2015,WSH,TOR,0,8,-130,-1.5,160,7.5,-114,-106,115,1.5,-190,4.24,Nationals Park,8,-8
2015-06-03,2015,TOR,WSH,8,0,115,1.5,-190,7.5,-114,-106,-130,-1.5,160,3.49,Nationals Park,8,8
2015-06-04,2015,NYM,ARI,6,2,-140,-1.5,120,8.5,100,-120,125,1.5,-140,4.96,Chase Field,8,4
2015-06-04,2015,HOU,BAL,2,3,-172,-1.5,125,7.0,-120,100,152,1.5,-145,4.43,Minute Maid Park,5,-1
2015-06-04,2015,MIN,BOS,8,4,147,1.5,-150,8.5,-120,100,-162,-1.5,130,3.44,Fenway Park,12,4
2015-06-04,2015,WSH,CHC,1,2,-113,-1.5,200,6.5,-120,100,103,1.5,-240,3.45,Nationals Park,3,-1
2015-06-04,2015,PHI,CIN,4,6,112,1.5,-155,7.0,-105,-115,-122,-1.5,135,3.3,Citizens Bank Park,10,-2
2015-06-04,2015,KC,CLE,2,6,-117,-1.5,180,8.0,-123,103,107,1.5,-210,4.31,Kauffman Stadium,8,-4
2015-06-04,2015,TEX,CWS,2,1,-103,1.5,-170,8.5,-115,-105,-107,-1.5,150,4.31,Rangers Ballpark,3,1
2015-06-04,2015,OAK,DET,7,5,-108,-1.5,145,8.5,-115,-105,-102,1.5,-165,4.41,Comerica Park,12,2
2015-06-04,2015,BAL,HOU,3,2,152,1.5,-145,7.0,-120,100,-172,-1.5,125,2.78,Minute Maid Park,5,1
2015-06-04,2015,CLE,KC,6,2,107,1.5,-210,8.0,-123,103,-117,-1.5,180,3.86,Kauffman Stadium,8,4
2015-06-04,2015,STL,LAD,7,1,-105,1.5,-240,7.5,106,-126,-105,-1.5,200,3.84,Dodger Stadium,8,6
2015-06-04,2015,BOS,MIN,4,8,-162,-1.5,130,8.5,-120,100,147,1.5,-150,5.26,Fenway Park,12,-4
2015-06-04,2015,ARI,NYM,2,6,125,1.5,-140,8.5,100,-120,-140,-1.5,120,3.78,Chase Field,8,-4
2015-06-04,2015,DET,OAK,5,7,-102,1.5,-165,8.5,-115,-105,-108,-1.5,145,4.29,Comerica Park,12,-2
2015-06-04,2015,CIN,PHI,6,4,-122,-1.5,135,7.0,-105,-115,112,1.5,-155,3.85,Citizens Bank Park,10,2
2015-06-04,2015,TB,SEA,2,1,117,1.5,-205,7.5,-105,-115,-127,-1.5,175,3.46,T-Mobile Park,3,1
2015-06-04,2015,LAD,STL,1,7,-105,-1.5,200,7.5,106,-126,-105,1.5,-240,3.84,Dodger Stadium,8,-6
2015-06-04,2015,SEA,TB,1,2,-127,-1.5,175,7.5,-105,-115,117,1.5,-205,4.2,T-Mobile Park,3,-1
2015-06-04,2015,CWS,TEX,1,2,-107,-1.5,150,8.5,-115,-105,-103,1.5,-170,4.39,Rangers Ballpark,3,-1
2015-06-04,2015,CHC,WSH,2,1,103,1.5,-240,6.5,-120,100,-113,-1.5,200,3.2,Nationals Park,3,1
2015-06-05,2015,NYM,ARI,2,7,115,1.5,-180,9.0,-115,-105,-130,-1.5,160,4.19,Chase Field,9,-5
2015-06-05,2015,PIT,ATL,10,8,-124,-1.5,135,7.5,100,-120,114,1.5,-155,4.15,Turner Field,18,2
2015-06-05,2015,CLE,BAL,2,5,-122,-1.5,170,8.5,-105,-115,112,1.5,-200,4.67,Progressive Field,7,-3
2015-06-05,2015,OAK,BOS,2,4,108,1.5,-195,8.0,-110,-110,-118,-1.5,165,3.85,Fenway Park,6,-2
2015-06-05,2015,WSH,CHC,7,5,-126,-1.5,175,8.0,-110,-110,116,1.5,-205,4.46,Nationals Park,12,2
2015-06-05,2015,SD,CIN,6,2,-122,-1.5,145,7.5,-120,100,112,1.5,-165,4.12,Great American Ballpark,8,4
2015-06-05,2015,BAL,CLE,5,2,112,1.5,-200,8.5,-105,-115,-122,-1.5,170,4.01,Progressive Field,7,3
2015-06-05,2015,MIA,COL,6,2,-106,-1.5,145,11.0,-105,-115,-104,1.5,-165,5.66,Coors Field,8,4
2015-06-05,2015,DET,CWS,3,4,135,1.5,-165,8.5,-110,-110,-150,-1.5,145,3.62,Guaranteed Rate Field,7,-1
2015-06-05,2015,CWS,DET,4,3,-150,-1.5,145,8.5,-110,-110,135,1.5,-165,5.1,Guaranteed Rate Field,7,1
2015-06-05,2015,TOR,HOU,6,2,-161,-1.5,134,9.5,-105,-115,146,1.5,-154,5.86,Rogers Centre,8,4
2015-06-05,2015,TEX,KC,4,0,157,1.5,-140,8.5,105,-125,-177,-1.5,120,3.31,Kauffman Stadium,4,4
2015-06-05,2015,NYY,LAA,8,7,-120,-1.5,165,8.0,-115,-105,110,1.5,-195,4.36,Yankee Stadium,15,1
2015-06-05,2015,STL,LAD,2,1,110,1.5,-210,7.0,105,-125,-120,-1.5,180,3.33,Dodger Stadium,3,1
2015-06-05,2015,COL,MIA,2,6,-104,1.5,-165,11.0,-105,-115,-106,-1.5,145,5.61,Coors Field,8,-4
2015-06-05,2015,MIN,MIL,5,10,-127,-1.5,155,8.0,-115,-105,117,1.5,-175,4.48,Target Field,15,-5
2015-06-05,2015,MIL,MIN,10,5,117,1.5,-175,8.0,-115,-105,-127,-1.5,155,3.69,Target Field,15,5
2015-06-05,2015,ARI,NYM,7,2,-130,-1.5,160,9.0,-115,-105,115,1.5,-180,5.09,Chase Field,9,5
2015-06-05,2015,LAA,NYY,7,8,110,1.5,-195,8.0,-115,-105,-120,-1.5,165,3.81,Yankee Stadium,15,-1
2015-06-05,2015,BOS,OAK,4,2,-118,-1.5,165,8.0,-110,-110,108,1.5,-195,4.33,Fenway Park,6,2
2015-06-05,2015,SF,PHI,5,4,-128,-1.5,130,8.0,100,-120,118,1.5,-150,4.49,Citizens Bank Park,9,1
2015-06-05,2015,ATL,PIT,8,10,114,1.5,-155,7.5,100,-120,-124,-1.5,135,3.5,Turner Field,18,-2
2015-06-05,2015,CIN,SD,2,6,112,1.5,-165,7.5,-120,100,-122,-1.5,145,3.54,Great American Ballpark,8,-4
2015-06-05,2015,TB,SEA,1,0,-101,1.5,-230,7.0,-125,105,-109,-1.5,190,3.52,T-Mobile Park,1,1
2015-06-05,2015,PHI,SF,4,5,118,1.5,-150,8.0,100,-120,-128,-1.5,130,3.67,Citizens Bank Park,9,-1
2015-06-05,2015,LAD,STL,1,2,-120,-1.5,180,7.0,105,-125,110,1.5,-210,3.82,Dodger Stadium,3,-1
2015-06-05,2015,SEA,TB,0,1,-109,-1.5,190,7.0,-125,105,-101,1.5,-230,3.65,T-Mobile Park,1,-1
2015-06-05,2015,KC,TEX,0,4,-177,-1.5,120,8.5,105,-125,157,1.5,-140,5.43,Kauffman Stadium,4,-4
2015-06-05,2015,HOU,TOR,2,6,146,1.5,-154,9.5,-105,-115,-161,-1.5,134,3.86,Rogers Centre,8,-4
2015-06-05,2015,CHC,WSH,5,7,116,1.5,-205,8.0,-110,-110,-126,-1.5,175,3.7,Nationals Park,12,-2
2015-06-06,2015,NYM,ARI,1,2,133,1.5,-165,9.0,-110,-110,-148,-1.5,145,3.86,Chase Field,3,-1
2015-06-06,2015,PIT,ATL,4,5,-108,-1.5,144,8.0,100,-120,-102,1.5,-164,4.15,Turner Field,9,-1
2015-06-06,2015,CLE,BAL,2,1,-158,-1.5,140,7.5,-105,-115,143,1.5,-160,4.59,Progressive Field,3,1
2015-06-06,2015,OAK,BOS,2,4,-102,1.5,-210,8.5,100,-120,-108,-1.5,180,4.29,Fenway Park,6,-2
2015-06-06,2015,WSH,CHC,2,4,-103,1.5,-165,8.0,100,-120,-107,-1.5,145,4.06,Nationals Park,6,-2
2015-06-06,2015,SD,CIN,9,7,-111,-1.5,150,8.0,-109,-111,101,1.5,-170,4.21,Great American Ballpark,16,2
2015-06-06,2015,BAL,CLE,1,2,143,1.5,-160,7.5,-105,-115,-158,-1.5,140,3.09,Progressive Field,3,-1
2015-06-06,2015,MIA,COL,5,10,-114,-1.5,135,10.5,-118,-102,104,1.5,-155,5.59,Coors Field,15,-5
2015-06-06,2015,DET,CWS,7,1,-180,-1.5,-115,8.0,-103,-117,160,1.5,-105,5.14,Guaranteed Rate Field,8,6
2015-06-06,2015,CWS,DET,1,7,160,1.5,-105,8.0,-103,-117,-180,-1.5,-115,3.08,Guaranteed Rate Field,8,-6
2015-06-06,2015,TOR,HOU,7,2,-164,-1.5,125,9.0,104,-124,149,1.5,-145,5.59,Rogers Centre,9,5
2015-06-06,2015,TEX,KC,4,2,135,1.5,-165,7.5,-115,-105,-150,-1.5,145,3.19,Kauffman Stadium,6,2
2015-06-06,2015,NYY,LAA,8,2,107,1.5,-160,8.5,-120,100,-117,-1.5,140,4.11,Yankee Stadium,10,6
2015-06-06,2015,STL,LAD,0,2,175,1.5,-145,6.0,105,-125,-205,-1.5,125,2.18,Dodger Stadium,2,-2
2015-06-06,2015,COL,MIA,10,5,104,1.5,-155,10.5,-118,-102,-114,-1.5,135,5.15,Coors Field,15,5
2015-06-06,2015,MIN,MIL,2,4,-130,-1.5,160,9.0,-104,-116,115,1.5,-190,5.09,Target Field,6,-2
2015-06-06,2015,MIL,MIN,4,2,115,1.5,-190,9.0,-104,-116,-130,-1.5,160,4.19,Target Field,6,2
2015-06-06,2015,ARI,NYM,2,1,-148,-1.5,145,9.0,-110,-110,133,1.5,-165,5.37,Chase Field,3,1
2015-06-06,2015,LAA,NYY,2,8,-117,-1.5,140,8.5,-120,100,107,1.5,-160,4.58,Yankee Stadium,10,-6
2015-06-06,2015,BOS,OAK,4,2,-108,-1.5,180,8.5,100,-120,-102,1.5,-210,4.41,Fenway Park,6,2
2015-06-06,2015,SF,PHI,7,5,-205,-1.5,-125,7.5,100,-120,175,1.5,105,5.04,Citizens Bank Park,12,2
2015-06-06,2015,ATL,PIT,5,4,-102,1.5,-164,8.0,100,-120,-108,-1.5,144,4.04,Turner Field,9,1
2015-06-06,2015,CIN,SD,7,9,101,1.5,-170,8.0,-109,-111,-111,-1.5,150,3.98,Great American Ballpark,16,-2
2015-06-06,2015,TB,SEA,1,2,170,1.5,-135,6.5,-110,-110,-200,-1.5,115,2.41,T-Mobile Park,3,-1
2015-06-06,2015,PHI,SF,5,7,175,1.5,105,7.5,100,-120,-205,-1.5,-125,2.73,Citizens Bank Park,12,-2
2015-06-06,2015,LAD,STL,2,0,-205,-1.5,125,6.0,105,-125,175,1.5,-145,4.03,Dodger Stadium,2,2
2015-06-06,2015,SEA,TB,2,1,-200,-1.5,115,6.5,-110,-110,170,1.5,-135,4.33,T-Mobile Park,3,1
2015-06-06,2015,KC,TEX,2,4,-150,-1.5,145,7.5,-115,-105,135,1.5,-165,4.5,Kauffman Stadium,6,-2
2015-06-06,2015,HOU,TOR,2,7,149,1.5,-145,9.0,104,-124,-164,-1.5,125,3.61,Rogers Centre,9,-5
2015-06-06,2015,CHC,WSH,4,2,-107,-1.5,145,8.0,100,-120,-103,1.5,-165,4.14,Nationals Park,6,2
2015-06-07,2015,NYM,ARI,6,3,-140,-1.5,120,8.0,-105,-115,125,1.5,-140,4.67,Chase Field,9,3
2015-06-07,2015,PIT,ATL,3,0,-152,-1.5,110,7.0,-110,-110,137,1.5,-130,4.22,Turner Field,3,3
2015-06-07,2015,CLE,BAL,3,7,-184,-1.5,106,8.0,-110,-110,164,1.5,-126,5.18,Progressive Field,10,-4
2015-06-07,2015,OAK,BOS,4,7,164,1.5,-135,8.5,-110,-110,-184,-1.5,115,3.22,Fenway Park,11,-3
2015-06-07,2015,WSH,CHC,3,6,-141,-1.5,158,7.5,100,-120,126,1.5,-178,4.39,Nationals Park,9,-3
2015-06-07,2015,SD,CIN,0,4,156,1.5,-140,8.0,100,-120,-176,-1.5,120,3.13,Great American Ballpark,4,-4
2015-06-07,2015,BAL,CLE,7,3,164,1.5,-126,8.0,-110,-110,-184,-1.5,106,3.03,Progressive Field,10,4
2015-06-07,2015,MIA,COL,3,2,-101,1.5,-190,11.5,-105,-115,-109,-1.5,160,5.78,Coors Field,5,1
2015-06-07,2015,DET,CWS,6,4,119,1.5,-180,9.0,-115,-105,-129,-1.5,160,4.11,Guaranteed Rate Field,10,2
2015-06-07,2015,CWS,DET,4,6,-129,-1.5,160,9.0,-115,-105,119,1.5,-180,5.07,Guaranteed Rate Field,10,-2
2015-06-07,2015,TOR,HOU,7,6,-109,-1.5,175,8.5,-120,100,-101,1.5,-205,4.43,Rogers Centre,13,1
2015-06-07,2015,TEX,KC,3,4,116,1.5,-190,9.0,-120,100,-131,-1.5,160,4.17,Kauffman Stadium,7,-1
2015-06-07,2015,NYY,LAA,6,2,-112,-1.5,185,8.5,-120,100,102,1.5,-215,4.49,Yankee Stadium,8,4
2015-06-07,2015,STL,LAD,4,2,147,1.5,-160,7.0,105,-125,-162,-1.5,140,2.83,Dodger Stadium,6,2
2015-06-07,2015,COL,MIA,2,3,-109,-1.5,160,11.5,-105,-115,-101,1.5,-190,6.0,Coors Field,5,-1
2015-06-07,2015,MIN,MIL,2,0,111,1.5,-150,8.5,-120,100,-121,-1.5,130,4.03,Target Field,2,2
2015-06-07,2015,MIL,MIN,0,2,-121,-1.5,130,8.5,-120,100,111,1.5,-150,4.65,Target Field,2,-2
2015-06-07,2015,ARI,NYM,3,6,125,1.5,-140,8.0,-105,-115,-140,-1.5,120,3.56,Chase Field,9,-3
2015-06-07,2015,LAA,NYY,2,6,102,1.5,-215,8.5,-120,100,-112,-1.5,185,4.21,Yankee Stadium,8,-4
2015-06-07,2015,BOS,OAK,7,4,-184,-1.5,115,8.5,-110,-110,164,1.5,-135,5.51,Fenway Park,11,3
2015-06-07,2015,SF,PHI,4,6,-142,-1.5,115,8.5,-120,100,127,1.5,-135,4.99,Citizens Bank Park,10,-2
2015-06-07,2015,ATL,PIT,0,3,137,1.5,-130,7.0,-110,-110,-152,-1.5,110,2.95,Turner Field,3,-3
2015-06-07,2015,CIN,SD,4,0,-176,-1.5,120,8.0,100,-120,156,1.5,-140,5.1,Great American Ballpark,4,4
2015-06-07,2015,TB,SEA,3,1,-129,-1.5,125,6.5,-119,-101,119,1.5,-145,3.66,T-Mobile Park,4,2
2015-06-07,2015,PHI,SF,6,4,127,1.5,-135,8.5,-120,100,-142,-1.5,115,3.74,Citizens Bank Park,10,2
2015-06-07,2015,LAD,STL,2,4,-162,-1.5,140,7.0,105,-125,147,1.5,-160,4.33,Dodger Stadium,6,-2
2015-06-07,2015,SEA,TB,1,3,119,1.5,-145,6.5,-119,-101,-129,-1.5,125,2.97,T-Mobile Park,4,-2
2015-06-07,2015,KC,TEX,4,3,-131,-1.5,160,9.0,-120,100,116,1.5,-190,5.1,Kauffman Stadium,7,1
2015-06-07,2015,HOU,TOR,6,7,-101,1.5,-205,8.5,-120,100,-109,-1.5,175,4.27,Rogers Centre,13,-1
2015-06-07,2015,CHC,WSH,6,3,126,1.5,-178,7.5,100,-120,-141,-1.5,158,3.32,Nationals Park,9,3
2015-06-08,2015,LAD,ARI,9,3,-150,-1.5,155,7.0,-125,105,135,1.5,-175,4.2,Dodger Stadium,12,6
2015-06-08,2015,SD,ATL,5,3,107,1.5,-210,7.5,-110,-110,-117,-1.5,180,3.62,Turner Field,8,2
2015-06-08,2015,PHI,CIN,4,6,-105,1.5,-235,7.0,-121,101,-105,-1.5,195,3.59,Great American Ballpark,10,-2
2015-06-08,2015,STL,COL,3,11,-145,-1.5,105,10.5,100,-120,130,1.5,-125,6.21,Coors Field,14,-8
2015-06-08,2015,HOU,CWS,1,3,125,1.5,-195,7.0,-120,100,-140,-1.5,165,3.11,Guaranteed Rate Field,4,-2
2015-06-08,2015,CWS,HOU,3,1,-140,-1.5,165,7.0,-120,100,125,1.5,-195,4.08,Guaranteed Rate Field,4,2
2015-06-08,2015,MIN,KC,1,3,100,1.5,-170,8.5,100,-120,-110,-1.5,150,4.25,Target Field,4,-2
2015-06-08,2015,ARI,LAD,3,9,135,1.5,-175,7.0,-125,105,-150,-1.5,155,2.98,Dodger Stadium,12,-6
2015-06-08,2015,TOR,MIA,11,3,-172,-1.5,115,9.5,-116,-104,152,1.5,-135,6.01,Rogers Centre,14,8
2015-06-08,2015,PIT,MIL,0,2,-134,-1.5,160,7.5,-110,-110,119,1.5,-180,4.29,PNC Park,2,-2
2015-06-08,2015,KC,MIN,3,1,-110,-1.5,150,8.5,100,-120,100,1.5,-170,4.45,Target Field,4,2
2015-06-08,2015,CIN,PHI,6,4,-105,-1.5,195,7.0,-121,101,-105,1.5,-235,3.59,Great American Ballpark,10,2
2015-06-08,2015,MIL,PIT,2,0,119,1.5,-180,7.5,-110,-110,-134,-1.5,160,3.42,PNC Park,2,2
2015-06-08,2015,ATL,SD,3,5,-117,-1.5,180,7.5,-110,-110,107,1.5,-210,4.04,Turner Field,8,-2
2015-06-08,2015,COL,STL,11,3,130,1.5,-125,10.5,100,-120,-145,-1.5,105,4.57,Coors Field,14,8
2015-06-08,2015,MIA,TOR,3,11,152,1.5,-135,9.5,-116,-104,-172,-1.5,115,3.77,Rogers Centre,14,-8
2015-06-09,2015,LAD,ARI,3,1,-156,-1.5,145,7.5,107,-127,141,1.5,-165,4.57,Dodger Stadium,4,2
2015-06-09,2015,SD,ATL,5,6,-124,-1.5,140,7.0,-105,-115,114,1.5,-160,3.88,Turner Field,11,-1
2015-06-09,2015,BOS,BAL,0,1,-113,-1.5,140,8.0,-120,100,103,1.5,-160,4.24,Camden Yards,1,-1
2015-06-09,2015,BAL,BOS,1,0,103,1.5,-160,8.0,-120,100,-113,-1.5,140,3.94,Camden Yards,1,1
2015-06-09,2015,DET,CHC,6,0,-149,-1.5,140,8.5,-115,-105,134,1.5,-160,5.09,Comerica Park,6,6
2015-06-09,2015,PHI,CIN,2,11,125,1.5,-190,8.5,100,-120,-140,-1.5,160,3.78,Great American Ballpark,13,-9
2015-06-09,2015,SEA,CLE,3,2,170,1.5,-119,7.5,100,-120,-200,-1.5,-101,2.78,Progressive Field,5,1
2015-06-09,2015,STL,COL,3,4,-112,-1.5,135,10.0,-115,-105,102,1.5,-155,5.28,Coors Field,7,-1
2015-06-09,2015,HOU,CWS,2,4,-144,-1.5,115,8.5,-120,100,129,1.5,-135,5.02,Guaranteed Rate Field,6,-2
2015-06-09,2015,CHC,DET,0,6,134,1.5,-160,8.5,-115,-105,-149,-1.5,140,3.63,Comerica Park,6,-6
2015-06-09,2015,CWS,HOU,4,2,129,1.5,-135,8.5,-120,100,-144,-1.5,115,3.71,Guaranteed Rate Field,6,2
2015-06-09,2015,MIN,KC,0,2,102,1.5,-165,9.0,-105,-115,-112,-1.5,145,4.46,Target Field,2,-2
2015-06-09,2015,TB,LAA,2,8,106,1.5,-165,7.0,-120,100,-116,-1.5,145,3.4,Tropicana Field,10,-6
2015-06-09,2015,ARI,LAD,1,3,141,1.5,-165,7.5,107,-127,-156,-1.5,145,3.11,Dodger Stadium,4,-2
2015-06-09,2015,TOR,MIA,4,3,-147,-1.5,140,9.0,100,-120,132,1.5,-160,5.36,Rogers Centre,7,1
2015-06-09,2015,PIT,MIL,1,4,-183,-1.5,115,7.5,-125,105,163,1.5,-135,4.85,PNC Park,5,-3
2015-06-09,2015,KC,MIN,2,0,-112,-1.5,145,9.0,-105,-115,102,1.5,-165,4.75,Target Field,2,2
2015-06-09,2015,SF,NYM,5,0,107,1.5,-210,7.0,-113,-107,-117,-1.5,180,3.38,Citi Field,5,5
2015-06-09,2015,WSH,NYY,1,6,116,1.5,-195,7.5,-103,-117,-126,-1.5,165,3.47,Yankee Stadium,7,-5
2015-06-09,2015,TEX,OAK,2,1,173,1.5,-130,7.0,100,-120,-193,-1.5,110,2.56,Oakland Coliseum,3,1
2015-06-09,2015,CIN,PHI,11,2,-140,-1.5,160,8.5,100,-120,125,1.5,-190,4.96,Great American Ballpark,13,9
2015-06-09,2015,MIL,PIT,4,1,163,1.5,-135,7.5,-125,105,-183,-1.5,115,2.85,PNC Park,5,3
2015-06-09,2015,ATL,SD,6,5,114,1.5,-160,7.0,-105,-115,-124,-1.5,140,3.27,Turner Field,11,1
2015-06-09,2015,CLE,SEA,2,3,-200,-1.5,-101,7.5,100,-120,170,1.5,-119,5.0,Progressive Field,5,-1
2015-06-09,2015,NYM,SF,0,5,-117,-1.5,180,7.0,-113,-107,107,1.5,-210,3.77,Citi Field,5,-5
2015-06-09,2015,COL,STL,4,3,102,1.5,-155,10.0,-115,-105,-112,-1.5,135,4.95,Coors Field,7,1
2015-06-09,2015,LAA,TB,8,2,-116,-1.5,145,7.0,-120,100,106,1.5,-165,3.76,Tropicana Field,10,6
2015-06-09,2015,OAK,TEX,1,2,-193,-1.5,110,7.0,100,-120,173,1.5,-130,4.61,Oakland Coliseum,3,-1
2015-06-09,2015,MIA,TOR,3,4,132,1.5,-160,9.0,100,-120,-147,-1.5,140,3.88,Rogers Centre,7,-1
2015-06-09,2015,NYY,WSH,6,1,-126,-1.5,165,7.5,-103,-117,116,1.5,-195,4.18,Yankee Stadium,7,5
2015-06-10,2015,LAD,ARI,7,6,-182,-1.5,124,7.5,-101,-119,162,1.5,-144,4.84,Dodger Stadium,13,1
2015-06-10,2015,SD,ATL,1,4,-122,-1.5,135,7.0,-119,-101,112,1.5,-155,3.85,Turner Field,5,-3
2015-06-10,2015,BOS,BAL,2,5,-103,1.5,-210,8.5,-101,-119,-107,-1.5,180,4.31,Camden Yards,7,-3
2015-06-10,2015,BAL,BOS,5,2,-107,-1.5,180,8.5,-101,-119,-103,1.5,-210,4.39,Camden Yards,7,3
2015-06-10,2015,DET,CHC,3,12,101,1.5,-165,8.5,-115,-105,-111,-1.5,145,4.23,Comerica Park,15,-9
2015-06-10,2015,PHI,CIN,2,5,136,1.5,-160,9.0,-120,100,-151,-1.5,140,3.81,Great American Ballpark,7,-3
2015-06-10,2015,SEA,CLE,9,3,114,1.5,-180,9.0,-110,-110,-124,-1.5,160,4.21,Progressive Field,12,6
2015-06-10,2015,STL,COL,4,2,-154,-1.5,105,9.0,-125,105,139,1.5,-125,5.46,Coors Field,6,2
2015-06-10,2015,HOU,CWS,1,4,-104,1.5,-230,8.0,-116,-104,-106,-1.5,190,4.08,Guaranteed Rate Field,5,-3
2015-06-10,2015,CHC,DET,12,3,-111,-1.5,145,8.5,-115,-105,101,1.5,-165,4.47,Comerica Park,15,9
2015-06-10,2015,CWS,HOU,4,1,-106,-1.5,190,8.0,-116,-104,-104,1.5,-230,4.12,Guaranteed Rate Field,5,3
2015-06-10,2015,MIN,KC,2,7,-101,1.5,-165,7.5,-115,-105,-109,-1.5,145,3.77,Target Field,9,-5
2015-06-10,2015,TB,LAA,4,2,-123,-1.5,175,7.5,100,-120,113,1.5,-205,4.14,Tropicana Field,6,2
2015-06-10,2015,ARI,LAD,6,7,162,1.5,-144,7.5,-101,-119,-182,-1.5,124,2.86,Dodger Stadium,13,-1
2015-06-10,2015,TOR,MIA,7,2,-142,-1.5,135,9.0,-120,100,127,1.5,-155,5.28,Rogers Centre,9,5
2015-06-10,2015,PIT,MIL,2,0,-172,-1.5,125,8.0,-105,-115,152,1.5,-145,5.06,PNC Park,2,2
2015-06-10,2015,KC,MIN,7,2,-109,-1.5,145,7.5,-115,-105,-101,1.5,-165,3.91,Target Field,9,5
2015-06-10,2015,SF,NYM,8,5,145,1.5,-165,6.5,105,-125,-160,-1.5,145,2.65,Citi Field,13,3
2015-06-10,2015,WSH,NYY,5,4,117,1.5,-180,8.5,-112,-108,-127,-1.5,160,3.92,Yankee Stadium,9,1
2015-06-10,2015,TEX,OAK,4,5,126,1.5,-190,7.0,-115,-105,-141,-1.5,160,3.1,Oakland Coliseum,9,-1
2015-06-10,2015,CIN,PHI,5,2,-151,-1.5,140,9.0,-120,100,136,1.5,-160,5.41,Great American Ballpark,7,3
2015-06-10,2015,MIL,PIT,0,2,152,1.5,-145,8.0,-105,-115,-172,-1.5,125,3.17,PNC Park,2,-2
2015-06-10,2015,ATL,SD,4,1,112,1.5,-155,7.0,-119,-101,-122,-1.5,135,3.3,Turner Field,5,3
2015-06-10,2015,CLE,SEA,3,9,-124,-1.5,160,9.0,-110,-110,114,1.5,-180,4.98,Progressive Field,12,-6
2015-06-10,2015,NYM,SF,5,8,-160,-1.5,145,6.5,105,-125,145,1.5,-165,4.0,Citi Field,13,-3
2015-06-10,2015,COL,STL,2,4,139,1.5,-125,9.0,-125,105,-154,-1.5,105,3.77,Coors Field,6,-2
2015-06-10,2015,LAA,TB,2,4,113,1.5,-205,7.5,100,-120,-123,-1.5,175,3.52,Tropicana Field,6,-2
2015-06-10,2015,OAK,TEX,5,4,-141,-1.5,160,7.0,-115,-105,126,1.5,-190,4.1,Oakland Coliseum,9,1
2015-06-10,2015,MIA,TOR,2,7,127,1.5,-155,9.0,-120,100,-142,-1.5,135,3.96,Rogers Centre,9,-5
2015-06-10,2015,NYY,WSH,4,5,-127,-1.5,160,8.5,-112,-108,117,1.5,-180,4.76,Yankee Stadium,9,-1
2015-06-11,2015,SD,ATL,6,4,-113,-1.5,155,7.5,100,-120,103,1.5,-175,3.98,Turner Field,10,2
2015-06-11,2015,BOS,BAL,5,6,-105,-1.5,151,9.0,100,-120,-105,1.5,-171,4.61,Camden Yards,11,-1
2015-06-11,2015,BAL,BOS,6,5,-105,1.5,-171,9.0,100,-120,-105,-1.5,151,4.61,Camden Yards,11,1
2015-06-11,2015,CIN,CHC,3,6,148,1.5,-160,7.5,105,-125,-163,-1.5,140,3.02,Wrigley Field,9,-3
2015-06-11,2015,CHC,CIN,6,3,-163,-1.5,140,7.5,105,-125,148,1.5,-160,4.65,Wrigley Field,9,3
2015-06-11,2015,SEA,CLE,0,6,-106,-1.5,155,8.5,-115,-105,-104,1.5,-175,4.37,Progressive Field,6,-6
2015-06-11,2015,MIA,COL,6,0,-131,-1.5,165,8.0,-105,-115,116,1.5,-195,4.54,Marlins Park,6,6
2015-06-11,2015,TB,LAA,2,6,-102,1.5,-175,7.0,-105,-115,-108,-1.5,155,3.53,Tropicana Field,8,-4
2015-06-11,2015,COL,MIA,0,6,116,1.5,-195,8.0,-105,-115,-131,-1.5,165,3.7,Marlins Park,6,-6
2015-06-11,2015,WSH,MIL,5,6,-103,1.5,-230,8.5,100,-120,-107,-1.5,190,4.31,Miller Park,11,-1
2015-06-11,2015,SF,NYM,4,5,115,1.5,-205,8.5,-101,-119,-125,-1.5,175,3.95,Citi Field,9,-1
2015-06-11,2015,TEX,OAK,0,7,161,1.5,-150,7.5,100,-120,-181,-1.5,130,2.87,Oakland Coliseum,7,-7
2015-06-11,2015,ATL,SD,4,6,103,1.5,-175,7.5,100,-120,-113,-1.5,155,3.69,Turner Field,10,-2
2015-06-11,2015,CLE,SEA,6,0,-104,1.5,-175,8.5,-115,-105,-106,-1.5,155,4.33,Progressive Field,6,6
2015-06-11,2015,NYM,SF,5,4,-125,-1.5,175,8.5,-101,-119,115,1.5,-205,4.72,Citi Field,9,1
2015-06-11,2015,LAA,TB,6,2,-108,-1.5,155,7.0,-105,-115,-102,1.5,-175,3.63,Tropicana Field,8,4
2015-06-11,2015,OAK,TEX,7,0,-181,-1.5,130,7.5,100,-120,161,1.5,-150,4.83,Oakland Coliseum,7,7
2015-06-11,2015,MIL,WSH,6,5,-107,-1.5,190,8.5,100,-120,-103,1.5,-230,4.39,Miller Park,11,1
2015-06-12,2015,SF,ARI,0,1,-155,-1.5,152,6.5,-125,105,140,1.5,-172,3.95,AT&T Park,1,-1
2015-06-12,2015,NYM,ATL,5,3,-105,-1.5,190,7.0,-115,-105,-105,1.5,-230,3.59,Citi Field,8,2
2015-06-12,2015,NYY,BAL,3,11,-126,-1.5,125,8.0,100,-120,116,1.5,-145,4.46,Camden Yards,14,-8
2015-06-12,2015,TOR,BOS,13,10,-105,-1.5,150,9.0,-125,105,-105,1.5,-170,4.61,Fenway Park,23,3
2015-06-12,2015,CIN,CHC,5,4,117,1.5,-210,6.5,110,-130,-127,-1.5,180,3.0,Wrigley Field,9,1
2015-06-12,2015,CHC,CIN,4,5,-127,-1.5,180,6.5,110,-130,117,1.5,-210,3.64,Wrigley Field,9,-1
2015-06-12,2015,DET,CLE,4,0,-111,-1.5,180,8.0,100,-120,101,1.5,-210,4.21,Comerica Park,4,4
2015-06-12,2015,MIA,COL,5,1,-133,-1.5,160,8.0,-119,-101,118,1.5,-180,4.57,Marlins Park,6,4
2015-06-12,2015,TB,CWS,7,5,-153,-1.5,145,8.0,105,-125,138,1.5,-165,4.84,Tropicana Field,12,2
2015-06-12,2015,CLE,DET,0,4,101,1.5,-210,8.0,100,-120,-111,-1.5,180,3.98,Comerica Park,4,-4
2015-06-12,2015,SEA,HOU,0,10,-132,-1.5,125,7.5,-110,-110,117,1.5,-145,4.27,Minute Maid Park,10,-10
2015-06-12,2015,STL,KC,4,0,-124,-1.5,175,6.5,-115,-105,114,1.5,-205,3.6,Busch Stadium,4,4
2015-06-12,2015,OAK,LAA,4,5,103,1.5,-210,7.5,100,-120,-113,-1.5,180,3.69,Angel Stadium,9,-1
2015-06-12,2015,SD,LAD,3,4,177,1.5,103,6.5,-102,-118,-207,-1.5,-123,2.35,PETCO Park,7,-1
2015-06-12,2015,COL,MIA,1,5,118,1.5,-180,8.0,-119,-101,-133,-1.5,160,3.67,Marlins Park,6,-4
2015-06-12,2015,WSH,MIL,4,8,-105,-1.5,150,7.5,-115,-105,-105,1.5,-170,3.84,Miller Park,12,-4
2015-06-12,2015,TEX,MIN,6,2,-126,-1.5,160,9.0,-115,-105,116,1.5,-180,5.02,Rangers Ballpark,8,4
2015-06-12,2015,ATL,NYM,3,5,-105,1.5,-230,7.0,-115,-105,-105,-1.5,190,3.59,Citi Field,8,-2
2015-06-12,2015,BAL,NYY,11,3,116,1.5,-145,8.0,100,-120,-126,-1.5,125,3.7,Camden Yards,14,8
2015-06-12,2015,LAA,OAK,5,4,-113,-1.5,180,7.5,100,-120,103,1.5,-210,3.98,Angel Stadium,9,1
2015-06-12,2015,PIT,PHI,1,0,-233,-1.5,-101,8.0,-105,-115,203,1.5,-119,5.6,PNC Park,1,1
2015-06-12,2015,PHI,PIT,0,1,203,1.5,-119,8.0,-105,-115,-233,-1.5,-101,2.64,PNC Park,1,-1
2015-06-12,2015,LAD,SD,4,3,-207,-1.5,-123,6.5,-102,-118,177,1.5,103,4.38,PETCO Park,7,1
2015-06-12,2015,HOU,SEA,10,0,117,1.5,-145,7.5,-110,-110,-132,-1.5,125,3.46,Minute Maid Park,10,10
2015-06-12,2015,ARI,SF,1,0,140,1.5,-172,6.5,-125,105,-155,-1.5,152,2.71,AT&T Park,1,1
2015-06-12,2015,KC,STL,0,4,114,1.5,-205,6.5,-115,-105,-124,-1.5,175,3.04,Busch Stadium,4,-4
2015-06-12,2015,CWS,TB,5,7,138,1.5,-165,8.0,105,-125,-153,-1.5,145,3.36,Tropicana Field,12,-2
2015-06-12,2015,MIN,TEX,2,6,116,1.5,-180,9.0,-115,-105,-126,-1.5,160,4.17,Rangers Ballpark,8,-4
2015-06-12,2015,BOS,TOR,10,13,-105,1.5,-170,9.0,-125,105,-105,-1.5,150,4.61,Fenway Park,23,-3
2015-06-12,2015,MIL,WSH,8,4,-105,1.5,-170,7.5,-115,-105,-105,-1.5,150,3.84,Miller Park,12,4
2015-06-13,2015,SF,ARI,2,4,-140,-1.5,160,7.5,-115,-105,125,1.5,-180,4.38,AT&T Park,6,-2
2015-06-13,2015,NYM,ATL,3,5,-160,-1.5,150,7.5,110,-130,145,1.5,-170,4.62,Citi Field,8,-2
2015-06-13,2015,NYY,BAL,4,9,106,1.5,-200,8.5,-120,100,-116,-1.5,170,4.13,Camden Yards,13,-5
2015-06-13,2015,TOR,BOS,5,4,110,1.5,-190,9.5,-120,100,-120,-1.5,160,4.52,Fenway Park,9,1
2015-06-13,2015,CIN,CHC,3,4,130,1.5,-175,7.5,-115,-105,-145,-1.5,155,3.26,Wrigley Field,7,-1
2015-06-13,2015,CHC,CIN,4,3,-145,-1.5,155,7.5,-115,-105,130,1.5,-175,4.44,Wrigley Field,7,1
2015-06-13,2015,DET,CLE,4,5,106,1.5,-155,8.0,-115,-105,-116,-1.5,135,3.88,Comerica Park,9,-1
2015-06-13,2015,MIA,COL,4,1,-131,-1.5,160,7.5,-115,-105,116,1.5,-180,4.25,Marlins Park,5,3
2015-06-13,2015,TB,CWS,5,4,-180,-1.5,130,6.5,110,-130,160,1.5,-150,4.18,Tropicana Field,9,1
2015-06-13,2015,CLE,DET,5,4,-116,-1.5,135,8.0,-115,-105,106,1.5,-155,4.3,Comerica Park,9,1
2015-06-13,2015,SEA,HOU,8,1,118,1.5,-195,8.0,-120,100,-128,-1.5,165,3.67,Minute Maid Park,9,7
2015-06-13,2015,STL,KC,3,2,-141,-1.5,148,7.5,105,-125,126,1.5,-167,4.39,Busch Stadium,5,1
2015-06-13,2015,OAK,LAA,0,1,125,1.5,-175,8.0,-110,-110,-140,-1.5,155,3.56,Angel Stadium,1,-1
2015-06-13,2015,SD,LAD,2,1,145,1.5,-130,7.0,-105,-115,-160,-1.5,110,2.86,PETCO Park,3,1
2015-06-13,2015,COL,MIA,1,4,116,1.5,-180,7.5,-115,-105,-131,-1.5,160,3.47,Marlins Park,5,-3
2015-06-13,2015,WSH,MIL,7,2,109,1.5,-205,7.5,-120,100,-119,-1.5,175,3.59,Miller Park,9,5
2015-06-13,2015,TEX,MIN,11,7,-146,-1.5,150,9.0,-105,-115,131,1.5,-170,5.34,Rangers Ballpark,18,4
2015-06-13,2015,ATL,NYM,5,3,145,1.5,-170,7.5,110,-130,-160,-1.5,150,3.06,Citi Field,8,2
2015-06-13,2015,BAL,NYY,9,4,-116,-1.5,170,8.5,-120,100,106,1.5,-200,4.56,Camden Yards,13,5
2015-06-13,2015,LAA,OAK,1,0,-140,-1.5,155,8.0,-110,-110,125,1.5,-175,4.67,Angel Stadium,1,1
2015-06-13,2015,PIT,PHI,4,3,-291,-1.5,-135,7.5,-115,-105,251,1.5,115,5.58,PNC Park,7,1
2015-06-13,2015,PHI,PIT,3,4,251,1.5,115,7.5,-115,-105,-291,-1.5,-135,2.14,PNC Park,7,-1
2015-06-13,2015,LAD,SD,1,2,-160,-1.5,110,7.0,-105,-115,145,1.5,-130,4.31,PETCO Park,3,-1
2015-06-13,2015,HOU,SEA,1,8,-128,-1.5,165,8.0,-120,100,118,1.5,-195,4.49,Minute Maid Park,9,-7
2015-06-13,2015,ARI,SF,4,2,125,1.5,-180,7.5,-115,-105,-140,-1.5,160,3.33,AT&T Park,6,2
2015-06-13,2015,KC,STL,2,3,126,1.5,-167,7.5,105,-125,-141,-1.5,148,3.32,Busch Stadium,5,-1
2015-06-13,2015,CWS,TB,4,5,160,1.5,-150,6.5,110,-130,-180,-1.5,130,2.5,Tropicana Field,9,-1
2015-06-13,2015,MIN,TEX,7,11,131,1.5,-170,9.0,-105,-115,-146,-1.5,150,3.9,Rangers Ballpark,18,-4
2015-06-13,2015,BOS,TOR,4,5,-120,-1.5,160,9.5,-120,100,110,1.5,-190,5.18,Fenway Park,9,-1
2015-06-13,2015,MIL,WSH,2,7,-119,-1.5,175,7.5,-120,100,109,1.5,-205,4.08,Miller Park,9,-5
2015-06-14,2015,SF,ARI,0,4,-131,-1.5,165,7.0,-115,-105,116,1.5,-195,3.97,AT&T Park,4,-4
2015-06-14,2015,NYM,ATL,10,8,-119,-1.5,175,7.5,-112,-108,109,1.5,-205,4.08,Citi Field,18,2
2015-06-14,2015,NYY,BAL,5,3,110,1.5,-200,8.5,-127,107,-120,-1.5,170,4.05,Camden Yards,8,2
2015-06-14,2015,TOR,BOS,13,5,106,1.5,-202,9.0,100,-120,-116,-1.5,172,4.37,Fenway Park,18,8
2015-06-14,2015,CIN,CHC,1,2,135,1.5,-160,8.0,-110,-110,-150,-1.5,140,3.4,Wrigley Field,3,-1
2015-06-14,2015,CHC,CIN,2,1,-150,-1.5,140,8.0,-110,-110,135,1.5,-160,4.8,Wrigley Field,3,1
2015-06-14,2015,DET,CLE,8,1,149,1.5,-125,8.5,-101,-119,-164,-1.5,105,3.41,Comerica Park,9,7
2015-06-14,2015,MIA,COL,1,4,-127,-1.5,184,7.0,-119,-101,117,1.5,-214,3.92,Marlins Park,5,-3
2015-06-14,2015,TB,CWS,2,1,125,1.5,-145,6.5,-115,-105,-140,-1.5,125,2.89,Tropicana Field,3,1
2015-06-14,2015,CLE,DET,1,8,-164,-1.5,105,8.5,-101,-119,149,1.5,-125,5.28,Comerica Park,9,-7
2015-06-14,2015,SEA,HOU,0,13,115,1.5,-180,8.0,100,-120,-130,-1.5,160,3.72,Minute Maid Park,13,-13
2015-06-14,2015,OAK,LAA,8,1,-115,-1.5,145,7.0,101,-121,105,1.5,-165,3.74,Angel Stadium,9,7
2015-06-14,2015,SD,LAD,2,4,100,1.5,-175,7.0,-105,-115,-110,-1.5,155,3.5,PETCO Park,6,-2
2015-06-14,2015,COL,MIA,4,1,117,1.5,-214,7.0,-119,-101,-127,-1.5,184,3.23,Marlins Park,5,3
2015-06-14,2015,WSH,MIL,4,0,-156,-1.5,105,7.0,-119,-101,141,1.5,-125,4.27,Miller Park,4,4
2015-06-14,2015,TEX,MIN,3,4,-115,-1.5,175,9.0,-110,-110,105,1.5,-205,4.81,Rangers Ballpark,7,-1
2015-06-14,2015,ATL,NYM,8,10,109,1.5,-205,7.5,-112,-108,-119,-1.5,175,3.59,Citi Field,18,-2
2015-06-14,2015,BAL,NYY,3,5,-120,-1.5,170,8.5,-127,107,110,1.5,-200,4.64,Camden Yards,8,-2
2015-06-14,2015,LAA,OAK,1,8,105,1.5,-165,7.0,101,-121,-115,-1.5,145,3.41,Angel Stadium,9,-7
2015-06-14,2015,PIT,PHI,1,0,-141,-1.5,167,6.5,-120,100,126,1.5,-195,3.8,PNC Park,1,1
2015-06-14,2015,PHI,PIT,0,1,126,1.5,-195,6.5,-120,100,-141,-1.5,167,2.88,PNC Park,1,-1
2015-06-14,2015,LAD,SD,4,2,-110,-1.5,155,7.0,-105,-115,100,1.5,-175,3.67,PETCO Park,6,2
2015-06-14,2015,HOU,SEA,13,0,-130,-1.5,160,8.0,100,-120,115,1.5,-180,4.52,Minute Maid Park,13,13
2015-06-14,2015,ARI,SF,4,0,116,1.5,-195,7.0,-115,-105,-131,-1.5,165,3.24,AT&T Park,4,4
2015-06-14,2015,CWS,TB,1,2,-140,-1.5,125,6.5,-115,-105,125,1.5,-145,3.79,Tropicana Field,3,-1
2015-06-14,2015,MIN,TEX,4,3,105,1.5,-205,9.0,-110,-110,-115,-1.5,175,4.39,Rangers Ballpark,7,1
2015-06-14,2015,BOS,TOR,5,13,-116,-1.5,172,9.0,100,-120,106,1.5,-202,4.83,Fenway Park,18,-8
2015-06-14,2015,MIL,WSH,0,4,141,1.5,-125,7.0,-119,-101,-156,-1.5,105,2.9,Miller Park,4,-4
2015-06-15,2015,LAA,ARI,3,7,-149,-1.5,155,8.0,-105,-115,134,1.5,-175,4.79,Angel Stadium,10,-4
2015-06-15,2015,BOS,ATL,2,4,-172,-1.5,125,8.0,-105,-115,152,1.5,-145,5.06,Fenway Park,6,-2
2015-06-15,2015,PHI,BAL,0,4,221,1.5,100,8.0,-110,-110,-261,-1.5,-120,2.49,Camden Yards,4,-4
2015-06-15,2015,ATL,BOS,4,2,152,1.5,-145,8.0,-105,-115,-172,-1.5,125,3.17,Fenway Park,6,2
2015-06-15,2015,DET,CIN,6,0,-190,-1.5,110,9.0,100,-120,170,1.5,-130,5.9,Comerica Park,6,6
2015-06-15,2015,HOU,COL,6,3,-180,-1.5,125,7.5,110,-130,160,1.5,-145,4.82,Minute Maid Park,9,3
2015-06-15,2015,PIT,CWS,11,0,-202,-1.5,120,7.0,-110,-110,172,1.5,-140,4.68,PNC Park,11,11
2015-06-15,2015,CIN,DET,0,6,170,1.5,-130,9.0,100,-120,-190,-1.5,110,3.33,Comerica Park,6,-6
2015-06-15,2015,COL,HOU,3,6,160,1.5,-145,7.5,110,-130,-180,-1.5,125,2.88,Minute Maid Park,9,-3
2015-06-15,2015,MIL,KC,5,8,103,1.5,-165,7.5,-109,-111,-113,-1.5,145,3.69,Miller Park,13,-3
2015-06-15,2015,ARI,LAA,7,3,134,1.5,-175,8.0,-105,-115,-149,-1.5,155,3.42,Angel Stadium,10,4
2015-06-15,2015,TEX,LAD,4,1,101,1.5,-165,9.5,-110,-110,-111,-1.5,145,4.73,Rangers Ballpark,5,3
2015-06-15,2015,NYY,MIA,1,2,-141,-1.5,115,6.5,100,-120,126,1.5,-135,3.8,Marlins Park,3,-1
2015-06-15,2015,KC,MIL,8,5,-113,-1.5,145,7.5,-109,-111,103,1.5,-165,3.98,Miller Park,13,3
2015-06-15,2015,STL,MIN,3,2,-172,-1.5,135,7.0,110,-130,152,1.5,-155,4.43,Busch Stadium,5,1
2015-06-15,2015,TOR,NYM,3,4,110,1.5,-205,7.5,110,-130,-120,-1.5,175,3.57,Citi Field,7,-1
2015-06-15,2015,MIA,NYY,2,1,126,1.5,-135,6.5,100,-120,-141,-1.5,115,2.88,Marlins Park,3,1
2015-06-15,2015,SD,OAK,1,9,-115,-1.5,190,7.0,100,-120,105,1.5,-230,3.74,PETCO Park,10,-8
2015-06-15,2015,BAL,PHI,4,0,-261,-1.5,-120,8.0,-110,-110,221,1.5,100,5.78,Camden Yards,4,4
2015-06-15,2015,CWS,PIT,0,11,172,1.5,-140,7.0,-110,-110,-202,-1.5,120,2.57,PNC Park,11,-11
2015-06-15,2015,OAK,SD,9,1,105,1.5,-230,7.0,100,-120,-115,-1.5,190,3.41,PETCO Park,10,8
2015-06-15,2015,SF,SEA,1,5,-122,-1.5,180,7.0,-137,117,112,1.5,-210,3.85,AT&T Park,6,-4
2015-06-15,2015,SEA,SF,5,1,112,1.5,-210,7.0,-137,117,-122,-1.5,180,3.3,AT&T Park,6,4
2015-06-15,2015,MIN,STL,2,3,152,1.5,-155,7.0,110,-130,-172,-1.5,135,2.78,Busch Stadium,5,-1
2015-06-15,2015,WSH,TB,1,6,116,1.5,-210,7.0,100,-120,-126,-1.5,180,3.24,Tropicana Field,7,-5
2015-06-15,2015,LAD,TEX,1,4,-111,-1.5,145,9.5,-110,-110,101,1.5,-165,5.0,Rangers Ballpark,5,-3
2015-06-15,2015,NYM,TOR,4,3,-120,-1.5,175,7.5,110,-130,110,1.5,-205,4.09,Citi Field,7,1
2015-06-15,2015,TB,WSH,6,1,-126,-1.5,180,7.0,100,-120,116,1.5,-210,3.9,Tropicana Field,7,5
2015-06-16,2015,LAA,ARI,4,1,-191,-1.5,118,7.0,-120,100,171,1.5,-138,4.59,Angel Stadium,5,3
2015-06-16,2015,BOS,ATL,9,4,-156,-1.5,125,8.5,-114,-106,141,1.5,-145,5.18,Fenway Park,13,5
2015-06-16,2015,PHI,BAL,3,19,175,1.5,-130,8.5,-115,-105,-195,-1.5,110,3.09,Camden Yards,22,-16
2015-06-16,2015,ATL,BOS,4,9,141,1.5,-145,8.5,-114,-106,-156,-1.5,125,3.53,Fenway Park,13,-5
2015-06-16,2015,CLE,CHC,6,0,132,1.5,-190,6.0,-120,100,-147,-1.5,160,2.59,Wrigley Field,6,6
2015-06-16,2015,DET,CIN,2,5,-134,-1.5,150,8.5,-120,100,119,1.5,-170,4.87,Comerica Park,7,-3
2015-06-16,2015,CHC,CLE,0,6,-147,-1.5,160,6.0,-120,100,132,1.5,-190,3.57,Wrigley Field,6,-6
2015-06-16,2015,HOU,COL,8,5,-178,-1.5,115,8.5,100,-120,158,1.5,-135,5.44,Minute Maid Park,13,3
2015-06-16,2015,PIT,CWS,3,0,-158,-1.5,150,7.0,105,-125,143,1.5,-170,4.29,PNC Park,3,3
2015-06-16,2015,CIN,DET,5,2,119,1.5,-170,8.5,-120,100,-134,-1.5,150,3.88,Comerica Park,7,3
2015-06-16,2015,COL,HOU,5,8,158,1.5,-135,8.5,100,-120,-178,-1.5,115,3.29,Minute Maid Park,13,-3
2015-06-16,2015,MIL,KC,2,7,103,1.5,-165,7.0,-125,105,-113,-1.5,145,3.45,Miller Park,9,-5
2015-06-16,2015,ARI,LAA,1,4,171,1.5,-138,7.0,-120,100,-191,-1.5,118,2.58,Angel Stadium,5,-3
2015-06-16,2015,TEX,LAD,3,2,136,1.5,-132,9.5,100,-120,-151,-1.5,112,4.03,Rangers Ballpark,5,1
2015-06-16,2015,NYY,MIA,2,12,100,1.5,-215,7.5,100,-120,-110,-1.5,185,3.75,Marlins Park,14,-10
2015-06-16,2015,KC,MIL,7,2,-113,-1.5,145,7.0,-125,105,103,1.5,-165,3.71,Miller Park,9,5
2015-06-16,2015,STL,MIN,3,2,-170,-1.5,140,7.0,105,-125,150,1.5,-160,4.41,Busch Stadium,5,1
2015-06-16,2015,TOR,NYM,2,3,148,1.5,-160,7.0,-125,105,-163,-1.5,140,2.82,Citi Field,5,-1
2015-06-16,2015,MIA,NYY,12,2,-110,-1.5,185,7.5,100,-120,100,1.5,-215,3.93,Marlins Park,14,10
2015-06-16,2015,SD,OAK,5,6,105,1.5,-175,6.5,102,-122,-115,-1.5,155,3.17,PETCO Park,11,-1
2015-06-16,2015,BAL,PHI,19,3,-195,-1.5,110,8.5,-115,-105,175,1.5,-130,5.62,Camden Yards,22,16
2015-06-16,2015,CWS,PIT,0,3,143,1.5,-170,7.0,105,-125,-158,-1.5,150,2.88,PNC Park,3,-3
2015-06-16,2015,OAK,SD,6,5,-115,-1.5,155,6.5,102,-122,105,1.5,-175,3.48,PETCO Park,11,1
2015-06-16,2015,SF,SEA,6,2,113,1.5,-165,7.5,105,-125,-123,-1.5,145,3.52,AT&T Park,8,4
2015-06-16,2015,SEA,SF,2,6,-123,-1.5,145,7.5,105,-125,113,1.5,-165,4.14,AT&T Park,8,-4
2015-06-16,2015,MIN,STL,2,3,150,1.5,-160,7.0,105,-125,-170,-1.5,140,2.8,Busch Stadium,5,-1
2015-06-16,2015,WSH,TB,16,4,116,1.5,-200,7.0,-120,100,-126,-1.5,170,3.24,Tropicana Field,20,12
2015-06-16,2015,LAD,TEX,2,3,-151,-1.5,112,9.5,100,-120,136,1.5,-132,5.72,Rangers Ballpark,5,-1
2015-06-16,2015,NYM,TOR,3,2,-163,-1.5,140,7.0,-125,105,148,1.5,-160,4.34,Citi Field,5,1
2015-06-16,2015,TB,WSH,4,16,-126,-1.5,170,7.0,-120,100,116,1.5,-200,3.9,Tropicana Field,20,-12
2015-06-17,2015,LAA,ARI,2,3,115,1.5,-185,9.0,-110,-110,-130,-1.5,165,4.19,Chase Field,5,-1
2015-06-17,2015,BOS,ATL,2,5,102,1.5,-230,8.0,100,-120,-112,-1.5,190,3.96,Turner Field,7,-3
2015-06-17,2015,PHI,BAL,4,6,150,1.5,-119,7.5,-110,-110,-170,-1.5,-101,3.0,Citizens Bank Park,10,-2
2015-06-17,2015,ATL,BOS,5,2,-112,-1.5,190,8.0,100,-120,102,1.5,-230,4.23,Turner Field,7,3
2015-06-17,2015,CLE,CHC,0,17,-122,-1.5,170,9.0,-105,-115,112,1.5,-200,4.95,Progressive Field,17,-17
2015-06-17,2015,DET,CIN,4,8,-105,-1.5,155,6.5,-110,-110,-105,1.5,-175,3.33,Great American Ballpark,12,-4
2015-06-17,2015,CHC,CLE,17,0,112,1.5,-200,9.0,-105,-115,-122,-1.5,170,4.25,Progressive Field,17,17
2015-06-17,2015,HOU,COL,8,4,-106,-1.5,135,10.5,-120,100,-104,1.5,-155,5.4,Coors Field,12,4
2015-06-17,2015,PIT,CWS,3,2,-118,-1.5,140,9.0,-105,-115,108,1.5,-160,4.87,Guaranteed Rate Field,5,1
2015-06-17,2015,CIN,DET,8,4,-105,1.5,-175,6.5,-110,-110,-105,-1.5,155,3.33,Great American Ballpark,12,4
2015-06-17,2015,COL,HOU,4,8,-104,1.5,-155,10.5,-120,100,-106,-1.5,135,5.35,Coors Field,12,-4
2015-06-17,2015,MIL,KC,2,10,128,1.5,-190,7.5,-120,100,-143,-1.5,160,3.29,Kauffman Stadium,12,-8
2015-06-17,2015,ARI,LAA,3,2,-130,-1.5,165,9.0,-110,-110,115,1.5,-185,5.09,Chase Field,5,1
2015-06-17,2015,TEX,LAD,5,3,247,1.5,-110,6.5,105,-125,-287,-1.5,-110,1.87,Dodger Stadium,8,2
2015-06-17,2015,NYY,MIA,2,1,-206,-1.5,-101,7.5,-115,-105,176,1.5,-119,5.05,Yankee Stadium,3,1
2015-06-17,2015,KC,MIL,10,2,-143,-1.5,160,7.5,-120,100,128,1.5,-190,4.41,Kauffman Stadium,12,8
2015-06-17,2015,STL,MIN,1,3,-145,-1.5,115,8.0,-110,-110,130,1.5,-135,4.73,Target Field,4,-2
2015-06-17,2015,TOR,NYM,8,0,-197,-1.5,105,9.0,100,-120,177,1.5,-125,5.97,Rogers Centre,8,8
2015-06-17,2015,MIA,NYY,1,2,176,1.5,-119,7.5,-115,-105,-206,-1.5,-101,2.72,Yankee Stadium,3,-1
2015-06-17,2015,SD,OAK,2,16,155,1.5,-140,7.0,-115,-105,-175,-1.5,120,2.75,Oakland Coliseum,18,-14
2015-06-17,2015,BAL,PHI,6,4,-170,-1.5,-101,7.5,-110,-110,150,1.5,-119,4.72,Citizens Bank Park,10,2
2015-06-17,2015,CWS,PIT,2,3,108,1.5,-160,9.0,-105,-115,-118,-1.5,140,4.33,Guaranteed Rate Field,5,-1
2015-06-17,2015,OAK,SD,16,2,-175,-1.5,120,7.0,-115,-105,155,1.5,-140,4.45,Oakland Coliseum,18,14
2015-06-17,2015,SF,SEA,0,2,118,1.5,-205,6.0,-101,-119,-133,-1.5,175,2.75,T-Mobile Park,2,-2
2015-06-17,2015,SEA,SF,2,0,-133,-1.5,175,6.0,-101,-119,118,1.5,-205,3.42,T-Mobile Park,2,2
2015-06-17,2015,MIN,STL,3,1,130,1.5,-135,8.0,-110,-110,-145,-1.5,115,3.48,Target Field,4,2
2015-06-17,2015,WSH,TB,0,5,-143,-1.5,155,7.5,-101,-119,128,1.5,-175,4.41,Nationals Park,5,-5
2015-06-17,2015,LAD,TEX,3,5,-287,-1.5,-110,6.5,105,-125,247,1.5,-110,4.82,Dodger Stadium,8,-2
2015-06-17,2015,NYM,TOR,0,8,177,1.5,-125,9.0,100,-120,-197,-1.5,105,3.25,Rogers Centre,8,-8
2015-06-17,2015,TB,WSH,5,0,128,1.5,-175,7.5,-101,-119,-143,-1.5,155,3.29,Nationals Park,5,5
2015-06-18,2015,LAA,ARI,7,1,-109,-1.5,145,9.0,-115,-105,-101,1.5,-165,4.69,Chase Field,8,6
2015-06-18,2015,BOS,ATL,5,2,-114,-1.5,144,7.0,101,-121,104,1.5,-163,3.73,Turner Field,7,3
2015-06-18,2015,PHI,BAL,2,1,150,1.5,-115,8.0,-101,-119,-170,-1.5,-105,3.2,Citizens Bank Park,3,1
2015-06-18,2015,ATL,BOS,2,5,104,1.5,-163,7.0,101,-121,-114,-1.5,144,3.43,Turner Field,7,-3
2015-06-18,2015,CLE,CHC,4,3,-145,-1.5,155,7.5,-115,-105,130,1.5,-175,4.44,Progressive Field,7,1
2015-06-18,2015,CHC,CLE,3,4,130,1.5,-175,7.5,-115,-105,-145,-1.5,155,3.26,Progressive Field,7,-1
2015-06-18,2015,HOU,COL,8,4,-111,-1.5,130,10.5,-120,100,101,1.5,-150,5.52,Coors Field,12,4
2015-06-18,2015,PIT,CWS,3,2,-123,-1.5,130,7.0,-110,-110,113,1.5,-150,3.86,Guaranteed Rate Field,5,1
2015-06-18,2015,COL,HOU,4,8,101,1.5,-150,10.5,-120,100,-111,-1.5,130,5.22,Coors Field,12,-4
2015-06-18,2015,MIL,KC,2,3,127,1.5,-175,8.0,-110,-110,-142,-1.5,155,3.52,Kauffman Stadium,5,-1
2015-06-18,2015,ARI,LAA,1,7,-101,1.5,-165,9.0,-115,-105,-109,-1.5,145,4.52,Chase Field,8,-6
2015-06-18,2015,TEX,LAD,0,1,225,1.5,102,7.5,-105,-115,-265,-1.5,-122,2.31,Dodger Stadium,1,-1
2015-06-18,2015,NYY,MIA,9,4,-132,-1.5,155,8.0,100,-120,117,1.5,-175,4.55,Yankee Stadium,13,5
2015-06-18,2015,KC,MIL,3,2,-142,-1.5,155,8.0,-110,-110,127,1.5,-175,4.69,Kauffman Stadium,5,1
2015-06-18,2015,STL,MIN,1,2,-122,-1.5,135,8.0,100,-120,112,1.5,-155,4.4,Target Field,3,-1
2015-06-18,2015,TOR,NYM,7,1,-152,-1.5,140,9.0,-105,-115,137,1.5,-160,5.43,Rogers Centre,8,6
2015-06-18,2015,MIA,NYY,4,9,117,1.5,-175,8.0,100,-120,-132,-1.5,155,3.69,Yankee Stadium,13,-5
2015-06-18,2015,SD,OAK,3,1,115,1.5,-195,7.5,-115,-105,-130,-1.5,165,3.49,Oakland Coliseum,4,2
2015-06-18,2015,BAL,PHI,1,2,-170,-1.5,-105,8.0,-101,-119,150,1.5,-115,5.04,Citizens Bank Park,3,-1
2015-06-18,2015,CWS,PIT,2,3,113,1.5,-150,7.0,-110,-110,-123,-1.5,130,3.29,Guaranteed Rate Field,5,-1
2015-06-18,2015,OAK,SD,1,3,-130,-1.5,165,7.5,-115,-105,115,1.5,-195,4.24,Oakland Coliseum,4,-2
2015-06-18,2015,SF,SEA,7,0,135,1.5,-165,7.5,-120,100,-150,-1.5,145,3.19,T-Mobile Park,7,7
2015-06-18,2015,SEA,SF,0,7,-150,-1.5,145,7.5,-120,100,135,1.5,-165,4.5,T-Mobile Park,7,-7
2015-06-18,2015,MIN,STL,2,1,112,1.5,-155,8.0,100,-120,-122,-1.5,135,3.77,Target Field,3,1
2015-06-18,2015,WSH,TB,3,5,-101,1.5,-170,7.0,105,-125,-109,-1.5,150,3.52,Nationals Park,8,-2
2015-06-18,2015,LAD,TEX,1,0,-265,-1.5,-122,7.5,-105,-115,225,1.5,102,5.45,Dodger Stadium,1,1
2015-06-18,2015,NYM,TOR,1,7,137,1.5,-160,9.0,-105,-115,-152,-1.5,140,3.8,Rogers Centre,8,-6
2015-06-18,2015,TB,WSH,5,3,-109,-1.5,150,7.0,105,-125,-101,1.5,-170,3.65,Nationals Park,8,2
2015-06-19,2015,SD,ARI,2,4,-111,-1.5,145,8.0,-105,-115,101,1.5,-165,4.21,Chase Field,6,-2
2015-06-19,2015,NYM,ATL,1,2,-149,-1.5,115,6.5,-125,105,134,1.5,-135,3.89,Turner Field,3,-1
2015-06-19,2015,TOR,BAL,5,4,-108,-1.5,180,8.5,-120,100,-102,1.5,-210,4.41,Rogers Centre,9,1
2015-06-19,2015,KC,BOS,3,7,-101,1.5,-170,7.5,-105,-115,-109,-1.5,150,3.77,Kauffman Stadium,10,-4
2015-06-19,2015,MIN,CHC,7,2,106,1.5,-160,8.5,100,-120,-116,-1.5,140,4.13,Target Field,9,5
2015-06-19,2015,MIA,CIN,0,5,117,1.5,-200,8.0,-110,-110,-127,-1.5,170,3.69,Great American Ballpark,5,-5
2015-06-19,2015,TB,CLE,4,1,151,1.5,-140,7.0,-105,-115,-171,-1.5,120,2.79,Progressive Field,5,3
2015-06-19,2015,MIL,COL,9,5,128,1.5,-155,10.5,-115,-105,-143,-1.5,135,4.61,Coors Field,14,4
2015-06-19,2015,TEX,CWS,2,1,170,1.5,-135,7.0,111,-131,-200,-1.5,115,2.59,Guaranteed Rate Field,3,1
2015-06-19,2015,NYY,DET,7,2,102,1.5,-170,8.5,100,-120,-112,-1.5,150,4.21,Yankee Stadium,9,5
2015-06-19,2015,SEA,HOU,5,2,-101,1.5,-175,7.0,-105,-115,-109,-1.5,155,3.52,T-Mobile Park,7,3
2015-06-19,2015,BOS,KC,7,3,-109,-1.5,150,7.5,-105,-115,-101,1.5,-170,3.91,Kauffman Stadium,10,4
2015-06-19,2015,OAK,LAA,7,12,-161,-1.5,135,7.0,-105,-115,146,1.5,-155,4.32,Oakland Coliseum,19,-5
2015-06-19,2015,SF,LAD,9,5,131,1.5,-175,7.0,-125,105,-146,-1.5,155,3.03,Dodger Stadium,14,4
2015-06-19,2015,CIN,MIA,5,0,-127,-1.5,170,8.0,-110,-110,117,1.5,-200,4.48,Great American Ballpark,5,5
2015-06-19,2015,COL,MIL,5,9,-143,-1.5,135,10.5,-115,-105,128,1.5,-155,6.18,Coors Field,14,-4
2015-06-19,2015,CHC,MIN,2,7,-116,-1.5,140,8.5,100,-120,106,1.5,-160,4.56,Target Field,9,-5
2015-06-19,2015,ATL,NYM,2,1,134,1.5,-135,6.5,-125,105,-149,-1.5,115,2.78,Turner Field,3,1
2015-06-19,2015,DET,NYY,2,7,-112,-1.5,150,8.5,100,-120,102,1.5,-170,4.49,Yankee Stadium,9,-5
2015-06-19,2015,LAA,OAK,12,7,146,1.5,-155,7.0,-105,-115,-161,-1.5,135,2.85,Oakland Coliseum,19,5
2015-06-19,2015,STL,PHI,12,4,-200,-1.5,-120,7.5,-110,-110,170,1.5,100,5.0,Citizens Bank Park,16,8
2015-06-19,2015,WSH,PIT,4,1,117,1.5,-155,7.0,-120,100,-127,-1.5,135,3.23,Nationals Park,5,3
2015-06-19,2015,ARI,SD,4,2,101,1.5,-165,8.0,-105,-115,-111,-1.5,145,3.98,Chase Field,6,2
2015-06-19,2015,HOU,SEA,2,5,-109,-1.5,155,7.0,-105,-115,-101,1.5,-175,3.65,T-Mobile Park,7,-3
2015-06-19,2015,LAD,SF,5,9,-146,-1.5,155,7.0,-125,105,131,1.5,-175,4.15,Dodger Stadium,14,-4
2015-06-19,2015,PHI,STL,4,12,170,1.5,100,7.5,-110,-110,-200,-1.5,-120,2.78,Citizens Bank Park,16,-8
2015-06-19,2015,CLE,TB,1,4,-171,-1.5,120,7.0,-105,-115,151,1.5,-140,4.42,Progressive Field,5,-3
2015-06-19,2015,CWS,TEX,1,2,-200,-1.5,115,7.0,111,-131,170,1.5,-135,4.67,Guaranteed Rate Field,3,-1
2015-06-19,2015,BAL,TOR,4,5,-102,1.5,-210,8.5,-120,100,-108,-1.5,180,4.29,Rogers Centre,9,-1
2015-06-19,2015,PIT,WSH,1,4,-127,-1.5,135,7.0,-120,100,117,1.5,-155,3.92,Nationals Park,5,-3
2015-06-20,2015,SD,ARI,8,1,-114,-1.5,140,8.0,100,-120,104,1.5,-160,4.26,Chase Field,9,7
2015-06-20,2015,NYM,ATL,4,6,-125,-1.5,130,7.0,-105,-115,115,1.5,-150,3.89,Turner Field,10,-2
2015-06-20,2015,TOR,BAL,3,5,-111,-1.5,170,8.5,-110,-110,101,1.5,-200,4.47,Rogers Centre,8,-2
2015-06-20,2015,KC,BOS,7,4,-120,-1.5,175,8.5,-115,-105,110,1.5,-205,4.64,Kauffman Stadium,11,3
2015-06-20,2015,MIN,CHC,1,4,-105,1.5,-170,8.0,-120,100,-105,-1.5,150,4.1,Target Field,5,-3
2015-06-20,2015,MIA,CIN,5,0,117,1.5,-185,8.5,100,-120,-132,-1.5,165,3.92,Great American Ballpark,5,5
2015-06-20,2015,TB,CLE,4,1,165,1.5,-140,7.0,100,-120,-185,-1.5,120,2.64,Progressive Field,5,3
2015-06-20,2015,MIL,COL,1,5,116,1.5,-165,10.5,-105,-115,-131,-1.5,145,4.86,Coors Field,6,-4
2015-06-20,2015,TEX,CWS,2,3,145,1.5,-155,8.5,-102,-118,-160,-1.5,135,3.47,Guaranteed Rate Field,5,-1
2015-06-20,2015,NYY,DET,14,3,-140,-1.5,145,8.5,100,-120,125,1.5,-165,4.96,Yankee Stadium,17,11
2015-06-20,2015,SEA,HOU,6,3,112,1.5,-155,6.5,-105,-115,-122,-1.5,135,3.07,T-Mobile Park,9,3
2015-06-20,2015,BOS,KC,4,7,110,1.5,-205,8.5,-115,-105,-120,-1.5,175,4.05,Kauffman Stadium,11,-3
2015-06-20,2015,OAK,LAA,4,1,-134,-1.5,165,8.0,-115,-105,119,1.5,-185,4.58,Oakland Coliseum,5,3
2015-06-20,2015,SF,LAD,6,2,138,1.5,-165,8.0,-120,100,-153,-1.5,145,3.36,Dodger Stadium,8,4
2015-06-20,2015,CIN,MIA,0,5,-132,-1.5,165,8.5,100,-120,117,1.5,-185,4.84,Great American Ballpark,5,-5
2015-06-20,2015,COL,MIL,5,1,-131,-1.5,145,10.5,-105,-115,116,1.5,-165,5.95,Coors Field,6,4
2015-06-20,2015,CHC,MIN,4,1,-105,-1.5,150,8.0,-120,100,-105,1.5,-170,4.1,Target Field,5,3
2015-06-20,2015,ATL,NYM,6,4,115,1.5,-150,7.0,-105,-115,-125,-1.5,130,3.26,Turner Field,10,2
2015-06-20,2015,DET,NYY,3,14,125,1.5,-165,8.5,100,-120,-140,-1.5,145,3.78,Yankee Stadium,17,-11
2015-06-20,2015,LAA,OAK,1,4,119,1.5,-185,8.0,-115,-105,-134,-1.5,165,3.65,Oakland Coliseum,5,-3
2015-06-20,2015,STL,PHI,10,1,-150,-1.5,115,7.5,110,-130,135,1.5,-135,4.5,Citizens Bank Park,11,9
2015-06-20,2015,WSH,PIT,6,0,-144,-1.5,164,6.5,100,-120,129,1.5,-184,3.84,Nationals Park,6,6
2015-06-20,2015,ARI,SD,1,8,104,1.5,-160,8.0,100,-120,-114,-1.5,140,3.92,Chase Field,9,-7
2015-06-20,2015,HOU,SEA,3,6,-122,-1.5,135,6.5,-105,-115,112,1.5,-155,3.57,T-Mobile Park,9,-3
2015-06-20,2015,LAD,SF,2,6,-153,-1.5,145,8.0,-120,100,138,1.5,-165,4.84,Dodger Stadium,8,-4
2015-06-20,2015,PHI,STL,1,10,135,1.5,-135,7.5,110,-130,-150,-1.5,115,3.19,Citizens Bank Park,11,-9
2015-06-20,2015,CLE,TB,1,4,-185,-1.5,120,7.0,100,-120,165,1.5,-140,4.54,Progressive Field,5,-3
2015-06-20,2015,CWS,TEX,3,2,-160,-1.5,135,8.5,-102,-118,145,1.5,-155,5.23,Guaranteed Rate Field,5,1
2015-06-20,2015,BAL,TOR,5,3,101,1.5,-200,8.5,-110,-110,-111,-1.5,170,4.23,Rogers Centre,8,2
2015-06-20,2015,PIT,WSH,0,6,129,1.5,-184,6.5,100,-120,-144,-1.5,164,2.84,Nationals Park,6,-6
2015-06-21,2015,SD,ARI,2,7,-113,-1.5,145,8.5,-105,-115,103,1.5,-165,4.51,Chase Field,9,-5
2015-06-21,2015,NYM,ATL,0,1,-128,-1.5,135,6.5,-125,105,118,1.5,-155,3.65,Turner Field,1,-1
2015-06-21,2015,TOR,BAL,9,13,-125,-1.5,165,9.0,-110,-110,115,1.5,-185,5.0,Rogers Centre,22,-4
2015-06-21,2015,KC,BOS,2,13,-107,-1.5,185,8.0,-123,103,-103,1.5,-215,4.14,Kauffman Stadium,15,-11
2015-06-21,2015,MIN,CHC,0,8,119,1.5,-140,8.0,-120,100,-134,-1.5,120,3.65,Target Field,8,-8
2015-06-21,2015,MIA,CIN,2,5,108,1.5,-205,9.0,100,-120,-118,-1.5,175,4.33,Great American Ballpark,7,-3
2015-06-21,2015,TB,CLE,0,1,109,1.5,-200,8.5,-105,-115,-119,-1.5,170,4.07,Progressive Field,1,-1
2015-06-21,2015,MIL,COL,4,10,106,1.5,-185,11.0,-125,105,-116,-1.5,165,5.34,Coors Field,14,-6
2015-06-21,2015,TEX,CWS,2,3,116,1.5,-200,8.0,101,-121,-126,-1.5,170,3.7,Guaranteed Rate Field,5,-1
2015-06-21,2015,NYY,DET,4,12,-150,-1.5,140,7.5,-120,100,135,1.5,-160,4.5,Yankee Stadium,16,-8
2015-06-21,2015,SEA,HOU,2,6,-114,-1.5,185,7.5,-104,-116,104,1.5,-215,4.0,T-Mobile Park,8,-4
2015-06-21,2015,BOS,KC,13,2,-103,1.5,-215,8.0,-123,103,-107,-1.5,185,4.06,Kauffman Stadium,15,11
2015-06-21,2015,OAK,LAA,3,2,-107,-1.5,185,7.5,105,-125,-103,1.5,-215,3.88,Oakland Coliseum,5,1
2015-06-21,2015,SF,LAD,2,10,152,1.5,-145,8.0,-101,-119,-172,-1.5,125,3.17,Dodger Stadium,12,-8
2015-06-21,2015,CIN,MIA,5,2,-118,-1.5,175,9.0,100,-120,108,1.5,-205,4.87,Great American Ballpark,7,3
2015-06-21,2015,COL,MIL,10,4,-116,-1.5,165,11.0,-125,105,106,1.5,-185,5.91,Coors Field,14,6
2015-06-21,2015,CHC,MIN,8,0,-134,-1.5,120,8.0,-120,100,119,1.5,-140,4.58,Target Field,8,8
2015-06-21,2015,ATL,NYM,1,0,118,1.5,-155,6.5,-125,105,-128,-1.5,135,2.98,Turner Field,1,1
2015-06-21,2015,DET,NYY,12,4,135,1.5,-160,7.5,-120,100,-150,-1.5,140,3.19,Yankee Stadium,16,8
2015-06-21,2015,LAA,OAK,2,3,-103,1.5,-215,7.5,105,-125,-107,-1.5,185,3.81,Oakland Coliseum,5,-1
2015-06-21,2015,STL,PHI,2,9,-195,-1.5,-130,8.0,-120,100,175,1.5,110,5.29,Citizens Bank Park,11,-7
2015-06-21,2015,WSH,PIT,9,2,-110,-1.5,185,8.0,-115,-105,100,1.5,-215,4.19,Nationals Park,11,7
2015-06-21,2015,ARI,SD,7,2,103,1.5,-165,8.5,-105,-115,-113,-1.5,145,4.19,Chase Field,9,5
2015-06-21,2015,HOU,SEA,6,2,104,1.5,-215,7.5,-104,-116,-114,-1.5,185,3.68,T-Mobile Park,8,4
2015-06-21,2015,LAD,SF,10,2,-172,-1.5,125,8.0,-101,-119,152,1.5,-145,5.06,Dodger Stadium,12,8
2015-06-21,2015,PHI,STL,9,2,175,1.5,110,8.0,-120,100,-195,-1.5,-130,2.91,Citizens Bank Park,11,7
2015-06-21,2015,CLE,TB,1,0,-119,-1.5,170,8.5,-105,-115,109,1.5,-200,4.62,Progressive Field,1,1
2015-06-21,2015,CWS,TEX,3,2,-126,-1.5,170,8.0,101,-121,116,1.5,-200,4.46,Guaranteed Rate Field,5,1
2015-06-21,2015,BAL,TOR,13,9,115,1.5,-185,9.0,-110,-110,-125,-1.5,165,4.19,Rogers Centre,22,4
2015-06-21,2015,PIT,WSH,2,9,100,1.5,-215,8.0,-115,-105,-110,-1.5,185,4.0,Nationals Park,11,-7
2015-06-22,2015,LAD,CHC,2,4,-190,-1.5,-119,8.5,-110,-110,170,1.5,-101,5.57,Wrigley Field,6,-2
2015-06-22,2015,DET,CLE,8,5,130,1.5,-170,9.0,105,-125,-145,-1.5,150,3.91,Progressive Field,13,3
2015-06-22,2015,MIN,CWS,13,2,-134,-1.5,150,9.0,-115,-105,119,1.5,-170,5.15,Target Field,15,11
2015-06-22,2015,CLE,DET,5,8,-145,-1.5,150,9.0,105,-125,130,1.5,-170,5.33,Progressive Field,13,-3
2015-06-22,2015,LAA,HOU,4,3,-119,-1.5,170,8.0,-115,-105,109,1.5,-200,4.35,Angel Stadium,7,1
2015-06-22,2015,SEA,KC,1,4,-148,-1.5,145,6.5,-105,-115,133,1.5,-165,3.88,T-Mobile Park,5,-3
2015-06-22,2015,HOU,LAA,3,4,109,1.5,-200,8.0,-115,-105,-119,-1.5,170,3.83,Angel Stadium,7,-1
2015-06-22,2015,CHC,LAD,4,2,170,1.5,-101,8.5,-110,-110,-190,-1.5,-119,3.15,Wrigley Field,6,2
2015-06-22,2015,CWS,MIN,2,13,119,1.5,-170,9.0,-115,-105,-134,-1.5,150,4.11,Target Field,15,-11
2015-06-22,2015,PHI,NYY,11,8,250,1.5,115,8.0,-120,100,-290,-1.5,-135,2.29,Yankee Stadium,19,3
2015-06-22,2015,NYY,PHI,8,11,-290,-1.5,-135,8.0,-120,100,250,1.5,115,5.95,Yankee Stadium,19,-3
2015-06-22,2015,KC,SEA,4,1,133,1.5,-165,6.5,-105,-115,-148,-1.5,145,2.79,T-Mobile Park,5,3
2015-06-22,2015,TOR,TB,8,5,119,1.5,-200,7.0,-120,100,-129,-1.5,170,3.2,Tropicana Field,13,3
2015-06-22,2015,TB,TOR,5,8,-129,-1.5,170,7.0,-120,100,119,1.5,-200,3.94,Tropicana Field,13,-3
2015-06-23,2015,COL,ARI,10,5,115,1.5,-135,10.5,-105,-115,-125,-1.5,115,4.88,Coors Field,15,5
2015-06-23,2015,WSH,ATL,3,1,-170,-1.5,135,7.5,105,-125,150,1.5,-155,4.72,Nationals Park,4,2
2015-06-23,2015,BOS,BAL,4,6,-115,-1.5,165,9.0,-128,108,105,1.5,-195,4.81,Fenway Park,10,-2
2015-06-23,2015,BAL,BOS,6,4,105,1.5,-195,9.0,-128,108,-115,-1.5,165,4.39,Fenway Park,10,2
2015-06-23,2015,LAD,CHC,0,1,-143,-1.5,130,7.0,-105,-115,128,1.5,-150,4.12,Wrigley Field,1,-1
2015-06-23,2015,PIT,CIN,7,6,-155,-1.5,145,7.5,-115,-105,140,1.5,-165,4.56,PNC Park,13,1
2015-06-23,2015,DET,CLE,7,3,101,1.5,-210,7.0,105,-125,-111,-1.5,181,3.48,Progressive Field,10,4
2015-06-23,2015,ARI,COL,5,10,-125,-1.5,115,10.5,-105,-115,115,1.5,-135,5.83,Coors Field,15,-5
2015-06-23,2015,MIN,CWS,2,6,101,1.5,-170,7.5,-117,-103,-111,-1.5,150,3.73,Target Field,8,-4
2015-06-23,2015,CLE,DET,3,7,-111,-1.5,181,7.0,105,-125,101,1.5,-210,3.68,Progressive Field,10,-4
2015-06-23,2015,LAA,HOU,3,13,-113,-1.5,180,8.0,-105,-115,103,1.5,-210,4.24,Angel Stadium,16,-10
2015-06-23,2015,SEA,KC,7,0,-119,-1.5,175,7.5,-110,-110,109,1.5,-205,4.08,T-Mobile Park,7,7
2015-06-23,2015,HOU,LAA,13,3,103,1.5,-210,8.0,-105,-115,-113,-1.5,180,3.94,Angel Stadium,16,10
2015-06-23,2015,CHC,LAD,1,0,128,1.5,-150,7.0,-105,-115,-143,-1.5,130,3.07,Wrigley Field,1,1
2015-06-23,2015,STL,MIA,4,3,-132,-1.5,125,6.5,-110,-110,117,1.5,-145,3.7,Marlins Park,7,1
2015-06-23,2015,NYM,MIL,2,3,135,1.5,-165,7.5,-120,100,-150,-1.5,145,3.19,Miller Park,5,-1
2015-06-23,2015,CWS,MIN,6,2,-111,-1.5,150,7.5,-117,-103,101,1.5,-170,3.95,Target Field,8,4
2015-06-23,2015,MIL,NYM,3,2,-150,-1.5,145,7.5,-120,100,135,1.5,-165,4.5,Miller Park,5,1
2015-06-23,2015,PHI,NYY,11,6,250,1.5,115,9.5,-120,100,-300,-1.5,-135,2.71,Yankee Stadium,17,5
2015-06-23,2015,TEX,OAK,6,8,115,1.5,-150,8.5,-120,100,-130,-1.5,130,3.95,Rangers Ballpark,14,-2
2015-06-23,2015,NYY,PHI,6,11,-300,-1.5,-135,9.5,-120,100,250,1.5,115,7.13,Yankee Stadium,17,-5
2015-06-23,2015,CIN,PIT,6,7,140,1.5,-165,7.5,-115,-105,-155,-1.5,145,3.13,PNC Park,13,-1
2015-06-23,2015,SF,SD,2,3,-183,-1.5,125,6.5,-105,-115,163,1.5,-145,4.2,AT&T Park,5,-1
2015-06-23,2015,KC,SEA,0,7,109,1.5,-205,7.5,-110,-110,-119,-1.5,175,3.59,T-Mobile Park,7,-7
2015-06-23,2015,SD,SF,3,2,163,1.5,-145,6.5,-105,-115,-183,-1.5,125,2.47,AT&T Park,5,1
2015-06-23,2015,MIA,STL,3,4,117,1.5,-145,6.5,-110,-110,-132,-1.5,125,3.0,Marlins Park,7,-1
2015-06-23,2015,TOR,TB,3,4,150,1.5,-155,7.0,100,-120,-170,-1.5,135,2.8,Tropicana Field,7,-1
2015-06-23,2015,OAK,TEX,8,6,-130,-1.5,130,8.5,-120,100,115,1.5,-150,4.8,Rangers Ballpark,14,2
2015-06-23,2015,TB,TOR,4,3,-170,-1.5,135,7.0,100,-120,150,1.5,-155,4.41,Tropicana Field,7,1
2015-06-23,2015,ATL,WSH,1,3,150,1.5,-155,7.5,105,-125,-170,-1.5,135,3.0,Nationals Park,4,-2
2015-06-24,2015,COL,ARI,7,8,-116,-1.5,160,10.5,-120,100,106,1.5,-180,5.64,Coors Field,15,-1
2015-06-24,2015,WSH,ATL,2,1,-173,-1.5,135,6.5,-115,-105,153,1.5,-155,4.12,Nationals Park,3,1
2015-06-24,2015,BOS,BAL,5,1,-147,-1.5,145,8.5,-114,-106,132,1.5,-165,5.06,Fenway Park,6,4
2015-06-24,2015,BAL,BOS,1,5,132,1.5,-165,8.5,-114,-106,-147,-1.5,145,3.66,Fenway Park,6,-4
2015-06-24,2015,LAD,CHC,5,2,-105,-1.5,150,8.0,-110,-110,-105,1.5,-170,4.1,Wrigley Field,7,3
2015-06-24,2015,PIT,CIN,2,5,-192,-1.5,120,7.0,110,-130,172,1.5,-140,4.6,PNC Park,7,-3
2015-06-24,2015,DET,CLE,2,8,179,1.5,-120,7.5,-120,100,-209,-1.5,100,2.69,Progressive Field,10,-6
2015-06-24,2015,ARI,COL,8,7,106,1.5,-180,10.5,-120,100,-116,-1.5,160,5.1,Coors Field,15,1
2015-06-24,2015,MIN,CWS,6,1,117,1.5,-150,7.0,-115,-105,-127,-1.5,130,3.23,Target Field,7,5
2015-06-24,2015,CLE,DET,8,2,-209,-1.5,100,7.5,-120,100,179,1.5,-120,5.07,Progressive Field,10,6
2015-06-24,2015,LAA,HOU,2,1,105,1.5,-165,7.5,-120,100,-115,-1.5,145,3.66,Angel Stadium,3,1
2015-06-24,2015,SEA,KC,2,8,-107,-1.5,190,7.0,-105,-115,-103,1.5,-230,3.62,T-Mobile Park,10,-6
2015-06-24,2015,HOU,LAA,1,2,-115,-1.5,145,7.5,-120,100,105,1.5,-165,4.01,Angel Stadium,3,-1
2015-06-24,2015,CHC,LAD,2,5,-105,1.5,-170,8.0,-110,-110,-105,-1.5,150,4.1,Wrigley Field,7,-3
2015-06-24,2015,STL,MIA,6,1,-115,-1.5,150,6.5,-120,100,105,1.5,-170,3.48,Marlins Park,7,5
2015-06-24,2015,NYM,MIL,1,4,118,1.5,-185,7.5,-110,-110,-133,-1.5,165,3.44,Miller Park,5,-3
2015-06-24,2015,CWS,MIN,1,6,-127,-1.5,130,7.0,-115,-105,117,1.5,-150,3.92,Target Field,7,-5
2015-06-24,2015,MIL,NYM,4,1,-133,-1.5,165,7.5,-110,-110,118,1.5,-185,4.28,Miller Park,5,3
2015-06-24,2015,PHI,NYY,2,10,116,1.5,-190,8.0,114,-134,-126,-1.5,160,3.7,Yankee Stadium,12,-8
2015-06-24,2015,TEX,OAK,2,8,-121,-1.5,166,9.0,-105,-115,111,1.5,-195,4.93,Rangers Ballpark,10,-6
2015-06-24,2015,NYY,PHI,10,2,-126,-1.5,160,8.0,114,-134,116,1.5,-190,4.46,Yankee Stadium,12,8
2015-06-24,2015,CIN,PIT,5,2,172,1.5,-140,7.0,110,-130,-192,-1.5,120,2.57,PNC Park,7,3
2015-06-24,2015,SF,SD,6,0,-124,-1.5,180,7.0,-119,-101,114,1.5,-210,3.88,AT&T Park,6,6
2015-06-24,2015,KC,SEA,8,2,-103,1.5,-230,7.0,-105,-115,-107,-1.5,190,3.55,T-Mobile Park,10,6
2015-06-24,2015,SD,SF,0,6,114,1.5,-210,7.0,-119,-101,-124,-1.5,180,3.27,AT&T Park,6,-6
2015-06-24,2015,MIA,STL,1,6,105,1.5,-170,6.5,-120,100,-115,-1.5,150,3.17,Marlins Park,7,-5
2015-06-24,2015,TOR,TB,1,0,110,1.5,-215,7.0,-120,100,-120,-1.5,185,3.33,Tropicana Field,1,1
2015-06-24,2015,OAK,TEX,8,2,111,1.5,-195,9.0,-105,-115,-121,-1.5,166,4.27,Rangers Ballpark,10,6
2015-06-24,2015,TB,TOR,0,1,-120,-1.5,185,7.0,-120,100,110,1.5,-215,3.82,Tropicana Field,1,-1
2015-06-24,2015,ATL,WSH,1,2,153,1.5,-155,6.5,-115,-105,-173,-1.5,135,2.57,Nationals Park,3,-1
2015-06-25,2015,COL,ARI,6,4,115,1.5,-145,10.5,-105,-115,-130,-1.5,125,4.88,Coors Field,10,2
2015-06-25,2015,WSH,ATL,7,0,-130,-1.5,170,7.5,-113,-107,115,1.5,-200,4.24,Nationals Park,7,7
2015-06-25,2015,BOS,BAL,6,8,-131,-1.5,155,8.5,-105,-115,116,1.5,-175,4.82,Fenway Park,14,-2
2015-06-25,2015,BAL,BOS,8,6,116,1.5,-175,8.5,-105,-115,-131,-1.5,155,3.94,Fenway Park,14,2
2015-06-25,2015,LAD,CHC,4,0,129,1.5,-190,7.0,115,-135,-144,-1.5,161,3.06,Wrigley Field,4,4
2015-06-25,2015,PIT,CIN,4,5,-161,-1.5,135,7.0,-130,110,146,1.5,-155,4.32,PNC Park,9,-1
2015-06-25,2015,ARI,COL,4,6,-130,-1.5,125,10.5,-105,-115,115,1.5,-145,5.93,Coors Field,10,-2
2015-06-25,2015,DET,CWS,7,8,-172,-1.5,125,8.5,-110,-110,152,1.5,-145,5.38,Comerica Park,15,-1
2015-06-25,2015,CWS,DET,8,7,152,1.5,-145,8.5,-110,-110,-172,-1.5,125,3.37,Comerica Park,15,1
2015-06-25,2015,NYY,HOU,0,4,142,1.5,-165,7.5,-110,-110,-157,-1.5,145,3.1,Minute Maid Park,4,-4
2015-06-25,2015,CHC,LAD,0,4,-144,-1.5,161,7.0,115,-135,129,1.5,-190,4.13,Wrigley Field,4,-4
2015-06-25,2015,STL,MIA,5,1,-110,-1.5,145,7.5,105,-125,100,1.5,-165,3.93,Marlins Park,6,4
2015-06-25,2015,NYM,MIL,2,0,-115,-1.5,145,7.0,-105,-115,105,1.5,-165,3.74,Miller Park,2,2
2015-06-25,2015,MIL,NYM,0,2,105,1.5,-165,7.0,-105,-115,-115,-1.5,145,3.41,Miller Park,2,-2
2015-06-25,2015,HOU,NYY,4,0,-157,-1.5,145,7.5,-110,-110,142,1.5,-165,4.58,Minute Maid Park,4,4
2015-06-25,2015,TEX,OAK,3,6,130,1.5,-130,9.0,105,-125,-145,-1.5,110,3.91,Rangers Ballpark,9,-3
2015-06-25,2015,CIN,PIT,5,4,146,1.5,-155,7.0,-130,110,-161,-1.5,135,2.85,PNC Park,9,1
2015-06-25,2015,SF,SD,13,8,-132,-1.5,170,6.5,-120,100,117,1.5,-200,3.7,AT&T Park,21,5
2015-06-25,2015,SD,SF,8,13,117,1.5,-200,6.5,-120,100,-132,-1.5,170,3.0,AT&T Park,21,-5
2015-06-25,2015,MIA,STL,1,5,100,1.5,-165,7.5,105,-125,-110,-1.5,145,3.75,Marlins Park,6,-4
2015-06-25,2015,OAK,TEX,6,3,-145,-1.5,110,9.0,105,-125,130,1.5,-130,5.33,Rangers Ballpark,9,3
2015-06-25,2015,ATL,WSH,0,7,115,1.5,-200,7.5,-113,-107,-130,-1.5,170,3.49,Nationals Park,7,-7
2015-06-26,2015,SD,ARI,4,2,-146,-1.5,155,6.5,-115,-105,131,1.5,-175,3.86,PETCO Park,6,2
2015-06-26,2015,PIT,ATL,3,2,-265,-1.5,-105,7.0,110,-130,225,1.5,-115,5.08,PNC Park,5,1
2015-06-26,2015,CLE,BAL,3,4,-113,-1.5,150,7.0,-125,105,103,1.5,-170,3.71,Camden Yards,7,-1
2015-06-26,2015,TB,BOS,3,4,-114,-1.5,180,7.0,-116,-104,104,1.5,-210,3.73,Tropicana Field,7,-1
2015-06-26,2015,STL,CHC,3,2,-119,-1.5,180,7.0,100,-120,109,1.5,-210,3.8,Busch Stadium,5,1
2015-06-26,2015,NYM,CIN,2,1,109,1.5,-165,6.5,100,-120,-119,-1.5,145,3.11,Citi Field,3,1
2015-06-26,2015,BAL,CLE,4,3,103,1.5,-170,7.0,-125,105,-113,-1.5,150,3.45,Camden Yards,7,1
2015-06-26,2015,SF,COL,6,8,-127,-1.5,175,7.0,-105,-115,117,1.5,-205,3.92,AT&T Park,14,-2
2015-06-26,2015,DET,CWS,5,4,-172,-1.5,126,8.0,-120,100,152,1.5,-146,5.06,Comerica Park,9,1
2015-06-26,2015,CWS,DET,4,5,152,1.5,-146,8.0,-120,100,-172,-1.5,126,3.17,Comerica Park,9,-1
2015-06-26,2015,NYY,HOU,3,2,116,1.5,-190,8.5,-115,-105,-126,-1.5,162,3.94,Minute Maid Park,5,1
2015-06-26,2015,OAK,KC,2,5,-123,-1.5,165,7.0,-120,100,113,1.5,-195,3.86,Oakland Coliseum,7,-3
2015-06-26,2015,SEA,LAA,3,1,105,1.5,-210,7.5,-120,100,-115,-1.5,180,3.66,Angel Stadium,4,2
2015-06-26,2015,MIA,LAD,1,7,115,1.5,-155,7.5,-115,-105,-130,-1.5,135,3.49,Marlins Park,8,-6
2015-06-26,2015,LAD,MIA,7,1,-130,-1.5,135,7.5,-115,-105,115,1.5,-155,4.24,Marlins Park,8,6
2015-06-26,2015,MIN,MIL,4,10,115,1.5,-190,7.5,100,-120,-130,-1.5,160,3.49,Miller Park,14,-6
2015-06-26,2015,MIL,MIN,10,4,-130,-1.5,160,7.5,100,-120,115,1.5,-190,4.24,Miller Park,14,6
2015-06-26,2015,CIN,NYM,1,2,-119,-1.5,145,6.5,100,-120,109,1.5,-165,3.53,Citi Field,3,-1
2015-06-26,2015,HOU,NYY,2,3,-126,-1.5,162,8.5,-115,-105,116,1.5,-190,4.74,Minute Maid Park,5,-1
2015-06-26,2015,KC,OAK,5,2,113,1.5,-195,7.0,-120,100,-123,-1.5,165,3.29,Oakland Coliseum,7,3
2015-06-26,2015,WSH,PHI,5,2,-191,-1.5,-115,6.5,-115,-105,171,1.5,-105,4.27,Citizens Bank Park,7,3
2015-06-26,2015,ATL,PIT,2,3,225,1.5,-115,7.0,110,-130,-265,-1.5,-105,2.15,PNC Park,5,-1
2015-06-26,2015,ARI,SD,2,4,131,1.5,-175,6.5,-115,-105,-146,-1.5,155,2.81,PETCO Park,6,-2
2015-06-26,2015,LAA,SEA,1,3,-115,-1.5,180,7.5,-120,100,105,1.5,-210,4.01,Angel Stadium,4,-2
2015-06-26,2015,COL,SF,8,6,117,1.5,-205,7.0,-105,-115,-127,-1.5,175,3.23,AT&T Park,14,2
2015-06-26,2015,CHC,STL,2,3,109,1.5,-210,7.0,100,-120,-119,-1.5,180,3.35,Busch Stadium,5,-1
2015-06-26,2015,BOS,TB,4,3,104,1.5,-210,7.0,-116,-104,-114,-1.5,180,3.43,Tropicana Field,7,1
2015-06-26,2015,TOR,TEX,12,2,-181,-1.5,120,9.0,-115,-105,161,1.5,-140,5.8,Rogers Centre,14,10
2015-06-26,2015,TEX,TOR,2,12,161,1.5,-140,9.0,-115,-105,-181,-1.5,120,3.45,Rogers Centre,14,-10
2015-06-26,2015,PHI,WSH,2,5,171,1.5,-105,6.5,-115,-105,-191,-1.5,-115,2.4,Citizens Bank Park,7,-3
2015-06-27,2015,SD,ARI,7,2,-121,-1.5,180,7.0,110,-130,111,1.5,-210,3.83,PETCO Park,9,5
2015-06-27,2015,PIT,ATL,8,4,-160,-1.5,145,7.0,-120,100,145,1.5,-165,4.31,PNC Park,12,4
2015-06-27,2015,TB,BOS,4,1,-115,-1.5,185,7.5,110,-130,105,1.5,-215,4.01,Tropicana Field,5,3
2015-06-27,2015,STL,CHC,8,1,-181,-1.5,120,7.0,-125,105,161,1.5,-140,4.51,Busch Stadium,9,7
2015-06-27,2015,NYM,CIN,2,1,-163,-1.5,145,7.0,-110,-110,148,1.5,-165,4.34,Citi Field,3,1
2015-06-27,2015,SF,COL,7,5,-125,-1.5,174,7.5,-120,100,115,1.5,-204,4.17,AT&T Park,12,2
2015-06-27,2015,NYY,HOU,9,6,-129,-1.5,130,7.5,-115,-105,119,1.5,-150,4.22,Minute Maid Park,15,3
2015-06-27,2015,OAK,KC,2,3,-150,-1.5,155,7.0,-105,-115,135,1.5,-175,4.2,Oakland Coliseum,5,-1
2015-06-27,2015,SEA,LAA,2,4,120,1.5,-170,7.5,-110,-110,-135,-1.5,150,3.41,Angel Stadium,6,-2
2015-06-27,2015,MIA,LAD,3,2,238,1.5,140,6.5,100,-120,-278,-1.5,-160,1.92,Marlins Park,5,1
2015-06-27,2015,LAD,MIA,2,3,-278,-1.5,-160,6.5,100,-120,238,1.5,140,4.78,Marlins Park,5,-1
2015-06-27,2015,MIN,MIL,5,2,119,1.5,-180,8.0,100,-120,-134,-1.5,160,3.65,Miller Park,7,3
2015-06-27,2015,MIL,MIN,2,5,-134,-1.5,160,8.0,100,-120,119,1.5,-180,4.58,Miller Park,7,-3
2015-06-27,2015,CIN,NYM,1,2,148,1.5,-165,7.0,-110,-110,-163,-1.5,145,2.82,Citi Field,3,-1
2015-06-27,2015,HOU,NYY,6,9,119,1.5,-150,7.5,-115,-105,-129,-1.5,130,3.42,Minute Maid Park,15,-3
2015-06-27,2015,KC,OAK,3,2,135,1.5,-175,7.0,-105,-115,-150,-1.5,155,2.98,Oakland Coliseum,5,1
2015-06-27,2015,ATL,PIT,4,8,145,1.5,-165,7.0,-120,100,-160,-1.5,145,2.86,PNC Park,12,-4
2015-06-27,2015,ARI,SD,2,7,111,1.5,-210,7.0,110,-130,-121,-1.5,180,3.32,PETCO Park,9,-5
2015-06-27,2015,LAA,SEA,4,2,-135,-1.5,150,7.5,-110,-110,120,1.5,-170,4.31,Angel Stadium,6,2
2015-06-27,2015,COL,SF,5,7,115,1.5,-204,7.5,-120,100,-125,-1.5,174,3.49,AT&T Park,12,-2
2015-06-27,2015,CHC,STL,1,8,161,1.5,-140,7.0,-125,105,-181,-1.5,120,2.68,Busch Stadium,9,-7
2015-06-27,2015,BOS,TB,1,4,105,1.5,-215,7.5,110,-130,-115,-1.5,185,3.66,Tropicana Field,5,-3
2015-06-27,2015,TOR,TEX,0,4,-155,-1.5,135,8.5,-125,105,140,1.5,-155,5.17,Rogers Centre,4,-4
2015-06-27,2015,TEX,TOR,4,0,140,1.5,-155,8.5,-125,105,-155,-1.5,135,3.54,Rogers Centre,4,4
2015-06-28,2015,SD,ARI,4,6,-110,-1.5,185,7.5,105,-125,100,1.5,-215,3.93,PETCO Park,10,-2
2015-06-28,2015,PIT,ATL,1,2,-159,-1.5,150,7.0,-110,-110,144,1.5,-170,4.3,PNC Park,3,-1
2015-06-28,2015,CLE,BAL,0,4,117,1.5,-180,8.5,-115,-105,-127,-1.5,160,3.92,Camden Yards,4,-4
2015-06-28,2015,CLE,BAL,0,8,126,1.5,-165,9.0,-105,-115,-141,-1.5,145,3.98,Camden Yards,8,-8
2015-06-28,2015,TB,BOS,3,5,-179,-1.5,125,6.5,-125,105,159,1.5,-145,4.17,Tropicana Field,8,-2
2015-06-28,2015,STL,CHC,4,1,-142,-1.5,165,6.5,-120,100,127,1.5,-195,3.81,Busch Stadium,5,3
2015-06-28,2015,NYM,CIN,7,2,-140,-1.5,150,7.5,100,-120,125,1.5,-170,4.38,Citi Field,9,5
2015-06-28,2015,BAL,CLE,4,0,-127,-1.5,160,8.5,-115,-105,117,1.5,-180,4.76,Camden Yards,4,4
2015-06-28,2015,BAL,CLE,8,0,-141,-1.5,145,9.0,-105,-115,126,1.5,-165,5.27,Camden Yards,8,8
2015-06-28,2015,SF,COL,6,3,-236,-1.5,-105,7.0,-115,-105,206,1.5,-115,4.92,AT&T Park,9,3
2015-06-28,2015,DET,CWS,5,4,-162,-1.5,135,8.0,100,-120,147,1.5,-155,4.95,Comerica Park,9,1
2015-06-28,2015,CWS,DET,4,5,147,1.5,-155,8.0,100,-120,-162,-1.5,135,3.24,Comerica Park,9,-1
2015-06-28,2015,NYY,HOU,1,3,-106,-1.5,145,7.5,-115,-105,-104,1.5,-165,3.86,Minute Maid Park,4,-2
2015-06-28,2015,OAK,KC,3,5,-137,-1.5,160,7.0,-125,105,122,1.5,-190,4.05,Oakland Coliseum,8,-2
2015-06-28,2015,SEA,LAA,2,3,-114,-1.5,150,7.0,-130,110,104,1.5,-170,3.73,Angel Stadium,5,-1
2015-06-28,2015,MIA,LAD,0,2,206,1.5,-215,7.0,100,-120,-236,-1.5,-105,2.29,Marlins Park,2,-2
2015-06-28,2015,LAD,MIA,2,0,-236,-1.5,-105,7.0,100,-120,206,1.5,-215,4.92,Marlins Park,2,2
2015-06-28,2015,MIN,MIL,3,5,149,1.5,-150,8.0,-105,-115,-164,-1.5,130,3.21,Miller Park,8,-2
2015-06-28,2015,MIL,MIN,5,3,-164,-1.5,130,8.0,-105,-115,149,1.5,-150,4.97,Miller Park,8,2
2015-06-28,2015,CIN,NYM,2,7,125,1.5,-170,7.5,100,-120,-140,-1.5,150,3.33,Citi Field,9,-5
2015-06-28,2015,HOU,NYY,3,1,-104,1.5,-165,7.5,-115,-105,-106,-1.5,145,3.82,Minute Maid Park,4,2
2015-06-28,2015,KC,OAK,5,3,122,1.5,-190,7.0,-125,105,-137,-1.5,160,3.15,Oakland Coliseum,8,2
2015-06-28,2015,WSH,PHI,3,2,-174,-1.5,-110,8.0,-115,-105,154,1.5,-110,5.08,Citizens Bank Park,5,1
2015-06-28,2015,WSH,PHI,5,8,-145,-1.5,110,8.0,-120,100,130,1.5,-130,4.73,Citizens Bank Park,13,-3
2015-06-28,2015,ATL,PIT,2,1,144,1.5,-170,7.0,-110,-110,-159,-1.5,150,2.87,PNC Park,3,1
2015-06-28,2015,ARI,SD,6,4,100,1.5,-215,7.5,105,-125,-110,-1.5,185,3.75,PETCO Park,10,2
2015-06-28,2015,LAA,SEA,3,2,104,1.5,-170,7.0,-130,110,-114,-1.5,150,3.43,Angel Stadium,5,1
2015-06-28,2015,COL,SF,3,6,206,1.5,-115,7.0,-115,-105,-236,-1.5,-105,2.29,AT&T Park,9,-3
2015-06-28,2015,CHC,STL,1,4,127,1.5,-195,6.5,-120,100,-142,-1.5,165,2.86,Busch Stadium,5,-3
2015-06-28,2015,BOS,TB,5,3,159,1.5,-145,6.5,-125,105,-179,-1.5,125,2.51,Tropicana Field,8,2
2015-06-28,2015,TOR,TEX,3,2,-174,-1.5,115,9.0,-125,105,154,1.5,-135,5.72,Rogers Centre,5,1
2015-06-28,2015,TEX,TOR,2,3,154,1.5,-135,9.0,-125,105,-174,-1.5,115,3.54,Rogers Centre,5,-1
2015-06-28,2015,PHI,WSH,2,3,154,1.5,-110,8.0,-115,-105,-174,-1.5,-110,3.15,Citizens Bank Park,5,-1
2015-06-28,2015,PHI,WSH,8,5,130,1.5,-130,8.0,-120,100,-145,-1.5,110,3.48,Citizens Bank Park,13,3
2015-06-29,2015,LAD,ARI,6,10,-156,-1.5,100,9.0,-110,-110,141,1.5,-120,5.48,Chase Field,16,-4
2015-06-29,2015,TEX,BAL,8,1,117,1.5,-175,9.0,100,-120,-132,-1.5,155,4.15,Camden Yards,9,7
2015-06-29,2015,TOR,BOS,1,3,-122,-1.5,170,8.5,-105,-115,112,1.5,-200,4.67,Rogers Centre,4,-2
2015-06-29,2015,MIN,CIN,7,11,149,1.5,-150,8.0,100,-120,-164,-1.5,130,3.21,Great American Ballpark,18,-4
2015-06-29,2015,TB,CLE,1,7,-119,-1.5,180,7.0,-110,-110,109,1.5,-210,3.8,Tropicana Field,8,-6
2015-06-29,2015,OAK,COL,7,1,-176,-1.5,120,8.0,-105,-115,156,1.5,-140,5.1,Oakland Coliseum,8,6
2015-06-29,2015,KC,HOU,1,6,114,1.5,-205,7.0,-115,-105,-124,-1.5,175,3.27,Minute Maid Park,7,-5
2015-06-29,2015,HOU,KC,6,1,-124,-1.5,175,7.0,-115,-105,114,1.5,-205,3.88,Minute Maid Park,7,5
2015-06-29,2015,NYY,LAA,1,4,115,1.5,-195,8.5,-105,-115,-130,-1.5,165,3.95,Angel Stadium,5,-3
2015-06-29,2015,ARI,LAD,10,6,141,1.5,-120,9.0,-110,-110,-156,-1.5,100,3.73,Chase Field,16,4
2015-06-29,2015,PHI,MIL,4,7,141,1.5,-130,8.0,-120,100,-156,-1.5,110,3.32,Citizens Bank Park,11,-3
2015-06-29,2015,CIN,MIN,11,7,-164,-1.5,130,8.0,100,-120,149,1.5,-150,4.97,Great American Ballpark,18,4
2015-06-29,2015,LAA,NYY,4,1,-130,-1.5,165,8.5,-105,-115,115,1.5,-195,4.8,Angel Stadium,5,3
2015-06-29,2015,COL,OAK,1,7,156,1.5,-140,8.0,-105,-115,-176,-1.5,120,3.13,Oakland Coliseum,8,-6
2015-06-29,2015,MIL,PHI,7,4,-156,-1.5,110,8.0,-120,100,141,1.5,-130,4.88,Citizens Bank Park,11,3
2015-06-29,2015,CLE,TB,7,1,109,1.5,-210,7.0,-110,-110,-119,-1.5,180,3.35,Tropicana Field,8,6
2015-06-29,2015,BAL,TEX,1,8,-132,-1.5,155,9.0,100,-120,117,1.5,-175,5.12,Camden Yards,9,-7
2015-06-29,2015,BOS,TOR,3,1,112,1.5,-200,8.5,-105,-115,-122,-1.5,170,4.01,Rogers Centre,4,2
2015-06-30,2015,LAD,ARI,6,4,-110,-1.5,145,9.0,-105,-115,100,1.5,-165,4.71,Chase Field,10,2
2015-06-30,2015,WSH,ATL,6,1,-114,-1.5,155,6.5,-105,-115,104,1.5,-175,3.46,Turner Field,7,5
2015-06-30,2015,TEX,BAL,8,6,128,1.5,-165,9.0,100,-120,-143,-1.5,145,3.95,Camden Yards,14,2
2015-06-30,2015,TOR,BOS,3,4,-146,-1.5,140,9.0,100,-120,131,1.5,-160,5.34,Rogers Centre,7,-1
2015-06-30,2015,NYM,CHC,0,1,106,1.5,-160,7.0,-119,-101,-116,-1.5,140,3.4,Citi Field,1,-1
2015-06-30,2015,MIN,CIN,8,5,118,1.5,-200,8.0,-115,-105,-128,-1.5,170,3.67,Great American Ballpark,13,3
2015-06-30,2015,TB,CLE,2,6,125,1.5,-140,7.0,100,-120,-140,-1.5,120,3.11,Tropicana Field,8,-4
2015-06-30,2015,OAK,COL,1,2,-147,-1.5,155,7.5,-125,105,132,1.5,-175,4.46,Oakland Coliseum,3,-1
2015-06-30,2015,STL,CWS,1,2,103,1.5,-180,6.0,110,-130,-113,-1.5,160,2.96,Busch Stadium,3,-1
2015-06-30,2015,PIT,DET,5,4,-112,-1.5,145,8.0,100,-120,102,1.5,-165,4.23,Comerica Park,9,1
2015-06-30,2015,KC,HOU,0,4,134,1.5,-170,6.5,-120,100,-149,-1.5,150,2.78,Minute Maid Park,4,-4
2015-06-30,2015,HOU,KC,4,0,-149,-1.5,150,6.5,-120,100,134,1.5,-170,3.89,Minute Maid Park,4,4
2015-06-30,2015,NYY,LAA,1,2,116,1.5,-170,8.0,-105,-115,-131,-1.5,150,3.7,Angel Stadium,3,-1
2015-06-30,2015,ARI,LAD,4,6,100,1.5,-165,9.0,-105,-115,-110,-1.5,145,4.5,Chase Field,10,-2
2015-06-30,2015,SF,MIA,3,5,114,1.5,-205,7.0,-105,-115,-124,-1.5,175,3.27,Marlins Park,8,-2
2015-06-30,2015,PHI,MIL,3,4,-124,-1.5,180,7.0,-110,-110,114,1.5,-210,3.88,Citizens Bank Park,7,-1
2015-06-30,2015,CIN,MIN,5,8,-128,-1.5,170,8.0,-115,-105,118,1.5,-200,4.49,Great American Ballpark,13,-3
2015-06-30,2015,CHC,NYM,1,0,-116,-1.5,140,7.0,-119,-101,106,1.5,-160,3.76,Citi Field,1,1
2015-06-30,2015,LAA,NYY,2,1,-131,-1.5,150,8.0,-105,-115,116,1.5,-170,4.54,Angel Stadium,3,1
2015-06-30,2015,COL,OAK,2,1,132,1.5,-175,7.5,-125,105,-147,-1.5,155,3.23,Oakland Coliseum,3,1
2015-06-30,2015,MIL,PHI,4,3,114,1.5,-210,7.0,-110,-110,-124,-1.5,180,3.27,Citizens Bank Park,7,1
2015-06-30,2015,DET,PIT,4,5,102,1.5,-165,8.0,100,-120,-112,-1.5,145,3.96,Comerica Park,9,-1
2015-06-30,2015,SEA,SD,5,0,107,1.5,-215,7.5,-105,-115,-117,-1.5,185,3.62,PETCO Park,5,5
2015-06-30,2015,SD,SEA,0,5,-117,-1.5,185,7.5,-105,-115,107,1.5,-215,4.04,PETCO Park,5,-5
2015-06-30,2015,MIA,SF,5,3,-124,-1.5,175,7.0,-105,-115,114,1.5,-205,3.88,Marlins Park,8,2
2015-06-30,2015,CWS,STL,2,1,-113,-1.5,160,6.0,110,-130,103,1.5,-180,3.18,Busch Stadium,3,1
2015-06-30,2015,CLE,TB,6,2,-140,-1.5,120,7.0,100,-120,125,1.5,-140,4.08,Tropicana Field,8,4
2015-06-30,2015,BAL,TEX,6,8,-143,-1.5,145,9.0,100,-120,128,1.5,-165,5.3,Camden Yards,14,-2
2015-06-30,2015,BOS,TOR,4,3,131,1.5,-160,9.0,100,-120,-146,-1.5,140,3.9,Rogers Centre,7,1
2015-06-30,2015,ATL,WSH,1,6,104,1.5,-175,6.5,-105,-115,-114,-1.5,155,3.19,Turner Field,7,-5
2015-07-01,2015,LAD,ARI,4,3,-123,-1.5,135,8.5,-110,-110,113,1.5,-155,4.69,Chase Field,7,1
2015-07-01,2015,WSH,ATL,1,4,-141,-1.5,130,7.5,-101,-119,126,1.5,-150,4.39,Turner Field,5,-3
2015-07-01,2015,TEX,BAL,2,4,164,1.5,-130,8.5,-115,-105,-184,-1.5,110,3.22,Camden Yards,6,-2
2015-07-01,2015,TOR,BOS,11,2,-135,-1.5,150,8.5,100,-120,120,1.5,-170,4.88,Rogers Centre,13,9
2015-07-01,2015,NYM,CHC,0,2,109,1.5,-160,7.0,-121,101,-119,-1.5,140,3.35,Citi Field,2,-2
2015-07-01,2015,MIN,CIN,1,2,181,1.5,-125,7.0,-115,-105,-211,-1.5,105,2.49,Great American Ballpark,3,-1
2015-07-01,2015,TB,CLE,1,8,135,1.5,-135,7.0,-105,-115,-150,-1.5,115,2.98,Tropicana Field,9,-7
2015-07-01,2015,OAK,COL,4,1,-195,-1.5,110,8.0,100,-120,175,1.5,-130,5.29,Oakland Coliseum,5,3
2015-07-01,2015,STL,CWS,1,7,-158,-1.5,145,6.5,-107,-113,143,1.5,-165,3.98,Busch Stadium,8,-6
2015-07-01,2015,PIT,DET,9,3,102,1.5,-215,8.5,-120,100,-112,-1.5,185,4.21,Comerica Park,12,6
2015-07-01,2015,KC,HOU,5,6,107,1.5,-200,7.5,-110,-110,-117,-1.5,170,3.62,Minute Maid Park,11,-1
2015-07-01,2015,HOU,KC,6,5,-117,-1.5,170,7.5,-110,-110,107,1.5,-200,4.04,Minute Maid Park,11,1
2015-07-01,2015,NYY,LAA,3,1,-111,-1.5,150,8.0,-117,-103,101,1.5,-170,4.21,Angel Stadium,4,2
2015-07-01,2015,ARI,LAD,3,4,113,1.5,-155,8.5,-110,-110,-123,-1.5,135,3.99,Chase Field,7,-1
2015-07-01,2015,SF,MIA,5,6,-135,-1.5,135,6.5,-119,-101,120,1.5,-155,3.73,Marlins Park,11,-1
2015-07-01,2015,PHI,MIL,5,9,101,1.5,-166,7.5,-105,-115,-111,-1.5,146,3.73,Citizens Bank Park,14,-4
2015-07-01,2015,CIN,MIN,2,1,-211,-1.5,105,7.0,-115,-105,181,1.5,-125,4.75,Great American Ballpark,3,1
2015-07-01,2015,CHC,NYM,2,0,-119,-1.5,140,7.0,-121,101,109,1.5,-160,3.8,Citi Field,2,2
2015-07-01,2015,LAA,NYY,1,3,101,1.5,-170,8.0,-117,-103,-111,-1.5,150,3.98,Angel Stadium,4,-2
2015-07-01,2015,COL,OAK,1,4,175,1.5,-130,8.0,100,-120,-195,-1.5,110,2.91,Oakland Coliseum,5,-3
2015-07-01,2015,MIL,PHI,9,5,-111,-1.5,146,7.5,-105,-115,101,1.5,-166,3.95,Citizens Bank Park,14,4
2015-07-01,2015,DET,PIT,3,9,-112,-1.5,185,8.5,-120,100,102,1.5,-215,4.49,Comerica Park,12,-6
2015-07-01,2015,SEA,SD,7,0,100,1.5,-240,7.0,-105,-115,-110,-1.5,200,3.5,PETCO Park,7,7
2015-07-01,2015,SD,SEA,0,7,-110,-1.5,200,7.0,-105,-115,100,1.5,-240,3.67,PETCO Park,7,-7
2015-07-01,2015,MIA,SF,6,5,120,1.5,-155,6.5,-119,-101,-135,-1.5,135,2.95,Marlins Park,11,1
2015-07-01,2015,CWS,STL,7,1,143,1.5,-165,6.5,-107,-113,-158,-1.5,145,2.67,Busch Stadium,8,6
2015-07-01,2015,CLE,TB,8,1,-150,-1.5,115,7.0,-105,-115,135,1.5,-135,4.2,Tropicana Field,9,7
2015-07-01,2015,BAL,TEX,4,2,-184,-1.5,110,8.5,-115,-105,164,1.5,-130,5.51,Camden Yards,6,2
2015-07-01,2015,BOS,TOR,2,11,120,1.5,-170,8.5,100,-120,-135,-1.5,150,3.86,Rogers Centre,13,-9
2015-07-01,2015,ATL,WSH,4,1,126,1.5,-150,7.5,-101,-119,-141,-1.5,130,3.32,Turner Field,5,3
2015-07-02,2015,COL,ARI,1,8,140,1.5,-155,9.0,-105,-115,-155,-1.5,135,3.75,Chase Field,9,-7
2015-07-02,2015,WSH,ATL,1,2,-204,-1.5,-120,6.5,105,-125,174,1.5,100,4.36,Turner Field,3,-1
2015-07-02,2015,TEX,BAL,2,0,-104,1.5,-215,8.0,-110,-110,-106,-1.5,185,4.08,Camden Yards,2,2
2015-07-02,2015,TOR,BOS,6,12,-152,-1.5,125,9.0,-115,-105,137,1.5,-145,5.43,Rogers Centre,18,-6
2015-07-02,2015,NYM,CHC,1,6,-114,-1.5,190,6.0,105,-125,104,1.5,-230,3.2,Citi Field,7,-5
2015-07-02,2015,TB,CLE,4,5,118,1.5,-165,6.5,-108,-112,-128,-1.5,145,2.98,Tropicana Field,9,-1
2015-07-02,2015,ARI,COL,8,1,-155,-1.5,135,9.0,-105,-115,140,1.5,-155,5.47,Chase Field,9,7
2015-07-02,2015,PIT,DET,8,4,-134,-1.5,120,9.0,-110,-110,119,1.5,-140,5.15,Comerica Park,12,4
2015-07-02,2015,MIN,KC,2,0,146,1.5,-155,7.5,-105,-115,-161,-1.5,135,3.05,Kauffman Stadium,2,2
2015-07-02,2015,SF,MIA,4,5,106,1.5,-217,6.5,-110,-110,-116,-1.5,186,3.16,Marlins Park,9,-1
2015-07-02,2015,PHI,MIL,7,8,130,1.5,-130,8.0,100,-120,-145,-1.5,110,3.48,Citizens Bank Park,15,-1
2015-07-02,2015,KC,MIN,0,2,-161,-1.5,135,7.5,-105,-115,146,1.5,-155,4.63,Kauffman Stadium,2,-2
2015-07-02,2015,CHC,NYM,6,1,104,1.5,-230,6.0,105,-125,-114,-1.5,190,2.94,Citi Field,7,5
2015-07-02,2015,SEA,OAK,0,4,137,1.5,-170,7.0,100,-120,-152,-1.5,150,2.95,Oakland Coliseum,4,-4
2015-07-02,2015,MIL,PHI,8,7,-145,-1.5,110,8.0,100,-120,130,1.5,-130,4.73,Citizens Bank Park,15,1
2015-07-02,2015,DET,PIT,4,8,119,1.5,-140,9.0,-110,-110,-134,-1.5,120,4.11,Comerica Park,12,-4
2015-07-02,2015,STL,SD,3,5,-109,-1.5,190,7.0,-110,-110,-101,1.5,-230,3.65,Busch Stadium,8,-2
2015-07-02,2015,OAK,SEA,4,0,-152,-1.5,150,7.0,100,-120,137,1.5,-170,4.22,Oakland Coliseum,4,4
2015-07-02,2015,MIA,SF,5,4,-116,-1.5,186,6.5,-110,-110,106,1.5,-217,3.49,Marlins Park,9,1
2015-07-02,2015,SD,STL,5,3,-101,1.5,-230,7.0,-110,-110,-109,-1.5,190,3.52,Busch Stadium,8,2
2015-07-02,2015,CLE,TB,5,4,-128,-1.5,145,6.5,-108,-112,118,1.5,-165,3.65,Tropicana Field,9,1
2015-07-02,2015,BAL,TEX,0,2,-106,-1.5,185,8.0,-110,-110,-104,1.5,-215,4.12,Camden Yards,2,-2
2015-07-02,2015,BOS,TOR,12,6,137,1.5,-145,9.0,-115,-105,-152,-1.5,125,3.8,Rogers Centre,18,6
2015-07-02,2015,ATL,WSH,2,1,174,1.5,100,6.5,105,-125,-204,-1.5,-120,2.37,Turner Field,3,1
2015-07-03,2015,COL,ARI,3,4,146,1.5,-150,9.0,-120,100,-161,-1.5,130,3.66,Chase Field,7,-1
2015-07-03,2015,PHI,ATL,1,2,151,1.5,-150,7.0,-125,105,-171,-1.5,130,2.79,Turner Field,3,-1
2015-07-03,2015,CWS,BAL,1,0,145,1.5,-116,8.0,-110,-110,-160,-1.5,-104,3.27,Guaranteed Rate Field,1,1
2015-07-03,2015,HOU,BOS,12,8,111,1.5,-195,9.5,-105,-115,-121,-1.5,165,4.5,Fenway Park,20,4
2015-07-03,2015,MIA,CHC,2,1,170,1.5,-140,7.0,-105,-115,-200,-1.5,120,2.59,Wrigley Field,3,1
2015-07-03,2015,MIL,CIN,12,1,-119,-1.5,140,8.0,-117,-103,109,1.5,-160,4.35,Great American Ballpark,13,11
2015-07-03,2015,PIT,CLE,2,5,-120,-1.5,175,7.5,-105,-115,110,1.5,-205,4.09,PNC Park,7,-3
2015-07-03,2015,ARI,COL,4,3,-161,-1.5,130,9.0,-120,100,146,1.5,-150,5.55,Chase Field,7,1
2015-07-03,2015,BAL,CWS,0,1,-160,-1.5,-104,8.0,-110,-110,145,1.5,-116,4.92,Guaranteed Rate Field,1,-1
2015-07-03,2015,TOR,DET,6,8,113,1.5,-200,8.5,-120,100,-123,-1.5,170,3.99,Comerica Park,14,-2
2015-07-03,2015,BOS,HOU,8,12,-121,-1.5,165,9.5,-105,-115,111,1.5,-195,5.2,Fenway Park,20,-4
2015-07-03,2015,MIN,KC,2,3,119,1.5,-181,7.5,-110,-110,-134,-1.5,161,3.42,Kauffman Stadium,5,-1
2015-07-03,2015,TEX,LAA,2,8,130,1.5,-135,9.5,-110,-110,-145,-1.5,115,4.13,Rangers Ballpark,10,-6
2015-07-03,2015,NYM,LAD,2,1,210,1.5,-113,6.0,-110,-110,-250,-1.5,-107,1.94,Dodger Stadium,3,1
2015-07-03,2015,CHC,MIA,1,2,-200,-1.5,120,7.0,-105,-115,170,1.5,-140,4.67,Wrigley Field,3,-1
2015-07-03,2015,CIN,MIL,1,12,109,1.5,-160,8.0,-117,-103,-119,-1.5,140,3.83,Great American Ballpark,13,-11
2015-07-03,2015,KC,MIN,3,2,-134,-1.5,161,7.5,-110,-110,119,1.5,-181,4.29,Kauffman Stadium,5,1
2015-07-03,2015,LAD,NYM,1,2,-250,-1.5,-107,6.0,-110,-110,210,1.5,-113,4.29,Dodger Stadium,3,-1
2015-07-03,2015,TB,NYY,5,7,114,1.5,-190,7.0,-105,-115,-124,-1.5,160,3.27,Yankee Stadium,12,-2
2015-07-03,2015,SEA,OAK,9,5,105,1.5,-215,7.0,-127,107,-115,-1.5,185,3.41,Oakland Coliseum,14,4
2015-07-03,2015,ATL,PHI,2,1,-171,-1.5,130,7.0,-125,105,151,1.5,-150,4.42,Turner Field,3,1
2015-07-03,2015,CLE,PIT,5,2,110,1.5,-205,7.5,-105,-115,-120,-1.5,175,3.57,PNC Park,7,3
2015-07-03,2015,STL,SD,1,2,-158,-1.5,150,7.0,-105,-115,143,1.5,-170,4.29,Busch Stadium,3,-1
2015-07-03,2015,OAK,SEA,5,9,-115,-1.5,185,7.0,-127,107,105,1.5,-215,3.74,Oakland Coliseum,14,-4
2015-07-03,2015,WSH,SF,2,1,-124,-1.5,170,7.5,-101,-119,114,1.5,-200,4.15,Nationals Park,3,1
2015-07-03,2015,SD,STL,2,1,143,1.5,-170,7.0,-105,-115,-158,-1.5,150,2.88,Busch Stadium,3,1
2015-07-03,2015,NYY,TB,7,5,-124,-1.5,160,7.0,-105,-115,114,1.5,-190,3.88,Yankee Stadium,12,2
2015-07-03,2015,LAA,TEX,8,2,-145,-1.5,115,9.5,-110,-110,130,1.5,-135,5.62,Rangers Ballpark,10,6
2015-07-03,2015,DET,TOR,8,6,-123,-1.5,170,8.5,-120,100,113,1.5,-200,4.69,Comerica Park,14,2
2015-07-03,2015,SF,WSH,1,2,114,1.5,-200,7.5,-101,-119,-124,-1.5,170,3.5,Nationals Park,3,-1
2015-07-04,2015,COL,ARI,3,7,150,1.5,-145,9.0,-105,-115,-170,-1.5,125,3.6,Chase Field,10,-4
2015-07-04,2015,PHI,ATL,5,9,160,1.5,-145,7.0,-101,-119,-180,-1.5,125,2.69,Turner Field,14,-4
2015-07-04,2015,CWS,BAL,3,2,-105,-1.5,185,8.0,-125,105,-105,1.5,-215,4.1,Guaranteed Rate Field,5,1
2015-07-04,2015,HOU,BOS,1,6,131,1.5,-170,8.0,-115,-105,-146,-1.5,150,3.46,Fenway Park,7,-5
2015-07-04,2015,MIA,CHC,2,7,115,1.5,-200,7.5,-118,-102,-125,-1.5,170,3.49,Wrigley Field,9,-5
2015-07-04,2015,MIL,CIN,7,3,-105,1.5,-215,8.5,-120,100,-105,-1.5,185,4.35,Great American Ballpark,10,4
2015-07-04,2015,PIT,CLE,1,0,-114,-1.5,180,8.0,-120,100,104,1.5,-210,4.26,PNC Park,1,1
2015-07-04,2015,ARI,COL,7,3,-170,-1.5,125,9.0,-105,-115,150,1.5,-145,5.67,Chase Field,10,4
2015-07-04,2015,BAL,CWS,2,3,-105,1.5,-215,8.0,-125,105,-105,-1.5,185,4.1,Guaranteed Rate Field,5,-1
2015-07-04,2015,TOR,DET,3,8,100,1.5,-215,9.0,-105,-115,-110,-1.5,185,4.5,Comerica Park,11,-5
2015-07-04,2015,BOS,HOU,6,1,-146,-1.5,150,8.0,-115,-105,131,1.5,-170,4.75,Fenway Park,7,5
2015-07-04,2015,MIN,KC,5,3,149,1.5,-150,8.0,-125,105,-164,-1.5,130,3.21,Kauffman Stadium,8,2
2015-07-04,2015,TEX,LAA,0,13,106,1.5,-160,9.0,-105,-115,-116,-1.5,140,4.37,Rangers Ballpark,13,-13
2015-07-04,2015,NYM,LAD,3,4,150,1.5,-160,6.5,110,-130,-170,-1.5,140,2.6,Dodger Stadium,7,-1
2015-07-04,2015,CHC,MIA,7,2,-125,-1.5,170,7.5,-118,-102,115,1.5,-200,4.17,Wrigley Field,9,5
2015-07-04,2015,CIN,MIL,3,7,-105,-1.5,185,8.5,-120,100,-105,1.5,-215,4.35,Great American Ballpark,10,-4
2015-07-04,2015,KC,MIN,3,5,-164,-1.5,130,8.0,-125,105,149,1.5,-150,4.97,Kauffman Stadium,8,-2
2015-07-04,2015,LAD,NYM,4,3,-170,-1.5,140,6.5,110,-130,150,1.5,-160,4.09,Dodger Stadium,7,1
2015-07-04,2015,TB,NYY,2,3,146,1.5,-150,7.5,-105,-115,-161,-1.5,130,3.05,Yankee Stadium,5,-1
2015-07-04,2015,SEA,OAK,0,2,-131,-1.5,125,7.5,-105,-115,116,1.5,-145,4.25,Oakland Coliseum,2,-2
2015-07-04,2015,ATL,PHI,9,5,-180,-1.5,125,7.0,-101,-119,160,1.5,-145,4.5,Turner Field,14,4
2015-07-04,2015,CLE,PIT,0,1,104,1.5,-210,8.0,-120,100,-114,-1.5,180,3.92,PNC Park,1,-1
2015-07-04,2015,STL,SD,2,1,-211,-1.5,105,7.0,-101,-119,181,1.5,-125,4.75,Busch Stadium,3,1
2015-07-04,2015,OAK,SEA,2,0,116,1.5,-145,7.5,-105,-115,-131,-1.5,125,3.47,Oakland Coliseum,2,2
2015-07-04,2015,WSH,SF,9,3,-105,-1.5,195,6.5,-105,-115,-105,1.5,-235,3.33,Nationals Park,12,6
2015-07-04,2015,SD,STL,1,2,181,1.5,-125,7.0,-101,-119,-211,-1.5,105,2.49,Busch Stadium,3,-1
2015-07-04,2015,NYY,TB,3,2,-161,-1.5,130,7.5,-105,-115,146,1.5,-150,4.63,Yankee Stadium,5,1
2015-07-04,2015,LAA,TEX,13,0,-116,-1.5,140,9.0,-105,-115,106,1.5,-160,4.83,Rangers Ballpark,13,13
2015-07-04,2015,DET,TOR,8,3,-110,-1.5,185,9.0,-105,-115,100,1.5,-215,4.71,Comerica Park,11,5
2015-07-04,2015,SF,WSH,3,9,-105,1.5,-235,6.5,-105,-115,-105,-1.5,195,3.33,Nationals Park,12,-6
2015-07-05,2015,COL,ARI,6,4,149,1.5,-150,8.0,-115,-105,-164,-1.5,130,3.21,Chase Field,10,2
2015-07-05,2015,PHI,ATL,4,0,-105,1.5,-240,6.5,104,-124,-105,-1.5,200,3.33,Turner Field,4,4
2015-07-05,2015,CWS,BAL,1,9,100,1.5,-165,8.5,-122,102,-110,-1.5,145,4.25,Guaranteed Rate Field,10,-8
2015-07-05,2015,HOU,BOS,4,5,106,1.5,-205,8.5,-110,-110,-116,-1.5,175,4.13,Fenway Park,9,-1
2015-07-05,2015,MIA,CHC,0,2,115,1.5,-195,7.5,-110,-110,-130,-1.5,165,3.49,Wrigley Field,2,-2
2015-07-05,2015,MIL,CIN,6,1,112,1.5,-200,7.5,-105,-115,-122,-1.5,170,3.54,Great American Ballpark,7,5
2015-07-05,2015,PIT,CLE,5,3,-133,-1.5,170,6.5,100,-120,118,1.5,-200,3.71,PNC Park,8,2
2015-07-05,2015,ARI,COL,4,6,-164,-1.5,130,8.0,-115,-105,149,1.5,-150,4.97,Chase Field,10,-2
2015-07-05,2015,BAL,CWS,9,1,-110,-1.5,145,8.5,-122,102,100,1.5,-165,4.45,Guaranteed Rate Field,10,8
2015-07-05,2015,TOR,DET,10,5,-127,-1.5,125,9.0,-120,100,117,1.5,-145,5.04,Comerica Park,15,5
2015-07-05,2015,BOS,HOU,5,4,-116,-1.5,175,8.5,-110,-110,106,1.5,-205,4.56,Fenway Park,9,1
2015-07-05,2015,MIN,KC,2,3,137,1.5,-160,8.5,-101,-119,-152,-1.5,140,3.59,Kauffman Stadium,5,-1
2015-07-05,2015,TEX,LAA,6,12,117,1.5,-150,9.0,-125,105,-127,-1.5,130,4.15,Rangers Ballpark,18,-6
2015-07-05,2015,NYM,LAD,8,0,140,1.5,-165,7.0,-120,100,-155,-1.5,145,2.92,Dodger Stadium,8,8
2015-07-05,2015,CHC,MIA,2,0,-130,-1.5,165,7.5,-110,-110,115,1.5,-195,4.24,Wrigley Field,2,2
2015-07-05,2015,CIN,MIL,1,6,-122,-1.5,170,7.5,-105,-115,112,1.5,-200,4.12,Great American Ballpark,7,-5
2015-07-05,2015,KC,MIN,3,2,-152,-1.5,140,8.5,-101,-119,137,1.5,-160,5.13,Kauffman Stadium,5,1
2015-07-05,2015,LAD,NYM,0,8,-155,-1.5,145,7.0,-120,100,140,1.5,-165,4.25,Dodger Stadium,8,-8
2015-07-05,2015,TB,NYY,8,1,116,1.5,-175,9.0,-105,-115,-126,-1.5,155,4.17,Yankee Stadium,9,7
2015-07-05,2015,SEA,OAK,2,1,-102,1.5,-215,7.5,-115,-105,-108,-1.5,185,3.79,Oakland Coliseum,3,1
2015-07-05,2015,ATL,PHI,0,4,-105,-1.5,200,6.5,104,-124,-105,1.5,-240,3.33,Turner Field,4,-4
2015-07-05,2015,CLE,PIT,3,5,118,1.5,-200,6.5,100,-120,-133,-1.5,170,2.98,PNC Park,8,-2
2015-07-05,2015,STL,SD,3,1,-190,-1.5,125,7.0,110,-130,170,1.5,-145,4.59,Busch Stadium,4,2
2015-07-05,2015,OAK,SEA,1,2,-108,-1.5,185,7.5,-115,-105,-102,1.5,-215,3.89,Oakland Coliseum,3,-1
2015-07-05,2015,WSH,SF,3,1,-160,-1.5,130,7.0,-115,-105,145,1.5,-150,4.31,Nationals Park,4,2
2015-07-05,2015,SD,STL,1,3,170,1.5,-145,7.0,110,-130,-190,-1.5,125,2.59,Busch Stadium,4,-2
2015-07-05,2015,NYY,TB,1,8,-126,-1.5,155,9.0,-105,-115,116,1.5,-175,5.02,Yankee Stadium,9,-7
2015-07-05,2015,LAA,TEX,12,6,-127,-1.5,130,9.0,-125,105,117,1.5,-150,5.04,Rangers Ballpark,18,6
2015-07-05,2015,DET,TOR,5,10,117,1.5,-145,9.0,-120,100,-127,-1.5,125,4.15,Comerica Park,15,-5
2015-07-05,2015,SF,WSH,1,3,145,1.5,-150,7.0,-115,-105,-160,-1.5,130,2.86,Nationals Park,4,-2
2015-07-06,2015,MIL,ATL,3,5,-160,-1.5,145,8.5,-106,-114,145,1.5,-165,5.23,Miller Park,8,-2
2015-07-06,2015,MIN,BAL,4,2,106,1.5,-165,7.5,105,-125,-116,-1.5,145,3.64,Target Field,6,2
2015-07-06,2015,STL,CHC,6,0,107,1.5,-205,8.5,-119,-101,-117,-1.5,175,4.11,Wrigley Field,6,6
2015-07-06,2015,WSH,CIN,2,3,-116,-1.5,180,8.0,-105,-115,106,1.5,-210,4.3,Nationals Park,5,-1
2015-07-06,2015,HOU,CLE,9,4,108,1.5,-215,7.0,-102,-118,-118,-1.5,185,3.37,Progressive Field,13,5
2015-07-06,2015,TOR,CWS,2,4,110,1.5,-205,8.0,100,-120,-120,-1.5,175,3.81,Guaranteed Rate Field,6,-2
2015-07-06,2015,SEA,DET,5,12,-172,-1.5,125,8.0,-105,-115,152,1.5,-145,5.06,T-Mobile Park,17,-7
2015-07-06,2015,CLE,HOU,4,9,-118,-1.5,185,7.0,-102,-118,108,1.5,-215,3.79,Progressive Field,13,-5
2015-07-06,2015,PHI,LAD,7,10,225,1.5,104,8.0,-105,-115,-265,-1.5,-124,2.46,Dodger Stadium,17,-3
2015-07-06,2015,ATL,MIL,5,3,145,1.5,-165,8.5,-106,-114,-160,-1.5,145,3.47,Miller Park,8,2
2015-07-06,2015,BAL,MIN,2,4,-116,-1.5,145,7.5,105,-125,106,1.5,-165,4.03,Target Field,6,-2
2015-07-06,2015,SF,NYM,0,3,-146,-1.5,161,6.5,-105,-115,131,1.5,-181,3.86,AT&T Park,3,-3
2015-07-06,2015,LAD,PHI,10,7,-265,-1.5,-124,8.0,-105,-115,225,1.5,104,5.81,Dodger Stadium,17,3
2015-07-06,2015,SD,PIT,1,2,104,1.5,-230,7.0,-120,100,-114,-1.5,190,3.43,PNC Park,3,-1
2015-07-06,2015,PIT,SD,2,1,-114,-1.5,190,7.0,-120,100,104,1.5,-230,3.73,PNC Park,3,1
2015-07-06,2015,DET,SEA,12,5,152,1.5,-145,8.0,-105,-115,-172,-1.5,125,3.17,T-Mobile Park,17,7
2015-07-06,2015,NYM,SF,3,0,131,1.5,-181,6.5,-105,-115,-146,-1.5,161,2.81,AT&T Park,3,3
2015-07-06,2015,CHC,STL,0,6,-117,-1.5,175,8.5,-119,-101,107,1.5,-205,4.58,Wrigley Field,6,-6
2015-07-06,2015,CWS,TOR,4,2,-120,-1.5,175,8.0,100,-120,110,1.5,-205,4.36,Guaranteed Rate Field,6,2
2015-07-06,2015,CIN,WSH,3,2,106,1.5,-210,8.0,-105,-115,-116,-1.5,180,3.88,Nationals Park,5,1
2015-07-07,2015,TEX,ARI,2,4,-131,-1.5,161,8.5,-120,100,116,1.5,-191,4.82,Rangers Ballpark,6,-2
2015-07-07,2015,MIL,ATL,3,4,-184,-1.5,120,7.5,-110,-110,164,1.5,-140,4.86,Miller Park,7,-1
2015-07-07,2015,MIN,BAL,8,3,114,1.5,-150,7.0,-125,105,-124,-1.5,130,3.27,Target Field,11,5
2015-07-07,2015,MIA,BOS,3,4,191,1.5,-119,9.0,-101,-119,-221,-1.5,-101,3.09,Fenway Park,7,-1
2015-07-07,2015,STL,CHC,4,7,154,1.5,-165,5.5,100,-120,-174,-1.5,145,2.17,Wrigley Field,11,-3
2015-07-07,2015,STL,CHC,3,5,-105,-1.5,160,7.0,100,-120,-105,1.5,-190,3.59,Wrigley Field,8,-2
2015-07-07,2015,WSH,CIN,0,5,-150,-1.5,160,6.0,-115,-105,135,1.5,-190,3.6,Nationals Park,5,-5
2015-07-07,2015,HOU,CLE,0,2,160,1.5,-140,7.0,-120,100,-180,-1.5,120,2.69,Progressive Field,2,-2
2015-07-07,2015,LAA,COL,10,2,-107,-1.5,135,10.0,-115,-105,-103,1.5,-155,5.17,Coors Field,12,8
2015-07-07,2015,TOR,CWS,2,1,-125,-1.5,130,8.5,-121,101,115,1.5,-150,4.72,Guaranteed Rate Field,3,1
2015-07-07,2015,SEA,DET,7,6,-200,-1.5,110,7.5,-105,-115,170,1.5,-130,5.0,T-Mobile Park,13,1
2015-07-07,2015,CLE,HOU,2,0,-180,-1.5,120,7.0,-120,100,160,1.5,-140,4.5,Progressive Field,2,2
2015-07-07,2015,TB,KC,5,9,106,1.5,-205,6.5,-120,100,-116,-1.5,175,3.16,Kauffman Stadium,14,-4
2015-07-07,2015,TB,KC,1,7,111,1.5,-210,7.0,-105,-115,-121,-1.5,180,3.32,Kauffman Stadium,8,-6
2015-07-07,2015,COL,LAA,2,10,-103,1.5,-155,10.0,-115,-105,-107,-1.5,135,5.07,Coors Field,12,-8
2015-07-07,2015,PHI,LAD,7,2,215,1.5,-110,7.5,-105,-115,-255,-1.5,-110,2.38,Dodger Stadium,9,5
2015-07-07,2015,BOS,MIA,4,3,-221,-1.5,-101,9.0,-101,-119,191,1.5,-119,6.2,Fenway Park,7,1
2015-07-07,2015,ATL,MIL,4,3,164,1.5,-140,7.5,-110,-110,-184,-1.5,120,2.84,Miller Park,7,1
2015-07-07,2015,BAL,MIN,3,8,-124,-1.5,130,7.0,-125,105,114,1.5,-150,3.88,Target Field,11,-5
2015-07-07,2015,SF,NYM,3,0,-121,-1.5,185,7.0,100,-120,111,1.5,-215,3.83,AT&T Park,3,3
2015-07-07,2015,OAK,NYY,4,3,-120,-1.5,135,8.0,-115,-105,110,1.5,-155,4.36,Yankee Stadium,7,1
2015-07-07,2015,NYY,OAK,3,4,110,1.5,-155,8.0,-115,-105,-120,-1.5,135,3.81,Yankee Stadium,7,-1
2015-07-07,2015,LAD,PHI,2,7,-255,-1.5,-110,7.5,-105,-115,215,1.5,-110,5.39,Dodger Stadium,9,-5
2015-07-07,2015,SD,PIT,2,3,130,1.5,-189,7.0,110,-130,-145,-1.5,159,3.04,PNC Park,5,-1
2015-07-07,2015,PIT,SD,3,2,-145,-1.5,159,7.0,110,-130,130,1.5,-189,4.14,PNC Park,5,1
2015-07-07,2015,DET,SEA,6,7,170,1.5,-130,7.5,-105,-115,-200,-1.5,110,2.78,T-Mobile Park,13,-1
2015-07-07,2015,NYM,SF,0,3,111,1.5,-215,7.0,100,-120,-121,-1.5,185,3.32,AT&T Park,3,-3
2015-07-07,2015,CHC,STL,7,4,-174,-1.5,145,5.5,100,-120,154,1.5,-165,3.49,Wrigley Field,11,3
2015-07-07,2015,CHC,STL,5,3,-105,1.5,-190,7.0,100,-120,-105,-1.5,160,3.59,Wrigley Field,8,2
2015-07-07,2015,KC,TB,9,5,-116,-1.5,175,6.5,-120,100,106,1.5,-205,3.49,Kauffman Stadium,14,4
2015-07-07,2015,KC,TB,7,1,-121,-1.5,180,7.0,-105,-115,111,1.5,-210,3.83,Kauffman Stadium,8,6
2015-07-07,2015,ARI,TEX,4,2,116,1.5,-191,8.5,-120,100,-131,-1.5,161,3.94,Rangers Ballpark,6,2
2015-07-07,2015,CWS,TOR,1,2,115,1.5,-150,8.5,-121,101,-125,-1.5,130,3.95,Guaranteed Rate Field,3,-1
2015-07-07,2015,CIN,WSH,5,0,135,1.5,-190,6.0,-115,-105,-150,-1.5,160,2.55,Nationals Park,5,5
2015-07-08,2015,TEX,ARI,4,7,-109,-1.5,170,9.5,-109,-111,-101,1.5,-200,4.95,Rangers Ballpark,11,-3
2015-07-08,2015,MIL,ATL,6,5,-142,-1.5,160,7.0,100,-120,127,1.5,-180,4.11,Miller Park,11,1
2015-07-08,2015,MIN,BAL,5,3,119,1.5,-145,7.5,-115,-105,-129,-1.5,125,3.42,Target Field,8,2
2015-07-08,2015,MIA,BOS,3,6,160,1.5,-135,9.0,-110,-110,-180,-1.5,115,3.46,Fenway Park,9,-3
2015-07-08,2015,STL,CHC,6,5,105,1.5,-235,6.5,-115,-105,-115,-1.5,195,3.17,Wrigley Field,11,1
2015-07-08,2015,HOU,CLE,2,4,127,1.5,-175,8.0,-107,-113,-142,-1.5,155,3.52,Progressive Field,6,-2
2015-07-08,2015,LAA,COL,3,2,-130,-1.5,120,10.5,-104,-116,115,1.5,-140,5.93,Coors Field,5,1
2015-07-08,2015,TOR,CWS,6,7,-160,-1.5,-105,9.0,105,-125,145,1.5,-115,5.54,Guaranteed Rate Field,13,-1
2015-07-08,2015,SEA,DET,4,5,-114,-1.5,185,7.5,105,-125,104,1.5,-215,4.0,T-Mobile Park,9,-1
2015-07-08,2015,CLE,HOU,4,2,-142,-1.5,155,8.0,-107,-113,127,1.5,-175,4.69,Progressive Field,6,2
2015-07-08,2015,TB,KC,7,9,-142,-1.5,120,6.5,-104,-116,127,1.5,-140,3.81,Kauffman Stadium,16,-2
2015-07-08,2015,COL,LAA,2,3,115,1.5,-140,10.5,-104,-116,-130,-1.5,120,4.88,Coors Field,5,-1
2015-07-08,2015,PHI,LAD,0,5,338,1.5,128,6.5,-114,-106,-398,-1.5,-148,1.48,Dodger Stadium,5,-5
2015-07-08,2015,BOS,MIA,6,3,-180,-1.5,115,9.0,-110,-110,160,1.5,-135,5.79,Fenway Park,9,3
2015-07-08,2015,ATL,MIL,5,6,127,1.5,-180,7.0,100,-120,-142,-1.5,160,3.08,Miller Park,11,-1
2015-07-08,2015,BAL,MIN,3,5,-129,-1.5,125,7.5,-115,-105,119,1.5,-145,4.22,Target Field,8,-2
2015-07-08,2015,SF,NYM,1,4,103,1.5,-190,6.5,-120,100,-113,-1.5,160,3.2,AT&T Park,5,-3
2015-07-08,2015,OAK,NYY,4,5,-105,-1.5,150,8.0,-120,100,-105,1.5,-170,4.1,Yankee Stadium,9,-1
2015-07-08,2015,NYY,OAK,5,4,-105,1.5,-170,8.0,-120,100,-105,-1.5,150,4.1,Yankee Stadium,9,1
2015-07-08,2015,LAD,PHI,5,0,-398,-1.5,-148,6.5,-114,-106,338,1.5,128,5.19,Dodger Stadium,5,5
2015-07-08,2015,SD,PIT,2,5,117,1.5,-195,7.0,-115,-105,-127,-1.5,166,3.23,PNC Park,7,-3
2015-07-08,2015,PIT,SD,5,2,-127,-1.5,166,7.0,-115,-105,117,1.5,-195,3.92,PNC Park,7,3
2015-07-08,2015,DET,SEA,5,4,104,1.5,-215,7.5,105,-125,-114,-1.5,185,3.68,T-Mobile Park,9,1
2015-07-08,2015,NYM,SF,4,1,-113,-1.5,160,6.5,-120,100,103,1.5,-190,3.45,AT&T Park,5,3
2015-07-08,2015,CHC,STL,5,6,-115,-1.5,195,6.5,-115,-105,105,1.5,-235,3.48,Wrigley Field,11,-1
2015-07-08,2015,KC,TB,9,7,127,1.5,-140,6.5,-104,-116,-142,-1.5,120,2.86,Kauffman Stadium,16,2
2015-07-08,2015,ARI,TEX,7,4,-101,1.5,-200,9.5,-109,-111,-109,-1.5,170,4.77,Rangers Ballpark,11,3
2015-07-08,2015,CWS,TOR,7,6,145,1.5,-115,9.0,105,-125,-160,-1.5,-105,3.67,Guaranteed Rate Field,13,1
2015-07-09,2015,COL,ATL,5,3,-110,-1.5,170,10.0,-110,-110,100,1.5,-200,5.24,Coors Field,8,2
2015-07-09,2015,MIA,CIN,2,0,-150,-1.5,155,7.0,100,-120,135,1.5,-175,4.2,Marlins Park,2,2
2015-07-09,2015,HOU,CLE,1,3,108,1.5,-205,8.0,-117,-103,-118,-1.5,175,3.85,Progressive Field,4,-2
2015-07-09,2015,ATL,COL,3,5,100,1.5,-200,10.0,-110,-110,-110,-1.5,170,5.0,Coors Field,8,-2
2015-07-09,2015,TOR,CWS,0,2,112,1.5,-195,8.0,-110,-110,-122,-1.5,165,3.77,Guaranteed Rate Field,2,-2
2015-07-09,2015,MIN,DET,2,4,115,1.5,-150,8.0,-115,-105,-125,-1.5,130,3.72,Target Field,6,-2
2015-07-09,2015,CLE,HOU,3,1,-118,-1.5,175,8.0,-117,-103,108,1.5,-205,4.33,Progressive Field,4,2
2015-07-09,2015,TB,KC,3,8,118,1.5,-200,7.0,-105,-115,-128,-1.5,170,3.21,Kauffman Stadium,11,-5
2015-07-09,2015,SEA,LAA,7,2,-140,-1.5,159,7.0,-105,-115,125,1.5,-189,4.08,T-Mobile Park,9,5
2015-07-09,2015,PHI,LAD,0,6,275,1.5,115,7.0,100,-120,-325,-1.5,-135,1.87,Dodger Stadium,6,-6
2015-07-09,2015,CIN,MIA,0,2,135,1.5,-175,7.0,100,-120,-150,-1.5,155,2.98,Marlins Park,2,-2
2015-07-09,2015,DET,MIN,4,2,-125,-1.5,130,8.0,-115,-105,115,1.5,-150,4.44,Target Field,6,2
2015-07-09,2015,OAK,NYY,2,6,141,1.5,-160,8.5,-104,-116,-156,-1.5,140,3.53,Yankee Stadium,8,-4
2015-07-09,2015,NYY,OAK,6,2,-156,-1.5,140,8.5,-104,-116,141,1.5,-160,5.18,Yankee Stadium,8,4
2015-07-09,2015,LAD,PHI,6,0,-325,-1.5,-135,7.0,100,-120,275,1.5,115,5.35,Dodger Stadium,6,6
2015-07-09,2015,STL,PIT,4,1,100,1.5,-230,7.0,106,-126,-110,-1.5,190,3.5,PNC Park,5,3
2015-07-09,2015,LAA,SEA,2,7,125,1.5,-189,7.0,-105,-115,-140,-1.5,159,3.11,T-Mobile Park,9,-5
2015-07-09,2015,PIT,STL,1,4,-110,-1.5,190,7.0,106,-126,100,1.5,-230,3.67,PNC Park,5,-3
2015-07-09,2015,KC,TB,8,3,-128,-1.5,170,7.0,-105,-115,118,1.5,-200,3.93,Kauffman Stadium,11,5
2015-07-09,2015,CWS,TOR,2,0,-122,-1.5,165,8.0,-110,-110,112,1.5,-195,4.4,Guaranteed Rate Field,2,2
2015-07-10,2015,NYM,ARI,4,2,-141,-1.5,170,7.0,105,-125,126,1.5,-200,4.1,Citi Field,6,2
2015-07-10,2015,COL,ATL,5,3,-114,-1.5,170,10.0,-105,-115,104,1.5,-200,5.33,Coors Field,8,2
2015-07-10,2015,WSH,BAL,2,3,115,1.5,-180,8.5,-110,-110,-130,-1.5,160,3.95,Camden Yards,5,-1
2015-07-10,2015,NYY,BOS,5,1,-112,-1.5,145,7.5,-121,101,102,1.5,-165,3.96,Fenway Park,6,4
2015-07-10,2015,CWS,CHC,1,0,149,1.5,-160,7.0,-125,105,-164,-1.5,140,2.81,Wrigley Field,1,1
2015-07-10,2015,MIA,CIN,0,1,112,1.5,-160,7.0,-105,-115,-122,-1.5,140,3.3,Marlins Park,1,-1
2015-07-10,2015,OAK,CLE,1,5,142,1.5,-165,7.5,-115,-105,-157,-1.5,145,3.1,Progressive Field,6,-4
2015-07-10,2015,ATL,COL,3,5,104,1.5,-200,10.0,-105,-115,-114,-1.5,170,4.9,Coors Field,8,-2
2015-07-10,2015,CHC,CWS,0,1,-164,-1.5,140,7.0,-125,105,149,1.5,-160,4.35,Wrigley Field,1,-1
2015-07-10,2015,MIN,DET,8,6,-120,-1.5,170,8.5,-106,-114,110,1.5,-200,4.64,Target Field,14,2
2015-07-10,2015,TB,HOU,3,1,-110,-1.5,195,7.0,105,-125,100,1.5,-235,3.67,Tropicana Field,4,2
2015-07-10,2015,TOR,KC,0,3,-116,-1.5,140,8.5,-120,100,106,1.5,-160,4.56,Kauffman Stadium,3,-3
2015-07-10,2015,SEA,LAA,3,7,107,1.5,-165,7.5,-104,-116,-117,-1.5,145,3.62,T-Mobile Park,10,-4
2015-07-10,2015,MIL,LAD,2,3,141,1.5,-160,7.0,-110,-110,-156,-1.5,140,2.9,Dodger Stadium,5,-1
2015-07-10,2015,CIN,MIA,1,0,-122,-1.5,140,7.0,-105,-115,112,1.5,-160,3.85,Marlins Park,1,1
2015-07-10,2015,LAD,MIL,3,2,-156,-1.5,140,7.0,-110,-110,141,1.5,-160,4.27,Dodger Stadium,5,1
2015-07-10,2015,DET,MIN,6,8,110,1.5,-200,8.5,-106,-114,-120,-1.5,170,4.05,Target Field,14,-2
2015-07-10,2015,ARI,NYM,2,4,126,1.5,-200,7.0,105,-125,-141,-1.5,170,3.1,Citi Field,6,-2
2015-07-10,2015,BOS,NYY,1,5,102,1.5,-165,7.5,-121,101,-112,-1.5,145,3.71,Fenway Park,6,-4
2015-07-10,2015,CLE,OAK,5,1,-157,-1.5,145,7.5,-115,-105,142,1.5,-165,4.58,Progressive Field,6,4
2015-07-10,2015,SF,PHI,15,2,-172,-1.5,145,6.0,105,-125,152,1.5,-165,3.79,AT&T Park,17,13
2015-07-10,2015,STL,PIT,2,5,126,1.5,-205,6.0,-122,102,-141,-1.5,175,2.65,PNC Park,7,-3
2015-07-10,2015,TEX,SD,4,3,-120,-1.5,165,9.5,-116,-104,110,1.5,-195,5.18,Rangers Ballpark,7,1
2015-07-10,2015,LAA,SEA,7,3,-117,-1.5,145,7.5,-104,-116,107,1.5,-165,4.04,T-Mobile Park,10,4
2015-07-10,2015,PHI,SF,2,15,152,1.5,-165,6.0,105,-125,-172,-1.5,145,2.38,AT&T Park,17,-13
2015-07-10,2015,PIT,STL,5,2,-141,-1.5,175,6.0,-122,102,126,1.5,-205,3.51,PNC Park,7,3
2015-07-10,2015,HOU,TB,1,3,100,1.5,-235,7.0,105,-125,-110,-1.5,195,3.5,Tropicana Field,4,-2
2015-07-10,2015,SD,TEX,3,4,110,1.5,-195,9.5,-116,-104,-120,-1.5,165,4.52,Rangers Ballpark,7,-1
2015-07-10,2015,KC,TOR,3,0,106,1.5,-160,8.5,-120,100,-116,-1.5,140,4.13,Kauffman Stadium,3,3
2015-07-10,2015,BAL,WSH,3,2,-130,-1.5,160,8.5,-110,-110,115,1.5,-180,4.8,Camden Yards,5,1
2015-07-11,2015,NYM,ARI,4,2,-130,-1.5,165,6.5,-119,-101,115,1.5,-195,3.67,Citi Field,6,2
2015-07-11,2015,COL,ATL,3,2,-148,-1.5,140,10.0,-110,-110,133,1.5,-160,5.97,Coors Field,5,1
2015-07-11,2015,WSH,BAL,7,4,110,1.5,-200,7.5,-115,-105,-120,-1.5,170,3.57,Camden Yards,11,3
2015-07-11,2015,NYY,BOS,3,5,131,1.5,-165,8.5,-120,100,-146,-1.5,145,3.68,Fenway Park,8,-2
2015-07-11,2015,CWS,CHC,5,1,-118,-1.5,150,6.5,108,-128,108,1.5,-170,3.52,Wrigley Field,6,4
2015-07-11,2015,MIA,CIN,14,3,117,1.5,-145,7.5,100,-120,-127,-1.5,125,3.46,Marlins Park,17,11
2015-07-11,2015,OAK,CLE,5,4,140,1.5,-160,7.5,105,-125,-155,-1.5,140,3.13,Progressive Field,9,1
2015-07-11,2015,ATL,COL,2,3,133,1.5,-160,10.0,-110,-110,-148,-1.5,140,4.29,Coors Field,5,-1
2015-07-11,2015,CHC,CWS,1,5,108,1.5,-170,6.5,108,-128,-118,-1.5,150,3.13,Wrigley Field,6,-4
2015-07-11,2015,MIN,DET,9,5,-147,-1.5,140,9.0,-105,-115,132,1.5,-160,5.36,Target Field,14,4
2015-07-11,2015,TB,HOU,3,0,-101,1.5,-170,6.5,-105,-115,-109,-1.5,150,3.27,Tropicana Field,3,3
2015-07-11,2015,TOR,KC,6,2,-134,-1.5,115,8.0,-110,-110,119,1.5,-135,4.58,Kauffman Stadium,8,4
2015-07-11,2015,SEA,LAA,5,0,-109,-1.5,185,7.5,110,-130,-101,1.5,-215,3.91,T-Mobile Park,5,5
2015-07-11,2015,MIL,LAD,7,1,126,1.5,-170,7.5,-116,-104,-141,-1.5,150,3.32,Dodger Stadium,8,6
2015-07-11,2015,CIN,MIA,3,14,-127,-1.5,125,7.5,100,-120,117,1.5,-145,4.2,Marlins Park,17,-11
2015-07-11,2015,LAD,MIL,1,7,-141,-1.5,150,7.5,-116,-104,126,1.5,-170,4.39,Dodger Stadium,8,-6
2015-07-11,2015,DET,MIN,5,9,132,1.5,-160,9.0,-105,-115,-147,-1.5,140,3.88,Target Field,14,-4
2015-07-11,2015,ARI,NYM,2,4,115,1.5,-195,6.5,-119,-101,-130,-1.5,165,3.02,Citi Field,6,-2
2015-07-11,2015,BOS,NYY,5,3,-146,-1.5,145,8.5,-120,100,131,1.5,-165,5.04,Fenway Park,8,2
2015-07-11,2015,CLE,OAK,4,5,-155,-1.5,140,7.5,105,-125,140,1.5,-160,4.56,Progressive Field,9,-1
2015-07-11,2015,SF,PHI,8,5,-201,-1.5,102,7.5,-120,100,171,1.5,-122,5.01,AT&T Park,13,3
2015-07-11,2015,STL,PIT,5,6,112,1.5,-210,7.0,100,-120,-122,-1.5,180,3.3,PNC Park,11,-1
2015-07-11,2015,TEX,SD,5,6,-125,-1.5,155,9.0,-120,100,115,1.5,-175,5.0,Rangers Ballpark,11,-1
2015-07-11,2015,LAA,SEA,0,5,-101,1.5,-215,7.5,110,-130,-109,-1.5,185,3.77,T-Mobile Park,5,-5
2015-07-11,2015,PHI,SF,5,8,171,1.5,-122,7.5,-120,100,-201,-1.5,102,2.77,AT&T Park,13,-3
2015-07-11,2015,PIT,STL,6,5,-122,-1.5,180,7.0,100,-120,112,1.5,-210,3.85,PNC Park,11,1
2015-07-11,2015,HOU,TB,0,3,-109,-1.5,150,6.5,-105,-115,-101,1.5,-170,3.39,Tropicana Field,3,-3
2015-07-11,2015,SD,TEX,6,5,115,1.5,-175,9.0,-120,100,-125,-1.5,155,4.19,Rangers Ballpark,11,1
2015-07-11,2015,KC,TOR,2,6,119,1.5,-135,8.0,-110,-110,-134,-1.5,115,3.65,Kauffman Stadium,8,-4
2015-07-11,2015,BAL,WSH,4,7,-120,-1.5,170,7.5,-115,-105,110,1.5,-200,4.09,Camden Yards,11,-3
2015-07-12,2015,NYM,ARI,5,3,102,1.5,-165,7.5,-120,100,-112,-1.5,145,3.71,Citi Field,8,2
2015-07-12,2015,COL,ATL,11,3,-126,-1.5,150,10.5,-113,-107,116,1.5,-170,5.85,Coors Field,14,8
2015-07-12,2015,WSH,BAL,3,2,-112,-1.5,145,7.0,-105,-115,102,1.5,-165,3.7,Camden Yards,5,1
2015-07-12,2015,NYY,BOS,8,6,-105,-1.5,150,9.0,-120,100,-105,1.5,-170,4.61,Fenway Park,14,2
2015-07-12,2015,CWS,CHC,1,3,158,1.5,-155,6.0,-110,-110,-178,-1.5,135,2.33,Wrigley Field,4,-2
2015-07-12,2015,MIA,CIN,8,1,139,1.5,-130,6.0,-101,-119,-154,-1.5,110,2.51,Marlins Park,9,7
2015-07-12,2015,OAK,CLE,2,0,125,1.5,-200,6.5,100,-120,-140,-1.5,170,2.89,Progressive Field,2,2
2015-07-12,2015,ATL,COL,3,11,116,1.5,-170,10.5,-113,-107,-126,-1.5,150,4.86,Coors Field,14,-8
2015-07-12,2015,CHC,CWS,3,1,-178,-1.5,135,6.0,-110,-110,158,1.5,-155,3.84,Wrigley Field,4,2
2015-07-12,2015,MIN,DET,7,1,-130,-1.5,155,9.0,100,-120,115,1.5,-175,5.09,Target Field,8,6
2015-07-12,2015,TB,HOU,4,3,114,1.5,-150,7.0,-115,-105,-124,-1.5,130,3.27,Tropicana Field,7,1
2015-07-12,2015,TOR,KC,10,11,111,1.5,-205,8.5,-119,-101,-121,-1.5,175,4.03,Kauffman Stadium,21,-1
2015-07-12,2015,SEA,LAA,3,10,-105,1.5,-175,7.5,-105,-115,-105,-1.5,155,3.84,T-Mobile Park,13,-7
2015-07-12,2015,MIL,LAD,3,4,138,1.5,-165,7.0,-125,105,-153,-1.5,145,2.94,Dodger Stadium,7,-1
2015-07-12,2015,CIN,MIA,1,8,-154,-1.5,110,6.0,-101,-119,139,1.5,-130,3.64,Marlins Park,9,-7
2015-07-12,2015,LAD,MIL,4,3,-153,-1.5,145,7.0,-125,105,138,1.5,-165,4.23,Dodger Stadium,7,1
2015-07-12,2015,DET,MIN,1,7,115,1.5,-175,9.0,100,-120,-130,-1.5,155,4.19,Target Field,8,-6
2015-07-12,2015,ARI,NYM,3,5,-112,-1.5,145,7.5,-120,100,102,1.5,-165,3.96,Citi Field,8,-2
2015-07-12,2015,BOS,NYY,6,8,-105,1.5,-170,9.0,-120,100,-105,-1.5,150,4.61,Fenway Park,14,-2
2015-07-12,2015,CLE,OAK,0,2,-140,-1.5,170,6.5,100,-120,125,1.5,-200,3.79,Progressive Field,2,-2
2015-07-12,2015,SF,PHI,4,2,-211,-1.5,-105,7.5,-119,-101,181,1.5,-115,5.09,AT&T Park,6,2
2015-07-12,2015,STL,PIT,5,6,149,1.5,-155,6.5,-120,100,-164,-1.5,135,2.61,PNC Park,11,-1
2015-07-12,2015,TEX,SD,1,2,-145,-1.5,145,9.0,100,-120,130,1.5,-165,5.33,Rangers Ballpark,3,-1
2015-07-12,2015,LAA,SEA,10,3,-105,-1.5,155,7.5,-105,-115,-105,1.5,-175,3.84,T-Mobile Park,13,7
2015-07-12,2015,PHI,SF,2,4,181,1.5,-115,7.5,-119,-101,-211,-1.5,-105,2.67,AT&T Park,6,-2
2015-07-12,2015,PIT,STL,6,5,-164,-1.5,135,6.5,-120,100,149,1.5,-155,4.04,PNC Park,11,1
2015-07-12,2015,HOU,TB,3,4,-124,-1.5,130,7.0,-115,-105,114,1.5,-150,3.88,Tropicana Field,7,-1
2015-07-12,2015,SD,TEX,2,1,130,1.5,-165,9.0,100,-120,-145,-1.5,145,3.91,Rangers Ballpark,3,1
2015-07-12,2015,KC,TOR,11,10,-121,-1.5,175,8.5,-119,-101,111,1.5,-205,4.65,Kauffman Stadium,21,1
2015-07-12,2015,BAL,WSH,2,3,102,1.5,-165,7.0,-105,-115,-112,-1.5,145,3.47,Camden Yards,5,-1
2015-07-17,2015,SF,ARI,6,5,104,1.5,-215,8.0,-120,100,-114,-1.5,185,3.92,Chase Field,11,1
2015-07-17,2015,CHC,ATL,2,4,-128,-1.5,135,7.5,105,-125,118,1.5,-155,4.21,Turner Field,6,-2
2015-07-17,2015,DET,BAL,7,3,-104,1.5,-175,8.0,-120,100,-106,-1.5,155,4.08,Comerica Park,10,4
2015-07-17,2015,LAA,BOS,1,0,-130,-1.5,160,8.0,100,-120,115,1.5,-190,4.52,Angel Stadium,1,1
2015-07-17,2015,ATL,CHC,4,2,118,1.5,-155,7.5,105,-125,-128,-1.5,135,3.44,Turner Field,6,2
2015-07-17,2015,CLE,CIN,1,6,-107,-1.5,150,8.5,-120,100,-103,1.5,-170,4.39,Great American Ballpark,7,-5
2015-07-17,2015,CIN,CLE,6,1,-103,1.5,-170,8.5,-120,100,-107,-1.5,150,4.31,Great American Ballpark,7,5
2015-07-17,2015,SD,COL,4,2,-140,-1.5,165,7.0,-110,-110,125,1.5,-195,4.08,PETCO Park,6,2
2015-07-17,2015,KC,CWS,4,2,107,1.5,-200,7.5,-115,-105,-117,-1.5,170,3.62,Guaranteed Rate Field,6,2
2015-07-17,2015,KC,CWS,0,2,-112,-1.5,140,9.0,100,-120,102,1.5,-160,4.75,Guaranteed Rate Field,2,-2
2015-07-17,2015,BAL,DET,3,7,-106,-1.5,155,8.0,-120,100,-104,1.5,-175,4.12,Comerica Park,10,-4
2015-07-17,2015,TEX,HOU,2,3,128,1.5,-165,8.0,-105,-115,-143,-1.5,145,3.51,Minute Maid Park,5,-1
2015-07-17,2015,CWS,KC,2,4,-117,-1.5,170,7.5,-115,-105,107,1.5,-200,4.04,Guaranteed Rate Field,6,-2
2015-07-17,2015,CWS,KC,2,0,102,1.5,-160,9.0,100,-120,-112,-1.5,140,4.46,Guaranteed Rate Field,2,2
2015-07-17,2015,BOS,LAA,0,1,115,1.5,-190,8.0,100,-120,-130,-1.5,160,3.72,Angel Stadium,1,-1
2015-07-17,2015,WSH,LAD,5,3,111,1.5,-150,7.5,110,-130,-121,-1.5,130,3.55,Nationals Park,8,2
2015-07-17,2015,PHI,MIA,6,3,152,1.5,-115,7.0,-111,-109,-172,-1.5,-105,2.78,Citizens Bank Park,9,3
2015-07-17,2015,PIT,MIL,1,4,-102,1.5,-210,8.5,-115,-105,-108,-1.5,180,4.29,Miller Park,5,-3
2015-07-17,2015,OAK,MIN,0,5,-172,-1.5,130,6.5,-115,-105,152,1.5,-150,4.11,Oakland Coliseum,5,-5
2015-07-17,2015,STL,NYM,3,2,-146,-1.5,160,7.0,-115,-105,131,1.5,-190,4.15,Busch Stadium,5,1
2015-07-17,2015,SEA,NYY,3,4,151,1.5,-145,8.0,-105,-115,-171,-1.5,125,3.19,Yankee Stadium,7,-1
2015-07-17,2015,MIN,OAK,5,0,152,1.5,-150,6.5,-115,-105,-172,-1.5,130,2.58,Oakland Coliseum,5,5
2015-07-17,2015,MIA,PHI,3,6,-172,-1.5,-105,7.0,-111,-109,152,1.5,-115,4.43,Citizens Bank Park,9,-3
2015-07-17,2015,MIL,PIT,4,1,-108,-1.5,180,8.5,-115,-105,-102,1.5,-210,4.41,Miller Park,5,3
2015-07-17,2015,COL,SD,2,4,125,1.5,-195,7.0,-110,-110,-140,-1.5,165,3.11,PETCO Park,6,-2
2015-07-17,2015,NYY,SEA,4,3,-171,-1.5,125,8.0,-105,-115,151,1.5,-145,5.05,Yankee Stadium,7,1
2015-07-17,2015,ARI,SF,5,6,-114,-1.5,185,8.0,-120,100,104,1.5,-215,4.26,Chase Field,11,-1
2015-07-17,2015,NYM,STL,2,3,131,1.5,-190,7.0,-115,-105,-146,-1.5,160,3.03,Busch Stadium,5,-1
2015-07-17,2015,TOR,TB,6,2,-147,-1.5,130,8.5,100,-120,132,1.5,-150,5.06,Rogers Centre,8,4
2015-07-17,2015,HOU,TEX,3,2,-143,-1.5,145,8.0,-105,-115,128,1.5,-165,4.71,Minute Maid Park,5,1
2015-07-17,2015,TB,TOR,2,6,132,1.5,-150,8.5,100,-120,-147,-1.5,130,3.66,Rogers Centre,8,-4
2015-07-17,2015,LAD,WSH,3,5,-121,-1.5,130,7.5,110,-130,111,1.5,-150,4.11,Nationals Park,8,-2
2015-07-18,2015,SF,ARI,8,4,-105,1.5,-215,8.5,-115,-105,-105,-1.5,185,4.35,Chase Field,12,4
2015-07-18,2015,CHC,ATL,4,0,-170,-1.5,105,7.5,110,-130,150,1.5,-125,4.72,Turner Field,4,4
2015-07-18,2015,DET,BAL,0,3,-127,-1.5,154,8.0,-105,-115,117,1.5,-174,4.48,Comerica Park,3,-3
2015-07-18,2015,LAA,BOS,3,0,-142,-1.5,160,7.5,110,-130,127,1.5,-190,4.4,Angel Stadium,3,3
2015-07-18,2015,ATL,CHC,0,4,150,1.5,-125,7.5,110,-130,-170,-1.5,105,3.0,Turner Field,4,-4
2015-07-18,2015,CLE,CIN,9,4,-158,-1.5,100,7.5,-110,-110,143,1.5,-120,4.59,Great American Ballpark,13,5
2015-07-18,2015,CIN,CLE,4,9,143,1.5,-120,7.5,-110,-110,-158,-1.5,100,3.09,Great American Ballpark,13,-5
2015-07-18,2015,SD,COL,5,4,-143,-1.5,170,6.5,-120,100,128,1.5,-200,3.83,PETCO Park,9,1
2015-07-18,2015,KC,CWS,7,6,103,1.5,-200,7.5,-115,-105,-113,-1.5,170,3.69,Guaranteed Rate Field,13,1
2015-07-18,2015,BAL,DET,3,0,117,1.5,-174,8.0,-105,-115,-127,-1.5,154,3.69,Comerica Park,3,3
2015-07-18,2015,TEX,HOU,7,6,118,1.5,-190,8.5,-115,-105,-128,-1.5,160,3.9,Minute Maid Park,13,1
2015-07-18,2015,CWS,KC,6,7,-113,-1.5,170,7.5,-115,-105,103,1.5,-200,3.98,Guaranteed Rate Field,13,-1
2015-07-18,2015,BOS,LAA,0,3,127,1.5,-190,7.5,110,-130,-142,-1.5,160,3.3,Angel Stadium,3,-3
2015-07-18,2015,WSH,LAD,2,4,202,1.5,100,7.0,100,-120,-232,-1.5,-120,2.32,Nationals Park,6,-2
2015-07-18,2015,PHI,MIA,3,1,104,1.5,-160,7.5,-120,100,-114,-1.5,140,3.68,Citizens Bank Park,4,2
2015-07-18,2015,PIT,MIL,5,8,-131,-1.5,136,8.0,-105,-115,116,1.5,-156,4.54,Miller Park,13,-3
2015-07-18,2015,OAK,MIN,3,2,-156,-1.5,140,7.0,-115,-105,141,1.5,-160,4.27,Oakland Coliseum,5,1
2015-07-18,2015,STL,NYM,12,2,-170,-1.5,130,7.5,100,-120,150,1.5,-150,4.72,Busch Stadium,14,10
2015-07-18,2015,SEA,NYY,4,3,146,1.5,-145,8.0,-115,-105,-161,-1.5,125,3.25,Yankee Stadium,7,1
2015-07-18,2015,MIN,OAK,2,3,141,1.5,-160,7.0,-115,-105,-156,-1.5,140,2.9,Oakland Coliseum,5,-1
2015-07-18,2015,MIA,PHI,1,3,-114,-1.5,140,7.5,-120,100,104,1.5,-160,4.0,Citizens Bank Park,4,-2
2015-07-18,2015,MIL,PIT,8,5,116,1.5,-156,8.0,-105,-115,-131,-1.5,136,3.7,Miller Park,13,3
2015-07-18,2015,COL,SD,4,5,128,1.5,-200,6.5,-120,100,-143,-1.5,170,2.85,PETCO Park,9,-1
2015-07-18,2015,NYY,SEA,3,4,-161,-1.5,125,8.0,-115,-105,146,1.5,-145,4.93,Yankee Stadium,7,-1
2015-07-18,2015,ARI,SF,4,8,-105,-1.5,185,8.5,-115,-105,-105,1.5,-215,4.35,Chase Field,12,-4
2015-07-18,2015,NYM,STL,2,12,150,1.5,-150,7.5,100,-120,-170,-1.5,130,3.0,Busch Stadium,14,-10
2015-07-18,2015,TOR,TB,2,3,-140,-1.5,145,9.0,100,-120,125,1.5,-165,5.25,Rogers Centre,5,-1
2015-07-18,2015,HOU,TEX,6,7,-128,-1.5,160,8.5,-115,-105,118,1.5,-190,4.77,Minute Maid Park,13,-1
2015-07-18,2015,TB,TOR,3,2,125,1.5,-165,9.0,100,-120,-140,-1.5,145,4.0,Rogers Centre,5,1
2015-07-18,2015,LAD,WSH,4,2,-232,-1.5,-120,7.0,100,-120,202,1.5,100,4.89,Nationals Park,6,2
2015-07-19,2015,SF,ARI,2,1,-108,-1.5,155,7.5,105,-125,-102,1.5,-175,3.89,Chase Field,3,1
2015-07-19,2015,CHC,ATL,4,1,-170,-1.5,100,6.5,-115,-105,150,1.5,-120,4.09,Turner Field,5,3
2015-07-19,2015,DET,BAL,3,9,-117,-1.5,170,9.0,-110,-110,107,1.5,-200,4.85,Comerica Park,12,-6
2015-07-19,2015,ATL,CHC,1,4,150,1.5,-120,6.5,-115,-105,-170,-1.5,100,2.6,Turner Field,5,-3
2015-07-19,2015,CLE,CIN,5,3,101,1.5,-230,7.0,100,-120,-111,-1.5,190,3.48,Great American Ballpark,8,2
2015-07-19,2015,CIN,CLE,3,5,-111,-1.5,190,7.0,100,-120,101,1.5,-230,3.68,Great American Ballpark,8,-2
2015-07-19,2015,KC,CWS,4,1,153,1.5,-145,7.0,-110,-110,-173,-1.5,125,2.77,Guaranteed Rate Field,5,3
2015-07-19,2015,BAL,DET,9,3,107,1.5,-200,9.0,-110,-110,-117,-1.5,170,4.35,Comerica Park,12,6
2015-07-19,2015,TEX,HOU,0,10,163,1.5,-140,7.0,-115,-105,-183,-1.5,120,2.66,Minute Maid Park,10,-10
2015-07-19,2015,CWS,KC,1,4,-173,-1.5,125,7.0,-110,-110,153,1.5,-145,4.44,Guaranteed Rate Field,5,-3
2015-07-19,2015,WSH,LAD,0,5,-103,1.5,-200,6.0,-125,105,-107,-1.5,170,3.04,Nationals Park,5,-5
2015-07-19,2015,PHI,MIA,8,7,-161,-1.5,145,7.5,-105,-115,146,1.5,-165,4.63,Citizens Bank Park,15,1
2015-07-19,2015,PIT,MIL,1,6,125,1.5,-195,8.0,100,-120,-140,-1.5,165,3.56,Miller Park,7,-5
2015-07-19,2015,OAK,MIN,14,1,-157,-1.5,140,7.5,-110,-110,142,1.5,-160,4.58,Oakland Coliseum,15,13
2015-07-19,2015,STL,NYM,1,3,-147,-1.5,145,7.5,-120,100,132,1.5,-165,4.46,Busch Stadium,4,-2
2015-07-19,2015,SEA,NYY,1,2,-113,-1.5,155,8.5,-120,100,103,1.5,-175,4.51,Yankee Stadium,3,-1
2015-07-19,2015,MIN,OAK,1,14,142,1.5,-160,7.5,-110,-110,-157,-1.5,140,3.1,Oakland Coliseum,15,-13
2015-07-19,2015,MIA,PHI,7,8,146,1.5,-165,7.5,-105,-115,-161,-1.5,145,3.05,Citizens Bank Park,15,-1
2015-07-19,2015,MIL,PIT,6,1,-140,-1.5,165,8.0,100,-120,125,1.5,-195,4.67,Miller Park,7,5
2015-07-19,2015,NYY,SEA,2,1,103,1.5,-175,8.5,-120,100,-113,-1.5,155,4.19,Yankee Stadium,3,1
2015-07-19,2015,ARI,SF,1,2,-102,1.5,-175,7.5,105,-125,-108,-1.5,155,3.79,Chase Field,3,-1
2015-07-19,2015,NYM,STL,3,1,132,1.5,-165,7.5,-120,100,-147,-1.5,145,3.23,Busch Stadium,4,2
2015-07-19,2015,TOR,TB,4,0,100,1.5,-170,8.0,-120,100,-110,-1.5,150,4.0,Rogers Centre,4,4
2015-07-19,2015,HOU,TEX,10,0,-183,-1.5,120,7.0,-115,-105,163,1.5,-140,4.53,Minute Maid Park,10,10
2015-07-19,2015,TB,TOR,0,4,-110,-1.5,150,8.0,-120,100,100,1.5,-170,4.19,Rogers Centre,4,-4
2015-07-19,2015,LAD,WSH,5,0,-107,-1.5,170,6.0,-125,105,-103,1.5,-200,3.1,Nationals Park,5,5
2015-07-20,2015,MIA,ARI,1,3,150,1.5,-150,8.0,-105,-115,-165,-1.5,130,3.2,Chase Field,4,-2
2015-07-20,2015,LAD,ATL,5,7,-129,-1.5,125,7.5,-110,-110,119,1.5,-145,4.22,Turner Field,12,-2
2015-07-20,2015,LAA,BOS,11,1,-118,-1.5,170,8.0,-115,-105,108,1.5,-200,4.33,Angel Stadium,12,10
2015-07-20,2015,LAA,BOS,7,3,-152,-1.5,140,8.0,100,-120,137,1.5,-160,4.83,Angel Stadium,10,4
2015-07-20,2015,CIN,CHC,5,4,-109,-1.5,170,9.5,-110,-110,-101,1.5,-200,4.95,Great American Ballpark,9,1
2015-07-20,2015,CHC,CIN,4,5,-101,1.5,-200,9.5,-110,-110,-109,-1.5,170,4.77,Great American Ballpark,9,-1
2015-07-20,2015,TEX,COL,7,8,147,1.5,-150,10.5,-105,-115,-162,-1.5,130,4.25,Coors Field,15,-1
2015-07-20,2015,SEA,DET,4,5,102,1.5,-200,10.0,-110,-110,-112,-1.5,170,4.95,Comerica Park,9,-1
2015-07-20,2015,PIT,KC,10,7,116,1.5,-190,7.0,-110,-110,-131,-1.5,160,3.24,Kauffman Stadium,17,3
2015-07-20,2015,BOS,LAA,1,11,108,1.5,-200,8.0,-115,-105,-118,-1.5,170,3.85,Angel Stadium,12,-10
2015-07-20,2015,BOS,LAA,3,7,137,1.5,-160,8.0,100,-120,-152,-1.5,140,3.38,Angel Stadium,10,-4
2015-07-20,2015,ATL,LAD,7,5,119,1.5,-145,7.5,-110,-110,-129,-1.5,125,3.42,Turner Field,12,2
2015-07-20,2015,ARI,MIA,3,1,-165,-1.5,130,8.0,-105,-115,150,1.5,-150,4.98,Chase Field,4,2
2015-07-20,2015,WSH,NYM,7,2,-126,-1.5,175,7.0,100,-120,116,1.5,-205,3.9,Nationals Park,9,5
2015-07-20,2015,TB,PHI,3,5,-116,-1.5,140,8.0,-110,-110,106,1.5,-160,4.3,Citizens Bank Park,8,-2
2015-07-20,2015,KC,PIT,7,10,-131,-1.5,160,7.0,-110,-110,116,1.5,-190,3.97,Kauffman Stadium,17,-3
2015-07-20,2015,SF,SD,2,4,-113,-1.5,140,7.0,-120,100,103,1.5,-160,3.71,PETCO Park,6,-2
2015-07-20,2015,DET,SEA,5,4,-112,-1.5,170,10.0,-110,-110,102,1.5,-200,5.28,Comerica Park,9,1
2015-07-20,2015,SD,SF,4,2,103,1.5,-160,7.0,-120,100,-113,-1.5,140,3.45,PETCO Park,6,2
2015-07-20,2015,PHI,TB,5,3,106,1.5,-160,8.0,-110,-110,-116,-1.5,140,3.88,Citizens Bank Park,8,2
2015-07-20,2015,COL,TEX,8,7,-162,-1.5,130,10.5,-105,-115,147,1.5,-150,6.49,Coors Field,15,1
2015-07-20,2015,NYM,WSH,2,7,116,1.5,-205,7.0,100,-120,-126,-1.5,175,3.24,Nationals Park,9,-5
2015-07-21,2015,MIA,ARI,3,0,115,1.5,-195,8.0,-105,-115,-130,-1.5,165,3.72,Chase Field,3,3
2015-07-21,2015,LAD,ATL,3,4,-141,-1.5,130,7.0,-110,-110,126,1.5,-150,4.1,Turner Field,7,-1
2015-07-21,2015,NYY,BAL,3,2,-120,-1.5,170,8.5,-120,100,110,1.5,-200,4.64,Yankee Stadium,5,1
2015-07-21,2015,HOU,BOS,8,3,-115,-1.5,170,8.0,104,-124,105,1.5,-200,4.28,Minute Maid Park,11,5
2015-07-21,2015,CIN,CHC,4,5,119,1.5,-150,8.5,-105,-115,-129,-1.5,130,3.88,Great American Ballpark,9,-1
2015-07-21,2015,CHC,CIN,5,4,-129,-1.5,130,8.5,-105,-115,119,1.5,-150,4.79,Great American Ballpark,9,1
2015-07-21,2015,MIL,CLE,8,1,108,1.5,-155,8.0,-105,-115,-118,-1.5,135,3.85,Miller Park,9,7
2015-07-21,2015,TEX,COL,9,0,115,1.5,-159,11.5,-116,-104,-130,-1.5,139,5.35,Coors Field,9,9
2015-07-21,2015,STL,CWS,8,5,-134,-1.5,125,7.5,-105,-115,119,1.5,-145,4.29,Guaranteed Rate Field,13,3
2015-07-21,2015,SEA,DET,11,9,-140,-1.5,115,9.0,-115,-105,125,1.5,-135,5.25,Comerica Park,20,2
2015-07-21,2015,BOS,HOU,3,8,105,1.5,-200,8.0,104,-124,-115,-1.5,170,3.9,Minute Maid Park,11,-5
2015-07-21,2015,PIT,KC,1,3,-119,-1.5,145,7.0,-120,100,109,1.5,-165,3.8,Kauffman Stadium,4,-2
2015-07-21,2015,MIN,LAA,0,7,115,1.5,-205,7.0,-115,-105,-130,-1.5,175,3.26,Angel Stadium,7,-7
2015-07-21,2015,ATL,LAD,4,3,126,1.5,-150,7.0,-110,-110,-141,-1.5,130,3.1,Turner Field,7,1
2015-07-21,2015,ARI,MIA,0,3,-130,-1.5,165,8.0,-105,-115,115,1.5,-195,4.52,Chase Field,3,-3
2015-07-21,2015,CLE,MIL,1,8,-118,-1.5,135,8.0,-105,-115,108,1.5,-155,4.33,Miller Park,9,-7
2015-07-21,2015,LAA,MIN,7,0,-130,-1.5,175,7.0,-115,-105,115,1.5,-205,3.96,Angel Stadium,7,7
2015-07-21,2015,WSH,NYM,2,7,-103,1.5,-195,6.5,-120,100,-107,-1.5,165,3.3,Nationals Park,9,-5
2015-07-21,2015,BAL,NYY,2,3,110,1.5,-200,8.5,-120,100,-120,-1.5,170,4.05,Yankee Stadium,5,-1
2015-07-21,2015,TOR,OAK,7,1,-113,-1.5,140,7.5,-105,-115,103,1.5,-160,3.98,Oakland Coliseum,8,6
2015-07-21,2015,TB,PHI,1,0,-140,-1.5,125,7.5,-110,-110,125,1.5,-145,4.38,Citizens Bank Park,1,1
2015-07-21,2015,KC,PIT,3,1,109,1.5,-165,7.0,-120,100,-119,-1.5,145,3.35,Kauffman Stadium,4,2
2015-07-21,2015,SF,SD,9,3,-125,-1.5,140,7.0,-105,-115,115,1.5,-160,3.89,PETCO Park,12,6
2015-07-21,2015,DET,SEA,9,11,125,1.5,-135,9.0,-115,-105,-140,-1.5,115,4.0,Comerica Park,20,-2
2015-07-21,2015,SD,SF,3,9,115,1.5,-160,7.0,-105,-115,-125,-1.5,140,3.26,PETCO Park,12,-6
2015-07-21,2015,CWS,STL,5,8,119,1.5,-145,7.5,-105,-115,-134,-1.5,125,3.42,Guaranteed Rate Field,13,-3
2015-07-21,2015,PHI,TB,0,1,125,1.5,-145,7.5,-110,-110,-140,-1.5,125,3.33,Citizens Bank Park,1,-1
2015-07-21,2015,COL,TEX,0,9,-130,-1.5,139,11.5,-116,-104,115,1.5,-159,6.5,Coors Field,9,-9
2015-07-21,2015,OAK,TOR,1,7,103,1.5,-160,7.5,-105,-115,-113,-1.5,140,3.69,Oakland Coliseum,8,-6
2015-07-21,2015,NYM,WSH,7,2,-107,-1.5,165,6.5,-120,100,-103,1.5,-195,3.36,Nationals Park,9,5
2015-07-22,2015,MIA,ARI,5,3,-111,-1.5,145,7.0,111,-131,101,1.5,-165,3.68,Chase Field,8,2
2015-07-22,2015,LAD,ATL,3,1,-154,-1.5,105,7.5,-120,100,139,1.5,-125,4.55,Turner Field,4,2
2015-07-22,2015,NYY,BAL,4,3,-116,-1.5,160,8.5,-119,-101,106,1.5,-190,4.56,Yankee Stadium,7,1
2015-07-22,2015,HOU,BOS,4,2,-144,-1.5,140,8.0,100,-120,129,1.5,-160,4.72,Minute Maid Park,6,2
2015-07-22,2015,CIN,CHC,9,1,102,1.5,-170,7.5,-110,-110,-112,-1.5,150,3.71,Great American Ballpark,10,8
2015-07-22,2015,CIN,CHC,5,6,-120,-1.5,161,8.0,-110,-110,110,1.5,-191,4.36,Great American Ballpark,11,-1
2015-07-22,2015,CHC,CIN,1,9,-112,-1.5,150,7.5,-110,-110,102,1.5,-170,3.96,Great American Ballpark,10,-8
2015-07-22,2015,CHC,CIN,6,5,110,1.5,-191,8.0,-110,-110,-120,-1.5,161,3.81,Great American Ballpark,11,1
2015-07-22,2015,MIL,CLE,5,7,-111,-1.5,170,9.0,-105,-115,101,1.5,-200,4.73,Miller Park,12,-2
2015-07-22,2015,TEX,COL,10,8,145,1.5,-140,10.5,-105,-115,-160,-1.5,120,4.29,Coors Field,18,2
2015-07-22,2015,STL,CWS,3,2,-148,-1.5,105,8.0,-120,100,133,1.5,-125,4.77,Guaranteed Rate Field,5,1
2015-07-22,2015,SEA,DET,4,9,126,1.5,-165,8.5,-110,-110,-141,-1.5,145,3.76,Comerica Park,13,-5
2015-07-22,2015,BOS,HOU,2,4,129,1.5,-160,8.0,100,-120,-144,-1.5,140,3.49,Minute Maid Park,6,-2
2015-07-22,2015,PIT,KC,1,5,114,1.5,-195,7.5,-120,100,-124,-1.5,165,3.5,Kauffman Stadium,6,-4
2015-07-22,2015,MIN,LAA,2,5,152,1.5,-145,8.0,-115,-105,-172,-1.5,125,3.17,Angel Stadium,7,-3
2015-07-22,2015,ATL,LAD,1,3,139,1.5,-125,7.5,-120,100,-154,-1.5,105,3.14,Turner Field,4,-2
2015-07-22,2015,ARI,MIA,3,5,101,1.5,-165,7.0,111,-131,-111,-1.5,145,3.48,Chase Field,8,-2
2015-07-22,2015,CLE,MIL,7,5,101,1.5,-200,9.0,-105,-115,-111,-1.5,170,4.48,Miller Park,12,2
2015-07-22,2015,LAA,MIN,5,2,-172,-1.5,125,8.0,-115,-105,152,1.5,-145,5.06,Angel Stadium,7,3
2015-07-22,2015,WSH,NYM,4,3,-110,-1.5,190,6.5,-110,-110,100,1.5,-230,3.4,Nationals Park,7,1
2015-07-22,2015,BAL,NYY,3,4,106,1.5,-190,8.5,-119,-101,-116,-1.5,160,4.13,Yankee Stadium,7,-1
2015-07-22,2015,TOR,OAK,3,4,125,1.5,-190,7.0,-120,100,-140,-1.5,160,3.11,Oakland Coliseum,7,-1
2015-07-22,2015,TB,PHI,4,5,-178,-1.5,-105,8.0,100,-120,158,1.5,-115,5.12,Citizens Bank Park,9,-1
2015-07-22,2015,KC,PIT,5,1,-124,-1.5,165,7.5,-120,100,114,1.5,-195,4.15,Kauffman Stadium,6,4
2015-07-22,2015,SF,SD,7,1,-107,1.5,-240,7.0,105,-125,-103,-1.5,200,3.62,PETCO Park,8,6
2015-07-22,2015,DET,SEA,9,4,-141,-1.5,145,8.5,-110,-110,126,1.5,-165,4.97,Comerica Park,13,5
2015-07-22,2015,SD,SF,1,7,-103,-1.5,200,7.0,105,-125,-107,1.5,-240,3.55,PETCO Park,8,-6
2015-07-22,2015,CWS,STL,2,3,133,1.5,-125,8.0,-120,100,-148,-1.5,105,3.43,Guaranteed Rate Field,5,-1
2015-07-22,2015,PHI,TB,5,4,158,1.5,-115,8.0,100,-120,-178,-1.5,-105,3.1,Citizens Bank Park,9,1
2015-07-22,2015,COL,TEX,8,10,-160,-1.5,120,10.5,-105,-115,145,1.5,-140,6.46,Coors Field,18,-2
2015-07-22,2015,OAK,TOR,4,3,-140,-1.5,160,7.0,-120,100,125,1.5,-190,4.08,Oakland Coliseum,7,1
2015-07-22,2015,NYM,WSH,3,4,100,1.5,-230,6.5,-110,-110,-110,-1.5,190,3.25,Nationals Park,7,-1
2015-07-23,2015,MIL,ARI,3,8,-140,-1.5,120,8.0,-120,100,125,1.5,-140,4.67,Chase Field,11,-5
2015-07-23,2015,NYY,BAL,9,3,-129,-1.5,165,7.5,-120,100,119,1.5,-195,4.22,Yankee Stadium,12,6
2015-07-23,2015,HOU,BOS,5,4,-131,-1.5,162,7.5,-115,-105,116,1.5,-190,4.25,Minute Maid Park,9,1
2015-07-23,2015,CWS,CLE,8,1,118,1.5,-190,7.5,105,-125,-133,-1.5,160,3.44,Progressive Field,9,7
2015-07-23,2015,CLE,CWS,1,8,-133,-1.5,160,7.5,105,-125,118,1.5,-190,4.28,Progressive Field,9,-7
2015-07-23,2015,SEA,DET,3,2,145,1.5,-150,7.5,-110,-110,-160,-1.5,130,3.06,Comerica Park,5,1
2015-07-23,2015,BOS,HOU,4,5,116,1.5,-190,7.5,-115,-105,-131,-1.5,162,3.47,Minute Maid Park,9,-1
2015-07-23,2015,STL,KC,4,3,-143,-1.5,160,7.0,105,-125,128,1.5,-190,4.12,Busch Stadium,7,1
2015-07-23,2015,MIN,LAA,3,0,157,1.5,-145,7.0,-115,-105,-177,-1.5,125,2.72,Angel Stadium,3,3
2015-07-23,2015,NYM,LAD,0,3,237,1.5,120,6.5,-105,-115,-277,-1.5,-140,1.93,Citi Field,3,-3
2015-07-23,2015,SD,MIA,0,4,-148,-1.5,150,6.0,-119,-101,133,1.5,-170,3.58,PETCO Park,4,-4
2015-07-23,2015,ARI,MIL,8,3,125,1.5,-140,8.0,-120,100,-140,-1.5,120,3.56,Chase Field,11,5
2015-07-23,2015,LAA,MIN,0,3,-177,-1.5,125,7.0,-115,-105,157,1.5,-145,4.47,Angel Stadium,3,-3
2015-07-23,2015,LAD,NYM,3,0,-277,-1.5,-140,6.5,-105,-115,237,1.5,120,4.78,Citi Field,3,3
2015-07-23,2015,BAL,NYY,3,9,119,1.5,-195,7.5,-120,100,-129,-1.5,165,3.42,Yankee Stadium,12,-6
2015-07-23,2015,TOR,OAK,5,2,-120,-1.5,135,8.5,-125,105,110,1.5,-155,4.64,Oakland Coliseum,7,3
2015-07-23,2015,WSH,PIT,3,7,171,1.5,-140,7.0,105,-125,-191,-1.5,120,2.58,PNC Park,10,-4
2015-07-23,2015,MIA,SD,4,0,133,1.5,-170,6.0,-119,-101,-148,-1.5,150,2.58,PETCO Park,4,4
2015-07-23,2015,DET,SEA,2,3,-160,-1.5,130,7.5,-110,-110,145,1.5,-150,4.62,Comerica Park,5,-1
2015-07-23,2015,KC,STL,3,4,128,1.5,-190,7.0,105,-125,-143,-1.5,160,3.07,Busch Stadium,7,-1
2015-07-23,2015,OAK,TOR,2,5,110,1.5,-155,8.5,-125,105,-120,-1.5,135,4.05,Oakland Coliseum,7,-3
2015-07-23,2015,PIT,WSH,7,3,-191,-1.5,120,7.0,105,-125,171,1.5,-140,4.59,PNC Park,10,4
2015-07-24,2015,MIL,ARI,2,1,113,1.5,-195,8.0,-105,-115,-123,-1.5,165,3.76,Chase Field,3,1
2015-07-24,2015,STL,ATL,4,2,-186,-1.5,115,7.5,-110,-110,166,1.5,-135,4.88,Busch Stadium,6,2
2015-07-24,2015,TB,BAL,3,1,-156,-1.5,140,6.5,105,-125,141,1.5,-160,3.96,Tropicana Field,4,2
2015-07-24,2015,DET,BOS,1,2,130,1.5,-155,9.0,100,-120,-145,-1.5,135,3.91,Fenway Park,3,-1
2015-07-24,2015,PHI,CHC,5,3,240,1.5,115,9.0,-115,-105,-280,-1.5,-135,2.65,Wrigley Field,8,2
2015-07-24,2015,COL,CIN,6,5,-114,-1.5,160,11.0,105,-125,104,1.5,-190,5.86,Coors Field,11,1
2015-07-24,2015,CWS,CLE,6,0,142,1.5,-160,6.5,-122,102,-157,-1.5,140,2.69,Progressive Field,6,6
2015-07-24,2015,CIN,COL,5,6,104,1.5,-190,11.0,105,-125,-114,-1.5,160,5.39,Coors Field,11,-1
2015-07-24,2015,CLE,CWS,0,6,-157,-1.5,140,6.5,-122,102,142,1.5,-160,3.97,Progressive Field,6,-6
2015-07-24,2015,BOS,DET,2,1,-145,-1.5,135,9.0,100,-120,130,1.5,-155,5.33,Fenway Park,3,1
2015-07-24,2015,KC,HOU,0,4,101,1.5,-165,8.0,-110,-110,-111,-1.5,145,3.98,Kauffman Stadium,4,-4
2015-07-24,2015,HOU,KC,4,0,-111,-1.5,145,8.0,-110,-110,101,1.5,-165,4.21,Kauffman Stadium,4,4
2015-07-24,2015,TEX,LAA,4,2,132,1.5,-165,8.0,-117,-103,-147,-1.5,145,3.45,Angel Stadium,6,2
2015-07-24,2015,NYM,LAD,2,7,102,1.5,-165,7.5,100,-120,-112,-1.5,145,3.71,Citi Field,9,-5
2015-07-24,2015,SD,MIA,3,1,-157,-1.5,155,7.0,100,-120,142,1.5,-175,4.28,PETCO Park,4,2
2015-07-24,2015,ARI,MIL,1,2,-123,-1.5,165,8.0,-105,-115,113,1.5,-195,4.41,Chase Field,3,-1
2015-07-24,2015,NYY,MIN,1,10,-153,-1.5,101,8.0,-115,-105,138,1.5,-121,4.84,Target Field,11,-9
2015-07-24,2015,LAD,NYM,7,2,-112,-1.5,145,7.5,100,-120,102,1.5,-165,3.96,Citi Field,9,5
2015-07-24,2015,MIN,NYY,10,1,138,1.5,-121,8.0,-115,-105,-153,-1.5,101,3.36,Target Field,11,9
2015-07-24,2015,SF,OAK,9,3,-130,-1.5,160,7.0,-110,-110,115,1.5,-190,3.96,AT&T Park,12,6
2015-07-24,2015,CHC,PHI,3,5,-280,-1.5,-135,9.0,-115,-105,240,1.5,115,6.63,Wrigley Field,8,-2
2015-07-24,2015,WSH,PIT,5,7,-130,-1.5,135,6.5,-109,-111,115,1.5,-155,3.67,PNC Park,12,-2
2015-07-24,2015,MIA,SD,1,3,142,1.5,-175,7.0,100,-120,-157,-1.5,155,2.89,PETCO Park,4,-2
2015-07-24,2015,TOR,SEA,2,5,144,1.5,-155,6.5,-130,110,-159,-1.5,135,2.66,T-Mobile Park,7,-3
2015-07-24,2015,OAK,SF,3,9,115,1.5,-190,7.0,-110,-110,-130,-1.5,160,3.26,AT&T Park,12,-6
2015-07-24,2015,ATL,STL,2,4,166,1.5,-135,7.5,-110,-110,-186,-1.5,115,2.82,Busch Stadium,6,-2
2015-07-24,2015,BAL,TB,1,3,141,1.5,-160,6.5,105,-125,-156,-1.5,140,2.7,Tropicana Field,4,-2
2015-07-24,2015,LAA,TEX,2,4,-147,-1.5,145,8.0,-117,-103,132,1.5,-165,4.76,Angel Stadium,6,-2
2015-07-24,2015,SEA,TOR,5,2,-159,-1.5,135,6.5,-130,110,144,1.5,-155,3.99,T-Mobile Park,7,3
2015-07-24,2015,PIT,WSH,7,5,115,1.5,-155,6.5,-109,-111,-130,-1.5,135,3.02,PNC Park,12,2
2015-07-25,2015,MIL,ARI,0,2,106,1.5,-205,8.0,-120,100,-116,-1.5,175,3.88,Chase Field,2,-2
2015-07-25,2015,STL,ATL,1,0,-220,-1.5,108,6.5,-115,-105,190,1.5,-128,4.47,Busch Stadium,1,1
2015-07-25,2015,TB,BAL,1,5,-118,-1.5,185,7.0,105,-125,108,1.5,-215,3.79,Tropicana Field,6,-4
2015-07-25,2015,DET,BOS,5,1,114,1.5,-190,9.5,-110,-110,-124,-1.5,160,4.44,Fenway Park,6,4
2015-07-25,2015,PHI,CHC,5,0,186,1.5,-130,6.0,-120,100,-216,-1.5,110,2.1,Wrigley Field,5,5
2015-07-25,2015,COL,CIN,2,5,115,1.5,-135,10.0,-115,-105,-130,-1.5,115,4.65,Coors Field,7,-3
2015-07-25,2015,CWS,CLE,10,3,-114,-1.5,155,6.0,-115,-105,104,1.5,-175,3.2,Progressive Field,13,7
2015-07-25,2015,CIN,COL,5,2,-130,-1.5,115,10.0,-115,-105,115,1.5,-135,5.65,Coors Field,7,3
2015-07-25,2015,CLE,CWS,3,10,104,1.5,-175,6.0,-115,-105,-114,-1.5,155,2.94,Progressive Field,13,-7
2015-07-25,2015,BOS,DET,1,5,-124,-1.5,160,9.5,-110,-110,114,1.5,-190,5.26,Fenway Park,6,-4
2015-07-25,2015,KC,HOU,2,1,-143,-1.5,160,8.0,-115,-105,128,1.5,-190,4.71,Kauffman Stadium,3,1
2015-07-25,2015,HOU,KC,1,2,128,1.5,-190,8.0,-115,-105,-143,-1.5,160,3.51,Kauffman Stadium,3,-1
2015-07-25,2015,TEX,LAA,7,6,137,1.5,-150,7.5,-120,100,-152,-1.5,130,3.16,Angel Stadium,13,1
2015-07-25,2015,NYM,LAD,15,2,-125,-1.5,170,7.0,-105,-115,115,1.5,-200,3.89,Citi Field,17,13
2015-07-25,2015,SD,MIA,3,1,-122,-1.5,175,7.5,-105,-115,112,1.5,-205,4.12,PETCO Park,4,2
2015-07-25,2015,ARI,MIL,2,0,-116,-1.5,175,8.0,-120,100,106,1.5,-205,4.3,Chase Field,2,2
2015-07-25,2015,NYY,MIN,8,5,-105,-1.5,150,8.5,-110,-110,-105,1.5,-170,4.35,Target Field,13,3
2015-07-25,2015,LAD,NYM,2,15,115,1.5,-200,7.0,-105,-115,-125,-1.5,170,3.26,Citi Field,17,-13
2015-07-25,2015,MIN,NYY,5,8,-105,1.5,-170,8.5,-110,-110,-105,-1.5,150,4.35,Target Field,13,-3
2015-07-25,2015,SF,OAK,2,1,-200,-1.5,110,7.0,100,-120,170,1.5,-130,4.67,AT&T Park,3,1
2015-07-25,2015,CHC,PHI,0,5,-216,-1.5,110,6.0,-120,100,186,1.5,-130,4.1,Wrigley Field,5,-5
2015-07-25,2015,WSH,PIT,9,3,138,1.5,-170,7.0,-125,105,-153,-1.5,150,2.94,PNC Park,12,6
2015-07-25,2015,MIA,SD,1,3,112,1.5,-205,7.5,-105,-115,-122,-1.5,175,3.54,PETCO Park,4,-2
2015-07-25,2015,TOR,SEA,8,6,-131,-1.5,125,8.0,100,-120,116,1.5,-145,4.54,T-Mobile Park,14,2
2015-07-25,2015,OAK,SF,1,2,170,1.5,-130,7.0,100,-120,-200,-1.5,110,2.59,AT&T Park,3,-1
2015-07-25,2015,ATL,STL,0,1,190,1.5,-128,6.5,-115,-105,-220,-1.5,108,2.24,Busch Stadium,1,-1
2015-07-25,2015,BAL,TB,5,1,108,1.5,-215,7.0,105,-125,-118,-1.5,185,3.37,Tropicana Field,6,4
2015-07-25,2015,LAA,TEX,6,7,-152,-1.5,130,7.5,-120,100,137,1.5,-150,4.52,Angel Stadium,13,-1
2015-07-25,2015,SEA,TOR,6,8,116,1.5,-145,8.0,100,-120,-131,-1.5,125,3.7,T-Mobile Park,14,-2
2015-07-25,2015,PIT,WSH,3,9,-153,-1.5,150,7.0,-125,105,138,1.5,-170,4.23,PNC Park,12,-6
2015-07-26,2015,MIL,ARI,0,3,135,1.5,-170,8.0,105,-125,-150,-1.5,150,3.4,Chase Field,3,-3
2015-07-26,2015,STL,ATL,2,3,-203,-1.5,105,7.0,-105,-115,173,1.5,-125,4.69,Busch Stadium,5,-1
2015-07-26,2015,TB,BAL,2,5,107,1.5,-165,7.0,-120,100,-117,-1.5,145,3.38,Tropicana Field,7,-3
2015-07-26,2015,DET,BOS,1,11,137,1.5,-145,9.5,-105,-115,-152,-1.5,125,4.01,Fenway Park,12,-10
2015-07-26,2015,PHI,CHC,11,5,170,1.5,-115,7.5,105,-125,-190,-1.5,-105,2.78,Wrigley Field,16,6
2015-07-26,2015,COL,CIN,17,7,105,1.5,-145,11.5,105,-125,-115,-1.5,125,5.61,Coors Field,24,10
2015-07-26,2015,CWS,CLE,2,1,141,1.5,-165,7.0,100,-120,-156,-1.5,145,2.9,Progressive Field,3,1
2015-07-26,2015,CIN,COL,7,17,-115,-1.5,125,11.5,105,-125,105,1.5,-145,6.15,Coors Field,24,-10
2015-07-26,2015,CLE,CWS,1,2,-156,-1.5,145,7.0,100,-120,141,1.5,-165,4.27,Progressive Field,3,-1
2015-07-26,2015,BOS,DET,11,1,-152,-1.5,125,9.5,-105,-115,137,1.5,-145,5.73,Fenway Park,12,10
2015-07-26,2015,KC,HOU,5,1,102,1.5,-170,7.0,100,-120,-112,-1.5,150,3.47,Kauffman Stadium,6,4
2015-07-26,2015,HOU,KC,1,5,-112,-1.5,150,7.0,100,-120,102,1.5,-170,3.7,Kauffman Stadium,6,-4
2015-07-26,2015,TEX,LAA,7,13,163,1.5,-130,7.5,-105,-115,-183,-1.5,110,2.85,Angel Stadium,20,-6
2015-07-26,2015,NYM,LAD,3,2,115,1.5,-160,6.0,-115,-105,-125,-1.5,140,2.79,Citi Field,5,1
2015-07-26,2015,SD,MIA,3,2,-102,1.5,-190,7.0,-105,-115,-108,-1.5,160,3.53,PETCO Park,5,1
2015-07-26,2015,ARI,MIL,3,0,-150,-1.5,150,8.0,105,-125,135,1.5,-170,4.8,Chase Field,3,3
2015-07-26,2015,NYY,MIN,7,2,-126,-1.5,125,8.5,-120,100,116,1.5,-145,4.74,Target Field,9,5
2015-07-26,2015,LAD,NYM,2,3,-125,-1.5,140,6.0,-115,-105,115,1.5,-160,3.33,Citi Field,5,-1
2015-07-26,2015,MIN,NYY,2,7,116,1.5,-145,8.5,-120,100,-126,-1.5,125,3.94,Target Field,9,-5
2015-07-26,2015,SF,OAK,4,3,-142,-1.5,160,7.5,-115,-105,127,1.5,-190,4.4,AT&T Park,7,1
2015-07-26,2015,CHC,PHI,5,11,-190,-1.5,-105,7.5,105,-125,170,1.5,-115,4.91,Wrigley Field,16,-6
2015-07-26,2015,WSH,PIT,1,3,150,1.5,-160,7.0,-105,-115,-170,-1.5,140,2.8,PNC Park,4,-2
2015-07-26,2015,MIA,SD,2,3,-108,-1.5,160,7.0,-105,-115,-102,1.5,-190,3.63,PETCO Park,5,-1
2015-07-26,2015,TOR,SEA,5,6,-120,-1.5,140,7.5,-105,-115,110,1.5,-160,4.09,T-Mobile Park,11,-1
2015-07-26,2015,OAK,SF,3,4,127,1.5,-190,7.5,-115,-105,-142,-1.5,160,3.3,AT&T Park,7,-1
2015-07-26,2015,ATL,STL,3,2,173,1.5,-125,7.0,-105,-115,-203,-1.5,105,2.56,Busch Stadium,5,1
2015-07-26,2015,BAL,TB,5,2,-117,-1.5,145,7.0,-120,100,107,1.5,-165,3.77,Tropicana Field,7,3
2015-07-26,2015,LAA,TEX,13,7,-183,-1.5,110,7.5,-105,-115,163,1.5,-130,4.85,Angel Stadium,20,6
2015-07-26,2015,SEA,TOR,6,5,110,1.5,-160,7.5,-105,-115,-120,-1.5,140,3.57,T-Mobile Park,11,1
2015-07-26,2015,PIT,WSH,3,1,-170,-1.5,140,7.0,-105,-115,150,1.5,-160,4.41,PNC Park,4,2
2015-07-27,2015,SEA,ARI,3,4,-120,-1.5,175,7.0,101,-121,110,1.5,-205,3.82,T-Mobile Park,7,-1
2015-07-27,2015,BAL,ATL,2,1,-156,-1.5,130,7.5,-115,-105,141,1.5,-150,4.57,Camden Yards,3,1
2015-07-27,2015,ATL,BAL,1,2,141,1.5,-150,7.5,-115,-105,-156,-1.5,130,3.11,Camden Yards,3,-1
2015-07-27,2015,CWS,BOS,10,8,149,1.5,-135,9.0,-125,105,-164,-1.5,115,3.61,Fenway Park,18,2
2015-07-27,2015,COL,CHC,8,9,134,1.5,-180,7.0,-105,-115,-149,-1.5,160,2.99,Wrigley Field,17,-1
2015-07-27,2015,STL,CIN,4,1,-174,-1.5,130,7.0,-125,105,154,1.5,-150,4.45,Busch Stadium,5,3
2015-07-27,2015,KC,CLE,9,4,-109,-1.5,150,8.0,100,-120,-101,1.5,-170,4.17,Progressive Field,13,5
2015-07-27,2015,CHC,COL,9,8,-149,-1.5,160,7.0,-105,-115,134,1.5,-180,4.19,Wrigley Field,17,1
2015-07-27,2015,BOS,CWS,8,10,-164,-1.5,115,9.0,-125,105,149,1.5,-135,5.59,Fenway Park,18,-2
2015-07-27,2015,TB,DET,5,2,-116,-1.5,185,6.5,-120,100,106,1.5,-215,3.49,Tropicana Field,7,3
2015-07-27,2015,CLE,KC,4,9,-101,1.5,-170,8.0,100,-120,-109,-1.5,150,4.02,Progressive Field,13,-5
2015-07-27,2015,SF,MIL,4,2,-200,-1.5,110,7.0,100,-120,170,1.5,-130,4.67,AT&T Park,6,2
2015-07-27,2015,TEX,NYY,2,6,101,1.5,-155,10.0,-105,-115,-111,-1.5,135,4.98,Rangers Ballpark,8,-4
2015-07-27,2015,ARI,SEA,4,3,110,1.5,-205,7.0,101,-121,-120,-1.5,175,3.33,T-Mobile Park,7,1
2015-07-27,2015,MIL,SF,2,4,170,1.5,-130,7.0,100,-120,-200,-1.5,110,2.59,AT&T Park,6,-2
2015-07-27,2015,CIN,STL,1,4,154,1.5,-150,7.0,-125,105,-174,-1.5,130,2.76,Busch Stadium,5,-3
2015-07-27,2015,DET,TB,2,5,106,1.5,-215,6.5,-120,100,-116,-1.5,185,3.16,Tropicana Field,7,-3
2015-07-27,2015,NYY,TEX,6,2,-111,-1.5,135,10.0,-105,-115,101,1.5,-155,5.26,Rangers Ballpark,8,4
2015-07-28,2015,SEA,ARI,4,8,-177,-1.5,125,7.0,-110,-110,157,1.5,-145,4.47,T-Mobile Park,12,-4
2015-07-28,2015,BAL,ATL,7,3,-177,-1.5,115,8.0,-125,105,157,1.5,-135,5.11,Camden Yards,10,4
2015-07-28,2015,ATL,BAL,3,7,157,1.5,-135,8.0,-125,105,-177,-1.5,115,3.11,Camden Yards,10,-4
2015-07-28,2015,CWS,BOS,9,4,125,1.5,-170,8.5,105,-125,-140,-1.5,150,3.78,Fenway Park,13,5
2015-07-28,2015,COL,CHC,7,2,139,1.5,-160,9.0,105,-125,-154,-1.5,140,3.77,Wrigley Field,9,5
2015-07-28,2015,STL,CIN,0,4,-142,-1.5,150,7.0,-120,100,127,1.5,-170,4.11,Busch Stadium,4,-4
2015-07-28,2015,KC,CLE,2,1,111,1.5,-215,8.0,-115,-105,-121,-1.5,185,3.79,Progressive Field,3,1
2015-07-28,2015,CHC,COL,2,7,-154,-1.5,140,9.0,105,-125,139,1.5,-160,5.46,Wrigley Field,9,-5
2015-07-28,2015,BOS,CWS,4,9,-140,-1.5,150,8.5,105,-125,125,1.5,-170,4.96,Fenway Park,13,-5
2015-07-28,2015,TB,DET,10,2,108,1.5,-170,6.5,100,-120,-118,-1.5,150,3.13,Tropicana Field,12,8
2015-07-28,2015,LAA,HOU,5,10,127,1.5,-175,7.5,100,-120,-142,-1.5,155,3.3,Minute Maid Park,15,-5
2015-07-28,2015,CLE,KC,1,2,-121,-1.5,185,8.0,-115,-105,111,1.5,-215,4.38,Progressive Field,3,-1
2015-07-28,2015,HOU,LAA,10,5,-142,-1.5,155,7.5,100,-120,127,1.5,-175,4.4,Minute Maid Park,15,5
2015-07-28,2015,OAK,LAD,2,0,130,1.5,-185,6.5,-115,-105,-145,-1.5,165,2.83,Dodger Stadium,2,2
2015-07-28,2015,WSH,MIA,1,4,116,1.5,-215,6.0,100,-120,-126,-1.5,185,2.78,Marlins Park,5,-3
2015-07-28,2015,SF,MIL,2,5,-155,-1.5,140,7.0,-120,100,140,1.5,-160,4.25,AT&T Park,7,-3
2015-07-28,2015,PIT,MIN,8,7,-109,-1.5,145,9.5,-110,-110,-101,1.5,-165,4.95,Target Field,15,1
2015-07-28,2015,SD,NYM,0,4,117,1.5,-195,7.0,105,-125,-127,-1.5,165,3.23,Citi Field,4,-4
2015-07-28,2015,TEX,NYY,5,21,106,1.5,-160,9.5,-105,-115,-116,-1.5,140,4.61,Rangers Ballpark,26,-16
2015-07-28,2015,LAD,OAK,0,2,-145,-1.5,165,6.5,-115,-105,130,1.5,-185,3.85,Dodger Stadium,2,-2
2015-07-28,2015,TOR,PHI,2,3,-268,-1.5,-130,9.5,-110,-110,228,1.5,110,6.92,Rogers Centre,5,-1
2015-07-28,2015,MIN,PIT,7,8,-101,1.5,-165,9.5,-110,-110,-109,-1.5,145,4.77,Target Field,15,-1
2015-07-28,2015,NYM,SD,4,0,-127,-1.5,165,7.0,105,-125,117,1.5,-195,3.92,Citi Field,4,4
2015-07-28,2015,ARI,SEA,8,4,157,1.5,-145,7.0,-110,-110,-177,-1.5,125,2.72,T-Mobile Park,12,4
2015-07-28,2015,MIL,SF,5,2,140,1.5,-160,7.0,-120,100,-155,-1.5,140,2.92,AT&T Park,7,3
2015-07-28,2015,CIN,STL,4,0,127,1.5,-170,7.0,-120,100,-142,-1.5,150,3.08,Busch Stadium,4,4
2015-07-28,2015,DET,TB,2,10,-118,-1.5,150,6.5,100,-120,108,1.5,-170,3.52,Tropicana Field,12,-8
2015-07-28,2015,NYY,TEX,21,5,-116,-1.5,140,9.5,-105,-115,106,1.5,-160,5.1,Rangers Ballpark,26,16
2015-07-28,2015,PHI,TOR,3,2,228,1.5,110,9.5,-110,-110,-268,-1.5,-130,2.9,Rogers Centre,5,1
2015-07-28,2015,MIA,WSH,4,1,-126,-1.5,185,6.0,100,-120,116,1.5,-215,3.35,Marlins Park,5,3
2015-07-29,2015,SEA,ARI,2,8,-173,-1.5,130,6.5,105,-125,153,1.5,-150,4.12,T-Mobile Park,10,-6
2015-07-29,2015,BAL,ATL,2,0,-179,-1.5,120,8.5,-110,-110,159,1.5,-140,5.45,Camden Yards,2,2
2015-07-29,2015,ATL,BAL,0,2,159,1.5,-140,8.5,-110,-110,-179,-1.5,120,3.28,Camden Yards,2,-2
2015-07-29,2015,CWS,BOS,9,2,105,1.5,-205,8.5,-123,103,-115,-1.5,175,4.15,Fenway Park,11,7
2015-07-29,2015,COL,CHC,2,3,190,1.5,-111,8.0,-115,-105,-220,-1.5,-109,2.76,Wrigley Field,5,-1
2015-07-29,2015,STL,CIN,0,1,-170,-1.5,135,7.5,-102,-118,150,1.5,-155,4.72,Busch Stadium,1,-1
2015-07-29,2015,KC,CLE,1,12,153,1.5,-145,7.5,105,-125,-173,-1.5,125,2.96,Progressive Field,13,-11
2015-07-29,2015,CHC,COL,3,2,-220,-1.5,-109,8.0,-115,-105,190,1.5,-111,5.5,Wrigley Field,5,1
2015-07-29,2015,BOS,CWS,2,9,-115,-1.5,175,8.5,-123,103,105,1.5,-205,4.55,Fenway Park,11,-7
2015-07-29,2015,TB,DET,1,2,-171,-1.5,125,6.5,105,-125,151,1.5,-145,4.1,Tropicana Field,3,-1
2015-07-29,2015,LAA,HOU,3,6,118,1.5,-185,7.5,100,-120,-128,-1.5,165,3.44,Minute Maid Park,9,-3
2015-07-29,2015,CLE,KC,12,1,-173,-1.5,125,7.5,105,-125,153,1.5,-145,4.75,Progressive Field,13,11
2015-07-29,2015,HOU,LAA,6,3,-128,-1.5,165,7.5,100,-120,118,1.5,-185,4.21,Minute Maid Park,9,3
2015-07-29,2015,OAK,LAD,7,10,140,1.5,-165,7.0,-110,-110,-155,-1.5,145,2.92,Dodger Stadium,17,-3
2015-07-29,2015,WSH,MIA,7,2,-123,-1.5,130,7.5,110,-130,113,1.5,-150,4.14,Marlins Park,9,5
2015-07-29,2015,SF,MIL,5,0,-105,1.5,-180,7.0,105,-125,-105,-1.5,160,3.59,AT&T Park,5,5
2015-07-29,2015,PIT,MIN,10,4,-128,-1.5,135,8.0,-115,-105,118,1.5,-155,4.49,Target Field,14,6
2015-07-29,2015,SD,NYM,7,3,-105,1.5,-240,7.0,-114,-106,-105,-1.5,200,3.59,Citi Field,10,4
2015-07-29,2015,TEX,NYY,5,2,150,1.5,-110,9.0,-115,-105,-170,-1.5,-110,3.6,Rangers Ballpark,7,3
2015-07-29,2015,LAD,OAK,10,7,-155,-1.5,145,7.0,-110,-110,140,1.5,-165,4.25,Dodger Stadium,17,3
2015-07-29,2015,TOR,PHI,8,2,-287,-1.5,-135,9.0,-120,100,247,1.5,115,6.67,Rogers Centre,10,6
2015-07-29,2015,MIN,PIT,4,10,118,1.5,-155,8.0,-115,-105,-128,-1.5,135,3.67,Target Field,14,-6
2015-07-29,2015,NYM,SD,3,7,-105,-1.5,200,7.0,-114,-106,-105,1.5,-240,3.59,Citi Field,10,-4
2015-07-29,2015,ARI,SEA,8,2,153,1.5,-150,6.5,105,-125,-173,-1.5,130,2.57,T-Mobile Park,10,6
2015-07-29,2015,MIL,SF,0,5,-105,-1.5,160,7.0,105,-125,-105,1.5,-180,3.59,AT&T Park,5,-5
2015-07-29,2015,CIN,STL,1,0,150,1.5,-155,7.5,-102,-118,-170,-1.5,135,3.0,Busch Stadium,1,1
2015-07-29,2015,DET,TB,2,1,151,1.5,-145,6.5,105,-125,-171,-1.5,125,2.59,Tropicana Field,3,1
2015-07-29,2015,NYY,TEX,2,5,-170,-1.5,-110,9.0,-115,-105,150,1.5,-110,5.67,Rangers Ballpark,7,-3
2015-07-29,2015,PHI,TOR,2,8,247,1.5,115,9.0,-120,100,-287,-1.5,-135,2.59,Rogers Centre,10,-6
2015-07-29,2015,MIA,WSH,2,7,113,1.5,-150,7.5,110,-130,-123,-1.5,130,3.52,Marlins Park,9,-5
2015-07-30,2015,PHI,ATL,4,1,115,1.5,-150,7.5,-101,-119,-125,-1.5,130,3.49,Citizens Bank Park,5,3
2015-07-30,2015,DET,BAL,9,8,127,1.5,-165,8.5,-110,-110,-142,-1.5,145,3.74,Camden Yards,17,1
2015-07-30,2015,CWS,BOS,2,8,-195,-1.5,-129,7.5,-120,100,175,1.5,109,4.96,Fenway Park,10,-6
2015-07-30,2015,MIL,CHC,2,5,125,1.5,-140,7.0,-125,105,-140,-1.5,120,3.11,Miller Park,7,-3
2015-07-30,2015,PIT,CIN,5,15,-160,-1.5,-101,9.0,102,-122,145,1.5,-119,5.54,Great American Ballpark,20,-10
2015-07-30,2015,OAK,CLE,1,3,115,1.5,-150,7.0,-102,-118,-125,-1.5,130,3.26,Oakland Coliseum,4,-2
2015-07-30,2015,STL,COL,9,8,-185,-1.5,125,7.0,-105,-115,165,1.5,-145,4.54,Busch Stadium,17,1
2015-07-30,2015,BOS,CWS,8,2,175,1.5,109,7.5,-120,100,-195,-1.5,-129,2.73,Fenway Park,10,6
2015-07-30,2015,BAL,DET,8,9,-142,-1.5,145,8.5,-110,-110,127,1.5,-165,4.99,Camden Yards,17,-1
2015-07-30,2015,LAA,HOU,0,3,116,1.5,-185,7.5,-115,-105,-131,-1.5,165,3.47,Minute Maid Park,3,-3
2015-07-30,2015,TOR,KC,5,2,-125,-1.5,170,9.0,-118,-102,115,1.5,-200,5.0,Rogers Centre,7,3
2015-07-30,2015,HOU,LAA,3,0,-131,-1.5,165,7.5,-115,-105,116,1.5,-185,4.25,Minute Maid Park,3,3
2015-07-30,2015,WSH,MIA,1,0,-195,-1.5,-115,6.5,-115,-105,175,1.5,-105,4.3,Marlins Park,1,1
2015-07-30,2015,CHC,MIL,5,2,-140,-1.5,120,7.0,-125,105,125,1.5,-140,4.08,Miller Park,7,3
2015-07-30,2015,SEA,MIN,5,9,106,1.5,-200,8.5,-110,-110,-116,-1.5,170,4.13,Target Field,14,-4
2015-07-30,2015,SD,NYM,8,7,-104,-1.5,155,7.5,-105,-115,-106,1.5,-175,3.82,Citi Field,15,1
2015-07-30,2015,TEX,NYY,7,6,116,1.5,-150,9.0,-115,-105,-126,-1.5,130,4.17,Rangers Ballpark,13,1
2015-07-30,2015,CLE,OAK,3,1,-125,-1.5,130,7.0,-102,-118,115,1.5,-150,3.89,Oakland Coliseum,4,2
2015-07-30,2015,ATL,PHI,1,4,-125,-1.5,130,7.5,-101,-119,115,1.5,-150,4.17,Citizens Bank Park,5,-3
2015-07-30,2015,CIN,PIT,15,5,145,1.5,-119,9.0,102,-122,-160,-1.5,-101,3.67,Great American Ballpark,20,10
2015-07-30,2015,NYM,SD,7,8,-106,1.5,-175,7.5,-105,-115,-104,-1.5,155,3.86,Citi Field,15,-1
2015-07-30,2015,MIN,SEA,9,5,-116,-1.5,170,8.5,-110,-110,106,1.5,-200,4.56,Target Field,14,4
2015-07-30,2015,COL,STL,8,9,165,1.5,-145,7.0,-105,-115,-185,-1.5,125,2.64,Busch Stadium,17,-1
2015-07-30,2015,NYY,TEX,6,7,-126,-1.5,130,9.0,-115,-105,116,1.5,-150,5.02,Rangers Ballpark,13,-1
2015-07-30,2015,KC,TOR,2,5,115,1.5,-200,9.0,-118,-102,-125,-1.5,170,4.19,Rogers Centre,7,-3
2015-07-30,2015,MIA,WSH,0,1,175,1.5,-105,6.5,-115,-105,-195,-1.5,-115,2.36,Marlins Park,1,-1
2015-07-31,2015,HOU,ARI,4,6,-140,-1.5,155,8.5,-101,-119,125,1.5,-175,4.96,Minute Maid Park,10,-2
2015-07-31,2015,PHI,ATL,9,3,114,1.5,-155,7.5,-120,100,-124,-1.5,135,3.5,Citizens Bank Park,12,6
2015-07-31,2015,DET,BAL,7,8,155,1.5,-135,9.0,-108,-112,-175,-1.5,115,3.53,Camden Yards,15,-1
2015-07-31,2015,TB,BOS,5,7,-103,1.5,-210,9.0,-120,100,-107,-1.5,180,4.57,Fenway Park,12,-2
2015-07-31,2015,MIL,CHC,1,4,115,1.5,-150,8.0,-105,-115,-125,-1.5,130,3.72,Miller Park,5,-3
2015-07-31,2015,PIT,CIN,5,4,-131,-1.5,125,9.0,105,-125,116,1.5,-145,5.1,Great American Ballpark,9,1
2015-07-31,2015,OAK,CLE,1,2,136,1.5,-130,7.0,-125,105,-151,-1.5,110,2.97,Oakland Coliseum,3,-1
2015-07-31,2015,STL,COL,7,0,-246,-1.5,-123,7.5,-110,-110,206,1.5,103,5.33,Busch Stadium,7,7
2015-07-31,2015,NYY,CWS,13,6,-120,-1.5,130,8.0,-115,-105,110,1.5,-150,4.36,Guaranteed Rate Field,19,7
2015-07-31,2015,BAL,DET,8,7,-175,-1.5,115,9.0,-108,-112,155,1.5,-135,5.73,Camden Yards,15,1
2015-07-31,2015,ARI,HOU,6,4,125,1.5,-175,8.5,-101,-119,-140,-1.5,155,3.78,Minute Maid Park,10,2
2015-07-31,2015,TOR,KC,7,6,-112,-1.5,185,7.5,-110,-110,102,1.5,-215,3.96,Rogers Centre,13,1
2015-07-31,2015,LAD,LAA,5,3,-193,-1.5,130,6.0,-125,105,173,1.5,-150,3.95,Dodger Stadium,8,2
2015-07-31,2015,LAA,LAD,3,5,173,1.5,-150,6.0,-125,105,-193,-1.5,130,2.2,Dodger Stadium,8,-2
2015-07-31,2015,SD,MIA,8,3,102,1.5,-230,7.0,-120,100,-112,-1.5,190,3.47,Marlins Park,11,5
2015-07-31,2015,CHC,MIL,4,1,-125,-1.5,130,8.0,-105,-115,115,1.5,-150,4.44,Miller Park,5,3
2015-07-31,2015,SEA,MIN,6,1,-106,-1.5,150,8.5,100,-120,-104,1.5,-170,4.37,Target Field,7,5
2015-07-31,2015,WSH,NYM,1,2,103,1.5,-230,7.0,-115,-105,-113,-1.5,190,3.45,Citi Field,3,-1
2015-07-31,2015,CWS,NYY,6,13,110,1.5,-150,8.0,-115,-105,-120,-1.5,130,3.81,Guaranteed Rate Field,19,-7
2015-07-31,2015,CLE,OAK,2,1,-151,-1.5,110,7.0,-125,105,136,1.5,-130,4.21,Oakland Coliseum,3,1
2015-07-31,2015,ATL,PHI,3,9,-124,-1.5,135,7.5,-120,100,114,1.5,-155,4.15,Citizens Bank Park,12,-6
2015-07-31,2015,CIN,PIT,4,5,116,1.5,-145,9.0,105,-125,-131,-1.5,125,4.17,Great American Ballpark,9,-1
2015-07-31,2015,MIA,SD,3,8,-112,-1.5,190,7.0,-120,100,102,1.5,-230,3.7,Marlins Park,11,-5
2015-07-31,2015,MIN,SEA,1,6,-104,1.5,-170,8.5,100,-120,-106,-1.5,150,4.33,Target Field,7,-5
2015-07-31,2015,TEX,SF,6,3,154,1.5,-106,9.0,-110,-110,-174,-1.5,-114,3.54,Rangers Ballpark,9,3
2015-07-31,2015,COL,STL,0,7,206,1.5,103,7.5,-110,-110,-246,-1.5,-123,2.45,Busch Stadium,7,-7
2015-07-31,2015,BOS,TB,7,5,-107,-1.5,180,9.0,-120,100,-103,1.5,-210,4.65,Fenway Park,12,2
2015-07-31,2015,SF,TEX,3,6,-174,-1.5,-114,9.0,-110,-110,154,1.5,-106,5.72,Rangers Ballpark,9,-3
2015-07-31,2015,KC,TOR,6,7,102,1.5,-215,7.5,-110,-110,-112,-1.5,185,3.71,Rogers Centre,13,-1
2015-07-31,2015,NYM,WSH,2,1,-113,-1.5,190,7.0,-115,-105,103,1.5,-230,3.71,Citi Field,3,1
2015-08-01,2015,HOU,ARI,9,2,-212,-1.5,106,7.5,100,-120,182,1.5,-126,5.1,Minute Maid Park,11,7
2015-08-01,2015,PHI,ATL,12,2,-116,-1.5,185,7.5,-105,-115,106,1.5,-215,4.03,Citizens Bank Park,14,10
2015-08-01,2015,DET,BAL,2,6,138,1.5,-160,8.0,-110,-110,-153,-1.5,140,3.36,Camden Yards,8,-4
2015-08-01,2015,TB,BOS,7,11,116,1.5,-165,10.5,-105,-115,-131,-1.5,145,4.86,Fenway Park,18,-4
2015-08-01,2015,MIL,CHC,2,4,132,1.5,-130,8.0,-120,100,-147,-1.5,110,3.45,Miller Park,6,-2
2015-08-01,2015,PIT,CIN,3,4,-144,-1.5,110,8.0,-105,-115,129,1.5,-130,4.72,Great American Ballpark,7,-1
2015-08-01,2015,OAK,CLE,5,1,-108,1.5,-182,7.5,-119,-101,-102,-1.5,160,3.89,Oakland Coliseum,6,4
2015-08-01,2015,STL,COL,2,6,-176,-1.5,135,7.0,110,-130,156,1.5,-155,4.46,Busch Stadium,8,-4
2015-08-01,2015,NYY,CWS,2,8,-130,-1.5,125,9.0,-110,-110,115,1.5,-145,5.09,Guaranteed Rate Field,10,-6
2015-08-01,2015,BAL,DET,6,2,-153,-1.5,140,8.0,-110,-110,138,1.5,-160,4.84,Camden Yards,8,4
2015-08-01,2015,ARI,HOU,2,9,182,1.5,-126,7.5,100,-120,-212,-1.5,106,2.66,Minute Maid Park,11,-7
2015-08-01,2015,TOR,KC,6,7,-127,-1.5,160,8.0,-119,-101,117,1.5,-180,4.48,Rogers Centre,13,-1
2015-08-01,2015,LAD,LAA,3,1,-205,-1.5,120,6.0,-120,100,175,1.5,-140,4.03,Dodger Stadium,4,2
2015-08-01,2015,LAA,LAD,1,3,175,1.5,-140,6.0,-120,100,-205,-1.5,120,2.18,Dodger Stadium,4,-2
2015-08-01,2015,SD,MIA,5,3,-113,-1.5,150,7.0,-125,105,103,1.5,-170,3.71,Marlins Park,8,2
2015-08-01,2015,CHC,MIL,4,2,-147,-1.5,110,8.0,-120,100,132,1.5,-130,4.76,Miller Park,6,2
2015-08-01,2015,SEA,MIN,2,3,118,1.5,-175,8.5,-121,101,-133,-1.5,155,3.9,Target Field,5,-1
2015-08-01,2015,WSH,NYM,2,3,130,1.5,-180,6.5,-132,112,-145,-1.5,160,2.83,Citi Field,5,-1
2015-08-01,2015,CWS,NYY,8,2,115,1.5,-145,9.0,-110,-110,-130,-1.5,125,4.19,Guaranteed Rate Field,10,6
2015-08-01,2015,CLE,OAK,1,5,-102,-1.5,160,7.5,-119,-101,-108,1.5,-182,3.79,Oakland Coliseum,6,-4
2015-08-01,2015,ATL,PHI,2,12,106,1.5,-215,7.5,-105,-115,-116,-1.5,185,3.64,Citizens Bank Park,14,-10
2015-08-01,2015,CIN,PIT,4,3,129,1.5,-130,8.0,-105,-115,-144,-1.5,110,3.49,Great American Ballpark,7,1
2015-08-01,2015,MIA,SD,3,5,103,1.5,-170,7.0,-125,105,-113,-1.5,150,3.45,Marlins Park,8,-2
2015-08-01,2015,MIN,SEA,3,2,-133,-1.5,155,8.5,-121,101,118,1.5,-175,4.85,Target Field,5,1
2015-08-01,2015,TEX,SF,7,9,-132,-1.5,150,8.5,-121,101,117,1.5,-170,4.84,Rangers Ballpark,16,-2
2015-08-01,2015,COL,STL,6,2,156,1.5,-155,7.0,110,-130,-176,-1.5,135,2.73,Busch Stadium,8,4
2015-08-01,2015,BOS,TB,11,7,-131,-1.5,145,10.5,-105,-115,116,1.5,-165,5.95,Fenway Park,18,4
2015-08-01,2015,SF,TEX,9,7,117,1.5,-170,8.5,-121,101,-132,-1.5,150,3.92,Rangers Ballpark,16,2
2015-08-01,2015,KC,TOR,7,6,117,1.5,-180,8.0,-119,-101,-127,-1.5,160,3.69,Rogers Centre,13,1
2015-08-01,2015,NYM,WSH,3,2,-145,-1.5,160,6.5,-132,112,130,1.5,-180,3.85,Citi Field,5,1
2015-08-02,2015,HOU,ARI,4,1,-146,-1.5,145,8.0,-105,-115,131,1.5,-165,4.75,Minute Maid Park,5,3
2015-08-02,2015,PHI,ATL,2,6,-105,1.5,-170,8.5,-110,-110,-105,-1.5,150,4.35,Citizens Bank Park,8,-4
2015-08-02,2015,DET,BAL,6,1,158,1.5,-130,9.0,100,-120,-178,-1.5,110,3.49,Camden Yards,7,5
2015-08-02,2015,TB,BOS,4,3,-105,-1.5,150,9.5,-104,-116,-105,1.5,-170,4.87,Fenway Park,7,1
2015-08-02,2015,MIL,CHC,3,4,-112,-1.5,175,9.5,-105,-115,102,1.5,-205,5.02,Miller Park,7,-1
2015-08-02,2015,PIT,CIN,3,0,-147,-1.5,115,9.0,-115,-105,132,1.5,-135,5.36,Great American Ballpark,3,3
2015-08-02,2015,OAK,CLE,2,1,-154,-1.5,150,6.5,-109,-111,139,1.5,-170,3.94,Oakland Coliseum,3,1
2015-08-02,2015,STL,COL,3,2,-190,-1.5,115,7.5,100,-120,170,1.5,-135,4.91,Busch Stadium,5,1
2015-08-02,2015,NYY,CWS,12,3,100,1.5,-205,9.0,-105,-115,-110,-1.5,175,4.5,Guaranteed Rate Field,15,9
2015-08-02,2015,BAL,DET,1,6,-178,-1.5,110,9.0,100,-120,158,1.5,-130,5.76,Camden Yards,7,-5
2015-08-02,2015,ARI,HOU,1,4,131,1.5,-165,8.0,-105,-115,-146,-1.5,145,3.46,Minute Maid Park,5,-3
2015-08-02,2015,TOR,KC,5,2,-146,-1.5,135,9.0,-101,-119,131,1.5,-155,5.34,Rogers Centre,7,3
2015-08-02,2015,LAD,LAA,5,3,-133,-1.5,165,8.0,-110,-110,118,1.5,-185,4.57,Dodger Stadium,8,2
2015-08-02,2015,LAA,LAD,3,5,118,1.5,-185,8.0,-110,-110,-133,-1.5,165,3.67,Dodger Stadium,8,-2
2015-08-02,2015,SD,MIA,2,5,130,1.5,-185,6.0,105,-125,-145,-1.5,165,2.61,Marlins Park,7,-3
2015-08-02,2015,CHC,MIL,4,3,102,1.5,-205,9.5,-105,-115,-112,-1.5,175,4.7,Miller Park,7,1
2015-08-02,2015,SEA,MIN,4,1,-115,-1.5,135,9.0,101,-121,105,1.5,-155,4.81,Target Field,5,3
2015-08-02,2015,WSH,NYM,2,5,116,1.5,-205,6.5,-130,110,-126,-1.5,175,3.01,Citi Field,7,-3
2015-08-02,2015,CWS,NYY,3,12,-110,-1.5,175,9.0,-105,-115,100,1.5,-205,4.71,Guaranteed Rate Field,15,-9
2015-08-02,2015,CLE,OAK,1,2,139,1.5,-170,6.5,-109,-111,-154,-1.5,150,2.72,Oakland Coliseum,3,-1
2015-08-02,2015,ATL,PHI,6,2,-105,-1.5,150,8.5,-110,-110,-105,1.5,-170,4.35,Citizens Bank Park,8,4
2015-08-02,2015,CIN,PIT,0,3,132,1.5,-135,9.0,-115,-105,-147,-1.5,115,3.88,Great American Ballpark,3,-3
2015-08-02,2015,MIA,SD,5,2,-145,-1.5,165,6.0,105,-125,130,1.5,-185,3.55,Marlins Park,7,3
2015-08-02,2015,MIN,SEA,1,4,105,1.5,-155,9.0,101,-121,-115,-1.5,135,4.39,Target Field,5,-3
2015-08-02,2015,TEX,SF,2,1,106,1.5,-155,9.5,-115,-105,-116,-1.5,135,4.61,Rangers Ballpark,3,1
2015-08-02,2015,COL,STL,2,3,170,1.5,-135,7.5,100,-120,-190,-1.5,115,2.78,Busch Stadium,5,-1
2015-08-02,2015,BOS,TB,3,4,-105,1.5,-170,9.5,-104,-116,-105,-1.5,150,4.87,Fenway Park,7,-1
2015-08-02,2015,SF,TEX,1,2,-116,-1.5,135,9.5,-115,-105,106,1.5,-155,5.1,Rangers Ballpark,3,-1
2015-08-02,2015,KC,TOR,2,5,131,1.5,-155,9.0,-101,-119,-146,-1.5,135,3.9,Rogers Centre,7,-3
2015-08-02,2015,NYM,WSH,5,2,-126,-1.5,175,6.5,-130,110,116,1.5,-205,3.62,Citi Field,7,3
2015-08-03,2015,WSH,ARI,4,6,-119,-1.5,176,8.0,-120,100,109,1.5,-205,4.35,Nationals Park,10,-2
2015-08-03,2015,SF,ATL,8,9,-147,-1.5,121,7.5,-106,-114,132,1.5,-141,4.46,Turner Field,17,-1
2015-08-03,2015,OAK,BAL,2,9,-118,-1.5,180,7.0,-125,105,108,1.5,-210,3.79,Oakland Coliseum,11,-7
2015-08-03,2015,LAA,CLE,5,4,-112,-1.5,195,6.5,102,-122,102,1.5,-235,3.43,Angel Stadium,9,1
2015-08-03,2015,SEA,COL,8,7,-175,-1.5,-119,9.5,-120,100,155,1.5,-101,6.05,Coors Field,15,1
2015-08-03,2015,TB,CWS,5,4,103,1.5,-205,7.5,-110,-110,-113,-1.5,175,3.69,Guaranteed Rate Field,9,1
2015-08-03,2015,TEX,HOU,12,9,110,1.5,-155,9.0,-110,-110,-120,-1.5,135,4.29,Rangers Ballpark,21,3
2015-08-03,2015,CLE,LAA,4,5,102,1.5,-235,6.5,102,-122,-112,-1.5,195,3.22,Angel Stadium,9,-1
2015-08-03,2015,NYM,MIA,12,1,-116,-1.5,155,7.5,105,-125,106,1.5,-176,4.03,Marlins Park,13,11
2015-08-03,2015,SD,MIL,13,5,-110,-1.5,150,7.0,-125,105,100,1.5,-170,3.67,Miller Park,18,8
2015-08-03,2015,TOR,MIN,5,1,-230,-1.5,-115,8.0,-105,-115,200,1.5,-105,5.58,Rogers Centre,6,4
2015-08-03,2015,MIA,NYM,1,12,106,1.5,-176,7.5,105,-125,-116,-1.5,155,3.64,Marlins Park,13,-11
2015-08-03,2015,BAL,OAK,9,2,108,1.5,-210,7.0,-125,105,-118,-1.5,180,3.37,Oakland Coliseum,11,7
2015-08-03,2015,MIL,SD,5,13,100,1.5,-170,7.0,-125,105,-110,-1.5,150,3.5,Miller Park,18,-8
2015-08-03,2015,COL,SEA,7,8,155,1.5,-101,9.5,-120,100,-175,-1.5,-119,3.73,Coors Field,15,-1
2015-08-03,2015,ATL,SF,9,8,132,1.5,-141,7.5,-106,-114,-147,-1.5,121,3.23,Turner Field,17,1
2015-08-03,2015,CWS,TB,4,5,-113,-1.5,175,7.5,-110,-110,103,1.5,-205,3.98,Guaranteed Rate Field,9,-1
2015-08-03,2015,HOU,TEX,9,12,-120,-1.5,135,9.0,-110,-110,110,1.5,-155,4.91,Rangers Ballpark,21,-3
2015-08-03,2015,MIN,TOR,1,5,200,1.5,-105,8.0,-105,-115,-230,-1.5,-115,2.67,Rogers Centre,6,-4
2015-08-03,2015,ARI,WSH,6,4,109,1.5,-205,8.0,-120,100,-119,-1.5,176,3.83,Nationals Park,10,2
2015-08-04,2015,WSH,ARI,5,4,-188,-1.5,115,6.5,-132,112,168,1.5,-135,4.24,Nationals Park,9,1
2015-08-04,2015,SF,ATL,8,3,-123,-1.5,145,7.0,-125,105,113,1.5,-166,3.86,Turner Field,11,5
2015-08-04,2015,OAK,BAL,5,0,100,1.5,-165,7.0,-125,105,-110,-1.5,145,3.5,Oakland Coliseum,5,5
2015-08-04,2015,NYY,BOS,13,3,-178,-1.5,115,8.5,-115,-105,158,1.5,-135,5.44,Yankee Stadium,16,10
2015-08-04,2015,PIT,CHC,0,5,112,1.5,-160,7.0,-105,-115,-122,-1.5,140,3.3,PNC Park,5,-5
2015-08-04,2015,STL,CIN,2,3,-118,-1.5,145,8.0,-125,105,108,1.5,-165,4.33,Great American Ballpark,5,-1
2015-08-04,2015,LAA,CLE,0,2,-118,-1.5,185,7.0,-110,-110,108,1.5,-215,3.79,Angel Stadium,2,-2
2015-08-04,2015,SEA,COL,10,4,102,1.5,-195,10.5,-115,-105,-112,-1.5,165,5.2,Coors Field,14,6
2015-08-04,2015,TB,CWS,11,3,115,1.5,-205,6.5,100,-120,-125,-1.5,175,3.02,Guaranteed Rate Field,14,8
2015-08-04,2015,KC,DET,5,1,-117,-1.5,140,8.5,-115,-105,107,1.5,-160,4.58,Comerica Park,6,4
2015-08-04,2015,TEX,HOU,4,3,-108,-1.5,165,10.0,-110,-110,-102,1.5,-195,5.19,Rangers Ballpark,7,1
2015-08-04,2015,DET,KC,1,5,107,1.5,-160,8.5,-115,-105,-117,-1.5,140,4.11,Comerica Park,6,-4
2015-08-04,2015,CLE,LAA,2,0,108,1.5,-215,7.0,-110,-110,-118,-1.5,185,3.37,Angel Stadium,2,2
2015-08-04,2015,PHI,LAD,6,2,198,1.5,110,8.5,-118,-102,-228,-1.5,-130,2.85,Citizens Bank Park,8,4
2015-08-04,2015,NYM,MIA,5,1,-121,-1.5,140,7.5,117,-137,111,1.5,-160,4.11,Marlins Park,6,4
2015-08-04,2015,SD,MIL,1,4,114,1.5,-200,7.5,-105,-115,-124,-1.5,170,3.5,Miller Park,5,-3
2015-08-04,2015,TOR,MIN,3,1,-170,-1.5,130,8.5,-115,-105,150,1.5,-150,5.35,Rogers Centre,4,2
2015-08-04,2015,MIA,NYM,1,5,111,1.5,-160,7.5,117,-137,-121,-1.5,140,3.55,Marlins Park,6,-4
2015-08-04,2015,BOS,NYY,3,13,158,1.5,-135,8.5,-115,-105,-178,-1.5,115,3.29,Yankee Stadium,16,-10
2015-08-04,2015,BAL,OAK,0,5,-110,-1.5,145,7.0,-125,105,100,1.5,-165,3.67,Oakland Coliseum,5,-5
2015-08-04,2015,LAD,PHI,2,6,-228,-1.5,-130,8.5,-118,-102,198,1.5,110,5.91,Citizens Bank Park,8,-4
2015-08-04,2015,CHC,PIT,5,0,-122,-1.5,140,7.0,-105,-115,112,1.5,-160,3.85,PNC Park,5,5
2015-08-04,2015,MIL,SD,4,1,-124,-1.5,170,7.5,-105,-115,114,1.5,-200,4.15,Miller Park,5,3
2015-08-04,2015,COL,SEA,4,10,-112,-1.5,165,10.5,-115,-105,102,1.5,-195,5.55,Coors Field,14,-6
2015-08-04,2015,ATL,SF,3,8,113,1.5,-166,7.0,-125,105,-123,-1.5,145,3.29,Turner Field,11,-5
2015-08-04,2015,CIN,STL,3,2,108,1.5,-165,8.0,-125,105,-118,-1.5,145,3.85,Great American Ballpark,5,1
2015-08-04,2015,CWS,TB,3,11,-125,-1.5,175,6.5,100,-120,115,1.5,-205,3.61,Guaranteed Rate Field,14,-8
2015-08-04,2015,HOU,TEX,3,4,-102,1.5,-195,10.0,-110,-110,-108,-1.5,165,5.05,Rangers Ballpark,7,-1
2015-08-04,2015,MIN,TOR,1,3,150,1.5,-150,8.5,-115,-105,-170,-1.5,130,3.4,Rogers Centre,4,-2
2015-08-04,2015,ARI,WSH,4,5,168,1.5,-135,6.5,-132,112,-188,-1.5,115,2.43,Nationals Park,9,-1
2015-08-05,2015,WSH,ARI,4,11,-143,-1.5,160,7.5,-115,-105,128,1.5,-180,4.41,Nationals Park,15,-7
2015-08-05,2015,SF,ATL,6,1,-205,-1.5,-118,7.0,-120,100,175,1.5,-101,4.7,Turner Field,7,5
2015-08-05,2015,OAK,BAL,3,7,112,1.5,-155,7.0,-125,105,-122,-1.5,135,3.3,Oakland Coliseum,10,-4
2015-08-05,2015,NYY,BOS,1,2,-184,-1.5,100,9.5,100,-120,164,1.5,-120,6.15,Yankee Stadium,3,-1
2015-08-05,2015,PIT,CHC,7,5,-146,-1.5,150,8.0,-115,-105,131,1.5,-170,4.75,PNC Park,12,2
2015-08-05,2015,STL,CIN,4,3,-160,-1.5,100,8.0,100,-120,145,1.5,-120,4.92,Great American Ballpark,7,1
2015-08-05,2015,LAA,CLE,4,3,-125,-1.5,169,7.5,100,-120,115,1.5,-199,4.17,Angel Stadium,7,1
2015-08-05,2015,SEA,COL,5,7,-114,-1.5,135,10.5,-120,100,104,1.5,-155,5.59,Coors Field,12,-2
2015-08-05,2015,TB,CWS,5,6,-104,1.5,-205,8.0,100,-120,-106,-1.5,175,4.08,Guaranteed Rate Field,11,-1
2015-08-05,2015,KC,DET,1,2,-177,-1.5,-111,7.5,-101,-119,157,1.5,-109,4.79,Comerica Park,3,-1
2015-08-05,2015,TEX,HOU,4,3,149,1.5,-119,9.0,-115,-105,-164,-1.5,-101,3.61,Rangers Ballpark,7,1
2015-08-05,2015,DET,KC,2,1,157,1.5,-109,7.5,-101,-119,-177,-1.5,-111,2.92,Comerica Park,3,1
2015-08-05,2015,CLE,LAA,3,4,115,1.5,-199,7.5,100,-120,-125,-1.5,169,3.49,Angel Stadium,7,-1
2015-08-05,2015,PHI,LAD,3,4,154,1.5,-114,8.0,-118,-102,-169,-1.5,-106,3.15,Citizens Bank Park,7,-1
2015-08-05,2015,NYM,MIA,8,6,-170,-1.5,-110,7.0,105,-125,150,1.5,-110,4.41,Marlins Park,14,2
2015-08-05,2015,SD,MIL,5,8,109,1.5,-215,7.5,100,-120,-119,-1.5,185,3.59,Miller Park,13,-3
2015-08-05,2015,TOR,MIN,9,7,-190,-1.5,115,9.0,100,-120,170,1.5,-135,5.9,Rogers Centre,16,2
2015-08-05,2015,MIA,NYM,6,8,150,1.5,-110,7.0,105,-125,-170,-1.5,-110,2.8,Marlins Park,14,-2
2015-08-05,2015,BOS,NYY,2,1,164,1.5,-120,9.5,100,-120,-184,-1.5,100,3.6,Yankee Stadium,3,1
2015-08-05,2015,BAL,OAK,7,3,-122,-1.5,135,7.0,-125,105,112,1.5,-155,3.85,Oakland Coliseum,10,4
2015-08-05,2015,LAD,PHI,4,3,-169,-1.5,-106,8.0,-118,-102,154,1.5,-114,5.03,Citizens Bank Park,7,1
2015-08-05,2015,CHC,PIT,5,7,131,1.5,-170,8.0,-115,-105,-146,-1.5,150,3.46,PNC Park,12,-2
2015-08-05,2015,MIL,SD,8,5,-119,-1.5,185,7.5,100,-120,109,1.5,-215,4.08,Miller Park,13,3
2015-08-05,2015,COL,SEA,7,5,104,1.5,-155,10.5,-120,100,-114,-1.5,135,5.15,Coors Field,12,2
2015-08-05,2015,ATL,SF,1,6,175,1.5,-101,7.0,-120,100,-205,-1.5,-118,2.55,Turner Field,7,-5
2015-08-05,2015,CIN,STL,3,4,145,1.5,-120,8.0,100,-120,-160,-1.5,100,3.27,Great American Ballpark,7,-1
2015-08-05,2015,CWS,TB,6,5,-106,-1.5,175,8.0,100,-120,-104,1.5,-205,4.12,Guaranteed Rate Field,11,1
2015-08-05,2015,HOU,TEX,3,4,-164,-1.5,-101,9.0,-115,-105,149,1.5,-119,5.59,Rangers Ballpark,7,-1
2015-08-05,2015,MIN,TOR,7,9,170,1.5,-135,9.0,100,-120,-190,-1.5,115,3.33,Rogers Centre,16,-2
2015-08-05,2015,ARI,WSH,11,4,128,1.5,-180,7.5,-115,-105,-143,-1.5,160,3.29,Nationals Park,15,7
2015-08-06,2015,WSH,ARI,8,3,-190,-1.5,120,7.0,-120,100,170,1.5,-140,4.59,Nationals Park,11,5
2015-08-06,2015,MIA,ATL,8,9,-111,-1.5,160,7.5,110,-130,101,1.5,-180,3.95,Turner Field,17,-1
2015-08-06,2015,NYY,BOS,2,1,-134,-1.5,150,8.5,-115,-105,119,1.5,-170,4.87,Yankee Stadium,3,1
2015-08-06,2015,SF,CHC,4,5,126,1.5,-195,7.0,-105,-115,-141,-1.5,165,3.1,Wrigley Field,9,-1
2015-08-06,2015,STL,CIN,3,0,-161,-1.5,110,7.5,102,-122,146,1.5,-130,4.63,Great American Ballpark,3,3
2015-08-06,2015,KC,DET,6,8,-104,-1.5,155,7.5,-118,-102,-106,1.5,-175,3.82,Comerica Park,14,-2
2015-08-06,2015,OAK,HOU,4,5,109,1.5,-160,7.5,-115,-105,-119,-1.5,140,3.59,Oakland Coliseum,9,-1
2015-08-06,2015,DET,KC,8,6,-106,1.5,-175,7.5,-118,-102,-104,-1.5,155,3.86,Comerica Park,14,2
2015-08-06,2015,PHI,LAD,8,10,243,1.5,130,7.5,-113,-107,-283,-1.5,-150,2.19,Citizens Bank Park,18,-2
2015-08-06,2015,ATL,MIA,9,8,101,1.5,-180,7.5,110,-130,-111,-1.5,160,3.73,Turner Field,17,1
2015-08-06,2015,SD,MIL,1,10,109,1.5,-210,8.0,-110,-110,-119,-1.5,180,3.83,Miller Park,11,-9
2015-08-06,2015,TOR,MIN,9,3,-160,-1.5,140,8.5,-105,-115,145,1.5,-160,5.23,Rogers Centre,12,6
2015-08-06,2015,BOS,NYY,1,2,119,1.5,-170,8.5,-115,-105,-134,-1.5,150,3.88,Yankee Stadium,3,-1
2015-08-06,2015,HOU,OAK,5,4,-119,-1.5,140,7.5,-115,-105,109,1.5,-160,4.08,Oakland Coliseum,9,1
2015-08-06,2015,LAD,PHI,10,8,-283,-1.5,-150,7.5,-113,-107,243,1.5,130,5.54,Citizens Bank Park,18,2
2015-08-06,2015,MIL,SD,10,1,-119,-1.5,180,8.0,-110,-110,109,1.5,-210,4.35,Miller Park,11,9
2015-08-06,2015,CHC,SF,5,4,-141,-1.5,165,7.0,-105,-115,126,1.5,-195,4.1,Wrigley Field,9,1
2015-08-06,2015,CIN,STL,0,3,146,1.5,-130,7.5,102,-122,-161,-1.5,110,3.05,Great American Ballpark,3,-3
2015-08-06,2015,MIN,TOR,3,9,145,1.5,-160,8.5,-105,-115,-160,-1.5,140,3.47,Rogers Centre,12,-6
2015-08-06,2015,ARI,WSH,3,8,170,1.5,-140,7.0,-120,100,-190,-1.5,120,2.59,Nationals Park,11,-5
2015-08-07,2015,CIN,ARI,0,2,107,1.5,-215,8.5,-105,-115,-117,-1.5,185,4.11,Chase Field,2,-2
2015-08-07,2015,MIA,ATL,3,6,-158,-1.5,115,6.5,105,-125,143,1.5,-135,3.98,Turner Field,9,-3
2015-08-07,2015,LAA,BAL,8,4,-130,-1.5,165,7.0,-125,105,115,1.5,-185,3.96,Angel Stadium,12,4
2015-08-07,2015,DET,BOS,2,7,-108,-1.5,175,9.0,-105,-115,-102,1.5,-205,4.67,Comerica Park,9,-5
2015-08-07,2015,SF,CHC,3,7,145,1.5,-150,8.0,-120,100,-160,-1.5,131,3.27,Wrigley Field,10,-4
2015-08-07,2015,ARI,CIN,2,0,-117,-1.5,185,8.5,-105,-115,107,1.5,-215,4.58,Chase Field,2,2
2015-08-07,2015,MIN,CLE,10,9,118,1.5,-170,8.5,-116,-104,-128,-1.5,150,3.9,Progressive Field,19,1
2015-08-07,2015,WSH,COL,4,5,-180,-1.5,120,7.5,-105,-115,160,1.5,-140,4.82,Nationals Park,9,-1
2015-08-07,2015,KC,CWS,3,2,-155,-1.5,135,8.0,-110,-110,140,1.5,-155,4.86,Kauffman Stadium,5,1
2015-08-07,2015,BOS,DET,7,2,-102,1.5,-205,9.0,-105,-115,-108,-1.5,175,4.54,Comerica Park,9,5
2015-08-07,2015,OAK,HOU,3,1,103,1.5,-184,6.0,-120,100,-113,-1.5,164,2.96,Oakland Coliseum,4,2
2015-08-07,2015,CWS,KC,2,3,140,1.5,-155,8.0,-110,-110,-155,-1.5,135,3.33,Kauffman Stadium,5,-1
2015-08-07,2015,BAL,LAA,4,8,115,1.5,-185,7.0,-125,105,-130,-1.5,165,3.26,Angel Stadium,12,-4
2015-08-07,2015,PIT,LAD,5,4,116,1.5,-160,6.0,-115,-105,-131,-1.5,140,2.78,PNC Park,9,1
2015-08-07,2015,ATL,MIA,6,3,143,1.5,-135,6.5,105,-125,-158,-1.5,115,2.67,Turner Field,9,3
2015-08-07,2015,STL,MIL,6,0,-140,-1.5,120,7.5,-120,100,125,1.5,-140,4.38,Miller Park,6,6
2015-08-07,2015,CLE,MIN,9,10,-128,-1.5,150,8.5,-116,-104,118,1.5,-170,4.77,Progressive Field,19,-1
2015-08-07,2015,TB,NYM,3,4,105,1.5,-175,6.5,-107,-113,-115,-1.5,155,3.17,Tropicana Field,7,-1
2015-08-07,2015,TOR,NYY,2,1,-101,1.5,-205,9.0,101,-121,-109,-1.5,175,4.52,Yankee Stadium,3,1
2015-08-07,2015,HOU,OAK,1,3,-113,-1.5,164,6.0,-120,100,103,1.5,-184,3.18,Oakland Coliseum,4,-2
2015-08-07,2015,SD,PHI,3,4,-145,-1.5,150,6.5,-115,-105,130,1.5,-170,3.85,PETCO Park,7,-1
2015-08-07,2015,LAD,PIT,4,5,-131,-1.5,140,6.0,-115,-105,116,1.5,-160,3.4,PNC Park,9,-1
2015-08-07,2015,PHI,SD,4,3,130,1.5,-170,6.5,-115,-105,-145,-1.5,150,2.83,PETCO Park,7,1
2015-08-07,2015,TEX,SEA,3,4,-109,-1.5,153,7.0,110,-130,-101,1.5,-173,3.65,T-Mobile Park,7,-1
2015-08-07,2015,CHC,SF,7,3,-160,-1.5,131,8.0,-120,100,145,1.5,-150,4.92,Wrigley Field,10,4
2015-08-07,2015,MIL,STL,0,6,125,1.5,-140,7.5,-120,100,-140,-1.5,120,3.33,Miller Park,6,-6
2015-08-07,2015,NYM,TB,4,3,-115,-1.5,155,6.5,-107,-113,105,1.5,-175,3.48,Tropicana Field,7,1
2015-08-07,2015,SEA,TEX,4,3,-101,1.5,-173,7.0,110,-130,-109,-1.5,153,3.52,T-Mobile Park,7,1
2015-08-07,2015,NYY,TOR,1,2,-109,-1.5,175,9.0,101,-121,-101,1.5,-205,4.69,Yankee Stadium,3,-1
2015-08-07,2015,COL,WSH,5,4,160,1.5,-140,7.5,-105,-115,-180,-1.5,120,2.88,Nationals Park,9,1
2015-08-08,2015,CIN,ARI,4,1,131,1.5,-165,8.0,-123,103,-146,-1.5,145,3.46,Chase Field,5,3
2015-08-08,2015,MIA,ATL,2,7,-108,-1.5,145,7.5,100,-120,-102,1.5,-165,3.89,Turner Field,9,-5
2015-08-08,2015,LAA,BAL,0,5,-133,-1.5,155,7.0,-110,-110,118,1.5,-175,4.0,Angel Stadium,5,-5
2015-08-08,2015,DET,BOS,7,6,105,1.5,-170,8.5,-120,100,-115,-1.5,150,4.15,Comerica Park,13,1
2015-08-08,2015,SF,CHC,6,8,119,1.5,-175,8.0,-104,-116,-134,-1.5,155,3.65,Wrigley Field,14,-2
2015-08-08,2015,ARI,CIN,1,4,-146,-1.5,145,8.0,-123,103,131,1.5,-165,4.75,Chase Field,5,-3
2015-08-08,2015,MIN,CLE,4,17,118,1.5,-185,8.0,100,-120,-133,-1.5,165,3.67,Progressive Field,21,-13
2015-08-08,2015,WSH,COL,6,1,-199,-1.5,105,7.5,-115,-105,179,1.5,-125,4.99,Nationals Park,7,5
2015-08-08,2015,KC,CWS,7,6,-117,-1.5,180,8.5,-110,-110,107,1.5,-210,4.58,Kauffman Stadium,13,1
2015-08-08,2015,BOS,DET,6,7,-115,-1.5,150,8.5,-120,100,105,1.5,-170,4.55,Comerica Park,13,-1
2015-08-08,2015,OAK,HOU,2,1,-102,1.5,-165,7.5,-105,-115,-108,-1.5,145,3.79,Oakland Coliseum,3,1
2015-08-08,2015,CWS,KC,6,7,107,1.5,-210,8.5,-110,-110,-117,-1.5,180,4.11,Kauffman Stadium,13,-1
2015-08-08,2015,BAL,LAA,5,0,118,1.5,-175,7.0,-110,-110,-133,-1.5,155,3.21,Angel Stadium,5,5
2015-08-08,2015,PIT,LAD,6,5,-156,-1.5,155,7.5,-105,-115,141,1.5,-175,4.57,PNC Park,11,1
2015-08-08,2015,ATL,MIA,7,2,-102,1.5,-165,7.5,100,-120,-108,-1.5,145,3.79,Turner Field,9,5
2015-08-08,2015,STL,MIL,3,0,-161,-1.5,106,7.5,105,-125,146,1.5,-127,4.63,Miller Park,3,3
2015-08-08,2015,CLE,MIN,17,4,-133,-1.5,165,8.0,100,-120,118,1.5,-185,4.57,Progressive Field,21,13
2015-08-08,2015,TB,NYM,5,4,106,1.5,-165,7.0,110,-130,-116,-1.5,145,3.4,Tropicana Field,9,1
2015-08-08,2015,TOR,NYY,6,0,-150,-1.5,107,8.5,-125,105,135,1.5,-127,5.1,Yankee Stadium,6,6
2015-08-08,2015,HOU,OAK,1,2,-108,-1.5,145,7.5,-105,-115,-102,1.5,-165,3.89,Oakland Coliseum,3,-1
2015-08-08,2015,SD,PHI,2,4,-215,-1.5,105,7.0,-101,-119,185,1.5,-125,4.78,PETCO Park,6,-2
2015-08-08,2015,LAD,PIT,5,6,141,1.5,-175,7.5,-105,-115,-156,-1.5,155,3.11,PNC Park,11,-1
2015-08-08,2015,PHI,SD,4,2,185,1.5,-125,7.0,-101,-119,-215,-1.5,105,2.46,PETCO Park,6,2
2015-08-08,2015,TEX,SEA,11,3,101,1.5,-230,7.5,-101,-119,-111,-1.5,190,3.73,T-Mobile Park,14,8
2015-08-08,2015,CHC,SF,8,6,-134,-1.5,155,8.0,-104,-116,119,1.5,-175,4.58,Wrigley Field,14,2
2015-08-08,2015,MIL,STL,0,3,146,1.5,-127,7.5,105,-125,-161,-1.5,106,3.05,Miller Park,3,-3
2015-08-08,2015,NYM,TB,4,5,-116,-1.5,145,7.0,110,-130,106,1.5,-165,3.76,Tropicana Field,9,-1
2015-08-08,2015,SEA,TEX,3,11,-111,-1.5,190,7.5,-101,-119,101,1.5,-230,3.95,T-Mobile Park,14,-8
2015-08-08,2015,NYY,TOR,0,6,135,1.5,-127,8.5,-125,105,-150,-1.5,107,3.62,Yankee Stadium,6,-6
2015-08-08,2015,COL,WSH,1,6,179,1.5,-125,7.5,-115,-105,-199,-1.5,105,2.69,Nationals Park,7,-5
2015-08-09,2015,CIN,ARI,3,4,131,1.5,-165,7.5,-115,-105,-146,-1.5,145,3.25,Chase Field,7,-1
2015-08-09,2015,MIA,ATL,4,1,119,1.5,-200,7.0,-115,-105,-129,-1.5,170,3.2,Turner Field,5,3
2015-08-09,2015,LAA,BAL,5,4,-110,-1.5,180,8.0,-110,-110,100,1.5,-210,4.19,Angel Stadium,9,1
2015-08-09,2015,DET,BOS,2,7,-144,-1.5,145,8.5,-102,-118,129,1.5,-165,5.02,Comerica Park,9,-5
2015-08-09,2015,SF,CHC,0,2,144,1.5,-155,7.5,-105,-115,-159,-1.5,135,3.07,Wrigley Field,2,-2
2015-08-09,2015,ARI,CIN,4,3,-146,-1.5,145,7.5,-115,-105,131,1.5,-165,4.45,Chase Field,7,1
2015-08-09,2015,MIN,CLE,1,8,151,1.5,-152,7.0,-110,-110,-171,-1.5,132,2.79,Progressive Field,9,-7
2015-08-09,2015,WSH,COL,4,6,-277,-1.5,-125,7.5,-105,-115,237,1.5,105,5.51,Nationals Park,10,-2
2015-08-09,2015,KC,CWS,5,4,-115,-1.5,180,7.5,-110,-110,105,1.5,-210,4.01,Kauffman Stadium,9,1
2015-08-09,2015,BOS,DET,7,2,129,1.5,-165,8.5,-102,-118,-144,-1.5,145,3.71,Comerica Park,9,5
2015-08-09,2015,OAK,HOU,5,4,115,1.5,-150,7.0,-115,-105,-125,-1.5,130,3.26,Oakland Coliseum,9,1
2015-08-09,2015,CWS,KC,4,5,105,1.5,-210,7.5,-110,-110,-115,-1.5,180,3.66,Kauffman Stadium,9,-1
2015-08-09,2015,BAL,LAA,4,5,100,1.5,-210,8.0,-110,-110,-110,-1.5,180,4.0,Angel Stadium,9,-1
2015-08-09,2015,PIT,LAD,13,6,103,1.5,-156,8.0,100,-120,-113,-1.5,136,3.94,PNC Park,19,7
2015-08-09,2015,ATL,MIA,1,4,-129,-1.5,170,7.0,-115,-105,119,1.5,-200,3.94,Turner Field,5,-3
2015-08-09,2015,STL,MIL,4,5,-115,-1.5,140,7.5,-110,-110,105,1.5,-160,4.01,Miller Park,9,-1
2015-08-09,2015,CLE,MIN,8,1,-171,-1.5,132,7.0,-110,-110,151,1.5,-152,4.42,Progressive Field,9,7
2015-08-09,2015,TB,NYM,4,3,-177,-1.5,130,6.5,-125,105,157,1.5,-150,4.15,Tropicana Field,7,1
2015-08-09,2015,TOR,NYY,2,0,145,1.5,-150,8.0,-120,100,-160,-1.5,130,3.27,Yankee Stadium,2,2
2015-08-09,2015,HOU,OAK,4,5,-125,-1.5,130,7.0,-115,-105,115,1.5,-150,3.89,Oakland Coliseum,9,-1
2015-08-09,2015,SD,PHI,3,5,-190,-1.5,115,7.5,105,-125,170,1.5,-135,4.91,PETCO Park,8,-2
2015-08-09,2015,LAD,PIT,6,13,-113,-1.5,136,8.0,100,-120,103,1.5,-156,4.24,PNC Park,19,-7
2015-08-09,2015,PHI,SD,5,3,170,1.5,-135,7.5,105,-125,-190,-1.5,115,2.78,PETCO Park,8,2
2015-08-09,2015,TEX,SEA,2,4,155,1.5,-140,7.5,-105,-115,-175,-1.5,120,2.94,T-Mobile Park,6,-2
2015-08-09,2015,CHC,SF,2,0,-159,-1.5,135,7.5,-105,-115,144,1.5,-155,4.6,Wrigley Field,2,2
2015-08-09,2015,MIL,STL,5,4,105,1.5,-160,7.5,-110,-110,-115,-1.5,140,3.66,Miller Park,9,1
2015-08-09,2015,NYM,TB,3,4,157,1.5,-150,6.5,-125,105,-177,-1.5,130,2.53,Tropicana Field,7,-1
2015-08-09,2015,SEA,TEX,4,2,-175,-1.5,120,7.5,-105,-115,155,1.5,-140,4.77,T-Mobile Park,6,2
2015-08-09,2015,NYY,TOR,0,2,-160,-1.5,130,8.0,-120,100,145,1.5,-150,4.92,Yankee Stadium,2,-2
2015-08-09,2015,COL,WSH,6,4,237,1.5,105,7.5,-105,-115,-277,-1.5,-125,2.23,Nationals Park,10,2
2015-08-10,2015,PHI,ARI,3,13,165,1.5,-140,8.5,-110,-110,-185,-1.5,120,3.21,Chase Field,16,-10
2015-08-10,2015,SEA,BAL,2,3,110,1.5,-160,7.5,100,-120,-120,-1.5,140,3.57,T-Mobile Park,5,-1
2015-08-10,2015,SD,CIN,2,1,-140,-1.5,155,7.5,100,-120,125,1.5,-175,4.38,PETCO Park,3,1
2015-08-10,2015,NYM,COL,4,2,-154,-1.5,140,7.5,100,-120,139,1.5,-160,4.55,Citi Field,6,2
2015-08-10,2015,LAA,CWS,2,8,132,1.5,-190,7.5,105,-125,-147,-1.5,160,3.23,Guaranteed Rate Field,10,-6
2015-08-10,2015,KC,DET,4,0,-220,-1.5,-105,7.0,-120,100,190,1.5,-115,4.81,Kauffman Stadium,4,4
2015-08-10,2015,DET,KC,0,4,190,1.5,-115,7.0,-120,100,-220,-1.5,-105,2.41,Kauffman Stadium,4,-4
2015-08-10,2015,CWS,LAA,8,2,-147,-1.5,160,7.5,105,-125,132,1.5,-190,4.46,Guaranteed Rate Field,10,6
2015-08-10,2015,WSH,LAD,8,3,-102,1.5,-230,7.0,100,-120,-108,-1.5,190,3.53,Dodger Stadium,11,5
2015-08-10,2015,COL,NYM,2,4,139,1.5,-160,7.5,100,-120,-154,-1.5,140,3.14,Citi Field,6,-2
2015-08-10,2015,ARI,PHI,13,3,-185,-1.5,120,8.5,-110,-110,165,1.5,-140,5.52,Chase Field,16,10
2015-08-10,2015,CIN,SD,1,2,125,1.5,-175,7.5,100,-120,-140,-1.5,155,3.33,PETCO Park,3,-1
2015-08-10,2015,BAL,SEA,3,2,-120,-1.5,140,7.5,100,-120,110,1.5,-160,4.09,T-Mobile Park,5,1
2015-08-10,2015,LAD,WSH,3,8,-108,-1.5,190,7.0,100,-120,-102,1.5,-230,3.63,Dodger Stadium,11,-5
2015-08-11,2015,PHI,ARI,1,13,175,1.5,-125,8.5,-120,100,-205,-1.5,105,3.09,Chase Field,14,-12
2015-08-11,2015,TB,ATL,2,0,-193,-1.5,110,7.0,-120,100,173,1.5,-130,4.61,Tropicana Field,2,2
2015-08-11,2015,SEA,BAL,6,5,-135,-1.5,160,7.5,110,-130,120,1.5,-190,4.31,T-Mobile Park,11,1
2015-08-11,2015,MIA,BOS,5,4,102,1.5,-165,7.5,105,-125,-112,-1.5,145,3.71,Marlins Park,9,1
2015-08-11,2015,MIL,CHC,3,6,130,1.5,-175,7.5,-105,-115,-145,-1.5,155,3.26,Wrigley Field,9,-3
2015-08-11,2015,SD,CIN,11,6,-122,-1.5,180,7.0,-110,-110,112,1.5,-210,3.85,PETCO Park,17,5
2015-08-11,2015,NYY,CLE,4,5,104,1.5,-210,7.0,100,-120,-114,-1.5,180,3.43,Progressive Field,9,-1
2015-08-11,2015,NYM,COL,4,0,-205,-1.5,-103,7.0,-120,100,175,1.5,-117,4.7,Citi Field,4,4
2015-08-11,2015,LAA,CWS,0,3,-121,-1.5,125,8.5,-120,100,111,1.5,-145,4.65,Guaranteed Rate Field,3,-3
2015-08-11,2015,KC,DET,6,1,-170,-1.5,135,7.5,100,-120,150,1.5,-155,4.72,Kauffman Stadium,7,5
2015-08-11,2015,SF,HOU,3,1,-140,-1.5,170,6.0,-115,-105,125,1.5,-200,3.5,AT&T Park,4,2
2015-08-11,2015,DET,KC,1,6,150,1.5,-155,7.5,100,-120,-170,-1.5,135,3.0,Kauffman Stadium,7,-5
2015-08-11,2015,CWS,LAA,3,0,111,1.5,-145,8.5,-120,100,-121,-1.5,125,4.03,Guaranteed Rate Field,3,3
2015-08-11,2015,WSH,LAD,0,5,164,1.5,-140,6.5,100,-120,-184,-1.5,120,2.46,Dodger Stadium,5,-5
2015-08-11,2015,BOS,MIA,4,5,-112,-1.5,145,7.5,105,-125,102,1.5,-165,3.96,Marlins Park,9,-1
2015-08-11,2015,CHC,MIL,6,3,-145,-1.5,155,7.5,-105,-115,130,1.5,-175,4.44,Wrigley Field,9,3
2015-08-11,2015,TEX,MIN,2,3,111,1.5,-190,8.5,-115,-105,-121,-1.5,160,4.03,Target Field,5,-1
2015-08-11,2015,COL,NYM,0,4,175,1.5,-117,7.0,-120,100,-205,-1.5,-103,2.55,Citi Field,4,-4
2015-08-11,2015,CLE,NYY,5,4,-114,-1.5,180,7.0,100,-120,104,1.5,-210,3.73,Progressive Field,9,1
2015-08-11,2015,TOR,OAK,4,2,-170,-1.5,110,8.5,-125,105,150,1.5,-130,5.35,Rogers Centre,6,2
2015-08-11,2015,ARI,PHI,13,1,-205,-1.5,105,8.5,-120,100,175,1.5,-125,5.71,Chase Field,14,12
2015-08-11,2015,STL,PIT,4,3,-140,-1.5,160,7.0,100,-120,125,1.5,-190,4.08,Busch Stadium,7,1
2015-08-11,2015,CIN,SD,6,11,112,1.5,-210,7.0,-110,-110,-122,-1.5,180,3.3,PETCO Park,17,-5
2015-08-11,2015,BAL,SEA,5,6,120,1.5,-190,7.5,110,-130,-135,-1.5,160,3.41,T-Mobile Park,11,-1
2015-08-11,2015,HOU,SF,1,3,125,1.5,-200,6.0,-115,-105,-140,-1.5,170,2.67,AT&T Park,4,-2
2015-08-11,2015,PIT,STL,3,4,125,1.5,-190,7.0,100,-120,-140,-1.5,160,3.11,Busch Stadium,7,-1
2015-08-11,2015,ATL,TB,0,2,173,1.5,-130,7.0,-120,100,-193,-1.5,110,2.56,Tropicana Field,2,-2
2015-08-11,2015,MIN,TEX,3,2,-121,-1.5,160,8.5,-115,-105,111,1.5,-190,4.65,Target Field,5,1
2015-08-11,2015,OAK,TOR,2,4,150,1.5,-130,8.5,-125,105,-170,-1.5,110,3.4,Rogers Centre,6,-2
2015-08-11,2015,LAD,WSH,5,0,-184,-1.5,120,6.5,100,-120,164,1.5,-140,4.21,Dodger Stadium,5,5
2015-08-12,2015,PHI,ARI,7,6,150,1.5,-145,8.0,-108,-112,-170,-1.5,125,3.2,Chase Field,13,1
2015-08-12,2015,TB,ATL,9,6,-224,-1.5,-101,7.0,-101,-119,194,1.5,-119,4.84,Tropicana Field,15,3
2015-08-12,2015,SEA,BAL,3,0,-110,-1.5,185,7.0,-127,107,100,1.5,-215,3.67,T-Mobile Park,3,3
2015-08-12,2015,MIA,BOS,14,6,110,1.5,-160,7.0,-118,-102,-120,-1.5,140,3.33,Marlins Park,20,8
2015-08-12,2015,MIL,CHC,2,3,155,1.5,-135,8.0,-110,-110,-175,-1.5,115,3.14,Wrigley Field,5,-1
2015-08-12,2015,SD,CIN,3,7,-125,-1.5,180,7.0,-113,-107,115,1.5,-210,3.89,PETCO Park,10,-4
2015-08-12,2015,NYY,CLE,1,2,103,1.5,-210,7.0,-125,105,-113,-1.5,180,3.45,Progressive Field,3,-1
2015-08-12,2015,NYM,COL,3,0,-216,-1.5,100,6.5,-115,-105,186,1.5,-120,4.44,Citi Field,3,3
2015-08-12,2015,LAA,CWS,2,3,-116,-1.5,140,8.5,-115,-105,106,1.5,-160,4.56,Guaranteed Rate Field,5,-1
2015-08-12,2015,KC,DET,4,7,-171,-1.5,115,7.5,-105,-115,151,1.5,-135,4.73,Kauffman Stadium,11,-3
2015-08-12,2015,SF,HOU,0,2,-140,-1.5,165,7.5,100,-120,125,1.5,-185,4.38,AT&T Park,2,-2
2015-08-12,2015,DET,KC,7,4,151,1.5,-135,7.5,-105,-115,-171,-1.5,115,2.99,Kauffman Stadium,11,3
2015-08-12,2015,CWS,LAA,3,2,106,1.5,-160,8.5,-115,-105,-116,-1.5,140,4.13,Guaranteed Rate Field,5,1
2015-08-12,2015,WSH,LAD,0,3,175,1.5,-140,6.0,-105,-115,-205,-1.5,120,2.18,Dodger Stadium,3,-3
2015-08-12,2015,BOS,MIA,6,14,-120,-1.5,140,7.0,-118,-102,110,1.5,-160,3.82,Marlins Park,20,-8
2015-08-12,2015,CHC,MIL,3,2,-175,-1.5,115,8.0,-110,-110,155,1.5,-135,5.09,Wrigley Field,5,1
2015-08-12,2015,TEX,MIN,1,11,108,1.5,-200,9.0,-120,100,-118,-1.5,170,4.33,Target Field,12,-10
2015-08-12,2015,COL,NYM,0,3,186,1.5,-120,6.5,-115,-105,-216,-1.5,100,2.27,Citi Field,3,-3
2015-08-12,2015,CLE,NYY,2,1,-113,-1.5,180,7.0,-125,105,103,1.5,-210,3.71,Progressive Field,3,1
2015-08-12,2015,TOR,OAK,10,3,-182,-1.5,104,8.0,-120,100,162,1.5,-124,5.16,Rogers Centre,13,7
2015-08-12,2015,ARI,PHI,6,7,-170,-1.5,125,8.0,-108,-112,150,1.5,-145,5.04,Chase Field,13,-1
2015-08-12,2015,STL,PIT,4,2,-120,-1.5,190,6.5,105,-125,110,1.5,-230,3.55,Busch Stadium,6,2
2015-08-12,2015,CIN,SD,7,3,115,1.5,-210,7.0,-113,-107,-125,-1.5,180,3.26,PETCO Park,10,4
2015-08-12,2015,BAL,SEA,0,3,100,1.5,-215,7.0,-127,107,-110,-1.5,185,3.5,T-Mobile Park,3,-3
2015-08-12,2015,HOU,SF,2,0,125,1.5,-185,7.5,100,-120,-140,-1.5,165,3.33,AT&T Park,2,2
2015-08-12,2015,PIT,STL,2,4,110,1.5,-230,6.5,105,-125,-120,-1.5,190,3.1,Busch Stadium,6,-2
2015-08-12,2015,ATL,TB,6,9,194,1.5,-119,7.0,-101,-119,-224,-1.5,-101,2.38,Tropicana Field,15,-3
2015-08-12,2015,MIN,TEX,11,1,-118,-1.5,170,9.0,-120,100,108,1.5,-200,4.87,Target Field,12,10
2015-08-12,2015,OAK,TOR,3,10,162,1.5,-124,8.0,-120,100,-182,-1.5,104,3.05,Rogers Centre,13,-7
2015-08-12,2015,LAD,WSH,3,0,-205,-1.5,120,6.0,-105,-115,175,1.5,-140,4.03,Dodger Stadium,3,3
2015-08-13,2015,MIL,CHC,2,9,170,1.5,-119,9.0,100,-120,-200,-1.5,-101,3.33,Wrigley Field,11,-7
2015-08-13,2015,LAD,CIN,3,10,-155,-1.5,135,7.5,-106,-114,140,1.5,-155,4.56,Dodger Stadium,13,-7
2015-08-13,2015,NYY,CLE,8,6,-121,-1.5,120,7.5,-115,-105,111,1.5,-140,4.11,Progressive Field,14,2
2015-08-13,2015,NYM,COL,12,3,-270,-1.5,-115,7.5,-110,-110,230,1.5,-105,5.47,Citi Field,15,9
2015-08-13,2015,LAA,KC,7,6,-134,-1.5,115,8.0,-105,-115,119,1.5,-136,4.58,Kauffman Stadium,13,1
2015-08-13,2015,KC,LAA,6,7,119,1.5,-136,8.0,-105,-115,-134,-1.5,115,3.65,Kauffman Stadium,13,-1
2015-08-13,2015,CIN,LAD,10,3,140,1.5,-155,7.5,-106,-114,-155,-1.5,135,3.13,Dodger Stadium,13,7
2015-08-13,2015,CHC,MIL,9,2,-200,-1.5,-101,9.0,100,-120,170,1.5,-119,6.0,Wrigley Field,11,7
2015-08-13,2015,TEX,MIN,6,5,127,1.5,-170,9.0,-115,-105,-142,-1.5,150,3.96,Target Field,11,1
2015-08-13,2015,COL,NYM,3,12,230,1.5,-105,7.5,-110,-110,-270,-1.5,-115,2.27,Citi Field,15,-9
2015-08-13,2015,CLE,NYY,6,8,111,1.5,-140,7.5,-115,-105,-121,-1.5,120,3.55,Progressive Field,14,-2
2015-08-13,2015,TOR,OAK,4,2,-164,-1.5,125,8.5,100,-120,149,1.5,-145,5.28,Rogers Centre,6,2
2015-08-13,2015,STL,PIT,5,10,-101,1.5,-185,6.5,100,-120,-109,-1.5,165,3.27,Busch Stadium,15,-5
2015-08-13,2015,WSH,SF,1,3,-131,-1.5,125,7.0,100,-120,116,1.5,-145,3.97,AT&T Park,4,-2
2015-08-13,2015,PIT,STL,10,5,-109,-1.5,165,6.5,100,-120,-101,1.5,-185,3.39,Busch Stadium,15,5
2015-08-13,2015,MIN,TEX,5,6,-142,-1.5,150,9.0,-115,-105,127,1.5,-170,5.28,Target Field,11,-1
2015-08-13,2015,OAK,TOR,2,4,149,1.5,-145,8.5,100,-120,-164,-1.5,125,3.41,Rogers Centre,6,-2
2015-08-13,2015,SF,WSH,3,1,116,1.5,-145,7.0,100,-120,-131,-1.5,125,3.24,AT&T Park,4,2
2015-08-14,2015,ATL,ARI,3,2,119,1.5,-150,7.0,-115,-105,-129,-1.5,130,3.2,Turner Field,5,1
2015-08-14,2015,ARI,ATL,2,3,-129,-1.5,130,7.0,-115,-105,119,1.5,-150,3.94,Turner Field,5,-1
2015-08-14,2015,OAK,BAL,6,8,175,1.5,-125,8.5,100,-120,-195,-1.5,105,3.09,Camden Yards,14,-2
2015-08-14,2015,SEA,BOS,1,15,115,1.5,-175,9.5,-105,-115,-130,-1.5,155,4.42,Fenway Park,16,-14
2015-08-14,2015,CWS,CHC,5,6,101,1.5,-160,9.0,100,-120,-111,-1.5,140,4.48,Guaranteed Rate Field,11,-1
2015-08-14,2015,LAD,CIN,5,3,-177,-1.5,118,7.5,-101,-119,157,1.5,-137,4.79,Dodger Stadium,8,2
2015-08-14,2015,MIN,CLE,1,6,119,1.5,-140,7.5,-110,-110,-134,-1.5,120,3.42,Target Field,7,-5
2015-08-14,2015,SD,COL,9,5,-130,-1.5,115,10.5,-103,-117,115,1.5,-135,5.93,Coors Field,14,4
2015-08-14,2015,CHC,CWS,6,5,-111,-1.5,140,9.0,100,-120,101,1.5,-160,4.73,Guaranteed Rate Field,11,1
2015-08-14,2015,HOU,DET,5,1,-206,-1.5,-105,8.0,-115,-105,176,1.5,-115,5.39,Minute Maid Park,6,4
2015-08-14,2015,DET,HOU,1,5,176,1.5,-115,8.0,-115,-105,-206,-1.5,-105,2.9,Minute Maid Park,6,-4
2015-08-14,2015,LAA,KC,1,4,111,1.5,-198,8.5,-104,-116,-121,-1.5,168,4.03,Kauffman Stadium,5,-3
2015-08-14,2015,KC,LAA,4,1,-121,-1.5,168,8.5,-104,-116,111,1.5,-198,4.65,Kauffman Stadium,5,3
2015-08-14,2015,CIN,LAD,3,5,157,1.5,-137,7.5,-101,-119,-177,-1.5,118,2.92,Dodger Stadium,8,-2
2015-08-14,2015,STL,MIA,3,1,-239,-1.5,-114,6.5,-116,-104,209,1.5,-106,4.58,Busch Stadium,4,2
2015-08-14,2015,PHI,MIL,1,3,153,1.5,-139,8.5,-125,105,-173,-1.5,119,3.36,Miller Park,4,-2
2015-08-14,2015,CLE,MIN,6,1,-134,-1.5,120,7.5,-110,-110,119,1.5,-140,4.29,Target Field,7,5
2015-08-14,2015,PIT,NYM,3,2,103,1.5,-210,8.0,100,-120,-113,-1.5,180,3.94,Citi Field,5,1
2015-08-14,2015,TOR,NYY,3,4,-234,-1.5,-117,7.5,-109,-111,204,1.5,-103,5.25,Rogers Centre,7,-1
2015-08-14,2015,BAL,OAK,8,6,-195,-1.5,105,8.5,100,-120,175,1.5,-125,5.62,Camden Yards,14,2
2015-08-14,2015,MIL,PHI,3,1,-173,-1.5,119,8.5,-125,105,153,1.5,-139,5.39,Miller Park,4,2
2015-08-14,2015,NYM,PIT,2,3,-113,-1.5,180,8.0,100,-120,103,1.5,-210,4.24,Citi Field,5,-1
2015-08-14,2015,COL,SD,5,9,115,1.5,-135,10.5,-103,-117,-130,-1.5,115,4.88,Coors Field,14,-4
2015-08-14,2015,BOS,SEA,15,1,-130,-1.5,155,9.5,-105,-115,115,1.5,-175,5.37,Fenway Park,16,14
2015-08-14,2015,WSH,SF,5,8,-131,-1.5,124,6.5,-109,-111,116,1.5,-144,3.69,AT&T Park,13,-3
2015-08-14,2015,MIA,STL,1,3,209,1.5,-106,6.5,-116,-104,-239,-1.5,-114,2.1,Busch Stadium,4,-2
2015-08-14,2015,TEX,TB,5,3,-105,-1.5,185,9.0,-110,-110,-105,1.5,-215,4.61,Rangers Ballpark,8,2
2015-08-14,2015,TB,TEX,3,5,-105,1.5,-215,9.0,-110,-110,-105,-1.5,185,4.61,Rangers Ballpark,8,-2
2015-08-14,2015,NYY,TOR,4,3,204,1.5,-103,7.5,-109,-111,-234,-1.5,-117,2.47,Rogers Centre,7,1
2015-08-14,2015,SF,WSH,8,5,116,1.5,-144,6.5,-109,-111,-131,-1.5,124,3.01,AT&T Park,13,3
2015-08-15,2015,ATL,ARI,4,8,151,1.5,-119,7.5,100,-120,-171,-1.5,-101,2.99,Turner Field,12,-4
2015-08-15,2015,ARI,ATL,8,4,-171,-1.5,-101,7.5,100,-120,151,1.5,-119,4.73,Turner Field,12,4
2015-08-15,2015,OAK,BAL,3,4,118,1.5,-185,8.5,-101,-119,-128,-1.5,165,3.9,Camden Yards,7,-1
2015-08-15,2015,SEA,BOS,10,22,-126,-1.5,130,8.5,-120,100,116,1.5,-150,4.74,Fenway Park,32,-12
2015-08-15,2015,CWS,CHC,3,6,108,1.5,-160,7.5,100,-120,-118,-1.5,140,3.61,Guaranteed Rate Field,9,-3
2015-08-15,2015,LAD,CIN,8,3,-175,-1.5,115,8.5,-105,-115,155,1.5,-135,5.41,Dodger Stadium,11,5
2015-08-15,2015,MIN,CLE,4,1,-118,-1.5,175,9.0,100,-120,108,1.5,-205,4.87,Target Field,5,3
2015-08-15,2015,SD,COL,7,5,109,1.5,-180,11.0,100,-120,-119,-1.5,160,5.26,Coors Field,12,2
2015-08-15,2015,CHC,CWS,6,3,-118,-1.5,140,7.5,100,-120,108,1.5,-160,4.06,Guaranteed Rate Field,9,3
2015-08-15,2015,HOU,DET,2,4,-140,-1.5,150,7.5,-110,-110,125,1.5,-170,4.38,Minute Maid Park,6,-2
2015-08-15,2015,DET,HOU,4,2,125,1.5,-170,7.5,-110,-110,-140,-1.5,150,3.33,Minute Maid Park,6,2
2015-08-15,2015,LAA,KC,4,9,138,1.5,-170,7.0,-120,100,-153,-1.5,150,2.94,Kauffman Stadium,13,-5
2015-08-15,2015,KC,LAA,9,4,-153,-1.5,150,7.0,-120,100,138,1.5,-170,4.23,Kauffman Stadium,13,5
2015-08-15,2015,CIN,LAD,3,8,155,1.5,-135,8.5,-105,-115,-175,-1.5,115,3.33,Dodger Stadium,11,-5
2015-08-15,2015,STL,MIA,6,2,-200,-1.5,111,6.5,-120,100,170,1.5,-132,4.33,Busch Stadium,8,4
2015-08-15,2015,PHI,MIL,2,4,158,1.5,-140,8.0,-105,-115,-178,-1.5,120,3.1,Miller Park,6,-2
2015-08-15,2015,CLE,MIN,1,4,108,1.5,-205,9.0,100,-120,-118,-1.5,175,4.33,Target Field,5,-3
2015-08-15,2015,PIT,NYM,5,3,103,1.5,-230,7.5,-110,-110,-113,-1.5,190,3.69,Citi Field,8,2
2015-08-15,2015,TOR,NYY,1,4,-125,-1.5,165,8.5,-103,-117,115,1.5,-185,4.72,Rogers Centre,5,-3
2015-08-15,2015,BAL,OAK,4,3,-128,-1.5,165,8.5,-101,-119,118,1.5,-185,4.77,Camden Yards,7,1
2015-08-15,2015,MIL,PHI,4,2,-178,-1.5,120,8.0,-105,-115,158,1.5,-140,5.12,Miller Park,6,2
2015-08-15,2015,NYM,PIT,3,5,-113,-1.5,190,7.5,-110,-110,103,1.5,-230,3.98,Citi Field,8,-2
2015-08-15,2015,COL,SD,5,7,-119,-1.5,160,11.0,100,-120,109,1.5,-180,5.98,Coors Field,12,-2
2015-08-15,2015,BOS,SEA,22,10,116,1.5,-150,8.5,-120,100,-126,-1.5,130,3.94,Fenway Park,32,12
2015-08-15,2015,WSH,SF,6,12,104,1.5,-235,6.5,-130,110,-114,-1.5,195,3.19,AT&T Park,18,-6
2015-08-15,2015,MIA,STL,2,6,170,1.5,-132,6.5,-120,100,-200,-1.5,111,2.41,Busch Stadium,8,-4
2015-08-15,2015,TEX,TB,12,4,115,1.5,-145,7.5,-120,100,-125,-1.5,125,3.49,Rangers Ballpark,16,8
2015-08-15,2015,TB,TEX,4,12,-125,-1.5,125,7.5,-120,100,115,1.5,-145,4.17,Rangers Ballpark,16,-8
2015-08-15,2015,NYY,TOR,4,1,115,1.5,-185,8.5,-103,-117,-125,-1.5,165,3.95,Rogers Centre,5,3
2015-08-15,2015,SF,WSH,12,6,-114,-1.5,195,6.5,-130,110,104,1.5,-235,3.46,AT&T Park,18,6
2015-08-16,2015,ATL,ARI,2,1,104,1.5,-160,7.0,-110,-110,-114,-1.5,140,3.43,Turner Field,3,1
2015-08-16,2015,ARI,ATL,1,2,-114,-1.5,140,7.0,-110,-110,104,1.5,-160,3.73,Turner Field,3,-1
2015-08-16,2015,OAK,BAL,2,18,153,1.5,-140,8.5,-105,-115,-173,-1.5,120,3.36,Camden Yards,20,-16
2015-08-16,2015,SEA,BOS,10,8,109,1.5,-200,9.0,-102,-118,-119,-1.5,170,4.31,Fenway Park,18,2
2015-08-16,2015,CWS,CHC,3,1,-194,-1.5,105,8.0,100,-120,174,1.5,-125,5.28,Guaranteed Rate Field,4,2
2015-08-16,2015,LAD,CIN,2,1,-235,-1.5,-110,7.5,-115,-105,205,1.5,-110,5.26,Dodger Stadium,3,1
2015-08-16,2015,MIN,CLE,4,1,125,1.5,-140,7.5,105,-125,-140,-1.5,120,3.33,Target Field,5,3
2015-08-16,2015,SD,COL,0,5,105,1.5,-180,11.0,-120,100,-115,-1.5,160,5.37,Coors Field,5,-5
2015-08-16,2015,CHC,CWS,1,3,174,1.5,-125,8.0,100,-120,-194,-1.5,105,2.92,Guaranteed Rate Field,4,-2
2015-08-16,2015,HOU,DET,6,5,-175,-1.5,120,7.5,-120,100,155,1.5,-140,4.77,Minute Maid Park,11,1
2015-08-16,2015,DET,HOU,5,6,155,1.5,-140,7.5,-120,100,-175,-1.5,120,2.94,Minute Maid Park,11,-1
2015-08-16,2015,LAA,KC,3,4,119,1.5,-175,8.5,-115,-105,-134,-1.5,155,3.88,Kauffman Stadium,7,-1
2015-08-16,2015,KC,LAA,4,3,-134,-1.5,155,8.5,-115,-105,119,1.5,-175,4.87,Kauffman Stadium,7,1
2015-08-16,2015,CIN,LAD,1,2,205,1.5,-110,7.5,-115,-105,-235,-1.5,-110,2.46,Dodger Stadium,3,-1
2015-08-16,2015,STL,MIA,4,6,-245,-1.5,-117,6.5,-125,105,205,1.5,-103,4.62,Busch Stadium,10,-2
2015-08-16,2015,PHI,MIL,1,6,156,1.5,-135,8.5,-110,-110,-176,-1.5,115,3.32,Miller Park,7,-5
2015-08-16,2015,CLE,MIN,1,4,-140,-1.5,120,7.5,105,-125,125,1.5,-140,4.38,Target Field,5,-3
2015-08-16,2015,PIT,NYM,8,1,144,1.5,-150,7.0,-110,-110,-159,-1.5,130,2.87,Citi Field,9,7
2015-08-16,2015,TOR,NYY,3,1,-117,-1.5,170,9.0,105,-125,107,1.5,-200,4.85,Rogers Centre,4,2
2015-08-16,2015,BAL,OAK,18,2,-173,-1.5,120,8.5,-105,-115,153,1.5,-140,5.39,Camden Yards,20,16
2015-08-16,2015,MIL,PHI,6,1,-176,-1.5,115,8.5,-110,-110,156,1.5,-135,5.42,Miller Park,7,5
2015-08-16,2015,NYM,PIT,1,8,-159,-1.5,130,7.0,-110,-110,144,1.5,-150,4.3,Citi Field,9,-7
2015-08-16,2015,COL,SD,5,0,-115,-1.5,160,11.0,-120,100,105,1.5,-180,5.88,Coors Field,5,5
2015-08-16,2015,BOS,SEA,8,10,-119,-1.5,170,9.0,-102,-118,109,1.5,-200,4.89,Fenway Park,18,-2
2015-08-16,2015,WSH,SF,0,5,137,1.5,-175,7.0,-110,-110,-152,-1.5,155,2.95,AT&T Park,5,-5
2015-08-16,2015,MIA,STL,6,4,205,1.5,-103,6.5,-125,105,-245,-1.5,-117,2.13,Busch Stadium,10,2
2015-08-16,2015,TEX,TB,5,3,-117,-1.5,175,8.5,-120,100,107,1.5,-205,4.58,Rangers Ballpark,8,2
2015-08-16,2015,TB,TEX,3,5,107,1.5,-205,8.5,-120,100,-117,-1.5,175,4.11,Rangers Ballpark,8,-2
2015-08-16,2015,NYY,TOR,1,3,107,1.5,-200,9.0,105,-125,-117,-1.5,170,4.35,Rogers Centre,4,-2
2015-08-16,2015,SF,WSH,5,0,-152,-1.5,155,7.0,-110,-110,137,1.5,-175,4.22,AT&T Park,5,5
2015-08-17,2015,PIT,ARI,1,4,-210,-1.5,-104,7.5,-105,-115,180,1.5,-116,5.08,PNC Park,5,-3
2015-08-17,2015,SD,ATL,5,3,-155,-1.5,140,7.0,-130,110,140,1.5,-160,4.25,PETCO Park,8,2
2015-08-17,2015,OAK,BAL,2,4,-104,1.5,-230,7.5,-105,-115,-106,-1.5,190,3.82,Camden Yards,6,-2
2015-08-17,2015,CLE,BOS,8,2,-115,-1.5,140,9.0,-130,110,105,1.5,-160,4.81,Fenway Park,10,6
2015-08-17,2015,BOS,CLE,2,8,105,1.5,-160,9.0,-130,110,-115,-1.5,140,4.39,Fenway Park,10,-6
2015-08-17,2015,LAA,CWS,2,1,-159,-1.5,135,7.5,-110,-110,144,1.5,-155,4.6,Angel Stadium,3,1
2015-08-17,2015,TB,HOU,9,2,147,1.5,-150,7.5,-105,-115,-162,-1.5,130,3.04,Minute Maid Park,11,7
2015-08-17,2015,CWS,LAA,1,2,144,1.5,-155,7.5,-110,-110,-159,-1.5,135,3.07,Angel Stadium,3,-1
2015-08-17,2015,MIL,MIA,2,6,-151,-1.5,140,8.0,-115,-105,136,1.5,-160,4.81,Miller Park,8,-4
2015-08-17,2015,MIA,MIL,6,2,136,1.5,-160,8.0,-115,-105,-151,-1.5,140,3.39,Miller Park,8,4
2015-08-17,2015,NYY,MIN,8,7,-151,-1.5,125,9.0,-120,100,136,1.5,-145,5.41,Yankee Stadium,15,1
2015-08-17,2015,MIN,NYY,7,8,136,1.5,-145,9.0,-120,100,-151,-1.5,125,3.81,Yankee Stadium,15,-1
2015-08-17,2015,BAL,OAK,4,2,-106,-1.5,190,7.5,-105,-115,-104,1.5,-230,3.86,Camden Yards,6,2
2015-08-17,2015,ARI,PIT,4,1,180,1.5,-116,7.5,-105,-115,-210,-1.5,-104,2.68,PNC Park,5,3
2015-08-17,2015,ATL,SD,3,5,140,1.5,-160,7.0,-130,110,-155,-1.5,140,2.92,PETCO Park,8,-2
2015-08-17,2015,TEX,SEA,4,3,-152,-1.5,140,8.5,-120,100,137,1.5,-160,5.13,Rangers Ballpark,7,1
2015-08-17,2015,STL,SF,2,1,-178,-1.5,125,6.5,-120,100,158,1.5,-145,4.16,Busch Stadium,3,1
2015-08-17,2015,SF,STL,1,2,158,1.5,-145,6.5,-120,100,-178,-1.5,125,2.52,Busch Stadium,3,-1
2015-08-17,2015,HOU,TB,2,9,-162,-1.5,130,7.5,-105,-115,147,1.5,-150,4.64,Minute Maid Park,11,-7
2015-08-17,2015,SEA,TEX,3,4,137,1.5,-160,8.5,-120,100,-152,-1.5,140,3.59,Rangers Ballpark,7,-1
2015-08-18,2015,PIT,ARI,9,8,-200,-1.5,110,7.0,-125,105,170,1.5,-130,4.67,PNC Park,17,1
2015-08-18,2015,SD,ATL,9,0,-187,-1.5,120,7.0,100,-120,167,1.5,-140,4.56,PETCO Park,9,9
2015-08-18,2015,NYM,BAL,5,3,-105,-1.5,145,7.5,110,-130,-105,1.5,-165,3.84,Camden Yards,8,2
2015-08-18,2015,CLE,BOS,1,9,116,1.5,-165,9.5,-110,-110,-131,-1.5,145,4.4,Fenway Park,10,-8
2015-08-18,2015,DET,CHC,10,8,143,1.5,-150,8.5,-120,100,-158,-1.5,130,3.5,Wrigley Field,18,2
2015-08-18,2015,KC,CIN,3,1,110,1.5,-205,7.5,-105,-115,-120,-1.5,175,3.57,Great American Ballpark,4,2
2015-08-18,2015,BOS,CLE,9,1,-131,-1.5,145,9.5,-110,-110,116,1.5,-165,5.39,Fenway Park,10,8
2015-08-18,2015,WSH,COL,15,6,-165,-1.5,100,9.5,-105,-115,150,1.5,-120,5.92,Coors Field,21,9
2015-08-18,2015,LAA,CWS,5,3,-200,-1.5,100,7.0,100,-120,170,1.5,-120,4.67,Angel Stadium,8,2
2015-08-18,2015,CHC,DET,8,10,-158,-1.5,130,8.5,-120,100,143,1.5,-150,5.21,Wrigley Field,18,-2
2015-08-18,2015,TB,HOU,2,3,104,1.5,-200,8.0,-105,-115,-114,-1.5,170,3.92,Minute Maid Park,5,-1
2015-08-18,2015,CIN,KC,1,3,-120,-1.5,175,7.5,-105,-115,110,1.5,-205,4.09,Great American Ballpark,4,-2
2015-08-18,2015,CWS,LAA,3,5,170,1.5,-120,7.0,100,-120,-200,-1.5,100,2.59,Angel Stadium,8,-2
2015-08-18,2015,OAK,LAD,5,4,210,1.5,130,6.5,-105,-115,-250,-1.5,-151,2.1,Oakland Coliseum,9,1
2015-08-18,2015,MIL,MIA,6,9,-147,-1.5,145,8.0,100,-120,132,1.5,-165,4.76,Miller Park,15,-3
2015-08-18,2015,MIA,MIL,9,6,132,1.5,-165,8.0,100,-120,-147,-1.5,145,3.45,Miller Park,15,3
2015-08-18,2015,NYY,MIN,8,4,-147,-1.5,125,9.5,-110,-110,132,1.5,-145,5.65,Yankee Stadium,12,4
2015-08-18,2015,BAL,NYM,3,5,-105,1.5,-165,7.5,110,-130,-105,-1.5,145,3.84,Camden Yards,8,-2
2015-08-18,2015,MIN,NYY,4,8,132,1.5,-145,9.5,-110,-110,-147,-1.5,125,4.09,Yankee Stadium,12,-4
2015-08-18,2015,LAD,OAK,4,5,-250,-1.5,-151,6.5,-105,-115,210,1.5,130,4.64,Oakland Coliseum,9,-1
2015-08-18,2015,TOR,PHI,8,5,-164,-1.5,-105,8.0,-120,100,149,1.5,-115,4.97,Citizens Bank Park,13,3
2015-08-18,2015,ARI,PIT,8,9,170,1.5,-130,7.0,-125,105,-200,-1.5,110,2.59,PNC Park,17,-1
2015-08-18,2015,ATL,SD,0,9,167,1.5,-140,7.0,100,-120,-187,-1.5,120,2.62,PETCO Park,9,-9
2015-08-18,2015,TEX,SEA,2,3,126,1.5,-135,9.5,-120,100,-141,-1.5,115,4.2,Rangers Ballpark,5,-1
2015-08-18,2015,STL,SF,0,2,-144,-1.5,150,7.0,-105,-115,129,1.5,-170,4.13,Busch Stadium,2,-2
2015-08-18,2015,SF,STL,2,0,129,1.5,-170,7.0,-105,-115,-144,-1.5,150,3.06,Busch Stadium,2,2
2015-08-18,2015,HOU,TB,3,2,-114,-1.5,170,8.0,-105,-115,104,1.5,-200,4.26,Minute Maid Park,5,1
2015-08-18,2015,SEA,TEX,3,2,-141,-1.5,115,9.5,-120,100,126,1.5,-135,5.56,Rangers Ballpark,5,1
2015-08-18,2015,PHI,TOR,5,8,149,1.5,-115,8.0,-120,100,-164,-1.5,-105,3.21,Citizens Bank Park,13,-3
2015-08-18,2015,COL,WSH,6,15,150,1.5,-120,9.5,-105,-115,-165,-1.5,100,3.8,Coors Field,21,-9
2015-08-19,2015,PIT,ARI,4,1,-129,-1.5,165,8.0,-105,-115,119,1.5,-185,4.51,PNC Park,5,3
2015-08-19,2015,SD,ATL,3,2,-156,-1.5,145,6.5,-125,105,141,1.5,-165,3.96,PETCO Park,5,1
2015-08-19,2015,NYM,BAL,4,5,126,1.5,-175,8.0,-120,100,-141,-1.5,155,3.54,Camden Yards,9,-1
2015-08-19,2015,CLE,BOS,4,6,-141,-1.5,111,9.0,100,-120,126,1.5,-131,5.27,Fenway Park,10,-2
2015-08-19,2015,DET,CHC,15,8,171,1.5,-130,9.0,-110,-110,-191,-1.5,110,3.32,Wrigley Field,23,7
2015-08-19,2015,KC,CIN,4,3,-118,-1.5,140,8.5,100,-120,108,1.5,-160,4.6,Great American Ballpark,7,1
2015-08-19,2015,BOS,CLE,6,4,126,1.5,-131,9.0,100,-120,-141,-1.5,111,3.98,Fenway Park,10,2
2015-08-19,2015,WSH,COL,4,1,-152,-1.5,105,9.5,-105,-115,137,1.5,-125,5.73,Coors Field,5,3
2015-08-19,2015,LAA,CWS,1,0,-118,-1.5,180,7.5,-116,-104,108,1.5,-210,4.06,Angel Stadium,1,1
2015-08-19,2015,CHC,DET,8,15,-191,-1.5,110,9.0,-110,-110,171,1.5,-130,5.91,Wrigley Field,23,-7
2015-08-19,2015,TB,HOU,2,3,170,1.5,-135,7.0,-120,100,-200,-1.5,115,2.59,Minute Maid Park,5,-1
2015-08-19,2015,CIN,KC,3,4,108,1.5,-160,8.5,100,-120,-118,-1.5,140,4.09,Great American Ballpark,7,-1
2015-08-19,2015,CWS,LAA,0,1,108,1.5,-210,7.5,-116,-104,-118,-1.5,180,3.61,Angel Stadium,1,-1
2015-08-19,2015,OAK,LAD,5,2,108,1.5,-160,8.0,-105,-115,-118,-1.5,140,3.85,Oakland Coliseum,7,3
2015-08-19,2015,MIL,MIA,8,7,-142,-1.5,155,8.0,-115,-105,127,1.5,-175,4.69,Miller Park,15,1
2015-08-19,2015,MIA,MIL,7,8,127,1.5,-175,8.0,-115,-105,-142,-1.5,155,3.52,Miller Park,15,-1
2015-08-19,2015,NYY,MIN,4,3,-177,-1.5,109,8.5,-123,103,157,1.5,-129,5.43,Yankee Stadium,7,1
2015-08-19,2015,BAL,NYM,5,4,-141,-1.5,155,8.0,-120,100,126,1.5,-175,4.68,Camden Yards,9,1
2015-08-19,2015,MIN,NYY,3,4,157,1.5,-129,8.5,-123,103,-177,-1.5,109,3.31,Yankee Stadium,7,-1
2015-08-19,2015,LAD,OAK,2,5,-118,-1.5,140,8.0,-105,-115,108,1.5,-160,4.33,Oakland Coliseum,7,-3
2015-08-19,2015,TOR,PHI,4,7,-251,-1.5,-150,9.0,105,-125,211,1.5,130,6.44,Citizens Bank Park,11,-3
2015-08-19,2015,ARI,PIT,1,4,119,1.5,-185,8.0,-105,-115,-129,-1.5,165,3.65,PNC Park,5,-3
2015-08-19,2015,ATL,SD,2,3,141,1.5,-165,6.5,-125,105,-156,-1.5,145,2.7,PETCO Park,5,-1
2015-08-19,2015,TEX,SEA,7,2,-146,-1.5,140,9.0,100,-120,131,1.5,-160,5.34,Rangers Ballpark,9,5
2015-08-19,2015,STL,SF,4,3,-170,-1.5,135,7.0,104,-124,150,1.5,-155,4.41,Busch Stadium,7,1
2015-08-19,2015,SF,STL,3,4,150,1.5,-155,7.0,104,-124,-170,-1.5,135,2.8,Busch Stadium,7,-1
2015-08-19,2015,HOU,TB,3,2,-200,-1.5,115,7.0,-120,100,170,1.5,-135,4.67,Minute Maid Park,5,1
2015-08-19,2015,SEA,TEX,2,7,131,1.5,-160,9.0,100,-120,-146,-1.5,140,3.9,Rangers Ballpark,9,-5
2015-08-19,2015,PHI,TOR,7,4,211,1.5,130,9.0,105,-125,-251,-1.5,-150,2.89,Citizens Bank Park,11,3
2015-08-19,2015,COL,WSH,1,4,137,1.5,-125,9.5,-105,-115,-152,-1.5,105,4.01,Coors Field,5,-3
2015-08-20,2015,CIN,ARI,4,5,118,1.5,-145,7.5,-105,-115,-128,-1.5,125,3.44,Great American Ballpark,9,-1
2015-08-20,2015,CHC,ATL,7,1,-310,-1.5,-150,8.0,-119,-101,260,1.5,130,6.05,Wrigley Field,8,6
2015-08-20,2015,MIN,BAL,15,2,155,1.5,-140,9.0,-105,-115,-175,-1.5,120,3.53,Camden Yards,17,13
2015-08-20,2015,KC,BOS,1,4,-104,1.5,-210,9.0,-110,-110,-106,-1.5,179,4.59,Fenway Park,5,-3
2015-08-20,2015,ATL,CHC,1,7,260,1.5,130,8.0,-119,-101,-310,-1.5,-150,2.22,Wrigley Field,8,-6
2015-08-20,2015,ARI,CIN,5,4,-128,-1.5,125,7.5,-105,-115,118,1.5,-145,4.21,Great American Ballpark,9,1
2015-08-20,2015,NYY,CLE,2,3,-155,-1.5,135,8.5,-115,-105,140,1.5,-155,5.17,Yankee Stadium,5,-1
2015-08-20,2015,WSH,COL,2,3,-205,-1.5,-135,10.5,-125,105,175,1.5,115,7.06,Coors Field,5,-1
2015-08-20,2015,LAA,CWS,2,8,-123,-1.5,169,7.5,-102,-118,113,1.5,-199,4.14,Angel Stadium,10,-6
2015-08-20,2015,TEX,DET,0,4,-104,1.5,-210,9.5,-115,-105,-106,-1.5,180,4.84,Comerica Park,4,-4
2015-08-20,2015,TB,HOU,1,0,102,1.5,-230,7.0,-105,-115,-112,-1.5,190,3.47,Minute Maid Park,1,1
2015-08-20,2015,BOS,KC,4,1,-106,-1.5,179,9.0,-110,-110,-104,1.5,-210,4.63,Fenway Park,5,3
2015-08-20,2015,CWS,LAA,8,2,113,1.5,-199,7.5,-102,-118,-123,-1.5,169,3.52,Angel Stadium,10,6
2015-08-20,2015,PHI,MIA,7,9,140,1.5,-155,7.5,100,-120,-155,-1.5,135,3.13,Marlins Park,16,-2
2015-08-20,2015,BAL,MIN,2,15,-175,-1.5,120,9.0,-105,-115,155,1.5,-140,5.73,Camden Yards,17,-13
2015-08-20,2015,CLE,NYY,3,2,140,1.5,-155,8.5,-115,-105,-155,-1.5,135,3.54,Yankee Stadium,5,1
2015-08-20,2015,MIA,PHI,9,7,-155,-1.5,135,7.5,100,-120,140,1.5,-155,4.56,Marlins Park,16,2
2015-08-20,2015,SF,PIT,0,4,119,1.5,-180,8.0,-106,-114,-134,-1.5,160,3.65,PNC Park,4,-4
2015-08-20,2015,PIT,SF,4,0,-134,-1.5,160,8.0,-106,-114,119,1.5,-180,4.58,PNC Park,4,4
2015-08-20,2015,HOU,TB,0,1,-112,-1.5,190,7.0,-105,-115,102,1.5,-230,3.7,Minute Maid Park,1,-1
2015-08-20,2015,DET,TEX,4,0,-106,-1.5,180,9.5,-115,-105,-104,1.5,-210,4.89,Comerica Park,4,4
2015-08-20,2015,COL,WSH,3,2,175,1.5,115,10.5,-125,105,-205,-1.5,-135,3.82,Coors Field,5,1
2015-08-21,2015,CIN,ARI,3,6,136,1.5,-125,8.5,-121,101,-151,-1.5,105,3.6,Great American Ballpark,9,-3
2015-08-21,2015,CHC,ATL,5,3,-171,-1.5,110,9.0,100,-120,151,1.5,-130,5.68,Wrigley Field,8,2
2015-08-21,2015,MIN,BAL,4,3,150,1.5,-145,8.5,-105,-115,-170,-1.5,125,3.4,Camden Yards,7,1
2015-08-21,2015,KC,BOS,2,7,-150,-1.5,105,8.5,-110,-110,135,1.5,-125,5.1,Fenway Park,9,-5
2015-08-21,2015,ATL,CHC,3,5,151,1.5,-130,9.0,100,-120,-171,-1.5,110,3.59,Wrigley Field,8,-2
2015-08-21,2015,ARI,CIN,6,3,-151,-1.5,105,8.5,-121,101,136,1.5,-125,5.11,Great American Ballpark,9,3
2015-08-21,2015,NYY,CLE,3,7,-131,-1.5,170,7.0,-115,-105,116,1.5,-200,3.97,Yankee Stadium,10,-4
2015-08-21,2015,NYM,COL,14,9,-109,-1.5,140,11.0,100,-120,-101,1.5,-160,5.74,Coors Field,23,5
2015-08-21,2015,SEA,CWS,4,11,-104,1.5,-175,5.5,-110,-110,-106,-1.5,155,2.8,T-Mobile Park,15,-7
2015-08-21,2015,TEX,DET,2,0,115,1.5,-200,8.5,-115,-105,-125,-1.5,170,3.95,Comerica Park,2,2
2015-08-21,2015,LAD,HOU,0,3,111,1.5,-200,8.0,-111,-109,-121,-1.5,170,3.79,Minute Maid Park,3,-3
2015-08-21,2015,BOS,KC,7,2,135,1.5,-125,8.5,-110,-110,-150,-1.5,105,3.62,Fenway Park,9,5
2015-08-21,2015,TOR,LAA,9,2,-184,-1.5,-117,7.0,-106,-114,164,1.5,-103,4.54,Angel Stadium,11,7
2015-08-21,2015,HOU,LAD,3,0,-121,-1.5,170,8.0,-111,-109,111,1.5,-200,4.38,Minute Maid Park,3,3
2015-08-21,2015,PHI,MIA,7,1,125,1.5,-175,7.5,106,-126,-140,-1.5,155,3.33,Marlins Park,8,6
2015-08-21,2015,WSH,MIL,3,10,-150,-1.5,145,7.0,100,-120,135,1.5,-165,4.2,Nationals Park,13,-7
2015-08-21,2015,BAL,MIN,3,4,-170,-1.5,125,8.5,-105,-115,150,1.5,-145,5.35,Camden Yards,7,-1
2015-08-21,2015,COL,NYM,9,14,-101,1.5,-160,11.0,100,-120,-109,-1.5,140,5.53,Coors Field,23,-5
2015-08-21,2015,CLE,NYY,7,3,116,1.5,-200,7.0,-115,-105,-131,-1.5,170,3.24,Yankee Stadium,10,4
2015-08-21,2015,TB,OAK,2,1,116,1.5,-205,7.0,104,-124,-126,-1.5,175,3.24,Oakland Coliseum,3,1
2015-08-21,2015,MIA,PHI,1,7,-140,-1.5,155,7.5,106,-126,125,1.5,-175,4.38,Marlins Park,8,-6
2015-08-21,2015,SF,PIT,6,4,-125,-1.5,130,6.5,-125,105,115,1.5,-150,3.61,PNC Park,10,2
2015-08-21,2015,STL,SD,3,9,-113,-1.5,135,6.5,-120,100,103,1.5,-155,3.45,PETCO Park,12,-6
2015-08-21,2015,CWS,SEA,11,4,-106,-1.5,155,5.5,-110,-110,-104,1.5,-175,2.83,T-Mobile Park,15,7
2015-08-21,2015,PIT,SF,4,6,115,1.5,-150,6.5,-125,105,-125,-1.5,130,3.02,PNC Park,10,-2
2015-08-21,2015,SD,STL,9,3,103,1.5,-155,6.5,-120,100,-113,-1.5,135,3.2,PETCO Park,12,6
2015-08-21,2015,OAK,TB,1,2,-126,-1.5,175,7.0,104,-124,116,1.5,-205,3.9,Oakland Coliseum,3,-1
2015-08-21,2015,DET,TEX,0,2,-125,-1.5,170,8.5,-115,-105,115,1.5,-200,4.72,Comerica Park,2,-2
2015-08-21,2015,LAA,TOR,2,9,164,1.5,-103,7.0,-106,-114,-184,-1.5,-117,2.65,Angel Stadium,11,-7
2015-08-21,2015,MIL,WSH,10,3,135,1.5,-165,7.0,100,-120,-150,-1.5,145,2.98,Nationals Park,13,7
2015-08-22,2015,CIN,ARI,7,11,-116,-1.5,175,8.0,100,-120,106,1.5,-205,4.3,Great American Ballpark,18,-4
2015-08-22,2015,CHC,ATL,9,7,-205,-1.5,-105,9.5,-101,-119,175,1.5,-115,6.39,Wrigley Field,16,2
2015-08-22,2015,MIN,BAL,3,2,139,1.5,-150,8.5,-110,-110,-154,-1.5,130,3.56,Camden Yards,5,1
2015-08-22,2015,KC,BOS,6,3,-141,-1.5,110,9.0,100,-120,126,1.5,-130,5.27,Fenway Park,9,3
2015-08-22,2015,ATL,CHC,7,9,175,1.5,-115,9.5,-101,-119,-205,-1.5,-105,3.45,Wrigley Field,16,-2
2015-08-22,2015,ARI,CIN,11,7,106,1.5,-205,8.0,100,-120,-116,-1.5,175,3.88,Great American Ballpark,18,4
2015-08-22,2015,NYY,CLE,6,2,-146,-1.5,160,7.5,100,-120,131,1.5,-180,4.45,Yankee Stadium,8,4
2015-08-22,2015,NYM,COL,14,9,-115,-1.5,135,11.0,-120,100,105,1.5,-155,5.88,Coors Field,23,5
2015-08-22,2015,SEA,CWS,3,6,-104,1.5,-175,7.0,-125,105,-106,-1.5,155,3.57,T-Mobile Park,9,-3
2015-08-22,2015,TEX,DET,5,3,-103,1.5,-215,9.0,-119,-101,-107,-1.5,185,4.57,Comerica Park,8,2
2015-08-22,2015,LAD,HOU,1,3,-125,-1.5,130,7.0,-110,-110,115,1.5,-150,3.89,Minute Maid Park,4,-2
2015-08-22,2015,BOS,KC,3,6,126,1.5,-130,9.0,100,-120,-141,-1.5,110,3.98,Fenway Park,9,-3
2015-08-22,2015,TOR,LAA,15,3,-125,-1.5,130,8.5,100,-120,115,1.5,-150,4.72,Angel Stadium,18,12
2015-08-22,2015,HOU,LAD,3,1,115,1.5,-150,7.0,-110,-110,-125,-1.5,130,3.26,Minute Maid Park,4,2
2015-08-22,2015,PHI,MIA,4,2,117,1.5,-185,8.0,-115,-105,-127,-1.5,165,3.69,Marlins Park,6,2
2015-08-22,2015,WSH,MIL,6,1,-154,-1.5,145,7.0,-120,100,139,1.5,-165,4.24,Nationals Park,7,5
2015-08-22,2015,BAL,MIN,2,3,-154,-1.5,130,8.5,-110,-110,139,1.5,-150,5.15,Camden Yards,5,-1
2015-08-22,2015,COL,NYM,9,14,105,1.5,-155,11.0,-120,100,-115,-1.5,135,5.37,Coors Field,23,-5
2015-08-22,2015,CLE,NYY,2,6,131,1.5,-180,7.5,100,-120,-146,-1.5,160,3.25,Yankee Stadium,8,-4
2015-08-22,2015,TB,OAK,5,4,136,1.5,-170,6.5,-120,100,-151,-1.5,150,2.75,Oakland Coliseum,9,1
2015-08-22,2015,MIA,PHI,2,4,-127,-1.5,165,8.0,-115,-105,117,1.5,-185,4.48,Marlins Park,6,-2
2015-08-22,2015,SF,PIT,2,3,148,1.5,-140,7.0,-120,100,-163,-1.5,120,2.82,PNC Park,5,-1
2015-08-22,2015,STL,SD,0,8,-134,-1.5,130,6.5,-115,-105,119,1.5,-150,3.72,PETCO Park,8,-8
2015-08-22,2015,CWS,SEA,6,3,-106,-1.5,155,7.0,-125,105,-104,1.5,-175,3.6,T-Mobile Park,9,3
2015-08-22,2015,PIT,SF,3,2,-163,-1.5,120,7.0,-120,100,148,1.5,-140,4.34,PNC Park,5,1
2015-08-22,2015,SD,STL,8,0,119,1.5,-150,6.5,-115,-105,-134,-1.5,130,2.97,PETCO Park,8,8
2015-08-22,2015,OAK,TB,4,5,-151,-1.5,150,6.5,-120,100,136,1.5,-170,3.91,Oakland Coliseum,9,-1
2015-08-22,2015,DET,TEX,3,5,-107,-1.5,185,9.0,-119,-101,-103,1.5,-215,4.65,Comerica Park,8,-2
2015-08-22,2015,LAA,TOR,3,15,115,1.5,-150,8.5,100,-120,-125,-1.5,130,3.95,Angel Stadium,18,-12
2015-08-22,2015,MIL,WSH,1,6,139,1.5,-165,7.0,-120,100,-154,-1.5,145,2.93,Nationals Park,7,-5
2015-08-23,2015,CIN,ARI,0,4,-112,-1.5,180,8.0,-105,-115,102,1.5,-210,4.23,Great American Ballpark,4,-4
2015-08-23,2015,CHC,ATL,9,3,-220,-1.5,-110,10.0,-105,-115,190,1.5,-110,6.88,Wrigley Field,12,6
2015-08-23,2015,MIN,BAL,4,3,151,1.5,-140,9.0,-108,-112,-171,-1.5,120,3.59,Camden Yards,7,1
2015-08-23,2015,KC,BOS,8,6,107,1.5,-200,8.5,-108,-112,-117,-1.5,170,4.11,Fenway Park,14,2
2015-08-23,2015,ATL,CHC,3,9,190,1.5,-110,10.0,-105,-115,-220,-1.5,-110,3.45,Wrigley Field,12,-6
2015-08-23,2015,ARI,CIN,4,0,102,1.5,-210,8.0,-105,-115,-112,-1.5,180,3.96,Great American Ballpark,4,4
2015-08-23,2015,NYY,CLE,3,4,-150,-1.5,135,8.5,-125,105,135,1.5,-155,5.1,Yankee Stadium,7,-1
2015-08-23,2015,NYM,COL,5,1,-125,-1.5,120,11.5,-105,-115,115,1.5,-140,6.39,Coors Field,6,4
2015-08-23,2015,SEA,CWS,8,6,-145,-1.5,155,7.5,-119,-101,130,1.5,-175,4.44,T-Mobile Park,14,2
2015-08-23,2015,TEX,DET,4,2,-125,-1.5,120,9.0,105,-125,115,1.5,-140,5.0,Comerica Park,6,2
2015-08-23,2015,LAD,HOU,2,3,-153,-1.5,110,6.5,-110,-110,138,1.5,-130,3.93,Minute Maid Park,5,-1
2015-08-23,2015,BOS,KC,6,8,-117,-1.5,170,8.5,-108,-112,107,1.5,-200,4.58,Fenway Park,14,-2
2015-08-23,2015,TOR,LAA,12,5,107,1.5,-210,8.5,100,-120,-117,-1.5,180,4.11,Angel Stadium,17,7
2015-08-23,2015,HOU,LAD,3,2,138,1.5,-130,6.5,-110,-110,-153,-1.5,110,2.73,Minute Maid Park,5,1
2015-08-23,2015,PHI,MIA,2,0,118,1.5,-200,7.5,-105,-115,-128,-1.5,170,3.44,Marlins Park,2,2
2015-08-23,2015,WSH,MIL,9,5,-190,-1.5,110,7.5,-110,-110,170,1.5,-130,4.91,Nationals Park,14,4
2015-08-23,2015,BAL,MIN,3,4,-171,-1.5,120,9.0,-108,-112,151,1.5,-140,5.68,Camden Yards,7,-1
2015-08-23,2015,COL,NYM,1,5,115,1.5,-140,11.5,-105,-115,-125,-1.5,120,5.35,Coors Field,6,-4
2015-08-23,2015,CLE,NYY,4,3,135,1.5,-155,8.5,-125,105,-150,-1.5,135,3.62,Yankee Stadium,7,1
2015-08-23,2015,TB,OAK,2,8,-115,-1.5,135,7.5,104,-124,105,1.5,-155,4.01,Oakland Coliseum,10,-6
2015-08-23,2015,MIA,PHI,0,2,-128,-1.5,170,7.5,-105,-115,118,1.5,-200,4.21,Marlins Park,2,-2
2015-08-23,2015,SF,PIT,2,5,162,1.5,-134,7.0,-120,100,-182,-1.5,114,2.67,PNC Park,7,-3
2015-08-23,2015,STL,SD,10,3,-155,-1.5,110,7.0,-101,-119,140,1.5,-130,4.25,PETCO Park,13,7
2015-08-23,2015,CWS,SEA,6,8,130,1.5,-175,7.5,-119,-101,-145,-1.5,155,3.26,T-Mobile Park,14,-2
2015-08-23,2015,PIT,SF,5,2,-182,-1.5,114,7.0,-120,100,162,1.5,-134,4.52,PNC Park,7,3
2015-08-23,2015,SD,STL,3,10,140,1.5,-130,7.0,-101,-119,-155,-1.5,110,2.92,PETCO Park,13,-7
2015-08-23,2015,OAK,TB,8,2,105,1.5,-155,7.5,104,-124,-115,-1.5,135,3.66,Oakland Coliseum,10,6
2015-08-23,2015,DET,TEX,2,4,115,1.5,-140,9.0,105,-125,-125,-1.5,120,4.19,Comerica Park,6,-2
2015-08-23,2015,LAA,TOR,5,12,-117,-1.5,180,8.5,100,-120,107,1.5,-210,4.58,Angel Stadium,17,-7
2015-08-23,2015,MIL,WSH,5,9,170,1.5,-130,7.5,-110,-110,-190,-1.5,110,2.78,Nationals Park,14,-4
2015-08-24,2015,STL,ARI,5,3,-116,-1.5,147,8.0,-122,102,106,1.5,-168,4.3,Chase Field,8,2
2015-08-24,2015,COL,ATL,3,5,-101,1.5,-235,7.0,-120,100,-109,-1.5,195,3.52,Turner Field,8,-2
2015-08-24,2015,KC,BAL,8,3,-125,-1.5,165,7.0,-120,100,115,1.5,-195,3.89,Kauffman Stadium,11,5
2015-08-24,2015,CWS,BOS,4,5,-125,-1.5,160,8.5,-115,-105,115,1.5,-190,4.72,Guaranteed Rate Field,9,-1
2015-08-24,2015,CLE,CHC,1,2,115,1.5,-200,8.0,-110,-110,-125,-1.5,170,3.72,Wrigley Field,3,-1
2015-08-24,2015,DET,CIN,5,12,107,1.5,-195,9.0,100,-120,-117,-1.5,165,4.35,Great American Ballpark,17,-7
2015-08-24,2015,CHC,CLE,2,1,-125,-1.5,170,8.0,-110,-110,115,1.5,-200,4.44,Wrigley Field,3,1
2015-08-24,2015,ATL,COL,5,3,-109,-1.5,195,7.0,-120,100,-101,1.5,-235,3.65,Turner Field,8,2
2015-08-24,2015,BOS,CWS,5,4,115,1.5,-190,8.5,-115,-105,-125,-1.5,160,3.95,Guaranteed Rate Field,9,1
2015-08-24,2015,CIN,DET,12,5,-117,-1.5,165,9.0,100,-120,107,1.5,-195,4.85,Great American Ballpark,17,7
2015-08-24,2015,NYY,HOU,1,0,-160,-1.5,125,8.5,-105,-115,145,1.5,-145,5.23,Yankee Stadium,1,1
2015-08-24,2015,BAL,KC,3,8,115,1.5,-195,7.0,-120,100,-125,-1.5,165,3.26,Kauffman Stadium,11,-5
2015-08-24,2015,PIT,MIA,5,2,-144,-1.5,120,8.0,-120,100,129,1.5,-140,4.72,Marlins Park,7,3
2015-08-24,2015,PHI,NYM,7,16,212,1.5,120,7.5,-115,-105,-252,-1.5,-140,2.4,Citizens Bank Park,23,-9
2015-08-24,2015,HOU,NYY,0,1,145,1.5,-145,8.5,-105,-115,-160,-1.5,125,3.47,Yankee Stadium,1,-1
2015-08-24,2015,SEA,OAK,5,11,-154,-1.5,130,7.0,-112,-108,139,1.5,-150,4.24,T-Mobile Park,16,-6
2015-08-24,2015,NYM,PHI,16,7,-252,-1.5,-140,7.5,-115,-105,212,1.5,120,5.37,Citizens Bank Park,23,9
2015-08-24,2015,MIA,PIT,2,5,129,1.5,-140,8.0,-120,100,-144,-1.5,120,3.49,Marlins Park,7,-3
2015-08-24,2015,OAK,SEA,11,5,139,1.5,-150,7.0,-112,-108,-154,-1.5,130,2.93,T-Mobile Park,16,6
2015-08-24,2015,ARI,STL,3,5,106,1.5,-168,8.0,-122,102,-116,-1.5,147,3.88,Chase Field,8,-2
2015-08-25,2015,STL,ARI,9,1,-124,-1.5,135,7.5,-115,-105,114,1.5,-155,4.15,Chase Field,10,8
2015-08-25,2015,COL,ATL,5,1,-102,1.5,-215,8.0,-110,-110,-108,-1.5,185,4.04,Turner Field,6,4
2015-08-25,2015,KC,BAL,3,2,-120,-1.5,175,8.0,-105,-115,110,1.5,-205,4.36,Kauffman Stadium,5,1
2015-08-25,2015,CWS,BOS,5,4,-132,-1.5,160,7.5,-104,-116,117,1.5,-190,4.27,Guaranteed Rate Field,9,1
2015-08-25,2015,SF,CHC,5,8,130,1.5,-130,6.5,-120,100,-145,-1.5,110,2.83,AT&T Park,13,-3
2015-08-25,2015,LAD,CIN,5,1,-125,-1.5,130,8.0,105,-125,115,1.5,-150,4.44,Great American Ballpark,6,4
2015-08-25,2015,MIL,CLE,6,11,148,1.5,-145,8.0,100,-120,-163,-1.5,125,3.23,Progressive Field,17,-5
2015-08-25,2015,ATL,COL,1,5,-108,-1.5,185,8.0,-110,-110,-102,1.5,-215,4.15,Turner Field,6,-4
2015-08-25,2015,BOS,CWS,4,5,117,1.5,-190,7.5,-104,-116,-132,-1.5,160,3.46,Guaranteed Rate Field,9,-1
2015-08-25,2015,LAA,DET,8,7,-120,-1.5,130,9.0,-120,100,110,1.5,-150,4.91,Comerica Park,15,1
2015-08-25,2015,NYY,HOU,1,15,138,1.5,-130,7.5,-115,-105,-153,-1.5,110,3.15,Yankee Stadium,16,-14
2015-08-25,2015,BAL,KC,2,3,110,1.5,-205,8.0,-105,-115,-120,-1.5,175,3.81,Kauffman Stadium,5,-1
2015-08-25,2015,DET,LAA,7,8,110,1.5,-150,9.0,-120,100,-120,-1.5,130,4.29,Comerica Park,15,-1
2015-08-25,2015,CIN,LAD,1,5,115,1.5,-150,8.0,105,-125,-125,-1.5,130,3.72,Great American Ballpark,6,-4
2015-08-25,2015,PIT,MIA,2,5,-142,-1.5,115,7.5,-105,-115,127,1.5,-135,4.4,Marlins Park,7,-3
2015-08-25,2015,CLE,MIL,11,6,-163,-1.5,125,8.0,100,-120,148,1.5,-145,4.96,Progressive Field,17,5
2015-08-25,2015,TB,MIN,7,11,-142,-1.5,150,7.0,-120,100,127,1.5,-170,4.11,Tropicana Field,18,-4
2015-08-25,2015,PHI,NYM,5,6,180,1.5,110,8.5,105,-125,-210,-1.5,-130,3.04,Citizens Bank Park,11,-1
2015-08-25,2015,HOU,NYY,15,1,-153,-1.5,110,7.5,-115,-105,138,1.5,-130,4.54,Yankee Stadium,16,14
2015-08-25,2015,SEA,OAK,6,5,-116,-1.5,195,7.5,-125,105,106,1.5,-225,4.03,T-Mobile Park,11,1
2015-08-25,2015,NYM,PHI,6,5,-210,-1.5,-130,8.5,105,-125,180,1.5,110,5.76,Citizens Bank Park,11,1
2015-08-25,2015,MIA,PIT,5,2,127,1.5,-135,7.5,-105,-115,-142,-1.5,115,3.3,Marlins Park,7,3
2015-08-25,2015,WSH,SD,8,3,-180,-1.5,115,7.0,-110,-110,160,1.5,-135,4.5,Nationals Park,11,5
2015-08-25,2015,OAK,SEA,5,6,106,1.5,-225,7.5,-125,105,-116,-1.5,195,3.64,T-Mobile Park,11,-1
2015-08-25,2015,CHC,SF,8,5,-145,-1.5,110,6.5,-120,100,130,1.5,-130,3.85,AT&T Park,13,3
2015-08-25,2015,ARI,STL,1,9,114,1.5,-155,7.5,-115,-105,-124,-1.5,135,3.5,Chase Field,10,-8
2015-08-25,2015,MIN,TB,11,7,127,1.5,-170,7.0,-120,100,-142,-1.5,150,3.08,Tropicana Field,18,4
2015-08-25,2015,TOR,TEX,6,5,-130,-1.5,120,9.0,-105,-115,115,1.5,-140,5.09,Rangers Ballpark,11,1
2015-08-25,2015,TEX,TOR,5,6,115,1.5,-140,9.0,-105,-115,-130,-1.5,120,4.19,Rangers Ballpark,11,-1
2015-08-25,2015,SD,WSH,3,8,160,1.5,-135,7.0,-110,-110,-180,-1.5,115,2.69,Nationals Park,11,-5
2015-08-26,2015,STL,ARI,3,1,113,1.5,-200,8.0,-105,-115,-123,-1.5,170,3.76,Chase Field,4,2
2015-08-26,2015,COL,ATL,6,3,138,1.5,-165,7.0,-120,100,-153,-1.5,145,2.94,Turner Field,9,3
2015-08-26,2015,KC,BAL,5,8,-141,-1.5,165,7.0,100,-120,126,1.5,-185,4.1,Kauffman Stadium,13,-3
2015-08-26,2015,CWS,BOS,0,3,-230,-1.5,-110,7.0,100,-120,200,1.5,-110,4.88,Guaranteed Rate Field,3,-3
2015-08-26,2015,SF,CHC,4,2,100,1.5,-170,7.5,100,-120,-110,-1.5,150,3.75,AT&T Park,6,2
2015-08-26,2015,LAD,CIN,7,4,-178,-1.5,-110,8.5,-101,-119,158,1.5,-110,5.44,Great American Ballpark,11,3
2015-08-26,2015,MIL,CLE,2,6,115,1.5,-180,8.0,100,-120,-130,-1.5,160,3.72,Progressive Field,8,-4
2015-08-26,2015,ATL,COL,3,6,-153,-1.5,145,7.0,-120,100,138,1.5,-165,4.23,Turner Field,9,-3
2015-08-26,2015,BOS,CWS,3,0,200,1.5,-110,7.0,100,-120,-230,-1.5,-110,2.33,Guaranteed Rate Field,3,3
2015-08-26,2015,LAA,DET,0,5,119,1.5,-170,9.0,100,-120,-134,-1.5,150,4.11,Comerica Park,5,-5
2015-08-26,2015,NYY,HOU,2,6,-158,-1.5,130,8.0,-105,-115,143,1.5,-150,4.9,Yankee Stadium,8,-4
2015-08-26,2015,BAL,KC,8,5,126,1.5,-185,7.0,100,-120,-141,-1.5,165,3.1,Kauffman Stadium,13,3
2015-08-26,2015,DET,LAA,5,0,-134,-1.5,150,9.0,100,-120,119,1.5,-170,5.15,Comerica Park,5,5
2015-08-26,2015,CIN,LAD,4,7,158,1.5,-110,8.5,-101,-119,-178,-1.5,-110,3.29,Great American Ballpark,11,-3
2015-08-26,2015,PIT,MIA,7,2,-151,-1.5,109,8.0,-105,-115,136,1.5,-129,4.81,Marlins Park,9,5
2015-08-26,2015,CLE,MIL,6,2,-130,-1.5,160,8.0,100,-120,115,1.5,-180,4.52,Progressive Field,8,4
2015-08-26,2015,TB,MIN,3,5,-183,-1.5,125,6.5,-115,-105,163,1.5,-145,4.2,Tropicana Field,8,-2
2015-08-26,2015,PHI,NYM,4,9,118,1.5,-142,8.0,-115,-105,-133,-1.5,122,3.67,Citizens Bank Park,13,-5
2015-08-26,2015,HOU,NYY,6,2,143,1.5,-150,8.0,-105,-115,-158,-1.5,130,3.29,Yankee Stadium,8,4
2015-08-26,2015,SEA,OAK,8,2,-155,-1.5,145,7.0,-130,110,140,1.5,-165,4.25,T-Mobile Park,10,6
2015-08-26,2015,NYM,PHI,9,4,-133,-1.5,122,8.0,-115,-105,118,1.5,-142,4.57,Citizens Bank Park,13,5
2015-08-26,2015,MIA,PIT,2,7,136,1.5,-129,8.0,-105,-115,-151,-1.5,109,3.39,Marlins Park,9,-5
2015-08-26,2015,WSH,SD,5,6,-139,-1.5,165,7.0,-105,-115,124,1.5,-185,4.07,Nationals Park,11,-1
2015-08-26,2015,OAK,SEA,2,8,140,1.5,-165,7.0,-130,110,-155,-1.5,145,2.92,T-Mobile Park,10,-6
2015-08-26,2015,CHC,SF,2,4,-110,-1.5,150,7.5,100,-120,100,1.5,-170,3.93,AT&T Park,6,-2
2015-08-26,2015,ARI,STL,1,3,-123,-1.5,170,8.0,-105,-115,113,1.5,-200,4.41,Chase Field,4,-2
2015-08-26,2015,MIN,TB,5,3,163,1.5,-145,6.5,-115,-105,-183,-1.5,125,2.47,Tropicana Field,8,2
2015-08-26,2015,TOR,TEX,12,4,-190,-1.5,-132,8.5,-105,-115,170,1.5,110,5.57,Rangers Ballpark,16,8
2015-08-26,2015,TEX,TOR,4,12,170,1.5,110,8.5,-105,-115,-190,-1.5,-132,3.15,Rangers Ballpark,16,-8
2015-08-26,2015,SD,WSH,6,5,124,1.5,-185,7.0,-105,-115,-139,-1.5,165,3.13,Nationals Park,11,1
2015-08-27,2015,STL,ARI,5,3,-118,-1.5,140,8.0,-110,-110,108,1.5,-160,4.33,Chase Field,8,2
2015-08-27,2015,KC,BAL,5,3,-113,-1.5,175,7.5,-110,-110,103,1.5,-205,3.98,Kauffman Stadium,8,2
2015-08-27,2015,SF,CHC,9,1,-195,-1.5,110,7.0,-119,-101,175,1.5,-130,4.63,AT&T Park,10,8
2015-08-27,2015,LAD,CIN,1,0,-206,-1.5,-133,7.0,-125,105,176,1.5,113,4.71,Great American Ballpark,1,1
2015-08-27,2015,SEA,CWS,2,4,119,1.5,-180,8.5,100,-120,-129,-1.5,160,3.88,Guaranteed Rate Field,6,-2
2015-08-27,2015,LAA,DET,2,0,-118,-1.5,130,9.0,-120,100,108,1.5,-150,4.87,Comerica Park,2,2
2015-08-27,2015,BAL,KC,3,5,103,1.5,-205,7.5,-110,-110,-113,-1.5,175,3.69,Kauffman Stadium,8,-2
2015-08-27,2015,DET,LAA,0,2,108,1.5,-150,9.0,-120,100,-118,-1.5,130,4.33,Comerica Park,2,-2
2015-08-27,2015,CIN,LAD,0,1,176,1.5,113,7.0,-125,105,-206,-1.5,-133,2.54,Great American Ballpark,1,-1
2015-08-27,2015,PIT,MIA,2,1,-230,-1.5,-130,7.0,-120,100,200,1.5,110,4.88,Marlins Park,3,1
2015-08-27,2015,TB,MIN,5,4,-128,-1.5,165,7.5,100,-120,118,1.5,-185,4.21,Tropicana Field,9,1
2015-08-27,2015,PHI,NYM,5,9,140,1.5,-125,8.5,-110,-110,-155,-1.5,105,3.54,Citizens Bank Park,14,-4
2015-08-27,2015,NYM,PHI,9,5,-155,-1.5,105,8.5,-110,-110,140,1.5,-125,5.17,Citizens Bank Park,14,4
2015-08-27,2015,MIA,PIT,1,2,200,1.5,110,7.0,-120,100,-230,-1.5,-130,2.33,Marlins Park,3,-1
2015-08-27,2015,WSH,SD,4,2,-176,-1.5,120,7.5,110,-130,156,1.5,-140,4.78,Nationals Park,6,2
2015-08-27,2015,CWS,SEA,4,2,-129,-1.5,160,8.5,100,-120,119,1.5,-180,4.79,Guaranteed Rate Field,6,2
2015-08-27,2015,CHC,SF,1,9,175,1.5,-130,7.0,-119,-101,-195,-1.5,110,2.55,AT&T Park,10,-8
2015-08-27,2015,ARI,STL,3,5,108,1.5,-160,8.0,-110,-110,-118,-1.5,140,3.85,Chase Field,8,-2
2015-08-27,2015,MIN,TB,4,5,118,1.5,-185,7.5,100,-120,-128,-1.5,165,3.44,Tropicana Field,9,-1
2015-08-27,2015,TOR,TEX,1,4,-111,-1.5,140,9.5,100,-120,101,1.5,-160,5.0,Rangers Ballpark,5,-3
2015-08-27,2015,TEX,TOR,4,1,101,1.5,-160,9.5,100,-120,-111,-1.5,140,4.73,Rangers Ballpark,5,3
2015-08-27,2015,SD,WSH,2,4,156,1.5,-140,7.5,110,-130,-176,-1.5,120,2.93,Nationals Park,6,-2
2015-08-28,2015,OAK,ARI,4,6,-106,-1.5,155,7.5,-110,-110,-104,1.5,-175,3.86,Chase Field,10,-2
2015-08-28,2015,NYY,ATL,15,4,-213,-1.5,-125,7.5,110,-130,183,1.5,105,5.1,Turner Field,19,11
2015-08-28,2015,TEX,BAL,4,1,-129,-1.5,160,8.5,-115,-105,119,1.5,-180,4.79,Rangers Ballpark,5,3
2015-08-28,2015,NYM,BOS,4,6,-215,-1.5,105,7.0,105,-125,185,1.5,-125,4.78,Citi Field,10,-2
2015-08-28,2015,LAD,CHC,4,1,-269,-1.5,-110,6.5,100,-120,229,1.5,-110,4.74,Dodger Stadium,5,3
2015-08-28,2015,MIL,CIN,5,0,-120,-1.5,175,7.0,-133,113,110,1.5,-205,3.82,Miller Park,5,5
2015-08-28,2015,LAA,CLE,1,3,110,1.5,-206,8.0,-120,100,-120,-1.5,176,3.81,Progressive Field,4,-2
2015-08-28,2015,PIT,COL,5,3,-265,-1.5,-133,7.0,-120,100,225,1.5,113,5.08,PNC Park,8,2
2015-08-28,2015,SEA,CWS,2,0,-120,-1.5,140,8.0,-120,100,110,1.5,-160,4.36,Guaranteed Rate Field,2,2
2015-08-28,2015,TOR,DET,5,3,-195,-1.5,-105,9.5,101,-121,175,1.5,-115,6.28,Rogers Centre,8,2
2015-08-28,2015,MIN,HOU,3,0,108,1.5,-155,7.5,100,-120,-118,-1.5,135,3.61,Target Field,3,3
2015-08-28,2015,TB,KC,2,3,102,1.5,-165,7.0,-110,-110,-112,-1.5,145,3.47,Tropicana Field,5,-1
2015-08-28,2015,CLE,LAA,3,1,-120,-1.5,176,8.0,-120,100,110,1.5,-206,4.36,Progressive Field,4,2
2015-08-28,2015,CHC,LAD,1,4,229,1.5,-110,6.5,100,-120,-269,-1.5,-110,1.98,Dodger Stadium,5,-3
2015-08-28,2015,WSH,MIA,3,4,-280,-1.5,-130,7.0,-110,-110,240,1.5,110,5.16,Nationals Park,7,-1
2015-08-28,2015,CIN,MIL,0,5,110,1.5,-205,7.0,-133,113,-120,-1.5,175,3.33,Miller Park,5,-5
2015-08-28,2015,HOU,MIN,0,3,-118,-1.5,135,7.5,100,-120,108,1.5,-155,4.06,Target Field,3,-3
2015-08-28,2015,BOS,NYM,6,4,185,1.5,-125,7.0,105,-125,-215,-1.5,105,2.46,Citi Field,10,2
2015-08-28,2015,ATL,NYY,4,15,183,1.5,105,7.5,110,-130,-213,-1.5,-125,2.65,Turner Field,19,-11
2015-08-28,2015,ARI,OAK,6,4,-104,1.5,-175,7.5,-110,-110,-106,-1.5,155,3.82,Chase Field,10,2
2015-08-28,2015,SD,PHI,1,7,-123,-1.5,130,7.5,-103,-117,113,1.5,-150,4.14,Citizens Bank Park,8,-6
2015-08-28,2015,COL,PIT,3,5,225,1.5,113,7.0,-120,100,-265,-1.5,-133,2.15,PNC Park,8,-2
2015-08-28,2015,PHI,SD,7,1,113,1.5,-150,7.5,-103,-117,-123,-1.5,130,3.52,Citizens Bank Park,8,6
2015-08-28,2015,CWS,SEA,0,2,110,1.5,-160,8.0,-120,100,-120,-1.5,140,3.81,Guaranteed Rate Field,2,-2
2015-08-28,2015,STL,SF,4,5,105,1.5,-230,6.5,-105,-115,-115,-1.5,190,3.17,AT&T Park,9,-1
2015-08-28,2015,SF,STL,5,4,-115,-1.5,190,6.5,-105,-115,105,1.5,-230,3.48,AT&T Park,9,1
2015-08-28,2015,KC,TB,3,2,-112,-1.5,145,7.0,-110,-110,102,1.5,-165,3.7,Tropicana Field,5,1
2015-08-28,2015,BAL,TEX,1,4,119,1.5,-180,8.5,-115,-105,-129,-1.5,160,3.88,Rangers Ballpark,5,-3
2015-08-28,2015,DET,TOR,3,5,175,1.5,-115,9.5,101,-121,-195,-1.5,-105,3.45,Rogers Centre,8,-2
2015-08-28,2015,MIA,WSH,4,3,240,1.5,110,7.0,-110,-110,-280,-1.5,-130,2.06,Nationals Park,7,1
2015-08-29,2015,OAK,ARI,3,2,129,1.5,-170,9.0,100,-120,-144,-1.5,150,3.93,Chase Field,5,1
2015-08-29,2015,NYY,ATL,3,1,-230,-1.5,-125,7.5,-105,-115,200,1.5,105,5.23,Turner Field,4,2
2015-08-29,2015,TEX,BAL,4,3,107,1.5,-155,9.0,-115,-105,-117,-1.5,135,4.35,Rangers Ballpark,7,1
2015-08-29,2015,NYM,BOS,1,3,-205,-1.5,110,7.0,105,-125,175,1.5,-130,4.7,Citi Field,4,-2
2015-08-29,2015,LAD,CHC,5,2,114,1.5,-150,7.5,-105,-115,-124,-1.5,130,3.5,Dodger Stadium,7,3
2015-08-29,2015,MIL,CIN,9,12,-132,-1.5,155,8.5,-110,-110,117,1.5,-175,4.84,Miller Park,21,-3
2015-08-29,2015,LAA,CLE,3,8,140,1.5,-170,7.0,-113,-107,-155,-1.5,150,2.92,Progressive Field,11,-5
2015-08-29,2015,PIT,COL,4,3,-233,-1.5,-107,8.0,-112,-108,203,1.5,-113,5.6,PNC Park,7,1
2015-08-29,2015,SEA,CWS,7,6,-116,-1.5,136,7.5,-111,-109,106,1.5,-156,4.03,Guaranteed Rate Field,13,1
2015-08-29,2015,TOR,DET,15,1,-265,-1.5,-130,10.0,-110,-110,225,1.5,110,7.26,Rogers Centre,16,14
2015-08-29,2015,MIN,HOU,1,4,103,1.5,-161,8.0,-105,-115,-113,-1.5,141,3.94,Target Field,5,-3
2015-08-29,2015,TB,KC,3,6,-101,1.5,-170,6.5,-115,-105,-109,-1.5,150,3.27,Tropicana Field,9,-3
2015-08-29,2015,CLE,LAA,8,3,-155,-1.5,150,7.0,-113,-107,140,1.5,-170,4.25,Progressive Field,11,5
2015-08-29,2015,CHC,LAD,2,5,-124,-1.5,130,7.5,-105,-115,114,1.5,-150,4.15,Dodger Stadium,7,-3
2015-08-29,2015,WSH,MIA,5,1,-251,-1.5,-120,7.5,-110,-110,211,1.5,100,5.36,Nationals Park,6,4
2015-08-29,2015,CIN,MIL,12,9,117,1.5,-175,8.5,-110,-110,-132,-1.5,155,3.92,Miller Park,21,3
2015-08-29,2015,HOU,MIN,4,1,-113,-1.5,141,8.0,-105,-115,103,1.5,-161,4.24,Target Field,5,3
2015-08-29,2015,BOS,NYM,3,1,175,1.5,-130,7.0,105,-125,-205,-1.5,110,2.55,Citi Field,4,2
2015-08-29,2015,ATL,NYY,1,3,200,1.5,105,7.5,-105,-115,-230,-1.5,-125,2.5,Turner Field,4,-2
2015-08-29,2015,ARI,OAK,2,3,-144,-1.5,150,9.0,100,-120,129,1.5,-170,5.31,Chase Field,5,-1
2015-08-29,2015,SD,PHI,3,4,-160,-1.5,-105,8.5,-115,-105,145,1.5,-115,5.23,Citizens Bank Park,7,-1
2015-08-29,2015,COL,PIT,3,4,203,1.5,-113,8.0,-112,-108,-233,-1.5,-107,2.64,PNC Park,7,-1
2015-08-29,2015,PHI,SD,4,3,145,1.5,-115,8.5,-115,-105,-160,-1.5,-105,3.47,Citizens Bank Park,7,1
2015-08-29,2015,CWS,SEA,6,7,106,1.5,-156,7.5,-111,-109,-116,-1.5,136,3.64,Guaranteed Rate Field,13,-1
2015-08-29,2015,STL,SF,6,0,-145,-1.5,128,7.0,-105,-115,130,1.5,-149,4.14,AT&T Park,6,6
2015-08-29,2015,SF,STL,0,6,130,1.5,-149,7.0,-105,-115,-145,-1.5,128,3.04,AT&T Park,6,-6
2015-08-29,2015,KC,TB,6,3,-109,-1.5,150,6.5,-115,-105,-101,1.5,-170,3.39,Tropicana Field,9,3
2015-08-29,2015,BAL,TEX,3,4,-117,-1.5,135,9.0,-115,-105,107,1.5,-155,4.85,Rangers Ballpark,7,-1
2015-08-29,2015,DET,TOR,1,15,225,1.5,110,10.0,-110,-110,-265,-1.5,-130,3.08,Rogers Centre,16,-14
2015-08-29,2015,MIA,WSH,1,5,211,1.5,100,7.5,-110,-110,-251,-1.5,-120,2.41,Nationals Park,6,-4
2015-08-30,2015,OAK,ARI,7,4,-106,1.5,-215,9.0,105,-125,-104,-1.5,185,4.63,Chase Field,11,3
2015-08-30,2015,NYY,ATL,20,6,-146,-1.5,105,7.0,-110,-110,131,1.5,-125,4.15,Turner Field,26,14
2015-08-30,2015,TEX,BAL,6,0,-117,-1.5,165,9.5,-110,-110,107,1.5,-185,5.12,Rangers Ballpark,6,6
2015-08-30,2015,NYM,BOS,5,4,-175,-1.5,130,7.0,-125,105,155,1.5,-150,4.45,Citi Field,9,1
2015-08-30,2015,LAD,CHC,0,2,118,1.5,-145,7.0,-122,102,-128,-1.5,125,3.21,Dodger Stadium,2,-2
2015-08-30,2015,MIL,CIN,4,1,-118,-1.5,170,8.5,-119,-101,108,1.5,-200,4.6,Miller Park,5,3
2015-08-30,2015,LAA,CLE,2,9,125,1.5,-175,8.5,-119,-101,-140,-1.5,155,3.78,Progressive Field,11,-7
2015-08-30,2015,PIT,COL,0,5,-190,-1.5,110,8.0,-105,-115,170,1.5,-130,5.24,PNC Park,5,-5
2015-08-30,2015,SEA,CWS,5,6,149,1.5,-145,8.0,-115,-105,-164,-1.5,125,3.21,Guaranteed Rate Field,11,-1
2015-08-30,2015,TOR,DET,9,2,-215,-1.5,-115,9.5,-115,-105,185,1.5,-105,6.48,Rogers Centre,11,7
2015-08-30,2015,MIN,HOU,7,5,127,1.5,-130,8.5,100,-120,-142,-1.5,110,3.74,Target Field,12,2
2015-08-30,2015,TB,KC,3,2,-118,-1.5,180,7.0,-105,-115,108,1.5,-210,3.79,Tropicana Field,5,1
2015-08-30,2015,CLE,LAA,9,2,-140,-1.5,155,8.5,-119,-101,125,1.5,-175,4.96,Progressive Field,11,7
2015-08-30,2015,CHC,LAD,2,0,-128,-1.5,125,7.0,-122,102,118,1.5,-145,3.93,Dodger Stadium,2,2
2015-08-30,2015,WSH,MIA,7,4,-250,-1.5,-120,7.0,-120,100,210,1.5,100,5.0,Nationals Park,11,3
2015-08-30,2015,CIN,MIL,1,4,108,1.5,-200,8.5,-119,-101,-118,-1.5,170,4.09,Miller Park,5,-3
2015-08-30,2015,HOU,MIN,5,7,-142,-1.5,110,8.5,100,-120,127,1.5,-130,4.99,Target Field,12,-2
2015-08-30,2015,BOS,NYM,4,5,155,1.5,-150,7.0,-125,105,-175,-1.5,130,2.75,Citi Field,9,-1
2015-08-30,2015,ATL,NYY,6,20,131,1.5,-125,7.0,-110,-110,-146,-1.5,105,3.03,Turner Field,26,-14
2015-08-30,2015,ARI,OAK,4,7,-104,-1.5,185,9.0,105,-125,-106,1.5,-215,4.59,Chase Field,11,-3
2015-08-30,2015,SD,PHI,9,4,-160,-1.5,100,8.0,-120,100,145,1.5,-120,4.92,Citizens Bank Park,13,5
2015-08-30,2015,COL,PIT,5,0,170,1.5,-130,8.0,-105,-115,-190,-1.5,110,2.96,PNC Park,5,5
2015-08-30,2015,PHI,SD,4,9,145,1.5,-120,8.0,-120,100,-160,-1.5,100,3.27,Citizens Bank Park,13,-5
2015-08-30,2015,CWS,SEA,6,5,-164,-1.5,125,8.0,-115,-105,149,1.5,-145,4.97,Guaranteed Rate Field,11,1
2015-08-30,2015,STL,SF,7,5,-113,-1.5,152,7.0,-110,-110,103,1.5,-172,3.71,AT&T Park,12,2
2015-08-30,2015,SF,STL,5,7,103,1.5,-172,7.0,-110,-110,-113,-1.5,152,3.45,AT&T Park,12,-2
2015-08-30,2015,KC,TB,2,3,108,1.5,-210,7.0,-105,-115,-118,-1.5,180,3.37,Tropicana Field,5,-1
2015-08-30,2015,BAL,TEX,0,6,107,1.5,-185,9.5,-110,-110,-117,-1.5,165,4.59,Rangers Ballpark,6,-6
2015-08-30,2015,DET,TOR,2,9,185,1.5,-105,9.5,-115,-105,-215,-1.5,-115,3.33,Rogers Centre,11,-7
2015-08-30,2015,MIA,WSH,4,7,210,1.5,100,7.0,-120,100,-250,-1.5,-120,2.26,Nationals Park,11,-3
2015-08-31,2015,COL,ARI,5,4,110,1.5,-150,10.0,-120,100,-120,-1.5,130,4.76,Coors Field,9,1
2015-08-31,2015,MIA,ATL,4,0,124,1.5,-185,7.5,100,-120,-139,-1.5,165,3.35,Turner Field,4,4
2015-08-31,2015,TB,BAL,6,3,-126,-1.5,140,7.5,101,-121,116,1.5,-160,4.18,Camden Yards,9,3
2015-08-31,2015,NYY,BOS,3,4,119,1.5,-175,9.5,-121,101,-129,-1.5,155,4.34,Fenway Park,7,-1
2015-08-31,2015,CIN,CHC,13,6,190,1.5,103,9.5,100,-120,-220,-1.5,-123,3.28,Wrigley Field,19,7
2015-08-31,2015,CHC,CIN,6,13,-220,-1.5,-123,9.5,100,-120,190,1.5,103,6.53,Wrigley Field,19,-7
2015-08-31,2015,TOR,CLE,2,4,-215,-1.5,-120,7.5,-105,-115,185,1.5,100,5.12,Rogers Centre,6,-2
2015-08-31,2015,ARI,COL,4,5,-120,-1.5,130,10.0,-120,100,110,1.5,-150,5.45,Coors Field,9,-1
2015-08-31,2015,SEA,HOU,3,8,210,1.5,113,7.5,105,-125,-250,-1.5,-133,2.42,Minute Maid Park,11,-5
2015-08-31,2015,OAK,LAA,11,5,106,1.5,-165,8.0,-115,-105,-116,-1.5,145,3.88,Oakland Coliseum,16,6
2015-08-31,2015,SF,LAD,4,5,126,1.5,-170,7.5,-106,-114,-141,-1.5,150,3.32,Dodger Stadium,9,-1
2015-08-31,2015,ATL,MIA,0,4,-139,-1.5,165,7.5,100,-120,124,1.5,-185,4.36,Turner Field,4,-4
2015-08-31,2015,PHI,NYM,1,3,170,1.5,-125,8.0,-119,-101,-200,-1.5,105,2.96,Citi Field,4,-2
2015-08-31,2015,BOS,NYY,4,3,-129,-1.5,155,9.5,-121,101,119,1.5,-175,5.35,Fenway Park,7,1
2015-08-31,2015,LAA,OAK,5,11,-116,-1.5,145,8.0,-115,-105,106,1.5,-165,4.3,Oakland Coliseum,16,-6
2015-08-31,2015,NYM,PHI,3,1,-200,-1.5,105,8.0,-119,-101,170,1.5,-125,5.33,Citi Field,4,2
2015-08-31,2015,TEX,SD,0,7,117,1.5,-210,7.0,100,-120,-127,-1.5,180,3.23,PETCO Park,7,-7
2015-08-31,2015,HOU,SEA,8,3,-250,-1.5,-133,7.5,105,-125,210,1.5,113,5.36,Minute Maid Park,11,5
2015-08-31,2015,LAD,SF,5,4,-141,-1.5,150,7.5,-106,-114,126,1.5,-170,4.39,Dodger Stadium,9,1
2015-08-31,2015,WSH,STL,5,8,116,1.5,-205,7.0,-110,-110,-126,-1.5,175,3.24,Busch Stadium,13,-3
2015-08-31,2015,BAL,TB,3,6,116,1.5,-160,7.5,101,-121,-126,-1.5,140,3.47,Camden Yards,9,-3
2015-08-31,2015,SD,TEX,7,0,-127,-1.5,180,7.0,100,-120,117,1.5,-210,3.92,PETCO Park,7,7
2015-08-31,2015,CLE,TOR,4,2,185,1.5,100,7.5,-105,-115,-215,-1.5,-120,2.63,Rogers Centre,6,2
2015-08-31,2015,STL,WSH,8,5,-126,-1.5,175,7.0,-110,-110,116,1.5,-205,3.9,Busch Stadium,13,3
2015-09-01,2015,COL,ARI,4,6,133,1.5,-130,11.0,-125,105,-148,-1.5,110,4.72,Coors Field,10,-2
2015-09-01,2015,COL,ARI,3,5,110,1.5,-145,11.5,-110,-110,-120,-1.5,125,5.48,Coors Field,8,-2
2015-09-01,2015,MIA,ATL,7,1,-105,1.5,-230,8.0,100,-120,-105,-1.5,190,4.1,Turner Field,8,6
2015-09-01,2015,TB,BAL,11,2,137,1.5,-155,8.5,-105,-115,-152,-1.5,135,3.59,Camden Yards,13,9
2015-09-01,2015,NYY,BOS,3,1,-153,-1.5,100,8.5,-125,105,138,1.5,-120,5.14,Fenway Park,4,2
2015-09-01,2015,CIN,CHC,4,5,127,1.5,-155,9.5,-120,100,-142,-1.5,135,4.19,Wrigley Field,9,-1
2015-09-01,2015,CHC,CIN,5,4,-142,-1.5,135,9.5,-120,100,127,1.5,-155,5.57,Wrigley Field,9,1
2015-09-01,2015,TOR,CLE,5,3,-182,-1.5,100,9.0,-110,-110,162,1.5,-120,5.81,Rogers Centre,8,2
2015-09-01,2015,ARI,COL,6,4,-148,-1.5,110,11.0,-125,105,133,1.5,-130,6.56,Coors Field,10,2
2015-09-01,2015,ARI,COL,5,3,-120,-1.5,125,11.5,-110,-110,110,1.5,-145,6.27,Coors Field,8,2
2015-09-01,2015,MIN,CWS,8,6,134,1.5,-135,7.5,100,-120,-149,-1.5,115,3.21,Target Field,14,2
2015-09-01,2015,KC,DET,5,6,-192,-1.5,115,7.0,-130,110,172,1.5,-135,4.6,Kauffman Stadium,11,-1
2015-09-01,2015,SEA,HOU,7,5,152,1.5,-145,8.5,-125,105,-167,-1.5,125,3.37,Minute Maid Park,12,2
2015-09-01,2015,DET,KC,6,5,172,1.5,-135,7.0,-130,110,-192,-1.5,115,2.57,Kauffman Stadium,11,1
2015-09-01,2015,OAK,LAA,2,6,119,1.5,-150,8.0,-110,-110,-129,-1.5,130,3.65,Oakland Coliseum,8,-4
2015-09-01,2015,SF,LAD,1,2,105,1.5,-220,5.5,-105,-115,-115,-1.5,190,2.68,Dodger Stadium,3,-1
2015-09-01,2015,ATL,MIA,1,7,-105,-1.5,190,8.0,100,-120,-105,1.5,-230,4.1,Turner Field,8,-6
2015-09-01,2015,PIT,MIL,4,7,-162,-1.5,-105,8.0,-110,-110,147,1.5,-115,4.95,Miller Park,11,-3
2015-09-01,2015,CWS,MIN,6,8,-149,-1.5,115,7.5,100,-120,134,1.5,-135,4.49,Target Field,14,-2
2015-09-01,2015,PHI,NYM,14,8,193,1.5,105,8.0,-110,-110,-223,-1.5,-125,2.73,Citi Field,22,6
2015-09-01,2015,BOS,NYY,1,3,138,1.5,-120,8.5,-125,105,-153,-1.5,100,3.57,Fenway Park,4,-2
2015-09-01,2015,LAA,OAK,6,2,-129,-1.5,130,8.0,-110,-110,119,1.5,-150,4.51,Oakland Coliseum,8,4
2015-09-01,2015,NYM,PHI,8,14,-223,-1.5,-125,8.0,-110,-110,193,1.5,105,5.52,Citi Field,22,-6
2015-09-01,2015,MIL,PIT,7,4,147,1.5,-115,8.0,-110,-110,-162,-1.5,-105,3.24,Miller Park,11,3
2015-09-01,2015,TEX,SD,8,6,-103,1.5,-220,7.0,-115,-105,-107,-1.5,190,3.55,PETCO Park,14,2
2015-09-01,2015,HOU,SEA,5,7,-167,-1.5,125,8.5,-125,105,152,1.5,-145,5.32,Minute Maid Park,12,-2
2015-09-01,2015,LAD,SF,2,1,-115,-1.5,190,5.5,-105,-115,105,1.5,-220,2.94,Dodger Stadium,3,1
2015-09-01,2015,WSH,STL,5,8,-120,-1.5,150,7.5,-115,-105,110,1.5,-170,4.09,Busch Stadium,13,-3
2015-09-01,2015,BAL,TB,2,11,-152,-1.5,135,8.5,-105,-115,137,1.5,-155,5.13,Camden Yards,13,-9
2015-09-01,2015,SD,TEX,6,8,-107,-1.5,190,7.0,-115,-105,-103,1.5,-220,3.62,PETCO Park,14,-2
2015-09-01,2015,CLE,TOR,3,5,162,1.5,-120,9.0,-110,-110,-182,-1.5,100,3.44,Rogers Centre,8,-2
2015-09-01,2015,STL,WSH,8,5,110,1.5,-170,7.5,-115,-105,-120,-1.5,150,3.57,Busch Stadium,13,3
2015-09-02,2015,COL,ARI,9,4,-130,-1.5,145,10.5,-114,-106,115,1.5,-165,5.93,Coors Field,13,5
2015-09-02,2015,MIA,ATL,7,3,-115,-1.5,135,8.5,100,-120,105,1.5,-155,4.55,Turner Field,10,4
2015-09-02,2015,TB,BAL,6,7,119,1.5,-175,8.5,-115,-105,-134,-1.5,155,3.88,Camden Yards,13,-1
2015-09-02,2015,NYY,BOS,13,8,-130,-1.5,120,9.0,-110,-110,115,1.5,-140,5.09,Fenway Park,21,5
2015-09-02,2015,CIN,CHC,7,4,136,1.5,-155,9.0,-115,-105,-151,-1.5,135,3.81,Wrigley Field,11,3
2015-09-02,2015,CHC,CIN,4,7,-151,-1.5,135,9.0,-115,-105,136,1.5,-155,5.41,Wrigley Field,11,-3
2015-09-02,2015,TOR,CLE,5,1,-171,-1.5,110,9.0,-115,-105,151,1.5,-130,5.68,Rogers Centre,6,4
2015-09-02,2015,ARI,COL,4,9,115,1.5,-165,10.5,-114,-106,-130,-1.5,145,4.88,Coors Field,13,-5
2015-09-02,2015,MIN,CWS,3,0,-128,-1.5,170,8.5,-110,-110,118,1.5,-200,4.77,Target Field,3,3
2015-09-02,2015,KC,DET,12,1,-202,-1.5,100,8.5,-115,-105,172,1.5,-120,5.69,Kauffman Stadium,13,11
2015-09-02,2015,SEA,HOU,8,3,145,1.5,-150,7.5,-115,-105,-160,-1.5,130,3.06,Minute Maid Park,11,5
2015-09-02,2015,DET,KC,1,12,172,1.5,-120,8.5,-115,-105,-202,-1.5,100,3.13,Kauffman Stadium,13,-11
2015-09-02,2015,OAK,LAA,4,9,-129,-1.5,170,7.5,-120,100,119,1.5,-200,4.22,Oakland Coliseum,13,-5
2015-09-02,2015,SF,LAD,1,2,210,1.5,-108,6.0,100,-120,-250,-1.5,-112,1.94,Dodger Stadium,3,-1
2015-09-02,2015,ATL,MIA,3,7,105,1.5,-155,8.5,100,-120,-115,-1.5,135,4.15,Turner Field,10,-4
2015-09-02,2015,PIT,MIL,4,9,-150,-1.5,-101,9.0,-120,100,135,1.5,-119,5.4,Miller Park,13,-5
2015-09-02,2015,CWS,MIN,0,3,118,1.5,-200,8.5,-110,-110,-128,-1.5,170,3.9,Target Field,3,-3
2015-09-02,2015,PHI,NYM,4,9,200,1.5,-110,7.0,105,-125,-240,-1.5,-110,2.33,Citi Field,13,-5
2015-09-02,2015,BOS,NYY,8,13,115,1.5,-140,9.0,-110,-110,-130,-1.5,120,4.19,Fenway Park,21,-5
2015-09-02,2015,LAA,OAK,9,4,119,1.5,-200,7.5,-120,100,-129,-1.5,170,3.42,Oakland Coliseum,13,5
2015-09-02,2015,NYM,PHI,9,4,-240,-1.5,-110,7.0,105,-125,200,1.5,-110,4.94,Citi Field,13,5
2015-09-02,2015,MIL,PIT,9,4,135,1.5,-119,9.0,-120,100,-150,-1.5,-101,3.83,Miller Park,13,5
2015-09-02,2015,TEX,SD,4,3,-162,-1.5,105,6.5,-119,-101,147,1.5,-125,4.02,PETCO Park,7,1
2015-09-02,2015,HOU,SEA,3,8,-160,-1.5,130,7.5,-115,-105,145,1.5,-150,4.62,Minute Maid Park,11,-5
2015-09-02,2015,LAD,SF,2,1,-250,-1.5,-112,6.0,100,-120,210,1.5,-108,4.29,Dodger Stadium,3,1
2015-09-02,2015,WSH,STL,4,3,-145,-1.5,110,7.0,-110,-110,130,1.5,-130,4.14,Busch Stadium,7,1
2015-09-02,2015,BAL,TB,7,6,-134,-1.5,155,8.5,-115,-105,119,1.5,-175,4.87,Camden Yards,13,1
2015-09-02,2015,SD,TEX,3,4,147,1.5,-125,6.5,-119,-101,-162,-1.5,105,2.63,PETCO Park,7,-1
2015-09-02,2015,CLE,TOR,1,5,151,1.5,-130,9.0,-115,-105,-171,-1.5,110,3.59,Rogers Centre,6,-4
2015-09-02,2015,STL,WSH,3,4,130,1.5,-130,7.0,-110,-110,-145,-1.5,110,3.04,Busch Stadium,7,-1
2015-09-03,2015,WSH,ATL,15,1,-222,-1.5,-120,8.0,-115,-105,192,1.5,100,5.52,Nationals Park,16,14
2015-09-03,2015,SF,COL,3,11,110,1.5,-180,10.5,-115,-105,-120,-1.5,160,5.0,Coors Field,14,-8
2015-09-03,2015,MIN,CWS,4,6,-117,-1.5,175,8.0,100,-120,107,1.5,-205,4.31,Target Field,10,-2
2015-09-03,2015,KC,DET,15,7,-164,-1.5,115,9.0,-115,-105,149,1.5,-135,5.59,Kauffman Stadium,22,8
2015-09-03,2015,DET,KC,7,15,149,1.5,-135,9.0,-115,-105,-164,-1.5,115,3.61,Kauffman Stadium,22,-8
2015-09-03,2015,SD,LAD,10,7,141,1.5,-130,7.5,-110,-110,-156,-1.5,110,3.11,PETCO Park,17,3
2015-09-03,2015,PIT,MIL,3,5,-131,-1.5,135,7.5,-110,-110,116,1.5,-155,4.25,Miller Park,8,-2
2015-09-03,2015,CWS,MIN,6,4,107,1.5,-205,8.0,100,-120,-117,-1.5,175,3.86,Target Field,10,2
2015-09-03,2015,MIL,PIT,5,3,116,1.5,-155,7.5,-110,-110,-131,-1.5,135,3.47,Miller Park,8,2
2015-09-03,2015,LAD,SD,7,10,-156,-1.5,110,7.5,-110,-110,141,1.5,-130,4.57,PETCO Park,17,-3
2015-09-03,2015,COL,SF,11,3,-120,-1.5,160,10.5,-115,-105,110,1.5,-180,5.73,Coors Field,14,8
2015-09-03,2015,ATL,WSH,1,15,192,1.5,100,8.0,-115,-105,-222,-1.5,-120,2.74,Nationals Park,16,-14
2015-09-04,2015,CHC,ARI,14,5,-205,-1.5,110,7.5,-110,-110,175,1.5,-130,5.04,Wrigley Field,19,9
2015-09-04,2015,WSH,ATL,5,2,-155,-1.5,125,8.5,-105,-115,140,1.5,-145,5.17,Nationals Park,7,3
2015-09-04,2015,TOR,BAL,2,10,-170,-1.5,110,9.0,-105,-115,150,1.5,-130,5.67,Rogers Centre,12,-8
2015-09-04,2015,PHI,BOS,5,7,190,1.5,-110,9.0,102,-122,-220,-1.5,-110,3.1,Fenway Park,12,-2
2015-09-04,2015,ARI,CHC,5,14,175,1.5,-130,7.5,-110,-110,-205,-1.5,110,2.73,Wrigley Field,19,-9
2015-09-04,2015,DET,CLE,1,8,132,1.5,-135,8.5,-115,-105,-147,-1.5,115,3.66,Comerica Park,9,-7
2015-09-04,2015,SF,COL,1,2,110,1.5,-170,10.5,-120,100,-120,-1.5,150,5.0,Coors Field,3,-1
2015-09-04,2015,KC,CWS,1,12,-200,-1.5,-104,8.5,-110,-110,170,1.5,-116,5.67,Kauffman Stadium,13,-11
2015-09-04,2015,CLE,DET,8,1,-147,-1.5,115,8.5,-115,-105,132,1.5,-135,5.06,Comerica Park,9,7
2015-09-04,2015,MIN,HOU,0,8,170,1.5,-120,8.5,100,-120,-200,-1.5,100,3.15,Minute Maid Park,8,-8
2015-09-04,2015,CWS,KC,12,1,170,1.5,-116,8.5,-110,-110,-200,-1.5,-104,3.15,Kauffman Stadium,13,11
2015-09-04,2015,TEX,LAA,2,5,140,1.5,-160,7.5,-120,100,-155,-1.5,140,3.13,Angel Stadium,7,-3
2015-09-04,2015,SD,LAD,4,8,-101,1.5,-170,7.0,-105,-115,-109,-1.5,150,3.52,PETCO Park,12,-4
2015-09-04,2015,NYM,MIA,5,6,-180,-1.5,-115,7.5,105,-125,160,1.5,-105,4.82,Marlins Park,11,-1
2015-09-04,2015,HOU,MIN,8,0,-200,-1.5,100,8.5,100,-120,170,1.5,-120,5.67,Minute Maid Park,8,8
2015-09-04,2015,MIA,NYM,6,5,160,1.5,-105,7.5,105,-125,-180,-1.5,-115,2.88,Marlins Park,11,1
2015-09-04,2015,TB,NYY,2,5,152,1.5,-145,8.0,-125,105,-172,-1.5,125,3.17,Yankee Stadium,7,-3
2015-09-04,2015,SEA,OAK,11,8,135,1.5,-165,8.0,-124,104,-150,-1.5,145,3.4,Oakland Coliseum,19,3
2015-09-04,2015,BOS,PHI,7,5,-220,-1.5,-110,9.0,102,-122,190,1.5,-110,6.19,Fenway Park,12,2
2015-09-04,2015,STL,PIT,3,9,-145,-1.5,150,7.5,105,-125,130,1.5,-170,4.44,Busch Stadium,12,-6
2015-09-04,2015,LAD,SD,8,4,-109,-1.5,150,7.0,-105,-115,-101,1.5,-170,3.65,PETCO Park,12,4
2015-09-04,2015,OAK,SEA,8,11,-150,-1.5,145,8.0,-124,104,135,1.5,-165,4.8,Oakland Coliseum,19,-3
2015-09-04,2015,COL,SF,2,1,-120,-1.5,150,10.5,-120,100,110,1.5,-170,5.73,Coors Field,3,1
2015-09-04,2015,PIT,STL,9,3,130,1.5,-170,7.5,105,-125,-145,-1.5,150,3.26,Busch Stadium,12,6
2015-09-04,2015,NYY,TB,5,2,-172,-1.5,125,8.0,-125,105,152,1.5,-145,5.06,Yankee Stadium,7,3
2015-09-04,2015,LAA,TEX,5,2,-155,-1.5,140,7.5,-120,100,140,1.5,-160,4.56,Angel Stadium,7,3
2015-09-04,2015,BAL,TOR,10,2,150,1.5,-130,9.0,-105,-115,-170,-1.5,110,3.6,Rogers Centre,12,8
2015-09-04,2015,ATL,WSH,2,5,140,1.5,-145,8.5,-105,-115,-155,-1.5,125,3.54,Nationals Park,7,-3
2015-09-05,2015,CHC,ARI,2,0,-235,-1.5,-126,8.0,-115,-105,205,1.5,106,5.61,Wrigley Field,2,2
2015-09-05,2015,WSH,ATL,8,2,-182,-1.5,113,7.5,-105,-115,162,1.5,-132,4.84,Nationals Park,10,6
2015-09-05,2015,TOR,BAL,5,1,-290,-1.5,-150,8.5,-120,100,250,1.5,130,6.32,Rogers Centre,6,4
2015-09-05,2015,PHI,BOS,2,9,190,1.5,-103,9.0,-115,-105,-220,-1.5,-117,3.1,Fenway Park,11,-7
2015-09-05,2015,ARI,CHC,0,2,205,1.5,106,8.0,-115,-105,-235,-1.5,-126,2.62,Wrigley Field,2,-2
2015-09-05,2015,MIL,CIN,8,6,134,1.5,-165,9.0,-115,-105,-149,-1.5,145,3.85,Great American Ballpark,14,2
2015-09-05,2015,MIL,CIN,7,3,-102,1.5,-170,8.5,-103,-117,-108,-1.5,150,4.29,Great American Ballpark,10,4
2015-09-05,2015,DET,CLE,6,0,131,1.5,-128,8.5,100,-120,-146,-1.5,108,3.68,Comerica Park,6,6
2015-09-05,2015,SF,COL,7,3,126,1.5,-153,10.5,-115,-105,-141,-1.5,133,4.65,Coors Field,10,4
2015-09-05,2015,KC,CWS,1,6,-105,1.5,-175,8.0,-115,-105,-105,-1.5,155,4.1,Kauffman Stadium,7,-5
2015-09-05,2015,CLE,DET,0,6,-146,-1.5,108,8.5,100,-120,131,1.5,-128,5.04,Comerica Park,6,-6
2015-09-05,2015,MIN,HOU,3,2,170,1.5,-119,8.5,100,-120,-200,-1.5,-101,3.15,Minute Maid Park,5,1
2015-09-05,2015,CWS,KC,6,1,-105,-1.5,155,8.0,-115,-105,-105,1.5,-175,4.1,Kauffman Stadium,7,5
2015-09-05,2015,TEX,LAA,2,1,101,1.5,-215,8.0,-110,-110,-111,-1.5,185,3.98,Angel Stadium,3,1
2015-09-05,2015,SD,LAD,0,2,-108,-1.5,190,7.0,-120,100,-102,1.5,-230,3.63,PETCO Park,2,-2
2015-09-05,2015,NYM,MIA,7,0,-131,-1.5,125,8.0,-110,-110,116,1.5,-145,4.54,Marlins Park,7,7
2015-09-05,2015,CIN,MIL,6,8,-149,-1.5,145,9.0,-115,-105,134,1.5,-165,5.39,Great American Ballpark,14,-2
2015-09-05,2015,CIN,MIL,3,7,-108,-1.5,150,8.5,-103,-117,-102,1.5,-170,4.41,Great American Ballpark,10,-4
2015-09-05,2015,HOU,MIN,2,3,-200,-1.5,-101,8.5,100,-120,170,1.5,-119,5.67,Minute Maid Park,5,-1
2015-09-05,2015,MIA,NYM,0,7,116,1.5,-145,8.0,-110,-110,-131,-1.5,125,3.7,Marlins Park,7,-7
2015-09-05,2015,TB,NYY,3,2,163,1.5,-125,8.0,-120,100,-183,-1.5,105,3.04,Yankee Stadium,5,1
2015-09-05,2015,SEA,OAK,8,3,-126,-1.5,130,7.5,100,-120,116,1.5,-150,4.18,Oakland Coliseum,11,5
2015-09-05,2015,BOS,PHI,9,2,-220,-1.5,-117,9.0,-115,-105,190,1.5,-103,6.19,Fenway Park,11,7
2015-09-05,2015,STL,PIT,4,1,-158,-1.5,140,7.5,-110,-110,143,1.5,-160,4.59,Busch Stadium,5,3
2015-09-05,2015,LAD,SD,2,0,-102,1.5,-230,7.0,-120,100,-108,-1.5,190,3.53,PETCO Park,2,2
2015-09-05,2015,OAK,SEA,3,8,116,1.5,-150,7.5,100,-120,-126,-1.5,130,3.47,Oakland Coliseum,11,-5
2015-09-05,2015,COL,SF,3,7,-141,-1.5,133,10.5,-115,-105,126,1.5,-153,6.14,Coors Field,10,-4
2015-09-05,2015,PIT,STL,1,4,143,1.5,-160,7.5,-110,-110,-158,-1.5,140,3.09,Busch Stadium,5,-3
2015-09-05,2015,NYY,TB,2,3,-183,-1.5,105,8.0,-120,100,163,1.5,-125,5.17,Yankee Stadium,5,-1
2015-09-05,2015,LAA,TEX,1,2,-111,-1.5,185,8.0,-110,-110,101,1.5,-215,4.21,Angel Stadium,3,-1
2015-09-05,2015,BAL,TOR,1,5,250,1.5,130,8.5,-120,100,-290,-1.5,-150,2.43,Rogers Centre,6,-4
2015-09-05,2015,ATL,WSH,2,8,162,1.5,-132,7.5,-105,-115,-182,-1.5,113,2.86,Nationals Park,10,-6
2015-09-06,2015,CHC,ARI,6,4,-161,-1.5,125,9.5,-115,-105,146,1.5,-145,5.86,Wrigley Field,10,2
2015-09-06,2015,WSH,ATL,8,4,-250,-1.5,-125,8.5,100,-120,210,1.5,105,6.07,Nationals Park,12,4
2015-09-06,2015,TOR,BAL,10,4,-175,-1.5,108,8.5,-120,100,155,1.5,-128,5.41,Rogers Centre,14,6
2015-09-06,2015,PHI,BOS,2,6,185,1.5,-127,9.0,100,-120,-215,-1.5,105,3.16,Fenway Park,8,-4
2015-09-06,2015,ARI,CHC,4,6,146,1.5,-145,9.5,-115,-105,-161,-1.5,125,3.86,Wrigley Field,10,-2
2015-09-06,2015,MIL,CIN,3,6,-116,-1.5,135,9.0,104,-124,106,1.5,-155,4.83,Great American Ballpark,9,-3
2015-09-06,2015,DET,CLE,0,4,-143,-1.5,150,8.5,100,-120,128,1.5,-170,5.0,Comerica Park,4,-4
2015-09-06,2015,SF,COL,7,4,-195,-1.5,-132,10.0,100,-120,175,1.5,112,6.61,Coors Field,11,3
2015-09-06,2015,KC,CWS,5,7,-220,-1.5,-110,8.0,-120,100,190,1.5,-110,5.5,Kauffman Stadium,12,-2
2015-09-06,2015,CLE,DET,4,0,128,1.5,-170,8.5,100,-120,-143,-1.5,150,3.73,Comerica Park,4,4
2015-09-06,2015,MIN,HOU,5,8,200,1.5,100,7.5,-115,-105,-240,-1.5,-120,2.5,Minute Maid Park,13,-3
2015-09-06,2015,CWS,KC,7,5,190,1.5,-110,8.0,-120,100,-220,-1.5,-110,2.76,Kauffman Stadium,12,2
2015-09-06,2015,TEX,LAA,0,7,115,1.5,-180,8.5,-115,-105,-125,-1.5,160,3.95,Angel Stadium,7,-7
2015-09-06,2015,SD,LAD,1,5,-104,1.5,-170,7.5,-115,-105,-106,-1.5,150,3.82,PETCO Park,6,-4
2015-09-06,2015,NYM,MIA,3,4,-153,-1.5,110,7.5,-110,-110,138,1.5,-130,4.54,Marlins Park,7,-1
2015-09-06,2015,CIN,MIL,6,3,106,1.5,-155,9.0,104,-124,-116,-1.5,135,4.37,Great American Ballpark,9,3
2015-09-06,2015,HOU,MIN,8,5,-240,-1.5,-120,7.5,-115,-105,200,1.5,100,5.29,Minute Maid Park,13,3
2015-09-06,2015,MIA,NYM,4,3,138,1.5,-130,7.5,-110,-110,-153,-1.5,110,3.15,Marlins Park,7,1
2015-09-06,2015,TB,NYY,4,6,-120,-1.5,140,7.5,-115,-105,110,1.5,-160,4.09,Yankee Stadium,10,-2
2015-09-06,2015,SEA,OAK,3,2,-129,-1.5,120,8.0,-101,-119,119,1.5,-140,4.51,Oakland Coliseum,5,1
2015-09-06,2015,BOS,PHI,6,2,-215,-1.5,105,9.0,100,-120,185,1.5,-127,6.14,Fenway Park,8,4
2015-09-06,2015,STL,PIT,1,7,-106,1.5,-180,7.0,-115,-105,-104,-1.5,160,3.6,Busch Stadium,8,-6
2015-09-06,2015,LAD,SD,5,1,-106,-1.5,150,7.5,-115,-105,-104,1.5,-170,3.86,PETCO Park,6,4
2015-09-06,2015,OAK,SEA,2,3,119,1.5,-140,8.0,-101,-119,-129,-1.5,120,3.65,Oakland Coliseum,5,-1
2015-09-06,2015,COL,SF,4,7,175,1.5,112,10.0,100,-120,-195,-1.5,-132,3.64,Coors Field,11,-3
2015-09-06,2015,PIT,STL,7,1,-104,-1.5,160,7.0,-115,-105,-106,1.5,-180,3.57,Busch Stadium,8,6
2015-09-06,2015,NYY,TB,6,4,110,1.5,-160,7.5,-115,-105,-120,-1.5,140,3.57,Yankee Stadium,10,2
2015-09-06,2015,LAA,TEX,7,0,-125,-1.5,160,8.5,-115,-105,115,1.5,-180,4.72,Angel Stadium,7,7
2015-09-06,2015,BAL,TOR,4,10,155,1.5,-128,8.5,-120,100,-175,-1.5,108,3.33,Rogers Centre,14,-6
2015-09-06,2015,ATL,WSH,4,8,210,1.5,105,8.5,100,-120,-250,-1.5,-125,2.74,Nationals Park,12,-4
2015-09-07,2015,SF,ARI,1,6,125,1.5,-175,7.5,-120,100,-140,-1.5,155,3.33,Chase Field,7,-5
2015-09-07,2015,PHI,ATL,2,7,-107,-1.5,185,9.0,-105,-115,-103,1.5,-215,4.65,Citizens Bank Park,9,-5
2015-09-07,2015,NYY,BAL,8,6,-153,-1.5,130,8.0,-115,-105,138,1.5,-150,4.84,Yankee Stadium,14,2
2015-09-07,2015,TOR,BOS,4,11,-131,-1.5,120,10.5,-106,-114,116,1.5,-140,5.95,Fenway Park,15,-7
2015-09-07,2015,STL,CHC,0,9,-150,-1.5,140,8.5,-120,100,135,1.5,-160,5.1,Busch Stadium,9,-9
2015-09-07,2015,PIT,CIN,1,3,105,1.5,-210,9.0,-110,-110,-115,-1.5,180,4.39,Great American Ballpark,4,-2
2015-09-07,2015,CWS,CLE,2,3,-180,-1.5,105,7.5,100,-120,160,1.5,-125,4.82,Guaranteed Rate Field,5,-1
2015-09-07,2015,SD,COL,4,6,-190,-1.5,109,7.5,-120,100,170,1.5,-130,4.91,PETCO Park,10,-2
2015-09-07,2015,CLE,CWS,3,2,160,1.5,-125,7.5,100,-120,-180,-1.5,105,2.88,Guaranteed Rate Field,5,1
2015-09-07,2015,TB,DET,4,5,-127,-1.5,130,9.0,-120,100,117,1.5,-150,5.04,Comerica Park,9,-1
2015-09-07,2015,OAK,HOU,10,9,138,1.5,-120,7.5,-120,100,-153,-1.5,100,3.15,Oakland Coliseum,19,1
2015-09-07,2015,MIN,KC,6,2,170,1.5,-119,8.0,-115,-105,-200,-1.5,-101,2.96,Kauffman Stadium,8,4
2015-09-07,2015,LAD,LAA,7,5,-175,-1.5,-107,7.5,-120,100,155,1.5,-113,4.77,Angel Stadium,12,2
2015-09-07,2015,LAA,LAD,5,7,155,1.5,-113,7.5,-120,100,-175,-1.5,-107,2.94,Angel Stadium,12,-2
2015-09-07,2015,MIL,MIA,9,1,109,1.5,-205,8.5,100,-120,-119,-1.5,175,4.07,Marlins Park,10,8
2015-09-07,2015,MIA,MIL,1,9,-119,-1.5,175,8.5,100,-120,109,1.5,-205,4.62,Marlins Park,10,-8
2015-09-07,2015,KC,MIN,2,6,-200,-1.5,-101,8.0,-115,-105,170,1.5,-119,5.33,Kauffman Stadium,8,-4
2015-09-07,2015,WSH,NYM,5,8,-229,-1.5,-101,8.0,100,-120,199,1.5,-119,5.57,Nationals Park,13,-3
2015-09-07,2015,BAL,NYY,6,8,138,1.5,-150,8.0,-115,-105,-153,-1.5,130,3.36,Yankee Stadium,14,-2
2015-09-07,2015,HOU,OAK,9,10,-153,-1.5,100,7.5,-120,100,138,1.5,-120,4.54,Oakland Coliseum,19,-1
2015-09-07,2015,ATL,PHI,7,2,-103,1.5,-215,9.0,-105,-115,-107,-1.5,185,4.57,Citizens Bank Park,9,5
2015-09-07,2015,CIN,PIT,3,1,-115,-1.5,180,9.0,-110,-110,105,1.5,-210,4.81,Great American Ballpark,4,2
2015-09-07,2015,COL,SD,6,4,170,1.5,-130,7.5,-120,100,-190,-1.5,109,2.78,PETCO Park,10,2
2015-09-07,2015,TEX,SEA,3,0,105,1.5,-210,7.5,-115,-105,-115,-1.5,180,3.66,T-Mobile Park,3,3
2015-09-07,2015,ARI,SF,6,1,-140,-1.5,155,7.5,-120,100,125,1.5,-175,4.38,Chase Field,7,5
2015-09-07,2015,CHC,STL,9,0,135,1.5,-160,8.5,-120,100,-150,-1.5,140,3.62,Busch Stadium,9,9
2015-09-07,2015,DET,TB,5,4,117,1.5,-150,9.0,-120,100,-127,-1.5,130,4.15,Comerica Park,9,1
2015-09-07,2015,SEA,TEX,0,3,-115,-1.5,180,7.5,-115,-105,105,1.5,-210,4.01,T-Mobile Park,3,-3
2015-09-07,2015,BOS,TOR,11,4,116,1.5,-140,10.5,-106,-114,-131,-1.5,120,4.86,Fenway Park,15,7
2015-09-07,2015,NYM,WSH,8,5,199,1.5,-119,8.0,100,-120,-229,-1.5,-101,2.68,Nationals Park,13,3
2015-09-08,2015,SF,ARI,6,2,-113,-1.5,140,8.5,-120,100,103,1.5,-160,4.51,Chase Field,8,4
2015-09-08,2015,PHI,ATL,5,0,-130,-1.5,150,9.0,105,-125,115,1.5,-170,5.09,Citizens Bank Park,5,5
2015-09-08,2015,NYY,BAL,1,2,-177,-1.5,115,8.5,-110,-110,157,1.5,-135,5.43,Yankee Stadium,3,-1
2015-09-08,2015,TOR,BOS,5,1,-127,-1.5,125,10.5,100,-120,117,1.5,-145,5.87,Fenway Park,6,4
2015-09-08,2015,STL,CHC,5,8,-143,-1.5,155,7.5,100,-120,128,1.5,-175,4.41,Busch Stadium,13,-3
2015-09-08,2015,PIT,CIN,7,3,-124,-1.5,130,7.5,-115,-105,114,1.5,-150,4.15,Great American Ballpark,10,4
2015-09-08,2015,CWS,CLE,7,4,117,1.5,-135,7.5,-105,-115,-132,-1.5,115,3.46,Guaranteed Rate Field,11,3
2015-09-08,2015,SD,COL,2,1,-114,-1.5,170,8.5,-105,-115,104,1.5,-200,4.53,PETCO Park,3,1
2015-09-08,2015,CLE,CWS,4,7,-132,-1.5,115,7.5,-105,-115,117,1.5,-135,4.27,Guaranteed Rate Field,11,-3
2015-09-08,2015,TB,DET,7,8,-120,-1.5,130,9.0,-110,-110,110,1.5,-150,4.91,Comerica Park,15,-1
2015-09-08,2015,OAK,HOU,4,0,-111,-1.5,190,7.5,100,-120,101,1.5,-230,3.95,Oakland Coliseum,4,4
2015-09-08,2015,MIN,KC,2,4,155,1.5,-135,8.0,-120,100,-175,-1.5,115,3.14,Kauffman Stadium,6,-2
2015-09-08,2015,LAD,LAA,6,4,-159,-1.5,100,6.5,-125,105,144,1.5,-120,3.99,Angel Stadium,10,2
2015-09-08,2015,LAA,LAD,4,6,144,1.5,-120,6.5,-125,105,-159,-1.5,100,2.66,Angel Stadium,10,-2
2015-09-08,2015,MIL,MIA,4,6,-116,-1.5,140,7.5,-105,-115,106,1.5,-160,4.03,Marlins Park,10,-2
2015-09-08,2015,MIA,MIL,6,4,106,1.5,-160,7.5,-105,-115,-116,-1.5,140,3.64,Marlins Park,10,2
2015-09-08,2015,KC,MIN,4,2,-175,-1.5,115,8.0,-120,100,155,1.5,-135,5.09,Kauffman Stadium,6,2
2015-09-08,2015,WSH,NYM,7,8,-105,-1.5,195,7.5,-105,-115,-105,1.5,-235,3.84,Nationals Park,15,-1
2015-09-08,2015,BAL,NYY,2,1,157,1.5,-135,8.5,-110,-110,-177,-1.5,115,3.31,Yankee Stadium,3,1
2015-09-08,2015,HOU,OAK,0,4,101,1.5,-230,7.5,100,-120,-111,-1.5,190,3.73,Oakland Coliseum,4,-4
2015-09-08,2015,ATL,PHI,0,5,115,1.5,-170,9.0,105,-125,-130,-1.5,150,4.19,Citizens Bank Park,5,-5
2015-09-08,2015,CIN,PIT,3,7,114,1.5,-150,7.5,-115,-105,-124,-1.5,130,3.5,Great American Ballpark,10,-4
2015-09-08,2015,COL,SD,1,2,104,1.5,-200,8.5,-105,-115,-114,-1.5,170,4.17,PETCO Park,3,-1
2015-09-08,2015,TEX,SEA,9,6,-127,-1.5,125,7.0,105,-125,117,1.5,-145,3.92,T-Mobile Park,15,3
2015-09-08,2015,ARI,SF,2,6,103,1.5,-160,8.5,-120,100,-113,-1.5,140,4.19,Chase Field,8,-4
2015-09-08,2015,CHC,STL,8,5,128,1.5,-175,7.5,100,-120,-143,-1.5,155,3.29,Busch Stadium,13,3
2015-09-08,2015,DET,TB,8,7,110,1.5,-150,9.0,-110,-110,-120,-1.5,130,4.29,Comerica Park,15,1
2015-09-08,2015,SEA,TEX,6,9,117,1.5,-145,7.0,105,-125,-127,-1.5,125,3.23,T-Mobile Park,15,-3
2015-09-08,2015,BOS,TOR,1,5,117,1.5,-145,10.5,100,-120,-127,-1.5,125,4.84,Fenway Park,6,-4
2015-09-08,2015,NYM,WSH,8,7,-105,1.5,-235,7.5,-105,-115,-105,-1.5,195,3.84,Nationals Park,15,1
2015-09-09,2015,SF,ARI,1,2,108,1.5,-215,8.0,-115,-105,-118,-1.5,185,3.85,Chase Field,3,-1
2015-09-09,2015,PHI,ATL,1,8,119,1.5,-135,9.0,-105,-115,-134,-1.5,115,4.11,Citizens Bank Park,9,-7
2015-09-09,2015,NYY,BAL,3,5,-140,-1.5,150,9.0,105,-125,125,1.5,-170,5.25,Yankee Stadium,8,-2
2015-09-09,2015,TOR,BOS,4,10,-124,-1.5,125,10.5,100,-120,114,1.5,-145,5.81,Fenway Park,14,-6
2015-09-09,2015,STL,CHC,4,3,-130,-1.5,170,7.0,100,-120,115,1.5,-200,3.96,Busch Stadium,7,1
2015-09-09,2015,PIT,CIN,5,4,-170,-1.5,-115,8.5,-125,105,150,1.5,-105,5.35,Great American Ballpark,9,1
2015-09-09,2015,CWS,CLE,4,6,101,1.5,-165,7.5,-110,-110,-111,-1.5,145,3.73,Guaranteed Rate Field,10,-2
2015-09-09,2015,SD,COL,11,4,-170,-1.5,125,7.5,-120,100,150,1.5,-145,4.72,PETCO Park,15,7
2015-09-09,2015,CLE,CWS,6,4,-111,-1.5,145,7.5,-110,-110,101,1.5,-165,3.95,Guaranteed Rate Field,10,2
2015-09-09,2015,TB,DET,8,0,-140,-1.5,115,9.0,-110,-110,125,1.5,-135,5.25,Comerica Park,8,8
2015-09-09,2015,OAK,HOU,5,11,149,1.5,-110,8.0,100,-120,-164,-1.5,-110,3.21,Oakland Coliseum,16,-6
2015-09-09,2015,MIN,KC,3,2,172,1.5,-118,8.5,-110,-110,-202,-1.5,-102,3.13,Kauffman Stadium,5,1
2015-09-09,2015,LAD,LAA,2,3,145,1.5,-155,8.5,-120,100,-160,-1.5,135,3.47,Angel Stadium,5,-1
2015-09-09,2015,LAA,LAD,3,2,-160,-1.5,135,8.5,-120,100,145,1.5,-155,5.23,Angel Stadium,5,1
2015-09-09,2015,MIL,MIA,2,5,115,1.5,-200,8.0,-115,-105,-125,-1.5,170,3.72,Marlins Park,7,-3
2015-09-09,2015,MIA,MIL,5,2,-125,-1.5,170,8.0,-115,-105,115,1.5,-200,4.44,Marlins Park,7,3
2015-09-09,2015,KC,MIN,2,3,-202,-1.5,-102,8.5,-110,-110,172,1.5,-118,5.69,Kauffman Stadium,5,-1
2015-09-09,2015,WSH,NYM,3,5,102,1.5,-170,7.5,100,-120,-112,-1.5,150,3.71,Nationals Park,8,-2
2015-09-09,2015,BAL,NYY,5,3,125,1.5,-170,9.0,105,-125,-140,-1.5,150,4.0,Yankee Stadium,8,2
2015-09-09,2015,HOU,OAK,11,5,-164,-1.5,-110,8.0,100,-120,149,1.5,-110,4.97,Oakland Coliseum,16,6
2015-09-09,2015,ATL,PHI,8,1,-134,-1.5,115,9.0,-105,-115,119,1.5,-135,5.15,Citizens Bank Park,9,7
2015-09-09,2015,CIN,PIT,4,5,150,1.5,-105,8.5,-125,105,-170,-1.5,-115,3.4,Great American Ballpark,9,-1
2015-09-09,2015,COL,SD,4,11,150,1.5,-145,7.5,-120,100,-170,-1.5,125,3.0,PETCO Park,15,-7
2015-09-09,2015,TEX,SEA,0,6,-123,-1.5,135,7.5,-106,-114,113,1.5,-155,4.14,T-Mobile Park,6,-6
2015-09-09,2015,ARI,SF,2,1,-118,-1.5,185,8.0,-115,-105,108,1.5,-215,4.33,Chase Field,3,1
2015-09-09,2015,CHC,STL,3,4,115,1.5,-200,7.0,100,-120,-130,-1.5,170,3.26,Busch Stadium,7,-1
2015-09-09,2015,DET,TB,0,8,125,1.5,-135,9.0,-110,-110,-140,-1.5,115,4.0,Comerica Park,8,-8
2015-09-09,2015,SEA,TEX,6,0,113,1.5,-155,7.5,-106,-114,-123,-1.5,135,3.52,T-Mobile Park,6,6
2015-09-09,2015,BOS,TOR,10,4,114,1.5,-145,10.5,100,-120,-124,-1.5,125,4.91,Fenway Park,14,6
2015-09-09,2015,NYM,WSH,5,3,-112,-1.5,150,7.5,100,-120,102,1.5,-170,3.96,Nationals Park,8,2
2015-09-10,2015,NYM,ATL,7,2,-111,-1.5,145,7.5,-120,100,101,1.5,-165,3.95,Turner Field,9,5
2015-09-10,2015,STL,CIN,0,11,-131,-1.5,120,7.5,-120,100,116,1.5,-140,4.25,Great American Ballpark,11,-11
2015-09-10,2015,DET,CLE,5,7,170,1.5,-120,8.0,-115,-105,-200,-1.5,100,2.96,Progressive Field,12,-2
2015-09-10,2015,SD,COL,3,4,-160,-1.5,135,7.5,-105,-115,145,1.5,-155,4.62,PETCO Park,7,-1
2015-09-10,2015,CLE,DET,7,5,-200,-1.5,100,8.0,-115,-105,170,1.5,-120,5.33,Progressive Field,12,2
2015-09-10,2015,PIT,MIL,4,6,-181,-1.5,110,8.0,-110,-110,161,1.5,-130,5.15,PNC Park,10,-2
2015-09-10,2015,ATL,NYM,2,7,101,1.5,-165,7.5,-120,100,-111,-1.5,145,3.73,Turner Field,9,-5
2015-09-10,2015,MIL,PIT,6,4,161,1.5,-130,8.0,-110,-110,-181,-1.5,110,3.07,PNC Park,10,2
2015-09-10,2015,COL,SD,4,3,145,1.5,-155,7.5,-105,-115,-160,-1.5,135,3.06,PETCO Park,7,1
2015-09-10,2015,TEX,SEA,0,5,101,1.5,-230,7.0,110,-130,-111,-1.5,190,3.48,T-Mobile Park,5,-5
2015-09-10,2015,CIN,STL,11,0,116,1.5,-140,7.5,-120,100,-131,-1.5,120,3.47,Great American Ballpark,11,11
2015-09-10,2015,SEA,TEX,5,0,-111,-1.5,190,7.0,110,-130,101,1.5,-230,3.68,T-Mobile Park,5,5
2015-09-11,2015,LAD,ARI,4,12,-105,-1.5,150,8.5,-105,-115,-105,1.5,-170,4.35,Chase Field,16,-8
2015-09-11,2015,NYM,ATL,5,1,-207,-1.5,-130,8.0,-105,-115,177,1.5,110,5.39,Turner Field,6,4
2015-09-11,2015,KC,BAL,8,14,-120,-1.5,135,9.0,100,-120,110,1.5,-155,4.91,Camden Yards,22,-6
2015-09-11,2015,TB,BOS,8,4,-153,-1.5,150,7.0,100,-120,138,1.5,-170,4.23,Tropicana Field,12,4
2015-09-11,2015,PHI,CHC,1,5,255,1.5,152,7.0,-125,105,-305,-1.5,-172,1.97,Citizens Bank Park,6,-4
2015-09-11,2015,PHI,CHC,3,7,180,1.5,120,9.0,100,-120,-210,-1.5,-140,3.21,Citizens Bank Park,10,-4
2015-09-11,2015,STL,CIN,2,4,-157,-1.5,-104,8.0,-115,-105,142,1.5,-116,4.89,Great American Ballpark,6,-2
2015-09-11,2015,SEA,COL,2,4,-200,-1.5,100,7.5,-110,-110,170,1.5,-120,5.0,T-Mobile Park,6,-2
2015-09-11,2015,MIN,CWS,6,2,-102,1.5,-230,8.0,-120,100,-108,-1.5,190,4.04,Guaranteed Rate Field,8,4
2015-09-11,2015,LAA,HOU,3,2,141,1.5,-120,7.5,-119,-101,-156,-1.5,100,3.11,Angel Stadium,5,1
2015-09-11,2015,BAL,KC,14,8,110,1.5,-155,9.0,100,-120,-120,-1.5,135,4.29,Camden Yards,22,6
2015-09-11,2015,HOU,LAA,2,3,-156,-1.5,100,7.5,-119,-101,141,1.5,-120,4.57,Angel Stadium,5,-1
2015-09-11,2015,ARI,LAD,12,4,-105,1.5,-170,8.5,-105,-115,-105,-1.5,150,4.35,Chase Field,16,8
2015-09-11,2015,WSH,MIA,1,2,-149,-1.5,110,7.5,-110,-110,134,1.5,-130,4.49,Marlins Park,3,-1
2015-09-11,2015,PIT,MIL,6,3,-173,-1.5,120,7.5,-105,-115,153,1.5,-140,4.75,PNC Park,9,3
2015-09-11,2015,CWS,MIN,2,6,-108,-1.5,190,8.0,-120,100,-102,1.5,-230,4.15,Guaranteed Rate Field,8,-4
2015-09-11,2015,ATL,NYM,1,5,177,1.5,110,8.0,-105,-115,-207,-1.5,-130,2.89,Turner Field,6,-4
2015-09-11,2015,TOR,NYY,11,5,-152,-1.5,101,7.5,100,-120,137,1.5,-121,4.52,Yankee Stadium,16,6
2015-09-11,2015,TEX,OAK,4,0,-131,-1.5,150,9.0,-120,100,116,1.5,-170,5.1,Rangers Ballpark,4,4
2015-09-11,2015,CHC,PHI,5,1,-305,-1.5,-172,7.0,-125,105,255,1.5,152,5.27,Citizens Bank Park,6,4
2015-09-11,2015,CHC,PHI,7,3,-210,-1.5,-140,9.0,100,-120,180,1.5,120,6.1,Citizens Bank Park,10,4
2015-09-11,2015,MIL,PIT,3,6,153,1.5,-140,7.5,-105,-115,-173,-1.5,120,2.96,PNC Park,9,-3
2015-09-11,2015,SF,SD,9,1,-124,-1.5,176,7.5,100,-120,114,1.5,-206,4.15,AT&T Park,10,8
2015-09-11,2015,COL,SEA,4,2,170,1.5,-120,7.5,-110,-110,-200,-1.5,100,2.78,T-Mobile Park,6,2
2015-09-11,2015,SD,SF,1,9,114,1.5,-206,7.5,100,-120,-124,-1.5,176,3.5,AT&T Park,10,-8
2015-09-11,2015,CIN,STL,4,2,142,1.5,-116,8.0,-115,-105,-157,-1.5,-104,3.31,Great American Ballpark,6,2
2015-09-11,2015,BOS,TB,4,8,138,1.5,-170,7.0,100,-120,-153,-1.5,150,2.94,Tropicana Field,12,-4
2015-09-11,2015,OAK,TEX,0,4,116,1.5,-170,9.0,-120,100,-131,-1.5,150,4.17,Rangers Ballpark,4,-4
2015-09-11,2015,NYY,TOR,5,11,137,1.5,-121,7.5,100,-120,-152,-1.5,101,3.16,Yankee Stadium,16,-6
2015-09-11,2015,MIA,WSH,2,1,134,1.5,-130,7.5,-110,-110,-149,-1.5,110,3.21,Marlins Park,3,1
2015-09-12,2015,LAD,ARI,9,5,-121,-1.5,130,8.5,-120,100,111,1.5,-150,4.65,Chase Field,14,4
2015-09-12,2015,NYM,ATL,6,4,-196,-1.5,-130,8.0,100,-120,176,1.5,110,5.3,Turner Field,10,2
2015-09-12,2015,KC,BAL,14,6,-128,-1.5,125,8.5,-110,-110,118,1.5,-145,4.77,Camden Yards,20,8
2015-09-12,2015,TB,BOS,4,10,105,1.5,-160,8.0,-120,100,-115,-1.5,140,3.9,Tropicana Field,14,-6
2015-09-12,2015,PHI,CHC,7,5,158,1.5,105,8.5,-115,-105,-178,-1.5,-125,3.29,Citizens Bank Park,12,2
2015-09-12,2015,STL,CIN,1,5,-124,-1.5,125,7.5,-110,-110,114,1.5,-145,4.15,Great American Ballpark,6,-4
2015-09-12,2015,SEA,COL,7,2,-190,-1.5,120,8.0,100,-120,170,1.5,-140,5.24,T-Mobile Park,9,5
2015-09-12,2015,MIN,CWS,2,8,106,1.5,-210,7.5,-105,-115,-116,-1.5,180,3.64,Guaranteed Rate Field,10,-6
2015-09-12,2015,LAA,HOU,3,2,117,1.5,-150,8.0,-119,-101,-127,-1.5,130,3.69,Angel Stadium,5,1
2015-09-12,2015,BAL,KC,6,14,118,1.5,-145,8.5,-110,-110,-128,-1.5,125,3.9,Camden Yards,20,-8
2015-09-12,2015,HOU,LAA,2,3,-127,-1.5,130,8.0,-119,-101,117,1.5,-150,4.48,Angel Stadium,5,-1
2015-09-12,2015,ARI,LAD,5,9,111,1.5,-150,8.5,-120,100,-121,-1.5,130,4.03,Chase Field,14,-4
2015-09-12,2015,WSH,MIA,0,2,137,1.5,-165,7.0,100,-120,-152,-1.5,145,2.95,Marlins Park,2,-2
2015-09-12,2015,PIT,MIL,10,2,-177,-1.5,125,7.5,-110,-110,157,1.5,-145,4.79,PNC Park,12,8
2015-09-12,2015,CWS,MIN,8,2,-116,-1.5,180,7.5,-105,-115,106,1.5,-210,4.03,Guaranteed Rate Field,10,6
2015-09-12,2015,ATL,NYM,4,6,176,1.5,110,8.0,100,-120,-196,-1.5,-130,2.9,Turner Field,10,-2
2015-09-12,2015,TOR,NYY,9,5,125,1.5,-175,8.5,-120,100,-140,-1.5,155,3.78,Yankee Stadium,14,4
2015-09-12,2015,TOR,NYY,10,7,-128,-1.5,125,9.0,-105,-115,118,1.5,-145,5.05,Yankee Stadium,17,3
2015-09-12,2015,TEX,OAK,3,5,-178,-1.5,115,8.5,-120,100,158,1.5,-135,5.44,Rangers Ballpark,8,-2
2015-09-12,2015,CHC,PHI,5,7,-178,-1.5,-125,8.5,-115,-105,158,1.5,105,5.44,Citizens Bank Park,12,-2
2015-09-12,2015,MIL,PIT,2,10,157,1.5,-145,7.5,-110,-110,-177,-1.5,125,2.92,PNC Park,12,-8
2015-09-12,2015,SF,SD,8,0,-205,-1.5,115,6.5,-115,-105,175,1.5,-135,4.37,AT&T Park,8,8
2015-09-12,2015,COL,SEA,2,7,170,1.5,-140,8.0,100,-120,-190,-1.5,120,2.96,T-Mobile Park,9,-5
2015-09-12,2015,SD,SF,0,8,175,1.5,-135,6.5,-115,-105,-205,-1.5,115,2.36,AT&T Park,8,-8
2015-09-12,2015,CIN,STL,5,1,114,1.5,-145,7.5,-110,-110,-124,-1.5,125,3.5,Great American Ballpark,6,4
2015-09-12,2015,BOS,TB,10,4,-115,-1.5,140,8.0,-120,100,105,1.5,-160,4.28,Tropicana Field,14,6
2015-09-12,2015,OAK,TEX,5,3,158,1.5,-135,8.5,-120,100,-178,-1.5,115,3.29,Rangers Ballpark,8,2
2015-09-12,2015,NYY,TOR,5,9,-140,-1.5,155,8.5,-120,100,125,1.5,-175,4.96,Yankee Stadium,14,-4
2015-09-12,2015,NYY,TOR,7,10,118,1.5,-145,9.0,-105,-115,-128,-1.5,125,4.13,Yankee Stadium,17,-3
2015-09-12,2015,MIA,WSH,2,0,-152,-1.5,145,7.0,100,-120,137,1.5,-165,4.22,Marlins Park,2,2
2015-09-13,2015,LAD,ARI,4,3,-140,-1.5,120,7.0,-124,104,125,1.5,-140,4.08,Chase Field,7,1
2015-09-13,2015,NYM,ATL,10,7,-147,-1.5,105,8.0,-105,-115,132,1.5,-125,4.76,Turner Field,17,3
2015-09-13,2015,KC,BAL,2,8,-146,-1.5,110,8.0,100,-120,131,1.5,-130,4.75,Camden Yards,10,-6
2015-09-13,2015,TB,BOS,0,2,-160,-1.5,135,7.5,-105,-115,145,1.5,-155,4.62,Tropicana Field,2,-2
2015-09-13,2015,PHI,CHC,7,4,165,1.5,-101,9.0,100,-120,-185,-1.5,-119,3.4,Citizens Bank Park,11,3
2015-09-13,2015,STL,CIN,9,2,-142,-1.5,120,7.5,101,-121,127,1.5,-140,4.4,Great American Ballpark,11,7
2015-09-13,2015,DET,CLE,2,7,-101,1.5,-215,7.5,105,-125,-109,-1.5,185,3.77,Progressive Field,9,-5
2015-09-13,2015,DET,CLE,9,2,162,1.5,-110,8.5,-115,-105,-182,-1.5,-110,3.24,Progressive Field,11,7
2015-09-13,2015,SEA,COL,2,3,-198,-1.5,105,8.0,-110,-110,178,1.5,-125,5.32,T-Mobile Park,5,-1
2015-09-13,2015,MIN,CWS,7,0,163,1.5,-135,7.0,-115,-105,-183,-1.5,115,2.66,Guaranteed Rate Field,7,7
2015-09-13,2015,CLE,DET,7,2,-109,-1.5,185,7.5,105,-125,-101,1.5,-215,3.91,Progressive Field,9,5
2015-09-13,2015,CLE,DET,2,9,-182,-1.5,-110,8.5,-115,-105,162,1.5,-110,5.49,Progressive Field,11,-7
2015-09-13,2015,LAA,HOU,3,5,104,1.5,-160,8.0,-121,101,-114,-1.5,140,3.92,Angel Stadium,8,-2
2015-09-13,2015,BAL,KC,8,2,131,1.5,-130,8.0,100,-120,-146,-1.5,110,3.46,Camden Yards,10,6
2015-09-13,2015,HOU,LAA,5,3,-114,-1.5,140,8.0,-121,101,104,1.5,-160,4.26,Angel Stadium,8,2
2015-09-13,2015,ARI,LAD,3,4,125,1.5,-140,7.0,-124,104,-140,-1.5,120,3.11,Chase Field,7,-1
2015-09-13,2015,WSH,MIA,5,0,-210,-1.5,-128,7.5,100,-120,180,1.5,108,5.08,Marlins Park,5,5
2015-09-13,2015,PIT,MIL,7,6,-205,-1.5,104,7.0,-104,-116,175,1.5,-124,4.7,PNC Park,13,1
2015-09-13,2015,CWS,MIN,0,7,-183,-1.5,115,7.0,-115,-105,163,1.5,-135,4.53,Guaranteed Rate Field,7,-7
2015-09-13,2015,ATL,NYM,7,10,132,1.5,-125,8.0,-105,-115,-147,-1.5,105,3.45,Turner Field,17,-3
2015-09-13,2015,TOR,NYY,0,5,131,1.5,-160,8.5,-120,100,-146,-1.5,140,3.68,Yankee Stadium,5,-5
2015-09-13,2015,TEX,OAK,12,4,-142,-1.5,140,9.5,-110,-110,127,1.5,-160,5.57,Rangers Ballpark,16,8
2015-09-13,2015,CHC,PHI,4,7,-185,-1.5,-119,9.0,100,-120,165,1.5,-101,5.84,Citizens Bank Park,11,-3
2015-09-13,2015,MIL,PIT,6,7,175,1.5,-124,7.0,-104,-116,-205,-1.5,104,2.55,PNC Park,13,-1
2015-09-13,2015,SF,SD,10,3,-176,-1.5,120,7.5,-120,100,156,1.5,-140,4.78,AT&T Park,13,7
2015-09-13,2015,COL,SEA,3,2,178,1.5,-125,8.0,-110,-110,-198,-1.5,105,2.88,T-Mobile Park,5,1
2015-09-13,2015,SD,SF,3,10,156,1.5,-140,7.5,-120,100,-176,-1.5,120,2.93,AT&T Park,13,-7
2015-09-13,2015,CIN,STL,2,9,127,1.5,-140,7.5,101,-121,-142,-1.5,120,3.3,Great American Ballpark,11,-7
2015-09-13,2015,BOS,TB,2,0,145,1.5,-155,7.5,-105,-115,-160,-1.5,135,3.06,Tropicana Field,2,2
2015-09-13,2015,OAK,TEX,4,12,127,1.5,-160,9.5,-110,-110,-142,-1.5,140,4.19,Rangers Ballpark,16,-8
2015-09-13,2015,NYY,TOR,5,0,-146,-1.5,140,8.5,-120,100,131,1.5,-160,5.04,Yankee Stadium,5,5
2015-09-13,2015,MIA,WSH,0,5,180,1.5,108,7.5,100,-120,-210,-1.5,-128,2.68,Marlins Park,5,-5
2015-09-14,2015,SD,ARI,10,3,100,1.5,-215,8.5,-115,-105,-110,-1.5,185,4.25,Chase Field,13,7
2015-09-14,2015,BOS,BAL,0,2,140,1.5,-153,8.0,-105,-115,-155,-1.5,133,3.33,Camden Yards,2,-2
2015-09-14,2015,BAL,BOS,2,0,-155,-1.5,133,8.0,-105,-115,140,1.5,-153,4.86,Camden Yards,2,2
2015-09-14,2015,SF,CIN,5,3,-161,-1.5,130,8.0,100,-120,146,1.5,-150,4.93,AT&T Park,8,2
2015-09-14,2015,KC,CLE,3,8,137,1.5,-160,7.5,-115,-105,-152,-1.5,140,3.16,Progressive Field,11,-5
2015-09-14,2015,LAD,COL,4,1,-382,-1.5,-149,6.0,-102,-118,322,1.5,130,4.76,Dodger Stadium,5,3
2015-09-14,2015,OAK,CWS,7,8,-137,-1.5,110,7.5,-120,100,122,1.5,-130,4.34,Guaranteed Rate Field,15,-1
2015-09-14,2015,MIN,DET,7,1,-173,-1.5,115,9.5,100,-120,153,1.5,-135,6.02,Target Field,8,6
2015-09-14,2015,TEX,HOU,5,3,-109,-1.5,180,8.0,-120,100,-101,1.5,-210,4.17,Rangers Ballpark,8,2
2015-09-14,2015,CLE,KC,8,3,-152,-1.5,140,7.5,-115,-105,137,1.5,-160,4.52,Progressive Field,11,5
2015-09-14,2015,SEA,LAA,10,1,-101,1.5,-169,7.0,-115,-105,-109,-1.5,149,3.52,T-Mobile Park,11,9
2015-09-14,2015,COL,LAD,1,4,322,1.5,130,6.0,-102,-118,-382,-1.5,-149,1.42,Dodger Stadium,5,-3
2015-09-14,2015,NYM,MIA,4,3,-200,-1.5,103,8.0,-105,-115,170,1.5,-123,5.33,Citi Field,7,1
2015-09-14,2015,DET,MIN,1,7,153,1.5,-135,9.5,100,-120,-173,-1.5,115,3.75,Target Field,8,-6
2015-09-14,2015,MIA,NYM,3,4,170,1.5,-123,8.0,-105,-115,-200,-1.5,103,2.96,Citi Field,7,-1
2015-09-14,2015,TB,NYY,1,4,-109,-1.5,190,7.5,-110,-110,-101,1.5,-230,3.91,Tropicana Field,5,-3
2015-09-14,2015,CWS,OAK,8,7,122,1.5,-130,7.5,-120,100,-137,-1.5,110,3.38,Guaranteed Rate Field,15,1
2015-09-14,2015,WSH,PHI,8,7,-156,-1.5,100,7.0,-125,105,141,1.5,-120,4.27,Citizens Bank Park,15,1
2015-09-14,2015,ARI,SD,3,10,-110,-1.5,185,8.5,-115,-105,100,1.5,-215,4.45,Chase Field,13,-7
2015-09-14,2015,LAA,SEA,1,10,-109,-1.5,149,7.0,-115,-105,-101,1.5,-169,3.65,T-Mobile Park,11,-9
2015-09-14,2015,CIN,SF,3,5,146,1.5,-150,8.0,100,-120,-161,-1.5,130,3.25,AT&T Park,8,-2
2015-09-14,2015,NYY,TB,4,1,-101,1.5,-230,7.5,-110,-110,-109,-1.5,190,3.77,Tropicana Field,5,3
2015-09-14,2015,HOU,TEX,3,5,-101,1.5,-210,8.0,-120,100,-109,-1.5,180,4.02,Rangers Ballpark,8,-2
2015-09-14,2015,PHI,WSH,7,8,141,1.5,-120,7.0,-125,105,-156,-1.5,100,2.9,Citizens Bank Park,15,-1
2015-09-15,2015,SD,ARI,4,6,-104,1.5,-224,8.5,100,-120,-106,-1.5,192,4.33,Chase Field,10,-2
2015-09-15,2015,TOR,ATL,2,3,-147,-1.5,100,7.5,-115,-105,132,1.5,-120,4.46,Turner Field,5,-1
2015-09-15,2015,BOS,BAL,5,6,125,1.5,-165,8.5,-105,-115,-140,-1.5,145,3.78,Camden Yards,11,-1
2015-09-15,2015,BAL,BOS,6,5,-140,-1.5,145,8.5,-105,-115,125,1.5,-165,4.96,Camden Yards,11,1
2015-09-15,2015,PIT,CHC,5,4,-155,-1.5,140,7.0,-130,110,140,1.5,-160,4.25,PNC Park,9,1
2015-09-15,2015,PIT,CHC,1,2,-118,-1.5,185,7.0,100,-120,108,1.5,-215,3.79,PNC Park,3,-1
2015-09-15,2015,SF,CIN,8,9,-133,-1.5,166,7.0,-130,110,118,1.5,-197,4.0,AT&T Park,17,-1
2015-09-15,2015,KC,CLE,2,0,-115,-1.5,140,7.5,-115,-105,105,1.5,-160,4.01,Progressive Field,2,2
2015-09-15,2015,LAD,COL,4,5,-195,-1.5,100,7.5,-105,-115,175,1.5,-120,4.96,Dodger Stadium,9,-1
2015-09-15,2015,OAK,CWS,17,6,144,1.5,-145,8.0,-125,105,-159,-1.5,125,3.28,Guaranteed Rate Field,23,11
2015-09-15,2015,MIN,DET,4,5,-151,-1.5,125,9.0,-130,110,136,1.5,-145,5.41,Target Field,9,-1
2015-09-15,2015,TEX,HOU,6,5,-114,-1.5,170,8.5,-130,110,104,1.5,-200,4.53,Rangers Ballpark,11,1
2015-09-15,2015,CLE,KC,0,2,105,1.5,-160,7.5,-115,-105,-115,-1.5,140,3.66,Progressive Field,2,-2
2015-09-15,2015,SEA,LAA,3,4,-175,-1.5,120,7.0,105,-125,155,1.5,-140,4.45,T-Mobile Park,7,-1
2015-09-15,2015,COL,LAD,5,4,175,1.5,-120,7.5,-105,-115,-195,-1.5,100,2.73,Dodger Stadium,9,1
2015-09-15,2015,NYM,MIA,3,9,-260,-1.5,-115,7.0,-115,-105,220,1.5,-105,5.06,Citi Field,12,-6
2015-09-15,2015,STL,MIL,3,1,-178,-1.5,-105,8.0,-105,-115,158,1.5,-115,5.12,Miller Park,4,2
2015-09-15,2015,DET,MIN,5,4,136,1.5,-145,9.0,-130,110,-151,-1.5,125,3.81,Target Field,9,1
2015-09-15,2015,MIA,NYM,9,3,220,1.5,-105,7.0,-115,-105,-260,-1.5,-115,2.19,Citi Field,12,6
2015-09-15,2015,TB,NYY,6,3,-108,-1.5,190,7.5,110,-130,-102,1.5,-230,3.89,Tropicana Field,9,3
2015-09-15,2015,CWS,OAK,6,17,-159,-1.5,125,8.0,-125,105,144,1.5,-145,4.91,Guaranteed Rate Field,23,-11
2015-09-15,2015,WSH,PHI,4,0,-255,-1.5,-140,8.5,-108,-112,215,1.5,120,6.11,Citizens Bank Park,4,4
2015-09-15,2015,CHC,PIT,4,5,140,1.5,-160,7.0,-130,110,-155,-1.5,140,2.92,PNC Park,9,-1
2015-09-15,2015,CHC,PIT,2,1,108,1.5,-215,7.0,100,-120,-118,-1.5,185,3.37,PNC Park,3,1
2015-09-15,2015,ARI,SD,6,4,-106,-1.5,192,8.5,100,-120,-104,1.5,-224,4.37,Chase Field,10,2
2015-09-15,2015,LAA,SEA,4,3,155,1.5,-140,7.0,105,-125,-175,-1.5,120,2.75,T-Mobile Park,7,1
2015-09-15,2015,CIN,SF,9,8,118,1.5,-197,7.0,-130,110,-133,-1.5,166,3.21,AT&T Park,17,1
2015-09-15,2015,MIL,STL,1,3,158,1.5,-115,8.0,-105,-115,-178,-1.5,-105,3.1,Miller Park,4,-2
2015-09-15,2015,NYY,TB,3,6,-102,1.5,-230,7.5,110,-130,-108,-1.5,190,3.79,Tropicana Field,9,-3
2015-09-15,2015,HOU,TEX,5,6,104,1.5,-200,8.5,-130,110,-114,-1.5,170,4.17,Rangers Ballpark,11,-1
2015-09-15,2015,ATL,TOR,3,2,132,1.5,-120,7.5,-115,-105,-147,-1.5,100,3.23,Turner Field,5,1
2015-09-15,2015,PHI,WSH,0,4,215,1.5,120,8.5,-108,-112,-255,-1.5,-140,2.7,Citizens Bank Park,4,-4
2015-09-16,2015,SD,ARI,4,3,117,1.5,-180,9.0,-105,-115,-132,-1.5,160,4.15,Chase Field,7,1
2015-09-16,2015,TOR,ATL,9,1,-240,-1.5,-143,6.5,-120,100,200,1.5,123,4.59,Turner Field,10,8
2015-09-16,2015,BOS,BAL,10,1,116,1.5,-180,9.0,-110,-110,-131,-1.5,160,4.17,Camden Yards,11,9
2015-09-16,2015,BAL,BOS,1,10,-131,-1.5,160,9.0,-110,-110,116,1.5,-180,5.1,Camden Yards,11,-9
2015-09-16,2015,PIT,CHC,2,3,131,1.5,-129,7.0,-110,-110,-146,-1.5,109,3.03,PNC Park,5,-1
2015-09-16,2015,SF,CIN,5,3,-175,-1.5,120,8.0,-105,-115,155,1.5,-140,5.09,AT&T Park,8,2
2015-09-16,2015,KC,CLE,1,5,111,1.5,-201,7.5,-115,-105,-121,-1.5,171,3.55,Progressive Field,6,-4
2015-09-16,2015,LAD,COL,2,0,-160,-1.5,140,7.0,-125,105,145,1.5,-160,4.31,Dodger Stadium,2,2
2015-09-16,2015,OAK,CWS,4,9,135,1.5,-155,9.0,-104,-116,-150,-1.5,135,3.83,Guaranteed Rate Field,13,-5
2015-09-16,2015,MIN,DET,4,7,-171,-1.5,115,9.0,-110,-110,151,1.5,-136,5.68,Target Field,11,-3
2015-09-16,2015,TEX,HOU,14,3,151,1.5,-111,8.5,-120,100,-171,-1.5,-109,3.39,Rangers Ballpark,17,11
2015-09-16,2015,CLE,KC,5,1,-121,-1.5,171,7.5,-115,-105,111,1.5,-201,4.11,Progressive Field,6,4
2015-09-16,2015,SEA,LAA,3,1,-144,-1.5,155,7.5,-115,-105,129,1.5,-175,4.43,T-Mobile Park,4,2
2015-09-16,2015,COL,LAD,0,2,145,1.5,-160,7.0,-125,105,-160,-1.5,140,2.86,Dodger Stadium,2,-2
2015-09-16,2015,NYM,MIA,0,6,-195,-1.5,100,7.5,-120,100,175,1.5,-120,4.96,Citi Field,6,-6
2015-09-16,2015,STL,MIL,5,4,-183,-1.5,-115,8.0,-105,-115,163,1.5,-105,5.17,Miller Park,9,1
2015-09-16,2015,DET,MIN,7,4,151,1.5,-136,9.0,-110,-110,-171,-1.5,115,3.59,Target Field,11,3
2015-09-16,2015,MIA,NYM,6,0,175,1.5,-120,7.5,-120,100,-195,-1.5,100,2.73,Citi Field,6,6
2015-09-16,2015,TB,NYY,1,3,-119,-1.5,170,7.0,110,-130,109,1.5,-200,3.8,Tropicana Field,4,-2
2015-09-16,2015,CWS,OAK,9,4,-150,-1.5,135,9.0,-104,-116,135,1.5,-155,5.4,Guaranteed Rate Field,13,5
2015-09-16,2015,WSH,PHI,12,2,-230,-1.5,-135,8.5,-110,-110,200,1.5,115,5.92,Citizens Bank Park,14,10
2015-09-16,2015,CHC,PIT,3,2,-146,-1.5,109,7.0,-110,-110,131,1.5,-129,4.15,PNC Park,5,1
2015-09-16,2015,ARI,SD,3,4,-132,-1.5,160,9.0,-105,-115,117,1.5,-180,5.12,Chase Field,7,-1
2015-09-16,2015,LAA,SEA,1,3,129,1.5,-175,7.5,-115,-105,-144,-1.5,155,3.28,T-Mobile Park,4,-2
2015-09-16,2015,CIN,SF,3,5,155,1.5,-140,8.0,-105,-115,-175,-1.5,120,3.14,AT&T Park,8,-2
2015-09-16,2015,MIL,STL,4,5,163,1.5,-105,8.0,-105,-115,-183,-1.5,-115,3.04,Miller Park,9,-1
2015-09-16,2015,NYY,TB,3,1,109,1.5,-200,7.0,110,-130,-119,-1.5,170,3.35,Tropicana Field,4,2
2015-09-16,2015,HOU,TEX,3,14,-171,-1.5,-109,8.5,-120,100,151,1.5,-111,5.36,Rangers Ballpark,17,-11
2015-09-16,2015,ATL,TOR,1,9,200,1.5,123,6.5,-120,100,-240,-1.5,-143,2.17,Turner Field,10,-8
2015-09-16,2015,PHI,WSH,2,12,200,1.5,115,8.5,-110,-110,-230,-1.5,-135,2.83,Citizens Bank Park,14,-10
2015-09-17,2015,TOR,ATL,5,0,-173,-1.5,-125,8.5,-105,-115,153,1.5,105,5.39,Turner Field,5,5
2015-09-17,2015,TB,BAL,3,4,115,1.5,-150,8.5,-116,-104,-125,-1.5,130,3.95,Tropicana Field,7,-1
2015-09-17,2015,PIT,CHC,6,9,-107,-1.5,190,8.5,-115,-105,-103,1.5,-230,4.39,PNC Park,15,-3
2015-09-17,2015,KC,CLE,8,4,119,1.5,-200,7.0,100,-120,-129,-1.5,170,3.2,Progressive Field,12,4
2015-09-17,2015,OAK,CWS,4,2,143,1.5,-150,8.5,100,-120,-158,-1.5,130,3.5,Guaranteed Rate Field,6,2
2015-09-17,2015,TEX,HOU,8,2,113,1.5,-150,9.5,-116,-104,-123,-1.5,130,4.46,Rangers Ballpark,10,6
2015-09-17,2015,CLE,KC,4,8,-129,-1.5,170,7.0,100,-120,119,1.5,-200,3.94,Progressive Field,12,-4
2015-09-17,2015,MIN,LAA,8,11,-122,-1.5,175,9.5,-110,-110,112,1.5,-205,5.22,Target Field,19,-3
2015-09-17,2015,WSH,MIA,4,6,-162,-1.5,135,8.0,-115,-105,147,1.5,-155,4.95,Nationals Park,10,-2
2015-09-17,2015,STL,MIL,6,3,-125,-1.5,130,7.5,-120,100,115,1.5,-150,4.17,Miller Park,9,3
2015-09-17,2015,LAA,MIN,11,8,112,1.5,-205,9.5,-110,-110,-122,-1.5,175,4.48,Target Field,19,3
2015-09-17,2015,CWS,OAK,2,4,-158,-1.5,130,8.5,100,-120,143,1.5,-150,5.21,Guaranteed Rate Field,6,-2
2015-09-17,2015,CHC,PIT,9,6,-103,1.5,-230,8.5,-115,-105,-107,-1.5,190,4.31,PNC Park,15,3
2015-09-17,2015,MIL,STL,3,6,115,1.5,-150,7.5,-120,100,-125,-1.5,130,3.49,Miller Park,9,-3
2015-09-17,2015,BAL,TB,4,3,-125,-1.5,130,8.5,-116,-104,115,1.5,-150,4.72,Tropicana Field,7,1
2015-09-17,2015,HOU,TEX,2,8,-123,-1.5,130,9.5,-116,-104,113,1.5,-150,5.24,Rangers Ballpark,10,-6
2015-09-17,2015,ATL,TOR,0,5,153,1.5,105,8.5,-105,-115,-173,-1.5,-125,3.36,Turner Field,5,-5
2015-09-17,2015,MIA,WSH,6,4,147,1.5,-155,8.0,-115,-105,-162,-1.5,135,3.24,Nationals Park,10,2
2015-09-18,2015,SF,ARI,0,2,-230,-1.5,-113,6.5,-120,100,200,1.5,-107,4.53,AT&T Park,2,-2
2015-09-18,2015,PHI,ATL,1,2,113,1.5,-200,8.5,100,-120,-123,-1.5,170,3.99,Turner Field,3,-1
2015-09-18,2015,TB,BAL,8,6,-120,-1.5,177,7.5,-105,-115,110,1.5,-207,4.09,Tropicana Field,14,2
2015-09-18,2015,TOR,BOS,6,1,-178,-1.5,-101,9.0,101,-121,158,1.5,-119,5.76,Rogers Centre,7,5
2015-09-18,2015,STL,CHC,3,8,100,1.5,-215,9.0,-116,-104,-110,-1.5,185,4.5,Wrigley Field,11,-5
2015-09-18,2015,MIL,CIN,3,5,-113,-1.5,170,8.5,-120,100,103,1.5,-200,4.51,Miller Park,8,-2
2015-09-18,2015,CWS,CLE,1,12,-145,-1.5,115,7.0,-120,100,130,1.5,-135,4.14,Progressive Field,13,-11
2015-09-18,2015,SD,COL,4,7,106,1.5,-180,10.5,-110,-110,-116,-1.5,160,5.1,Coors Field,11,-3
2015-09-18,2015,CLE,CWS,12,1,130,1.5,-135,7.0,-120,100,-145,-1.5,115,3.04,Progressive Field,13,11
2015-09-18,2015,KC,DET,4,5,-119,-1.5,140,8.0,-120,100,109,1.5,-160,4.35,Comerica Park,9,-1
2015-09-18,2015,OAK,HOU,4,3,179,1.5,-109,8.5,-105,-115,-209,-1.5,-111,3.05,Minute Maid Park,7,1
2015-09-18,2015,DET,KC,5,4,109,1.5,-160,8.0,-120,100,-119,-1.5,140,3.83,Comerica Park,9,1
2015-09-18,2015,PIT,LAD,2,6,157,1.5,-140,7.0,105,-125,-177,-1.5,120,2.72,Dodger Stadium,8,-4
2015-09-18,2015,WSH,MIA,5,4,-149,-1.5,155,6.5,-105,-115,134,1.5,-175,3.89,Nationals Park,9,1
2015-09-18,2015,CIN,MIL,5,3,103,1.5,-200,8.5,-120,100,-113,-1.5,170,4.19,Miller Park,8,2
2015-09-18,2015,NYY,NYM,1,5,101,1.5,-230,7.0,105,-125,-111,-1.5,190,3.48,Citi Field,6,-4
2015-09-18,2015,NYM,NYY,5,1,-111,-1.5,190,7.0,105,-125,101,1.5,-230,3.68,Citi Field,6,4
2015-09-18,2015,HOU,OAK,3,4,-209,-1.5,-111,8.5,-105,-115,179,1.5,-109,5.75,Minute Maid Park,7,-1
2015-09-18,2015,ATL,PHI,2,1,-123,-1.5,170,8.5,100,-120,113,1.5,-200,4.69,Turner Field,3,1
2015-09-18,2015,LAD,PIT,6,2,-177,-1.5,120,7.0,105,-125,157,1.5,-140,4.47,Dodger Stadium,8,4
2015-09-18,2015,COL,SD,7,4,-116,-1.5,160,10.5,-110,-110,106,1.5,-180,5.64,Coors Field,11,3
2015-09-18,2015,TEX,SEA,1,3,-115,-1.5,170,9.5,-120,100,105,1.5,-200,5.08,Rangers Ballpark,4,-2
2015-09-18,2015,ARI,SF,2,0,200,1.5,-107,6.5,-120,100,-230,-1.5,-113,2.17,AT&T Park,2,2
2015-09-18,2015,CHC,STL,8,3,-110,-1.5,185,9.0,-116,-104,100,1.5,-215,4.71,Wrigley Field,11,5
2015-09-18,2015,BAL,TB,6,8,110,1.5,-207,7.5,-105,-115,-120,-1.5,177,3.57,Tropicana Field,14,-2
2015-09-18,2015,SEA,TEX,3,1,105,1.5,-200,9.5,-120,100,-115,-1.5,170,4.63,Rangers Ballpark,4,2
2015-09-18,2015,BOS,TOR,1,6,158,1.5,-119,9.0,101,-121,-178,-1.5,-101,3.49,Rogers Centre,7,-5
2015-09-18,2015,MIA,WSH,4,5,134,1.5,-175,6.5,-105,-115,-149,-1.5,155,2.78,Nationals Park,9,-1
2015-09-19,2015,SF,ARI,0,6,111,1.5,-170,7.0,-120,100,-121,-1.5,150,3.32,AT&T Park,6,-6
2015-09-19,2015,PHI,ATL,1,2,125,1.5,-175,8.0,-105,-115,-140,-1.5,155,3.56,Turner Field,3,-1
2015-09-19,2015,TB,BAL,1,2,104,1.5,-165,7.5,-105,-115,-114,-1.5,145,3.68,Tropicana Field,3,-1
2015-09-19,2015,TOR,BOS,6,7,-170,-1.5,120,9.0,-115,-105,150,1.5,-140,5.67,Rogers Centre,13,-1
2015-09-19,2015,STL,CHC,4,5,-124,-1.5,145,7.0,-110,-110,114,1.5,-165,3.88,Wrigley Field,9,-1
2015-09-19,2015,MIL,CIN,7,9,-140,-1.5,150,8.5,100,-120,125,1.5,-170,4.96,Miller Park,16,-2
2015-09-19,2015,CWS,CLE,4,3,170,1.5,-125,7.0,100,-120,-200,-1.5,105,2.59,Progressive Field,7,1
2015-09-19,2015,SD,COL,2,10,-106,-1.5,145,11.5,-105,-115,-104,1.5,-165,5.92,Coors Field,12,-8
2015-09-19,2015,CLE,CWS,3,4,-200,-1.5,105,7.0,100,-120,170,1.5,-125,4.67,Progressive Field,7,-1
2015-09-19,2015,KC,DET,5,6,-142,-1.5,112,9.5,-122,102,127,1.5,-132,5.57,Comerica Park,11,-1
2015-09-19,2015,OAK,HOU,6,10,126,1.5,-175,8.0,-110,-110,-141,-1.5,155,3.54,Minute Maid Park,16,-4
2015-09-19,2015,DET,KC,6,5,127,1.5,-132,9.5,-122,102,-142,-1.5,112,4.19,Comerica Park,11,1
2015-09-19,2015,MIN,LAA,3,4,-116,-1.5,180,8.0,-115,-105,106,1.5,-210,4.3,Target Field,7,-1
2015-09-19,2015,MIN,LAA,2,5,125,1.5,-135,8.0,-120,100,-140,-1.5,115,3.56,Target Field,7,-3
2015-09-19,2015,PIT,LAD,3,2,162,1.5,-145,6.0,-110,-110,-182,-1.5,125,2.29,Dodger Stadium,5,1
2015-09-19,2015,WSH,MIA,5,2,-230,-1.5,-105,8.0,-120,100,200,1.5,-115,5.58,Nationals Park,7,3
2015-09-19,2015,CIN,MIL,9,7,125,1.5,-170,8.5,100,-120,-140,-1.5,150,3.78,Miller Park,16,2
2015-09-19,2015,LAA,MIN,4,3,106,1.5,-210,8.0,-115,-105,-116,-1.5,180,3.88,Target Field,7,1
2015-09-19,2015,LAA,MIN,5,2,-140,-1.5,115,8.0,-120,100,125,1.5,-135,4.67,Target Field,7,3
2015-09-19,2015,NYY,NYM,5,0,104,1.5,-215,7.0,-105,-115,-114,-1.5,185,3.43,Citi Field,5,5
2015-09-19,2015,NYM,NYY,0,5,-114,-1.5,185,7.0,-105,-115,104,1.5,-215,3.73,Citi Field,5,-5
2015-09-19,2015,HOU,OAK,10,6,-141,-1.5,155,8.0,-110,-110,126,1.5,-175,4.68,Minute Maid Park,16,4
2015-09-19,2015,ATL,PHI,2,1,-140,-1.5,155,8.0,-105,-115,125,1.5,-175,4.67,Turner Field,3,1
2015-09-19,2015,LAD,PIT,2,3,-182,-1.5,125,6.0,-110,-110,162,1.5,-145,3.87,Dodger Stadium,5,-1
2015-09-19,2015,COL,SD,10,2,-104,1.5,-165,11.5,-105,-115,-106,-1.5,145,5.86,Coors Field,12,8
2015-09-19,2015,TEX,SEA,10,1,-182,-1.5,100,9.0,105,-125,162,1.5,-120,5.81,Rangers Ballpark,11,9
2015-09-19,2015,ARI,SF,6,0,-121,-1.5,150,7.0,-120,100,111,1.5,-170,3.83,AT&T Park,6,6
2015-09-19,2015,CHC,STL,5,4,114,1.5,-165,7.0,-110,-110,-124,-1.5,145,3.27,Wrigley Field,9,1
2015-09-19,2015,BAL,TB,2,1,-114,-1.5,145,7.5,-105,-115,104,1.5,-165,4.0,Tropicana Field,3,1
2015-09-19,2015,SEA,TEX,1,10,162,1.5,-120,9.0,105,-125,-182,-1.5,100,3.44,Rangers Ballpark,11,-9
2015-09-19,2015,BOS,TOR,7,6,150,1.5,-140,9.0,-115,-105,-170,-1.5,120,3.6,Rogers Centre,13,1
2015-09-19,2015,MIA,WSH,2,5,200,1.5,-115,8.0,-120,100,-230,-1.5,-105,2.67,Nationals Park,7,-3
2015-09-20,2015,SF,ARI,5,1,-139,-1.5,155,8.0,-110,-110,124,1.5,-175,4.65,AT&T Park,6,4
2015-09-20,2015,PHI,ATL,1,2,130,1.5,-165,7.5,100,-120,-145,-1.5,145,3.26,Turner Field,3,-1
2015-09-20,2015,TB,BAL,7,6,110,1.5,-155,7.0,-114,-106,-120,-1.5,135,3.33,Tropicana Field,13,1
2015-09-20,2015,TOR,BOS,3,4,-190,-1.5,100,9.0,-115,-105,170,1.5,-120,5.9,Rogers Centre,7,-1
2015-09-20,2015,STL,CHC,4,3,129,1.5,-175,7.0,-120,100,-144,-1.5,155,3.06,Wrigley Field,7,1
2015-09-20,2015,MIL,CIN,8,4,105,1.5,-160,7.5,-105,-115,-115,-1.5,140,3.66,Miller Park,12,4
2015-09-20,2015,CWS,CLE,3,6,156,1.5,-133,7.5,-115,-105,-176,-1.5,113,2.93,Progressive Field,9,-3
2015-09-20,2015,SD,COL,10,4,-125,-1.5,120,11.5,-105,-115,115,1.5,-140,6.39,Coors Field,14,6
2015-09-20,2015,CLE,CWS,6,3,-176,-1.5,113,7.5,-115,-105,156,1.5,-133,4.78,Progressive Field,9,3
2015-09-20,2015,KC,DET,10,3,-154,-1.5,105,8.5,100,-120,139,1.5,-125,5.15,Comerica Park,13,7
2015-09-20,2015,OAK,HOU,1,5,189,1.5,-108,8.5,-120,100,-219,-1.5,-112,2.94,Minute Maid Park,6,-4
2015-09-20,2015,DET,KC,3,10,139,1.5,-125,8.5,100,-120,-154,-1.5,105,3.56,Comerica Park,13,-7
2015-09-20,2015,MIN,LAA,8,1,-109,-1.5,185,8.5,-115,-105,-101,1.5,-215,4.43,Target Field,9,7
2015-09-20,2015,PIT,LAD,4,3,-128,-1.5,130,7.5,-120,100,118,1.5,-150,4.21,Dodger Stadium,7,1
2015-09-20,2015,WSH,MIA,13,3,-270,-1.5,-135,7.5,-105,-115,230,1.5,115,5.47,Nationals Park,16,10
2015-09-20,2015,CIN,MIL,4,8,-115,-1.5,140,7.5,-105,-115,105,1.5,-160,4.01,Miller Park,12,-4
2015-09-20,2015,LAA,MIN,1,8,-101,1.5,-215,8.5,-115,-105,-109,-1.5,185,4.27,Target Field,9,-7
2015-09-20,2015,NYY,NYM,11,2,149,1.5,-155,7.0,100,-120,-164,-1.5,135,2.81,Citi Field,13,9
2015-09-20,2015,NYM,NYY,2,11,-164,-1.5,135,7.0,100,-120,149,1.5,-155,4.35,Citi Field,13,-9
2015-09-20,2015,HOU,OAK,5,1,-219,-1.5,-112,8.5,-120,100,189,1.5,-108,5.84,Minute Maid Park,6,4
2015-09-20,2015,ATL,PHI,2,1,-145,-1.5,145,7.5,100,-120,130,1.5,-165,4.44,Turner Field,3,1
2015-09-20,2015,LAD,PIT,3,4,118,1.5,-150,7.5,-120,100,-128,-1.5,130,3.44,Dodger Stadium,7,-1
2015-09-20,2015,COL,SD,4,10,115,1.5,-140,11.5,-105,-115,-125,-1.5,120,5.35,Coors Field,14,-6
2015-09-20,2015,TEX,SEA,2,9,-103,1.5,-170,8.0,-105,-115,-107,-1.5,150,4.06,Rangers Ballpark,11,-7
2015-09-20,2015,ARI,SF,1,5,124,1.5,-175,8.0,-110,-110,-139,-1.5,155,3.57,AT&T Park,6,-4
2015-09-20,2015,CHC,STL,3,4,-144,-1.5,155,7.0,-120,100,129,1.5,-175,4.13,Wrigley Field,7,-1
2015-09-20,2015,BAL,TB,6,7,-120,-1.5,135,7.0,-114,-106,110,1.5,-155,3.82,Tropicana Field,13,-1
2015-09-20,2015,SEA,TEX,9,2,-107,-1.5,150,8.0,-105,-115,-103,1.5,-170,4.14,Rangers Ballpark,11,7
2015-09-20,2015,BOS,TOR,4,3,170,1.5,-120,9.0,-115,-105,-190,-1.5,100,3.33,Rogers Centre,7,1
2015-09-20,2015,MIA,WSH,3,13,230,1.5,115,7.5,-105,-115,-270,-1.5,-135,2.27,Nationals Park,16,-10
2015-09-21,2015,LAD,ARI,4,8,-170,-1.5,125,8.0,-122,102,150,1.5,-145,5.04,Dodger Stadium,12,-4
2015-09-21,2015,NYM,ATL,4,0,-172,-1.5,130,7.0,-125,105,152,1.5,-150,4.43,Citi Field,4,4
2015-09-21,2015,TB,BOS,7,8,-115,-1.5,140,8.0,100,-120,105,1.5,-160,4.28,Fenway Park,15,-1
2015-09-21,2015,MIL,CHC,5,9,182,1.5,-104,8.0,-101,-119,-212,-1.5,-117,2.84,Wrigley Field,14,-4
2015-09-21,2015,STL,CIN,2,1,-172,-1.5,125,7.0,-120,100,152,1.5,-145,4.43,Busch Stadium,3,1
2015-09-21,2015,PIT,COL,9,3,-105,-1.5,150,11.0,-120,100,-105,1.5,-170,5.63,Coors Field,12,6
2015-09-21,2015,DET,CWS,0,2,134,1.5,-130,9.0,-105,-115,-149,-1.5,110,3.85,Comerica Park,2,-2
2015-09-21,2015,DET,CWS,2,3,-109,-1.5,180,9.0,100,-120,-101,1.5,-210,4.69,Comerica Park,5,-1
2015-09-21,2015,CWS,DET,2,0,-149,-1.5,110,9.0,-105,-115,134,1.5,-130,5.39,Comerica Park,2,2
2015-09-21,2015,CWS,DET,3,2,-101,1.5,-210,9.0,100,-120,-109,-1.5,180,4.52,Comerica Park,5,1
2015-09-21,2015,LAA,HOU,3,6,180,1.5,-120,8.5,-106,-114,-210,-1.5,100,3.04,Minute Maid Park,9,-3
2015-09-21,2015,HOU,LAA,6,3,-210,-1.5,100,8.5,-106,-114,180,1.5,-120,5.76,Minute Maid Park,9,3
2015-09-21,2015,ARI,LAD,8,4,150,1.5,-145,8.0,-122,102,-170,-1.5,125,3.2,Dodger Stadium,12,4
2015-09-21,2015,CHC,MIL,9,5,-212,-1.5,-117,8.0,-101,-119,182,1.5,-104,5.44,Wrigley Field,14,4
2015-09-21,2015,ATL,NYM,0,4,152,1.5,-150,7.0,-125,105,-172,-1.5,130,2.78,Citi Field,4,-4
2015-09-21,2015,TOR,NYY,4,2,-230,-1.5,-115,7.5,-120,100,200,1.5,-104,5.23,Rogers Centre,6,2
2015-09-21,2015,COL,PIT,3,9,-105,1.5,-170,11.0,-120,100,-105,-1.5,150,5.63,Coors Field,12,-6
2015-09-21,2015,CIN,STL,1,2,152,1.5,-145,7.0,-120,100,-172,-1.5,125,2.78,Busch Stadium,3,-1
2015-09-21,2015,BOS,TB,8,7,105,1.5,-160,8.0,100,-120,-115,-1.5,140,3.9,Fenway Park,15,1
2015-09-21,2015,NYY,TOR,2,4,200,1.5,-104,7.5,-120,100,-230,-1.5,-115,2.5,Rogers Centre,6,-2
2015-09-22,2015,LAD,ARI,0,8,-145,-1.5,145,7.5,-110,-110,130,1.5,-165,4.44,Dodger Stadium,8,-8
2015-09-22,2015,NYM,ATL,2,6,-190,-1.5,105,7.5,-110,-110,170,1.5,-125,4.91,Citi Field,8,-4
2015-09-22,2015,WSH,BAL,1,4,-142,-1.5,150,7.0,-120,100,127,1.5,-170,4.11,Nationals Park,5,-3
2015-09-22,2015,TB,BOS,5,2,106,1.5,-205,9.0,100,-120,-116,-1.5,175,4.37,Fenway Park,7,3
2015-09-22,2015,MIL,CHC,0,4,285,1.5,140,7.5,-115,-105,-335,-1.5,-161,1.95,Wrigley Field,4,-4
2015-09-22,2015,STL,CIN,3,1,-195,-1.5,110,7.5,100,-120,175,1.5,-130,4.96,Busch Stadium,4,2
2015-09-22,2015,MIN,CLE,3,1,107,1.5,-155,8.0,-115,-105,-117,-1.5,135,3.86,Target Field,4,2
2015-09-22,2015,PIT,COL,6,3,-143,-1.5,113,11.0,-120,100,128,1.5,-133,6.47,Coors Field,9,3
2015-09-22,2015,DET,CWS,2,1,103,1.5,-165,8.0,-110,-110,-113,-1.5,145,3.94,Comerica Park,3,1
2015-09-22,2015,CWS,DET,1,2,-113,-1.5,145,8.0,-110,-110,103,1.5,-165,4.24,Comerica Park,3,-1
2015-09-22,2015,LAA,HOU,4,3,151,1.5,-135,8.5,-110,-110,-171,-1.5,115,3.39,Minute Maid Park,7,1
2015-09-22,2015,SEA,KC,11,2,100,1.5,-205,8.0,-120,100,-110,-1.5,175,4.0,Kauffman Stadium,13,9
2015-09-22,2015,HOU,LAA,3,4,-171,-1.5,115,8.5,-110,-110,151,1.5,-135,5.36,Minute Maid Park,7,-1
2015-09-22,2015,ARI,LAD,8,0,130,1.5,-165,7.5,-110,-110,-145,-1.5,145,3.26,Dodger Stadium,8,8
2015-09-22,2015,PHI,MIA,6,2,153,1.5,-140,7.5,-110,-110,-173,-1.5,120,2.96,Marlins Park,8,4
2015-09-22,2015,CHC,MIL,4,0,-335,-1.5,-161,7.5,-115,-105,285,1.5,140,5.78,Wrigley Field,4,4
2015-09-22,2015,CLE,MIN,1,3,-117,-1.5,135,8.0,-115,-105,107,1.5,-155,4.31,Target Field,4,-2
2015-09-22,2015,ATL,NYM,6,2,170,1.5,-125,7.5,-110,-110,-190,-1.5,105,2.78,Citi Field,8,4
2015-09-22,2015,TOR,NYY,4,6,101,1.5,-190,8.5,100,-120,-111,-1.5,160,4.23,Rogers Centre,10,-2
2015-09-22,2015,TEX,OAK,8,6,-115,-1.5,145,8.0,-120,100,105,1.5,-165,4.28,Oakland Coliseum,14,2
2015-09-22,2015,MIA,PHI,2,6,-173,-1.5,120,7.5,-110,-110,153,1.5,-140,4.75,Marlins Park,8,-4
2015-09-22,2015,COL,PIT,3,6,128,1.5,-133,11.0,-120,100,-143,-1.5,113,4.82,Coors Field,9,-3
2015-09-22,2015,SF,SD,4,2,138,1.5,-190,7.0,100,-120,-153,-1.5,160,2.94,PETCO Park,6,2
2015-09-22,2015,KC,SEA,2,11,-110,-1.5,175,8.0,-120,100,100,1.5,-205,4.19,Kauffman Stadium,13,-9
2015-09-22,2015,SD,SF,2,4,-153,-1.5,160,7.0,100,-120,138,1.5,-190,4.23,PETCO Park,6,-2
2015-09-22,2015,CIN,STL,1,3,175,1.5,-130,7.5,100,-120,-195,-1.5,110,2.73,Busch Stadium,4,-2
2015-09-22,2015,BOS,TB,2,5,-116,-1.5,175,9.0,100,-120,106,1.5,-205,4.83,Fenway Park,7,-3
2015-09-22,2015,OAK,TEX,6,8,105,1.5,-165,8.0,-120,100,-115,-1.5,145,3.9,Oakland Coliseum,14,-2
2015-09-22,2015,NYY,TOR,6,4,-111,-1.5,160,8.5,100,-120,101,1.5,-190,4.47,Rogers Centre,10,2
2015-09-22,2015,BAL,WSH,4,1,127,1.5,-170,7.0,-120,100,-142,-1.5,150,3.08,Nationals Park,5,3
2015-09-23,2015,LAD,ARI,4,1,-151,-1.5,145,8.0,-120,100,136,1.5,-165,4.81,Dodger Stadium,5,3
2015-09-23,2015,NYM,ATL,3,6,-232,-1.5,-115,8.0,-105,-115,202,1.5,-105,5.59,Citi Field,9,-3
2015-09-23,2015,WSH,BAL,3,4,-184,-1.5,120,7.0,105,-125,164,1.5,-140,4.54,Nationals Park,7,-1
2015-09-23,2015,TB,BOS,6,2,107,1.5,-200,8.5,100,-120,-117,-1.5,170,4.11,Fenway Park,8,4
2015-09-23,2015,MIL,CHC,4,1,200,1.5,-109,7.5,-120,100,-230,-1.5,-111,2.5,Wrigley Field,5,3
2015-09-23,2015,STL,CIN,10,2,-155,-1.5,140,7.0,-120,100,140,1.5,-160,4.25,Busch Stadium,12,8
2015-09-23,2015,MIN,CLE,4,2,118,1.5,-145,7.5,100,-120,-133,-1.5,125,3.44,Target Field,6,2
2015-09-23,2015,PIT,COL,13,7,-140,-1.5,110,11.0,-110,-110,125,1.5,-130,6.42,Coors Field,20,6
2015-09-23,2015,DET,CWS,7,4,-132,-1.5,155,8.0,100,-120,117,1.5,-175,4.55,Comerica Park,11,3
2015-09-23,2015,CWS,DET,4,7,117,1.5,-175,8.0,100,-120,-132,-1.5,155,3.69,Comerica Park,11,-3
2015-09-23,2015,LAA,HOU,6,5,155,1.5,-140,8.5,-120,100,-175,-1.5,120,3.33,Minute Maid Park,11,1
2015-09-23,2015,SEA,KC,3,4,171,1.5,-135,8.0,-110,-110,-191,-1.5,115,2.95,Kauffman Stadium,7,-1
2015-09-23,2015,HOU,LAA,5,6,-175,-1.5,120,8.5,-120,100,155,1.5,-140,5.41,Minute Maid Park,11,-1
2015-09-23,2015,ARI,LAD,1,4,136,1.5,-165,8.0,-120,100,-151,-1.5,145,3.39,Dodger Stadium,5,-3
2015-09-23,2015,PHI,MIA,3,4,165,1.5,-135,8.0,100,-120,-185,-1.5,115,3.02,Marlins Park,7,-1
2015-09-23,2015,CHC,MIL,1,4,-230,-1.5,-111,7.5,-120,100,200,1.5,-109,5.23,Wrigley Field,5,-3
2015-09-23,2015,CLE,MIN,2,4,-133,-1.5,125,7.5,100,-120,118,1.5,-145,4.28,Target Field,6,-2
2015-09-23,2015,ATL,NYM,6,3,202,1.5,-105,8.0,-105,-115,-232,-1.5,-115,2.65,Citi Field,9,3
2015-09-23,2015,TOR,NYY,4,0,-191,-1.5,100,8.5,-127,107,171,1.5,-120,5.58,Rogers Centre,4,4
2015-09-23,2015,TEX,OAK,10,3,-117,-1.5,140,9.0,110,-130,107,1.5,-160,4.85,Oakland Coliseum,13,7
2015-09-23,2015,MIA,PHI,4,3,-185,-1.5,115,8.0,100,-120,165,1.5,-135,5.19,Marlins Park,7,1
2015-09-23,2015,COL,PIT,7,13,125,1.5,-130,11.0,-110,-110,-140,-1.5,110,4.89,Coors Field,20,-6
2015-09-23,2015,SF,SD,4,5,104,1.5,-230,7.0,-125,105,-114,-1.5,190,3.43,PETCO Park,9,-1
2015-09-23,2015,KC,SEA,4,3,-191,-1.5,115,8.0,-110,-110,171,1.5,-135,5.25,Kauffman Stadium,7,1
2015-09-23,2015,SD,SF,5,4,-114,-1.5,190,7.0,-125,105,104,1.5,-230,3.73,PETCO Park,9,1
2015-09-23,2015,CIN,STL,2,10,140,1.5,-160,7.0,-120,100,-155,-1.5,140,2.92,Busch Stadium,12,-8
2015-09-23,2015,BOS,TB,2,6,-117,-1.5,170,8.5,100,-120,107,1.5,-200,4.58,Fenway Park,8,-4
2015-09-23,2015,OAK,TEX,3,10,107,1.5,-160,9.0,110,-130,-117,-1.5,140,4.35,Oakland Coliseum,13,-7
2015-09-23,2015,NYY,TOR,0,4,171,1.5,-120,8.5,-127,107,-191,-1.5,100,3.14,Rogers Centre,4,-4
2015-09-23,2015,BAL,WSH,4,3,164,1.5,-140,7.0,105,-125,-184,-1.5,120,2.65,Nationals Park,7,1
2015-09-24,2015,LAD,ARI,6,3,-221,-1.5,110,6.0,-115,-105,191,1.5,-130,4.13,Dodger Stadium,9,3
2015-09-24,2015,WSH,BAL,4,5,-143,-1.5,150,8.5,-108,-112,128,1.5,-170,5.0,Nationals Park,9,-1
2015-09-24,2015,TB,BOS,4,2,116,1.5,-180,8.0,-120,100,-131,-1.5,160,3.7,Fenway Park,6,2
2015-09-24,2015,NYM,CIN,6,4,-171,-1.5,-110,9.0,100,-120,151,1.5,-110,5.68,Great American Ballpark,10,2
2015-09-24,2015,MIN,CLE,3,6,-141,-1.5,160,7.5,-105,-115,126,1.5,-180,4.39,Target Field,9,-3
2015-09-24,2015,PIT,COL,5,4,-129,-1.5,120,11.0,100,-120,119,1.5,-140,6.2,Coors Field,9,1
2015-09-24,2015,NYY,CWS,3,2,-105,1.5,-170,7.0,105,-125,-105,-1.5,150,3.59,Yankee Stadium,5,1
2015-09-24,2015,SEA,KC,4,10,161,1.5,-140,8.0,100,-120,-181,-1.5,120,3.07,Kauffman Stadium,14,-6
2015-09-24,2015,ARI,LAD,3,6,191,1.5,-130,6.0,-115,-105,-221,-1.5,110,2.06,Dodger Stadium,9,-3
2015-09-24,2015,PHI,MIA,0,1,163,1.5,-130,7.5,-105,-115,-183,-1.5,110,2.85,Marlins Park,1,-1
2015-09-24,2015,STL,MIL,7,3,-200,-1.5,109,7.0,-105,-115,170,1.5,-129,4.67,Busch Stadium,10,4
2015-09-24,2015,CLE,MIN,6,3,126,1.5,-180,7.5,-105,-115,-141,-1.5,160,3.32,Target Field,9,3
2015-09-24,2015,CIN,NYM,4,6,151,1.5,-110,9.0,100,-120,-171,-1.5,-110,3.59,Great American Ballpark,10,-2
2015-09-24,2015,CWS,NYY,2,3,-105,-1.5,150,7.0,105,-125,-105,1.5,-170,3.59,Yankee Stadium,5,-1
2015-09-24,2015,TEX,OAK,8,1,-145,-1.5,110,8.0,-110,-110,130,1.5,-130,4.73,Oakland Coliseum,9,7
2015-09-24,2015,MIA,PHI,1,0,-183,-1.5,110,7.5,-105,-115,163,1.5,-130,4.85,Marlins Park,1,1
2015-09-24,2015,COL,PIT,4,5,119,1.5,-140,11.0,100,-120,-129,-1.5,120,5.02,Coors Field,9,-1
2015-09-24,2015,SF,SD,4,5,-134,-1.5,130,6.5,-125,105,119,1.5,-150,3.72,PETCO Park,9,-1
2015-09-24,2015,KC,SEA,10,4,-181,-1.5,120,8.0,100,-120,161,1.5,-140,5.15,Kauffman Stadium,14,6
2015-09-24,2015,SD,SF,5,4,119,1.5,-150,6.5,-125,105,-134,-1.5,130,2.97,PETCO Park,9,1
2015-09-24,2015,MIL,STL,3,7,170,1.5,-129,7.0,-105,-115,-200,-1.5,109,2.59,Busch Stadium,10,-4
2015-09-24,2015,BOS,TB,2,4,-131,-1.5,160,8.0,-120,100,116,1.5,-180,4.54,Fenway Park,6,-2
2015-09-24,2015,OAK,TEX,1,8,130,1.5,-130,8.0,-110,-110,-145,-1.5,110,3.48,Oakland Coliseum,9,-7
2015-09-24,2015,BAL,WSH,5,4,128,1.5,-170,8.5,-108,-112,-143,-1.5,150,3.73,Nationals Park,9,1
2015-09-25,2015,SD,ARI,3,6,110,1.5,-160,7.5,-120,100,-120,-1.5,140,3.57,PETCO Park,9,-3
2015-09-25,2015,MIA,ATL,12,11,-210,-1.5,-108,6.5,-115,-105,180,1.5,-111,4.4,Marlins Park,23,1
2015-09-25,2015,BOS,BAL,7,0,100,-1.5,190,8.0,-106,-114,-110,1.5,-230,4.0,Fenway Park,7,7
2015-09-25,2015,BAL,BOS,0,7,-110,1.5,-230,8.0,-106,-114,100,-1.5,190,4.19,Fenway Park,7,-7
2015-09-25,2015,PIT,CHC,3,2,-102,1.5,-240,6.5,-110,-110,-108,-1.5,200,3.28,Wrigley Field,5,1
2015-09-25,2015,NYM,CIN,12,5,-130,-1.5,128,7.0,-113,-107,115,1.5,-148,3.96,Great American Ballpark,17,7
2015-09-25,2015,KC,CLE,0,6,146,1.5,-117,7.0,-116,-104,-161,-1.5,-102,2.85,Kauffman Stadium,6,-6
2015-09-25,2015,LAD,COL,4,7,-143,-1.5,105,11.5,-101,-119,128,1.5,-125,6.77,Coors Field,11,-3
2015-09-25,2015,NYY,CWS,2,5,-145,-1.5,150,7.5,-105,-115,130,1.5,-170,4.44,Yankee Stadium,7,-3
2015-09-25,2015,MIN,DET,4,6,-106,-1.5,140,9.0,-105,-115,-104,1.5,-160,4.63,Comerica Park,10,-2
2015-09-25,2015,TEX,HOU,6,2,128,1.5,-165,8.0,-120,100,-143,-1.5,145,3.51,Minute Maid Park,8,4
2015-09-25,2015,CLE,KC,6,0,-161,-1.5,-102,7.0,-116,-104,146,1.5,-117,4.32,Kauffman Stadium,6,6
2015-09-25,2015,SEA,LAA,4,8,160,1.5,-135,7.5,-120,100,-180,-1.5,115,2.88,Angel Stadium,12,-4
2015-09-25,2015,COL,LAD,7,4,128,1.5,-125,11.5,-101,-119,-143,-1.5,105,5.04,Coors Field,11,3
2015-09-25,2015,ATL,MIA,11,12,180,1.5,-111,6.5,-115,-105,-210,-1.5,-108,2.32,Marlins Park,23,-1
2015-09-25,2015,STL,MIL,3,4,-215,-1.5,-105,7.0,105,-125,185,1.5,-115,4.78,Busch Stadium,7,-1
2015-09-25,2015,DET,MIN,6,4,-104,1.5,-160,9.0,-105,-115,-106,-1.5,140,4.59,Comerica Park,10,2
2015-09-25,2015,CIN,NYM,5,12,115,1.5,-148,7.0,-113,-107,-130,-1.5,128,3.26,Great American Ballpark,17,-7
2015-09-25,2015,CWS,NYY,5,2,130,1.5,-170,7.5,-105,-115,-145,-1.5,150,3.26,Yankee Stadium,7,3
2015-09-25,2015,SF,OAK,4,5,160,1.5,-141,7.0,-120,100,-180,-1.5,121,2.69,Oakland Coliseum,9,-1
2015-09-25,2015,WSH,PHI,2,8,-246,-1.5,-111,7.0,100,-120,206,1.5,-109,4.98,Nationals Park,10,-6
2015-09-25,2015,CHC,PIT,2,3,-108,-1.5,200,6.5,-110,-110,-102,1.5,-240,3.38,Wrigley Field,5,-1
2015-09-25,2015,ARI,SD,6,3,-120,-1.5,140,7.5,-120,100,110,1.5,-160,4.09,PETCO Park,9,3
2015-09-25,2015,LAA,SEA,8,4,-180,-1.5,115,7.5,-120,100,160,1.5,-135,4.82,Angel Stadium,12,4
2015-09-25,2015,OAK,SF,5,4,-180,-1.5,121,7.0,-120,100,160,1.5,-141,4.5,Oakland Coliseum,9,1
2015-09-25,2015,MIL,STL,4,3,185,1.5,-115,7.0,105,-125,-215,-1.5,-105,2.46,Busch Stadium,7,1
2015-09-25,2015,TOR,TB,5,3,-163,-1.5,122,8.0,-115,-105,148,1.5,-142,4.96,Rogers Centre,8,2
2015-09-25,2015,HOU,TEX,2,6,-143,-1.5,145,8.0,-120,100,128,1.5,-165,4.71,Minute Maid Park,8,-4
2015-09-25,2015,TB,TOR,3,5,148,1.5,-142,8.0,-115,-105,-163,-1.5,122,3.23,Rogers Centre,8,-2
2015-09-25,2015,PHI,WSH,8,2,206,1.5,-109,7.0,100,-120,-246,-1.5,-111,2.29,Nationals Park,10,6
2015-09-26,2015,SD,ARI,3,0,-105,1.5,-175,8.0,-120,100,-105,-1.5,155,4.1,PETCO Park,3,3
2015-09-26,2015,MIA,ATL,6,2,114,1.5,-155,7.5,-105,-115,-124,-1.5,135,3.5,Marlins Park,8,4
2015-09-26,2015,BOS,BAL,8,0,115,1.5,-150,8.5,-120,100,-125,-1.5,130,3.95,Fenway Park,8,8
2015-09-26,2015,BAL,BOS,0,8,-125,-1.5,130,8.5,-120,100,115,1.5,-150,4.72,Fenway Park,8,-8
2015-09-26,2015,PIT,CHC,4,0,-105,-1.5,140,7.0,-125,105,-105,1.5,-160,3.59,Wrigley Field,4,4
2015-09-26,2015,NYM,CIN,10,2,-155,-1.5,100,7.0,-120,100,140,1.5,-120,4.25,Great American Ballpark,12,8
2015-09-26,2015,KC,CLE,5,9,-123,-1.5,170,7.5,-110,-110,113,1.5,-200,4.14,Kauffman Stadium,14,-4
2015-09-26,2015,LAD,COL,6,8,-170,-1.5,-115,11.5,100,-120,150,1.5,-105,7.24,Coors Field,14,-2
2015-09-26,2015,NYY,CWS,2,1,-171,-1.5,110,8.5,-105,-115,151,1.5,-130,5.36,Yankee Stadium,3,1
2015-09-26,2015,MIN,DET,6,2,-134,-1.5,120,8.5,-115,-105,119,1.5,-140,4.87,Comerica Park,8,4
2015-09-26,2015,TEX,HOU,7,9,136,1.5,-165,8.0,-115,-105,-151,-1.5,145,3.39,Minute Maid Park,16,-2
2015-09-26,2015,CLE,KC,9,5,113,1.5,-200,7.5,-110,-110,-123,-1.5,170,3.52,Kauffman Stadium,14,4
2015-09-26,2015,SEA,LAA,2,3,-101,1.5,-230,7.5,-110,-110,-109,-1.5,190,3.77,Angel Stadium,5,-1
2015-09-26,2015,COL,LAD,8,6,150,1.5,-105,11.5,100,-120,-170,-1.5,-115,4.6,Coors Field,14,2
2015-09-26,2015,ATL,MIA,2,6,-124,-1.5,135,7.5,-105,-115,114,1.5,-155,4.15,Marlins Park,8,-4
2015-09-26,2015,STL,MIL,5,1,-230,-1.5,-110,7.5,100,-120,200,1.5,-110,5.23,Busch Stadium,6,4
2015-09-26,2015,DET,MIN,2,6,119,1.5,-140,8.5,-115,-105,-134,-1.5,120,3.88,Comerica Park,8,-4
2015-09-26,2015,CIN,NYM,2,10,140,1.5,-120,7.0,-120,100,-155,-1.5,100,2.92,Great American Ballpark,12,-8
2015-09-26,2015,CWS,NYY,1,2,151,1.5,-130,8.5,-105,-115,-171,-1.5,110,3.39,Yankee Stadium,3,-1
2015-09-26,2015,SF,OAK,14,10,-101,1.5,-215,8.0,-112,-108,-109,-1.5,185,4.02,Oakland Coliseum,24,4
2015-09-26,2015,WSH,PHI,2,1,-275,-1.5,-125,7.0,100,-120,235,1.5,105,5.13,Nationals Park,3,1
2015-09-26,2015,CHC,PIT,0,4,-105,1.5,-160,7.0,-125,105,-105,-1.5,140,3.59,Wrigley Field,4,-4
2015-09-26,2015,ARI,SD,0,3,-105,-1.5,155,8.0,-120,100,-105,1.5,-175,4.1,PETCO Park,3,-3
2015-09-26,2015,LAA,SEA,3,2,-109,-1.5,190,7.5,-110,-110,-101,1.5,-230,3.91,Angel Stadium,5,1
2015-09-26,2015,OAK,SF,10,14,-109,-1.5,185,8.0,-112,-108,-101,1.5,-215,4.17,Oakland Coliseum,24,-4
2015-09-26,2015,MIL,STL,1,5,200,1.5,-110,7.5,100,-120,-230,-1.5,-110,2.5,Busch Stadium,6,-4
2015-09-26,2015,TOR,TB,10,8,-195,-1.5,110,7.0,-109,-111,175,1.5,-130,4.63,Rogers Centre,18,2
2015-09-26,2015,HOU,TEX,9,7,-151,-1.5,145,8.0,-115,-105,136,1.5,-165,4.81,Minute Maid Park,16,2
2015-09-26,2015,TB,TOR,8,10,175,1.5,-130,7.0,-109,-111,-195,-1.5,110,2.55,Rogers Centre,18,-2
2015-09-26,2015,PHI,WSH,1,2,235,1.5,105,7.0,100,-120,-275,-1.5,-125,2.09,Nationals Park,3,-1
2015-09-27,2015,SD,ARI,2,4,-145,-1.5,145,7.5,-115,-105,130,1.5,-165,4.44,PETCO Park,6,-2
2015-09-27,2015,MIA,ATL,9,5,-140,-1.5,165,7.5,-105,-115,125,1.5,-185,4.38,Marlins Park,14,4
2015-09-27,2015,BOS,BAL,2,0,106,1.5,-150,9.0,-105,-115,-116,-1.5,130,4.37,Fenway Park,2,2
2015-09-27,2015,BAL,BOS,0,2,-116,-1.5,130,9.0,-105,-115,106,1.5,-150,4.83,Fenway Park,2,-2
2015-09-27,2015,PIT,CHC,0,4,160,1.5,-140,7.0,-120,100,-180,-1.5,120,2.69,Wrigley Field,4,-4
2015-09-27,2015,NYM,CIN,8,1,-127,-1.5,130,7.5,-110,-110,117,1.5,-150,4.2,Great American Ballpark,9,7
2015-09-27,2015,KC,CLE,3,0,112,1.5,-155,8.0,-120,100,-122,-1.5,135,3.77,Kauffman Stadium,3,3
2015-09-27,2015,LAD,COL,5,12,-160,-1.5,-110,11.5,-110,-110,145,1.5,-110,7.08,Coors Field,17,-7
2015-09-27,2015,NYY,CWS,6,1,-201,-1.5,105,7.5,-105,-115,171,1.5,-125,5.01,Yankee Stadium,7,5
2015-09-27,2015,MIN,DET,7,1,-131,-1.5,120,8.5,-115,-105,116,1.5,-140,4.82,Comerica Park,8,6
2015-09-27,2015,TEX,HOU,2,4,190,1.5,-115,8.0,-105,-115,-220,-1.5,-105,2.76,Minute Maid Park,6,-2
2015-09-27,2015,CLE,KC,0,3,-122,-1.5,135,8.0,-120,100,112,1.5,-155,4.4,Kauffman Stadium,3,-3
2015-09-27,2015,SEA,LAA,2,3,-111,-1.5,140,8.5,-110,-110,101,1.5,-160,4.47,Angel Stadium,5,-1
2015-09-27,2015,COL,LAD,12,5,145,1.5,-110,11.5,-110,-110,-160,-1.5,-110,4.69,Coors Field,17,7
2015-09-27,2015,ATL,MIA,5,9,125,1.5,-185,7.5,-105,-115,-140,-1.5,165,3.33,Marlins Park,14,-4
2015-09-27,2015,STL,MIL,4,8,-220,-1.5,-110,7.0,-110,-110,190,1.5,-110,4.81,Busch Stadium,12,-4
2015-09-27,2015,DET,MIN,1,7,116,1.5,-140,8.5,-115,-105,-131,-1.5,120,3.94,Comerica Park,8,-6
2015-09-27,2015,CIN,NYM,1,8,117,1.5,-150,7.5,-110,-110,-127,-1.5,130,3.46,Great American Ballpark,9,-7
2015-09-27,2015,CWS,NYY,1,6,171,1.5,-125,7.5,-105,-115,-201,-1.5,105,2.77,Yankee Stadium,7,-5
2015-09-27,2015,SF,OAK,5,4,-105,-1.5,150,8.5,-120,100,-105,1.5,-170,4.35,Oakland Coliseum,9,1
2015-09-27,2015,WSH,PHI,5,12,-220,-1.5,-105,7.5,-120,100,190,1.5,-115,5.16,Nationals Park,17,-7
2015-09-27,2015,CHC,PIT,4,0,-180,-1.5,120,7.0,-120,100,160,1.5,-140,4.5,Wrigley Field,4,4
2015-09-27,2015,ARI,SD,4,2,130,1.5,-165,7.5,-115,-105,-145,-1.5,145,3.26,PETCO Park,6,2
2015-09-27,2015,LAA,SEA,3,2,101,1.5,-160,8.5,-110,-110,-111,-1.5,140,4.23,Angel Stadium,5,1
2015-09-27,2015,OAK,SF,4,5,-105,1.5,-170,8.5,-120,100,-105,-1.5,150,4.35,Oakland Coliseum,9,-1
2015-09-27,2015,MIL,STL,8,4,190,1.5,-110,7.0,-110,-110,-220,-1.5,-110,2.41,Busch Stadium,12,4
2015-09-27,2015,TOR,TB,5,4,-171,-1.5,120,9.0,100,-120,151,1.5,-140,5.68,Rogers Centre,9,1
2015-09-27,2015,HOU,TEX,4,2,-220,-1.5,-105,8.0,-105,-115,190,1.5,-115,5.5,Minute Maid Park,6,2
2015-09-27,2015,TB,TOR,4,5,151,1.5,-140,9.0,100,-120,-171,-1.5,120,3.59,Rogers Centre,9,-1
2015-09-27,2015,PHI,WSH,12,5,190,1.5,-115,7.5,-120,100,-220,-1.5,-105,2.59,Nationals Park,17,7
2015-09-28,2015,TOR,BAL,4,3,-101,1.5,-210,9.0,-105,-115,-109,-1.5,180,4.52,Camden Yards,7,1
2015-09-28,2015,NYY,BOS,1,5,-126,-1.5,160,8.5,-110,-110,116,1.5,-180,4.74,Yankee Stadium,6,-4
2015-09-28,2015,KC,CHC,0,1,-120,-1.5,140,8.0,-105,-115,110,1.5,-160,4.36,Wrigley Field,1,-1
2015-09-28,2015,WSH,CIN,5,1,-190,-1.5,110,7.0,-120,100,170,1.5,-130,4.59,Nationals Park,6,4
2015-09-28,2015,MIN,CLE,4,2,150,1.5,-145,8.0,-110,-110,-170,-1.5,125,3.2,Progressive Field,6,2
2015-09-28,2015,TEX,DET,4,7,-147,-1.5,140,8.5,-115,-105,132,1.5,-160,5.06,Rangers Ballpark,11,-3
2015-09-28,2015,SEA,HOU,2,3,125,1.5,-140,7.5,100,-120,-140,-1.5,120,3.33,T-Mobile Park,5,-1
2015-09-28,2015,CHC,KC,1,0,110,1.5,-160,8.0,-105,-115,-120,-1.5,140,3.81,Wrigley Field,1,1
2015-09-28,2015,OAK,LAA,4,5,170,1.5,-124,9.0,100,-120,-190,-1.5,104,3.33,Angel Stadium,9,-1
2015-09-28,2015,SF,LAD,3,2,170,1.5,-110,6.5,100,-120,-190,-1.5,-110,2.41,AT&T Park,5,1
2015-09-28,2015,CLE,MIN,2,4,-170,-1.5,125,8.0,-110,-110,150,1.5,-145,5.04,Progressive Field,6,-2
2015-09-28,2015,BOS,NYY,5,1,116,1.5,-180,8.5,-110,-110,-126,-1.5,160,3.94,Yankee Stadium,6,4
2015-09-28,2015,LAA,OAK,5,4,-190,-1.5,104,9.0,100,-120,170,1.5,-124,5.9,Angel Stadium,9,1
2015-09-28,2015,STL,PIT,3,0,134,1.5,-170,7.0,-120,100,-149,-1.5,150,2.99,PNC Park,3,3
2015-09-28,2015,HOU,SEA,3,2,-140,-1.5,120,7.5,100,-120,125,1.5,-140,4.38,T-Mobile Park,5,1
2015-09-28,2015,LAD,SF,2,3,-190,-1.5,-110,6.5,100,-120,170,1.5,-110,4.26,AT&T Park,5,-1
2015-09-28,2015,PIT,STL,0,3,-149,-1.5,150,7.0,-120,100,134,1.5,-170,4.19,PNC Park,3,-3
2015-09-28,2015,DET,TEX,7,4,132,1.5,-160,8.5,-115,-105,-147,-1.5,140,3.66,Rangers Ballpark,11,3
2015-09-28,2015,BAL,TOR,3,4,-109,-1.5,180,9.0,-105,-115,-101,1.5,-210,4.69,Camden Yards,7,-1
2015-09-28,2015,CIN,WSH,1,5,170,1.5,-130,7.0,-120,100,-190,-1.5,110,2.59,Nationals Park,6,-4
2015-09-29,2015,COL,ARI,3,4,155,1.5,-130,9.0,-115,-105,-175,-1.5,110,3.53,Chase Field,7,-1
2015-09-29,2015,WSH,ATL,1,2,-140,-1.5,120,8.5,105,-125,125,1.5,-140,4.96,Turner Field,3,-1
2015-09-29,2015,NYY,BOS,4,10,-180,-1.5,107,8.0,-124,104,160,1.5,-127,5.14,Yankee Stadium,14,-6
2015-09-29,2015,CIN,CHC,1,4,125,1.5,-145,8.5,-115,-105,-140,-1.5,125,3.78,Great American Ballpark,5,-3
2015-09-29,2015,CHC,CIN,4,1,-140,-1.5,125,8.5,-115,-105,125,1.5,-145,4.96,Great American Ballpark,5,3
2015-09-29,2015,ARI,COL,4,3,-175,-1.5,110,9.0,-115,-105,155,1.5,-130,5.73,Chase Field,7,1
2015-09-29,2015,KC,CWS,2,4,-154,-1.5,105,8.0,-105,-115,139,1.5,-125,4.85,Guaranteed Rate Field,6,-2
2015-09-29,2015,TEX,DET,7,6,-177,-1.5,110,9.0,100,-120,157,1.5,-130,5.75,Rangers Ballpark,13,1
2015-09-29,2015,SEA,HOU,6,4,125,1.5,-145,7.5,-110,-110,-140,-1.5,125,3.33,T-Mobile Park,10,2
2015-09-29,2015,CWS,KC,4,2,139,1.5,-125,8.0,-105,-115,-154,-1.5,105,3.35,Guaranteed Rate Field,6,2
2015-09-29,2015,OAK,LAA,1,8,147,1.5,-140,8.5,100,-120,-162,-1.5,120,3.44,Angel Stadium,9,-7
2015-09-29,2015,SF,LAD,0,8,115,1.5,-165,5.5,118,-138,-130,-1.5,145,2.56,AT&T Park,8,-8
2015-09-29,2015,TB,MIA,4,2,-156,-1.5,135,7.5,-115,-105,141,1.5,-155,4.57,Tropicana Field,6,2
2015-09-29,2015,SD,MIL,3,4,-178,-1.5,115,7.0,105,-125,158,1.5,-135,4.48,PETCO Park,7,-1
2015-09-29,2015,PHI,NYM,4,3,165,1.5,100,9.0,-115,-105,-185,-1.5,-120,3.4,Citizens Bank Park,7,1
2015-09-29,2015,BOS,NYY,10,4,160,1.5,-127,8.0,-124,104,-180,-1.5,107,3.08,Yankee Stadium,14,6
2015-09-29,2015,LAA,OAK,8,1,-162,-1.5,120,8.5,100,-120,147,1.5,-140,5.26,Angel Stadium,9,7
2015-09-29,2015,NYM,PHI,3,4,-185,-1.5,-120,9.0,-115,-105,165,1.5,100,5.84,Citizens Bank Park,7,-1
2015-09-29,2015,MIL,SD,4,3,158,1.5,-135,7.0,105,-125,-178,-1.5,115,2.71,PETCO Park,7,1
2015-09-29,2015,HOU,SEA,4,6,-140,-1.5,125,7.5,-110,-110,125,1.5,-145,4.38,T-Mobile Park,10,-2
2015-09-29,2015,LAD,SF,8,0,-130,-1.5,145,5.5,118,-138,115,1.5,-165,3.11,AT&T Park,8,8
2015-09-29,2015,MIA,TB,2,4,141,1.5,-155,7.5,-115,-105,-156,-1.5,135,3.11,Tropicana Field,6,-2
2015-09-29,2015,DET,TEX,6,7,157,1.5,-130,9.0,100,-120,-177,-1.5,110,3.5,Rangers Ballpark,13,-1
2015-09-29,2015,ATL,WSH,2,1,125,1.5,-140,8.5,105,-125,-140,-1.5,120,3.78,Turner Field,3,1
2015-09-30,2015,COL,ARI,1,3,111,1.5,-205,9.0,-115,-105,-121,-1.5,175,4.27,Chase Field,4,-2
2015-09-30,2015,WSH,ATL,0,2,-174,-1.5,-105,7.5,-110,-110,154,1.5,-115,4.76,Turner Field,2,-2
2015-09-30,2015,TOR,BAL,15,2,-170,-1.5,-117,8.5,100,-120,150,1.5,-103,5.35,Camden Yards,17,13
2015-09-30,2015,TOR,BAL,1,8,119,1.5,-175,8.0,-109,-111,-134,-1.5,155,3.65,Camden Yards,9,-7
2015-09-30,2015,NYY,BOS,5,9,-164,-1.5,120,7.5,-105,-115,149,1.5,-140,4.66,Yankee Stadium,14,-4
2015-09-30,2015,CIN,CHC,3,10,150,1.5,-116,7.0,-120,100,-170,-1.5,-104,2.8,Great American Ballpark,13,-7
2015-09-30,2015,CHC,CIN,10,3,-170,-1.5,-104,7.0,-120,100,150,1.5,-116,4.41,Great American Ballpark,13,7
2015-09-30,2015,MIN,CLE,7,1,155,1.5,-145,7.0,105,-125,-175,-1.5,125,2.75,Progressive Field,8,6
2015-09-30,2015,MIN,CLE,2,10,116,1.5,-175,8.0,100,-120,-131,-1.5,155,3.7,Progressive Field,12,-8
2015-09-30,2015,ARI,COL,3,1,-121,-1.5,175,9.0,-115,-105,111,1.5,-205,4.93,Chase Field,4,2
2015-09-30,2015,KC,CWS,5,3,117,1.5,-185,7.5,100,-120,-127,-1.5,165,3.46,Guaranteed Rate Field,8,2
2015-09-30,2015,TEX,DET,6,2,-190,-1.5,100,9.5,-109,-111,170,1.5,-120,6.22,Rangers Ballpark,8,4
2015-09-30,2015,SEA,HOU,6,7,142,1.5,-125,7.5,-105,-115,-157,-1.5,105,3.1,T-Mobile Park,13,-1
2015-09-30,2015,CWS,KC,3,5,-127,-1.5,165,7.5,100,-120,117,1.5,-185,4.2,Guaranteed Rate Field,8,-2
2015-09-30,2015,OAK,LAA,8,7,221,1.5,119,9.0,100,-120,-261,-1.5,-139,2.8,Angel Stadium,15,1
2015-09-30,2015,SF,LAD,5,0,107,1.5,-160,7.0,-105,-115,-117,-1.5,140,3.38,AT&T Park,5,5
2015-09-30,2015,TB,MIA,6,4,-181,-1.5,120,7.5,105,-125,161,1.5,-142,4.83,Tropicana Field,10,2
2015-09-30,2015,SD,MIL,0,5,-147,-1.5,160,7.0,-110,-110,132,1.5,-180,4.17,PETCO Park,5,-5
2015-09-30,2015,CLE,MIN,1,7,-175,-1.5,125,7.0,105,-125,155,1.5,-145,4.45,Progressive Field,8,-6
2015-09-30,2015,CLE,MIN,10,2,-131,-1.5,155,8.0,100,-120,116,1.5,-175,4.54,Progressive Field,12,8
2015-09-30,2015,PHI,NYM,7,5,163,1.5,-103,9.0,112,-132,-183,-1.5,-117,3.42,Citizens Bank Park,12,2
2015-09-30,2015,BOS,NYY,9,5,149,1.5,-140,7.5,-105,-115,-164,-1.5,120,3.01,Yankee Stadium,14,4
2015-09-30,2015,LAA,OAK,7,8,-261,-1.5,-139,9.0,100,-120,221,1.5,119,6.51,Angel Stadium,15,-1
2015-09-30,2015,NYM,PHI,5,7,-183,-1.5,-117,9.0,112,-132,163,1.5,-103,5.82,Citizens Bank Park,12,-2
2015-09-30,2015,STL,PIT,2,8,149,1.5,-165,6.5,-110,-110,-164,-1.5,145,2.61,PNC Park,10,-6
2015-09-30,2015,STL,PIT,11,1,117,1.5,-202,7.0,-110,-110,-127,-1.5,171,3.23,PNC Park,12,10
2015-09-30,2015,MIL,SD,5,0,132,1.5,-180,7.0,-110,-110,-147,-1.5,160,3.02,PETCO Park,5,5
2015-09-30,2015,HOU,SEA,7,6,-157,-1.5,105,7.5,-105,-115,142,1.5,-125,4.58,T-Mobile Park,13,1
2015-09-30,2015,LAD,SF,0,5,-117,-1.5,140,7.0,-105,-115,107,1.5,-160,3.77,AT&T Park,5,-5
2015-09-30,2015,PIT,STL,8,2,-164,-1.5,145,6.5,-110,-110,149,1.5,-165,4.04,PNC Park,10,6
2015-09-30,2015,PIT,STL,1,11,-127,-1.5,171,7.0,-110,-110,117,1.5,-202,3.92,PNC Park,12,-10
2015-09-30,2015,MIA,TB,4,6,161,1.5,-142,7.5,105,-125,-181,-1.5,120,2.87,Tropicana Field,10,-2
2015-09-30,2015,DET,TEX,2,6,170,1.5,-120,9.5,-109,-111,-190,-1.5,100,3.52,Rangers Ballpark,8,-4
2015-09-30,2015,BAL,TOR,2,15,150,1.5,-103,8.5,100,-120,-170,-1.5,-117,3.4,Camden Yards,17,-13
2015-09-30,2015,BAL,TOR,8,1,-134,-1.5,155,8.0,-109,-111,119,1.5,-175,4.58,Camden Yards,9,7
2015-09-30,2015,ATL,WSH,2,0,154,1.5,-115,7.5,-110,-110,-174,-1.5,-105,2.95,Turner Field,2,2
2015-10-01,2015,COL,ARI,6,8,180,1.5,-110,8.5,-110,-110,-210,-1.5,-110,3.04,Chase Field,14,-2
2015-10-01,2015,WSH,ATL,3,0,-211,-1.5,-133,7.0,-115,-105,181,1.5,113,4.75,Turner Field,3,3
2015-10-01,2015,TOR,BAL,4,6,166,1.5,-130,7.5,-110,-110,-186,-1.5,110,2.82,Camden Yards,10,-2
2015-10-01,2015,NYY,BOS,4,1,-148,-1.5,145,8.0,100,-120,133,1.5,-165,4.77,Yankee Stadium,5,3
2015-10-01,2015,CIN,CHC,3,5,107,1.5,-165,7.5,-105,-115,-117,-1.5,145,3.62,Great American Ballpark,8,-2
2015-10-01,2015,CHC,CIN,5,3,-117,-1.5,145,7.5,-105,-115,107,1.5,-165,4.04,Great American Ballpark,8,2
2015-10-01,2015,MIN,CLE,4,2,-109,-1.5,150,7.0,-110,-110,-101,1.5,-170,3.65,Progressive Field,6,2
2015-10-01,2015,ARI,COL,8,6,-210,-1.5,-110,8.5,-110,-110,180,1.5,-110,5.76,Chase Field,14,2
2015-10-01,2015,KC,CWS,6,4,-134,-1.5,120,7.5,-120,100,119,1.5,-140,4.29,Guaranteed Rate Field,10,2
2015-10-01,2015,CWS,KC,4,6,119,1.5,-140,7.5,-120,100,-134,-1.5,120,3.42,Guaranteed Rate Field,10,-2
2015-10-01,2015,TEX,LAA,5,3,-107,-1.5,185,9.0,-115,-105,-103,1.5,-215,4.65,Rangers Ballpark,8,2
2015-10-01,2015,SF,LAD,2,3,125,1.5,-140,7.5,100,-120,-140,-1.5,120,3.33,AT&T Park,5,-1
2015-10-01,2015,TB,MIA,4,1,-105,1.5,-170,6.5,-120,100,-105,-1.5,150,3.33,Tropicana Field,5,3
2015-10-01,2015,SD,MIL,3,1,-140,-1.5,165,7.0,-120,100,125,1.5,-185,4.08,PETCO Park,4,2
2015-10-01,2015,CLE,MIN,2,4,-101,1.5,-170,7.0,-110,-110,-109,-1.5,150,3.52,Progressive Field,6,-2
2015-10-01,2015,PHI,NYM,3,0,102,1.5,-175,7.0,-115,-105,-112,-1.5,155,3.47,Citizens Bank Park,3,3
2015-10-01,2015,BOS,NYY,1,4,133,1.5,-165,8.0,100,-120,-148,-1.5,145,3.43,Yankee Stadium,5,-3
2015-10-01,2015,NYM,PHI,0,3,-112,-1.5,155,7.0,-115,-105,102,1.5,-175,3.7,Citizens Bank Park,3,-3
2015-10-01,2015,MIL,SD,1,3,125,1.5,-185,7.0,-120,100,-140,-1.5,165,3.11,PETCO Park,4,-2
2015-10-01,2015,LAD,SF,3,2,-140,-1.5,120,7.5,100,-120,125,1.5,-140,4.38,AT&T Park,5,1
2015-10-01,2015,MIA,TB,1,4,-105,-1.5,150,6.5,-120,100,-105,1.5,-170,3.33,Tropicana Field,5,-3
2015-10-01,2015,LAA,TEX,3,5,-103,1.5,-215,9.0,-115,-105,-107,-1.5,185,4.57,Rangers Ballpark,8,-2
2015-10-01,2015,BAL,TOR,6,4,-186,-1.5,110,7.5,-110,-110,166,1.5,-130,4.88,Camden Yards,10,2
2015-10-01,2015,ATL,WSH,0,3,181,1.5,113,7.0,-115,-105,-211,-1.5,-133,2.49,Turner Field,3,-3
2015-10-02,2015,HOU,ARI,21,5,-172,-1.5,-110,8.5,100,-120,152,1.5,-110,5.38,Chase Field,26,16
2015-10-02,2015,STL,ATL,0,4,-121,-1.5,135,6.0,-115,-105,111,1.5,-155,3.29,Turner Field,4,-4
2015-10-02,2015,CLE,BOS,8,2,-125,-1.5,160,7.5,104,-124,115,1.5,-180,4.17,Progressive Field,10,6
2015-10-02,2015,MIL,CHC,1,6,205,1.5,136,7.5,100,-120,-245,-1.5,-156,2.46,Miller Park,7,-5
2015-10-02,2015,PIT,CIN,6,4,-265,-1.5,-125,7.0,-110,-110,225,1.5,105,5.08,PNC Park,10,2
2015-10-02,2015,BOS,CLE,2,8,115,1.5,-180,7.5,104,-124,-125,-1.5,160,3.49,Progressive Field,10,-6
2015-10-02,2015,SF,COL,3,9,-130,-1.5,165,7.5,-115,-105,115,1.5,-195,4.24,AT&T Park,12,-6
2015-10-02,2015,DET,CWS,1,2,200,1.5,-108,7.0,115,-135,-230,-1.5,-112,2.33,Guaranteed Rate Field,3,-1
2015-10-02,2015,CWS,DET,2,1,-230,-1.5,-112,7.0,115,-135,200,1.5,-108,4.88,Guaranteed Rate Field,3,1
2015-10-02,2015,ARI,HOU,5,21,152,1.5,-110,8.5,100,-120,-172,-1.5,-110,3.37,Chase Field,26,-16
2015-10-02,2015,MIN,KC,1,3,-116,-1.5,175,7.0,-110,-110,106,1.5,-205,3.76,Target Field,4,-2
2015-10-02,2015,TEX,LAA,1,2,-117,-1.5,165,10.0,-105,-115,107,1.5,-195,5.39,Rangers Ballpark,3,-1
2015-10-02,2015,SD,LAD,2,6,175,1.5,-140,7.0,-114,-106,-205,-1.5,120,2.55,Dodger Stadium,8,-4
2015-10-02,2015,CHC,MIL,6,1,-245,-1.5,-156,7.5,100,-120,205,1.5,136,5.33,Miller Park,7,5
2015-10-02,2015,KC,MIN,3,1,106,1.5,-205,7.0,-110,-110,-116,-1.5,175,3.4,Target Field,4,2
2015-10-02,2015,SEA,OAK,2,4,-194,-1.5,105,7.0,-120,100,174,1.5,-125,4.62,T-Mobile Park,6,-2
2015-10-02,2015,CIN,PIT,4,6,225,1.5,105,7.0,-110,-110,-265,-1.5,-125,2.15,PNC Park,10,-2
2015-10-02,2015,LAD,SD,6,2,-205,-1.5,120,7.0,-114,-106,175,1.5,-140,4.7,Dodger Stadium,8,4
2015-10-02,2015,OAK,SEA,4,2,174,1.5,-125,7.0,-120,100,-194,-1.5,105,2.55,T-Mobile Park,6,2
2015-10-02,2015,COL,SF,9,3,115,1.5,-195,7.5,-115,-105,-130,-1.5,165,3.49,AT&T Park,12,6
2015-10-02,2015,ATL,STL,4,0,111,1.5,-155,6.0,-115,-105,-121,-1.5,135,2.84,Turner Field,4,4
2015-10-02,2015,TOR,TB,8,4,-126,-1.5,130,8.0,-120,100,116,1.5,-150,4.46,Tropicana Field,12,4
2015-10-02,2015,LAA,TEX,2,1,107,1.5,-195,10.0,-105,-115,-117,-1.5,165,4.83,Rangers Ballpark,3,1
2015-10-02,2015,TB,TOR,4,8,116,1.5,-150,8.0,-120,100,-126,-1.5,130,3.7,Tropicana Field,12,-4
2015-10-03,2015,HOU,ARI,6,2,-173,-1.5,-115,9.0,-110,-110,153,1.5,-104,5.7,Chase Field,8,4
2015-10-03,2015,NYY,BAL,2,9,132,1.5,-160,7.5,-110,-110,-147,-1.5,140,3.23,Camden Yards,11,-7
2015-10-03,2015,NYY,BAL,3,4,-115,-1.5,135,7.5,100,-120,105,1.5,-155,4.01,Camden Yards,7,-1
2015-10-03,2015,CLE,BOS,2,0,-200,-1.5,110,7.5,106,-126,170,1.5,-130,5.0,Progressive Field,2,2
2015-10-03,2015,MIL,CHC,0,1,170,1.5,110,8.0,-110,-110,-200,-1.5,-130,2.96,Miller Park,1,-1
2015-10-03,2015,PIT,CIN,1,3,-200,-1.5,110,7.0,-110,-110,170,1.5,-130,4.67,PNC Park,4,-2
2015-10-03,2015,BOS,CLE,0,2,170,1.5,-130,7.5,106,-126,-200,-1.5,110,2.78,Progressive Field,2,-2
2015-10-03,2015,SF,COL,3,2,-126,-1.5,165,7.5,100,-120,116,1.5,-185,4.18,AT&T Park,5,1
2015-10-03,2015,DET,CWS,3,4,-122,-1.5,135,7.5,112,-132,112,1.5,-155,4.12,Guaranteed Rate Field,7,-1
2015-10-03,2015,CWS,DET,4,3,112,1.5,-155,7.5,112,-132,-122,-1.5,135,3.54,Guaranteed Rate Field,7,1
2015-10-03,2015,ARI,HOU,2,6,153,1.5,-104,9.0,-110,-110,-173,-1.5,-115,3.56,Chase Field,8,-4
2015-10-03,2015,MIN,KC,1,5,111,1.5,-153,7.5,100,-120,-121,-1.5,133,3.55,Target Field,6,-4
2015-10-03,2015,TEX,LAA,10,11,-105,-1.5,180,9.5,100,-120,-105,1.5,-210,4.87,Rangers Ballpark,21,-1
2015-10-03,2015,SD,LAD,1,2,261,1.5,130,6.5,-120,100,-311,-1.5,-150,1.8,Dodger Stadium,3,-1
2015-10-03,2015,PHI,MIA,6,7,107,1.5,-155,7.5,105,-125,-117,-1.5,135,3.62,Citizens Bank Park,13,-1
2015-10-03,2015,PHI,MIA,2,5,120,1.5,-140,7.5,-105,-115,-135,-1.5,120,3.41,Citizens Bank Park,7,-3
2015-10-03,2015,CHC,MIL,1,0,-200,-1.5,-130,8.0,-110,-110,170,1.5,110,5.33,Miller Park,1,1
2015-10-03,2015,KC,MIN,5,1,-121,-1.5,133,7.5,100,-120,111,1.5,-153,4.11,Target Field,6,4
2015-10-03,2015,WSH,NYM,3,1,146,1.5,-160,7.0,107,-127,-161,-1.5,140,2.85,Citi Field,4,2
2015-10-03,2015,WSH,NYM,2,0,102,1.5,-240,6.0,100,-120,-112,-1.5,200,2.97,Citi Field,2,2
2015-10-03,2015,BAL,NYY,9,2,-147,-1.5,140,7.5,-110,-110,132,1.5,-160,4.46,Camden Yards,11,7
2015-10-03,2015,BAL,NYY,4,3,105,1.5,-155,7.5,100,-120,-115,-1.5,135,3.66,Camden Yards,7,1
2015-10-03,2015,SEA,OAK,5,7,-146,-1.5,145,7.5,-112,-108,131,1.5,-165,4.45,T-Mobile Park,12,-2
2015-10-03,2015,MIA,PHI,7,6,-117,-1.5,135,7.5,105,-125,107,1.5,-155,4.04,Citizens Bank Park,13,1
2015-10-03,2015,MIA,PHI,5,2,-135,-1.5,120,7.5,-105,-115,120,1.5,-140,4.31,Citizens Bank Park,7,3
2015-10-03,2015,CIN,PIT,3,1,170,1.5,-130,7.0,-110,-110,-200,-1.5,110,2.59,PNC Park,4,2
2015-10-03,2015,LAD,SD,2,1,-311,-1.5,-150,6.5,-120,100,261,1.5,130,4.92,Dodger Stadium,3,1
2015-10-03,2015,OAK,SEA,7,5,131,1.5,-165,7.5,-112,-108,-146,-1.5,145,3.25,T-Mobile Park,12,2
2015-10-03,2015,COL,SF,2,3,116,1.5,-185,7.5,100,-120,-126,-1.5,165,3.47,AT&T Park,5,-1
2015-10-03,2015,TOR,TB,3,4,100,1.5,-205,7.5,100,-120,-110,-1.5,175,3.75,Tropicana Field,7,-1
2015-10-03,2015,LAA,TEX,11,10,-105,1.5,-210,9.5,100,-120,-105,-1.5,180,4.87,Rangers Ballpark,21,1
2015-10-03,2015,TB,TOR,4,3,-110,-1.5,175,7.5,100,-120,100,1.5,-205,3.93,Tropicana Field,7,1
2015-10-03,2015,NYM,WSH,1,3,-161,-1.5,140,7.0,107,-127,146,1.5,-160,4.32,Citi Field,4,-2
2015-10-03,2015,NYM,WSH,0,2,-112,-1.5,200,6.0,100,-120,102,1.5,-240,3.17,Citi Field,2,-2
2015-10-04,2015,HOU,ARI,3,5,-150,-1.5,105,8.5,-105,-115,135,1.5,-125,5.1,Chase Field,8,-2
2015-10-04,2015,STL,ATL,0,6,-148,-1.5,100,7.0,105,-125,133,1.5,-120,4.18,Turner Field,6,-6
2015-10-04,2015,STL,ATL,0,2,-140,-1.5,120,7.5,100,-120,125,1.5,-140,4.38,Turner Field,2,-2
2015-10-04,2015,NYY,BAL,4,9,-155,-1.5,111,7.5,-107,-113,140,1.5,-131,4.56,Camden Yards,13,-5
2015-10-04,2015,CLE,BOS,3,1,-112,-1.5,180,7.0,105,-125,102,1.5,-210,3.7,Progressive Field,4,2
2015-10-04,2015,MIL,CHC,1,3,119,1.5,-145,8.0,-112,-108,-134,-1.5,125,3.65,Miller Park,4,-2
2015-10-04,2015,PIT,CIN,4,0,-220,-1.5,-110,7.5,-105,-115,190,1.5,-110,5.16,PNC Park,4,4
2015-10-04,2015,BOS,CLE,1,3,102,1.5,-210,7.0,105,-125,-112,-1.5,180,3.47,Progressive Field,4,-2
2015-10-04,2015,SF,COL,3,7,-120,-1.5,175,7.5,-115,-105,110,1.5,-205,4.09,AT&T Park,10,-4
2015-10-04,2015,DET,CWS,6,0,116,1.5,-185,7.5,110,-130,-131,-1.5,165,3.47,Guaranteed Rate Field,6,6
2015-10-04,2015,CWS,DET,0,6,-131,-1.5,165,7.5,110,-130,116,1.5,-185,4.25,Guaranteed Rate Field,6,-6
2015-10-04,2015,ARI,HOU,5,3,135,1.5,-125,8.5,-105,-115,-150,-1.5,105,3.62,Chase Field,8,2
2015-10-04,2015,MIN,KC,1,6,156,1.5,-110,7.5,-120,100,-176,-1.5,-110,2.93,Target Field,7,-5
2015-10-04,2015,TEX,LAA,9,2,-125,-1.5,160,8.5,-115,-105,115,1.5,-180,4.72,Rangers Ballpark,11,7
2015-10-04,2015,SD,LAD,3,6,295,1.5,109,6.5,113,-133,-345,-1.5,-126,1.65,Dodger Stadium,9,-3
2015-10-04,2015,PHI,MIA,7,2,119,1.5,-145,7.5,-120,100,-129,-1.5,125,3.42,Citizens Bank Park,9,5
2015-10-04,2015,CHC,MIL,3,1,-134,-1.5,125,8.0,-112,-108,119,1.5,-145,4.58,Miller Park,4,2
2015-10-04,2015,KC,MIN,6,1,-176,-1.5,-110,7.5,-120,100,156,1.5,-110,4.78,Target Field,7,5
2015-10-04,2015,WSH,NYM,0,1,180,1.5,-120,6.5,-110,-110,-210,-1.5,100,2.32,Citi Field,1,-1
2015-10-04,2015,BAL,NYY,9,4,140,1.5,-131,7.5,-107,-113,-155,-1.5,111,3.13,Camden Yards,13,5
2015-10-04,2015,SEA,OAK,3,2,-121,-1.5,180,7.5,-115,-105,111,1.5,-210,4.11,T-Mobile Park,5,1
2015-10-04,2015,MIA,PHI,2,7,-129,-1.5,125,7.5,-120,100,119,1.5,-145,4.22,Citizens Bank Park,9,-5
2015-10-04,2015,CIN,PIT,0,4,190,1.5,-110,7.5,-105,-115,-220,-1.5,-110,2.59,PNC Park,4,-4
2015-10-04,2015,LAD,SD,6,3,-345,-1.5,-126,6.5,113,-133,295,1.5,109,5.04,Dodger Stadium,9,3
2015-10-04,2015,OAK,SEA,2,3,111,1.5,-210,7.5,-115,-105,-121,-1.5,180,3.55,T-Mobile Park,5,-1
2015-10-04,2015,COL,SF,7,3,110,1.5,-205,7.5,-115,-105,-120,-1.5,175,3.57,AT&T Park,10,4
2015-10-04,2015,ATL,STL,6,0,133,1.5,-120,7.0,105,-125,-148,-1.5,100,3.0,Turner Field,6,6
2015-10-04,2015,ATL,STL,2,0,125,1.5,-140,7.5,100,-120,-140,-1.5,120,3.33,Turner Field,2,2
2015-10-04,2015,TOR,TB,3,12,-151,-1.5,-107,8.5,-120,100,136,1.5,-114,5.11,Tropicana Field,15,-9
2015-10-04,2015,LAA,TEX,2,9,115,1.5,-180,8.5,-115,-105,-125,-1.5,160,3.95,Rangers Ballpark,11,-7
2015-10-04,2015,TB,TOR,12,3,136,1.5,-114,8.5,-120,100,-151,-1.5,-107,3.6,Tropicana Field,15,9
2015-10-04,2015,NYM,WSH,1,0,-210,-1.5,100,6.5,-110,-110,180,1.5,-120,4.4,Citi Field,1,1
2016-04-03,2016,NYM,KC,3,4,-120,-1.5,145,8.0,-103,-117,110,1.5,-165,4.36,Kauffman Stadium,7,-1
2016-04-03,2016,KC,NYM,4,3,110,1.5,-165,8.0,-103,-117,-120,-1.5,145,3.81,Kauffman Stadium,7,1
2016-04-03,2016,STL,PIT,1,4,109,1.5,-230,6.5,-110,-110,-119,-1.5,190,3.11,PNC Park,5,-3
2016-04-03,2016,PIT,STL,4,1,-119,-1.5,190,6.5,-110,-110,109,1.5,-230,3.53,PNC Park,5,3
2016-04-03,2016,TOR,TB,5,3,111,1.5,-210,7.0,-130,110,-121,-1.5,180,3.32,Tropicana Field,8,2
2016-04-03,2016,TB,TOR,3,5,-121,-1.5,180,7.0,-130,110,111,1.5,-210,3.83,Tropicana Field,8,-2
2016-04-04,2016,COL,ARI,10,5,155,1.5,-140,8.0,-110,-110,-175,-1.5,120,3.14,Chase Field,15,5
2016-04-04,2016,WSH,ATL,4,3,-180,-1.5,-107,7.0,-115,-105,160,1.5,-113,4.5,Turner Field,7,1
2016-04-04,2016,MIN,BAL,2,3,109,1.5,-200,9.0,-110,-110,-119,-1.5,170,4.31,Camden Yards,5,-1
2016-04-04,2016,LAA,CHC,0,9,130,1.5,-135,7.0,110,-130,-145,-1.5,115,3.04,Angel Stadium,9,-9
2016-04-04,2016,PHI,CIN,2,6,155,1.5,-140,7.5,100,-120,-175,-1.5,120,2.94,Great American Ballpark,8,-4
2016-04-04,2016,ARI,COL,5,10,-175,-1.5,120,8.0,-110,-110,155,1.5,-140,5.09,Chase Field,15,-5
2016-04-04,2016,OAK,CWS,3,4,130,1.5,-135,7.0,-105,-115,-145,-1.5,115,3.04,Oakland Coliseum,7,-1
2016-04-04,2016,CHC,LAA,9,0,-145,-1.5,115,7.0,110,-130,130,1.5,-135,4.14,Angel Stadium,9,9
2016-04-04,2016,SD,LAD,0,15,170,1.5,-109,6.0,100,-120,-200,-1.5,-111,2.22,PETCO Park,15,-15
2016-04-04,2016,SF,MIL,12,3,-175,-1.5,-110,8.0,-107,-113,155,1.5,-110,5.09,Miller Park,15,9
2016-04-04,2016,BAL,MIN,3,2,-119,-1.5,170,9.0,-110,-110,109,1.5,-200,4.89,Camden Yards,5,1
2016-04-04,2016,CWS,OAK,4,3,-145,-1.5,115,7.0,-105,-115,130,1.5,-135,4.14,Oakland Coliseum,7,1
2016-04-04,2016,CIN,PHI,6,2,-175,-1.5,120,7.5,100,-120,155,1.5,-140,4.77,Great American Ballpark,8,4
2016-04-04,2016,LAD,SD,15,0,-200,-1.5,-111,6.0,100,-120,170,1.5,-109,4.0,PETCO Park,15,15
2016-04-04,2016,TEX,SEA,3,2,-126,-1.5,170,8.0,-125,105,116,1.5,-200,4.46,Rangers Ballpark,5,1
2016-04-04,2016,MIL,SF,3,12,155,1.5,-110,8.0,-107,-113,-175,-1.5,-110,3.14,Miller Park,15,-9
2016-04-04,2016,TOR,TB,5,3,107,1.5,-210,8.5,100,-120,-117,-1.5,180,4.11,Tropicana Field,8,2
2016-04-04,2016,SEA,TEX,2,3,116,1.5,-200,8.0,-125,105,-126,-1.5,170,3.7,Rangers Ballpark,5,-1
2016-04-04,2016,TB,TOR,3,5,-117,-1.5,180,8.5,100,-120,107,1.5,-210,4.58,Tropicana Field,8,-2
2016-04-04,2016,ATL,WSH,3,4,160,1.5,-113,7.0,-115,-105,-180,-1.5,-107,2.69,Turner Field,7,-1
2016-04-05,2016,COL,ARI,6,11,115,1.5,-175,9.0,-105,-115,-130,-1.5,155,4.19,Chase Field,17,-5
2016-04-05,2016,CLE,BOS,2,6,-123,-1.5,205,6.0,-110,-110,113,1.5,-245,3.31,Progressive Field,8,-4
2016-04-05,2016,LAA,CHC,1,6,115,1.5,-160,7.5,100,-120,-125,-1.5,140,3.49,Angel Stadium,7,-5
2016-04-05,2016,BOS,CLE,6,2,113,1.5,-245,6.0,-110,-110,-123,-1.5,205,2.82,Progressive Field,8,4
2016-04-05,2016,ARI,COL,11,6,-130,-1.5,155,9.0,-105,-115,115,1.5,-175,5.09,Chase Field,17,5
2016-04-05,2016,OAK,CWS,4,5,103,1.5,-165,7.5,-115,-105,-113,-1.5,145,3.69,Oakland Coliseum,9,-1
2016-04-05,2016,MIA,DET,7,8,-103,1.5,-175,7.5,-125,105,-107,-1.5,155,3.81,Marlins Park,15,-1
2016-04-05,2016,NYY,HOU,3,5,113,1.5,-168,6.5,-115,-105,-123,-1.5,148,3.05,Yankee Stadium,8,-2
2016-04-05,2016,NYM,KC,2,0,-127,-1.5,120,8.5,-120,100,117,1.5,-140,4.76,Kauffman Stadium,2,2
2016-04-05,2016,CHC,LAA,6,1,-125,-1.5,140,7.5,100,-120,115,1.5,-160,4.17,Angel Stadium,7,5
2016-04-05,2016,SD,LAD,0,3,105,1.5,-160,7.5,110,-130,-115,-1.5,140,3.66,PETCO Park,3,-3
2016-04-05,2016,DET,MIA,8,7,-107,-1.5,155,7.5,-125,105,-103,1.5,-175,3.88,Marlins Park,15,1
2016-04-05,2016,SF,MIL,2,1,-158,-1.5,-105,8.0,-120,100,143,1.5,-115,4.9,Miller Park,3,1
2016-04-05,2016,KC,NYM,0,2,117,1.5,-140,8.5,-120,100,-127,-1.5,120,3.92,Kauffman Stadium,2,-2
2016-04-05,2016,HOU,NYY,5,3,-123,-1.5,148,6.5,-115,-105,113,1.5,-168,3.59,Yankee Stadium,8,2
2016-04-05,2016,CWS,OAK,5,4,-113,-1.5,145,7.5,-115,-105,103,1.5,-165,3.98,Oakland Coliseum,9,1
2016-04-05,2016,STL,PIT,5,6,102,1.5,-235,7.0,-115,-105,-112,-1.5,195,3.47,PNC Park,11,-1
2016-04-05,2016,LAD,SD,3,0,-115,-1.5,140,7.5,110,-130,105,1.5,-160,4.01,PETCO Park,3,3
2016-04-05,2016,TEX,SEA,2,10,-107,-1.5,185,9.0,-120,100,-103,1.5,-215,4.65,Rangers Ballpark,12,-8
2016-04-05,2016,MIL,SF,1,2,143,1.5,-115,8.0,-120,100,-158,-1.5,-105,3.29,Miller Park,3,-1
2016-04-05,2016,PIT,STL,6,5,-112,-1.5,195,7.0,-115,-105,102,1.5,-235,3.7,PNC Park,11,1
2016-04-05,2016,TOR,TB,2,3,-107,-1.5,150,8.5,-110,-110,-103,1.5,-170,4.39,Tropicana Field,5,-1
2016-04-05,2016,SEA,TEX,10,2,-103,1.5,-215,9.0,-120,100,-107,-1.5,185,4.57,Rangers Ballpark,12,8
2016-04-05,2016,TB,TOR,3,2,-103,1.5,-170,8.5,-110,-110,-107,-1.5,150,4.31,Tropicana Field,5,1
2016-04-06,2016,COL,ARI,4,3,125,1.5,-165,8.5,-120,100,-140,-1.5,145,3.78,Chase Field,7,1
2016-04-06,2016,WSH,ATL,3,1,-190,-1.5,-117,7.0,-115,-105,170,1.5,-103,4.59,Turner Field,4,2
2016-04-06,2016,MIN,BAL,2,4,106,1.5,-200,8.5,-115,-105,-116,-1.5,170,4.13,Camden Yards,6,-2
2016-04-06,2016,CLE,BOS,7,6,-141,-1.5,160,7.5,108,-128,126,1.5,-180,4.39,Progressive Field,13,1
2016-04-06,2016,PHI,CIN,2,3,117,1.5,-185,8.0,-110,-110,-132,-1.5,165,3.69,Great American Ballpark,5,-1
2016-04-06,2016,BOS,CLE,6,7,126,1.5,-180,7.5,108,-128,-141,-1.5,160,3.32,Progressive Field,13,-1
2016-04-06,2016,ARI,COL,3,4,-140,-1.5,145,8.5,-120,100,125,1.5,-165,4.96,Chase Field,7,-1
2016-04-06,2016,OAK,CWS,2,1,-127,-1.5,170,8.0,-110,-110,117,1.5,-200,4.48,Oakland Coliseum,3,1
2016-04-06,2016,MIA,DET,3,7,-174,-1.5,130,7.0,-130,110,154,1.5,-150,4.45,Marlins Park,10,-4
2016-04-06,2016,NYY,HOU,16,6,-131,-1.5,170,7.5,-105,-115,116,1.5,-200,4.25,Yankee Stadium,22,10
2016-04-06,2016,SD,LAD,0,7,130,1.5,-140,7.0,-115,-105,-145,-1.5,120,3.04,PETCO Park,7,-7
2016-04-06,2016,DET,MIA,7,3,154,1.5,-150,7.0,-130,110,-174,-1.5,130,2.76,Marlins Park,10,4
2016-04-06,2016,SF,MIL,3,4,-141,-1.5,120,9.0,-110,-110,126,1.5,-140,5.27,Miller Park,7,-1
2016-04-06,2016,BAL,MIN,4,2,-116,-1.5,170,8.5,-115,-105,106,1.5,-200,4.56,Camden Yards,6,2
2016-04-06,2016,HOU,NYY,6,16,116,1.5,-200,7.5,-105,-115,-131,-1.5,170,3.47,Yankee Stadium,22,-10
2016-04-06,2016,CWS,OAK,1,2,117,1.5,-200,8.0,-110,-110,-127,-1.5,170,3.69,Oakland Coliseum,3,-1
2016-04-06,2016,CIN,PHI,3,2,-132,-1.5,165,8.0,-110,-110,117,1.5,-185,4.55,Great American Ballpark,5,1
2016-04-06,2016,STL,PIT,1,5,102,1.5,-215,7.5,-110,-110,-112,-1.5,185,3.71,PNC Park,6,-4
2016-04-06,2016,LAD,SD,7,0,-145,-1.5,120,7.0,-115,-105,130,1.5,-140,4.14,PETCO Park,7,7
2016-04-06,2016,TEX,SEA,5,9,115,1.5,-145,9.5,-105,-115,-130,-1.5,125,4.42,Rangers Ballpark,14,-4
2016-04-06,2016,MIL,SF,4,3,126,1.5,-140,9.0,-110,-110,-141,-1.5,120,3.98,Miller Park,7,1
2016-04-06,2016,PIT,STL,5,1,-112,-1.5,185,7.5,-110,-110,102,1.5,-215,3.96,PNC Park,6,4
2016-04-06,2016,TOR,TB,3,5,-123,-1.5,130,8.5,-115,-105,113,1.5,-150,4.69,Tropicana Field,8,-2
2016-04-06,2016,SEA,TEX,9,5,-130,-1.5,125,9.5,-105,-115,115,1.5,-145,5.37,Rangers Ballpark,14,4
2016-04-06,2016,TB,TOR,5,3,113,1.5,-150,8.5,-115,-105,-123,-1.5,130,3.99,Tropicana Field,8,2
2016-04-06,2016,ATL,WSH,1,3,170,1.5,-103,7.0,-115,-105,-190,-1.5,-117,2.59,Turner Field,4,-2
2016-04-07,2016,CHC,ARI,14,6,-177,-1.5,-119,9.0,-125,105,157,1.5,-101,5.75,Chase Field,20,8
2016-04-07,2016,MIN,BAL,2,4,125,1.5,-170,8.5,-101,-119,-140,-1.5,150,3.78,Camden Yards,6,-2
2016-04-07,2016,ARI,CHC,6,14,157,1.5,-101,9.0,-125,105,-177,-1.5,-119,3.5,Chase Field,20,-8
2016-04-07,2016,PHI,CIN,6,10,116,1.5,-190,8.5,100,-120,-126,-1.5,160,3.94,Great American Ballpark,16,-4
2016-04-07,2016,OAK,CWS,1,6,-111,-1.5,185,8.5,-125,105,101,1.5,-215,4.47,Oakland Coliseum,7,-5
2016-04-07,2016,NYY,HOU,8,5,-107,-1.5,185,9.0,100,-120,-103,1.5,-215,4.65,Yankee Stadium,13,3
2016-04-07,2016,TEX,LAA,3,4,129,1.5,-175,8.0,-110,-110,-144,-1.5,155,3.49,Angel Stadium,7,-1
2016-04-07,2016,SF,LAD,12,6,-120,-1.5,175,8.0,-120,100,110,1.5,-205,4.36,AT&T Park,18,6
2016-04-07,2016,WSH,MIA,4,6,-141,-1.5,155,8.5,-120,100,126,1.5,-175,4.97,Nationals Park,10,-2
2016-04-07,2016,BAL,MIN,4,2,-140,-1.5,150,8.5,-101,-119,125,1.5,-170,4.96,Camden Yards,6,2
2016-04-07,2016,HOU,NYY,5,8,-103,1.5,-215,9.0,100,-120,-107,-1.5,185,4.57,Yankee Stadium,13,-3
2016-04-07,2016,CWS,OAK,6,1,101,1.5,-215,8.5,-125,105,-111,-1.5,185,4.23,Oakland Coliseum,7,5
2016-04-07,2016,CIN,PHI,10,6,-126,-1.5,160,8.5,100,-120,116,1.5,-190,4.74,Great American Ballpark,16,4
2016-04-07,2016,LAD,SF,6,12,110,1.5,-205,8.0,-120,100,-120,-1.5,175,3.81,AT&T Park,18,-6
2016-04-07,2016,LAA,TEX,4,3,-144,-1.5,155,8.0,-110,-110,129,1.5,-175,4.72,Angel Stadium,7,1
2016-04-07,2016,MIA,WSH,6,4,126,1.5,-175,8.5,-120,100,-141,-1.5,155,3.76,Nationals Park,10,2
2016-04-08,2016,CHC,ARI,2,3,-124,-1.5,130,9.0,-105,-115,114,1.5,-150,4.98,Chase Field,5,-1
2016-04-08,2016,STL,ATL,7,4,-164,-1.5,-102,7.0,-115,-105,149,1.5,-118,4.35,Turner Field,11,3
2016-04-08,2016,TB,BAL,1,6,-125,-1.5,130,7.5,-110,-110,115,1.5,-150,4.17,Camden Yards,7,-5
2016-04-08,2016,TOR,BOS,7,8,-155,-1.5,130,9.0,100,-120,140,1.5,-150,5.47,Rogers Centre,15,-1
2016-04-08,2016,ARI,CHC,3,2,114,1.5,-150,9.0,-105,-115,-124,-1.5,130,4.21,Chase Field,5,1
2016-04-08,2016,PIT,CIN,6,5,-141,-1.5,113,8.0,-110,-110,126,1.5,-133,4.68,Great American Ballpark,11,1
2016-04-08,2016,CWS,CLE,1,7,129,1.5,-135,8.0,-115,-105,-144,-1.5,115,3.49,Guaranteed Rate Field,8,-6
2016-04-08,2016,SD,COL,13,6,140,1.5,-136,11.0,-110,-110,-155,-1.5,116,4.58,Coors Field,19,7
2016-04-08,2016,CLE,CWS,7,1,-144,-1.5,115,8.0,-115,-105,129,1.5,-135,4.72,Guaranteed Rate Field,8,6
2016-04-08,2016,NYY,DET,0,4,108,1.5,-210,8.0,-105,-115,-118,-1.5,180,3.85,Comerica Park,4,-4
2016-04-08,2016,MIL,HOU,6,4,101,1.5,-165,9.0,-115,-105,-111,-1.5,145,4.48,Miller Park,10,2
2016-04-08,2016,MIN,KC,3,4,144,1.5,-160,7.5,105,-125,-159,-1.5,140,3.07,Kauffman Stadium,7,-1
2016-04-08,2016,TEX,LAA,7,3,117,1.5,-185,8.0,100,-120,-127,-1.5,165,3.69,Angel Stadium,10,4
2016-04-08,2016,SF,LAD,3,2,100,-1.5,185,8.5,-115,-105,-110,1.5,-215,4.25,AT&T Park,5,1
2016-04-08,2016,HOU,MIL,4,6,-111,-1.5,145,9.0,-115,-105,101,1.5,-165,4.73,Miller Park,10,-2
2016-04-08,2016,KC,MIN,4,3,-159,-1.5,140,7.5,105,-125,144,1.5,-160,4.6,Kauffman Stadium,7,1
2016-04-08,2016,PHI,NYM,2,7,237,1.5,-101,7.0,-121,101,-277,-1.5,-119,2.08,Citi Field,9,-5
2016-04-08,2016,DET,NYY,4,0,-118,-1.5,180,8.0,-105,-115,108,1.5,-210,4.33,Comerica Park,4,4
2016-04-08,2016,SEA,OAK,2,3,-154,-1.5,135,8.0,-110,-110,139,1.5,-155,4.85,T-Mobile Park,5,-1
2016-04-08,2016,NYM,PHI,7,2,-277,-1.5,-119,7.0,-121,101,237,1.5,-101,5.14,Citi Field,9,5
2016-04-08,2016,CIN,PIT,5,6,126,1.5,-133,8.0,-110,-110,-141,-1.5,113,3.54,Great American Ballpark,11,-1
2016-04-08,2016,COL,SD,6,13,-155,-1.5,116,11.0,-110,-110,140,1.5,-136,6.69,Coors Field,19,-7
2016-04-08,2016,OAK,SEA,3,2,139,1.5,-155,8.0,-110,-110,-154,-1.5,135,3.35,T-Mobile Park,5,1
2016-04-08,2016,LAD,SF,2,3,-110,1.5,-215,8.5,-115,-105,100,-1.5,185,4.45,AT&T Park,5,-1
2016-04-08,2016,ATL,STL,4,7,149,1.5,-118,7.0,-115,-105,-164,-1.5,-102,2.81,Turner Field,11,-3
2016-04-08,2016,BAL,TB,6,1,115,1.5,-150,7.5,-110,-110,-125,-1.5,130,3.49,Camden Yards,7,5
2016-04-08,2016,LAA,TEX,3,7,-127,-1.5,165,8.0,100,-120,117,1.5,-185,4.48,Angel Stadium,10,-4
2016-04-08,2016,BOS,TOR,8,7,140,1.5,-150,9.0,100,-120,-155,-1.5,130,3.75,Rogers Centre,15,1
2016-04-09,2016,CHC,ARI,4,2,-105,1.5,-230,8.0,-125,105,-105,-1.5,190,4.1,Chase Field,6,2
2016-04-09,2016,STL,ATL,12,2,-130,-1.5,125,7.0,100,-120,115,1.5,-145,3.96,Turner Field,14,10
2016-04-09,2016,TOR,BOS,4,8,-115,-1.5,165,9.0,-115,-105,105,1.5,-185,4.81,Rogers Centre,12,-4
2016-04-09,2016,ARI,CHC,2,4,-105,-1.5,190,8.0,-125,105,-105,1.5,-230,4.1,Chase Field,6,-2
2016-04-09,2016,PIT,CIN,1,5,-122,-1.5,131,7.0,-105,-115,112,1.5,-151,3.85,Great American Ballpark,6,-4
2016-04-09,2016,CWS,CLE,7,3,-170,-1.5,130,7.0,105,-125,150,1.5,-150,4.41,Guaranteed Rate Field,10,4
2016-04-09,2016,SD,COL,16,3,111,1.5,-165,11.5,-104,-116,-121,-1.5,145,5.45,Coors Field,19,13
2016-04-09,2016,CLE,CWS,3,7,150,1.5,-150,7.0,105,-125,-170,-1.5,130,2.8,Guaranteed Rate Field,10,-4
2016-04-09,2016,NYY,DET,8,4,101,1.5,-205,9.0,-110,-110,-111,-1.5,175,4.48,Comerica Park,12,4
2016-04-09,2016,MIL,HOU,4,6,140,1.5,-130,9.0,-115,-105,-155,-1.5,110,3.75,Miller Park,10,-2
2016-04-09,2016,MIN,KC,0,7,116,1.5,-202,7.5,-115,-105,-126,-1.5,172,3.47,Kauffman Stadium,7,-7
2016-04-09,2016,TEX,LAA,4,1,109,1.5,-215,7.0,-105,-115,-119,-1.5,185,3.35,Angel Stadium,5,3
2016-04-09,2016,SF,LAD,2,3,133,1.5,-145,6.0,-105,-115,-148,-1.5,125,2.58,AT&T Park,5,-1
2016-04-09,2016,HOU,MIL,6,4,-155,-1.5,110,9.0,-115,-105,140,1.5,-130,5.47,Miller Park,10,2
2016-04-09,2016,KC,MIN,7,0,-126,-1.5,172,7.5,-115,-105,116,1.5,-202,4.18,Kauffman Stadium,7,7
2016-04-09,2016,PHI,NYM,1,0,138,1.5,-165,7.0,-115,-105,-153,-1.5,145,2.94,Citi Field,1,1
2016-04-09,2016,DET,NYY,4,8,-111,-1.5,175,9.0,-110,-110,101,1.5,-205,4.73,Comerica Park,12,-4
2016-04-09,2016,SEA,OAK,1,6,-124,-1.5,170,8.0,100,-120,114,1.5,-200,4.43,T-Mobile Park,7,-5
2016-04-09,2016,NYM,PHI,0,1,-153,-1.5,145,7.0,-115,-105,138,1.5,-165,4.23,Citi Field,1,-1
2016-04-09,2016,CIN,PIT,5,1,112,1.5,-151,7.0,-105,-115,-122,-1.5,131,3.3,Great American Ballpark,6,4
2016-04-09,2016,COL,SD,3,16,-121,-1.5,145,11.5,-104,-116,111,1.5,-165,6.3,Coors Field,19,-13
2016-04-09,2016,OAK,SEA,6,1,114,1.5,-200,8.0,100,-120,-124,-1.5,170,3.74,T-Mobile Park,7,5
2016-04-09,2016,LAD,SF,3,2,-148,-1.5,125,6.0,-105,-115,133,1.5,-145,3.58,AT&T Park,5,1
2016-04-09,2016,ATL,STL,2,12,115,1.5,-145,7.0,100,-120,-130,-1.5,125,3.26,Turner Field,14,-10
2016-04-09,2016,LAA,TEX,1,4,-119,-1.5,185,7.0,-105,-115,109,1.5,-215,3.8,Angel Stadium,5,-3
2016-04-09,2016,BOS,TOR,8,4,105,1.5,-185,9.0,-115,-105,-115,-1.5,165,4.39,Rogers Centre,12,4
2016-04-10,2016,CHC,ARI,7,3,-215,-1.5,-130,8.0,-110,-110,185,1.5,110,5.46,Chase Field,10,4
2016-04-10,2016,STL,ATL,12,7,-158,-1.5,-105,7.5,-116,-104,143,1.5,-115,4.59,Turner Field,19,5
2016-04-10,2016,TB,BAL,3,5,-105,-1.5,155,8.0,-120,100,-105,1.5,-175,4.1,Camden Yards,8,-2
2016-04-10,2016,TOR,BOS,3,0,-151,-1.5,135,9.5,105,-125,136,1.5,-155,5.72,Rogers Centre,3,3
2016-04-10,2016,ARI,CHC,3,7,185,1.5,110,8.0,-110,-110,-215,-1.5,-130,2.81,Chase Field,10,-4
2016-04-10,2016,PIT,CIN,1,2,-120,-1.5,145,9.0,100,-120,110,1.5,-165,4.91,Great American Ballpark,3,-1
2016-04-10,2016,SD,COL,3,6,125,1.5,-165,11.5,-109,-111,-140,-1.5,145,5.11,Coors Field,9,-3
2016-04-10,2016,MIL,HOU,3,2,153,1.5,-115,9.0,-109,-111,-173,-1.5,-105,3.56,Miller Park,5,1
2016-04-10,2016,MIN,KC,3,4,150,1.5,-140,8.5,-115,-105,-170,-1.5,120,3.4,Kauffman Stadium,7,-1
2016-04-10,2016,TEX,LAA,1,3,115,1.5,-183,8.5,-105,-115,-125,-1.5,163,3.95,Angel Stadium,4,-2
2016-04-10,2016,SF,LAD,9,6,-145,-1.5,165,7.5,-115,-105,130,1.5,-185,4.44,AT&T Park,15,3
2016-04-10,2016,WSH,MIA,4,2,-155,-1.5,140,8.0,-110,-110,140,1.5,-160,4.86,Nationals Park,6,2
2016-04-10,2016,HOU,MIL,2,3,-173,-1.5,-105,9.0,-109,-111,153,1.5,-115,5.7,Miller Park,5,-1
2016-04-10,2016,KC,MIN,4,3,-170,-1.5,120,8.5,-115,-105,150,1.5,-140,5.35,Kauffman Stadium,7,1
2016-04-10,2016,PHI,NYM,5,2,200,1.5,-104,6.5,-120,100,-240,-1.5,-116,2.17,Citi Field,7,3
2016-04-10,2016,SEA,OAK,1,2,-163,-1.5,140,7.5,-121,101,148,1.5,-160,4.65,T-Mobile Park,3,-1
2016-04-10,2016,NYM,PHI,2,5,-240,-1.5,-116,6.5,-120,100,200,1.5,-104,4.59,Citi Field,7,-3
2016-04-10,2016,CIN,PIT,2,1,110,1.5,-165,9.0,100,-120,-120,-1.5,145,4.29,Great American Ballpark,3,1
2016-04-10,2016,COL,SD,6,3,-140,-1.5,145,11.5,-109,-111,125,1.5,-165,6.71,Coors Field,9,3
2016-04-10,2016,OAK,SEA,2,1,148,1.5,-160,7.5,-121,101,-163,-1.5,140,3.02,T-Mobile Park,3,1
2016-04-10,2016,LAD,SF,6,9,130,1.5,-185,7.5,-115,-105,-145,-1.5,165,3.26,AT&T Park,15,-3
2016-04-10,2016,ATL,STL,7,12,143,1.5,-115,7.5,-116,-104,-158,-1.5,-105,3.09,Turner Field,19,-5
2016-04-10,2016,BAL,TB,5,3,-105,1.5,-175,8.0,-120,100,-105,-1.5,155,4.1,Camden Yards,8,2
2016-04-10,2016,LAA,TEX,3,1,-125,-1.5,163,8.5,-105,-115,115,1.5,-183,4.72,Angel Stadium,4,2
2016-04-10,2016,BOS,TOR,0,3,136,1.5,-155,9.5,105,-125,-151,-1.5,135,4.03,Rogers Centre,3,-3
2016-04-10,2016,MIA,WSH,2,4,140,1.5,-160,8.0,-110,-110,-155,-1.5,140,3.33,Nationals Park,6,-2
2016-04-11,2016,WSH,ATL,6,4,-243,-1.5,-114,7.5,-110,-110,203,1.5,-106,5.31,Nationals Park,10,2
2016-04-11,2016,BOS,BAL,7,9,-185,-1.5,-105,8.5,-103,-117,165,1.5,-115,5.52,Fenway Park,16,-2
2016-04-11,2016,BAL,BOS,9,7,165,1.5,-115,8.5,-103,-117,-185,-1.5,-105,3.21,Fenway Park,16,2
2016-04-11,2016,CIN,CHC,3,5,165,1.5,-135,7.0,-115,-105,-185,-1.5,115,2.64,Wrigley Field,8,-2
2016-04-11,2016,CHC,CIN,5,3,-185,-1.5,115,7.0,-115,-105,165,1.5,-135,4.54,Wrigley Field,8,2
2016-04-11,2016,MIN,CWS,1,4,108,1.5,-160,7.5,-105,-115,-118,-1.5,140,3.61,Target Field,5,-3
2016-04-11,2016,PIT,DET,7,4,146,1.5,-145,8.5,-122,102,-161,-1.5,125,3.46,Comerica Park,11,3
2016-04-11,2016,KC,HOU,2,8,133,1.5,-170,8.5,-115,-105,-148,-1.5,150,3.65,Minute Maid Park,10,-6
2016-04-11,2016,HOU,KC,8,2,-148,-1.5,150,8.5,-115,-105,133,1.5,-170,5.07,Minute Maid Park,10,6
2016-04-11,2016,OAK,LAA,1,4,-144,-1.5,155,7.5,-106,-114,129,1.5,-175,4.43,Oakland Coliseum,5,-3
2016-04-11,2016,NYM,MIA,3,10,-160,-1.5,135,7.5,-120,100,145,1.5,-155,4.62,Citi Field,13,-7
2016-04-11,2016,STL,MIL,10,1,-177,-1.5,135,7.5,105,-125,157,1.5,-155,4.79,Busch Stadium,11,9
2016-04-11,2016,CWS,MIN,4,1,-118,-1.5,140,7.5,-105,-115,108,1.5,-160,4.06,Target Field,5,3
2016-04-11,2016,MIA,NYM,10,3,145,1.5,-155,7.5,-120,100,-160,-1.5,135,3.06,Citi Field,13,7
2016-04-11,2016,LAA,OAK,4,1,129,1.5,-175,7.5,-106,-114,-144,-1.5,155,3.28,Oakland Coliseum,5,3
2016-04-11,2016,SD,PHI,4,3,110,1.5,-210,8.0,-110,-110,-120,-1.5,180,3.81,Citizens Bank Park,7,1
2016-04-11,2016,DET,PIT,4,7,-161,-1.5,125,8.5,-122,102,146,1.5,-145,5.24,Comerica Park,11,-3
2016-04-11,2016,PHI,SD,3,4,-120,-1.5,180,8.0,-110,-110,110,1.5,-210,4.36,Citizens Bank Park,7,-1
2016-04-11,2016,TEX,SEA,7,3,155,1.5,-135,7.5,-120,100,-175,-1.5,115,2.94,T-Mobile Park,10,4
2016-04-11,2016,MIL,STL,1,10,157,1.5,-155,7.5,105,-125,-177,-1.5,135,2.92,Busch Stadium,11,-9
2016-04-11,2016,SEA,TEX,3,7,-175,-1.5,115,7.5,-120,100,155,1.5,-135,4.77,T-Mobile Park,10,-4
2016-04-11,2016,ATL,WSH,4,6,203,1.5,-106,7.5,-110,-110,-243,-1.5,-114,2.48,Nationals Park,10,-2
2016-04-12,2016,LAD,ARI,2,4,-141,-1.5,156,7.0,-110,-110,126,1.5,-176,4.1,Dodger Stadium,6,-2
2016-04-12,2016,WSH,ATL,2,1,-179,-1.5,110,7.5,-120,100,159,1.5,-130,4.81,Nationals Park,3,1
2016-04-12,2016,BOS,BAL,5,9,-152,-1.5,126,9.0,100,-120,137,1.5,-146,5.43,Fenway Park,14,-4
2016-04-12,2016,BAL,BOS,9,5,137,1.5,-146,9.0,100,-120,-152,-1.5,126,3.8,Fenway Park,14,4
2016-04-12,2016,TB,CLE,5,1,110,1.5,-165,7.0,-125,105,-120,-1.5,145,3.33,Tropicana Field,6,4
2016-04-12,2016,SF,COL,7,2,106,1.5,-190,11.5,-105,-115,-116,-1.5,160,5.58,Coors Field,9,5
2016-04-12,2016,PIT,DET,2,8,106,1.5,-190,8.5,-115,-105,-116,-1.5,160,4.13,Comerica Park,10,-6
2016-04-12,2016,KC,HOU,3,2,115,1.5,-180,8.0,-117,-103,-125,-1.5,160,3.72,Minute Maid Park,5,1
2016-04-12,2016,HOU,KC,2,3,-125,-1.5,160,8.0,-117,-103,115,1.5,-180,4.44,Minute Maid Park,5,-1
2016-04-12,2016,OAK,LAA,4,5,-113,-1.5,175,8.0,-125,105,103,1.5,-205,4.24,Oakland Coliseum,9,-1
2016-04-12,2016,ARI,LAD,4,2,126,1.5,-176,7.0,-110,-110,-141,-1.5,156,3.1,Dodger Stadium,6,2
2016-04-12,2016,NYM,MIA,1,2,-125,-1.5,180,6.0,-120,100,115,1.5,-210,3.33,Citi Field,3,-1
2016-04-12,2016,MIA,NYM,2,1,115,1.5,-210,6.0,-120,100,-125,-1.5,180,2.79,Citi Field,3,1
2016-04-12,2016,TOR,NYY,2,3,-114,-1.5,170,8.0,-115,-105,104,1.5,-200,4.26,Rogers Centre,5,-1
2016-04-12,2016,LAA,OAK,5,4,103,1.5,-205,8.0,-125,105,-113,-1.5,175,3.94,Oakland Coliseum,9,1
2016-04-12,2016,SD,PHI,0,3,-108,-1.5,160,7.5,105,-125,-102,1.5,-190,3.89,Citizens Bank Park,3,-3
2016-04-12,2016,DET,PIT,8,2,-116,-1.5,160,8.5,-115,-105,106,1.5,-190,4.56,Comerica Park,10,6
2016-04-12,2016,PHI,SD,3,0,-102,1.5,-190,7.5,105,-125,-108,-1.5,160,3.79,Citizens Bank Park,3,3
2016-04-12,2016,TEX,SEA,8,0,116,1.5,-200,7.0,-110,-110,-126,-1.5,170,3.24,T-Mobile Park,8,8
2016-04-12,2016,COL,SF,2,7,-116,-1.5,160,11.5,-105,-115,106,1.5,-190,6.18,Coors Field,9,-5
2016-04-12,2016,CLE,TB,1,5,-120,-1.5,145,7.0,-125,105,110,1.5,-165,3.82,Tropicana Field,6,-4
2016-04-12,2016,SEA,TEX,0,8,-126,-1.5,170,7.0,-110,-110,116,1.5,-200,3.9,T-Mobile Park,8,-8
2016-04-12,2016,NYY,TOR,3,2,104,1.5,-200,8.0,-115,-105,-114,-1.5,170,3.92,Rogers Centre,5,1
2016-04-12,2016,ATL,WSH,1,2,159,1.5,-130,7.5,-120,100,-179,-1.5,110,2.9,Nationals Park,3,-1
2016-04-13,2016,LAD,ARI,3,1,-175,-1.5,130,8.0,100,-120,155,1.5,-150,5.09,Dodger Stadium,4,2
2016-04-13,2016,WSH,ATL,3,0,-141,-1.5,150,8.0,-110,-110,126,1.5,-170,4.68,Nationals Park,3,3
2016-04-13,2016,BOS,BAL,4,2,-123,-1.5,165,8.5,-110,-110,113,1.5,-185,4.69,Fenway Park,6,2
2016-04-13,2016,BAL,BOS,2,4,113,1.5,-185,8.5,-110,-110,-123,-1.5,165,3.99,Fenway Park,6,-2
2016-04-13,2016,CIN,CHC,2,9,170,1.5,-130,7.5,-110,-110,-200,-1.5,110,2.78,Wrigley Field,11,-7
2016-04-13,2016,CHC,CIN,9,2,-200,-1.5,110,7.5,-110,-110,170,1.5,-130,5.0,Wrigley Field,11,7
2016-04-13,2016,TB,CLE,1,4,-101,1.5,-175,7.0,100,-120,-109,-1.5,155,3.52,Tropicana Field,5,-3
2016-04-13,2016,SF,COL,6,10,-105,-1.5,140,11.5,-110,-110,-105,1.5,-160,5.89,Coors Field,16,-4
2016-04-13,2016,MIN,CWS,0,3,-105,1.5,-175,8.0,-110,-110,-105,-1.5,155,4.1,Target Field,3,-3
2016-04-13,2016,PIT,DET,3,7,-122,-1.5,170,8.5,-110,-110,112,1.5,-200,4.67,PNC Park,10,-4
2016-04-13,2016,KC,HOU,4,2,-105,1.5,-215,8.5,-105,-115,-105,-1.5,185,4.35,Minute Maid Park,6,2
2016-04-13,2016,HOU,KC,2,4,-105,-1.5,185,8.5,-105,-115,-105,1.5,-215,4.35,Minute Maid Park,6,-2
2016-04-13,2016,OAK,LAA,1,5,-103,1.5,-170,9.0,-105,-115,-107,-1.5,150,4.57,Oakland Coliseum,6,-4
2016-04-13,2016,ARI,LAD,1,3,155,1.5,-150,8.0,100,-120,-175,-1.5,130,3.14,Dodger Stadium,4,-2
2016-04-13,2016,NYM,MIA,2,1,-115,-1.5,185,7.0,-120,100,105,1.5,-215,3.74,Citi Field,3,1
2016-04-13,2016,STL,MIL,4,6,-145,-1.5,160,7.0,-110,-110,130,1.5,-180,4.14,Busch Stadium,10,-2
2016-04-13,2016,CWS,MIN,3,0,-105,-1.5,155,8.0,-110,-110,-105,1.5,-175,4.1,Target Field,3,3
2016-04-13,2016,MIA,NYM,1,2,105,1.5,-215,7.0,-120,100,-115,-1.5,185,3.41,Citi Field,3,-1
2016-04-13,2016,TOR,NYY,7,2,-126,-1.5,160,8.0,-120,100,116,1.5,-180,4.46,Rogers Centre,9,5
2016-04-13,2016,LAA,OAK,5,1,-107,-1.5,150,9.0,-105,-115,-103,1.5,-170,4.65,Oakland Coliseum,6,4
2016-04-13,2016,SD,PHI,1,2,105,1.5,-210,7.0,-120,100,-115,-1.5,180,3.41,Citizens Bank Park,3,-1
2016-04-13,2016,DET,PIT,7,3,112,1.5,-200,8.5,-110,-110,-122,-1.5,170,4.01,PNC Park,10,4
2016-04-13,2016,PHI,SD,2,1,-115,-1.5,180,7.0,-120,100,105,1.5,-210,3.74,Citizens Bank Park,3,1
2016-04-13,2016,TEX,SEA,2,4,130,1.5,-165,7.5,-120,100,-145,-1.5,145,3.26,T-Mobile Park,6,-2
2016-04-13,2016,COL,SF,10,6,-105,1.5,-160,11.5,-110,-110,-105,-1.5,140,5.89,Coors Field,16,4
2016-04-13,2016,MIL,STL,6,4,130,1.5,-180,7.0,-110,-110,-145,-1.5,160,3.04,Busch Stadium,10,2
2016-04-13,2016,CLE,TB,4,1,-109,-1.5,155,7.0,100,-120,-101,1.5,-175,3.65,Tropicana Field,5,3
2016-04-13,2016,SEA,TEX,4,2,-145,-1.5,145,7.5,-120,100,130,1.5,-165,4.44,T-Mobile Park,6,2
2016-04-13,2016,NYY,TOR,2,7,116,1.5,-180,8.0,-120,100,-126,-1.5,160,3.7,Rogers Centre,9,-5
2016-04-13,2016,ATL,WSH,0,3,126,1.5,-170,8.0,-110,-110,-141,-1.5,150,3.54,Nationals Park,3,-3
2016-04-14,2016,LAD,ARI,5,2,-126,-1.5,170,7.5,-115,-105,116,1.5,-200,4.18,Dodger Stadium,7,3
2016-04-14,2016,WSH,ATL,6,2,-235,-1.5,-105,7.0,100,-120,205,1.5,-115,4.91,Nationals Park,8,4
2016-04-14,2016,TEX,BAL,6,3,-127,-1.5,165,8.0,-115,-105,117,1.5,-185,4.48,Rangers Ballpark,9,3
2016-04-14,2016,CIN,CHC,1,8,144,1.5,-160,7.0,-110,-110,-159,-1.5,140,2.87,Wrigley Field,9,-7
2016-04-14,2016,CHC,CIN,8,1,-159,-1.5,140,7.0,-110,-110,144,1.5,-160,4.3,Wrigley Field,9,7
2016-04-14,2016,TB,CLE,0,6,-143,-1.5,160,7.0,-105,-115,128,1.5,-180,4.12,Tropicana Field,6,-6
2016-04-14,2016,SF,COL,6,11,-102,1.5,-200,11.5,-120,100,-108,-1.5,170,5.81,Coors Field,17,-5
2016-04-14,2016,MIN,CWS,1,3,-124,-1.5,170,8.5,-115,-105,114,1.5,-200,4.71,Target Field,4,-2
2016-04-14,2016,PIT,DET,4,7,-148,-1.5,155,6.5,-115,-105,133,1.5,-175,3.88,PNC Park,11,-3
2016-04-14,2016,KC,HOU,6,2,113,1.5,-200,8.5,-105,-115,-123,-1.5,170,3.99,Minute Maid Park,8,4
2016-04-14,2016,HOU,KC,2,6,-123,-1.5,170,8.5,-105,-115,113,1.5,-200,4.69,Minute Maid Park,8,-4
2016-04-14,2016,ARI,LAD,2,5,116,1.5,-200,7.5,-115,-105,-126,-1.5,170,3.47,Dodger Stadium,7,-3
2016-04-14,2016,STL,MIL,7,0,-200,-1.5,110,7.5,105,-125,170,1.5,-130,5.0,Busch Stadium,7,7
2016-04-14,2016,CWS,MIN,3,1,114,1.5,-200,8.5,-115,-105,-124,-1.5,170,3.97,Target Field,4,2
2016-04-14,2016,TOR,NYY,4,2,-143,-1.5,140,9.0,-105,-115,128,1.5,-160,5.3,Rogers Centre,6,2
2016-04-14,2016,SD,PHI,0,3,105,1.5,-215,7.0,100,-120,-115,-1.5,185,3.41,Citizens Bank Park,3,-3
2016-04-14,2016,DET,PIT,7,4,133,1.5,-175,6.5,-115,-105,-148,-1.5,155,2.79,PNC Park,11,3
2016-04-14,2016,PHI,SD,3,0,-115,-1.5,185,7.0,100,-120,105,1.5,-215,3.74,Citizens Bank Park,3,3
2016-04-14,2016,COL,SF,11,6,-108,-1.5,170,11.5,-120,100,-102,1.5,-200,5.97,Coors Field,17,5
2016-04-14,2016,MIL,STL,0,7,170,1.5,-130,7.5,105,-125,-200,-1.5,110,2.78,Busch Stadium,7,-7
2016-04-14,2016,CLE,TB,6,0,128,1.5,-180,7.0,-105,-115,-143,-1.5,160,3.07,Tropicana Field,6,6
2016-04-14,2016,BAL,TEX,3,6,117,1.5,-185,8.0,-115,-105,-127,-1.5,165,3.69,Rangers Ballpark,9,-3
2016-04-14,2016,NYY,TOR,2,4,128,1.5,-160,9.0,-105,-115,-143,-1.5,140,3.95,Rogers Centre,6,-2
2016-04-14,2016,ATL,WSH,2,6,205,1.5,-115,7.0,100,-120,-235,-1.5,-105,2.3,Nationals Park,8,-4
2016-04-15,2016,SD,ARI,2,3,136,1.5,-135,6.5,-110,-110,-151,-1.5,115,2.75,PETCO Park,5,-1
2016-04-15,2016,MIA,ATL,3,6,-210,-1.5,-101,8.0,-125,105,180,1.5,-119,5.42,Marlins Park,9,-3
2016-04-15,2016,TEX,BAL,5,11,104,1.5,-165,9.0,-120,100,-114,-1.5,145,4.41,Rangers Ballpark,16,-6
2016-04-15,2016,TOR,BOS,3,5,109,1.5,-185,9.0,-108,-112,-119,-1.5,165,4.31,Fenway Park,8,-2
2016-04-15,2016,COL,CHC,6,1,200,1.5,-110,7.5,100,-120,-240,-1.5,-110,2.5,Wrigley Field,7,5
2016-04-15,2016,STL,CIN,14,3,-185,-1.5,110,7.5,-110,-110,165,1.5,-130,4.87,Busch Stadium,17,11
2016-04-15,2016,NYM,CLE,6,5,109,1.5,-200,8.0,-115,-105,-119,-1.5,170,3.83,Progressive Field,11,1
2016-04-15,2016,CHC,COL,1,6,-240,-1.5,-110,7.5,100,-120,200,1.5,-110,5.29,Wrigley Field,7,-5
2016-04-15,2016,TB,CWS,0,1,-101,1.5,-175,6.5,-120,100,-109,-1.5,155,3.27,Tropicana Field,1,-1
2016-04-15,2016,HOU,DET,1,0,-205,-1.5,-105,9.5,-115,-105,175,1.5,-115,6.39,Minute Maid Park,1,1
2016-04-15,2016,DET,HOU,0,1,175,1.5,-115,9.5,-115,-105,-205,-1.5,-105,3.45,Minute Maid Park,1,-1
2016-04-15,2016,OAK,KC,2,4,-115,-1.5,185,7.0,-130,110,105,1.5,-215,3.74,Oakland Coliseum,6,-2
2016-04-15,2016,MIN,LAA,5,4,135,1.5,-125,8.5,100,-120,-150,-1.5,105,3.62,Target Field,9,1
2016-04-15,2016,SF,LAD,3,7,146,1.5,-165,6.0,-105,-115,-161,-1.5,145,2.44,Dodger Stadium,10,-4
2016-04-15,2016,ATL,MIA,6,3,180,1.5,-119,8.0,-125,105,-210,-1.5,-101,2.86,Marlins Park,9,3
2016-04-15,2016,PIT,MIL,4,8,-140,-1.5,160,7.5,101,-121,125,1.5,-180,4.38,PNC Park,12,-4
2016-04-15,2016,LAA,MIN,4,5,-150,-1.5,105,8.5,100,-120,135,1.5,-125,5.1,Target Field,9,-1
2016-04-15,2016,CLE,NYM,5,6,-119,-1.5,170,8.0,-115,-105,109,1.5,-200,4.35,Progressive Field,11,-1
2016-04-15,2016,SEA,NYY,7,1,127,1.5,-170,8.0,112,-132,-142,-1.5,150,3.52,Yankee Stadium,8,6
2016-04-15,2016,KC,OAK,4,2,105,1.5,-215,7.0,-130,110,-115,-1.5,185,3.41,Oakland Coliseum,6,2
2016-04-15,2016,WSH,PHI,9,1,-145,-1.5,115,7.5,-115,-105,130,1.5,-135,4.44,Citizens Bank Park,10,8
2016-04-15,2016,MIL,PIT,8,4,125,1.5,-180,7.5,101,-121,-140,-1.5,160,3.33,PNC Park,12,4
2016-04-15,2016,ARI,SD,3,2,-151,-1.5,115,6.5,-110,-110,136,1.5,-135,3.91,PETCO Park,5,1
2016-04-15,2016,NYY,SEA,1,7,-142,-1.5,150,8.0,112,-132,127,1.5,-170,4.69,Yankee Stadium,8,-6
2016-04-15,2016,LAD,SF,7,3,-161,-1.5,145,6.0,-105,-115,146,1.5,-165,3.7,Dodger Stadium,10,4
2016-04-15,2016,CIN,STL,3,14,165,1.5,-130,7.5,-110,-110,-185,-1.5,110,2.83,Busch Stadium,17,-11
2016-04-15,2016,CWS,TB,1,0,-109,-1.5,155,6.5,-120,100,-101,1.5,-175,3.39,Tropicana Field,1,1
2016-04-15,2016,BAL,TEX,11,5,-114,-1.5,145,9.0,-120,100,104,1.5,-165,4.79,Rangers Ballpark,16,6
2016-04-15,2016,BOS,TOR,5,3,-119,-1.5,165,9.0,-108,-112,109,1.5,-185,4.89,Fenway Park,8,2
2016-04-15,2016,PHI,WSH,1,9,130,1.5,-135,7.5,-115,-105,-145,-1.5,115,3.26,Citizens Bank Park,10,-8
2016-04-16,2016,SD,ARI,5,3,-103,1.5,-175,7.5,-110,-110,-107,-1.5,155,3.81,PETCO Park,8,2
2016-04-16,2016,MIA,ATL,4,6,-145,-1.5,150,8.5,-115,-105,130,1.5,-170,5.03,Marlins Park,10,-2
2016-04-16,2016,TEX,BAL,8,4,-105,-1.5,175,9.5,-105,-115,-105,1.5,-205,4.87,Rangers Ballpark,12,4
2016-04-16,2016,TOR,BOS,2,4,117,1.5,-180,8.0,102,-122,-132,-1.5,160,3.69,Fenway Park,6,-2
2016-04-16,2016,COL,CHC,2,6,265,1.5,106,7.0,100,-120,-315,-1.5,-126,1.92,Wrigley Field,8,-4
2016-04-16,2016,STL,CIN,8,9,-140,-1.5,165,7.5,-110,-110,125,1.5,-185,4.38,Busch Stadium,17,-1
2016-04-16,2016,NYM,CLE,5,7,-122,-1.5,140,7.5,104,-124,112,1.5,-160,4.12,Progressive Field,12,-2
2016-04-16,2016,CHC,COL,6,2,-315,-1.5,-126,7.0,100,-120,265,1.5,106,5.31,Wrigley Field,8,4
2016-04-16,2016,TB,CWS,7,2,-148,-1.5,150,8.0,-120,100,133,1.5,-170,4.77,Tropicana Field,9,5
2016-04-16,2016,HOU,DET,3,5,-127,-1.5,165,9.0,-105,-115,117,1.5,-185,5.04,Minute Maid Park,8,-2
2016-04-16,2016,DET,HOU,5,3,117,1.5,-185,9.0,-105,-115,-127,-1.5,165,4.15,Minute Maid Park,8,2
2016-04-16,2016,OAK,KC,5,3,-144,-1.5,155,7.5,100,-120,129,1.5,-175,4.43,Oakland Coliseum,8,2
2016-04-16,2016,MIN,LAA,6,4,-124,-1.5,165,9.5,100,-120,114,1.5,-185,5.26,Target Field,10,2
2016-04-16,2016,SF,LAD,4,3,-107,-1.5,165,7.5,-106,-114,-103,1.5,-185,3.88,Dodger Stadium,7,1
2016-04-16,2016,ATL,MIA,6,4,130,1.5,-170,8.5,-115,-105,-145,-1.5,150,3.7,Marlins Park,10,2
2016-04-16,2016,PIT,MIL,5,0,-140,-1.5,155,8.0,-120,100,125,1.5,-175,4.67,PNC Park,5,5
2016-04-16,2016,LAA,MIN,4,6,114,1.5,-185,9.5,100,-120,-124,-1.5,165,4.44,Target Field,10,-2
2016-04-16,2016,CLE,NYM,7,5,112,1.5,-160,7.5,104,-124,-122,-1.5,140,3.54,Progressive Field,12,2
2016-04-16,2016,SEA,NYY,3,2,-122,-1.5,130,7.5,-110,-110,112,1.5,-150,4.12,Yankee Stadium,5,1
2016-04-16,2016,KC,OAK,3,5,129,1.5,-175,7.5,100,-120,-144,-1.5,155,3.28,Oakland Coliseum,8,-2
2016-04-16,2016,WSH,PHI,8,1,-206,-1.5,-120,7.0,100,-120,176,1.5,100,4.71,Citizens Bank Park,9,7
2016-04-16,2016,MIL,PIT,0,5,125,1.5,-175,8.0,-120,100,-140,-1.5,155,3.56,PNC Park,5,-5
2016-04-16,2016,ARI,SD,3,5,-107,-1.5,155,7.5,-110,-110,-103,1.5,-175,3.88,PETCO Park,8,-2
2016-04-16,2016,NYY,SEA,2,3,112,1.5,-150,7.5,-110,-110,-122,-1.5,130,3.54,Yankee Stadium,5,-1
2016-04-16,2016,LAD,SF,3,4,-103,1.5,-185,7.5,-106,-114,-107,-1.5,165,3.81,Dodger Stadium,7,-1
2016-04-16,2016,CIN,STL,9,8,125,1.5,-185,7.5,-110,-110,-140,-1.5,165,3.33,Busch Stadium,17,1
2016-04-16,2016,CWS,TB,2,7,133,1.5,-170,8.0,-120,100,-148,-1.5,150,3.43,Tropicana Field,9,-5
2016-04-16,2016,BAL,TEX,4,8,-105,1.5,-205,9.5,-105,-115,-105,-1.5,175,4.87,Rangers Ballpark,12,-4
2016-04-16,2016,BOS,TOR,4,2,-132,-1.5,160,8.0,102,-122,117,1.5,-180,4.55,Fenway Park,6,2
2016-04-16,2016,PHI,WSH,1,8,176,1.5,100,7.0,100,-120,-206,-1.5,-120,2.54,Citizens Bank Park,9,-7
2016-04-17,2016,SD,ARI,3,7,-112,-1.5,190,7.0,-120,100,102,1.5,-230,3.7,PETCO Park,10,-4
2016-04-17,2016,MIA,ATL,5,6,-127,-1.5,170,8.0,100,-120,117,1.5,-200,4.48,Marlins Park,11,-1
2016-04-17,2016,TOR,BOS,5,3,-141,-1.5,115,9.0,-111,-109,126,1.5,-135,5.27,Fenway Park,8,2
2016-04-17,2016,COL,CHC,2,0,200,1.5,-115,7.5,-105,-115,-230,-1.5,-105,2.5,Wrigley Field,2,2
2016-04-17,2016,STL,CIN,4,3,-177,-1.5,120,8.0,-115,-105,157,1.5,-140,5.11,Busch Stadium,7,1
2016-04-17,2016,NYM,CLE,6,0,144,1.5,-155,7.5,-110,-110,-159,-1.5,135,3.07,Progressive Field,6,6
2016-04-17,2016,CHC,COL,0,2,-230,-1.5,-105,7.5,-105,-115,200,1.5,-115,5.23,Wrigley Field,2,-2
2016-04-17,2016,TB,CWS,3,2,-101,1.5,-185,7.0,-125,105,-109,-1.5,164,3.52,Tropicana Field,5,1
2016-04-17,2016,HOU,DET,5,4,-121,-1.5,170,8.5,-110,-110,111,1.5,-200,4.65,Minute Maid Park,9,1
2016-04-17,2016,DET,HOU,4,5,111,1.5,-200,8.5,-110,-110,-121,-1.5,170,4.03,Minute Maid Park,9,-1
2016-04-17,2016,OAK,KC,3,2,100,1.5,-170,8.5,-110,-110,-110,-1.5,150,4.25,Oakland Coliseum,5,1
2016-04-17,2016,MIN,LAA,3,2,-102,1.5,-170,9.0,-117,-103,-108,-1.5,150,4.54,Target Field,5,1
2016-04-17,2016,SF,LAD,1,3,130,1.5,-170,8.0,-120,100,-145,-1.5,150,3.48,Dodger Stadium,4,-2
2016-04-17,2016,ATL,MIA,6,5,117,1.5,-200,8.0,100,-120,-127,-1.5,170,3.69,Marlins Park,11,1
2016-04-17,2016,PIT,MIL,9,3,-125,-1.5,170,8.0,-115,-105,115,1.5,-200,4.44,PNC Park,12,6
2016-04-17,2016,LAA,MIN,2,3,-108,-1.5,150,9.0,-117,-103,-102,1.5,-170,4.67,Target Field,5,-1
2016-04-17,2016,CLE,NYM,0,6,-159,-1.5,135,7.5,-110,-110,144,1.5,-155,4.6,Progressive Field,6,-6
2016-04-17,2016,SEA,NYY,3,4,118,1.5,-185,7.5,-115,-105,-128,-1.5,165,3.44,Yankee Stadium,7,-1
2016-04-17,2016,KC,OAK,2,3,-110,-1.5,150,8.5,-110,-110,100,1.5,-170,4.45,Oakland Coliseum,5,-1
2016-04-17,2016,WSH,PHI,2,3,-150,-1.5,115,8.0,-113,-107,135,1.5,-135,4.8,Citizens Bank Park,5,-1
2016-04-17,2016,MIL,PIT,3,9,115,1.5,-200,8.0,-115,-105,-125,-1.5,170,3.72,PNC Park,12,-6
2016-04-17,2016,ARI,SD,7,3,102,1.5,-230,7.0,-120,100,-112,-1.5,190,3.47,PETCO Park,10,4
2016-04-17,2016,NYY,SEA,4,3,-128,-1.5,165,7.5,-115,-105,118,1.5,-185,4.21,Yankee Stadium,7,1
2016-04-17,2016,LAD,SF,3,1,-145,-1.5,150,8.0,-120,100,130,1.5,-170,4.73,Dodger Stadium,4,2
2016-04-17,2016,CIN,STL,3,4,157,1.5,-140,8.0,-115,-105,-177,-1.5,120,3.11,Busch Stadium,7,-1
2016-04-17,2016,CWS,TB,2,3,-109,-1.5,164,7.0,-125,105,-101,1.5,-185,3.65,Tropicana Field,5,-1
2016-04-17,2016,BOS,TOR,3,5,126,1.5,-135,9.0,-111,-109,-141,-1.5,115,3.98,Fenway Park,8,-2
2016-04-17,2016,PHI,WSH,3,2,135,1.5,-135,8.0,-113,-107,-150,-1.5,115,3.4,Citizens Bank Park,5,1
2016-04-18,2016,SF,ARI,7,9,-145,-1.5,150,8.0,-115,-105,130,1.5,-170,4.73,AT&T Park,16,-2
2016-04-18,2016,TOR,BOS,4,3,-105,-1.5,155,8.5,-120,100,-105,1.5,-175,4.35,Fenway Park,7,1
2016-04-18,2016,STL,CHC,0,5,104,1.5,-160,8.5,100,-120,-114,-1.5,140,4.17,Busch Stadium,5,-5
2016-04-18,2016,COL,CIN,5,1,117,1.5,-185,8.5,100,-120,-127,-1.5,165,3.92,Great American Ballpark,6,4
2016-04-18,2016,CIN,COL,1,5,-127,-1.5,165,8.5,100,-120,117,1.5,-185,4.76,Great American Ballpark,6,-4
2016-04-18,2016,LAA,CWS,7,0,107,1.5,-200,9.0,100,-120,-117,-1.5,170,4.35,Guaranteed Rate Field,7,7
2016-04-18,2016,CWS,LAA,0,7,-117,-1.5,170,9.0,100,-120,107,1.5,-200,4.85,Guaranteed Rate Field,7,-7
2016-04-18,2016,WSH,MIA,1,6,156,1.5,-145,7.5,-105,-115,-176,-1.5,125,2.93,Marlins Park,7,-5
2016-04-18,2016,MIN,MIL,7,4,-141,-1.5,150,8.0,-105,-115,126,1.5,-170,4.68,Target Field,11,3
2016-04-18,2016,MIL,MIN,4,7,126,1.5,-170,8.0,-105,-115,-141,-1.5,150,3.54,Target Field,11,-3
2016-04-18,2016,PHI,NYM,2,5,151,1.5,-110,7.5,100,-120,-171,-1.5,-110,2.99,Citizens Bank Park,7,-3
2016-04-18,2016,NYM,PHI,5,2,-171,-1.5,-110,7.5,100,-120,151,1.5,-110,4.73,Citizens Bank Park,7,3
2016-04-18,2016,ARI,SF,9,7,130,1.5,-170,8.0,-115,-105,-145,-1.5,150,3.48,AT&T Park,16,2
2016-04-18,2016,CHC,STL,5,0,-114,-1.5,140,8.5,100,-120,104,1.5,-160,4.53,Busch Stadium,5,5
2016-04-18,2016,BOS,TOR,3,4,-105,1.5,-175,8.5,-120,100,-105,-1.5,155,4.35,Fenway Park,7,-1
2016-04-18,2016,MIA,WSH,6,1,-176,-1.5,125,7.5,-105,-115,156,1.5,-145,4.78,Marlins Park,7,5
2016-04-19,2016,SF,ARI,0,3,-118,-1.5,175,7.5,-115,-105,108,1.5,-205,4.06,AT&T Park,3,-3
2016-04-19,2016,LAD,ATL,1,8,-215,-1.5,-127,8.0,-115,-105,185,1.5,107,5.46,Turner Field,9,-7
2016-04-19,2016,TOR,BAL,4,3,-132,-1.5,118,9.0,100,-120,117,1.5,-138,5.12,Camden Yards,7,1
2016-04-19,2016,TB,BOS,3,0,-112,-1.5,145,8.5,-110,-110,102,1.5,-165,4.49,Fenway Park,3,3
2016-04-19,2016,STL,CHC,1,2,-117,-1.5,183,7.5,-105,-115,107,1.5,-211,4.04,Busch Stadium,3,-1
2016-04-19,2016,COL,CIN,3,4,102,1.5,-204,8.5,-113,-107,-112,-1.5,174,4.21,Great American Ballpark,7,-1
2016-04-19,2016,SEA,CLE,2,3,136,1.5,-155,7.5,105,-125,-151,-1.5,135,3.18,Progressive Field,5,-1
2016-04-19,2016,CIN,COL,4,3,-112,-1.5,174,8.5,-113,-107,102,1.5,-204,4.49,Great American Ballpark,7,1
2016-04-19,2016,LAA,CWS,0,5,104,1.5,-200,8.0,-120,100,-114,-1.5,170,3.92,Guaranteed Rate Field,5,-5
2016-04-19,2016,KC,DET,8,6,-163,-1.5,125,8.0,-119,-101,148,1.5,-145,4.96,Kauffman Stadium,14,2
2016-04-19,2016,TEX,HOU,7,5,-107,-1.5,185,9.0,-115,-105,-103,1.5,-215,4.65,Rangers Ballpark,12,2
2016-04-19,2016,DET,KC,6,8,148,1.5,-145,8.0,-119,-101,-163,-1.5,125,3.23,Kauffman Stadium,14,-2
2016-04-19,2016,CWS,LAA,5,0,-114,-1.5,170,8.0,-120,100,104,1.5,-200,4.26,Guaranteed Rate Field,5,5
2016-04-19,2016,ATL,LAD,8,1,185,1.5,107,8.0,-115,-105,-215,-1.5,-127,2.81,Turner Field,9,7
2016-04-19,2016,WSH,MIA,7,0,-146,-1.5,110,7.5,101,-121,131,1.5,-130,4.45,Marlins Park,7,7
2016-04-19,2016,MIN,MIL,5,6,-177,-1.5,110,8.0,-110,-110,157,1.5,-130,5.11,Target Field,11,-1
2016-04-19,2016,MIL,MIN,6,5,157,1.5,-130,8.0,-110,-110,-177,-1.5,110,3.11,Target Field,11,1
2016-04-19,2016,PHI,NYM,1,11,-101,1.5,-165,7.5,-105,-115,-109,-1.5,145,3.77,Citizens Bank Park,12,-10
2016-04-19,2016,OAK,NYY,3,2,149,1.5,-150,8.5,-110,-110,-164,-1.5,130,3.41,Yankee Stadium,5,1
2016-04-19,2016,NYY,OAK,2,3,-164,-1.5,130,8.5,-110,-110,149,1.5,-150,5.28,Yankee Stadium,5,-1
2016-04-19,2016,NYM,PHI,11,1,-109,-1.5,145,7.5,-105,-115,-101,1.5,-165,3.91,Citizens Bank Park,12,10
2016-04-19,2016,SD,PIT,5,4,139,1.5,-120,7.5,-115,-105,-154,-1.5,100,3.14,PETCO Park,9,1
2016-04-19,2016,PIT,SD,4,5,-154,-1.5,100,7.5,-115,-105,139,1.5,-120,4.55,PETCO Park,9,-1
2016-04-19,2016,CLE,SEA,3,2,-151,-1.5,135,7.5,105,-125,136,1.5,-155,4.51,Progressive Field,5,1
2016-04-19,2016,ARI,SF,3,0,108,1.5,-205,7.5,-115,-105,-118,-1.5,175,3.61,AT&T Park,3,3
2016-04-19,2016,CHC,STL,2,1,107,1.5,-211,7.5,-105,-115,-117,-1.5,183,3.62,Busch Stadium,3,1
2016-04-19,2016,BOS,TB,0,3,102,1.5,-165,8.5,-110,-110,-112,-1.5,145,4.21,Fenway Park,3,-3
2016-04-19,2016,HOU,TEX,5,7,-103,1.5,-215,9.0,-115,-105,-107,-1.5,185,4.57,Rangers Ballpark,12,-2
2016-04-19,2016,BAL,TOR,3,4,117,1.5,-138,9.0,100,-120,-132,-1.5,118,4.15,Camden Yards,7,-1
2016-04-19,2016,MIA,WSH,0,7,131,1.5,-130,7.5,101,-121,-146,-1.5,110,3.25,Marlins Park,7,-7
2016-04-20,2016,SF,ARI,1,2,-145,-1.5,170,6.5,-110,-110,130,1.5,-200,3.85,AT&T Park,3,-1
2016-04-20,2016,LAD,ATL,5,3,-155,-1.5,100,8.5,100,-120,140,1.5,-120,5.17,Turner Field,8,2
2016-04-20,2016,TOR,BAL,3,4,107,1.5,-200,9.0,100,-120,-117,-1.5,170,4.35,Camden Yards,7,-1
2016-04-20,2016,TB,BOS,3,7,-105,-1.5,160,8.0,-105,-115,-105,1.5,-180,4.1,Fenway Park,10,-4
2016-04-20,2016,STL,CHC,5,3,-116,-1.5,185,7.5,100,-120,106,1.5,-215,4.03,Busch Stadium,8,2
2016-04-20,2016,COL,CIN,5,6,117,1.5,-200,7.5,-109,-111,-127,-1.5,170,3.46,Great American Ballpark,11,-1
2016-04-20,2016,SEA,CLE,2,1,119,1.5,-185,7.5,100,-120,-129,-1.5,165,3.42,Progressive Field,3,1
2016-04-20,2016,CIN,COL,6,5,-127,-1.5,170,7.5,-109,-111,117,1.5,-200,4.2,Great American Ballpark,11,1
2016-04-20,2016,LAA,CWS,1,2,139,1.5,-160,7.0,-110,-110,-154,-1.5,140,2.93,Guaranteed Rate Field,3,-1
2016-04-20,2016,KC,DET,2,3,-132,-1.5,170,8.0,-105,-115,117,1.5,-200,4.55,Kauffman Stadium,5,-1
2016-04-20,2016,TEX,HOU,2,1,-123,-1.5,165,8.5,-120,100,113,1.5,-185,4.69,Rangers Ballpark,3,1
2016-04-20,2016,DET,KC,3,2,117,1.5,-200,8.0,-105,-115,-132,-1.5,170,3.69,Kauffman Stadium,5,1
2016-04-20,2016,CWS,LAA,2,1,-154,-1.5,140,7.0,-110,-110,139,1.5,-160,4.24,Guaranteed Rate Field,3,1
2016-04-20,2016,ATL,LAD,3,5,140,1.5,-120,8.5,100,-120,-155,-1.5,100,3.54,Turner Field,8,-2
2016-04-20,2016,WSH,MIA,3,1,-108,-1.5,159,7.5,-115,-105,-102,1.5,-179,3.89,Marlins Park,4,2
2016-04-20,2016,MIN,MIL,5,10,125,1.5,-175,9.0,100,-120,-140,-1.5,155,4.0,Miller Park,15,-5
2016-04-20,2016,MIL,MIN,10,5,-140,-1.5,155,9.0,100,-120,125,1.5,-175,5.25,Miller Park,15,5
2016-04-20,2016,PHI,NYM,5,4,145,1.5,-120,8.0,-116,-104,-160,-1.5,100,3.27,Citizens Bank Park,9,1
2016-04-20,2016,OAK,NYY,5,2,131,1.5,-165,8.5,-105,-115,-146,-1.5,145,3.68,Yankee Stadium,7,3
2016-04-20,2016,NYY,OAK,2,5,-146,-1.5,145,8.5,-105,-115,131,1.5,-165,5.04,Yankee Stadium,7,-3
2016-04-20,2016,NYM,PHI,4,5,-160,-1.5,100,8.0,-116,-104,145,1.5,-120,4.92,Citizens Bank Park,9,-1
2016-04-20,2016,SD,PIT,8,2,-101,1.5,-175,8.0,100,-120,-109,-1.5,155,4.02,PETCO Park,10,6
2016-04-20,2016,PIT,SD,2,8,-109,-1.5,155,8.0,100,-120,-101,1.5,-175,4.17,PETCO Park,10,-6
2016-04-20,2016,CLE,SEA,1,2,-129,-1.5,165,7.5,100,-120,119,1.5,-185,4.22,Progressive Field,3,-1
2016-04-20,2016,ARI,SF,2,1,130,1.5,-200,6.5,-110,-110,-145,-1.5,170,2.83,AT&T Park,3,1
2016-04-20,2016,CHC,STL,3,5,106,1.5,-215,7.5,100,-120,-116,-1.5,185,3.64,Busch Stadium,8,-2
2016-04-20,2016,BOS,TB,7,3,-105,1.5,-180,8.0,-105,-115,-105,-1.5,160,4.1,Fenway Park,10,4
2016-04-20,2016,HOU,TEX,1,2,113,1.5,-185,8.5,-120,100,-123,-1.5,165,3.99,Rangers Ballpark,3,-1
2016-04-20,2016,BAL,TOR,4,3,-117,-1.5,170,9.0,100,-120,107,1.5,-200,4.85,Camden Yards,7,1
2016-04-20,2016,MIA,WSH,1,3,-102,1.5,-179,7.5,-115,-105,-108,-1.5,159,3.79,Marlins Park,4,-2
2016-04-21,2016,SF,ARI,2,6,-177,-1.5,130,7.5,105,-125,157,1.5,-150,4.79,AT&T Park,8,-4
2016-04-21,2016,LAD,ATL,2,1,-290,-1.5,-145,6.5,-110,-110,250,1.5,125,4.83,Turner Field,3,1
2016-04-21,2016,TOR,BAL,2,3,-123,-1.5,126,8.5,-122,102,113,1.5,-146,4.69,Camden Yards,5,-1
2016-04-21,2016,TB,BOS,12,8,140,1.5,-160,8.5,-105,-115,-155,-1.5,140,3.54,Fenway Park,20,4
2016-04-21,2016,CIN,CHC,0,16,170,1.5,-101,7.5,100,-120,-200,-1.5,-119,2.78,Great American Ballpark,16,-16
2016-04-21,2016,CHC,CIN,16,0,-200,-1.5,-119,7.5,100,-120,170,1.5,-101,5.0,Great American Ballpark,16,16
2016-04-21,2016,SEA,CLE,10,7,-114,-1.5,145,9.0,-105,-115,104,1.5,-165,4.79,Progressive Field,17,3
2016-04-21,2016,LAA,CWS,3,2,-105,1.5,-215,10.5,-115,-105,-105,-1.5,185,5.38,Guaranteed Rate Field,5,1
2016-04-21,2016,KC,DET,4,0,-159,-1.5,130,9.0,100,-120,144,1.5,-150,5.53,Kauffman Stadium,4,4
2016-04-21,2016,TEX,HOU,7,4,170,1.5,100,8.5,-105,-115,-190,-1.5,-120,3.15,Rangers Ballpark,11,3
2016-04-21,2016,DET,KC,0,4,144,1.5,-150,9.0,100,-120,-159,-1.5,130,3.69,Kauffman Stadium,4,-4
2016-04-21,2016,CWS,LAA,2,3,-105,-1.5,185,10.5,-115,-105,-105,1.5,-215,5.38,Guaranteed Rate Field,5,-1
2016-04-21,2016,ATL,LAD,1,2,250,1.5,125,6.5,-110,-110,-290,-1.5,-145,1.86,Turner Field,3,-1
2016-04-21,2016,WSH,MIA,1,5,-205,-1.5,-125,7.0,-115,-105,175,1.5,105,4.7,Marlins Park,6,-4
2016-04-21,2016,MIN,MIL,8,1,-105,1.5,-210,9.0,100,-120,-105,-1.5,180,4.61,Miller Park,9,7
2016-04-21,2016,MIL,MIN,1,8,-105,-1.5,180,9.0,100,-120,-105,1.5,-210,4.61,Miller Park,9,-7
2016-04-21,2016,OAK,NYY,7,3,115,1.5,-185,8.0,-115,-105,-125,-1.5,165,3.72,Yankee Stadium,10,4
2016-04-21,2016,NYY,OAK,3,7,-125,-1.5,165,8.0,-115,-105,115,1.5,-185,4.44,Yankee Stadium,10,-4
2016-04-21,2016,SD,PIT,1,11,140,1.5,-122,7.0,-105,-115,-155,-1.5,102,2.92,PETCO Park,12,-10
2016-04-21,2016,PIT,SD,11,1,-155,-1.5,102,7.0,-105,-115,140,1.5,-122,4.25,PETCO Park,12,10
2016-04-21,2016,CLE,SEA,7,10,104,1.5,-165,9.0,-105,-115,-114,-1.5,145,4.41,Progressive Field,17,-3
2016-04-21,2016,ARI,SF,6,2,157,1.5,-150,7.5,105,-125,-177,-1.5,130,2.92,AT&T Park,8,4
2016-04-21,2016,BOS,TB,8,12,-155,-1.5,140,8.5,-105,-115,140,1.5,-160,5.17,Fenway Park,20,-4
2016-04-21,2016,HOU,TEX,4,7,-190,-1.5,-120,8.5,-105,-115,170,1.5,100,5.57,Rangers Ballpark,11,-3
2016-04-21,2016,BAL,TOR,3,2,113,1.5,-146,8.5,-122,102,-123,-1.5,126,3.99,Camden Yards,5,1
2016-04-21,2016,MIA,WSH,5,1,175,1.5,105,7.0,-115,-105,-205,-1.5,-125,2.55,Marlins Park,6,4
2016-04-22,2016,PIT,ARI,8,7,118,1.5,-185,9.0,-111,-109,-128,-1.5,165,4.13,Chase Field,15,1
2016-04-22,2016,NYM,ATL,6,3,-200,-1.5,-127,8.0,-110,-110,170,1.5,106,5.33,Turner Field,9,3
2016-04-22,2016,KC,BAL,4,2,-131,-1.5,160,8.5,-101,-119,116,1.5,-180,4.82,Kauffman Stadium,6,2
2016-04-22,2016,HOU,BOS,2,6,-144,-1.5,150,8.5,-120,100,129,1.5,-170,5.02,Minute Maid Park,8,-4
2016-04-22,2016,CIN,CHC,1,8,180,1.5,110,8.5,-125,105,-210,-1.5,-130,3.04,Great American Ballpark,9,-7
2016-04-22,2016,CHC,CIN,8,1,-210,-1.5,-130,8.5,-125,105,180,1.5,110,5.76,Great American Ballpark,9,7
2016-04-22,2016,DET,CLE,1,2,-105,-1.5,185,8.0,100,-120,-105,1.5,-215,4.1,Comerica Park,3,-1
2016-04-22,2016,LAD,COL,5,7,-124,-1.5,125,11.0,-120,100,114,1.5,-145,6.09,Coors Field,12,-2
2016-04-22,2016,TEX,CWS,0,5,160,1.5,-135,7.5,-110,-110,-180,-1.5,115,2.88,Guaranteed Rate Field,5,-5
2016-04-22,2016,CLE,DET,2,1,-105,1.5,-215,8.0,100,-120,-105,-1.5,185,4.1,Comerica Park,3,1
2016-04-22,2016,BOS,HOU,6,2,129,1.5,-170,8.5,-120,100,-144,-1.5,150,3.71,Minute Maid Park,8,4
2016-04-22,2016,BAL,KC,2,4,116,1.5,-180,8.5,-101,-119,-131,-1.5,160,3.94,Kauffman Stadium,6,-2
2016-04-22,2016,SEA,LAA,5,2,-105,1.5,-230,7.5,-108,-112,-105,-1.5,190,3.84,Angel Stadium,7,3
2016-04-22,2016,COL,LAD,7,5,114,1.5,-145,11.0,-120,100,-124,-1.5,125,5.14,Coors Field,12,2
2016-04-22,2016,SF,MIA,8,1,-170,-1.5,125,8.0,-110,-110,150,1.5,-145,5.04,AT&T Park,9,7
2016-04-22,2016,PHI,MIL,5,2,118,1.5,-200,8.0,-120,100,-128,-1.5,170,3.67,Miller Park,7,3
2016-04-22,2016,WSH,MIN,8,4,-163,-1.5,125,8.0,-105,-115,148,1.5,-145,4.96,Nationals Park,12,4
2016-04-22,2016,ATL,NYM,3,6,170,1.5,106,8.0,-110,-110,-200,-1.5,-127,2.96,Turner Field,9,-3
2016-04-22,2016,TB,NYY,3,6,-113,-1.5,145,9.0,-106,-114,103,1.5,-165,4.77,Yankee Stadium,9,-3
2016-04-22,2016,TOR,OAK,5,8,-120,-1.5,170,8.0,100,-120,110,1.5,-200,4.36,Rogers Centre,13,-3
2016-04-22,2016,MIL,PHI,2,5,-128,-1.5,170,8.0,-120,100,118,1.5,-200,4.49,Miller Park,7,-3
2016-04-22,2016,ARI,PIT,7,8,-128,-1.5,165,9.0,-111,-109,118,1.5,-185,5.05,Chase Field,15,-1
2016-04-22,2016,STL,SD,1,4,-140,-1.5,130,7.0,-110,-110,125,1.5,-150,4.08,PETCO Park,5,-3
2016-04-22,2016,LAA,SEA,2,5,-105,-1.5,190,7.5,-108,-112,-105,1.5,-230,3.84,Angel Stadium,7,-3
2016-04-22,2016,MIA,SF,1,8,150,1.5,-145,8.0,-110,-110,-170,-1.5,125,3.2,AT&T Park,9,-7
2016-04-22,2016,SD,STL,4,1,125,1.5,-150,7.0,-110,-110,-140,-1.5,130,3.11,PETCO Park,5,3
2016-04-22,2016,NYY,TB,6,3,103,1.5,-165,9.0,-106,-114,-113,-1.5,145,4.43,Yankee Stadium,9,3
2016-04-22,2016,CWS,TEX,5,0,-180,-1.5,115,7.5,-110,-110,160,1.5,-135,4.82,Guaranteed Rate Field,5,5
2016-04-22,2016,OAK,TOR,8,5,110,1.5,-200,8.0,100,-120,-120,-1.5,170,3.81,Rogers Centre,13,3
2016-04-22,2016,MIN,WSH,4,8,148,1.5,-145,8.0,-105,-115,-163,-1.5,125,3.23,Nationals Park,12,-4
2016-04-23,2016,PIT,ARI,1,7,-110,-1.5,145,9.0,-110,-110,100,1.5,-165,4.71,Chase Field,8,-6
2016-04-23,2016,NYM,ATL,8,2,-149,-1.5,115,7.5,100,-120,134,1.5,-135,4.49,Turner Field,10,6
2016-04-23,2016,KC,BAL,3,8,-119,-1.5,170,9.0,100,-120,109,1.5,-200,4.89,Kauffman Stadium,11,-5
2016-04-23,2016,HOU,BOS,8,3,-131,-1.5,150,8.5,-120,100,116,1.5,-170,4.82,Minute Maid Park,11,5
2016-04-23,2016,CIN,CHC,13,5,154,1.5,-110,8.5,100,-120,-174,-1.5,-110,3.35,Great American Ballpark,18,8
2016-04-23,2016,CHC,CIN,5,13,-174,-1.5,-110,8.5,100,-120,154,1.5,-110,5.4,Great American Ballpark,18,-8
2016-04-23,2016,DET,CLE,1,10,106,1.5,-160,8.0,100,-120,-116,-1.5,140,3.88,Comerica Park,11,-9
2016-04-23,2016,LAD,COL,4,1,-117,-1.5,130,11.0,-115,-105,107,1.5,-150,5.93,Coors Field,5,3
2016-04-23,2016,TEX,CWS,3,4,127,1.5,-170,8.0,-115,-105,-142,-1.5,150,3.52,Guaranteed Rate Field,7,-1
2016-04-23,2016,CLE,DET,10,1,-116,-1.5,140,8.0,100,-120,106,1.5,-160,4.3,Comerica Park,11,9
2016-04-23,2016,BOS,HOU,3,8,116,1.5,-170,8.5,-120,100,-131,-1.5,150,3.94,Minute Maid Park,11,-5
2016-04-23,2016,BAL,KC,8,3,109,1.5,-200,9.0,100,-120,-119,-1.5,170,4.31,Kauffman Stadium,11,5
2016-04-23,2016,SEA,LAA,2,4,102,1.5,-215,7.0,-119,-101,-112,-1.5,185,3.47,Angel Stadium,6,-2
2016-04-23,2016,COL,LAD,1,4,107,1.5,-150,11.0,-115,-105,-117,-1.5,130,5.31,Coors Field,5,-3
2016-04-23,2016,SF,MIA,7,2,109,1.5,-165,7.0,-105,-115,-119,-1.5,145,3.35,AT&T Park,9,5
2016-04-23,2016,PHI,MIL,10,6,125,1.5,-175,8.5,-105,-115,-140,-1.5,155,3.78,Miller Park,16,4
2016-04-23,2016,WSH,MIN,2,0,-123,-1.5,170,8.5,100,-120,113,1.5,-200,4.69,Nationals Park,2,2
2016-04-23,2016,ATL,NYM,2,8,134,1.5,-135,7.5,100,-120,-149,-1.5,115,3.21,Turner Field,10,-6
2016-04-23,2016,TB,NYY,2,3,148,1.5,-160,7.5,-115,-105,-163,-1.5,140,3.02,Yankee Stadium,5,-1
2016-04-23,2016,TOR,OAK,9,3,-180,-1.5,115,8.5,-110,-110,160,1.5,-135,5.46,Rogers Centre,12,6
2016-04-23,2016,MIL,PHI,6,10,-140,-1.5,155,8.5,-105,-115,125,1.5,-175,4.96,Miller Park,16,-4
2016-04-23,2016,ARI,PIT,7,1,100,1.5,-165,9.0,-110,-110,-110,-1.5,145,4.5,Chase Field,8,6
2016-04-23,2016,STL,SD,11,2,-148,-1.5,110,7.0,-125,105,133,1.5,-130,4.18,PETCO Park,13,9
2016-04-23,2016,LAA,SEA,4,2,-112,-1.5,185,7.0,-119,-101,102,1.5,-215,3.7,Angel Stadium,6,2
2016-04-23,2016,MIA,SF,2,7,-119,-1.5,145,7.0,-105,-115,109,1.5,-165,3.8,AT&T Park,9,-5
2016-04-23,2016,SD,STL,2,11,133,1.5,-130,7.0,-125,105,-148,-1.5,110,3.0,PETCO Park,13,-9
2016-04-23,2016,NYY,TB,3,2,-163,-1.5,140,7.5,-115,-105,148,1.5,-160,4.65,Yankee Stadium,5,1
2016-04-23,2016,CWS,TEX,4,3,-142,-1.5,150,8.0,-115,-105,127,1.5,-170,4.69,Guaranteed Rate Field,7,1
2016-04-23,2016,OAK,TOR,3,9,160,1.5,-135,8.5,-110,-110,-180,-1.5,115,3.27,Rogers Centre,12,-6
2016-04-23,2016,MIN,WSH,0,2,113,1.5,-200,8.5,100,-120,-123,-1.5,170,3.99,Nationals Park,2,-2
2016-04-24,2016,PIT,ARI,12,10,-116,-1.5,145,8.5,-105,-115,106,1.5,-165,4.56,Chase Field,22,2
2016-04-24,2016,NYM,ATL,3,2,-170,-1.5,-110,7.5,105,-125,150,1.5,-110,4.72,Turner Field,5,1
2016-04-24,2016,KC,BAL,6,1,-141,-1.5,155,8.5,-120,100,126,1.5,-175,4.97,Kauffman Stadium,7,5
2016-04-24,2016,HOU,BOS,5,7,-105,-1.5,180,9.0,-115,-105,-105,1.5,-210,4.61,Minute Maid Park,12,-2
2016-04-24,2016,CIN,CHC,0,9,151,1.5,-116,9.0,-102,-118,-171,-1.5,-104,3.59,Great American Ballpark,9,-9
2016-04-24,2016,CHC,CIN,9,0,-171,-1.5,-104,9.0,-102,-118,151,1.5,-116,5.68,Great American Ballpark,9,9
2016-04-24,2016,DET,CLE,3,6,151,1.5,-110,8.0,-105,-115,-171,-1.5,-110,3.19,Comerica Park,9,-3
2016-04-24,2016,LAD,COL,12,10,-124,-1.5,120,11.0,-119,-101,114,1.5,-140,6.09,Coors Field,22,2
2016-04-24,2016,TEX,CWS,1,4,114,1.5,-200,8.5,-120,100,-124,-1.5,170,3.97,Guaranteed Rate Field,5,-3
2016-04-24,2016,CLE,DET,6,3,-171,-1.5,-110,8.0,-105,-115,151,1.5,-110,5.05,Comerica Park,9,3
2016-04-24,2016,BOS,HOU,7,5,-105,1.5,-210,9.0,-115,-105,-105,-1.5,180,4.61,Minute Maid Park,12,2
2016-04-24,2016,BAL,KC,1,6,126,1.5,-175,8.5,-120,100,-141,-1.5,155,3.76,Kauffman Stadium,7,-5
2016-04-24,2016,SEA,LAA,9,4,111,1.5,-185,8.0,-105,-115,-121,-1.5,165,3.79,Angel Stadium,13,5
2016-04-24,2016,COL,LAD,10,12,114,1.5,-140,11.0,-119,-101,-124,-1.5,120,5.14,Coors Field,22,-2
2016-04-24,2016,SF,MIA,4,5,100,1.5,-170,8.0,-112,-108,-110,-1.5,150,4.0,AT&T Park,9,-1
2016-04-24,2016,PHI,MIL,5,8,-109,-1.5,150,8.5,-105,-115,-101,1.5,-170,4.43,Miller Park,13,-3
2016-04-24,2016,WSH,MIN,6,5,-163,-1.5,135,7.0,100,-120,148,1.5,-155,4.34,Nationals Park,11,1
2016-04-24,2016,ATL,NYM,2,3,150,1.5,-110,7.5,105,-125,-170,-1.5,-110,3.0,Turner Field,5,-1
2016-04-24,2016,TB,NYY,8,1,110,1.5,-210,7.5,100,-120,-120,-1.5,180,3.57,Yankee Stadium,9,7
2016-04-24,2016,TOR,OAK,6,3,-195,-1.5,105,9.5,-105,-115,175,1.5,-125,6.28,Rogers Centre,9,3
2016-04-24,2016,MIL,PHI,8,5,-101,1.5,-170,8.5,-105,-115,-109,-1.5,150,4.27,Miller Park,13,3
2016-04-24,2016,ARI,PIT,10,12,106,1.5,-165,8.5,-105,-115,-116,-1.5,145,4.13,Chase Field,22,-2
2016-04-24,2016,STL,SD,8,5,-150,-1.5,105,8.0,100,-120,135,1.5,-125,4.8,PETCO Park,13,3
2016-04-24,2016,LAA,SEA,4,9,-121,-1.5,165,8.0,-105,-115,111,1.5,-185,4.38,Angel Stadium,13,-5
2016-04-24,2016,MIA,SF,5,4,-110,-1.5,150,8.0,-112,-108,100,1.5,-170,4.19,AT&T Park,9,1
2016-04-24,2016,SD,STL,5,8,135,1.5,-125,8.0,100,-120,-150,-1.5,105,3.4,PETCO Park,13,-3
2016-04-24,2016,NYY,TB,1,8,-120,-1.5,180,7.5,100,-120,110,1.5,-210,4.09,Yankee Stadium,9,-7
2016-04-24,2016,CWS,TEX,4,1,-124,-1.5,170,8.5,-120,100,114,1.5,-200,4.71,Guaranteed Rate Field,5,3
2016-04-24,2016,OAK,TOR,3,6,175,1.5,-125,9.5,-105,-115,-195,-1.5,105,3.45,Rogers Centre,9,-3
2016-04-24,2016,MIN,WSH,5,6,148,1.5,-155,7.0,100,-120,-163,-1.5,135,2.82,Nationals Park,11,-1
2016-04-25,2016,STL,ARI,7,12,109,1.5,-205,7.5,-115,-105,-119,-1.5,175,3.59,Chase Field,19,-5
2016-04-25,2016,BOS,ATL,1,0,-125,-1.5,128,7.5,-101,-119,115,1.5,-148,4.17,Turner Field,1,1
2016-04-25,2016,TB,BAL,2,0,-124,-1.5,175,7.5,105,-125,114,1.5,-205,4.15,Tropicana Field,2,2
2016-04-25,2016,ATL,BOS,0,1,115,1.5,-148,7.5,-101,-119,-125,-1.5,128,3.49,Turner Field,1,-1
2016-04-25,2016,NYM,CIN,5,3,-210,-1.5,110,6.5,-105,-115,180,1.5,-130,4.4,Citi Field,8,2
2016-04-25,2016,MIN,CLE,4,3,135,1.5,-130,7.5,-118,-102,-150,-1.5,110,3.19,Target Field,7,1
2016-04-25,2016,PIT,COL,6,1,119,1.5,-160,11.5,-114,-106,-134,-1.5,140,5.25,Coors Field,7,5
2016-04-25,2016,TOR,CWS,5,7,-185,-1.5,110,8.5,-110,-110,165,1.5,-130,5.52,Rogers Centre,12,-2
2016-04-25,2016,OAK,DET,3,7,115,1.5,-185,8.5,-110,-110,-130,-1.5,165,3.95,Comerica Park,10,-4
2016-04-25,2016,SEA,HOU,3,2,-143,-1.5,155,7.5,-110,-110,128,1.5,-175,4.41,T-Mobile Park,5,1
2016-04-25,2016,LAA,KC,6,1,-116,-1.5,180,7.0,110,-130,106,1.5,-210,3.76,Angel Stadium,7,5
2016-04-25,2016,KC,LAA,1,6,106,1.5,-210,7.0,110,-130,-116,-1.5,180,3.4,Angel Stadium,7,-5
2016-04-25,2016,MIA,LAD,3,2,-102,1.5,-215,7.5,-110,-110,-108,-1.5,185,3.79,Dodger Stadium,5,1
2016-04-25,2016,LAD,MIA,2,3,-108,-1.5,185,7.5,-110,-110,-102,1.5,-215,3.89,Dodger Stadium,5,-1
2016-04-25,2016,CLE,MIN,3,4,-150,-1.5,110,7.5,-118,-102,135,1.5,-130,4.5,Target Field,7,-1
2016-04-25,2016,CIN,NYM,3,5,180,1.5,-130,6.5,-105,-115,-210,-1.5,110,2.32,Citi Field,8,-2
2016-04-25,2016,TEX,NYY,1,3,109,1.5,-155,9.0,-110,-110,-119,-1.5,135,4.31,Rangers Ballpark,4,-2
2016-04-25,2016,DET,OAK,7,3,-130,-1.5,165,8.5,-110,-110,115,1.5,-185,4.8,Comerica Park,10,4
2016-04-25,2016,COL,PIT,1,6,-134,-1.5,140,11.5,-114,-106,119,1.5,-160,6.59,Coors Field,7,-5
2016-04-25,2016,SF,SD,5,4,-180,-1.5,120,6.5,-120,100,160,1.5,-140,4.18,AT&T Park,9,1
2016-04-25,2016,HOU,SEA,2,3,128,1.5,-175,7.5,-110,-110,-143,-1.5,155,3.29,T-Mobile Park,5,-1
2016-04-25,2016,SD,SF,4,5,160,1.5,-140,6.5,-120,100,-180,-1.5,120,2.5,AT&T Park,9,-1
2016-04-25,2016,ARI,STL,12,7,-119,-1.5,175,7.5,-115,-105,109,1.5,-205,4.08,Chase Field,19,5
2016-04-25,2016,BAL,TB,0,2,114,1.5,-205,7.5,105,-125,-124,-1.5,175,3.5,Tropicana Field,2,-2
2016-04-25,2016,NYY,TEX,3,1,-119,-1.5,135,9.0,-110,-110,109,1.5,-155,4.89,Rangers Ballpark,4,2
2016-04-25,2016,CWS,TOR,7,5,165,1.5,-130,8.5,-110,-110,-185,-1.5,110,3.21,Rogers Centre,12,2
2016-04-26,2016,STL,ARI,8,2,-125,-1.5,130,8.5,-115,-105,115,1.5,-150,4.72,Chase Field,10,6
2016-04-26,2016,BOS,ATL,11,4,-230,-1.5,-131,7.0,-120,100,200,1.5,111,4.88,Turner Field,15,7
2016-04-26,2016,TB,BAL,3,1,-119,-1.5,180,7.5,-105,-115,109,1.5,-210,4.08,Tropicana Field,4,2
2016-04-26,2016,ATL,BOS,4,11,200,1.5,111,7.0,-120,100,-230,-1.5,-131,2.33,Turner Field,15,-7
2016-04-26,2016,MIL,CHC,3,4,200,1.5,-105,7.0,-125,105,-230,-1.5,-115,2.33,Wrigley Field,7,-1
2016-04-26,2016,NYM,CIN,4,3,-150,-1.5,145,7.0,-105,-115,135,1.5,-165,4.2,Citi Field,7,1
2016-04-26,2016,MIN,CLE,6,5,110,1.5,-155,8.0,100,-120,-120,-1.5,135,3.81,Target Field,11,1
2016-04-26,2016,PIT,COL,9,4,-153,-1.5,-105,9.5,105,-125,138,1.5,-115,5.75,Coors Field,13,5
2016-04-26,2016,TOR,CWS,1,10,115,1.5,-148,8.0,-115,-105,-125,-1.5,128,3.72,Rogers Centre,11,-9
2016-04-26,2016,OAK,DET,5,1,-134,-1.5,115,9.0,-105,-115,119,1.5,-135,5.15,Comerica Park,6,4
2016-04-26,2016,SEA,HOU,11,1,132,1.5,-130,7.0,-105,-115,-147,-1.5,110,3.02,T-Mobile Park,12,10
2016-04-26,2016,LAA,KC,9,4,117,1.5,-150,7.5,-107,-113,-127,-1.5,130,3.46,Angel Stadium,13,5
2016-04-26,2016,KC,LAA,4,9,-127,-1.5,130,7.5,-107,-113,117,1.5,-150,4.2,Angel Stadium,13,-5
2016-04-26,2016,MIA,LAD,6,3,265,1.5,120,6.5,-135,115,-315,-1.5,-140,1.78,Dodger Stadium,9,3
2016-04-26,2016,LAD,MIA,3,6,-315,-1.5,-140,6.5,-135,115,265,1.5,120,4.93,Dodger Stadium,9,-3
2016-04-26,2016,CHC,MIL,4,3,-230,-1.5,-115,7.0,-125,105,200,1.5,-105,4.88,Wrigley Field,7,1
2016-04-26,2016,CLE,MIN,5,6,-120,-1.5,135,8.0,100,-120,110,1.5,-155,4.36,Target Field,11,-1
2016-04-26,2016,CIN,NYM,3,4,135,1.5,-165,7.0,-105,-115,-150,-1.5,145,2.98,Citi Field,7,-1
2016-04-26,2016,TEX,NYY,10,1,105,1.5,-165,9.0,-110,-110,-115,-1.5,145,4.39,Rangers Ballpark,11,9
2016-04-26,2016,DET,OAK,1,5,119,1.5,-135,9.0,-105,-115,-134,-1.5,115,4.11,Comerica Park,6,-4
2016-04-26,2016,WSH,PHI,3,4,-200,-1.5,105,7.0,-125,105,170,1.5,-125,4.67,Nationals Park,7,-1
2016-04-26,2016,COL,PIT,4,9,138,1.5,-115,9.5,105,-125,-153,-1.5,-105,3.99,Coors Field,13,-5
2016-04-26,2016,SF,SD,1,0,-215,-1.5,100,7.0,-116,-104,185,1.5,-120,4.78,AT&T Park,1,1
2016-04-26,2016,HOU,SEA,1,11,-147,-1.5,110,7.0,-105,-115,132,1.5,-130,4.17,T-Mobile Park,12,-10
2016-04-26,2016,SD,SF,0,1,185,1.5,-120,7.0,-116,-104,-215,-1.5,100,2.46,AT&T Park,1,-1
2016-04-26,2016,ARI,STL,2,8,115,1.5,-150,8.5,-115,-105,-125,-1.5,130,3.95,Chase Field,10,-6
2016-04-26,2016,BAL,TB,1,3,109,1.5,-210,7.5,-105,-115,-119,-1.5,180,3.59,Tropicana Field,4,-2
2016-04-26,2016,NYY,TEX,1,10,-115,-1.5,145,9.0,-110,-110,105,1.5,-165,4.81,Rangers Ballpark,11,-9
2016-04-26,2016,CWS,TOR,10,1,-125,-1.5,128,8.0,-115,-105,115,1.5,-148,4.44,Rogers Centre,11,9
2016-04-26,2016,PHI,WSH,4,3,170,1.5,-125,7.0,-125,105,-200,-1.5,105,2.59,Nationals Park,7,1
2016-04-27,2016,STL,ARI,11,4,109,1.5,-200,9.0,-115,-105,-119,-1.5,170,4.31,Chase Field,15,7
2016-04-27,2016,BOS,ATL,9,4,-210,-1.5,-105,9.0,-124,104,180,1.5,-115,6.1,Fenway Park,13,5
2016-04-27,2016,TB,BAL,1,3,-115,-1.5,180,7.5,-115,-105,105,1.5,-210,4.01,Tropicana Field,4,-2
2016-04-27,2016,ATL,BOS,4,9,180,1.5,-115,9.0,-124,104,-210,-1.5,-105,3.21,Fenway Park,13,-5
2016-04-27,2016,NYM,CIN,5,2,-205,-1.5,105,7.5,-105,-115,175,1.5,-125,5.04,Citi Field,7,3
2016-04-27,2016,MIN,CLE,5,6,-105,1.5,-175,8.0,105,-125,-105,-1.5,155,4.1,Target Field,11,-1
2016-04-27,2016,PIT,COL,9,8,108,1.5,-180,10.5,-119,-101,-118,-1.5,160,5.05,Coors Field,17,1
2016-04-27,2016,TOR,CWS,0,4,-120,-1.5,165,8.5,-115,-105,110,1.5,-185,4.64,Rogers Centre,4,-4
2016-04-27,2016,OAK,DET,4,9,-109,-1.5,150,7.5,-110,-110,-101,1.5,-170,3.91,Comerica Park,13,-5
2016-04-27,2016,SEA,HOU,4,7,-133,-1.5,165,7.0,-122,102,118,1.5,-185,4.0,T-Mobile Park,11,-3
2016-04-27,2016,LAA,KC,4,2,-127,-1.5,175,7.5,105,-125,117,1.5,-205,4.2,Angel Stadium,6,2
2016-04-27,2016,KC,LAA,2,4,117,1.5,-205,7.5,105,-125,-127,-1.5,175,3.46,Angel Stadium,6,-2
2016-04-27,2016,MIA,LAD,2,0,146,1.5,-155,8.0,-115,-105,-161,-1.5,135,3.25,Dodger Stadium,2,2
2016-04-27,2016,LAD,MIA,0,2,-161,-1.5,135,8.0,-115,-105,146,1.5,-155,4.93,Dodger Stadium,2,-2
2016-04-27,2016,CLE,MIN,6,5,-105,-1.5,155,8.0,105,-125,-105,1.5,-175,4.1,Target Field,11,1
2016-04-27,2016,CIN,NYM,2,5,175,1.5,-125,7.5,-105,-115,-205,-1.5,105,2.73,Citi Field,7,-3
2016-04-27,2016,TEX,NYY,3,2,-119,-1.5,170,9.0,-115,-105,109,1.5,-200,4.89,Rangers Ballpark,5,1
2016-04-27,2016,DET,OAK,9,4,-101,1.5,-170,7.5,-110,-110,-109,-1.5,150,3.77,Comerica Park,13,5
2016-04-27,2016,WSH,PHI,0,3,-212,-1.5,105,7.0,-125,105,182,1.5,-125,4.76,Nationals Park,3,-3
2016-04-27,2016,COL,PIT,8,9,-118,-1.5,160,10.5,-119,-101,108,1.5,-180,5.68,Coors Field,17,-1
2016-04-27,2016,SF,SD,13,9,-202,-1.5,110,7.5,-105,-115,172,1.5,-130,5.02,AT&T Park,22,4
2016-04-27,2016,HOU,SEA,7,4,118,1.5,-185,7.0,-122,102,-133,-1.5,165,3.21,T-Mobile Park,11,3
2016-04-27,2016,SD,SF,9,13,172,1.5,-130,7.5,-105,-115,-202,-1.5,110,2.76,AT&T Park,22,-4
2016-04-27,2016,ARI,STL,4,11,-119,-1.5,170,9.0,-115,-105,109,1.5,-200,4.89,Chase Field,15,-7
2016-04-27,2016,BAL,TB,3,1,105,1.5,-210,7.5,-115,-105,-115,-1.5,180,3.66,Tropicana Field,4,2
2016-04-27,2016,NYY,TEX,2,3,109,1.5,-200,9.0,-115,-105,-119,-1.5,170,4.31,Rangers Ballpark,5,-1
2016-04-27,2016,CWS,TOR,4,0,110,1.5,-185,8.5,-115,-105,-120,-1.5,165,4.05,Rogers Centre,4,4
2016-04-27,2016,PHI,WSH,3,0,182,1.5,-125,7.0,-125,105,-212,-1.5,105,2.48,Nationals Park,3,3
2016-04-28,2016,STL,ARI,0,3,-122,-1.5,135,8.5,-115,-105,112,1.5,-155,4.67,Chase Field,3,-3
2016-04-28,2016,BOS,ATL,3,5,-195,-1.5,105,8.5,-115,-105,175,1.5,-125,5.62,Fenway Park,8,-2
2016-04-28,2016,CWS,BAL,2,10,133,1.5,-160,8.5,-120,100,-148,-1.5,140,3.65,Camden Yards,12,-8
2016-04-28,2016,ATL,BOS,5,3,175,1.5,-125,8.5,-115,-105,-195,-1.5,105,3.09,Fenway Park,8,2
2016-04-28,2016,MIL,CHC,2,7,305,1.5,130,6.5,-110,-110,-365,-1.5,-150,1.6,Wrigley Field,9,-5
2016-04-28,2016,BAL,CWS,10,2,-148,-1.5,140,8.5,-120,100,133,1.5,-160,5.07,Camden Yards,12,8
2016-04-28,2016,OAK,DET,3,7,115,1.5,-184,8.5,-105,-115,-125,-1.5,164,3.95,Comerica Park,10,-4
2016-04-28,2016,MIA,LAD,5,3,110,1.5,-215,6.0,-115,-105,-120,-1.5,185,2.86,Dodger Stadium,8,2
2016-04-28,2016,LAD,MIA,3,5,-120,-1.5,185,6.0,-115,-105,110,1.5,-215,3.27,Dodger Stadium,8,-2
2016-04-28,2016,CHC,MIL,7,2,-365,-1.5,-150,6.5,-110,-110,305,1.5,130,5.1,Wrigley Field,9,5
2016-04-28,2016,DET,OAK,7,3,-125,-1.5,164,8.5,-105,-115,115,1.5,-184,4.72,Comerica Park,10,4
2016-04-28,2016,WSH,PHI,0,3,-140,-1.5,165,7.0,-125,105,125,1.5,-185,4.08,Nationals Park,3,-3
2016-04-28,2016,ARI,STL,3,0,112,1.5,-155,8.5,-115,-105,-122,-1.5,135,4.01,Chase Field,3,3
2016-04-28,2016,PHI,WSH,3,0,125,1.5,-185,7.0,-125,105,-140,-1.5,165,3.11,Nationals Park,3,3
2016-04-29,2016,COL,ARI,9,0,127,1.5,-170,9.0,100,-120,-142,-1.5,150,3.96,Chase Field,9,9
2016-04-29,2016,CHC,ATL,6,1,-290,-1.5,-115,6.5,-120,100,250,1.5,-105,4.83,Wrigley Field,7,5
2016-04-29,2016,CWS,BAL,3,6,104,1.5,-210,9.0,100,-120,-114,-1.5,180,4.41,Camden Yards,9,-3
2016-04-29,2016,NYY,BOS,2,4,-121,-1.5,135,8.0,-110,-110,111,1.5,-155,4.38,Fenway Park,6,-2
2016-04-29,2016,ATL,CHC,1,6,250,1.5,-105,6.5,-120,100,-290,-1.5,-115,1.86,Wrigley Field,7,-5
2016-04-29,2016,PIT,CIN,4,1,-151,-1.5,145,7.5,-115,-105,136,1.5,-165,4.51,PNC Park,5,3
2016-04-29,2016,PHI,CLE,4,3,175,1.5,-110,7.0,100,-120,-195,-1.5,-110,2.55,Citizens Bank Park,7,1
2016-04-29,2016,ARI,COL,0,9,-142,-1.5,150,9.0,100,-120,127,1.5,-170,5.28,Chase Field,9,-9
2016-04-29,2016,BAL,CWS,6,3,-114,-1.5,180,9.0,100,-120,104,1.5,-210,4.79,Camden Yards,9,3
2016-04-29,2016,MIN,DET,2,9,-125,-1.5,170,8.0,-120,100,115,1.5,-200,4.44,Target Field,11,-7
2016-04-29,2016,OAK,HOU,7,4,105,1.5,-165,7.5,-110,-110,-115,-1.5,145,3.66,Oakland Coliseum,11,3
2016-04-29,2016,SEA,KC,1,0,-146,-1.5,154,7.0,110,-130,131,1.5,-174,4.15,T-Mobile Park,1,1
2016-04-29,2016,TEX,LAA,4,2,125,1.5,-124,9.0,-110,-110,-140,-1.5,104,4.0,Rangers Ballpark,6,2
2016-04-29,2016,SD,LAD,5,1,155,1.5,-139,7.5,-110,-110,-175,-1.5,119,2.94,Dodger Stadium,6,4
2016-04-29,2016,MIL,MIA,3,6,-116,-1.5,170,8.5,-115,-105,106,1.5,-200,4.56,Miller Park,9,-3
2016-04-29,2016,MIA,MIL,6,3,106,1.5,-200,8.5,-115,-105,-116,-1.5,170,4.13,Miller Park,9,3
2016-04-29,2016,DET,MIN,9,2,115,1.5,-200,8.0,-120,100,-125,-1.5,170,3.72,Target Field,11,7
2016-04-29,2016,SF,NYM,1,13,126,1.5,-175,7.0,-119,-101,-141,-1.5,155,3.1,Citi Field,14,-12
2016-04-29,2016,BOS,NYY,4,2,111,1.5,-155,8.0,-110,-110,-121,-1.5,135,3.79,Fenway Park,6,2
2016-04-29,2016,HOU,OAK,4,7,-115,-1.5,145,7.5,-110,-110,105,1.5,-165,4.01,Oakland Coliseum,11,-3
2016-04-29,2016,CLE,PHI,3,4,-195,-1.5,-110,7.0,100,-120,175,1.5,-110,4.63,Citizens Bank Park,7,-1
2016-04-29,2016,CIN,PIT,1,4,136,1.5,-165,7.5,-115,-105,-151,-1.5,145,3.18,PNC Park,5,-3
2016-04-29,2016,LAD,SD,1,5,-175,-1.5,119,7.5,-110,-110,155,1.5,-139,4.77,Dodger Stadium,6,-4
2016-04-29,2016,KC,SEA,0,1,131,1.5,-174,7.0,110,-130,-146,-1.5,154,3.03,T-Mobile Park,1,-1
2016-04-29,2016,NYM,SF,13,1,-141,-1.5,155,7.0,-119,-101,126,1.5,-175,4.1,Citi Field,14,12
2016-04-29,2016,WSH,STL,5,4,-145,-1.5,115,7.0,-110,-110,130,1.5,-135,4.14,Busch Stadium,9,1
2016-04-29,2016,TOR,TB,6,1,114,1.5,-205,7.0,-125,105,-124,-1.5,175,3.27,Tropicana Field,7,5
2016-04-29,2016,LAA,TEX,2,4,-140,-1.5,104,9.0,-110,-110,125,1.5,-124,5.25,Rangers Ballpark,6,-2
2016-04-29,2016,TB,TOR,1,6,-124,-1.5,175,7.0,-125,105,114,1.5,-205,3.88,Tropicana Field,7,-5
2016-04-29,2016,STL,WSH,4,5,130,1.5,-135,7.0,-110,-110,-145,-1.5,115,3.04,Busch Stadium,9,-1
2016-04-30,2016,COL,ARI,5,2,180,1.5,-123,8.5,-115,-105,-210,-1.5,104,3.04,Chase Field,7,3
2016-04-30,2016,CWS,BAL,8,7,151,1.5,-140,7.5,-101,-119,-171,-1.5,120,2.99,Camden Yards,15,1
2016-04-30,2016,NYY,BOS,0,8,109,1.5,-200,8.0,105,-125,-119,-1.5,170,3.83,Fenway Park,8,-8
2016-04-30,2016,PIT,CIN,5,1,-205,-1.5,-101,7.5,110,-130,175,1.5,-119,5.04,PNC Park,6,4
2016-04-30,2016,PHI,CLE,4,3,109,1.5,-160,7.5,-115,-105,-119,-1.5,140,3.59,Citizens Bank Park,7,1
2016-04-30,2016,ARI,COL,2,5,-210,-1.5,104,8.5,-115,-105,180,1.5,-123,5.76,Chase Field,7,-3
2016-04-30,2016,BAL,CWS,7,8,-171,-1.5,120,7.5,-101,-119,151,1.5,-140,4.73,Camden Yards,15,-1
2016-04-30,2016,MIN,DET,1,4,106,1.5,-160,8.0,-120,100,-116,-1.5,140,3.88,Target Field,5,-3
2016-04-30,2016,OAK,HOU,2,0,-110,-1.5,180,9.0,100,-120,100,1.5,-210,4.71,Oakland Coliseum,2,2
2016-04-30,2016,SEA,KC,6,0,101,1.5,-170,7.0,100,-120,-111,-1.5,150,3.48,T-Mobile Park,6,6
2016-04-30,2016,TEX,LAA,7,2,-103,-1.5,180,9.0,-110,-110,-107,1.5,-210,4.57,Rangers Ballpark,9,5
2016-04-30,2016,SD,LAD,5,2,175,1.5,-125,7.5,-110,-110,-195,-1.5,105,2.73,Dodger Stadium,7,3
2016-04-30,2016,MIL,MIA,5,7,111,1.5,-155,9.0,-113,-107,-121,-1.5,135,4.27,Miller Park,12,-2
2016-04-30,2016,MIA,MIL,7,5,-121,-1.5,135,9.0,-113,-107,111,1.5,-155,4.93,Miller Park,12,2
2016-04-30,2016,DET,MIN,4,1,-116,-1.5,140,8.0,-120,100,106,1.5,-160,4.3,Target Field,5,3
2016-04-30,2016,SF,NYM,5,6,151,1.5,-148,7.0,-125,105,-171,-1.5,128,2.79,Citi Field,11,-1
2016-04-30,2016,BOS,NYY,8,0,-119,-1.5,170,8.0,105,-125,109,1.5,-200,4.35,Fenway Park,8,8
2016-04-30,2016,HOU,OAK,0,2,100,1.5,-210,9.0,100,-120,-110,-1.5,180,4.5,Oakland Coliseum,2,-2
2016-04-30,2016,CLE,PHI,3,4,-119,-1.5,140,7.5,-115,-105,109,1.5,-160,4.08,Citizens Bank Park,7,-1
2016-04-30,2016,CIN,PIT,1,5,175,1.5,-119,7.5,110,-130,-205,-1.5,-101,2.73,PNC Park,6,-4
2016-04-30,2016,LAD,SD,2,5,-195,-1.5,105,7.5,-110,-110,175,1.5,-125,4.96,Dodger Stadium,7,-3
2016-04-30,2016,KC,SEA,0,6,-111,-1.5,150,7.0,100,-120,101,1.5,-170,3.68,T-Mobile Park,6,-6
2016-04-30,2016,NYM,SF,6,5,-171,-1.5,128,7.0,-125,105,151,1.5,-148,4.42,Citi Field,11,1
2016-04-30,2016,WSH,STL,6,1,131,1.5,-180,7.5,105,-125,-146,-1.5,160,3.25,Busch Stadium,7,5
2016-04-30,2016,TOR,TB,3,4,114,1.5,-200,7.5,-105,-115,-124,-1.5,170,3.5,Tropicana Field,7,-1
2016-04-30,2016,LAA,TEX,2,7,-107,1.5,-210,9.0,-110,-110,-103,-1.5,180,4.65,Rangers Ballpark,9,-5
2016-04-30,2016,TB,TOR,4,3,-124,-1.5,170,7.5,-105,-115,114,1.5,-200,4.15,Tropicana Field,7,1
2016-04-30,2016,STL,WSH,1,6,-146,-1.5,160,7.5,105,-125,131,1.5,-180,4.45,Busch Stadium,7,-5
2016-05-01,2016,COL,ARI,6,3,-105,1.5,-215,9.0,100,-120,-105,-1.5,185,4.61,Chase Field,9,3
2016-05-01,2016,CHC,ATL,3,4,-205,-1.5,-102,7.0,-105,-115,175,1.5,-118,4.7,Wrigley Field,7,-1
2016-05-01,2016,CWS,BAL,7,1,-110,-1.5,150,7.5,100,-120,100,1.5,-170,3.93,Camden Yards,8,6
2016-05-01,2016,NYY,BOS,7,8,152,1.5,-140,7.0,-114,-106,-167,-1.5,120,2.78,Fenway Park,15,-1
2016-05-01,2016,ATL,CHC,4,3,175,1.5,-118,7.0,-105,-115,-205,-1.5,-102,2.55,Wrigley Field,7,1
2016-05-01,2016,PIT,CIN,5,6,-150,-1.5,140,8.5,-105,-115,135,1.5,-160,5.1,PNC Park,11,-1
2016-05-01,2016,PHI,CLE,2,1,115,1.5,-160,7.0,115,-135,-125,-1.5,140,3.26,Citizens Bank Park,3,1
2016-05-01,2016,ARI,COL,3,6,-105,-1.5,185,9.0,100,-120,-105,1.5,-215,4.61,Chase Field,9,-3
2016-05-01,2016,BAL,CWS,1,7,100,1.5,-170,7.5,100,-120,-110,-1.5,150,3.75,Camden Yards,8,-6
2016-05-01,2016,MIN,DET,5,6,-141,-1.5,150,8.5,-120,100,126,1.5,-170,4.97,Target Field,11,-1
2016-05-01,2016,OAK,HOU,1,2,-152,-1.5,140,8.5,-118,-102,137,1.5,-160,5.13,Oakland Coliseum,3,-1
2016-05-01,2016,SEA,KC,1,4,-117,-1.5,175,7.5,110,-130,107,1.5,-205,4.04,T-Mobile Park,5,-3
2016-05-01,2016,TEX,LAA,6,9,-115,-1.5,180,8.5,-110,-110,105,1.5,-210,4.55,Rangers Ballpark,15,-3
2016-05-01,2016,SD,LAD,0,1,250,1.5,-106,6.5,-103,-117,-290,-1.5,-113,1.86,Dodger Stadium,1,-1
2016-05-01,2016,MIL,MIA,14,5,100,1.5,-160,9.0,-120,100,-110,-1.5,140,4.5,Miller Park,19,9
2016-05-01,2016,MIA,MIL,5,14,-110,-1.5,140,9.0,-120,100,100,1.5,-160,4.71,Miller Park,19,-9
2016-05-01,2016,DET,MIN,6,5,126,1.5,-170,8.5,-120,100,-141,-1.5,150,3.76,Target Field,11,1
2016-05-01,2016,SF,NYM,6,1,114,1.5,-215,6.0,-105,-115,-124,-1.5,185,2.8,Citi Field,7,5
2016-05-01,2016,BOS,NYY,8,7,-167,-1.5,120,7.0,-114,-106,152,1.5,-140,4.38,Fenway Park,15,1
2016-05-01,2016,HOU,OAK,2,1,137,1.5,-160,8.5,-118,-102,-152,-1.5,140,3.59,Oakland Coliseum,3,1
2016-05-01,2016,CLE,PHI,1,2,-125,-1.5,140,7.0,115,-135,115,1.5,-160,3.89,Citizens Bank Park,3,-1
2016-05-01,2016,CIN,PIT,6,5,135,1.5,-160,8.5,-105,-115,-150,-1.5,140,3.62,PNC Park,11,1
2016-05-01,2016,LAD,SD,1,0,-290,-1.5,-113,6.5,-103,-117,250,1.5,-106,4.83,Dodger Stadium,1,1
2016-05-01,2016,KC,SEA,4,1,107,1.5,-205,7.5,110,-130,-117,-1.5,175,3.62,T-Mobile Park,5,3
2016-05-01,2016,NYM,SF,1,6,-124,-1.5,185,6.0,-105,-115,114,1.5,-215,3.32,Citi Field,7,-5
2016-05-01,2016,WSH,STL,6,1,-116,-1.5,150,7.0,-110,-110,106,1.5,-170,3.76,Busch Stadium,7,5
2016-05-01,2016,TOR,TB,5,1,-119,-1.5,140,7.5,100,-120,109,1.5,-160,4.08,Tropicana Field,6,4
2016-05-01,2016,LAA,TEX,9,6,105,1.5,-210,8.5,-110,-110,-115,-1.5,180,4.15,Rangers Ballpark,15,3
2016-05-01,2016,TB,TOR,1,5,109,1.5,-160,7.5,100,-120,-119,-1.5,140,3.59,Tropicana Field,6,-4
2016-05-01,2016,STL,WSH,1,6,106,1.5,-170,7.0,-110,-110,-116,-1.5,150,3.4,Busch Stadium,7,-5
2016-05-02,2016,NYM,ATL,4,1,-200,-1.5,105,7.5,-110,-110,170,1.5,-125,5.0,Citi Field,5,3
2016-05-02,2016,PIT,CHC,2,7,-144,-1.5,155,7.0,-120,100,129,1.5,-175,4.13,PNC Park,9,-5
2016-05-02,2016,SF,CIN,9,6,-170,-1.5,-110,8.0,-110,-110,150,1.5,-110,5.04,Great American Ballpark,15,3
2016-05-02,2016,SD,COL,2,1,108,1.5,-170,7.0,-104,-116,-118,-1.5,150,3.37,PETCO Park,3,1
2016-05-02,2016,MIN,HOU,6,2,156,1.5,-140,8.0,105,-125,-176,-1.5,120,3.13,Minute Maid Park,8,4
2016-05-02,2016,WSH,KC,2,0,112,1.5,-205,7.0,-132,112,-122,-1.5,175,3.3,Kauffman Stadium,2,2
2016-05-02,2016,MIL,LAA,8,5,-106,-1.5,170,9.0,-120,100,-104,1.5,-200,4.63,Miller Park,13,3
2016-05-02,2016,LAA,MIL,5,8,-104,1.5,-200,9.0,-120,100,-106,-1.5,170,4.59,Miller Park,13,-3
2016-05-02,2016,HOU,MIN,2,6,-176,-1.5,120,8.0,105,-125,156,1.5,-140,5.1,Minute Maid Park,8,-4
2016-05-02,2016,ATL,NYM,1,4,170,1.5,-125,7.5,-110,-110,-200,-1.5,105,2.78,Citi Field,5,-3
2016-05-02,2016,SEA,OAK,4,3,-102,1.5,-215,8.0,-105,-115,-108,-1.5,185,4.04,Oakland Coliseum,7,1
2016-05-02,2016,STL,PHI,10,3,-170,-1.5,130,7.5,105,-125,150,1.5,-150,4.72,Busch Stadium,13,7
2016-05-02,2016,CHC,PIT,7,2,129,1.5,-175,7.0,-120,100,-144,-1.5,155,3.06,PNC Park,9,5
2016-05-02,2016,COL,SD,1,2,-118,-1.5,150,7.0,-104,-116,108,1.5,-170,3.79,PETCO Park,3,-1
2016-05-02,2016,OAK,SEA,3,4,-108,-1.5,185,8.0,-105,-115,-102,1.5,-215,4.15,Oakland Coliseum,7,-1
2016-05-02,2016,CIN,SF,6,9,150,1.5,-110,8.0,-110,-110,-170,-1.5,-110,3.2,Great American Ballpark,15,-3
2016-05-02,2016,PHI,STL,3,10,150,1.5,-150,7.5,105,-125,-170,-1.5,130,3.0,Busch Stadium,13,-7
2016-05-02,2016,TOR,TEX,1,2,-160,-1.5,120,9.0,-115,-105,145,1.5,-140,5.54,Rogers Centre,3,-1
2016-05-02,2016,TEX,TOR,2,1,145,1.5,-140,9.0,-115,-105,-160,-1.5,120,3.67,Rogers Centre,3,1
2016-05-02,2016,KC,WSH,0,2,-122,-1.5,175,7.0,-132,112,112,1.5,-205,3.85,Kauffman Stadium,2,-2
2016-05-03,2016,MIA,ARI,7,4,111,1.5,-160,8.5,-115,-105,-121,-1.5,140,4.03,Marlins Park,11,3
2016-05-03,2016,NYM,ATL,0,3,-230,-1.5,100,7.0,-125,105,200,1.5,-120,4.88,Citi Field,3,-3
2016-05-03,2016,NYY,BAL,1,4,103,1.5,-210,8.0,-115,-105,-113,-1.5,180,3.94,Camden Yards,5,-3
2016-05-03,2016,CWS,BOS,4,1,-143,-1.5,150,8.0,-115,-105,128,1.5,-170,4.71,Guaranteed Rate Field,5,3
2016-05-03,2016,PIT,CHC,1,7,153,1.5,-110,7.0,-125,105,-173,-1.5,-110,2.77,PNC Park,8,-6
2016-05-03,2016,SF,CIN,3,1,-129,-1.5,125,8.5,-105,-115,119,1.5,-145,4.79,Great American Ballpark,4,2
2016-05-03,2016,DET,CLE,3,7,119,1.5,-180,8.0,-110,-110,-129,-1.5,160,3.65,Progressive Field,10,-4
2016-05-03,2016,SD,COL,6,3,-110,-1.5,185,7.5,-110,-110,100,1.5,-215,3.93,PETCO Park,9,3
2016-05-03,2016,BOS,CWS,1,4,128,1.5,-170,8.0,-115,-105,-143,-1.5,150,3.51,Guaranteed Rate Field,5,-3
2016-05-03,2016,CLE,DET,7,3,-129,-1.5,160,8.0,-110,-110,119,1.5,-180,4.51,Progressive Field,10,4
2016-05-03,2016,MIN,HOU,4,6,141,1.5,-145,8.5,100,-120,-156,-1.5,125,3.53,Minute Maid Park,10,-2
2016-05-03,2016,WSH,KC,6,7,109,1.5,-200,7.5,-120,100,-119,-1.5,170,3.59,Kauffman Stadium,13,-1
2016-05-03,2016,MIL,LAA,5,4,117,1.5,-145,8.5,-105,-115,-132,-1.5,125,3.92,Miller Park,9,1
2016-05-03,2016,TB,LAD,5,10,-147,-1.5,140,7.5,-120,100,132,1.5,-160,4.46,Tropicana Field,15,-5
2016-05-03,2016,ARI,MIA,4,7,-121,-1.5,140,8.5,-115,-105,111,1.5,-160,4.65,Marlins Park,11,-3
2016-05-03,2016,LAA,MIL,4,5,-132,-1.5,125,8.5,-105,-115,117,1.5,-145,4.84,Miller Park,9,-1
2016-05-03,2016,HOU,MIN,6,4,-156,-1.5,125,8.5,100,-120,141,1.5,-145,5.18,Minute Maid Park,10,2
2016-05-03,2016,ATL,NYM,3,0,200,1.5,-120,7.0,-125,105,-230,-1.5,100,2.33,Citi Field,3,3
2016-05-03,2016,BAL,NYY,4,1,-113,-1.5,180,8.0,-115,-105,103,1.5,-210,4.24,Camden Yards,5,3
2016-05-03,2016,SEA,OAK,8,2,107,1.5,-200,7.5,-110,-110,-117,-1.5,170,3.62,Oakland Coliseum,10,6
2016-05-03,2016,STL,PHI,0,1,-174,-1.5,130,7.0,-105,-115,154,1.5,-150,4.45,Busch Stadium,1,-1
2016-05-03,2016,CHC,PIT,7,1,-173,-1.5,-110,7.0,-125,105,153,1.5,-110,4.44,PNC Park,8,6
2016-05-03,2016,COL,SD,3,6,100,1.5,-215,7.5,-110,-110,-110,-1.5,185,3.75,PETCO Park,9,-3
2016-05-03,2016,OAK,SEA,2,8,-117,-1.5,170,7.5,-110,-110,107,1.5,-200,4.04,Oakland Coliseum,10,-6
2016-05-03,2016,CIN,SF,1,3,119,1.5,-145,8.5,-105,-115,-129,-1.5,125,3.88,Great American Ballpark,4,-2
2016-05-03,2016,PHI,STL,1,0,154,1.5,-150,7.0,-105,-115,-174,-1.5,130,2.76,Busch Stadium,1,1
2016-05-03,2016,LAD,TB,10,5,132,1.5,-160,7.5,-120,100,-147,-1.5,140,3.23,Tropicana Field,15,5
2016-05-03,2016,TOR,TEX,3,1,-183,-1.5,100,9.0,-115,-105,163,1.5,-120,5.82,Rogers Centre,4,2
2016-05-03,2016,TEX,TOR,1,3,163,1.5,-120,9.0,-115,-105,-183,-1.5,100,3.42,Rogers Centre,4,-2
2016-05-03,2016,KC,WSH,7,6,-119,-1.5,170,7.5,-120,100,109,1.5,-200,4.08,Kauffman Stadium,13,1
2016-05-04,2016,MIA,ARI,4,3,-176,-1.5,125,7.0,-125,105,156,1.5,-145,4.46,Marlins Park,7,1
2016-05-04,2016,NYM,ATL,8,0,-195,-1.5,120,7.0,105,-125,175,1.5,-140,4.63,Citi Field,8,8
2016-05-04,2016,NYY,BAL,7,0,119,1.5,-175,8.5,-120,100,-129,-1.5,155,3.88,Camden Yards,7,7
2016-05-04,2016,CWS,BOS,2,5,-119,-1.5,170,8.0,100,-120,109,1.5,-200,4.35,Guaranteed Rate Field,7,-3
2016-05-04,2016,PIT,CHC,2,6,117,1.5,-160,7.5,105,-125,-127,-1.5,140,3.46,PNC Park,8,-4
2016-05-04,2016,SF,CIN,4,7,101,1.5,-215,8.5,-120,100,-111,-1.5,185,4.23,Great American Ballpark,11,-3
2016-05-04,2016,DET,CLE,0,4,165,1.5,-130,7.5,-119,-101,-185,-1.5,110,2.83,Progressive Field,4,-4
2016-05-04,2016,SD,COL,0,2,110,1.5,-155,7.5,-103,-117,-120,-1.5,135,3.57,PETCO Park,2,-2
2016-05-04,2016,BOS,CWS,5,2,109,1.5,-200,8.0,100,-120,-119,-1.5,170,3.83,Guaranteed Rate Field,7,3
2016-05-04,2016,CLE,DET,4,0,-185,-1.5,110,7.5,-119,-101,165,1.5,-130,4.87,Progressive Field,4,4
2016-05-04,2016,MIN,HOU,4,16,147,1.5,-155,9.0,-105,-115,-162,-1.5,135,3.64,Minute Maid Park,20,-12
2016-05-04,2016,WSH,KC,13,2,-150,-1.5,110,7.0,-125,105,135,1.5,-130,4.2,Kauffman Stadium,15,11
2016-05-04,2016,MIL,LAA,3,7,130,1.5,-130,9.0,-110,-110,-145,-1.5,110,3.91,Miller Park,10,-4
2016-05-04,2016,TB,LAD,8,5,-160,-1.5,140,7.0,-115,-105,145,1.5,-160,4.31,Tropicana Field,13,3
2016-05-04,2016,ARI,MIA,3,4,156,1.5,-145,7.0,-125,105,-176,-1.5,125,2.73,Marlins Park,7,-1
2016-05-04,2016,LAA,MIL,7,3,-145,-1.5,110,9.0,-110,-110,130,1.5,-130,5.33,Miller Park,10,4
2016-05-04,2016,HOU,MIN,16,4,-162,-1.5,135,9.0,-105,-115,147,1.5,-155,5.56,Minute Maid Park,20,12
2016-05-04,2016,ATL,NYM,0,8,175,1.5,-140,7.0,105,-125,-195,-1.5,120,2.55,Citi Field,8,-8
2016-05-04,2016,BAL,NYY,0,7,-129,-1.5,155,8.5,-120,100,119,1.5,-175,4.79,Camden Yards,7,-7
2016-05-04,2016,SEA,OAK,9,8,-111,-1.5,150,7.5,100,-120,101,1.5,-170,3.95,Oakland Coliseum,17,1
2016-05-04,2016,STL,PHI,5,4,-160,-1.5,145,7.5,-110,-110,145,1.5,-165,4.62,Busch Stadium,9,1
2016-05-04,2016,CHC,PIT,6,2,-127,-1.5,140,7.5,105,-125,117,1.5,-160,4.2,PNC Park,8,4
2016-05-04,2016,COL,SD,2,0,-120,-1.5,135,7.5,-103,-117,110,1.5,-155,4.09,PETCO Park,2,2
2016-05-04,2016,OAK,SEA,8,9,101,1.5,-170,7.5,100,-120,-111,-1.5,150,3.73,Oakland Coliseum,17,-1
2016-05-04,2016,CIN,SF,7,4,-111,-1.5,185,8.5,-120,100,101,1.5,-215,4.47,Great American Ballpark,11,3
2016-05-04,2016,PHI,STL,4,5,145,1.5,-165,7.5,-110,-110,-160,-1.5,145,3.06,Busch Stadium,9,-1
2016-05-04,2016,LAD,TB,5,8,145,1.5,-160,7.0,-115,-105,-160,-1.5,140,2.86,Tropicana Field,13,-3
2016-05-04,2016,TOR,TEX,4,3,-200,-1.5,-101,9.0,-120,100,170,1.5,-119,6.0,Rogers Centre,7,1
2016-05-04,2016,TEX,TOR,3,4,170,1.5,-119,9.0,-120,100,-200,-1.5,-101,3.33,Rogers Centre,7,-1
2016-05-04,2016,KC,WSH,2,13,135,1.5,-130,7.0,-125,105,-150,-1.5,110,2.98,Kauffman Stadium,15,-11
2016-05-05,2016,MIA,ARI,4,0,-132,-1.5,170,8.5,-105,-115,117,1.5,-200,4.84,Marlins Park,4,4
2016-05-05,2016,NYY,BAL,0,1,-103,1.5,-215,7.0,-130,110,-107,-1.5,185,3.55,Camden Yards,1,-1
2016-05-05,2016,CWS,BOS,3,7,-105,-1.5,180,8.5,-110,-110,-105,1.5,-210,4.35,Guaranteed Rate Field,10,-4
2016-05-05,2016,WSH,CHC,2,5,127,1.5,-185,7.5,105,-125,-142,-1.5,165,3.3,Wrigley Field,7,-3
2016-05-05,2016,MIL,CIN,5,9,100,1.5,-215,9.0,100,-120,-110,-1.5,185,4.5,Great American Ballpark,14,-4
2016-05-05,2016,DET,CLE,4,9,117,1.5,-180,8.5,-120,100,-127,-1.5,160,3.92,Progressive Field,13,-5
2016-05-05,2016,SF,COL,7,17,-128,-1.5,170,7.5,-115,-105,118,1.5,-200,4.21,AT&T Park,24,-10
2016-05-05,2016,BOS,CWS,7,3,-105,1.5,-210,8.5,-110,-110,-105,-1.5,180,4.35,Guaranteed Rate Field,10,4
2016-05-05,2016,CLE,DET,9,4,-127,-1.5,160,8.5,-120,100,117,1.5,-180,4.76,Progressive Field,13,5
2016-05-05,2016,SEA,HOU,6,3,118,1.5,-175,9.0,-120,100,-133,-1.5,155,4.13,Minute Maid Park,9,3
2016-05-05,2016,ARI,MIA,0,4,117,1.5,-200,8.5,-105,-115,-132,-1.5,170,3.92,Marlins Park,4,-4
2016-05-05,2016,CIN,MIL,9,5,-110,-1.5,185,9.0,100,-120,100,1.5,-215,4.71,Great American Ballpark,14,4
2016-05-05,2016,SD,NYM,5,3,170,1.5,110,7.0,-120,100,-200,-1.5,-130,2.59,PETCO Park,8,2
2016-05-05,2016,BAL,NYY,1,0,-107,-1.5,185,7.0,-130,110,-103,1.5,-215,3.62,Camden Yards,1,1
2016-05-05,2016,STL,PHI,4,0,-185,-1.5,110,6.5,-115,-105,165,1.5,-130,4.22,Busch Stadium,4,4
2016-05-05,2016,NYM,SD,3,5,-200,-1.5,-130,7.0,-120,100,170,1.5,110,4.67,PETCO Park,8,-2
2016-05-05,2016,HOU,SEA,3,6,-133,-1.5,155,9.0,-120,100,118,1.5,-175,5.14,Minute Maid Park,9,-3
2016-05-05,2016,COL,SF,17,7,118,1.5,-200,7.5,-115,-105,-128,-1.5,170,3.44,AT&T Park,24,10
2016-05-05,2016,PHI,STL,0,4,165,1.5,-130,6.5,-115,-105,-185,-1.5,110,2.45,Busch Stadium,4,-4
2016-05-05,2016,TOR,TEX,12,2,-200,-1.5,105,8.5,-120,100,170,1.5,-125,5.67,Rogers Centre,14,10
2016-05-05,2016,TEX,TOR,2,12,170,1.5,-125,8.5,-120,100,-200,-1.5,105,3.15,Rogers Centre,14,-10
2016-05-05,2016,CHC,WSH,5,2,-142,-1.5,165,7.5,105,-125,127,1.5,-185,4.4,Wrigley Field,7,3
2016-05-06,2016,ATL,ARI,2,7,149,1.5,-110,7.0,-125,105,-164,-1.5,-110,2.81,Turner Field,9,-5
2016-05-06,2016,ARI,ATL,7,2,-164,-1.5,-110,7.0,-125,105,149,1.5,-110,4.35,Turner Field,9,5
2016-05-06,2016,NYY,BOS,3,2,-106,1.5,-170,7.0,-120,100,-104,-1.5,150,3.6,Yankee Stadium,5,1
2016-05-06,2016,WSH,CHC,6,8,-107,-1.5,150,8.5,-110,-110,-103,1.5,-170,4.39,Wrigley Field,14,-2
2016-05-06,2016,MIL,CIN,1,5,119,1.5,-180,8.5,-120,100,-129,-1.5,160,3.88,Great American Ballpark,6,-4
2016-05-06,2016,KC,CLE,1,7,123,1.5,-175,7.0,-120,100,-138,-1.5,155,3.14,Progressive Field,8,-6
2016-05-06,2016,SF,COL,6,4,-205,-1.5,110,7.0,-117,-103,175,1.5,-130,4.7,AT&T Park,10,2
2016-05-06,2016,MIN,CWS,4,10,116,1.5,-180,9.0,-115,-105,-131,-1.5,160,4.17,Guaranteed Rate Field,14,-6
2016-05-06,2016,TEX,DET,5,1,103,1.5,-210,8.0,-110,-110,-113,-1.5,180,3.94,Comerica Park,6,4
2016-05-06,2016,SEA,HOU,3,6,-112,-1.5,140,9.0,-110,-110,102,1.5,-160,4.75,Minute Maid Park,9,-3
2016-05-06,2016,CLE,KC,7,1,-138,-1.5,155,7.0,-120,100,123,1.5,-175,4.06,Progressive Field,8,6
2016-05-06,2016,TB,LAA,5,2,-134,-1.5,125,7.5,-105,-115,119,1.5,-145,4.29,Angel Stadium,7,3
2016-05-06,2016,TOR,LAD,5,2,-129,-1.5,165,8.0,-115,-105,119,1.5,-185,4.51,Rogers Centre,7,3
2016-05-06,2016,PHI,MIA,4,6,125,1.5,-180,7.0,-110,-110,-140,-1.5,160,3.11,Marlins Park,10,-2
2016-05-06,2016,CIN,MIL,5,1,-129,-1.5,160,8.5,-120,100,119,1.5,-180,4.79,Great American Ballpark,6,4
2016-05-06,2016,CWS,MIN,10,4,-131,-1.5,160,9.0,-115,-105,116,1.5,-180,5.1,Guaranteed Rate Field,14,6
2016-05-06,2016,SD,NYM,2,0,145,1.5,-130,6.5,-110,-110,-160,-1.5,110,2.65,PETCO Park,2,2
2016-05-06,2016,BOS,NYY,2,3,-104,-1.5,150,7.0,-120,100,-106,1.5,-170,3.57,Yankee Stadium,5,-1
2016-05-06,2016,MIA,PHI,6,4,-140,-1.5,160,7.0,-110,-110,125,1.5,-180,4.08,Marlins Park,10,2
2016-05-06,2016,STL,PIT,2,4,-127,-1.5,170,7.5,-105,-115,117,1.5,-200,4.2,Busch Stadium,6,-2
2016-05-06,2016,NYM,SD,0,2,-160,-1.5,110,6.5,-110,-110,145,1.5,-130,4.0,PETCO Park,2,-2
2016-05-06,2016,HOU,SEA,6,3,102,1.5,-160,9.0,-110,-110,-112,-1.5,140,4.46,Minute Maid Park,9,3
2016-05-06,2016,COL,SF,4,6,175,1.5,-130,7.0,-117,-103,-205,-1.5,110,2.55,AT&T Park,10,-2
2016-05-06,2016,PIT,STL,4,2,117,1.5,-200,7.5,-105,-115,-127,-1.5,170,3.46,Busch Stadium,6,2
2016-05-06,2016,LAA,TB,2,5,119,1.5,-145,7.5,-105,-115,-134,-1.5,125,3.42,Angel Stadium,7,-3
2016-05-06,2016,DET,TEX,1,5,-113,-1.5,180,8.0,-110,-110,103,1.5,-210,4.24,Comerica Park,6,-4
2016-05-06,2016,LAD,TOR,2,5,119,1.5,-185,8.0,-115,-105,-129,-1.5,165,3.65,Rogers Centre,7,-3
2016-05-06,2016,CHC,WSH,8,6,-103,1.5,-170,8.5,-110,-110,-107,-1.5,150,4.31,Wrigley Field,14,2
2016-05-07,2016,ATL,ARI,2,4,-121,-1.5,175,7.5,-120,100,111,1.5,-205,4.11,Turner Field,6,-2
2016-05-07,2016,ARI,ATL,4,2,111,1.5,-205,7.5,-120,100,-121,-1.5,175,3.55,Turner Field,6,2
2016-05-07,2016,OAK,BAL,8,4,-125,-1.5,130,8.0,-120,100,115,1.5,-150,4.44,Camden Yards,12,4
2016-05-07,2016,OAK,BAL,2,5,110,1.5,-205,8.5,100,-120,-120,-1.5,175,4.05,Camden Yards,7,-3
2016-05-07,2016,NYY,BOS,8,2,140,1.5,-131,7.5,-105,-115,-155,-1.5,111,3.13,Yankee Stadium,10,6
2016-05-07,2016,WSH,CHC,5,8,130,1.5,-170,7.5,105,-125,-145,-1.5,150,3.26,Wrigley Field,13,-3
2016-05-07,2016,MIL,CIN,13,7,102,1.5,-210,9.0,100,-120,-112,-1.5,180,4.46,Great American Ballpark,20,6
2016-05-07,2016,KC,CLE,7,0,-109,-1.5,150,8.5,100,-120,-101,1.5,-170,4.43,Progressive Field,7,7
2016-05-07,2016,SF,COL,2,1,-185,-1.5,115,7.0,-110,-110,165,1.5,-135,4.54,AT&T Park,3,1
2016-05-07,2016,MIN,CWS,2,7,180,1.5,-120,7.0,100,-120,-210,-1.5,100,2.5,Guaranteed Rate Field,9,-5
2016-05-07,2016,TEX,DET,10,5,-106,-1.5,145,10.0,-110,-110,-104,1.5,-165,5.15,Comerica Park,15,5
2016-05-07,2016,SEA,HOU,3,2,149,1.5,-145,8.5,104,-124,-164,-1.5,125,3.41,Minute Maid Park,5,1
2016-05-07,2016,CLE,KC,0,7,-101,1.5,-170,8.5,100,-120,-109,-1.5,150,4.27,Progressive Field,7,-7
2016-05-07,2016,TB,LAA,4,2,-125,-1.5,130,8.0,-110,-110,115,1.5,-150,4.44,Angel Stadium,6,2
2016-05-07,2016,TOR,LAD,2,6,135,1.5,-126,8.0,-115,-105,-150,-1.5,106,3.4,Rogers Centre,8,-4
2016-05-07,2016,PHI,MIA,4,3,118,1.5,-185,8.5,-104,-116,-133,-1.5,165,3.9,Marlins Park,7,1
2016-05-07,2016,CIN,MIL,7,13,-112,-1.5,180,9.0,100,-120,102,1.5,-210,4.75,Great American Ballpark,20,-6
2016-05-07,2016,CWS,MIN,7,2,-210,-1.5,100,7.0,100,-120,180,1.5,-120,4.74,Guaranteed Rate Field,9,5
2016-05-07,2016,SD,NYM,3,6,118,1.5,-145,7.5,105,-125,-133,-1.5,125,3.44,PETCO Park,9,-3
2016-05-07,2016,BOS,NYY,2,8,-155,-1.5,111,7.5,-105,-115,140,1.5,-131,4.56,Yankee Stadium,10,-6
2016-05-07,2016,BAL,OAK,4,8,115,1.5,-150,8.0,-120,100,-125,-1.5,130,3.72,Camden Yards,12,-4
2016-05-07,2016,BAL,OAK,5,2,-120,-1.5,175,8.5,100,-120,110,1.5,-205,4.64,Camden Yards,7,3
2016-05-07,2016,MIA,PHI,3,4,-133,-1.5,165,8.5,-104,-116,118,1.5,-185,4.85,Marlins Park,7,-1
2016-05-07,2016,STL,PIT,6,4,-140,-1.5,155,9.0,100,-120,125,1.5,-175,5.25,Busch Stadium,10,2
2016-05-07,2016,NYM,SD,6,3,-133,-1.5,125,7.5,105,-125,118,1.5,-145,4.28,PETCO Park,9,3
2016-05-07,2016,HOU,SEA,2,3,-164,-1.5,125,8.5,104,-124,149,1.5,-145,5.28,Minute Maid Park,5,-1
2016-05-07,2016,COL,SF,1,2,165,1.5,-135,7.0,-110,-110,-185,-1.5,115,2.64,AT&T Park,3,-1
2016-05-07,2016,PIT,STL,4,6,125,1.5,-175,9.0,100,-120,-140,-1.5,155,4.0,Busch Stadium,10,-2
2016-05-07,2016,LAA,TB,2,4,115,1.5,-150,8.0,-110,-110,-125,-1.5,130,3.72,Angel Stadium,6,-2
2016-05-07,2016,DET,TEX,5,10,-104,1.5,-165,10.0,-110,-110,-106,-1.5,145,5.1,Comerica Park,15,-5
2016-05-07,2016,LAD,TOR,6,2,-150,-1.5,106,8.0,-115,-105,135,1.5,-126,4.8,Rogers Centre,8,4
2016-05-07,2016,CHC,WSH,8,5,-145,-1.5,150,7.5,105,-125,130,1.5,-170,4.44,Wrigley Field,13,3
2016-05-08,2016,ATL,ARI,3,5,125,1.5,-130,8.0,100,-120,-140,-1.5,110,3.56,Turner Field,8,-2
2016-05-08,2016,ARI,ATL,5,3,-140,-1.5,110,8.0,100,-120,125,1.5,-130,4.67,Turner Field,8,2
2016-05-08,2016,OAK,BAL,3,11,140,1.5,-150,8.5,-119,-101,-155,-1.5,130,3.54,Camden Yards,14,-8
2016-05-08,2016,NYY,BOS,1,5,-114,-1.5,180,8.5,100,-120,104,1.5,-210,4.53,Yankee Stadium,6,-4
2016-05-08,2016,WSH,CHC,3,4,200,1.5,-110,8.0,-125,105,-230,-1.5,-110,2.67,Wrigley Field,7,-1
2016-05-08,2016,MIL,CIN,5,4,-119,-1.5,140,8.5,-115,-105,109,1.5,-160,4.62,Great American Ballpark,9,1
2016-05-08,2016,KC,CLE,4,5,119,1.5,-185,7.5,-110,-110,-129,-1.5,165,3.42,Progressive Field,9,-1
2016-05-08,2016,SF,COL,0,2,-195,-1.5,110,8.0,-105,-115,175,1.5,-130,5.29,AT&T Park,2,-2
2016-05-08,2016,MIN,CWS,1,3,175,1.5,-130,7.5,-110,-110,-195,-1.5,110,2.73,Guaranteed Rate Field,4,-2
2016-05-08,2016,TEX,DET,8,3,119,1.5,-170,9.0,-105,-115,-129,-1.5,150,4.11,Comerica Park,11,5
2016-05-08,2016,SEA,HOU,1,5,-111,1.5,-210,8.5,100,-120,101,-1.5,180,4.47,Minute Maid Park,6,-4
2016-05-08,2016,CLE,KC,5,4,-129,-1.5,165,7.5,-110,-110,119,1.5,-185,4.22,Progressive Field,9,1
2016-05-08,2016,TB,LAA,3,1,114,1.5,-205,8.0,-110,-110,-124,-1.5,175,3.74,Angel Stadium,4,2
2016-05-08,2016,TOR,LAD,2,4,-155,-1.5,130,9.5,100,-120,140,1.5,-150,5.77,Rogers Centre,6,-2
2016-05-08,2016,PHI,MIA,6,5,-119,-1.5,140,7.5,100,-120,109,1.5,-160,4.08,Marlins Park,11,1
2016-05-08,2016,CIN,MIL,4,5,109,1.5,-160,8.5,-115,-105,-119,-1.5,140,4.07,Great American Ballpark,9,-1
2016-05-08,2016,CWS,MIN,3,1,-195,-1.5,110,7.5,-110,-110,175,1.5,-130,4.96,Guaranteed Rate Field,4,2
2016-05-08,2016,SD,NYM,3,4,135,1.5,-130,7.5,-116,-104,-150,-1.5,110,3.19,PETCO Park,7,-1
2016-05-08,2016,BOS,NYY,5,1,104,1.5,-210,8.5,100,-120,-114,-1.5,180,4.17,Yankee Stadium,6,4
2016-05-08,2016,BAL,OAK,11,3,-155,-1.5,130,8.5,-119,-101,140,1.5,-150,5.17,Camden Yards,14,8
2016-05-08,2016,MIA,PHI,5,6,109,1.5,-160,7.5,100,-120,-119,-1.5,140,3.59,Marlins Park,11,-1
2016-05-08,2016,STL,PIT,5,10,-115,-1.5,185,7.5,-120,100,105,1.5,-215,4.01,Busch Stadium,15,-5
2016-05-08,2016,NYM,SD,4,3,-150,-1.5,110,7.5,-116,-104,135,1.5,-130,4.5,PETCO Park,7,1
2016-05-08,2016,HOU,SEA,5,1,101,-1.5,180,8.5,100,-120,-111,1.5,-210,4.23,Minute Maid Park,6,4
2016-05-08,2016,COL,SF,2,0,175,1.5,-130,8.0,-105,-115,-195,-1.5,110,2.91,AT&T Park,2,2
2016-05-08,2016,PIT,STL,10,5,105,1.5,-215,7.5,-120,100,-115,-1.5,185,3.66,Busch Stadium,15,5
2016-05-08,2016,LAA,TB,1,3,-124,-1.5,175,8.0,-110,-110,114,1.5,-205,4.43,Angel Stadium,4,-2
2016-05-08,2016,DET,TEX,3,8,-129,-1.5,150,9.0,-105,-115,119,1.5,-170,5.07,Comerica Park,11,-5
2016-05-08,2016,LAD,TOR,4,2,140,1.5,-150,9.5,100,-120,-155,-1.5,130,3.96,Rogers Centre,6,2
2016-05-08,2016,CHC,WSH,4,3,-230,-1.5,-110,8.0,-125,105,200,1.5,-110,5.58,Wrigley Field,7,1
2016-05-09,2016,COL,ARI,5,10,-171,-1.5,115,10.5,-115,-105,151,1.5,-135,6.63,Coors Field,15,-5
2016-05-09,2016,OAK,BOS,7,14,115,1.5,-175,8.5,-115,-105,-130,-1.5,155,3.95,Fenway Park,21,-7
2016-05-09,2016,PIT,CIN,2,3,-121,-1.5,140,8.5,-120,100,111,1.5,-160,4.65,Great American Ballpark,5,-1
2016-05-09,2016,HOU,CLE,7,1,103,1.5,-165,7.5,-115,-105,-113,-1.5,145,3.69,Minute Maid Park,8,6
2016-05-09,2016,ARI,COL,10,5,151,1.5,-135,10.5,-115,-105,-171,-1.5,115,4.18,Coors Field,15,5
2016-05-09,2016,TEX,CWS,4,8,-116,-1.5,170,10.0,-105,-115,106,1.5,-200,5.37,Rangers Ballpark,12,-4
2016-05-09,2016,WSH,DET,5,4,-215,-1.5,-105,7.0,-110,-110,185,1.5,-115,4.78,Nationals Park,9,1
2016-05-09,2016,CLE,HOU,1,7,-113,-1.5,145,7.5,-115,-105,103,1.5,-165,3.98,Minute Maid Park,8,-6
2016-05-09,2016,NYY,KC,6,3,-130,-1.5,160,8.0,-110,-110,115,1.5,-180,4.52,Yankee Stadium,9,3
2016-05-09,2016,NYM,LAD,4,2,-105,1.5,-230,7.0,-115,-105,-105,-1.5,190,3.59,Dodger Stadium,6,2
2016-05-09,2016,MIL,MIA,1,4,245,1.5,115,7.5,-115,-105,-285,-1.5,-135,2.17,Marlins Park,5,-3
2016-05-09,2016,MIA,MIL,4,1,-285,-1.5,-135,7.5,-115,-105,245,1.5,115,5.55,Marlins Park,5,3
2016-05-09,2016,LAD,NYM,2,4,-105,-1.5,190,7.0,-115,-105,-105,1.5,-230,3.59,Dodger Stadium,6,-2
2016-05-09,2016,KC,NYY,3,6,115,1.5,-180,8.0,-110,-110,-130,-1.5,160,3.72,Yankee Stadium,9,-3
2016-05-09,2016,BOS,OAK,14,7,-130,-1.5,155,8.5,-115,-105,115,1.5,-175,4.8,Fenway Park,21,7
2016-05-09,2016,CIN,PIT,3,2,111,1.5,-160,8.5,-120,100,-121,-1.5,140,4.03,Great American Ballpark,5,1
2016-05-09,2016,TB,SEA,2,5,116,1.5,-200,7.0,-120,100,-126,-1.5,170,3.24,T-Mobile Park,7,-3
2016-05-09,2016,TOR,SF,3,1,-133,-1.5,120,8.0,109,-129,118,1.5,-140,4.57,AT&T Park,4,2
2016-05-09,2016,SEA,TB,5,2,-126,-1.5,170,7.0,-120,100,116,1.5,-200,3.9,T-Mobile Park,7,3
2016-05-09,2016,CWS,TEX,8,4,106,1.5,-200,10.0,-105,-115,-116,-1.5,170,4.85,Rangers Ballpark,12,4
2016-05-09,2016,SF,TOR,1,3,118,1.5,-140,8.0,109,-129,-133,-1.5,120,3.67,AT&T Park,4,-2
2016-05-09,2016,DET,WSH,4,5,185,1.5,-115,7.0,-110,-110,-215,-1.5,-105,2.46,Nationals Park,9,-1
2016-05-10,2016,COL,ARI,1,5,-124,-1.5,150,10.5,-105,-115,114,1.5,-170,5.81,Coors Field,6,-4
2016-05-10,2016,PHI,ATL,3,2,109,1.5,-210,7.5,105,-125,-119,-1.5,180,3.59,Turner Field,5,1
2016-05-10,2016,MIN,BAL,3,5,115,1.5,-155,7.5,-115,-105,-125,-1.5,135,3.49,Target Field,8,-2
2016-05-10,2016,OAK,BOS,5,13,-104,1.5,-205,9.5,-115,-105,-106,-1.5,175,4.84,Fenway Park,18,-8
2016-05-10,2016,SD,CHC,7,8,225,1.5,105,7.5,105,-125,-265,-1.5,-125,2.31,Wrigley Field,15,-1
2016-05-10,2016,HOU,CLE,0,4,-127,-1.5,150,8.5,-120,100,117,1.5,-170,4.76,Minute Maid Park,4,-4
2016-05-10,2016,ARI,COL,5,1,114,1.5,-170,10.5,-105,-115,-124,-1.5,150,4.91,Coors Field,6,4
2016-05-10,2016,TEX,CWS,13,11,106,1.5,-150,9.5,-105,-115,-116,-1.5,130,4.61,Rangers Ballpark,24,2
2016-05-10,2016,WSH,DET,4,5,-179,-1.5,115,8.0,100,-120,159,1.5,-135,5.13,Nationals Park,9,-1
2016-05-10,2016,CLE,HOU,4,0,117,1.5,-170,8.5,-120,100,-127,-1.5,150,3.92,Minute Maid Park,4,4
2016-05-10,2016,NYY,KC,10,7,-174,-1.5,115,7.0,110,-130,154,1.5,-135,4.45,Yankee Stadium,17,3
2016-05-10,2016,STL,LAA,8,1,108,1.5,-200,7.5,-110,-110,-118,-1.5,170,3.61,Angel Stadium,9,7
2016-05-10,2016,NYM,LAD,2,3,107,1.5,-210,7.0,-120,100,-117,-1.5,180,3.38,Dodger Stadium,5,-1
2016-05-10,2016,MIL,MIA,10,2,148,1.5,-140,8.5,-105,-115,-163,-1.5,120,3.43,Marlins Park,12,8
2016-05-10,2016,MIA,MIL,2,10,-163,-1.5,120,8.5,-105,-115,148,1.5,-140,5.27,Marlins Park,12,-8
2016-05-10,2016,BAL,MIN,5,3,-125,-1.5,135,7.5,-115,-105,115,1.5,-155,4.17,Target Field,8,2
2016-05-10,2016,LAD,NYM,3,2,-117,-1.5,180,7.0,-120,100,107,1.5,-210,3.77,Dodger Stadium,5,1
2016-05-10,2016,KC,NYY,7,10,154,1.5,-135,7.0,110,-130,-174,-1.5,115,2.76,Yankee Stadium,17,-3
2016-05-10,2016,BOS,OAK,13,5,-106,-1.5,175,9.5,-115,-105,-104,1.5,-205,4.89,Fenway Park,18,8
2016-05-10,2016,ATL,PHI,2,3,-119,-1.5,180,7.5,105,-125,109,1.5,-210,4.08,Turner Field,5,-1
2016-05-10,2016,CHC,SD,8,7,-265,-1.5,-125,7.5,105,-125,225,1.5,105,5.45,Wrigley Field,15,1
2016-05-10,2016,TB,SEA,4,6,-128,-1.5,135,7.0,100,-120,118,1.5,-155,3.93,T-Mobile Park,10,-2
2016-05-10,2016,TOR,SF,4,0,-126,-1.5,130,8.0,-120,100,116,1.5,-150,4.46,AT&T Park,4,4
2016-05-10,2016,LAA,STL,1,8,-118,-1.5,170,7.5,-110,-110,108,1.5,-200,4.06,Angel Stadium,9,-7
2016-05-10,2016,SEA,TB,6,4,118,1.5,-155,7.0,100,-120,-128,-1.5,135,3.21,T-Mobile Park,10,2
2016-05-10,2016,CWS,TEX,11,13,-116,-1.5,130,9.5,-105,-115,106,1.5,-150,5.1,Rangers Ballpark,24,-2
2016-05-10,2016,SF,TOR,0,4,116,1.5,-150,8.0,-120,100,-126,-1.5,130,3.7,AT&T Park,4,-4
2016-05-10,2016,DET,WSH,5,4,159,1.5,-135,8.0,100,-120,-179,-1.5,115,3.09,Nationals Park,9,1
2016-05-11,2016,COL,ARI,8,7,-126,-1.5,155,10.5,-110,-110,116,1.5,-175,5.85,Coors Field,15,1
2016-05-11,2016,PHI,ATL,1,5,-117,-1.5,140,7.5,-115,-105,107,1.5,-160,4.04,Turner Field,6,-4
2016-05-11,2016,MIN,BAL,2,9,108,1.5,-155,8.5,-110,-110,-118,-1.5,135,4.09,Target Field,11,-7
2016-05-11,2016,OAK,BOS,3,13,170,1.5,-115,9.0,-125,105,-200,-1.5,-105,3.33,Fenway Park,16,-10
2016-05-11,2016,SD,CHC,7,4,215,1.5,-105,7.5,-120,100,-255,-1.5,-115,2.38,Wrigley Field,11,3
2016-05-11,2016,SD,CHC,1,0,180,1.5,-120,7.0,-110,-110,-210,-1.5,100,2.5,Wrigley Field,1,1
2016-05-11,2016,PIT,CIN,5,4,-142,-1.5,115,9.0,-105,-115,127,1.5,-135,5.28,Great American Ballpark,9,1
2016-05-11,2016,HOU,CLE,5,3,127,1.5,-140,8.0,-105,-115,-142,-1.5,120,3.52,Minute Maid Park,8,2
2016-05-11,2016,ARI,COL,7,8,116,1.5,-175,10.5,-110,-110,-126,-1.5,155,4.86,Coors Field,15,-1
2016-05-11,2016,TEX,CWS,6,5,-149,-1.5,140,9.0,-110,-110,134,1.5,-160,5.39,Rangers Ballpark,11,1
2016-05-11,2016,WSH,DET,3,2,-173,-1.5,130,7.0,100,-120,153,1.5,-150,4.44,Nationals Park,5,1
2016-05-11,2016,CLE,HOU,3,5,-142,-1.5,120,8.0,-105,-115,127,1.5,-140,4.69,Minute Maid Park,8,-2
2016-05-11,2016,NYY,KC,3,7,-130,-1.5,165,7.5,-115,-105,115,1.5,-185,4.24,Yankee Stadium,10,-4
2016-05-11,2016,STL,LAA,5,2,-147,-1.5,115,7.5,-110,-110,132,1.5,-135,4.46,Angel Stadium,7,3
2016-05-11,2016,NYM,LAD,4,3,-109,-1.5,160,6.5,-120,100,-101,1.5,-180,3.39,Dodger Stadium,7,1
2016-05-11,2016,MIL,MIA,2,3,141,1.5,-155,8.5,-115,-105,-156,-1.5,135,3.53,Marlins Park,5,-1
2016-05-11,2016,MIA,MIL,3,2,-156,-1.5,135,8.5,-115,-105,141,1.5,-155,5.18,Marlins Park,5,1
2016-05-11,2016,BAL,MIN,9,2,-118,-1.5,135,8.5,-110,-110,108,1.5,-155,4.6,Target Field,11,7
2016-05-11,2016,LAD,NYM,3,4,-101,1.5,-180,6.5,-120,100,-109,-1.5,160,3.27,Dodger Stadium,7,-1
2016-05-11,2016,KC,NYY,7,3,115,1.5,-185,7.5,-115,-105,-130,-1.5,165,3.49,Yankee Stadium,10,4
2016-05-11,2016,BOS,OAK,13,3,-200,-1.5,-105,9.0,-125,105,170,1.5,-115,6.0,Fenway Park,16,10
2016-05-11,2016,ATL,PHI,5,1,107,1.5,-160,7.5,-115,-105,-117,-1.5,140,3.62,Turner Field,6,4
2016-05-11,2016,CIN,PIT,4,5,127,1.5,-135,9.0,-105,-115,-142,-1.5,115,3.96,Great American Ballpark,9,-1
2016-05-11,2016,CHC,SD,4,7,-255,-1.5,-115,7.5,-120,100,215,1.5,-105,5.39,Wrigley Field,11,-3
2016-05-11,2016,CHC,SD,0,1,-210,-1.5,100,7.0,-110,-110,180,1.5,-120,4.74,Wrigley Field,1,-1
2016-05-11,2016,TB,SEA,5,6,110,1.5,-210,7.5,100,-120,-120,-1.5,180,3.57,T-Mobile Park,11,-1
2016-05-11,2016,TOR,SF,4,5,109,1.5,-215,7.0,100,-120,-119,-1.5,185,3.35,AT&T Park,9,-1
2016-05-11,2016,LAA,STL,2,5,132,1.5,-135,7.5,-110,-110,-147,-1.5,115,3.23,Angel Stadium,7,-3
2016-05-11,2016,SEA,TB,6,5,-120,-1.5,180,7.5,100,-120,110,1.5,-210,4.09,T-Mobile Park,11,1
2016-05-11,2016,CWS,TEX,5,6,134,1.5,-160,9.0,-110,-110,-149,-1.5,140,3.85,Rangers Ballpark,11,-1
2016-05-11,2016,SF,TOR,5,4,-119,-1.5,185,7.0,100,-120,109,1.5,-215,3.8,AT&T Park,9,1
2016-05-11,2016,DET,WSH,2,3,153,1.5,-150,7.0,100,-120,-173,-1.5,130,2.77,Nationals Park,5,-1
2016-05-12,2016,SF,ARI,4,2,-108,-1.5,150,8.0,-120,100,-102,1.5,-170,4.15,Chase Field,6,2
2016-05-12,2016,PHI,ATL,7,4,-130,-1.5,130,7.0,-115,-105,115,1.5,-150,3.96,Turner Field,11,3
2016-05-12,2016,DET,BAL,5,7,155,1.5,-125,9.5,-105,-115,-175,-1.5,105,3.73,Camden Yards,12,-2
2016-05-12,2016,HOU,BOS,1,11,132,1.5,-160,8.0,-115,-105,-147,-1.5,140,3.45,Fenway Park,12,-10
2016-05-12,2016,BAL,DET,7,5,-175,-1.5,105,9.5,-105,-115,155,1.5,-125,6.05,Camden Yards,12,2
2016-05-12,2016,BOS,HOU,11,1,-147,-1.5,140,8.0,-115,-105,132,1.5,-160,4.76,Fenway Park,12,10
2016-05-12,2016,NYY,KC,7,3,-134,-1.5,165,7.5,-104,-116,119,1.5,-185,4.29,Yankee Stadium,10,4
2016-05-12,2016,STL,LAA,12,10,-123,-1.5,130,8.0,100,-120,113,1.5,-150,4.41,Angel Stadium,22,2
2016-05-12,2016,NYM,LAD,0,5,230,1.5,-110,6.0,-110,-110,-270,-1.5,-110,1.82,Dodger Stadium,5,-5
2016-05-12,2016,SD,MIL,3,0,125,1.5,-175,9.0,100,-120,-140,-1.5,155,4.0,Miller Park,3,3
2016-05-12,2016,LAD,NYM,5,0,-270,-1.5,-110,6.0,-110,-110,230,1.5,-110,4.38,Dodger Stadium,5,5
2016-05-12,2016,KC,NYY,3,7,119,1.5,-185,7.5,-104,-116,-134,-1.5,165,3.42,Yankee Stadium,10,-4
2016-05-12,2016,ATL,PHI,4,7,115,1.5,-150,7.0,-115,-105,-130,-1.5,130,3.26,Turner Field,11,-3
2016-05-12,2016,MIL,SD,0,3,-140,-1.5,155,9.0,100,-120,125,1.5,-175,5.25,Miller Park,3,-3
2016-05-12,2016,ARI,SF,2,4,-102,1.5,-170,8.0,-120,100,-108,-1.5,150,4.04,Chase Field,6,-2
2016-05-12,2016,LAA,STL,10,12,113,1.5,-150,8.0,100,-120,-123,-1.5,130,3.76,Angel Stadium,22,-2
2016-05-13,2016,SF,ARI,3,1,-172,-1.5,-110,9.5,-118,-102,152,1.5,-110,6.01,Chase Field,4,2
2016-05-13,2016,KC,ATL,5,1,-175,-1.5,120,7.5,100,-120,155,1.5,-140,4.77,Kauffman Stadium,6,4
2016-05-13,2016,DET,BAL,0,1,116,1.5,-170,9.0,100,-120,-131,-1.5,150,4.17,Camden Yards,1,-1
2016-05-13,2016,HOU,BOS,7,6,116,1.5,-170,9.0,-120,100,-131,-1.5,150,4.17,Fenway Park,13,1
2016-05-13,2016,PIT,CHC,4,9,126,1.5,-170,9.0,105,-125,-141,-1.5,150,3.98,Wrigley Field,13,-5
2016-05-13,2016,PHI,CIN,3,2,-114,-1.5,180,8.0,-115,-105,104,1.5,-210,4.26,Citizens Bank Park,5,1
2016-05-13,2016,MIN,CLE,6,7,140,1.5,-155,8.5,-105,-115,-155,-1.5,135,3.54,Progressive Field,13,-1
2016-05-13,2016,NYM,COL,2,5,-113,-1.5,135,10.5,100,-120,103,1.5,-155,5.57,Coors Field,7,-3
2016-05-13,2016,NYY,CWS,1,7,125,1.5,-130,7.0,-125,105,-140,-1.5,110,3.11,Yankee Stadium,8,-6
2016-05-13,2016,BAL,DET,1,0,-131,-1.5,150,9.0,100,-120,116,1.5,-170,5.1,Camden Yards,1,1
2016-05-13,2016,BOS,HOU,6,7,-131,-1.5,150,9.0,-120,100,116,1.5,-170,5.1,Fenway Park,13,-1
2016-05-13,2016,ATL,KC,1,5,155,1.5,-140,7.5,100,-120,-175,-1.5,120,2.94,Kauffman Stadium,6,-4
2016-05-13,2016,SEA,LAA,6,7,-159,-1.5,137,8.0,-110,-110,144,1.5,-157,4.91,T-Mobile Park,13,-1
2016-05-13,2016,STL,LAD,4,8,-117,-1.5,145,7.5,100,-120,107,1.5,-165,4.04,Dodger Stadium,12,-4
2016-05-13,2016,WSH,MIA,5,3,-170,-1.5,120,8.5,-114,-106,150,1.5,-140,5.35,Nationals Park,8,2
2016-05-13,2016,SD,MIL,0,1,164,1.5,-125,9.0,-115,-105,-184,-1.5,105,3.41,Miller Park,1,-1
2016-05-13,2016,CLE,MIN,7,6,-155,-1.5,135,8.5,-105,-115,140,1.5,-155,5.17,Progressive Field,13,1
2016-05-13,2016,COL,NYM,5,2,103,1.5,-155,10.5,100,-120,-113,-1.5,135,5.17,Coors Field,7,3
2016-05-13,2016,CWS,NYY,7,1,-140,-1.5,110,7.0,-125,105,125,1.5,-130,4.08,Yankee Stadium,8,6
2016-05-13,2016,TB,OAK,3,6,-115,-1.5,185,7.0,-110,-110,105,1.5,-215,3.74,Tropicana Field,9,-3
2016-05-13,2016,CIN,PHI,2,3,104,1.5,-210,8.0,-115,-105,-114,-1.5,180,3.92,Citizens Bank Park,5,-1
2016-05-13,2016,CHC,PIT,9,4,-141,-1.5,150,9.0,105,-125,126,1.5,-170,5.27,Wrigley Field,13,5
2016-05-13,2016,MIL,SD,1,0,-184,-1.5,105,9.0,-115,-105,164,1.5,-125,5.83,Miller Park,1,1
2016-05-13,2016,LAA,SEA,7,6,144,1.5,-157,8.0,-110,-110,-159,-1.5,137,3.28,T-Mobile Park,13,1
2016-05-13,2016,ARI,SF,1,3,152,1.5,-110,9.5,-118,-102,-172,-1.5,-110,3.77,Chase Field,4,-2
2016-05-13,2016,LAD,STL,8,4,107,1.5,-165,7.5,100,-120,-117,-1.5,145,3.62,Dodger Stadium,12,4
2016-05-13,2016,OAK,TB,6,3,105,1.5,-215,7.0,-110,-110,-115,-1.5,185,3.41,Tropicana Field,9,3
2016-05-13,2016,TOR,TEX,5,0,-127,-1.5,125,9.5,-115,-105,117,1.5,-145,5.31,Rangers Ballpark,5,5
2016-05-13,2016,TEX,TOR,0,5,117,1.5,-145,9.5,-115,-105,-127,-1.5,125,4.38,Rangers Ballpark,5,-5
2016-05-13,2016,MIA,WSH,3,5,150,1.5,-140,8.5,-114,-106,-170,-1.5,120,3.4,Nationals Park,8,-2
2016-05-14,2016,SF,ARI,5,3,117,1.5,-180,9.0,-115,-105,-127,-1.5,160,4.15,Chase Field,8,2
2016-05-14,2016,KC,ATL,0,5,-200,-1.5,100,8.0,-105,-115,170,1.5,-120,5.33,Kauffman Stadium,5,-5
2016-05-14,2016,DET,BAL,3,9,117,1.5,-170,9.0,-115,-105,-132,-1.5,150,4.15,Camden Yards,12,-6
2016-05-14,2016,HOU,BOS,5,6,106,1.5,-174,10.0,-120,100,-116,-1.5,154,4.85,Fenway Park,11,-1
2016-05-14,2016,PIT,CHC,2,8,250,1.5,120,8.5,100,-120,-290,-1.5,-140,2.43,Wrigley Field,10,-6
2016-05-14,2016,PHI,CIN,4,3,-155,-1.5,135,7.5,105,-125,140,1.5,-155,4.56,Citizens Bank Park,7,1
2016-05-14,2016,MIN,CLE,6,3,170,1.5,-130,7.5,110,-130,-200,-1.5,110,2.78,Progressive Field,9,3
2016-05-14,2016,NYM,COL,4,7,-131,-1.5,115,11.5,-115,-105,116,1.5,-135,6.52,Coors Field,11,-3
2016-05-14,2016,NYY,CWS,2,1,135,1.5,-125,8.0,-115,-105,-150,-1.5,105,3.4,Yankee Stadium,3,1
2016-05-14,2016,BAL,DET,9,3,-132,-1.5,150,9.0,-115,-105,117,1.5,-170,5.12,Camden Yards,12,6
2016-05-14,2016,BOS,HOU,6,5,-116,-1.5,154,10.0,-120,100,106,1.5,-174,5.37,Fenway Park,11,1
2016-05-14,2016,ATL,KC,5,0,170,1.5,-120,8.0,-105,-115,-200,-1.5,100,2.96,Kauffman Stadium,5,5
2016-05-14,2016,SEA,LAA,7,9,-158,-1.5,130,7.5,-105,-115,143,1.5,-150,4.59,T-Mobile Park,16,-2
2016-05-14,2016,STL,LAD,3,5,-106,-1.5,150,7.5,-105,-115,-104,1.5,-170,3.86,Dodger Stadium,8,-2
2016-05-14,2016,WSH,MIA,6,4,-270,-1.5,-119,7.5,-105,-115,230,1.5,-101,5.47,Nationals Park,10,2
2016-05-14,2016,WSH,MIA,1,7,-130,-1.5,170,8.0,-120,100,115,1.5,-200,4.52,Nationals Park,8,-6
2016-05-14,2016,SD,MIL,8,7,115,1.5,-180,9.0,-119,-101,-130,-1.5,160,4.19,Miller Park,15,1
2016-05-14,2016,CLE,MIN,3,6,-200,-1.5,110,7.5,110,-130,170,1.5,-130,5.0,Progressive Field,9,-3
2016-05-14,2016,COL,NYM,7,4,116,1.5,-135,11.5,-115,-105,-131,-1.5,115,5.32,Coors Field,11,3
2016-05-14,2016,CWS,NYY,1,2,-150,-1.5,105,8.0,-115,-105,135,1.5,-125,4.8,Yankee Stadium,3,-1
2016-05-14,2016,TB,OAK,6,0,-144,-1.5,145,8.0,-110,-110,129,1.5,-165,4.72,Tropicana Field,6,6
2016-05-14,2016,CIN,PHI,3,4,140,1.5,-155,7.5,105,-125,-155,-1.5,135,3.13,Citizens Bank Park,7,-1
2016-05-14,2016,CHC,PIT,8,2,-290,-1.5,-140,8.5,100,-120,250,1.5,120,6.32,Wrigley Field,10,6
2016-05-14,2016,MIL,SD,7,8,-130,-1.5,160,9.0,-119,-101,115,1.5,-180,5.09,Miller Park,15,-1
2016-05-14,2016,LAA,SEA,9,7,143,1.5,-150,7.5,-105,-115,-158,-1.5,130,3.09,T-Mobile Park,16,2
2016-05-14,2016,ARI,SF,3,5,-127,-1.5,160,9.0,-115,-105,117,1.5,-180,5.04,Chase Field,8,-2
2016-05-14,2016,LAD,STL,5,3,-104,1.5,-170,7.5,-105,-115,-106,-1.5,150,3.82,Dodger Stadium,8,2
2016-05-14,2016,OAK,TB,0,6,129,1.5,-165,8.0,-110,-110,-144,-1.5,145,3.49,Tropicana Field,6,-6
2016-05-14,2016,TOR,TEX,5,6,-141,-1.5,110,8.5,-112,-108,126,1.5,-130,4.97,Rangers Ballpark,11,-1
2016-05-14,2016,TEX,TOR,6,5,126,1.5,-130,8.5,-112,-108,-141,-1.5,110,3.76,Rangers Ballpark,11,1
2016-05-14,2016,MIA,WSH,4,6,230,1.5,-101,7.5,-105,-115,-270,-1.5,-119,2.27,Nationals Park,10,-2
2016-05-14,2016,MIA,WSH,7,1,115,1.5,-200,8.0,-120,100,-130,-1.5,170,3.72,Nationals Park,8,6
2016-05-15,2016,SF,ARI,2,1,110,1.5,-200,9.0,-120,100,-120,-1.5,170,4.29,Chase Field,3,1
2016-05-15,2016,KC,ATL,4,2,-235,-1.5,-105,7.5,105,-125,205,1.5,-115,5.26,Kauffman Stadium,6,2
2016-05-15,2016,DET,BAL,6,5,150,1.5,-140,9.0,110,-130,-170,-1.5,120,3.6,Camden Yards,11,1
2016-05-15,2016,HOU,BOS,9,10,-116,-1.5,130,10.5,100,-120,106,1.5,-150,5.64,Fenway Park,19,-1
2016-05-15,2016,PIT,CHC,2,1,127,1.5,-175,7.5,-105,-115,-142,-1.5,155,3.3,Wrigley Field,3,1
2016-05-15,2016,PHI,CIN,4,9,-119,-1.5,175,7.5,-110,-110,109,1.5,-205,4.08,Citizens Bank Park,13,-5
2016-05-15,2016,MIN,CLE,5,1,112,1.5,-200,7.5,-115,-105,-122,-1.5,170,3.54,Progressive Field,6,4
2016-05-15,2016,NYM,COL,3,4,-121,-1.5,125,10.0,-125,105,111,1.5,-145,5.48,Coors Field,7,-1
2016-05-15,2016,NYY,CWS,7,5,-174,-1.5,115,8.0,-110,-110,154,1.5,-135,5.08,Yankee Stadium,12,2
2016-05-15,2016,BAL,DET,5,6,-170,-1.5,120,9.0,110,-130,150,1.5,-140,5.67,Camden Yards,11,-1
2016-05-15,2016,BOS,HOU,10,9,106,1.5,-150,10.5,100,-120,-116,-1.5,130,5.1,Fenway Park,19,1
2016-05-15,2016,ATL,KC,2,4,205,1.5,-115,7.5,105,-125,-235,-1.5,-105,2.46,Kauffman Stadium,6,-2
2016-05-15,2016,SEA,LAA,0,3,-145,-1.5,150,7.5,105,-125,130,1.5,-170,4.44,T-Mobile Park,3,-3
2016-05-15,2016,STL,LAD,5,2,119,1.5,-179,8.0,-110,-110,-134,-1.5,159,3.65,Dodger Stadium,7,3
2016-05-15,2016,WSH,MIA,1,5,113,1.5,-155,7.5,100,-120,-123,-1.5,135,3.52,Nationals Park,6,-4
2016-05-15,2016,SD,MIL,2,3,110,1.5,-185,9.0,100,-120,-120,-1.5,165,4.29,Miller Park,5,-1
2016-05-15,2016,CLE,MIN,1,5,-122,-1.5,170,7.5,-115,-105,112,1.5,-200,4.12,Progressive Field,6,-4
2016-05-15,2016,COL,NYM,4,3,111,1.5,-145,10.0,-125,105,-121,-1.5,125,4.74,Coors Field,7,1
2016-05-15,2016,CWS,NYY,5,7,154,1.5,-135,8.0,-110,-110,-174,-1.5,115,3.15,Yankee Stadium,12,-2
2016-05-15,2016,TB,OAK,6,7,-145,-1.5,155,7.5,-107,-113,130,1.5,-175,4.44,Tropicana Field,13,-1
2016-05-15,2016,CIN,PHI,9,4,109,1.5,-205,7.5,-110,-110,-119,-1.5,175,3.59,Citizens Bank Park,13,5
2016-05-15,2016,CHC,PIT,1,2,-142,-1.5,155,7.5,-105,-115,127,1.5,-175,4.4,Wrigley Field,3,-1
2016-05-15,2016,MIL,SD,3,2,-120,-1.5,165,9.0,100,-120,110,1.5,-185,4.91,Miller Park,5,1
2016-05-15,2016,LAA,SEA,3,0,130,1.5,-170,7.5,105,-125,-145,-1.5,150,3.26,T-Mobile Park,3,3
2016-05-15,2016,ARI,SF,1,2,-120,-1.5,170,9.0,-120,100,110,1.5,-200,4.91,Chase Field,3,-1
2016-05-15,2016,LAD,STL,2,5,-134,-1.5,159,8.0,-110,-110,119,1.5,-179,4.58,Dodger Stadium,7,-3
2016-05-15,2016,OAK,TB,7,6,130,1.5,-175,7.5,-107,-113,-145,-1.5,155,3.26,Tropicana Field,13,1
2016-05-15,2016,TOR,TEX,6,7,-164,-1.5,-105,9.0,-115,-105,149,1.5,-115,5.59,Rangers Ballpark,13,-1
2016-05-15,2016,TEX,TOR,7,6,149,1.5,-115,9.0,-115,-105,-164,-1.5,-105,3.61,Rangers Ballpark,13,1
2016-05-15,2016,MIA,WSH,5,1,-123,-1.5,135,7.5,100,-120,113,1.5,-155,4.14,Nationals Park,6,4
2016-05-16,2016,NYY,ARI,2,12,112,1.5,-200,9.0,-110,-110,-122,-1.5,170,4.25,Chase Field,14,-10
2016-05-16,2016,PIT,ATL,8,5,-195,-1.5,100,8.0,-105,-115,175,1.5,-120,5.29,PNC Park,13,3
2016-05-16,2016,CLE,CIN,15,6,-180,-1.5,115,8.5,-120,100,160,1.5,-135,5.46,Progressive Field,21,9
2016-05-16,2016,CIN,CLE,6,15,160,1.5,-135,8.5,-120,100,-180,-1.5,115,3.27,Progressive Field,21,-9
2016-05-16,2016,MIN,DET,8,10,120,1.5,-170,8.5,-120,100,-135,-1.5,150,3.86,Comerica Park,18,-2
2016-05-16,2016,LAD,LAA,6,7,-200,-1.5,105,7.5,-105,-115,170,1.5,-125,5.0,Dodger Stadium,13,-1
2016-05-16,2016,LAA,LAD,7,6,170,1.5,-125,7.5,-105,-115,-200,-1.5,105,2.78,Dodger Stadium,13,1
2016-05-16,2016,PHI,MIA,3,5,114,1.5,-155,7.5,-115,-105,-124,-1.5,135,3.5,Citizens Bank Park,8,-2
2016-05-16,2016,DET,MIN,10,8,-135,-1.5,150,8.5,-120,100,120,1.5,-170,4.88,Comerica Park,18,2
2016-05-16,2016,ARI,NYY,12,2,-122,-1.5,170,9.0,-110,-110,112,1.5,-200,4.95,Chase Field,14,10
2016-05-16,2016,TEX,OAK,1,3,125,1.5,-175,8.0,-120,100,-140,-1.5,155,3.56,Oakland Coliseum,4,-2
2016-05-16,2016,MIA,PHI,5,3,-124,-1.5,135,7.5,-115,-105,114,1.5,-155,4.15,Citizens Bank Park,8,2
2016-05-16,2016,ATL,PIT,5,8,175,1.5,-120,8.0,-105,-115,-195,-1.5,100,2.91,PNC Park,13,-3
2016-05-16,2016,TOR,TB,2,13,-134,-1.5,160,8.0,-120,100,119,1.5,-180,4.58,Rogers Centre,15,-11
2016-05-16,2016,OAK,TEX,3,1,-140,-1.5,155,8.0,-120,100,125,1.5,-175,4.67,Oakland Coliseum,4,2
2016-05-16,2016,TB,TOR,13,2,119,1.5,-180,8.0,-120,100,-134,-1.5,160,3.65,Rogers Centre,15,11
2016-05-17,2016,NYY,ARI,3,5,-101,1.5,-215,8.0,-101,-119,-109,-1.5,185,4.02,Chase Field,8,-2
2016-05-17,2016,PIT,ATL,12,9,-174,-1.5,115,7.5,-115,-105,154,1.5,-135,4.76,PNC Park,21,3
2016-05-17,2016,SEA,BAL,10,0,111,1.5,-180,9.0,110,-130,-121,-1.5,160,4.27,Camden Yards,10,10
2016-05-17,2016,KC,BOS,8,4,116,1.5,-140,7.0,-115,-105,-131,-1.5,120,3.24,Kauffman Stadium,12,4
2016-05-17,2016,MIL,CHC,4,2,170,1.5,110,8.5,-115,-105,-200,-1.5,-130,3.15,Miller Park,6,2
2016-05-17,2016,CLE,CIN,13,1,-260,-1.5,-135,7.5,-105,-115,220,1.5,115,5.42,Progressive Field,14,12
2016-05-17,2016,CIN,CLE,1,13,220,1.5,115,7.5,-105,-115,-260,-1.5,-135,2.34,Progressive Field,14,-12
2016-05-17,2016,STL,COL,1,3,-184,-1.5,120,7.0,110,-130,164,1.5,-140,4.54,Busch Stadium,4,-2
2016-05-17,2016,HOU,CWS,6,5,-128,-1.5,120,7.5,-110,-110,118,1.5,-140,4.21,Guaranteed Rate Field,11,1
2016-05-17,2016,MIN,DET,2,7,111,1.5,-175,9.5,-110,-110,-121,-1.5,155,4.5,Comerica Park,9,-5
2016-05-17,2016,CWS,HOU,5,6,118,1.5,-140,7.5,-110,-110,-128,-1.5,120,3.44,Guaranteed Rate Field,11,-1
2016-05-17,2016,BOS,KC,4,8,-131,-1.5,120,7.0,-115,-105,116,1.5,-140,3.97,Kauffman Stadium,12,-4
2016-05-17,2016,LAD,LAA,5,1,-340,-1.5,-135,6.5,-120,100,290,1.5,115,5.02,Dodger Stadium,6,4
2016-05-17,2016,LAA,LAD,1,5,290,1.5,115,6.5,-120,100,-340,-1.5,-135,1.67,Dodger Stadium,6,-4
2016-05-17,2016,PHI,MIA,3,1,-105,1.5,-185,7.0,-110,-110,-105,-1.5,165,3.59,Citizens Bank Park,4,2
2016-05-17,2016,CHC,MIL,2,4,-200,-1.5,-130,8.5,-115,-105,170,1.5,110,5.67,Miller Park,6,-2
2016-05-17,2016,DET,MIN,7,2,-121,-1.5,155,9.5,-110,-110,111,1.5,-175,5.2,Comerica Park,9,5
2016-05-17,2016,WSH,NYM,0,2,-109,-1.5,150,6.0,-110,-110,-101,1.5,-170,3.13,Citi Field,2,-2
2016-05-17,2016,ARI,NYY,5,3,-109,-1.5,185,8.0,-101,-119,-101,1.5,-215,4.17,Chase Field,8,2
2016-05-17,2016,TEX,OAK,5,8,-117,-1.5,140,7.5,105,-125,107,1.5,-160,4.04,Oakland Coliseum,13,-3
2016-05-17,2016,MIA,PHI,1,3,-105,-1.5,165,7.0,-110,-110,-105,1.5,-185,3.59,Citizens Bank Park,4,-2
2016-05-17,2016,ATL,PIT,9,12,154,1.5,-135,7.5,-115,-105,-174,-1.5,115,2.95,PNC Park,21,-3
2016-05-17,2016,SF,SD,5,1,-185,-1.5,-110,7.0,-125,105,165,1.5,-110,4.54,PETCO Park,6,4
2016-05-17,2016,BAL,SEA,0,10,-121,-1.5,160,9.0,110,-130,111,1.5,-180,4.93,Camden Yards,10,-10
2016-05-17,2016,SD,SF,1,5,165,1.5,-110,7.0,-125,105,-185,-1.5,-110,2.64,PETCO Park,6,-4
2016-05-17,2016,COL,STL,3,1,164,1.5,-140,7.0,110,-130,-184,-1.5,120,2.65,Busch Stadium,4,2
2016-05-17,2016,TOR,TB,2,12,-148,-1.5,145,8.0,-110,-110,133,1.5,-165,4.77,Rogers Centre,14,-10
2016-05-17,2016,OAK,TEX,8,5,107,1.5,-160,7.5,105,-125,-117,-1.5,140,3.62,Oakland Coliseum,13,3
2016-05-17,2016,TB,TOR,12,2,133,1.5,-165,8.0,-110,-110,-148,-1.5,145,3.43,Rogers Centre,14,10
2016-05-17,2016,NYM,WSH,2,0,-101,1.5,-170,6.0,-110,-110,-109,-1.5,150,3.01,Citi Field,2,2
2016-05-18,2016,NYY,ARI,4,2,-161,-1.5,-101,9.0,111,-131,146,1.5,-119,5.55,Chase Field,6,2
2016-05-18,2016,PIT,ATL,1,3,-182,-1.5,125,7.0,105,-125,162,1.5,-145,4.52,PNC Park,4,-2
2016-05-18,2016,SEA,BAL,2,5,102,1.5,-200,8.5,-110,-110,-112,-1.5,170,4.21,Camden Yards,7,-3
2016-05-18,2016,KC,BOS,3,2,105,1.5,-170,7.5,-110,-110,-115,-1.5,150,3.66,Kauffman Stadium,5,1
2016-05-18,2016,KC,BOS,2,5,149,1.5,-115,7.0,-110,-110,-164,-1.5,-105,2.81,Kauffman Stadium,7,-3
2016-05-18,2016,MIL,CHC,1,2,160,1.5,-105,8.5,-110,-110,-180,-1.5,-115,3.27,Miller Park,3,-1
2016-05-18,2016,CLE,CIN,8,7,-115,-1.5,140,8.5,100,-120,105,1.5,-160,4.55,Great American Ballpark,15,1
2016-05-18,2016,CIN,CLE,7,8,105,1.5,-160,8.5,100,-120,-115,-1.5,140,4.15,Great American Ballpark,15,-1
2016-05-18,2016,STL,COL,2,0,-175,-1.5,130,8.0,100,-120,155,1.5,-150,5.09,Busch Stadium,2,2
2016-05-18,2016,HOU,CWS,5,3,-106,-1.5,155,8.5,-120,100,-104,1.5,-175,4.37,Guaranteed Rate Field,8,2
2016-05-18,2016,MIN,DET,3,6,143,1.5,-155,9.0,-103,-117,-158,-1.5,135,3.7,Comerica Park,9,-3
2016-05-18,2016,CWS,HOU,3,5,-104,1.5,-175,8.5,-120,100,-106,-1.5,155,4.33,Guaranteed Rate Field,8,-2
2016-05-18,2016,BOS,KC,2,3,-115,-1.5,150,7.5,-110,-110,105,1.5,-170,4.01,Kauffman Stadium,5,-1
2016-05-18,2016,BOS,KC,5,2,-164,-1.5,-105,7.0,-110,-110,149,1.5,-115,4.35,Kauffman Stadium,7,3
2016-05-18,2016,LAD,LAA,1,8,101,1.5,-215,8.0,-105,-115,-111,-1.5,185,3.98,Angel Stadium,9,-7
2016-05-18,2016,LAA,LAD,8,1,-111,-1.5,185,8.0,-105,-115,101,1.5,-215,4.21,Angel Stadium,9,7
2016-05-18,2016,PHI,MIA,4,2,108,1.5,-160,8.0,-120,100,-118,-1.5,140,3.85,Citizens Bank Park,6,2
2016-05-18,2016,CHC,MIL,2,1,-180,-1.5,-115,8.5,-110,-110,160,1.5,-105,5.46,Miller Park,3,1
2016-05-18,2016,DET,MIN,6,3,-158,-1.5,135,9.0,-103,-117,143,1.5,-155,5.51,Comerica Park,9,3
2016-05-18,2016,WSH,NYM,7,1,-105,1.5,-230,7.0,-125,105,-105,-1.5,190,3.59,Citi Field,8,6
2016-05-18,2016,ARI,NYY,2,4,146,1.5,-119,9.0,111,-131,-161,-1.5,-101,3.66,Chase Field,6,-2
2016-05-18,2016,TEX,OAK,1,8,132,1.5,-165,8.0,100,-120,-147,-1.5,145,3.45,Oakland Coliseum,9,-7
2016-05-18,2016,MIA,PHI,2,4,-118,-1.5,140,8.0,-120,100,108,1.5,-160,4.33,Citizens Bank Park,6,-2
2016-05-18,2016,ATL,PIT,3,1,162,1.5,-145,7.0,105,-125,-182,-1.5,125,2.67,PNC Park,4,2
2016-05-18,2016,SF,SD,2,1,-134,-1.5,130,6.5,105,-125,119,1.5,-150,3.72,PETCO Park,3,1
2016-05-18,2016,BAL,SEA,5,2,-112,-1.5,170,8.5,-110,-110,102,1.5,-200,4.49,Camden Yards,7,3
2016-05-18,2016,SD,SF,1,2,119,1.5,-150,6.5,105,-125,-134,-1.5,130,2.97,PETCO Park,3,-1
2016-05-18,2016,COL,STL,0,2,155,1.5,-150,8.0,100,-120,-175,-1.5,130,3.14,Busch Stadium,2,-2
2016-05-18,2016,TOR,TB,3,6,-110,-1.5,175,8.5,-110,-110,100,1.5,-205,4.45,Rogers Centre,9,-3
2016-05-18,2016,OAK,TEX,8,1,-147,-1.5,145,8.0,100,-120,132,1.5,-165,4.76,Oakland Coliseum,9,7
2016-05-18,2016,TB,TOR,6,3,100,1.5,-205,8.5,-110,-110,-110,-1.5,175,4.25,Rogers Centre,9,3
2016-05-18,2016,NYM,WSH,1,7,-105,-1.5,190,7.0,-125,105,-105,1.5,-230,3.59,Citi Field,8,-6
2016-05-19,2016,PIT,ATL,8,2,-180,-1.5,120,8.0,-105,-115,160,1.5,-140,5.14,PNC Park,10,6
2016-05-19,2016,SEA,BAL,7,2,-105,-1.5,165,9.0,100,-120,-105,1.5,-185,4.61,Camden Yards,9,5
2016-05-19,2016,MIL,CHC,5,3,175,1.5,109,8.5,-122,102,-205,-1.5,-129,3.09,Miller Park,8,2
2016-05-19,2016,CLE,CIN,7,2,-115,-1.5,145,8.5,-105,-115,105,1.5,-165,4.55,Great American Ballpark,9,5
2016-05-19,2016,CIN,CLE,2,7,105,1.5,-165,8.5,-105,-115,-115,-1.5,145,4.15,Great American Ballpark,9,-5
2016-05-19,2016,STL,COL,13,7,-134,-1.5,170,7.0,-115,-105,119,1.5,-200,4.01,Busch Stadium,20,6
2016-05-19,2016,HOU,CWS,1,2,147,1.5,-150,7.5,-105,-115,-162,-1.5,130,3.04,Guaranteed Rate Field,3,-1
2016-05-19,2016,CWS,HOU,2,1,-162,-1.5,130,7.5,-105,-115,147,1.5,-150,4.64,Guaranteed Rate Field,3,1
2016-05-19,2016,LAD,LAA,4,7,107,1.5,-200,7.5,-115,-105,-117,-1.5,170,3.62,Angel Stadium,11,-3
2016-05-19,2016,LAA,LAD,7,4,-117,-1.5,170,7.5,-115,-105,107,1.5,-200,4.04,Angel Stadium,11,3
2016-05-19,2016,CHC,MIL,3,5,-205,-1.5,-129,8.5,-122,102,175,1.5,109,5.71,Miller Park,8,-2
2016-05-19,2016,TOR,MIN,3,2,-131,-1.5,120,9.0,-115,-105,116,1.5,-140,5.1,Target Field,5,1
2016-05-19,2016,WSH,NYM,9,1,-120,-1.5,145,6.5,-125,105,110,1.5,-165,3.55,Citi Field,10,8
2016-05-19,2016,OAK,NYY,1,4,-109,-1.5,180,8.0,-115,-105,-101,1.5,-210,4.17,Oakland Coliseum,5,-3
2016-05-19,2016,NYY,OAK,4,1,-101,1.5,-210,8.0,-115,-105,-109,-1.5,180,4.02,Oakland Coliseum,5,3
2016-05-19,2016,ATL,PIT,2,8,160,1.5,-140,8.0,-105,-115,-180,-1.5,120,3.08,PNC Park,10,-6
2016-05-19,2016,SF,SD,3,1,-154,-1.5,110,7.0,-120,100,139,1.5,-130,4.24,PETCO Park,4,2
2016-05-19,2016,BAL,SEA,2,7,-105,1.5,-185,9.0,100,-120,-105,-1.5,165,4.61,Camden Yards,9,-5
2016-05-19,2016,SD,SF,1,3,139,1.5,-130,7.0,-120,100,-154,-1.5,110,2.93,PETCO Park,4,-2
2016-05-19,2016,COL,STL,7,13,119,1.5,-200,7.0,-115,-105,-134,-1.5,170,3.2,Busch Stadium,20,-6
2016-05-19,2016,MIN,TOR,2,3,116,1.5,-140,9.0,-115,-105,-131,-1.5,120,4.17,Target Field,5,-1
2016-05-19,2016,NYM,WSH,1,9,110,1.5,-165,6.5,-125,105,-120,-1.5,145,3.1,Citi Field,10,-8
2016-05-20,2016,STL,ARI,7,11,-160,-1.5,140,7.0,-120,100,145,1.5,-160,4.31,Busch Stadium,18,-4
2016-05-20,2016,PHI,ATL,1,7,-170,-1.5,125,7.5,-110,-110,150,1.5,-145,4.72,Citizens Bank Park,8,-6
2016-05-20,2016,LAA,BAL,4,9,-125,-1.5,165,7.5,-110,-110,115,1.5,-185,4.17,Angel Stadium,13,-5
2016-05-20,2016,CLE,BOS,4,2,-115,-1.5,140,8.5,-125,105,105,1.5,-160,4.55,Fenway Park,6,2
2016-05-20,2016,SF,CHC,1,8,175,1.5,103,7.0,-130,110,-195,-1.5,-123,2.55,AT&T Park,9,-7
2016-05-20,2016,SEA,CIN,8,3,-131,-1.5,125,8.5,-110,-110,116,1.5,-145,4.82,Great American Ballpark,11,5
2016-05-20,2016,BOS,CLE,2,4,105,1.5,-160,8.5,-125,105,-115,-1.5,140,4.15,Fenway Park,6,-2
2016-05-20,2016,PIT,COL,2,1,-200,-1.5,105,7.5,-120,100,170,1.5,-125,5.0,PNC Park,3,1
2016-05-20,2016,KC,CWS,4,1,145,1.5,-160,7.5,105,-125,-160,-1.5,140,3.06,Guaranteed Rate Field,5,3
2016-05-20,2016,TB,DET,7,5,-111,-1.5,145,9.0,100,-120,101,1.5,-165,4.73,Comerica Park,12,2
2016-05-20,2016,TEX,HOU,2,1,149,1.5,-150,8.5,-120,100,-164,-1.5,130,3.41,Minute Maid Park,3,1
2016-05-20,2016,CWS,KC,1,4,-160,-1.5,140,7.5,105,-125,145,1.5,-160,4.62,Guaranteed Rate Field,5,-3
2016-05-20,2016,BAL,LAA,9,4,115,1.5,-185,7.5,-110,-110,-125,-1.5,165,3.49,Angel Stadium,13,5
2016-05-20,2016,SD,LAD,7,6,134,1.5,-135,7.5,-103,-117,-149,-1.5,115,3.21,PETCO Park,13,1
2016-05-20,2016,WSH,MIA,4,1,-145,-1.5,120,9.0,-115,-105,130,1.5,-140,5.33,Marlins Park,5,3
2016-05-20,2016,NYM,MIL,3,2,-252,-1.5,-120,7.5,-105,-115,212,1.5,100,5.37,Citi Field,5,1
2016-05-20,2016,TOR,MIN,9,3,-124,-1.5,130,8.5,-104,-116,114,1.5,-150,4.71,Target Field,12,6
2016-05-20,2016,MIL,NYM,2,3,212,1.5,100,7.5,-105,-115,-252,-1.5,-120,2.4,Citi Field,5,-1
2016-05-20,2016,OAK,NYY,3,8,-140,-1.5,155,7.5,-110,-110,125,1.5,-175,4.38,Oakland Coliseum,11,-5
2016-05-20,2016,NYY,OAK,8,3,125,1.5,-175,7.5,-110,-110,-140,-1.5,155,3.33,Oakland Coliseum,11,5
2016-05-20,2016,ATL,PHI,7,1,150,1.5,-145,7.5,-110,-110,-170,-1.5,125,3.0,Citizens Bank Park,8,6
2016-05-20,2016,COL,PIT,1,2,170,1.5,-125,7.5,-120,100,-200,-1.5,105,2.78,PNC Park,3,-1
2016-05-20,2016,LAD,SD,6,7,-149,-1.5,115,7.5,-103,-117,134,1.5,-135,4.49,PETCO Park,13,-1
2016-05-20,2016,CIN,SEA,3,8,116,1.5,-145,8.5,-110,-110,-131,-1.5,125,3.94,Great American Ballpark,11,-5
2016-05-20,2016,CHC,SF,8,1,-195,-1.5,-123,7.0,-130,110,175,1.5,103,4.63,AT&T Park,9,7
2016-05-20,2016,ARI,STL,11,7,145,1.5,-160,7.0,-120,100,-160,-1.5,140,2.86,Busch Stadium,18,4
2016-05-20,2016,DET,TB,5,7,101,1.5,-165,9.0,100,-120,-111,-1.5,145,4.48,Comerica Park,12,-2
2016-05-20,2016,HOU,TEX,1,2,-164,-1.5,130,8.5,-120,100,149,1.5,-150,5.28,Minute Maid Park,3,-1
2016-05-20,2016,MIN,TOR,3,9,114,1.5,-150,8.5,-104,-116,-124,-1.5,130,3.97,Target Field,12,-6
2016-05-20,2016,MIA,WSH,1,4,130,1.5,-140,9.0,-115,-105,-145,-1.5,120,3.91,Marlins Park,5,-3
2016-05-21,2016,STL,ARI,6,2,-160,-1.5,141,7.5,-123,103,145,1.5,-162,4.62,Busch Stadium,8,4
2016-05-21,2016,PHI,ATL,0,2,-144,-1.5,155,8.0,-105,-115,129,1.5,-175,4.72,Citizens Bank Park,2,-2
2016-05-21,2016,LAA,BAL,1,3,128,1.5,-135,8.0,-112,-108,-143,-1.5,115,3.51,Angel Stadium,4,-2
2016-05-21,2016,CLE,BOS,1,9,135,1.5,-150,10.0,-105,-115,-150,-1.5,130,4.26,Fenway Park,10,-8
2016-05-21,2016,SF,CHC,5,3,145,1.5,-110,7.5,-115,-105,-160,-1.5,-110,3.06,AT&T Park,8,2
2016-05-21,2016,SEA,CIN,4,0,-160,-1.5,105,8.5,-115,-105,145,1.5,-125,5.23,Great American Ballpark,4,4
2016-05-21,2016,BOS,CLE,9,1,-150,-1.5,130,10.0,-105,-115,135,1.5,-150,6.0,Fenway Park,10,8
2016-05-21,2016,PIT,COL,1,5,-121,-1.5,170,7.5,-110,-110,111,1.5,-200,4.11,PNC Park,6,-4
2016-05-21,2016,KC,CWS,2,1,-134,-1.5,120,9.0,100,-120,119,1.5,-140,5.15,Guaranteed Rate Field,3,1
2016-05-21,2016,TB,DET,4,5,-121,-1.5,135,9.0,-105,-115,111,1.5,-155,4.93,Comerica Park,9,-1
2016-05-21,2016,TEX,HOU,2,1,163,1.5,-130,8.5,-120,100,-183,-1.5,110,3.23,Minute Maid Park,3,1
2016-05-21,2016,CWS,KC,1,2,119,1.5,-140,9.0,100,-120,-134,-1.5,120,4.11,Guaranteed Rate Field,3,-1
2016-05-21,2016,BAL,LAA,3,1,-143,-1.5,115,8.0,-112,-108,128,1.5,-135,4.71,Angel Stadium,4,2
2016-05-21,2016,SD,LAD,3,2,154,1.5,-110,7.5,-107,-113,-174,-1.5,-110,2.95,PETCO Park,5,1
2016-05-21,2016,WSH,MIA,2,3,127,1.5,-175,7.0,-105,-115,-142,-1.5,155,3.08,Marlins Park,5,-1
2016-05-21,2016,NYM,MIL,5,4,-205,-1.5,110,7.0,-125,105,175,1.5,-130,4.7,Citi Field,9,1
2016-05-21,2016,TOR,MIN,3,5,-175,-1.5,-115,10.0,-105,-115,155,1.5,-105,6.36,Target Field,8,-2
2016-05-21,2016,MIL,NYM,4,5,175,1.5,-130,7.0,-125,105,-205,-1.5,110,2.55,Citi Field,9,-1
2016-05-21,2016,OAK,NYY,1,5,133,1.5,-135,7.0,-115,-105,-148,-1.5,115,3.0,Oakland Coliseum,6,-4
2016-05-21,2016,NYY,OAK,5,1,-148,-1.5,115,7.0,-115,-105,133,1.5,-135,4.18,Oakland Coliseum,6,4
2016-05-21,2016,ATL,PHI,2,0,129,1.5,-175,8.0,-105,-115,-144,-1.5,155,3.49,Citizens Bank Park,2,2
2016-05-21,2016,COL,PIT,5,1,111,1.5,-200,7.5,-110,-110,-121,-1.5,170,3.55,PNC Park,6,4
2016-05-21,2016,LAD,SD,2,3,-174,-1.5,-110,7.5,-107,-113,154,1.5,-110,4.76,PETCO Park,5,-1
2016-05-21,2016,CIN,SEA,0,4,145,1.5,-125,8.5,-115,-105,-160,-1.5,105,3.47,Great American Ballpark,4,-4
2016-05-21,2016,CHC,SF,3,5,-160,-1.5,-110,7.5,-115,-105,145,1.5,-110,4.62,AT&T Park,8,-2
2016-05-21,2016,ARI,STL,2,6,145,1.5,-162,7.5,-123,103,-160,-1.5,141,3.06,Busch Stadium,8,-4
2016-05-21,2016,DET,TB,5,4,111,1.5,-155,9.0,-105,-115,-121,-1.5,135,4.27,Comerica Park,9,1
2016-05-21,2016,HOU,TEX,1,2,-183,-1.5,110,8.5,-120,100,163,1.5,-130,5.5,Minute Maid Park,3,-1
2016-05-21,2016,MIN,TOR,5,3,155,1.5,-105,10.0,-105,-115,-175,-1.5,-115,3.92,Target Field,8,2
2016-05-21,2016,MIA,WSH,3,2,-142,-1.5,155,7.0,-105,-115,127,1.5,-175,4.11,Marlins Park,5,1
2016-05-22,2016,STL,ARI,2,7,-128,-1.5,180,7.0,-115,-105,118,1.5,-210,3.93,Busch Stadium,9,-5
2016-05-22,2016,PHI,ATL,5,0,-151,-1.5,145,7.5,112,-132,136,1.5,-165,4.51,Citizens Bank Park,5,5
2016-05-22,2016,LAA,BAL,10,2,101,1.5,-155,8.5,-105,-115,-111,-1.5,135,4.23,Angel Stadium,12,8
2016-05-22,2016,CLE,BOS,2,5,105,1.5,-200,8.5,100,-120,-115,-1.5,170,4.15,Fenway Park,7,-3
2016-05-22,2016,SF,CHC,1,0,-148,-1.5,165,7.0,100,-120,133,1.5,-185,4.18,AT&T Park,1,1
2016-05-22,2016,SEA,CIN,5,4,-152,-1.5,-101,9.0,-120,100,137,1.5,-119,5.43,Great American Ballpark,9,1
2016-05-22,2016,BOS,CLE,5,2,-115,-1.5,170,8.5,100,-120,105,1.5,-200,4.55,Fenway Park,7,3
2016-05-22,2016,KC,CWS,2,3,116,1.5,-200,7.5,-115,-105,-126,-1.5,170,3.47,Guaranteed Rate Field,5,-1
2016-05-22,2016,TB,DET,4,9,103,1.5,-215,8.5,-115,-105,-113,-1.5,185,4.19,Comerica Park,13,-5
2016-05-22,2016,TEX,HOU,9,2,140,1.5,-170,7.5,105,-125,-155,-1.5,150,3.13,Minute Maid Park,11,7
2016-05-22,2016,CWS,KC,3,2,-126,-1.5,170,7.5,-115,-105,116,1.5,-200,4.18,Guaranteed Rate Field,5,1
2016-05-22,2016,BAL,LAA,2,10,-111,-1.5,135,8.5,-105,-115,101,1.5,-155,4.47,Angel Stadium,12,-8
2016-05-22,2016,SD,LAD,5,9,151,1.5,-110,7.5,-111,-109,-171,-1.5,-110,2.99,PETCO Park,14,-4
2016-05-22,2016,WSH,MIA,8,2,-178,-1.5,-110,7.0,-119,-101,158,1.5,-110,4.48,Marlins Park,10,6
2016-05-22,2016,NYM,MIL,3,1,-235,-1.5,-114,7.0,-105,-115,205,1.5,-106,4.91,Citi Field,4,2
2016-05-22,2016,TOR,MIN,3,1,-175,-1.5,-101,9.0,100,-120,155,1.5,-119,5.73,Target Field,4,2
2016-05-22,2016,MIL,NYM,1,3,205,1.5,-106,7.0,-105,-115,-235,-1.5,-114,2.3,Citi Field,4,-2
2016-05-22,2016,OAK,NYY,4,5,130,1.5,-135,7.5,-115,-105,-145,-1.5,115,3.26,Oakland Coliseum,9,-1
2016-05-22,2016,NYY,OAK,5,4,-145,-1.5,115,7.5,-115,-105,130,1.5,-135,4.44,Oakland Coliseum,9,1
2016-05-22,2016,ATL,PHI,0,5,136,1.5,-165,7.5,112,-132,-151,-1.5,145,3.18,Citizens Bank Park,5,-5
2016-05-22,2016,LAD,SD,9,5,-171,-1.5,-110,7.5,-111,-109,151,1.5,-110,4.73,PETCO Park,14,4
2016-05-22,2016,CIN,SEA,4,5,137,1.5,-119,9.0,-120,100,-152,-1.5,-101,3.8,Great American Ballpark,9,-1
2016-05-22,2016,CHC,SF,0,1,133,1.5,-185,7.0,100,-120,-148,-1.5,165,3.0,AT&T Park,1,-1
2016-05-22,2016,ARI,STL,7,2,118,1.5,-210,7.0,-115,-105,-128,-1.5,180,3.21,Busch Stadium,9,5
2016-05-22,2016,DET,TB,9,4,-113,-1.5,185,8.5,-115,-105,103,1.5,-215,4.51,Comerica Park,13,5
2016-05-22,2016,HOU,TEX,2,9,-155,-1.5,150,7.5,105,-125,140,1.5,-170,4.56,Minute Maid Park,11,-7
2016-05-22,2016,MIN,TOR,1,3,155,1.5,-119,9.0,100,-120,-175,-1.5,-101,3.53,Target Field,4,-2
2016-05-22,2016,MIA,WSH,2,8,158,1.5,-110,7.0,-119,-101,-178,-1.5,-110,2.71,Marlins Park,10,-6
2016-05-23,2016,STL,CHC,4,3,-106,1.5,-170,8.0,-105,-115,-104,-1.5,150,4.12,Busch Stadium,7,1
2016-05-23,2016,LAD,CIN,1,0,-405,-1.5,-150,6.0,-105,-115,325,1.5,130,4.81,Dodger Stadium,1,1
2016-05-23,2016,CWS,CLE,7,6,-109,-1.5,175,9.0,-125,105,-101,1.5,-205,4.69,Guaranteed Rate Field,13,1
2016-05-23,2016,CWS,CLE,1,5,-113,-1.5,175,9.5,100,-120,103,1.5,-205,5.04,Guaranteed Rate Field,6,-4
2016-05-23,2016,PIT,COL,6,3,-132,-1.5,150,8.5,100,-120,117,1.5,-170,4.84,PNC Park,9,3
2016-05-23,2016,CLE,CWS,6,7,-101,1.5,-205,9.0,-125,105,-109,-1.5,175,4.52,Guaranteed Rate Field,13,-1
2016-05-23,2016,CLE,CWS,5,1,103,1.5,-205,9.5,100,-120,-113,-1.5,175,4.68,Guaranteed Rate Field,6,4
2016-05-23,2016,PHI,DET,4,5,110,1.5,-200,8.5,100,-120,-120,-1.5,170,4.05,Comerica Park,9,-1
2016-05-23,2016,MIN,KC,4,10,116,1.5,-150,8.0,-105,-115,-126,-1.5,130,3.7,Target Field,14,-6
2016-05-23,2016,TEX,LAA,0,2,-105,1.5,-170,9.5,-110,-110,-105,-1.5,150,4.87,Rangers Ballpark,2,-2
2016-05-23,2016,CIN,LAD,0,1,325,1.5,130,6.0,-105,-115,-405,-1.5,-150,1.41,Dodger Stadium,1,-1
2016-05-23,2016,TB,MIA,6,7,107,1.5,-210,7.5,-115,-105,-117,-1.5,180,3.62,Marlins Park,13,-1
2016-05-23,2016,KC,MIN,10,4,-126,-1.5,130,8.0,-105,-115,116,1.5,-150,4.46,Target Field,14,6
2016-05-23,2016,WSH,NYM,1,7,-159,-1.5,130,7.5,-120,100,144,1.5,-150,4.6,Nationals Park,8,-6
2016-05-23,2016,SEA,OAK,0,5,-125,-1.5,185,7.0,-110,-110,115,1.5,-215,3.89,T-Mobile Park,5,-5
2016-05-23,2016,DET,PHI,5,4,-120,-1.5,170,8.5,100,-120,110,1.5,-200,4.64,Comerica Park,9,1
2016-05-23,2016,COL,PIT,3,6,117,1.5,-170,8.5,100,-120,-132,-1.5,150,3.92,PNC Park,9,-3
2016-05-23,2016,SF,SD,1,0,-176,-1.5,145,6.5,-105,-115,156,1.5,-165,4.14,AT&T Park,1,1
2016-05-23,2016,OAK,SEA,5,0,115,1.5,-215,7.0,-110,-110,-125,-1.5,185,3.26,T-Mobile Park,5,5
2016-05-23,2016,SD,SF,0,1,156,1.5,-165,6.5,-105,-115,-176,-1.5,145,2.54,AT&T Park,1,-1
2016-05-23,2016,CHC,STL,3,4,-104,-1.5,150,8.0,-105,-115,-106,1.5,-170,4.08,Busch Stadium,7,-1
2016-05-23,2016,MIA,TB,7,6,-117,-1.5,180,7.5,-115,-105,107,1.5,-210,4.04,Marlins Park,13,1
2016-05-23,2016,LAA,TEX,2,0,-105,-1.5,150,9.5,-110,-110,-105,1.5,-170,4.87,Rangers Ballpark,2,2
2016-05-23,2016,NYM,WSH,7,1,144,1.5,-150,7.5,-120,100,-159,-1.5,130,3.07,Nationals Park,8,6
2016-05-24,2016,PIT,ARI,12,1,-170,-1.5,125,8.5,-110,-110,150,1.5,-145,5.35,PNC Park,13,11
2016-05-24,2016,MIL,ATL,2,1,106,1.5,-211,7.5,-115,-105,-116,-1.5,181,3.64,Turner Field,3,1
2016-05-24,2016,HOU,BAL,3,2,107,1.5,-155,8.5,-120,100,-117,-1.5,135,4.11,Minute Maid Park,5,1
2016-05-24,2016,COL,BOS,3,8,250,1.5,115,8.5,-110,-110,-290,-1.5,-135,2.43,Fenway Park,11,-5
2016-05-24,2016,STL,CHC,3,12,106,1.5,-160,8.0,100,-120,-116,-1.5,140,3.88,Busch Stadium,15,-9
2016-05-24,2016,LAD,CIN,8,2,-170,-1.5,125,7.5,110,-130,150,1.5,-145,4.72,Dodger Stadium,10,6
2016-05-24,2016,CWS,CLE,2,6,-179,-1.5,110,7.5,-120,100,159,1.5,-130,4.81,Guaranteed Rate Field,8,-4
2016-05-24,2016,BOS,COL,8,3,-290,-1.5,-135,8.5,-110,-110,250,1.5,115,6.32,Fenway Park,11,5
2016-05-24,2016,CLE,CWS,6,2,159,1.5,-130,7.5,-120,100,-179,-1.5,110,2.9,Guaranteed Rate Field,8,4
2016-05-24,2016,PHI,DET,1,3,164,1.5,-125,8.5,-110,-110,-184,-1.5,105,3.22,Comerica Park,4,-2
2016-05-24,2016,BAL,HOU,2,3,-117,-1.5,135,8.5,-120,100,107,1.5,-155,4.58,Minute Maid Park,5,-1
2016-05-24,2016,MIN,KC,4,7,-102,1.5,-165,8.0,-120,100,-108,-1.5,145,4.04,Target Field,11,-3
2016-05-24,2016,TEX,LAA,4,1,-111,-1.5,170,9.0,-110,-110,101,1.5,-200,4.73,Rangers Ballpark,5,3
2016-05-24,2016,CIN,LAD,2,8,150,1.5,-145,7.5,110,-130,-170,-1.5,125,3.0,Dodger Stadium,10,-6
2016-05-24,2016,TB,MIA,4,3,-120,-1.5,135,8.0,-125,105,110,1.5,-155,4.36,Marlins Park,7,1
2016-05-24,2016,ATL,MIL,1,2,-116,-1.5,181,7.5,-115,-105,106,1.5,-211,4.03,Turner Field,3,-1
2016-05-24,2016,KC,MIN,7,4,-108,-1.5,145,8.0,-120,100,-102,1.5,-165,4.15,Target Field,11,3
2016-05-24,2016,WSH,NYM,7,4,-172,-1.5,115,7.0,-110,-110,152,1.5,-135,4.43,Nationals Park,11,3
2016-05-24,2016,TOR,NYY,0,6,118,1.5,-175,8.0,-120,100,-133,-1.5,155,3.67,Yankee Stadium,6,-6
2016-05-24,2016,SEA,OAK,6,5,-170,-1.5,130,7.5,-105,-115,150,1.5,-150,4.72,T-Mobile Park,11,1
2016-05-24,2016,DET,PHI,3,1,-184,-1.5,105,8.5,-110,-110,164,1.5,-125,5.51,Comerica Park,4,2
2016-05-24,2016,ARI,PIT,1,12,150,1.5,-145,8.5,-110,-110,-170,-1.5,125,3.4,PNC Park,13,-11
2016-05-24,2016,SF,SD,8,2,-240,-1.5,-110,7.0,-115,-105,200,1.5,-110,4.94,AT&T Park,10,6
2016-05-24,2016,OAK,SEA,5,6,150,1.5,-150,7.5,-105,-115,-170,-1.5,130,3.0,T-Mobile Park,11,-1
2016-05-24,2016,SD,SF,2,8,200,1.5,-110,7.0,-115,-105,-240,-1.5,-110,2.33,AT&T Park,10,-6
2016-05-24,2016,CHC,STL,12,3,-116,-1.5,140,8.0,100,-120,106,1.5,-160,4.3,Busch Stadium,15,9
2016-05-24,2016,MIA,TB,3,4,110,1.5,-155,8.0,-125,105,-120,-1.5,135,3.81,Marlins Park,7,-1
2016-05-24,2016,LAA,TEX,1,4,101,1.5,-200,9.0,-110,-110,-111,-1.5,170,4.48,Rangers Ballpark,5,-3
2016-05-24,2016,NYY,TOR,6,0,-133,-1.5,155,8.0,-120,100,118,1.5,-175,4.57,Yankee Stadium,6,6
2016-05-24,2016,NYM,WSH,4,7,152,1.5,-135,7.0,-110,-110,-172,-1.5,115,2.78,Nationals Park,11,-3
2016-05-25,2016,PIT,ARI,5,4,-118,-1.5,180,8.5,100,-120,108,1.5,-210,4.6,PNC Park,9,1
2016-05-25,2016,MIL,ATL,3,2,-122,-1.5,130,7.5,-120,100,112,1.5,-150,4.12,Turner Field,5,1
2016-05-25,2016,HOU,BAL,4,3,-140,-1.5,150,9.0,-105,-115,125,1.5,-170,5.25,Minute Maid Park,7,1
2016-05-25,2016,COL,BOS,3,10,170,1.5,-121,9.5,-110,-110,-200,-1.5,101,3.52,Fenway Park,13,-7
2016-05-25,2016,STL,CHC,8,9,165,1.5,-105,7.5,-110,-110,-185,-1.5,-115,2.83,Busch Stadium,17,-1
2016-05-25,2016,LAD,CIN,3,1,-195,-1.5,112,7.0,-120,100,175,1.5,-132,4.63,Dodger Stadium,4,2
2016-05-25,2016,CWS,CLE,3,4,-115,-1.5,180,7.5,-105,-115,105,1.5,-210,4.01,Guaranteed Rate Field,7,-1
2016-05-25,2016,BOS,COL,10,3,-200,-1.5,101,9.5,-110,-110,170,1.5,-121,6.33,Fenway Park,13,7
2016-05-25,2016,CLE,CWS,4,3,105,1.5,-210,7.5,-105,-115,-115,-1.5,180,3.66,Guaranteed Rate Field,7,1
2016-05-25,2016,PHI,DET,8,5,104,1.5,-203,8.0,100,-120,-114,-1.5,173,3.92,Comerica Park,13,3
2016-05-25,2016,BAL,HOU,3,4,125,1.5,-170,9.0,-105,-115,-140,-1.5,150,4.0,Minute Maid Park,7,-1
2016-05-25,2016,MIN,KC,7,5,-134,-1.5,160,8.0,-105,-115,119,1.5,-180,4.58,Target Field,12,2
2016-05-25,2016,TEX,LAA,15,9,-108,-1.5,175,9.5,-106,-114,-102,1.5,-205,4.93,Rangers Ballpark,24,6
2016-05-25,2016,CIN,LAD,1,3,175,1.5,-132,7.0,-120,100,-195,-1.5,112,2.55,Dodger Stadium,4,-2
2016-05-25,2016,TB,MIA,3,4,-235,-1.5,-119,8.5,-120,100,205,1.5,-101,5.96,Tropicana Field,7,-1
2016-05-25,2016,ATL,MIL,2,3,112,1.5,-150,7.5,-120,100,-122,-1.5,130,3.54,Turner Field,5,-1
2016-05-25,2016,KC,MIN,5,7,119,1.5,-180,8.0,-105,-115,-134,-1.5,160,3.65,Target Field,12,-2
2016-05-25,2016,WSH,NYM,0,2,-105,1.5,-180,8.0,100,-120,-105,-1.5,160,4.1,Nationals Park,2,-2
2016-05-25,2016,TOR,NYY,8,4,-111,-1.5,150,9.0,-109,-111,101,1.5,-170,4.73,Yankee Stadium,12,4
2016-05-25,2016,SEA,OAK,13,3,-185,-1.5,101,8.0,100,-120,165,1.5,-120,5.19,T-Mobile Park,16,10
2016-05-25,2016,DET,PHI,5,8,-114,-1.5,173,8.0,100,-120,104,1.5,-203,4.26,Comerica Park,13,-3
2016-05-25,2016,ARI,PIT,4,5,108,1.5,-210,8.5,100,-120,-118,-1.5,180,4.09,PNC Park,9,-1
2016-05-25,2016,SF,SD,4,3,-124,-1.5,170,7.5,101,-121,114,1.5,-200,4.15,AT&T Park,7,1
2016-05-25,2016,OAK,SEA,3,13,165,1.5,-120,8.0,100,-120,-185,-1.5,101,3.02,T-Mobile Park,16,-10
2016-05-25,2016,SD,SF,3,4,114,1.5,-200,7.5,101,-121,-124,-1.5,170,3.5,AT&T Park,7,-1
2016-05-25,2016,CHC,STL,9,8,-185,-1.5,-115,7.5,-110,-110,165,1.5,-105,4.87,Busch Stadium,17,1
2016-05-25,2016,MIA,TB,4,3,205,1.5,-101,8.5,-120,100,-235,-1.5,-119,2.79,Tropicana Field,7,1
2016-05-25,2016,LAA,TEX,9,15,-102,1.5,-205,9.5,-106,-114,-108,-1.5,175,4.8,Rangers Ballpark,24,-6
2016-05-25,2016,NYY,TOR,4,8,101,1.5,-170,9.0,-109,-111,-111,-1.5,150,4.48,Yankee Stadium,12,-4
2016-05-25,2016,NYM,WSH,2,0,-105,-1.5,160,8.0,100,-120,-105,1.5,-180,4.1,Nationals Park,2,2
2016-05-26,2016,PIT,ARI,8,3,-185,-1.5,120,7.5,-116,-104,165,1.5,-140,4.87,PNC Park,11,5
2016-05-26,2016,MIL,ATL,6,2,119,1.5,-175,7.5,-120,100,-134,-1.5,155,3.42,Turner Field,8,4
2016-05-26,2016,HOU,BAL,4,2,-119,-1.5,175,8.0,100,-120,109,1.5,-205,4.35,Minute Maid Park,6,2
2016-05-26,2016,COL,BOS,8,2,143,1.5,-145,9.0,-110,-110,-158,-1.5,125,3.7,Fenway Park,10,6
2016-05-26,2016,BOS,COL,2,8,-158,-1.5,125,9.0,-110,-110,143,1.5,-145,5.51,Fenway Park,10,-6
2016-05-26,2016,BAL,HOU,2,4,109,1.5,-205,8.0,100,-120,-119,-1.5,175,3.83,Minute Maid Park,6,-2
2016-05-26,2016,TB,MIA,1,9,-123,-1.5,175,6.5,-105,-115,113,1.5,-205,3.59,Tropicana Field,10,-8
2016-05-26,2016,ATL,MIL,2,6,-134,-1.5,155,7.5,-120,100,119,1.5,-175,4.29,Turner Field,8,-4
2016-05-26,2016,TOR,NYY,3,1,-121,-1.5,130,9.5,-105,-115,111,1.5,-150,5.2,Yankee Stadium,4,2
2016-05-26,2016,ARI,PIT,3,8,165,1.5,-140,7.5,-116,-104,-185,-1.5,120,2.83,PNC Park,11,-5
2016-05-26,2016,WSH,STL,2,1,-148,-1.5,145,8.5,100,-120,133,1.5,-165,5.07,Nationals Park,3,1
2016-05-26,2016,MIA,TB,9,1,113,1.5,-205,6.5,-105,-115,-123,-1.5,175,3.05,Tropicana Field,10,8
2016-05-26,2016,NYY,TOR,1,3,111,1.5,-150,9.5,-105,-115,-121,-1.5,130,4.5,Yankee Stadium,4,-2
2016-05-26,2016,STL,WSH,1,2,133,1.5,-165,8.5,100,-120,-148,-1.5,145,3.65,Nationals Park,3,-1
2016-05-27,2016,SD,ARI,10,3,160,1.5,-125,10.0,-101,-119,-180,-1.5,105,3.85,Chase Field,13,7
2016-05-27,2016,MIA,ATL,2,4,-116,-1.5,140,7.5,100,-120,106,1.5,-160,4.03,Turner Field,6,-2
2016-05-27,2016,CLE,BAL,4,6,-120,-1.5,170,9.0,100,-120,110,1.5,-200,4.91,Progressive Field,10,-2
2016-05-27,2016,TOR,BOS,7,5,-148,-1.5,140,8.5,-105,-115,133,1.5,-160,5.07,Rogers Centre,12,2
2016-05-27,2016,PHI,CHC,2,6,250,1.5,119,9.0,-110,-110,-290,-1.5,-138,2.57,Wrigley Field,8,-4
2016-05-27,2016,MIL,CIN,9,5,-132,-1.5,160,9.0,-105,-115,117,1.5,-180,5.12,Miller Park,14,4
2016-05-27,2016,BAL,CLE,6,4,110,1.5,-200,9.0,100,-120,-120,-1.5,170,4.29,Progressive Field,10,2
2016-05-27,2016,SF,COL,2,5,125,1.5,-160,11.0,100,-120,-140,-1.5,140,4.89,Coors Field,7,-3
2016-05-27,2016,KC,CWS,7,5,-150,-1.5,145,7.5,-120,100,135,1.5,-165,4.5,Kauffman Stadium,12,2
2016-05-27,2016,OAK,DET,1,4,115,1.5,-145,8.5,-115,-105,-130,-1.5,125,3.95,Oakland Coliseum,5,-3
2016-05-27,2016,LAA,HOU,7,2,101,1.5,-165,7.5,-104,-116,-111,-1.5,145,3.73,Angel Stadium,9,5
2016-05-27,2016,CWS,KC,5,7,135,1.5,-165,7.5,-120,100,-150,-1.5,145,3.19,Kauffman Stadium,12,-2
2016-05-27,2016,HOU,LAA,2,7,-111,-1.5,145,7.5,-104,-116,101,1.5,-165,3.95,Angel Stadium,9,-5
2016-05-27,2016,NYM,LAD,6,5,-110,-1.5,187,7.0,-120,100,100,1.5,-226,3.67,Citi Field,11,1
2016-05-27,2016,ATL,MIA,4,2,106,1.5,-160,7.5,100,-120,-116,-1.5,140,3.64,Turner Field,6,2
2016-05-27,2016,CIN,MIL,5,9,117,1.5,-180,9.0,-105,-115,-132,-1.5,160,4.15,Miller Park,14,-4
2016-05-27,2016,SEA,MIN,2,7,-230,-1.5,-110,7.5,-115,-105,200,1.5,-110,5.23,T-Mobile Park,9,-5
2016-05-27,2016,LAD,NYM,5,6,100,1.5,-226,7.0,-120,100,-110,-1.5,187,3.5,Citi Field,11,-1
2016-05-27,2016,TB,NYY,1,4,119,1.5,-160,7.0,-105,-115,-129,-1.5,140,3.2,Tropicana Field,5,-3
2016-05-27,2016,DET,OAK,4,1,-130,-1.5,125,8.5,-115,-105,115,1.5,-145,4.8,Oakland Coliseum,5,3
2016-05-27,2016,CHC,PHI,6,2,-290,-1.5,-138,9.0,-110,-110,250,1.5,119,6.69,Wrigley Field,8,4
2016-05-27,2016,TEX,PIT,1,9,-130,-1.5,155,9.0,-110,-110,115,1.5,-175,5.09,Rangers Ballpark,10,-8
2016-05-27,2016,ARI,SD,3,10,-180,-1.5,105,10.0,-101,-119,160,1.5,-125,6.43,Chase Field,13,-7
2016-05-27,2016,MIN,SEA,7,2,200,1.5,-110,7.5,-115,-105,-230,-1.5,-110,2.5,T-Mobile Park,9,5
2016-05-27,2016,COL,SF,5,2,-140,-1.5,140,11.0,100,-120,125,1.5,-160,6.42,Coors Field,7,3
2016-05-27,2016,WSH,STL,2,6,-164,-1.5,130,7.0,-122,102,149,1.5,-150,4.35,Nationals Park,8,-4
2016-05-27,2016,NYY,TB,4,1,-129,-1.5,140,7.0,-105,-115,119,1.5,-160,3.94,Tropicana Field,5,3
2016-05-27,2016,PIT,TEX,9,1,115,1.5,-175,9.0,-110,-110,-130,-1.5,155,4.19,Rangers Ballpark,10,8
2016-05-27,2016,BOS,TOR,5,7,133,1.5,-160,8.5,-105,-115,-148,-1.5,140,3.65,Rogers Centre,12,-2
2016-05-27,2016,STL,WSH,6,2,149,1.5,-150,7.0,-122,102,-164,-1.5,130,2.81,Nationals Park,8,4
2016-05-28,2016,SD,ARI,7,8,170,1.5,-123,8.5,-125,105,-200,-1.5,103,3.15,Chase Field,15,-1
2016-05-28,2016,MIA,ATL,2,7,-121,-1.5,140,8.0,100,-120,111,1.5,-160,4.38,Turner Field,9,-5
2016-05-28,2016,CLE,BAL,11,4,-155,-1.5,135,8.5,-110,-110,140,1.5,-155,5.17,Progressive Field,15,7
2016-05-28,2016,TOR,BOS,10,9,-140,-1.5,150,9.0,105,-125,125,1.5,-170,5.25,Rogers Centre,19,1
2016-05-28,2016,PHI,CHC,1,4,230,1.5,106,9.5,-121,101,-270,-1.5,-126,2.88,Wrigley Field,5,-3
2016-05-28,2016,MIL,CIN,6,7,-149,-1.5,140,9.5,-105,-115,134,1.5,-160,5.68,Miller Park,13,-1
2016-05-28,2016,BAL,CLE,4,11,140,1.5,-155,8.5,-110,-110,-155,-1.5,135,3.54,Progressive Field,15,-7
2016-05-28,2016,SF,COL,10,5,-186,-1.5,-120,11.0,-105,-115,166,1.5,100,7.15,Coors Field,15,5
2016-05-28,2016,KC,CWS,8,7,-108,-1.5,185,8.0,100,-120,-102,1.5,-215,4.15,Kauffman Stadium,15,1
2016-05-28,2016,OAK,DET,12,3,-119,-1.5,170,9.5,100,-120,109,1.5,-200,5.16,Oakland Coliseum,15,9
2016-05-28,2016,LAA,HOU,2,4,116,1.5,-150,8.0,100,-120,-126,-1.5,130,3.7,Angel Stadium,6,-2
2016-05-28,2016,CWS,KC,7,8,-102,1.5,-215,8.0,100,-120,-108,-1.5,185,4.04,Kauffman Stadium,15,-1
2016-05-28,2016,HOU,LAA,4,2,-126,-1.5,130,8.0,100,-120,116,1.5,-150,4.46,Angel Stadium,6,2
2016-05-28,2016,NYM,LAD,1,9,-140,-1.5,170,6.5,-109,-111,125,1.5,-200,3.79,Citi Field,10,-8
2016-05-28,2016,ATL,MIA,7,2,111,1.5,-160,8.0,100,-120,-121,-1.5,140,3.79,Turner Field,9,5
2016-05-28,2016,CIN,MIL,7,6,134,1.5,-160,9.5,-105,-115,-149,-1.5,140,4.06,Miller Park,13,1
2016-05-28,2016,SEA,MIN,5,6,-156,-1.5,120,8.0,-110,-110,141,1.5,-140,4.88,T-Mobile Park,11,-1
2016-05-28,2016,LAD,NYM,9,1,125,1.5,-200,6.5,-109,-111,-140,-1.5,170,2.89,Citi Field,10,8
2016-05-28,2016,TB,NYY,9,5,-105,-1.5,190,7.5,105,-125,-105,1.5,-230,3.84,Tropicana Field,14,4
2016-05-28,2016,DET,OAK,3,12,109,1.5,-200,9.5,100,-120,-119,-1.5,170,4.55,Oakland Coliseum,15,-9
2016-05-28,2016,CHC,PHI,4,1,-270,-1.5,-126,9.5,-121,101,230,1.5,106,6.93,Wrigley Field,5,3
2016-05-28,2016,TEX,PIT,5,2,-140,-1.5,150,9.0,-111,-109,125,1.5,-170,5.25,Rangers Ballpark,7,3
2016-05-28,2016,ARI,SD,8,7,-200,-1.5,103,8.5,-125,105,170,1.5,-123,5.67,Chase Field,15,1
2016-05-28,2016,MIN,SEA,6,5,141,1.5,-140,8.0,-110,-110,-156,-1.5,120,3.32,T-Mobile Park,11,1
2016-05-28,2016,COL,SF,5,10,166,1.5,100,11.0,-105,-115,-186,-1.5,-120,4.14,Coors Field,15,-5
2016-05-28,2016,WSH,STL,4,9,-105,1.5,-175,8.0,-120,100,-105,-1.5,155,4.1,Nationals Park,13,-5
2016-05-28,2016,NYY,TB,5,9,-105,1.5,-230,7.5,105,-125,-105,-1.5,190,3.84,Tropicana Field,14,-4
2016-05-28,2016,PIT,TEX,2,5,125,1.5,-170,9.0,-111,-109,-140,-1.5,150,4.0,Rangers Ballpark,7,-3
2016-05-28,2016,BOS,TOR,9,10,125,1.5,-170,9.0,105,-125,-140,-1.5,150,4.0,Rogers Centre,19,-1
2016-05-28,2016,STL,WSH,9,4,-105,-1.5,155,8.0,-120,100,-105,1.5,-175,4.1,Nationals Park,13,5
2016-05-29,2016,SD,ARI,3,6,-104,1.5,-215,8.0,-110,-110,-106,-1.5,185,4.08,Chase Field,9,-3
2016-05-29,2016,MIA,ATL,7,3,119,1.5,-185,8.0,-105,-115,-129,-1.5,165,3.65,Turner Field,10,4
2016-05-29,2016,CLE,BAL,4,6,127,1.5,-135,8.5,-120,100,-142,-1.5,115,3.74,Progressive Field,10,-2
2016-05-29,2016,TOR,BOS,3,5,125,1.5,-130,8.5,-120,100,-140,-1.5,110,3.78,Rogers Centre,8,-2
2016-05-29,2016,PHI,CHC,2,7,175,1.5,-110,9.0,-116,-104,-205,-1.5,-110,3.27,Wrigley Field,9,-5
2016-05-29,2016,MIL,CIN,5,4,-141,-1.5,145,9.0,-115,-105,126,1.5,-165,5.27,Miller Park,9,1
2016-05-29,2016,BAL,CLE,6,4,-142,-1.5,115,8.5,-120,100,127,1.5,-135,4.99,Progressive Field,10,2
2016-05-29,2016,SF,COL,8,3,-162,-1.5,-105,10.5,-112,-108,147,1.5,-115,6.49,Coors Field,11,5
2016-05-29,2016,KC,CWS,5,4,135,1.5,-130,7.0,-120,100,-150,-1.5,110,2.98,Kauffman Stadium,9,1
2016-05-29,2016,OAK,DET,4,2,-149,-1.5,130,9.0,105,-125,134,1.5,-150,5.39,Oakland Coliseum,6,2
2016-05-29,2016,LAA,HOU,6,8,-131,-1.5,160,8.0,100,-120,116,1.5,-180,4.54,Angel Stadium,14,-2
2016-05-29,2016,CWS,KC,4,5,-150,-1.5,110,7.0,-120,100,135,1.5,-130,4.2,Kauffman Stadium,9,-1
2016-05-29,2016,HOU,LAA,8,6,116,1.5,-180,8.0,100,-120,-131,-1.5,160,3.7,Angel Stadium,14,2
2016-05-29,2016,NYM,LAD,2,4,220,1.5,115,6.5,100,-120,-260,-1.5,-135,2.03,Citi Field,6,-2
2016-05-29,2016,ATL,MIA,3,7,-129,-1.5,165,8.0,-105,-115,119,1.5,-185,4.51,Turner Field,10,-4
2016-05-29,2016,CIN,MIL,4,5,126,1.5,-165,9.0,-115,-105,-141,-1.5,145,3.98,Miller Park,9,-1
2016-05-29,2016,SEA,MIN,4,5,-195,-1.5,100,7.5,100,-120,175,1.5,-120,4.96,T-Mobile Park,9,-1
2016-05-29,2016,LAD,NYM,4,2,-260,-1.5,-135,6.5,100,-120,220,1.5,115,4.69,Citi Field,6,2
2016-05-29,2016,TB,NYY,1,2,101,1.5,-170,7.0,-105,-115,-111,-1.5,150,3.48,Tropicana Field,3,-1
2016-05-29,2016,DET,OAK,2,4,134,1.5,-150,9.0,105,-125,-149,-1.5,130,3.85,Oakland Coliseum,6,-2
2016-05-29,2016,CHC,PHI,7,2,-205,-1.5,-110,9.0,-116,-104,175,1.5,-110,6.05,Wrigley Field,9,5
2016-05-29,2016,TEX,PIT,6,2,125,1.5,-135,9.0,-110,-110,-140,-1.5,115,4.0,Rangers Ballpark,8,4
2016-05-29,2016,ARI,SD,6,3,-106,-1.5,185,8.0,-110,-110,-104,1.5,-215,4.12,Chase Field,9,3
2016-05-29,2016,MIN,SEA,5,4,175,1.5,-120,7.5,100,-120,-195,-1.5,100,2.73,T-Mobile Park,9,1
2016-05-29,2016,COL,SF,3,8,147,1.5,-115,10.5,-112,-108,-162,-1.5,-105,4.25,Coors Field,11,-5
2016-05-29,2016,WSH,STL,10,2,-230,-1.5,-110,7.5,-115,-105,200,1.5,-110,5.23,Nationals Park,12,8
2016-05-29,2016,NYY,TB,2,1,-111,-1.5,150,7.0,-105,-115,101,1.5,-170,3.68,Tropicana Field,3,1
2016-05-29,2016,PIT,TEX,2,6,-140,-1.5,115,9.0,-110,-110,125,1.5,-135,5.25,Rangers Ballpark,8,-4
2016-05-29,2016,BOS,TOR,5,3,-140,-1.5,110,8.5,-120,100,125,1.5,-130,4.96,Rogers Centre,8,2
2016-05-29,2016,STL,WSH,2,10,200,1.5,-110,7.5,-115,-105,-230,-1.5,-110,2.5,Nationals Park,12,-8
2016-05-30,2016,HOU,ARI,8,3,-150,-1.5,105,9.0,-105,-115,135,1.5,-125,5.4,Chase Field,11,5
2016-05-30,2016,SF,ATL,3,5,-155,-1.5,110,8.0,-105,-115,140,1.5,-130,4.86,Turner Field,8,-2
2016-05-30,2016,BOS,BAL,7,2,-110,-1.5,145,9.0,-115,-105,100,1.5,-165,4.71,Camden Yards,9,5
2016-05-30,2016,BAL,BOS,2,7,100,1.5,-165,9.0,-115,-105,-110,-1.5,145,4.5,Camden Yards,9,-5
2016-05-30,2016,LAD,CHC,0,2,118,1.5,-185,8.5,-120,100,-128,-1.5,165,3.9,Wrigley Field,2,-2
2016-05-30,2016,COL,CIN,8,11,-140,-1.5,140,11.5,100,-120,125,1.5,-160,6.71,Coors Field,19,-3
2016-05-30,2016,TEX,CLE,9,2,149,1.5,-140,9.0,100,-120,-164,-1.5,120,3.61,Progressive Field,11,7
2016-05-30,2016,CIN,COL,11,8,125,1.5,-160,11.5,100,-120,-140,-1.5,140,5.11,Coors Field,19,3
2016-05-30,2016,NYM,CWS,1,0,107,1.5,-165,7.0,100,-120,-117,-1.5,145,3.38,Citi Field,1,1
2016-05-30,2016,LAA,DET,5,1,-102,1.5,-170,7.5,-105,-115,-108,-1.5,150,3.79,Angel Stadium,6,4
2016-05-30,2016,ARI,HOU,3,8,135,1.5,-125,9.0,-105,-115,-150,-1.5,105,3.83,Chase Field,11,-5
2016-05-30,2016,TB,KC,2,6,110,1.5,-205,7.5,-110,-110,-120,-1.5,175,3.57,Kauffman Stadium,8,-4
2016-05-30,2016,DET,LAA,1,5,-108,-1.5,150,7.5,-105,-115,-102,1.5,-170,3.89,Angel Stadium,6,-4
2016-05-30,2016,CHC,LAD,2,0,-128,-1.5,165,8.5,-120,100,118,1.5,-185,4.77,Wrigley Field,2,2
2016-05-30,2016,PIT,MIA,10,0,-155,-1.5,105,9.0,-110,-110,140,1.5,-125,5.47,Marlins Park,10,10
2016-05-30,2016,STL,MIL,6,0,-141,-1.5,115,9.0,-102,-118,126,1.5,-135,5.27,Miller Park,6,6
2016-05-30,2016,OAK,MIN,3,2,-128,-1.5,165,9.0,100,-120,118,1.5,-185,5.05,Oakland Coliseum,5,1
2016-05-30,2016,CWS,NYM,0,1,-117,-1.5,145,7.0,100,-120,107,1.5,-165,3.77,Citi Field,1,-1
2016-05-30,2016,TOR,NYY,4,2,-145,-1.5,145,9.0,-115,-105,130,1.5,-165,5.33,Rogers Centre,6,2
2016-05-30,2016,MIN,OAK,2,3,118,1.5,-185,9.0,100,-120,-128,-1.5,165,4.13,Oakland Coliseum,5,-1
2016-05-30,2016,WSH,PHI,4,3,-155,-1.5,105,8.0,-120,100,140,1.5,-125,4.86,Citizens Bank Park,7,1
2016-05-30,2016,MIA,PIT,0,10,140,1.5,-125,9.0,-110,-110,-155,-1.5,105,3.75,Marlins Park,10,-10
2016-05-30,2016,SEA,SD,9,3,-226,-1.5,-110,8.0,-105,-115,196,1.5,-110,5.55,T-Mobile Park,12,6
2016-05-30,2016,SD,SEA,3,9,196,1.5,-110,8.0,-105,-115,-226,-1.5,-110,2.7,T-Mobile Park,12,-6
2016-05-30,2016,ATL,SF,5,3,140,1.5,-130,8.0,-105,-115,-155,-1.5,110,3.33,Turner Field,8,2
2016-05-30,2016,MIL,STL,0,6,126,1.5,-135,9.0,-102,-118,-141,-1.5,115,3.98,Miller Park,6,-6
2016-05-30,2016,KC,TB,6,2,-120,-1.5,175,7.5,-110,-110,110,1.5,-205,4.09,Kauffman Stadium,8,4
2016-05-30,2016,CLE,TEX,2,9,-164,-1.5,120,9.0,100,-120,149,1.5,-140,5.59,Progressive Field,11,-7
2016-05-30,2016,NYY,TOR,2,4,130,1.5,-165,9.0,-115,-105,-145,-1.5,145,3.91,Rogers Centre,6,-2
2016-05-30,2016,PHI,WSH,3,4,140,1.5,-125,8.0,-120,100,-155,-1.5,105,3.33,Citizens Bank Park,7,-1
2016-05-31,2016,HOU,ARI,8,5,-142,-1.5,110,8.5,-110,-110,127,1.5,-130,4.99,Chase Field,13,3
2016-05-31,2016,SF,ATL,4,0,-127,-1.5,130,9.0,105,-125,117,1.5,-150,5.04,Turner Field,4,4
2016-05-31,2016,BOS,BAL,6,2,109,1.5,-185,8.5,-120,100,-119,-1.5,165,4.07,Camden Yards,8,4
2016-05-31,2016,BAL,BOS,2,6,-119,-1.5,165,8.5,-120,100,109,1.5,-185,4.62,Camden Yards,8,-4
2016-05-31,2016,LAD,CHC,5,0,185,1.5,-111,7.5,-110,-110,-215,-1.5,-109,2.63,Wrigley Field,5,5
2016-05-31,2016,COL,CIN,17,4,-230,-1.5,-120,10.5,-125,105,200,1.5,100,7.32,Coors Field,21,13
2016-05-31,2016,TEX,CLE,7,3,175,1.5,-120,8.0,-111,-109,-205,-1.5,100,2.91,Progressive Field,10,4
2016-05-31,2016,CIN,COL,4,17,200,1.5,100,10.5,-125,105,-230,-1.5,-120,3.5,Coors Field,21,-13
2016-05-31,2016,NYM,CWS,4,6,-179,-1.5,115,7.5,-120,100,159,1.5,-135,4.81,Citi Field,10,-2
2016-05-31,2016,LAA,DET,11,9,-105,-1.5,175,8.5,-120,100,-105,1.5,-205,4.35,Angel Stadium,20,2
2016-05-31,2016,ARI,HOU,5,8,127,1.5,-130,8.5,-110,-110,-142,-1.5,110,3.74,Chase Field,13,-3
2016-05-31,2016,TB,KC,5,10,-125,-1.5,125,7.5,-105,-115,115,1.5,-145,4.17,Kauffman Stadium,15,-5
2016-05-31,2016,DET,LAA,9,11,-105,1.5,-205,8.5,-120,100,-105,-1.5,175,4.35,Angel Stadium,20,-2
2016-05-31,2016,CHC,LAD,0,5,-215,-1.5,-109,7.5,-110,-110,185,1.5,-111,5.12,Wrigley Field,5,-5
2016-05-31,2016,PIT,MIA,1,3,112,1.5,-200,6.5,-111,-109,-122,-1.5,170,3.07,Marlins Park,4,-2
2016-05-31,2016,STL,MIL,10,3,-146,-1.5,105,9.0,-115,-105,131,1.5,-125,5.34,Miller Park,13,7
2016-05-31,2016,OAK,MIN,7,4,-102,1.5,-165,8.5,-120,100,-108,-1.5,145,4.29,Oakland Coliseum,11,3
2016-05-31,2016,CWS,NYM,6,4,159,1.5,-135,7.5,-120,100,-179,-1.5,115,2.9,Citi Field,10,2
2016-05-31,2016,TOR,NYY,4,1,-173,-1.5,115,8.5,-125,105,153,1.5,-135,5.39,Rogers Centre,5,3
2016-05-31,2016,MIN,OAK,4,7,-108,-1.5,145,8.5,-120,100,-102,1.5,-165,4.41,Oakland Coliseum,11,-3
2016-05-31,2016,WSH,PHI,5,1,100,1.5,-215,7.0,-115,-105,-110,-1.5,185,3.5,Citizens Bank Park,6,4
2016-05-31,2016,MIA,PIT,3,1,-122,-1.5,170,6.5,-111,-109,112,1.5,-200,3.57,Marlins Park,4,2
2016-05-31,2016,SEA,SD,16,4,-195,-1.5,105,7.5,-110,-110,175,1.5,-125,4.96,T-Mobile Park,20,12
2016-05-31,2016,SD,SEA,4,16,175,1.5,-125,7.5,-110,-110,-195,-1.5,105,2.73,T-Mobile Park,20,-12
2016-05-31,2016,ATL,SF,0,4,117,1.5,-150,9.0,105,-125,-127,-1.5,130,4.15,Turner Field,4,-4
2016-05-31,2016,MIL,STL,3,10,131,1.5,-125,9.0,-115,-105,-146,-1.5,105,3.9,Miller Park,13,-7
2016-05-31,2016,KC,TB,10,5,115,1.5,-145,7.5,-105,-115,-125,-1.5,125,3.49,Kauffman Stadium,15,5
2016-05-31,2016,CLE,TEX,3,7,-205,-1.5,100,8.0,-111,-109,175,1.5,-120,5.38,Progressive Field,10,-4
2016-05-31,2016,NYY,TOR,1,4,153,1.5,-135,8.5,-125,105,-173,-1.5,115,3.36,Rogers Centre,5,-3
2016-05-31,2016,PHI,WSH,1,5,-110,-1.5,185,7.0,-115,-105,100,1.5,-215,3.67,Citizens Bank Park,6,-4
2016-06-01,2016,HOU,ARI,5,4,-201,-1.5,-102,8.5,-110,-110,171,1.5,-118,5.68,Minute Maid Park,9,1
2016-06-01,2016,SF,ATL,4,5,-134,-1.5,122,8.5,-113,-107,119,1.5,-142,4.87,Turner Field,9,-1
2016-06-01,2016,BOS,BAL,9,13,100,1.5,-205,9.0,-120,100,-110,-1.5,175,4.5,Camden Yards,22,-4
2016-06-01,2016,BAL,BOS,13,9,-110,-1.5,175,9.0,-120,100,100,1.5,-205,4.71,Camden Yards,22,4
2016-06-01,2016,LAD,CHC,1,2,178,1.5,-105,8.5,-110,-110,-208,-1.5,-115,3.06,Wrigley Field,3,-1
2016-06-01,2016,COL,CIN,2,7,-200,-1.5,-121,11.5,-115,-105,170,1.5,101,7.67,Coors Field,9,-5
2016-06-01,2016,TEX,CLE,4,5,-113,-1.5,145,8.0,-115,-105,103,1.5,-165,4.24,Progressive Field,9,-1
2016-06-01,2016,CIN,COL,7,2,170,1.5,101,11.5,-115,-105,-200,-1.5,-121,4.26,Coors Field,9,5
2016-06-01,2016,NYM,CWS,1,2,-170,-1.5,125,7.5,-105,-115,150,1.5,-145,4.72,Citi Field,3,-1
2016-06-01,2016,LAA,DET,0,3,-115,-1.5,175,8.0,-115,-105,105,1.5,-205,4.28,Angel Stadium,3,-3
2016-06-01,2016,ARI,HOU,4,5,171,1.5,-118,8.5,-110,-110,-201,-1.5,-102,3.14,Minute Maid Park,9,-1
2016-06-01,2016,TB,KC,3,6,109,1.5,-200,7.0,-125,105,-119,-1.5,170,3.35,Kauffman Stadium,9,-3
2016-06-01,2016,DET,LAA,3,0,105,1.5,-205,8.0,-115,-105,-115,-1.5,175,3.9,Angel Stadium,3,3
2016-06-01,2016,CHC,LAD,2,1,-208,-1.5,-115,8.5,-110,-110,178,1.5,-105,5.74,Wrigley Field,3,1
2016-06-01,2016,PIT,MIA,2,3,103,1.5,-205,9.0,100,-120,-113,-1.5,175,4.43,Marlins Park,5,-1
2016-06-01,2016,STL,MIL,1,3,-175,-1.5,-110,9.0,-103,-117,155,1.5,-110,5.73,Miller Park,4,-2
2016-06-01,2016,OAK,MIN,5,1,-170,-1.5,120,8.5,-115,-105,150,1.5,-140,5.35,Oakland Coliseum,6,4
2016-06-01,2016,CWS,NYM,2,1,150,1.5,-145,7.5,-105,-115,-170,-1.5,125,3.0,Citi Field,3,1
2016-06-01,2016,TOR,NYY,7,0,-101,1.5,-170,8.0,105,-125,-109,-1.5,150,4.02,Rogers Centre,7,7
2016-06-01,2016,MIN,OAK,1,5,150,1.5,-140,8.5,-115,-105,-170,-1.5,120,3.4,Oakland Coliseum,6,-4
2016-06-01,2016,WSH,PHI,7,2,-235,-1.5,-140,7.5,-110,-110,205,1.5,120,5.26,Citizens Bank Park,9,5
2016-06-01,2016,MIA,PIT,3,2,-113,-1.5,175,9.0,100,-120,103,1.5,-205,4.77,Marlins Park,5,1
2016-06-01,2016,SEA,SD,6,14,-124,-1.5,126,8.0,-101,-119,114,1.5,-145,4.43,PETCO Park,20,-8
2016-06-01,2016,SD,SEA,14,6,114,1.5,-145,8.0,-101,-119,-124,-1.5,126,3.74,PETCO Park,20,8
2016-06-01,2016,ATL,SF,5,4,119,1.5,-142,8.5,-113,-107,-134,-1.5,122,3.88,Turner Field,9,1
2016-06-01,2016,MIL,STL,3,1,155,1.5,-110,9.0,-103,-117,-175,-1.5,-110,3.53,Miller Park,4,2
2016-06-01,2016,KC,TB,6,3,-119,-1.5,170,7.0,-125,105,109,1.5,-200,3.8,Kauffman Stadium,9,3
2016-06-01,2016,CLE,TEX,5,4,103,1.5,-165,8.0,-115,-105,-113,-1.5,145,3.94,Progressive Field,9,1
2016-06-01,2016,NYY,TOR,0,7,-109,-1.5,150,8.0,105,-125,-101,1.5,-170,4.17,Rogers Centre,7,-7
2016-06-01,2016,PHI,WSH,2,7,205,1.5,120,7.5,-110,-110,-235,-1.5,-140,2.46,Citizens Bank Park,9,-5
2016-06-02,2016,HOU,ARI,0,3,-145,-1.5,165,7.0,-120,100,130,1.5,-185,4.14,Minute Maid Park,3,-3
2016-06-02,2016,SF,ATL,6,0,-255,-1.5,-156,7.5,-112,-108,215,1.5,136,5.39,Turner Field,6,6
2016-06-02,2016,BOS,BAL,7,12,-125,-1.5,135,9.0,-120,100,115,1.5,-155,5.0,Camden Yards,19,-5
2016-06-02,2016,BAL,BOS,12,7,115,1.5,-155,9.0,-120,100,-125,-1.5,135,4.19,Camden Yards,19,5
2016-06-02,2016,LAD,CHC,2,7,155,1.5,-135,8.5,-125,105,-175,-1.5,115,3.33,Wrigley Field,9,-5
2016-06-02,2016,COL,CIN,4,11,-160,-1.5,115,12.5,-106,-114,145,1.5,-135,7.69,Coors Field,15,-7
2016-06-02,2016,KC,CLE,4,5,170,1.5,-122,7.5,-115,-105,-200,-1.5,102,2.78,Progressive Field,9,-1
2016-06-02,2016,CIN,COL,11,4,145,1.5,-135,12.5,-106,-114,-160,-1.5,115,5.1,Coors Field,15,7
2016-06-02,2016,NYY,DET,5,4,-120,-1.5,130,9.0,-115,-105,110,1.5,-150,4.91,Comerica Park,9,1
2016-06-02,2016,ARI,HOU,3,0,130,1.5,-185,7.0,-120,100,-145,-1.5,165,3.04,Minute Maid Park,3,3
2016-06-02,2016,CLE,KC,5,4,-200,-1.5,102,7.5,-115,-105,170,1.5,-122,5.0,Progressive Field,9,1
2016-06-02,2016,CHC,LAD,7,2,-175,-1.5,115,8.5,-125,105,155,1.5,-135,5.41,Wrigley Field,9,5
2016-06-02,2016,PIT,MIA,3,4,-124,-1.5,125,8.0,-123,103,114,1.5,-145,4.43,Marlins Park,7,-1
2016-06-02,2016,PHI,MIL,1,4,100,1.5,-170,8.0,-115,-105,-110,-1.5,150,4.0,Citizens Bank Park,5,-3
2016-06-02,2016,TB,MIN,4,6,-111,-1.5,140,9.0,-120,100,101,1.5,-160,4.73,Target Field,10,-2
2016-06-02,2016,DET,NYY,4,5,110,1.5,-150,9.0,-115,-105,-120,-1.5,130,4.29,Comerica Park,9,-1
2016-06-02,2016,MIL,PHI,4,1,-110,-1.5,150,8.0,-115,-105,100,1.5,-170,4.19,Citizens Bank Park,5,3
2016-06-02,2016,MIA,PIT,4,3,114,1.5,-145,8.0,-123,103,-124,-1.5,125,3.74,Marlins Park,7,1
2016-06-02,2016,SEA,SD,16,13,-124,-1.5,135,8.5,-101,-119,114,1.5,-155,4.71,PETCO Park,29,3
2016-06-02,2016,SD,SEA,13,16,114,1.5,-155,8.5,-101,-119,-124,-1.5,135,3.97,PETCO Park,29,-3
2016-06-02,2016,ATL,SF,0,6,215,1.5,136,7.5,-112,-108,-255,-1.5,-156,2.38,Turner Field,6,-6
2016-06-02,2016,MIN,TB,6,4,101,1.5,-160,9.0,-120,100,-111,-1.5,140,4.48,Target Field,10,2
2016-06-03,2016,CHC,ARI,6,0,-260,-1.5,-127,8.5,-127,107,220,1.5,107,6.14,Wrigley Field,6,6
2016-06-03,2016,LAD,ATL,4,2,-193,-1.5,112,7.0,-110,-110,173,1.5,-133,4.61,Dodger Stadium,6,2
2016-06-03,2016,NYY,BAL,5,6,117,1.5,-180,8.0,-110,-110,-132,-1.5,160,3.69,Camden Yards,11,-1
2016-06-03,2016,TOR,BOS,5,2,152,1.5,-130,9.5,-112,-108,-172,-1.5,110,3.77,Fenway Park,7,3
2016-06-03,2016,ARI,CHC,0,6,220,1.5,107,8.5,-127,107,-260,-1.5,-127,2.66,Wrigley Field,6,-6
2016-06-03,2016,WSH,CIN,2,7,-155,-1.5,-105,9.0,-120,100,140,1.5,-115,5.47,Great American Ballpark,9,-5
2016-06-03,2016,KC,CLE,1,6,156,1.5,-135,7.5,-105,-115,-176,-1.5,115,2.93,Progressive Field,7,-5
2016-06-03,2016,SD,COL,4,0,-149,-1.5,145,7.5,-120,100,134,1.5,-165,4.49,PETCO Park,4,4
2016-06-03,2016,DET,CWS,10,3,-152,-1.5,135,9.0,-120,100,137,1.5,-155,5.43,Comerica Park,13,7
2016-06-03,2016,CWS,DET,3,10,137,1.5,-155,9.0,-120,100,-152,-1.5,135,3.8,Comerica Park,13,-7
2016-06-03,2016,OAK,HOU,2,12,127,1.5,-170,8.5,-125,105,-142,-1.5,150,3.74,Minute Maid Park,14,-10
2016-06-03,2016,CLE,KC,6,1,-176,-1.5,115,7.5,-105,-115,156,1.5,-135,4.78,Progressive Field,7,5
2016-06-03,2016,PIT,LAA,2,9,-156,-1.5,135,8.5,-125,105,141,1.5,-155,5.18,PNC Park,11,-7
2016-06-03,2016,ATL,LAD,2,4,173,1.5,-133,7.0,-110,-110,-193,-1.5,112,2.56,Dodger Stadium,6,-2
2016-06-03,2016,NYM,MIA,6,2,-173,-1.5,100,7.0,-125,105,153,1.5,-120,4.44,Marlins Park,8,4
2016-06-03,2016,PHI,MIL,6,3,-126,-1.5,170,8.0,-120,100,116,1.5,-200,4.46,Citizens Bank Park,9,3
2016-06-03,2016,TB,MIN,4,2,-116,-1.5,135,8.5,-120,100,106,1.5,-155,4.56,Target Field,6,2
2016-06-03,2016,MIA,NYM,2,6,153,1.5,-120,7.0,-125,105,-173,-1.5,100,2.77,Marlins Park,8,-4
2016-06-03,2016,BAL,NYY,6,5,-132,-1.5,160,8.0,-110,-110,117,1.5,-180,4.55,Camden Yards,11,1
2016-06-03,2016,HOU,OAK,12,2,-142,-1.5,150,8.5,-125,105,127,1.5,-170,4.99,Minute Maid Park,14,10
2016-06-03,2016,MIL,PHI,3,6,116,1.5,-200,8.0,-120,100,-126,-1.5,170,3.7,Citizens Bank Park,9,-3
2016-06-03,2016,LAA,PIT,9,2,141,1.5,-155,8.5,-125,105,-156,-1.5,135,3.53,PNC Park,11,7
2016-06-03,2016,COL,SD,0,4,134,1.5,-165,7.5,-120,100,-149,-1.5,145,3.21,PETCO Park,4,-4
2016-06-03,2016,TEX,SEA,7,3,-147,-1.5,125,8.5,100,-120,132,1.5,-145,5.06,Rangers Ballpark,10,4
2016-06-03,2016,STL,SF,1,5,103,1.5,-175,7.5,-110,-110,-113,-1.5,155,3.69,Busch Stadium,6,-4
2016-06-03,2016,SF,STL,5,1,-113,-1.5,155,7.5,-110,-110,103,1.5,-175,3.98,Busch Stadium,6,4
2016-06-03,2016,MIN,TB,2,4,106,1.5,-155,8.5,-120,100,-116,-1.5,135,4.13,Target Field,6,-2
2016-06-03,2016,SEA,TEX,3,7,132,1.5,-145,8.5,100,-120,-147,-1.5,125,3.66,Rangers Ballpark,10,-4
2016-06-03,2016,BOS,TOR,2,5,-172,-1.5,110,9.5,-112,-108,152,1.5,-130,6.01,Fenway Park,7,-3
2016-06-03,2016,CIN,WSH,7,2,140,1.5,-115,9.0,-120,100,-155,-1.5,-105,3.75,Great American Ballpark,9,5
2016-06-04,2016,CHC,ARI,5,3,-305,-1.5,-152,10.0,-110,-110,255,1.5,132,7.53,Wrigley Field,8,2
2016-06-04,2016,LAD,ATL,4,0,-497,-1.5,-175,6.0,-101,-119,397,1.5,155,4.99,Dodger Stadium,4,4
2016-06-04,2016,NYY,BAL,8,6,125,1.5,-170,9.5,100,-120,-140,-1.5,150,4.22,Camden Yards,14,2
2016-06-04,2016,TOR,BOS,4,6,127,1.5,-160,9.5,100,-120,-142,-1.5,140,4.19,Fenway Park,10,-2
2016-06-04,2016,ARI,CHC,3,5,255,1.5,132,10.0,-110,-110,-305,-1.5,-152,2.82,Wrigley Field,8,-2
2016-06-04,2016,WSH,CIN,3,6,-202,-1.5,-126,8.0,-113,-107,172,1.5,106,5.35,Great American Ballpark,9,-3
2016-06-04,2016,KC,CLE,1,7,107,1.5,-200,8.0,-115,-105,-117,-1.5,171,3.86,Progressive Field,8,-6
2016-06-04,2016,SD,COL,4,3,109,1.5,-152,8.0,-120,100,-119,-1.5,132,3.83,PETCO Park,7,1
2016-06-04,2016,DET,CWS,7,4,119,1.5,-135,8.5,-120,100,-134,-1.5,115,3.88,Comerica Park,11,3
2016-06-04,2016,CWS,DET,4,7,-134,-1.5,115,8.5,-120,100,119,1.5,-135,4.87,Comerica Park,11,-3
2016-06-04,2016,OAK,HOU,5,6,156,1.5,-135,8.5,-119,-101,-176,-1.5,115,3.32,Minute Maid Park,11,-1
2016-06-04,2016,CLE,KC,7,1,-117,-1.5,171,8.0,-115,-105,107,1.5,-200,4.31,Progressive Field,8,6
2016-06-04,2016,PIT,LAA,8,7,-102,1.5,-170,8.5,100,-120,-108,-1.5,150,4.29,PNC Park,15,1
2016-06-04,2016,ATL,LAD,0,4,397,1.5,155,6.0,-101,-119,-497,-1.5,-175,1.21,Dodger Stadium,4,-4
2016-06-04,2016,NYM,MIA,6,4,-111,-1.5,150,9.0,105,-125,101,1.5,-170,4.73,Marlins Park,10,2
2016-06-04,2016,PHI,MIL,3,6,110,1.5,-160,8.0,-115,-105,-120,-1.5,140,3.81,Citizens Bank Park,9,-3
2016-06-04,2016,TB,MIN,7,4,-105,-1.5,150,8.5,100,-120,-105,1.5,-170,4.35,Target Field,11,3
2016-06-04,2016,MIA,NYM,4,6,101,1.5,-170,9.0,105,-125,-111,-1.5,150,4.48,Marlins Park,10,-2
2016-06-04,2016,BAL,NYY,6,8,-140,-1.5,150,9.5,100,-120,125,1.5,-170,5.54,Camden Yards,14,-2
2016-06-04,2016,HOU,OAK,6,5,-176,-1.5,115,8.5,-119,-101,156,1.5,-135,5.42,Minute Maid Park,11,1
2016-06-04,2016,MIL,PHI,6,3,-120,-1.5,140,8.0,-115,-105,110,1.5,-160,4.36,Citizens Bank Park,9,3
2016-06-04,2016,LAA,PIT,7,8,-108,-1.5,150,8.5,100,-120,-102,1.5,-170,4.41,PNC Park,15,-1
2016-06-04,2016,COL,SD,3,4,-119,-1.5,132,8.0,-120,100,109,1.5,-152,4.35,PETCO Park,7,-1
2016-06-04,2016,TEX,SEA,10,4,107,1.5,-170,9.0,110,-130,-117,-1.5,150,4.35,Rangers Ballpark,14,6
2016-06-04,2016,STL,SF,7,4,106,1.5,-160,8.0,-110,-110,-116,-1.5,140,3.88,Busch Stadium,11,3
2016-06-04,2016,SF,STL,4,7,-116,-1.5,140,8.0,-110,-110,106,1.5,-160,4.3,Busch Stadium,11,-3
2016-06-04,2016,MIN,TB,4,7,-105,1.5,-170,8.5,100,-120,-105,-1.5,150,4.35,Target Field,11,-3
2016-06-04,2016,SEA,TEX,4,10,-117,-1.5,150,9.0,110,-130,107,1.5,-170,4.85,Rangers Ballpark,14,-6
2016-06-04,2016,BOS,TOR,6,4,-142,-1.5,140,9.5,100,-120,127,1.5,-160,5.57,Fenway Park,10,2
2016-06-04,2016,CIN,WSH,6,3,172,1.5,106,8.0,-113,-107,-202,-1.5,-126,2.94,Great American Ballpark,9,3
2016-06-05,2016,CHC,ARI,2,3,-320,-1.5,-146,8.0,100,-120,270,1.5,126,6.1,Wrigley Field,5,-1
2016-06-05,2016,LAD,ATL,12,6,-255,-1.5,-119,7.5,105,-125,215,1.5,-101,5.39,Dodger Stadium,18,6
2016-06-05,2016,NYY,BAL,1,3,119,1.5,-170,9.0,-110,-110,-134,-1.5,150,4.11,Camden Yards,4,-2
2016-06-05,2016,TOR,BOS,5,4,105,1.5,-200,9.5,-115,-105,-115,-1.5,170,4.63,Fenway Park,9,1
2016-06-05,2016,ARI,CHC,3,2,270,1.5,126,8.0,100,-120,-320,-1.5,-146,2.16,Wrigley Field,5,1
2016-06-05,2016,WSH,CIN,10,9,-200,-1.5,-134,9.5,-110,-110,170,1.5,114,6.33,Great American Ballpark,19,1
2016-06-05,2016,KC,CLE,0,7,170,1.5,-125,8.0,-113,-107,-200,-1.5,105,2.96,Progressive Field,7,-7
2016-06-05,2016,SD,COL,3,10,133,1.5,-120,8.0,-110,-110,-148,-1.5,100,3.43,PETCO Park,13,-7
2016-06-05,2016,DET,CWS,5,2,-127,-1.5,165,8.0,-105,-115,117,1.5,-185,4.48,Comerica Park,7,3
2016-06-05,2016,CWS,DET,2,5,117,1.5,-185,8.0,-105,-115,-127,-1.5,165,3.69,Comerica Park,7,-3
2016-06-05,2016,OAK,HOU,2,5,152,1.5,-140,8.5,-114,-106,-172,-1.5,120,3.37,Minute Maid Park,7,-3
2016-06-05,2016,CLE,KC,7,0,-200,-1.5,105,8.0,-113,-107,170,1.5,-125,5.33,Progressive Field,7,7
2016-06-05,2016,PIT,LAA,4,5,-150,-1.5,150,7.5,-120,100,135,1.5,-170,4.5,PNC Park,9,-1
2016-06-05,2016,ATL,LAD,6,12,215,1.5,-101,7.5,105,-125,-255,-1.5,-119,2.38,Dodger Stadium,18,-6
2016-06-05,2016,NYM,MIA,0,1,150,1.5,-145,7.0,110,-130,-170,-1.5,125,2.8,Marlins Park,1,-1
2016-06-05,2016,PHI,MIL,8,1,-162,-1.5,125,8.0,-110,-110,147,1.5,-145,4.95,Citizens Bank Park,9,7
2016-06-05,2016,TB,MIN,7,5,-119,-1.5,135,8.5,-110,-110,109,1.5,-155,4.62,Target Field,12,2
2016-06-05,2016,MIA,NYM,1,0,-170,-1.5,125,7.0,110,-130,150,1.5,-145,4.41,Marlins Park,1,1
2016-06-05,2016,BAL,NYY,3,1,-134,-1.5,150,9.0,-110,-110,119,1.5,-170,5.15,Camden Yards,4,2
2016-06-05,2016,HOU,OAK,5,2,-172,-1.5,120,8.5,-114,-106,152,1.5,-140,5.38,Minute Maid Park,7,3
2016-06-05,2016,MIL,PHI,1,8,147,1.5,-145,8.0,-110,-110,-162,-1.5,125,3.24,Citizens Bank Park,9,-7
2016-06-05,2016,LAA,PIT,5,4,135,1.5,-170,7.5,-120,100,-150,-1.5,150,3.19,PNC Park,9,1
2016-06-05,2016,COL,SD,10,3,-148,-1.5,100,8.0,-110,-110,133,1.5,-120,4.77,PETCO Park,13,7
2016-06-05,2016,TEX,SEA,3,2,112,1.5,-155,9.5,-105,-115,-122,-1.5,135,4.48,Rangers Ballpark,5,1
2016-06-05,2016,STL,SF,6,3,-155,-1.5,135,8.5,-110,-110,140,1.5,-155,5.17,Busch Stadium,9,3
2016-06-05,2016,SF,STL,3,6,140,1.5,-155,8.5,-110,-110,-155,-1.5,135,3.54,Busch Stadium,9,-3
2016-06-05,2016,MIN,TB,5,7,109,1.5,-155,8.5,-110,-110,-119,-1.5,135,4.07,Target Field,12,-2
2016-06-05,2016,SEA,TEX,2,3,-122,-1.5,135,9.5,-105,-115,112,1.5,-155,5.22,Rangers Ballpark,5,-1
2016-06-05,2016,BOS,TOR,4,5,-115,-1.5,170,9.5,-115,-105,105,1.5,-200,5.08,Fenway Park,9,-1
2016-06-05,2016,CIN,WSH,9,10,170,1.5,114,9.5,-110,-110,-200,-1.5,-134,3.52,Great American Ballpark,19,-1
2016-06-06,2016,TB,ARI,6,4,116,1.5,-200,8.0,-120,100,-126,-1.5,170,3.7,Chase Field,10,2
2016-06-06,2016,SD,ATL,7,2,-132,-1.5,165,7.5,-115,-105,117,1.5,-185,4.27,PETCO Park,9,5
2016-06-06,2016,KC,BAL,1,4,103,1.5,-200,8.5,-120,100,-113,-1.5,170,4.19,Camden Yards,5,-3
2016-06-06,2016,PHI,CHC,4,6,235,1.5,150,8.5,-105,-115,-275,-1.5,-170,2.54,Citizens Bank Park,10,-2
2016-06-06,2016,SEA,CLE,1,3,-130,-1.5,150,8.5,-115,-105,115,1.5,-170,4.8,T-Mobile Park,4,-2
2016-06-06,2016,LAD,COL,1,6,-129,-1.5,165,7.5,-105,-115,119,1.5,-185,4.22,Dodger Stadium,7,-5
2016-06-06,2016,TOR,DET,0,11,119,1.5,-170,9.5,-116,-104,-134,-1.5,150,4.34,Comerica Park,11,-11
2016-06-06,2016,TEX,HOU,6,5,119,1.5,-135,9.5,100,-120,-134,-1.5,115,4.34,Rangers Ballpark,11,1
2016-06-06,2016,BAL,KC,4,1,-113,-1.5,170,8.5,-120,100,103,1.5,-200,4.51,Camden Yards,5,3
2016-06-06,2016,NYY,LAA,5,2,-156,-1.5,125,8.5,-105,-115,141,1.5,-145,5.18,Yankee Stadium,7,3
2016-06-06,2016,COL,LAD,6,1,119,1.5,-185,7.5,-105,-115,-129,-1.5,165,3.42,Dodger Stadium,7,5
2016-06-06,2016,LAA,NYY,2,5,141,1.5,-145,8.5,-105,-115,-156,-1.5,125,3.53,Yankee Stadium,7,-3
2016-06-06,2016,CHC,PHI,6,4,-275,-1.5,-170,8.5,-105,-115,235,1.5,150,6.23,Citizens Bank Park,10,2
2016-06-06,2016,ATL,SD,2,7,117,1.5,-185,7.5,-115,-105,-132,-1.5,165,3.46,PETCO Park,9,-5
2016-06-06,2016,CLE,SEA,3,1,115,1.5,-170,8.5,-115,-105,-130,-1.5,150,3.95,T-Mobile Park,4,2
2016-06-06,2016,ARI,TB,4,6,-126,-1.5,170,8.0,-120,100,116,1.5,-200,4.46,Chase Field,10,-2
2016-06-06,2016,HOU,TEX,5,6,-134,-1.5,115,9.5,100,-120,119,1.5,-135,5.44,Rangers Ballpark,11,-1
2016-06-06,2016,DET,TOR,11,0,-134,-1.5,150,9.5,-116,-104,119,1.5,-170,5.44,Comerica Park,11,11
2016-06-07,2016,TB,ARI,0,5,165,1.5,-119,8.0,-110,-110,-185,-1.5,-101,3.02,Chase Field,5,-5
2016-06-07,2016,SD,ATL,4,3,-145,-1.5,145,8.0,-119,-101,130,1.5,-165,4.73,PETCO Park,7,1
2016-06-07,2016,KC,BAL,1,9,130,1.5,-160,9.0,-119,-101,-145,-1.5,140,3.91,Camden Yards,10,-8
2016-06-07,2016,SF,BOS,3,5,118,1.5,-150,7.5,110,-130,-128,-1.5,130,3.44,AT&T Park,8,-2
2016-06-07,2016,PHI,CHC,3,2,180,1.5,105,8.0,-110,-110,-210,-1.5,-125,2.86,Citizens Bank Park,5,1
2016-06-07,2016,STL,CIN,6,7,-156,-1.5,-101,9.0,-125,105,141,1.5,-119,5.48,Great American Ballpark,13,-1
2016-06-07,2016,SEA,CLE,7,1,-120,-1.5,165,9.0,105,-125,110,1.5,-185,4.91,T-Mobile Park,8,6
2016-06-07,2016,LAD,COL,4,3,-196,-1.5,100,8.0,-120,100,176,1.5,-120,5.3,Dodger Stadium,7,1
2016-06-07,2016,WSH,CWS,10,5,-149,-1.5,100,8.5,-120,100,134,1.5,-120,5.09,Guaranteed Rate Field,15,5
2016-06-07,2016,TOR,DET,2,3,-148,-1.5,105,9.5,-120,100,133,1.5,-125,5.67,Comerica Park,5,-1
2016-06-07,2016,TEX,HOU,4,3,100,1.5,-160,8.5,-105,-115,-110,-1.5,140,4.25,Rangers Ballpark,7,1
2016-06-07,2016,BAL,KC,9,1,-145,-1.5,140,9.0,-119,-101,130,1.5,-160,5.33,Camden Yards,10,8
2016-06-07,2016,NYY,LAA,6,3,-151,-1.5,132,9.0,-115,-105,136,1.5,-150,5.41,Yankee Stadium,9,3
2016-06-07,2016,COL,LAD,3,4,176,1.5,-120,8.0,-120,100,-196,-1.5,100,2.9,Dodger Stadium,7,-1
2016-06-07,2016,MIN,MIA,6,4,102,1.5,-165,9.0,-125,105,-112,-1.5,145,4.46,Target Field,10,2
2016-06-07,2016,OAK,MIL,4,5,126,1.5,-170,9.0,-120,100,-141,-1.5,150,3.98,Miller Park,9,-1
2016-06-07,2016,MIA,MIN,4,6,-112,-1.5,145,9.0,-125,105,102,1.5,-165,4.75,Target Field,10,-2
2016-06-07,2016,PIT,NYM,3,1,-140,-1.5,170,7.5,-120,100,125,1.5,-200,4.38,PNC Park,4,2
2016-06-07,2016,PIT,NYM,3,1,119,1.5,-145,7.5,100,-120,-134,-1.5,125,3.42,PNC Park,4,2
2016-06-07,2016,LAA,NYY,3,6,136,1.5,-150,9.0,-115,-105,-151,-1.5,132,3.81,Yankee Stadium,9,-3
2016-06-07,2016,MIL,OAK,5,4,-141,-1.5,150,9.0,-120,100,126,1.5,-170,5.27,Miller Park,9,1
2016-06-07,2016,CHC,PHI,2,3,-210,-1.5,-125,8.0,-110,-110,180,1.5,105,5.42,Citizens Bank Park,5,-1
2016-06-07,2016,NYM,PIT,1,3,125,1.5,-200,7.5,-120,100,-140,-1.5,170,3.33,PNC Park,4,-2
2016-06-07,2016,NYM,PIT,1,3,-134,-1.5,125,7.5,100,-120,119,1.5,-145,4.29,PNC Park,4,-2
2016-06-07,2016,ATL,SD,3,4,130,1.5,-165,8.0,-119,-101,-145,-1.5,145,3.48,PETCO Park,7,-1
2016-06-07,2016,CLE,SEA,1,7,110,1.5,-185,9.0,105,-125,-120,-1.5,165,4.29,T-Mobile Park,8,-6
2016-06-07,2016,BOS,SF,5,3,-128,-1.5,130,7.5,110,-130,118,1.5,-150,4.21,AT&T Park,8,2
2016-06-07,2016,CIN,STL,7,6,141,1.5,-119,9.0,-125,105,-156,-1.5,-101,3.73,Great American Ballpark,13,1
2016-06-07,2016,ARI,TB,5,0,-185,-1.5,-101,8.0,-110,-110,165,1.5,-119,5.19,Chase Field,5,5
2016-06-07,2016,HOU,TEX,3,4,-110,-1.5,140,8.5,-105,-115,100,1.5,-160,4.45,Rangers Ballpark,7,-1
2016-06-07,2016,DET,TOR,3,2,133,1.5,-125,9.5,-120,100,-148,-1.5,105,4.08,Comerica Park,5,1
2016-06-07,2016,CWS,WSH,5,10,134,1.5,-120,8.5,-120,100,-149,-1.5,100,3.63,Guaranteed Rate Field,15,-5
2016-06-08,2016,TB,ARI,6,3,106,1.5,-205,8.5,-110,-110,-116,-1.5,175,4.13,Chase Field,9,3
2016-06-08,2016,SD,ATL,2,4,-156,-1.5,155,6.5,100,-120,141,1.5,-175,3.96,PETCO Park,6,-2
2016-06-08,2016,KC,BAL,0,4,133,1.5,-155,8.5,-105,-115,-148,-1.5,135,3.65,Camden Yards,4,-4
2016-06-08,2016,SF,BOS,2,1,117,1.5,-165,6.0,-110,-110,-127,-1.5,145,2.76,AT&T Park,3,1
2016-06-08,2016,PHI,CHC,1,8,176,1.5,105,7.5,100,-120,-196,-1.5,-125,2.72,Citizens Bank Park,9,-7
2016-06-08,2016,STL,CIN,12,7,-201,-1.5,-135,9.5,-103,-117,171,1.5,115,6.34,Great American Ballpark,19,5
2016-06-08,2016,SEA,CLE,5,0,-108,1.5,-170,7.5,100,-120,-102,-1.5,150,3.89,T-Mobile Park,5,5
2016-06-08,2016,LAD,COL,0,1,-180,-1.5,120,7.0,-115,-105,160,1.5,-140,4.5,Dodger Stadium,1,-1
2016-06-08,2016,WSH,CWS,11,4,-175,-1.5,-110,7.5,-120,100,155,1.5,-110,4.77,Guaranteed Rate Field,15,7
2016-06-08,2016,TOR,DET,7,2,109,1.5,-185,9.0,100,-120,-119,-1.5,165,4.31,Comerica Park,9,5
2016-06-08,2016,TEX,HOU,1,3,-161,-1.5,125,8.5,-110,-110,146,1.5,-145,5.24,Rangers Ballpark,4,-2
2016-06-08,2016,BAL,KC,4,0,-148,-1.5,135,8.5,-105,-115,133,1.5,-155,5.07,Camden Yards,4,4
2016-06-08,2016,NYY,LAA,12,6,-200,-1.5,-104,9.0,100,-120,170,1.5,-116,6.0,Yankee Stadium,18,6
2016-06-08,2016,COL,LAD,1,0,160,1.5,-140,7.0,-115,-105,-180,-1.5,120,2.69,Dodger Stadium,1,1
2016-06-08,2016,MIN,MIA,7,5,-105,1.5,-170,8.5,-120,100,-105,-1.5,150,4.35,Target Field,12,2
2016-06-08,2016,OAK,MIL,0,4,132,1.5,-165,9.0,-105,-115,-147,-1.5,145,3.88,Miller Park,4,-4
2016-06-08,2016,MIA,MIN,5,7,-105,-1.5,150,8.5,-120,100,-105,1.5,-170,4.35,Target Field,12,-2
2016-06-08,2016,PIT,NYM,5,6,113,1.5,-165,7.0,-110,-110,-123,-1.5,145,3.29,PNC Park,11,-1
2016-06-08,2016,LAA,NYY,6,12,170,1.5,-116,9.0,100,-120,-200,-1.5,-104,3.33,Yankee Stadium,18,-6
2016-06-08,2016,MIL,OAK,4,0,-147,-1.5,145,9.0,-105,-115,132,1.5,-165,5.36,Miller Park,4,4
2016-06-08,2016,CHC,PHI,8,1,-196,-1.5,-125,7.5,100,-120,176,1.5,105,4.97,Citizens Bank Park,9,7
2016-06-08,2016,NYM,PIT,6,5,-123,-1.5,145,7.0,-110,-110,113,1.5,-165,3.86,PNC Park,11,1
2016-06-08,2016,ATL,SD,4,2,141,1.5,-175,6.5,100,-120,-156,-1.5,155,2.7,PETCO Park,6,2
2016-06-08,2016,CLE,SEA,0,5,-102,-1.5,150,7.5,100,-120,-108,1.5,-170,3.79,T-Mobile Park,5,-5
2016-06-08,2016,BOS,SF,1,2,-127,-1.5,145,6.0,-110,-110,117,1.5,-165,3.36,AT&T Park,3,-1
2016-06-08,2016,CIN,STL,7,12,171,1.5,115,9.5,-103,-117,-201,-1.5,-135,3.51,Great American Ballpark,19,-5
2016-06-08,2016,ARI,TB,3,6,-116,-1.5,175,8.5,-110,-110,106,1.5,-205,4.56,Chase Field,9,-3
2016-06-08,2016,HOU,TEX,3,1,146,1.5,-145,8.5,-110,-110,-161,-1.5,125,3.46,Rangers Ballpark,4,2
2016-06-08,2016,DET,TOR,2,7,-119,-1.5,165,9.0,100,-120,109,1.5,-185,4.89,Comerica Park,9,-5
2016-06-08,2016,CWS,WSH,4,11,155,1.5,-110,7.5,-120,100,-175,-1.5,-110,2.94,Guaranteed Rate Field,15,-7
2016-06-09,2016,TOR,BAL,5,6,-176,-1.5,115,9.0,-121,101,156,1.5,-135,5.74,Rogers Centre,11,-1
2016-06-09,2016,STL,CIN,3,2,-185,-1.5,-130,9.5,-115,-105,165,1.5,110,6.17,Great American Ballpark,5,1
2016-06-09,2016,SEA,CLE,3,5,-131,-1.5,160,8.0,105,-125,116,1.5,-180,4.54,T-Mobile Park,8,-2
2016-06-09,2016,PIT,COL,5,11,-101,1.5,-175,13.0,100,-120,-109,-1.5,155,6.53,Coors Field,16,-6
2016-06-09,2016,WSH,CWS,1,3,-126,-1.5,130,9.0,-105,-115,116,1.5,-150,5.02,Guaranteed Rate Field,4,-2
2016-06-09,2016,TEX,HOU,5,3,115,1.5,-145,9.5,100,-120,-130,-1.5,125,4.42,Rangers Ballpark,8,2
2016-06-09,2016,NYY,LAA,6,3,-127,-1.5,145,9.0,-120,100,117,1.5,-165,5.04,Yankee Stadium,9,3
2016-06-09,2016,MIN,MIA,3,10,-131,-1.5,150,9.5,-115,-105,116,1.5,-170,5.39,Target Field,13,-7
2016-06-09,2016,NYM,MIL,5,2,-101,1.5,-205,9.0,-115,-105,-109,-1.5,175,4.52,Miller Park,7,3
2016-06-09,2016,MIA,MIN,10,3,116,1.5,-170,9.5,-115,-105,-131,-1.5,150,4.4,Target Field,13,7
2016-06-09,2016,MIL,NYM,2,5,-109,-1.5,175,9.0,-115,-105,-101,1.5,-205,4.69,Miller Park,7,-3
2016-06-09,2016,LAA,NYY,3,6,117,1.5,-165,9.0,-120,100,-127,-1.5,145,4.15,Yankee Stadium,9,-3
2016-06-09,2016,COL,PIT,11,5,-109,-1.5,155,13.0,100,-120,-101,1.5,-175,6.78,Coors Field,16,6
2016-06-09,2016,CLE,SEA,5,3,116,1.5,-180,8.0,105,-125,-131,-1.5,160,3.7,T-Mobile Park,8,2
2016-06-09,2016,CIN,STL,2,3,165,1.5,110,9.5,-115,-105,-185,-1.5,-130,3.58,Great American Ballpark,5,-1
2016-06-09,2016,HOU,TEX,3,5,-130,-1.5,125,9.5,100,-120,115,1.5,-145,5.37,Rangers Ballpark,8,-2
2016-06-09,2016,BAL,TOR,6,5,156,1.5,-135,9.0,-121,101,-176,-1.5,115,3.52,Rogers Centre,11,1
2016-06-09,2016,CWS,WSH,3,1,116,1.5,-150,9.0,-105,-115,-126,-1.5,130,4.17,Guaranteed Rate Field,4,2
2016-06-10,2016,MIA,ARI,8,6,142,1.5,-148,9.5,100,-120,-157,-1.5,128,3.93,Chase Field,14,2
2016-06-10,2016,CHC,ATL,1,5,-213,-1.5,-124,8.0,-115,-105,183,1.5,105,5.44,Turner Field,6,-4
2016-06-10,2016,TOR,BAL,4,3,-112,-1.5,175,8.5,-120,100,102,1.5,-205,4.49,Rogers Centre,7,1
2016-06-10,2016,MIN,BOS,1,8,129,1.5,-130,9.0,-105,-115,-144,-1.5,110,3.93,Target Field,9,-7
2016-06-10,2016,ATL,CHC,5,1,183,1.5,105,8.0,-115,-105,-213,-1.5,-124,2.83,Turner Field,6,4
2016-06-10,2016,OAK,CIN,1,2,-110,-1.5,145,8.5,-120,100,100,1.5,-165,4.45,Great American Ballpark,3,-1
2016-06-10,2016,LAA,CLE,2,6,130,1.5,-135,7.5,100,-120,-145,-1.5,115,3.26,Angel Stadium,8,-4
2016-06-10,2016,SD,COL,7,5,185,1.5,105,12.0,-105,-115,-215,-1.5,-125,4.21,Coors Field,12,2
2016-06-10,2016,KC,CWS,5,7,149,1.5,-144,8.0,-115,-105,-164,-1.5,124,3.21,Guaranteed Rate Field,12,-2
2016-06-10,2016,NYY,DET,4,0,-128,-1.5,150,10.5,100,-120,118,1.5,-170,5.89,Yankee Stadium,4,4
2016-06-10,2016,TB,HOU,4,3,-109,-1.5,185,7.0,-127,107,-101,1.5,-215,3.65,Tropicana Field,7,1
2016-06-10,2016,CWS,KC,7,5,-164,-1.5,124,8.0,-115,-105,149,1.5,-144,4.97,Guaranteed Rate Field,12,2
2016-06-10,2016,CLE,LAA,6,2,-145,-1.5,115,7.5,100,-120,130,1.5,-135,4.44,Angel Stadium,8,4
2016-06-10,2016,SF,LAD,2,3,150,1.5,-135,5.0,-130,110,-170,-1.5,115,2.0,AT&T Park,5,-1
2016-06-10,2016,ARI,MIA,6,8,-157,-1.5,128,9.5,100,-120,142,1.5,-148,5.8,Chase Field,14,-2
2016-06-10,2016,NYM,MIL,2,1,109,1.5,-185,9.0,100,-120,-119,-1.5,165,4.31,Miller Park,3,1
2016-06-10,2016,BOS,MIN,8,1,-144,-1.5,110,9.0,-105,-115,129,1.5,-130,5.31,Target Field,9,7
2016-06-10,2016,MIL,NYM,1,2,-119,-1.5,165,9.0,100,-120,109,1.5,-185,4.89,Miller Park,3,-1
2016-06-10,2016,DET,NYY,0,4,118,1.5,-170,10.5,100,-120,-128,-1.5,150,4.82,Yankee Stadium,4,-4
2016-06-10,2016,CIN,OAK,2,1,100,1.5,-165,8.5,-120,100,-110,-1.5,145,4.25,Great American Ballpark,3,1
2016-06-10,2016,WSH,PHI,9,6,-270,-1.5,-125,7.5,-110,-110,230,1.5,105,5.47,Nationals Park,15,3
2016-06-10,2016,STL,PIT,9,3,146,1.5,-150,8.0,-125,105,-161,-1.5,130,3.25,PNC Park,12,6
2016-06-10,2016,COL,SD,5,7,-215,-1.5,-125,12.0,-105,-115,185,1.5,105,8.19,Coors Field,12,-2
2016-06-10,2016,TEX,SEA,5,7,133,1.5,-175,7.5,-110,-110,-148,-1.5,155,3.22,T-Mobile Park,12,-2
2016-06-10,2016,LAD,SF,3,2,-170,-1.5,115,5.0,-130,110,150,1.5,-135,3.15,AT&T Park,5,1
2016-06-10,2016,PIT,STL,3,9,-161,-1.5,130,8.0,-125,105,146,1.5,-150,4.93,PNC Park,12,-6
2016-06-10,2016,HOU,TB,3,4,-101,1.5,-215,7.0,-127,107,-109,-1.5,185,3.52,Tropicana Field,7,-1
2016-06-10,2016,SEA,TEX,7,5,-148,-1.5,155,7.5,-110,-110,133,1.5,-175,4.48,T-Mobile Park,12,2
2016-06-10,2016,BAL,TOR,3,4,102,1.5,-205,8.5,-120,100,-112,-1.5,175,4.21,Rogers Centre,7,-1
2016-06-10,2016,PHI,WSH,6,9,230,1.5,105,7.5,-110,-110,-270,-1.5,-125,2.27,Nationals Park,15,-3
2016-06-11,2016,MIA,ARI,3,5,-210,-1.5,-125,9.0,-105,-115,180,1.5,105,6.1,Chase Field,8,-2
2016-06-11,2016,CHC,ATL,8,2,-320,-1.5,-177,7.5,-115,-105,270,1.5,156,5.71,Turner Field,10,6
2016-06-11,2016,TOR,BAL,11,6,-132,-1.5,150,9.0,-110,-110,117,1.5,-170,5.12,Rogers Centre,17,5
2016-06-11,2016,MIN,BOS,4,15,125,1.5,-125,10.0,-110,-110,-140,-1.5,105,4.44,Target Field,19,-11
2016-06-11,2016,ATL,CHC,2,8,270,1.5,156,7.5,-115,-105,-320,-1.5,-177,2.03,Turner Field,10,-6
2016-06-11,2016,OAK,CIN,1,2,104,1.5,-200,9.5,-105,-115,-114,-1.5,170,4.66,Great American Ballpark,3,-1
2016-06-11,2016,LAA,CLE,4,3,-140,-1.5,160,7.5,110,-130,125,1.5,-180,4.38,Angel Stadium,7,1
2016-06-11,2016,SD,COL,3,5,155,1.5,-115,12.5,-115,-105,-175,-1.5,-105,4.9,Coors Field,8,-2
2016-06-11,2016,KC,CWS,4,1,117,1.5,-180,8.5,-110,-110,-132,-1.5,160,3.92,Guaranteed Rate Field,5,3
2016-06-11,2016,NYY,DET,1,6,-130,-1.5,155,8.0,-115,-105,115,1.5,-175,4.52,Yankee Stadium,7,-5
2016-06-11,2016,TB,HOU,3,4,-130,-1.5,170,7.5,-105,-115,115,1.5,-200,4.24,Tropicana Field,7,-1
2016-06-11,2016,CWS,KC,1,4,-132,-1.5,160,8.5,-110,-110,117,1.5,-180,4.84,Guaranteed Rate Field,5,-3
2016-06-11,2016,CLE,LAA,3,4,125,1.5,-180,7.5,110,-130,-140,-1.5,160,3.33,Angel Stadium,7,-1
2016-06-11,2016,SF,LAD,5,4,-116,-1.5,185,8.0,102,-122,106,1.5,-215,4.3,AT&T Park,9,1
2016-06-11,2016,ARI,MIA,5,3,180,1.5,105,9.0,-105,-115,-210,-1.5,-125,3.21,Chase Field,8,2
2016-06-11,2016,NYM,MIL,4,7,-115,-1.5,145,9.5,-119,-101,105,1.5,-165,5.08,Miller Park,11,-3
2016-06-11,2016,BOS,MIN,15,4,-140,-1.5,105,10.0,-110,-110,125,1.5,-125,5.83,Target Field,19,11
2016-06-11,2016,MIL,NYM,7,4,105,1.5,-165,9.5,-119,-101,-115,-1.5,145,4.63,Miller Park,11,3
2016-06-11,2016,DET,NYY,6,1,115,1.5,-175,8.0,-115,-105,-130,-1.5,155,3.72,Yankee Stadium,7,5
2016-06-11,2016,CIN,OAK,2,1,-114,-1.5,170,9.5,-105,-115,104,1.5,-200,5.06,Great American Ballpark,3,1
2016-06-11,2016,WSH,PHI,8,0,-149,-1.5,150,7.5,-110,-110,134,1.5,-170,4.49,Nationals Park,8,8
2016-06-11,2016,STL,PIT,5,1,-105,1.5,-230,8.0,-112,-108,-105,-1.5,190,4.1,PNC Park,6,4
2016-06-11,2016,COL,SD,5,3,-175,-1.5,-105,12.5,-115,-105,155,1.5,-115,7.95,Coors Field,8,2
2016-06-11,2016,TEX,SEA,2,1,176,1.5,-135,7.5,-115,-105,-196,-1.5,115,2.72,T-Mobile Park,3,1
2016-06-11,2016,LAD,SF,4,5,106,1.5,-215,8.0,102,-122,-116,-1.5,185,3.88,AT&T Park,9,-1
2016-06-11,2016,PIT,STL,1,5,-105,-1.5,190,8.0,-112,-108,-105,1.5,-230,4.1,PNC Park,6,-4
2016-06-11,2016,HOU,TB,4,3,115,1.5,-200,7.5,-105,-115,-130,-1.5,170,3.49,Tropicana Field,7,1
2016-06-11,2016,SEA,TEX,1,2,-196,-1.5,115,7.5,-115,-105,176,1.5,-135,4.97,T-Mobile Park,3,-1
2016-06-11,2016,BAL,TOR,6,11,117,1.5,-170,9.0,-110,-110,-132,-1.5,150,4.15,Rogers Centre,17,-5
2016-06-11,2016,PHI,WSH,0,8,134,1.5,-170,7.5,-110,-110,-149,-1.5,150,3.21,Nationals Park,8,-8
2016-06-12,2016,MIA,ARI,0,6,100,-1.5,154,8.5,-105,-115,-110,1.5,-175,4.25,Chase Field,6,-6
2016-06-12,2016,CHC,ATL,13,2,-260,-1.5,-155,8.0,-110,-110,220,1.5,135,5.78,Turner Field,15,11
2016-06-12,2016,TOR,BAL,10,9,-157,-1.5,130,9.0,110,-130,142,1.5,-150,5.5,Rogers Centre,19,1
2016-06-12,2016,MIN,BOS,7,4,175,1.5,100,9.0,-119,-101,-195,-1.5,-120,3.27,Target Field,11,3
2016-06-12,2016,ATL,CHC,2,13,220,1.5,135,8.0,-110,-110,-260,-1.5,-155,2.5,Turner Field,15,-11
2016-06-12,2016,OAK,CIN,6,1,-128,-1.5,130,10.0,101,-121,118,1.5,-150,5.61,Great American Ballpark,7,5
2016-06-12,2016,LAA,CLE,3,8,130,1.5,-130,7.5,-108,-112,-145,-1.5,110,3.26,Angel Stadium,11,-5
2016-06-12,2016,SD,COL,1,2,145,1.5,-130,13.0,103,-123,-160,-1.5,109,5.31,Coors Field,3,-1
2016-06-12,2016,KC,CWS,3,1,118,1.5,-200,8.5,-115,-105,-128,-1.5,170,3.9,Guaranteed Rate Field,4,2
2016-06-12,2016,NYY,DET,1,4,-125,-1.5,159,8.5,-113,-107,115,1.5,-179,4.72,Yankee Stadium,5,-3
2016-06-12,2016,TB,HOU,5,0,124,1.5,-140,7.5,-108,-112,-139,-1.5,120,3.35,Tropicana Field,5,5
2016-06-12,2016,CWS,KC,1,3,-128,-1.5,170,8.5,-115,-105,118,1.5,-200,4.77,Guaranteed Rate Field,4,-2
2016-06-12,2016,CLE,LAA,8,3,-145,-1.5,110,7.5,-108,-112,130,1.5,-130,4.44,Angel Stadium,11,5
2016-06-12,2016,SF,LAD,2,1,-105,1.5,-175,7.5,-110,-110,-105,-1.5,155,3.84,AT&T Park,3,1
2016-06-12,2016,ARI,MIA,6,0,-110,1.5,-175,8.5,-105,-115,100,-1.5,154,4.45,Chase Field,6,6
2016-06-12,2016,NYM,MIL,3,5,-117,-1.5,140,7.5,100,-120,107,1.5,-160,4.04,Miller Park,8,-2
2016-06-12,2016,BOS,MIN,4,7,-195,-1.5,-120,9.0,-119,-101,175,1.5,100,5.95,Target Field,11,-3
2016-06-12,2016,MIL,NYM,5,3,107,1.5,-160,7.5,100,-120,-117,-1.5,140,3.62,Miller Park,8,2
2016-06-12,2016,DET,NYY,4,1,115,1.5,-179,8.5,-113,-107,-125,-1.5,159,3.95,Yankee Stadium,5,3
2016-06-12,2016,CIN,OAK,1,6,118,1.5,-150,10.0,101,-121,-128,-1.5,130,4.59,Great American Ballpark,7,-5
2016-06-12,2016,WSH,PHI,5,4,-260,-1.5,-120,8.5,-120,100,220,1.5,100,6.14,Nationals Park,9,1
2016-06-12,2016,STL,PIT,8,3,-113,-1.5,145,8.5,-126,106,103,1.5,-165,4.51,PNC Park,11,5
2016-06-12,2016,COL,SD,2,1,-160,-1.5,109,13.0,103,-123,145,1.5,-130,8.0,Coors Field,3,1
2016-06-12,2016,TEX,SEA,6,4,100,1.5,-215,7.0,-121,101,-110,-1.5,185,3.5,T-Mobile Park,10,2
2016-06-12,2016,LAD,SF,1,2,-105,-1.5,155,7.5,-110,-110,-105,1.5,-175,3.84,AT&T Park,3,-1
2016-06-12,2016,PIT,STL,3,8,103,1.5,-165,8.5,-126,106,-113,-1.5,145,4.19,PNC Park,11,-5
2016-06-12,2016,HOU,TB,0,5,-139,-1.5,120,7.5,-108,-112,124,1.5,-140,4.36,Tropicana Field,5,-5
2016-06-12,2016,SEA,TEX,4,6,-110,-1.5,185,7.0,-121,101,100,1.5,-215,3.67,T-Mobile Park,10,-2
2016-06-12,2016,BAL,TOR,9,10,142,1.5,-150,9.0,110,-130,-157,-1.5,130,3.72,Rogers Centre,19,-1
2016-06-12,2016,PHI,WSH,4,5,220,1.5,100,8.5,-120,100,-260,-1.5,-120,2.66,Nationals Park,9,-1
2016-06-13,2016,LAD,ARI,2,3,130,1.5,-165,9.0,105,-125,-145,-1.5,145,3.91,Chase Field,5,-1
2016-06-13,2016,CIN,ATL,9,8,-105,-1.5,150,8.5,-113,-107,-105,1.5,-170,4.35,Turner Field,17,1
2016-06-13,2016,WSH,CHC,4,1,-131,-1.5,165,7.5,-105,-115,116,1.5,-185,4.25,Nationals Park,5,3
2016-06-13,2016,ATL,CIN,8,9,-105,1.5,-170,8.5,-113,-107,-105,-1.5,150,4.35,Turner Field,17,-1
2016-06-13,2016,KC,CLE,2,1,125,1.5,-140,8.0,-105,-115,-140,-1.5,120,3.56,Kauffman Stadium,3,1
2016-06-13,2016,DET,CWS,9,10,-103,1.5,-210,10.0,-110,-110,-107,-1.5,180,5.07,Guaranteed Rate Field,19,-1
2016-06-13,2016,CWS,DET,10,9,-107,-1.5,180,10.0,-110,-110,-103,1.5,-210,5.17,Guaranteed Rate Field,19,1
2016-06-13,2016,CLE,KC,1,2,-140,-1.5,120,8.0,-105,-115,125,1.5,-140,4.67,Kauffman Stadium,3,-1
2016-06-13,2016,MIN,LAA,9,4,105,1.5,-200,8.5,100,-120,-115,-1.5,170,4.15,Angel Stadium,13,5
2016-06-13,2016,ARI,LAD,3,2,-145,-1.5,145,9.0,105,-125,130,1.5,-165,5.33,Chase Field,5,1
2016-06-13,2016,SD,MIA,4,13,-102,1.5,-176,7.5,-105,-115,-108,-1.5,156,3.79,PETCO Park,17,-9
2016-06-13,2016,SF,MIL,11,5,-153,-1.5,150,7.5,-105,-115,138,1.5,-170,4.54,AT&T Park,16,6
2016-06-13,2016,LAA,MIN,4,9,-115,-1.5,170,8.5,100,-120,105,1.5,-200,4.55,Angel Stadium,13,-5
2016-06-13,2016,TEX,OAK,5,14,135,1.5,-165,8.0,105,-125,-150,-1.5,145,3.4,Oakland Coliseum,19,-9
2016-06-13,2016,TOR,PHI,0,7,-185,-1.5,110,8.5,-115,-105,165,1.5,-130,5.52,Rogers Centre,7,-7
2016-06-13,2016,MIA,SD,13,4,-108,-1.5,156,7.5,-105,-115,-102,1.5,-176,3.89,PETCO Park,17,9
2016-06-13,2016,MIL,SF,5,11,138,1.5,-170,7.5,-105,-115,-153,-1.5,150,3.15,AT&T Park,16,-6
2016-06-13,2016,OAK,TEX,14,5,-150,-1.5,145,8.0,105,-125,135,1.5,-165,4.8,Oakland Coliseum,19,9
2016-06-13,2016,PHI,TOR,7,0,165,1.5,-130,8.5,-115,-105,-185,-1.5,110,3.21,Rogers Centre,7,7
2016-06-13,2016,CHC,WSH,1,4,116,1.5,-185,7.5,-105,-115,-131,-1.5,165,3.47,Nationals Park,5,-3
2016-06-14,2016,LAD,ARI,7,4,-150,-1.5,105,9.0,-110,-110,135,1.5,-125,5.4,Chase Field,11,3
2016-06-14,2016,CIN,ATL,3,1,125,1.5,-185,7.5,100,-120,-140,-1.5,165,3.33,Turner Field,4,2
2016-06-14,2016,BOS,BAL,2,3,-186,-1.5,100,8.5,-125,105,166,1.5,-120,5.53,Fenway Park,5,-1
2016-06-14,2016,BAL,BOS,3,2,166,1.5,-120,8.5,-125,105,-186,-1.5,100,3.2,Fenway Park,5,1
2016-06-14,2016,WSH,CHC,3,4,115,1.5,-150,8.0,-110,-110,-130,-1.5,130,3.72,Nationals Park,7,-1
2016-06-14,2016,ATL,CIN,1,3,-140,-1.5,165,7.5,100,-120,125,1.5,-185,4.38,Turner Field,4,-2
2016-06-14,2016,KC,CLE,3,2,106,1.5,-160,8.5,-120,100,-116,-1.5,140,4.13,Kauffman Stadium,5,1
2016-06-14,2016,NYY,COL,10,13,-105,-1.5,150,10.0,-106,-114,-105,1.5,-170,5.12,Coors Field,23,-3
2016-06-14,2016,DET,CWS,11,8,-116,-1.5,135,8.5,-120,100,106,1.5,-155,4.56,Guaranteed Rate Field,19,3
2016-06-14,2016,CWS,DET,8,11,106,1.5,-155,8.5,-120,100,-116,-1.5,135,4.13,Guaranteed Rate Field,19,-3
2016-06-14,2016,STL,HOU,2,5,-156,-1.5,130,8.5,-115,-105,141,1.5,-150,5.18,Busch Stadium,7,-3
2016-06-14,2016,CLE,KC,2,3,-116,-1.5,140,8.5,-120,100,106,1.5,-160,4.56,Kauffman Stadium,5,-1
2016-06-14,2016,MIN,LAA,4,5,125,1.5,-170,7.5,-120,100,-140,-1.5,150,3.33,Angel Stadium,9,-1
2016-06-14,2016,ARI,LAD,4,7,135,1.5,-125,9.0,-110,-110,-150,-1.5,105,3.83,Chase Field,11,-3
2016-06-14,2016,SD,MIA,2,5,-130,-1.5,170,7.0,-126,106,115,1.5,-200,3.96,PETCO Park,7,-3
2016-06-14,2016,SF,MIL,3,2,-260,-1.5,-120,7.0,-105,-115,220,1.5,100,5.06,AT&T Park,5,1
2016-06-14,2016,LAA,MIN,5,4,-140,-1.5,150,7.5,-120,100,125,1.5,-170,4.38,Angel Stadium,9,1
2016-06-14,2016,PIT,NYM,4,0,115,1.5,-200,7.0,-115,-105,-130,-1.5,170,3.26,Citi Field,4,4
2016-06-14,2016,COL,NYY,13,10,-105,1.5,-170,10.0,-106,-114,-105,-1.5,150,5.12,Coors Field,23,3
2016-06-14,2016,TEX,OAK,10,6,105,1.5,-200,8.5,-110,-110,-115,-1.5,170,4.15,Oakland Coliseum,16,4
2016-06-14,2016,TOR,PHI,11,3,-300,-1.5,-150,8.5,-115,-105,250,1.5,130,6.38,Rogers Centre,14,8
2016-06-14,2016,NYM,PIT,0,4,-130,-1.5,170,7.0,-115,-105,115,1.5,-200,3.96,Citi Field,4,-4
2016-06-14,2016,MIA,SD,5,2,115,1.5,-200,7.0,-126,106,-130,-1.5,170,3.26,PETCO Park,7,3
2016-06-14,2016,TB,SEA,8,7,-119,-1.5,175,8.0,100,-120,109,1.5,-205,4.35,Tropicana Field,15,1
2016-06-14,2016,MIL,SF,2,3,220,1.5,100,7.0,-105,-115,-260,-1.5,-120,2.19,AT&T Park,5,-1
2016-06-14,2016,HOU,STL,5,2,141,1.5,-150,8.5,-115,-105,-156,-1.5,130,3.53,Busch Stadium,7,3
2016-06-14,2016,SEA,TB,7,8,109,1.5,-205,8.0,100,-120,-119,-1.5,175,3.83,Tropicana Field,15,-1
2016-06-14,2016,OAK,TEX,6,10,-115,-1.5,170,8.5,-110,-110,105,1.5,-200,4.55,Oakland Coliseum,16,-4
2016-06-14,2016,PHI,TOR,3,11,250,1.5,130,8.5,-115,-105,-300,-1.5,-150,2.43,Rogers Centre,14,-8
2016-06-14,2016,CHC,WSH,4,3,-130,-1.5,130,8.0,-110,-110,115,1.5,-150,4.52,Nationals Park,7,1
2016-06-15,2016,LAD,ARI,3,2,-255,-1.5,-145,7.0,-110,-110,215,1.5,125,5.03,Chase Field,5,1
2016-06-15,2016,CIN,ATL,8,9,111,1.5,-200,8.0,-105,-115,-121,-1.5,170,3.79,Turner Field,17,-1
2016-06-15,2016,BOS,BAL,6,4,-151,-1.5,130,9.5,-110,-110,136,1.5,-150,5.72,Fenway Park,10,2
2016-06-15,2016,BAL,BOS,4,6,136,1.5,-150,9.5,-110,-110,-151,-1.5,130,4.03,Fenway Park,10,-2
2016-06-15,2016,WSH,CHC,5,4,-147,-1.5,145,7.5,100,-120,132,1.5,-165,4.46,Nationals Park,9,1
2016-06-15,2016,ATL,CIN,9,8,-121,-1.5,170,8.0,-105,-115,111,1.5,-200,4.38,Turner Field,17,1
2016-06-15,2016,KC,CLE,9,4,142,1.5,-125,7.5,-112,-108,-157,-1.5,105,3.1,Kauffman Stadium,13,5
2016-06-15,2016,NYY,COL,3,6,-111,-1.5,140,12.0,-103,-117,101,1.5,-160,6.31,Coors Field,9,-3
2016-06-15,2016,DET,CWS,3,5,165,1.5,-119,9.0,-125,105,-185,-1.5,-101,3.4,Guaranteed Rate Field,8,-2
2016-06-15,2016,CWS,DET,5,3,-185,-1.5,-101,9.0,-125,105,165,1.5,-119,5.84,Guaranteed Rate Field,8,2
2016-06-15,2016,STL,HOU,1,4,-134,-1.5,160,8.5,-110,-110,119,1.5,-180,4.87,Busch Stadium,5,-3
2016-06-15,2016,CLE,KC,4,9,-157,-1.5,105,7.5,-112,-108,142,1.5,-125,4.58,Kauffman Stadium,13,-5
2016-06-15,2016,MIN,LAA,2,10,107,1.5,-200,8.0,-115,-105,-117,-1.5,170,3.86,Angel Stadium,12,-8
2016-06-15,2016,ARI,LAD,2,3,215,1.5,125,7.0,-110,-110,-255,-1.5,-145,2.22,Chase Field,5,-1
2016-06-15,2016,SD,MIA,6,3,-132,-1.5,160,8.5,-115,-105,117,1.5,-180,4.84,PETCO Park,9,3
2016-06-15,2016,SF,MIL,10,1,-220,-1.5,105,7.0,105,-125,190,1.5,-125,4.81,AT&T Park,11,9
2016-06-15,2016,LAA,MIN,10,2,-117,-1.5,170,8.0,-115,-105,107,1.5,-200,4.31,Angel Stadium,12,8
2016-06-15,2016,PIT,NYM,2,11,150,1.5,-150,7.0,-105,-115,-170,-1.5,130,2.8,Citi Field,13,-9
2016-06-15,2016,COL,NYY,6,3,101,1.5,-160,12.0,-103,-117,-111,-1.5,140,5.97,Coors Field,9,3
2016-06-15,2016,TEX,OAK,7,5,135,1.5,-160,8.0,-115,-105,-150,-1.5,140,3.4,Oakland Coliseum,12,2
2016-06-15,2016,TOR,PHI,7,2,-172,-1.5,-110,8.0,-115,-105,152,1.5,-110,5.06,Citizens Bank Park,9,5
2016-06-15,2016,NYM,PIT,11,2,-170,-1.5,130,7.0,-105,-115,150,1.5,-150,4.41,Citi Field,13,9
2016-06-15,2016,MIA,SD,3,6,117,1.5,-180,8.5,-115,-105,-132,-1.5,160,3.92,PETCO Park,9,-3
2016-06-15,2016,TB,SEA,3,2,-140,-1.5,160,7.5,-115,-105,125,1.5,-180,4.38,Tropicana Field,5,1
2016-06-15,2016,MIL,SF,1,10,190,1.5,-125,7.0,105,-125,-220,-1.5,105,2.41,AT&T Park,11,-9
2016-06-15,2016,HOU,STL,4,1,119,1.5,-180,8.5,-110,-110,-134,-1.5,160,3.88,Busch Stadium,5,3
2016-06-15,2016,SEA,TB,2,3,125,1.5,-180,7.5,-115,-105,-140,-1.5,160,3.33,Tropicana Field,5,-1
2016-06-15,2016,OAK,TEX,5,7,-150,-1.5,140,8.0,-115,-105,135,1.5,-160,4.8,Oakland Coliseum,12,-2
2016-06-15,2016,PHI,TOR,2,7,152,1.5,-110,8.0,-115,-105,-172,-1.5,-110,3.17,Citizens Bank Park,9,-5
2016-06-15,2016,CHC,WSH,4,5,132,1.5,-165,7.5,100,-120,-147,-1.5,145,3.23,Nationals Park,9,-1
2016-06-16,2016,CIN,ATL,2,7,106,1.5,-210,8.0,-110,-110,-116,-1.5,180,3.88,Turner Field,9,-5
2016-06-16,2016,BOS,BAL,1,5,-128,-1.5,150,10.5,100,-120,118,1.5,-170,5.89,Fenway Park,6,-4
2016-06-16,2016,BAL,BOS,5,1,118,1.5,-170,10.5,100,-120,-128,-1.5,150,4.82,Fenway Park,6,4
2016-06-16,2016,ATL,CIN,7,2,-116,-1.5,180,8.0,-110,-110,106,1.5,-210,4.3,Turner Field,9,5
2016-06-16,2016,KC,DET,4,10,-103,1.5,-170,8.0,-115,-105,-107,-1.5,150,4.06,Kauffman Stadium,14,-6
2016-06-16,2016,DET,KC,10,4,-107,-1.5,150,8.0,-115,-105,-103,1.5,-170,4.14,Kauffman Stadium,14,6
2016-06-16,2016,MIL,LAD,8,6,136,1.5,-165,7.5,100,-120,-151,-1.5,145,3.18,Dodger Stadium,14,2
2016-06-16,2016,LAD,MIL,6,8,-151,-1.5,145,7.5,100,-120,136,1.5,-165,4.51,Dodger Stadium,14,-2
2016-06-16,2016,NYY,MIN,4,1,-119,-1.5,130,8.5,-125,105,109,1.5,-150,4.62,Target Field,5,3
2016-06-16,2016,PIT,NYM,4,6,110,1.5,-200,8.0,100,-120,-120,-1.5,170,3.81,Citi Field,10,-2
2016-06-16,2016,MIN,NYY,1,4,109,1.5,-150,8.5,-125,105,-119,-1.5,130,4.07,Target Field,5,-3
2016-06-16,2016,TEX,OAK,5,1,102,1.5,-210,8.5,-105,-115,-112,-1.5,180,4.21,Oakland Coliseum,6,4
2016-06-16,2016,TOR,PHI,13,2,-140,-1.5,130,7.5,-106,-114,125,1.5,-150,4.38,Citizens Bank Park,15,11
2016-06-16,2016,NYM,PIT,6,4,-120,-1.5,170,8.0,100,-120,110,1.5,-200,4.36,Citi Field,10,2
2016-06-16,2016,WSH,SD,8,5,-184,-1.5,-126,7.5,-120,100,164,1.5,106,4.86,PETCO Park,13,3
2016-06-16,2016,TB,SEA,4,6,108,1.5,-165,7.5,100,-120,-118,-1.5,145,3.61,Tropicana Field,10,-2
2016-06-16,2016,SEA,TB,6,4,-118,-1.5,145,7.5,100,-120,108,1.5,-165,4.06,Tropicana Field,10,2
2016-06-16,2016,OAK,TEX,1,5,-112,-1.5,180,8.5,-105,-115,102,1.5,-210,4.49,Oakland Coliseum,6,-4
2016-06-16,2016,PHI,TOR,2,13,125,1.5,-150,7.5,-106,-114,-140,-1.5,130,3.33,Citizens Bank Park,15,-11
2016-06-16,2016,SD,WSH,5,8,164,1.5,106,7.5,-120,100,-184,-1.5,-126,2.84,PETCO Park,13,-3
2016-06-17,2016,PHI,ARI,2,10,130,1.5,-120,8.0,-115,-105,-145,-1.5,100,3.48,Citizens Bank Park,12,-8
2016-06-17,2016,NYM,ATL,1,5,-240,-1.5,-104,7.5,100,-120,200,1.5,-116,5.29,Citi Field,6,-4
2016-06-17,2016,TOR,BAL,13,3,-140,-1.5,115,9.0,-125,105,125,1.5,-135,5.25,Camden Yards,16,10
2016-06-17,2016,SEA,BOS,8,4,116,1.5,-170,10.0,-124,104,-131,-1.5,150,4.63,Fenway Park,12,4
2016-06-17,2016,PIT,CHC,0,6,250,1.5,107,6.5,-120,100,-290,-1.5,-127,1.86,Wrigley Field,6,-6
2016-06-17,2016,HOU,CIN,2,4,-275,-1.5,-145,9.0,100,-120,235,1.5,125,6.6,Minute Maid Park,6,-2
2016-06-17,2016,CWS,CLE,2,3,-116,-1.5,140,7.5,-105,-115,106,1.5,-160,4.03,Progressive Field,5,-1
2016-06-17,2016,MIA,COL,5,1,-130,-1.5,160,7.5,-115,-105,115,1.5,-180,4.24,Marlins Park,6,4
2016-06-17,2016,CLE,CWS,3,2,106,1.5,-160,7.5,-105,-115,-116,-1.5,140,3.64,Progressive Field,5,1
2016-06-17,2016,KC,DET,10,3,-103,1.5,-165,8.5,-101,-119,-107,-1.5,145,4.31,Kauffman Stadium,13,7
2016-06-17,2016,CIN,HOU,4,2,235,1.5,125,9.0,100,-120,-275,-1.5,-145,2.69,Minute Maid Park,6,2
2016-06-17,2016,DET,KC,3,10,-107,-1.5,145,8.5,-101,-119,-103,1.5,-165,4.39,Kauffman Stadium,13,-7
2016-06-17,2016,OAK,LAA,3,2,135,1.5,-125,8.0,100,-120,-150,-1.5,105,3.4,Oakland Coliseum,5,1
2016-06-17,2016,MIL,LAD,2,3,157,1.5,-145,7.5,110,-130,-177,-1.5,125,2.92,Dodger Stadium,5,-1
2016-06-17,2016,COL,MIA,1,5,115,1.5,-180,7.5,-115,-105,-130,-1.5,160,3.49,Marlins Park,6,-4
2016-06-17,2016,LAD,MIL,3,2,-177,-1.5,125,7.5,110,-130,157,1.5,-145,4.79,Dodger Stadium,5,1
2016-06-17,2016,NYY,MIN,8,2,-175,-1.5,-110,8.0,-120,100,155,1.5,-110,5.09,Target Field,10,6
2016-06-17,2016,ATL,NYM,5,1,200,1.5,-116,7.5,100,-120,-240,-1.5,-104,2.5,Citi Field,6,4
2016-06-17,2016,MIN,NYY,2,8,155,1.5,-110,8.0,-120,100,-175,-1.5,-110,3.14,Target Field,10,-6
2016-06-17,2016,LAA,OAK,2,3,-150,-1.5,105,8.0,100,-120,135,1.5,-125,4.8,Oakland Coliseum,5,-1
2016-06-17,2016,ARI,PHI,10,2,-145,-1.5,100,8.0,-115,-105,130,1.5,-120,4.73,Citizens Bank Park,12,8
2016-06-17,2016,CHC,PIT,6,0,-290,-1.5,-127,6.5,-120,100,250,1.5,107,4.83,Wrigley Field,6,6
2016-06-17,2016,WSH,SD,7,5,-171,-1.5,-110,8.0,105,-125,151,1.5,-110,5.05,PETCO Park,12,2
2016-06-17,2016,BOS,SEA,4,8,-131,-1.5,150,10.0,-124,104,116,1.5,-170,5.67,Fenway Park,12,-4
2016-06-17,2016,TB,SF,1,5,-123,-1.5,170,7.5,100,-120,113,1.5,-200,4.14,Tropicana Field,6,-4
2016-06-17,2016,TEX,STL,1,0,117,1.5,-200,8.0,-110,-110,-127,-1.5,170,3.69,Busch Stadium,1,1
2016-06-17,2016,SF,TB,5,1,113,1.5,-200,7.5,100,-120,-123,-1.5,170,3.52,Tropicana Field,6,4
2016-06-17,2016,STL,TEX,0,1,-127,-1.5,170,8.0,-110,-110,117,1.5,-200,4.48,Busch Stadium,1,-1
2016-06-17,2016,BAL,TOR,3,13,125,1.5,-135,9.0,-125,105,-140,-1.5,115,4.0,Camden Yards,16,-10
2016-06-17,2016,SD,WSH,5,7,151,1.5,-110,8.0,105,-125,-171,-1.5,-110,3.19,PETCO Park,12,-2
2016-06-18,2016,PHI,ARI,1,4,134,1.5,-125,7.5,-105,-115,-149,-1.5,105,3.21,Citizens Bank Park,5,-3
2016-06-18,2016,NYM,ATL,3,4,-265,-1.5,-125,7.5,100,-120,225,1.5,105,5.45,Citi Field,7,-1
2016-06-18,2016,TOR,BAL,2,4,103,1.5,-200,10.0,100,-120,-113,-1.5,170,4.93,Camden Yards,6,-2
2016-06-18,2016,SEA,BOS,2,6,169,1.5,-118,10.0,-120,100,-189,-1.5,-102,3.72,Fenway Park,8,-4
2016-06-18,2016,PIT,CHC,3,4,225,1.5,115,8.0,-109,-111,-265,-1.5,-135,2.46,Wrigley Field,7,-1
2016-06-18,2016,HOU,CIN,5,4,-235,-1.5,105,7.5,-115,-105,205,1.5,-125,5.26,Minute Maid Park,9,1
2016-06-18,2016,CWS,CLE,2,13,185,1.5,-110,8.0,-120,100,-215,-1.5,-110,2.81,Progressive Field,15,-11
2016-06-18,2016,MIA,COL,9,6,-117,-1.5,180,8.5,-106,-114,107,1.5,-210,4.58,Marlins Park,15,3
2016-06-18,2016,CLE,CWS,13,2,-215,-1.5,-110,8.0,-120,100,185,1.5,-110,5.46,Progressive Field,15,11
2016-06-18,2016,KC,DET,16,5,-140,-1.5,142,9.0,-115,-105,125,1.5,-162,5.25,Kauffman Stadium,21,11
2016-06-18,2016,CIN,HOU,4,5,205,1.5,-125,7.5,-115,-105,-235,-1.5,105,2.46,Minute Maid Park,9,-1
2016-06-18,2016,DET,KC,5,16,125,1.5,-162,9.0,-115,-105,-140,-1.5,142,4.0,Kauffman Stadium,21,-11
2016-06-18,2016,OAK,LAA,1,7,-122,-1.5,165,8.5,-112,-108,112,1.5,-185,4.67,Oakland Coliseum,8,-6
2016-06-18,2016,MIL,LAD,6,10,148,1.5,-155,8.5,-105,-115,-163,-1.5,135,3.43,Dodger Stadium,16,-4
2016-06-18,2016,COL,MIA,6,9,107,1.5,-210,8.5,-106,-114,-117,-1.5,180,4.11,Marlins Park,15,-3
2016-06-18,2016,LAD,MIL,10,6,-163,-1.5,135,8.5,-105,-115,148,1.5,-155,5.27,Dodger Stadium,16,4
2016-06-18,2016,NYY,MIN,7,6,-157,-1.5,-105,8.5,-110,-110,142,1.5,-115,5.19,Target Field,13,1
2016-06-18,2016,ATL,NYM,4,3,225,1.5,105,7.5,100,-120,-265,-1.5,-125,2.31,Citi Field,7,1
2016-06-18,2016,MIN,NYY,6,7,142,1.5,-115,8.5,-110,-110,-157,-1.5,-105,3.51,Target Field,13,-1
2016-06-18,2016,LAA,OAK,7,1,112,1.5,-185,8.5,-112,-108,-122,-1.5,165,4.01,Oakland Coliseum,8,6
2016-06-18,2016,ARI,PHI,4,1,-149,-1.5,105,7.5,-105,-115,134,1.5,-125,4.49,Citizens Bank Park,5,3
2016-06-18,2016,CHC,PIT,4,3,-265,-1.5,-135,8.0,-109,-111,225,1.5,115,5.81,Wrigley Field,7,1
2016-06-18,2016,WSH,SD,3,7,-275,-1.5,-153,7.0,-120,100,235,1.5,133,5.13,PETCO Park,10,-4
2016-06-18,2016,BOS,SEA,6,2,-189,-1.5,-102,10.0,-120,100,169,1.5,-118,6.54,Fenway Park,8,4
2016-06-18,2016,TB,SF,4,6,-130,-1.5,165,8.0,-117,-103,115,1.5,-185,4.52,Tropicana Field,10,-2
2016-06-18,2016,TEX,STL,4,3,160,1.5,-125,9.0,-105,-115,-180,-1.5,105,3.46,Busch Stadium,7,1
2016-06-18,2016,SF,TB,6,4,115,1.5,-185,8.0,-117,-103,-130,-1.5,165,3.72,Tropicana Field,10,2
2016-06-18,2016,STL,TEX,3,4,-180,-1.5,105,9.0,-105,-115,160,1.5,-125,5.79,Busch Stadium,7,-1
2016-06-18,2016,BAL,TOR,4,2,-113,-1.5,170,10.0,100,-120,103,1.5,-200,5.31,Camden Yards,6,2
2016-06-18,2016,SD,WSH,7,3,235,1.5,133,7.0,-120,100,-275,-1.5,-153,2.09,PETCO Park,10,4
2016-06-19,2016,PHI,ARI,1,5,115,1.5,-145,9.0,100,-120,-130,-1.5,125,4.19,Citizens Bank Park,6,-4
2016-06-19,2016,NYM,ATL,0,6,-170,-1.5,125,7.0,-105,-115,150,1.5,-145,4.41,Citi Field,6,-6
2016-06-19,2016,TOR,BAL,6,11,-109,-1.5,145,9.0,-111,-109,-101,1.5,-165,4.69,Camden Yards,17,-5
2016-06-19,2016,SEA,BOS,1,2,165,1.5,-125,9.0,-115,-105,-185,-1.5,105,3.4,Fenway Park,3,-1
2016-06-19,2016,PIT,CHC,5,10,145,1.5,-135,9.0,-115,-105,-160,-1.5,115,3.67,Wrigley Field,15,-5
2016-06-19,2016,HOU,CIN,6,0,-210,-1.5,100,8.5,-105,-115,180,1.5,-120,5.76,Minute Maid Park,6,6
2016-06-19,2016,CWS,CLE,2,3,159,1.5,-140,8.5,100,-120,-179,-1.5,120,3.28,Progressive Field,5,-1
2016-06-19,2016,MIA,COL,3,0,-140,-1.5,160,8.0,100,-120,125,1.5,-180,4.67,Marlins Park,3,3
2016-06-19,2016,CLE,CWS,3,2,-179,-1.5,120,8.5,100,-120,159,1.5,-140,5.45,Progressive Field,5,1
2016-06-19,2016,KC,DET,2,1,-105,1.5,-170,9.0,-105,-115,-105,-1.5,150,4.61,Kauffman Stadium,3,1
2016-06-19,2016,CIN,HOU,0,6,180,1.5,-120,8.5,-105,-115,-210,-1.5,100,3.04,Minute Maid Park,6,-6
2016-06-19,2016,DET,KC,1,2,-105,-1.5,150,9.0,-105,-115,-105,1.5,-170,4.61,Kauffman Stadium,3,-1
2016-06-19,2016,OAK,LAA,0,2,115,1.5,-145,9.5,-115,-105,-125,-1.5,125,4.42,Oakland Coliseum,2,-2
2016-06-19,2016,MIL,LAD,1,2,180,1.5,-115,8.0,-120,100,-210,-1.5,-105,2.86,Dodger Stadium,3,-1
2016-06-19,2016,COL,MIA,0,3,125,1.5,-180,8.0,100,-120,-140,-1.5,160,3.56,Marlins Park,3,-3
2016-06-19,2016,LAD,MIL,2,1,-210,-1.5,-105,8.0,-120,100,180,1.5,-115,5.42,Dodger Stadium,3,1
2016-06-19,2016,NYY,MIN,4,7,-160,-1.5,-101,9.0,-115,-105,145,1.5,-119,5.54,Target Field,11,-3
2016-06-19,2016,ATL,NYM,6,0,150,1.5,-145,7.0,-105,-115,-170,-1.5,125,2.8,Citi Field,6,6
2016-06-19,2016,MIN,NYY,7,4,145,1.5,-119,9.0,-115,-105,-160,-1.5,-101,3.67,Target Field,11,3
2016-06-19,2016,LAA,OAK,2,0,-125,-1.5,125,9.5,-115,-105,115,1.5,-145,5.28,Oakland Coliseum,2,2
2016-06-19,2016,ARI,PHI,5,1,-130,-1.5,125,9.0,100,-120,115,1.5,-145,5.09,Citizens Bank Park,6,4
2016-06-19,2016,CHC,PIT,10,5,-160,-1.5,115,9.0,-115,-105,145,1.5,-135,5.54,Wrigley Field,15,5
2016-06-19,2016,WSH,SD,3,6,-116,-1.5,145,8.5,-110,-110,106,1.5,-165,4.56,PETCO Park,9,-3
2016-06-19,2016,BOS,SEA,2,1,-185,-1.5,105,9.0,-115,-105,165,1.5,-125,5.84,Fenway Park,3,1
2016-06-19,2016,TB,SF,1,5,-147,-1.5,150,8.0,-106,-114,132,1.5,-170,4.76,Tropicana Field,6,-4
2016-06-19,2016,TEX,STL,5,4,114,1.5,-205,9.0,-113,-107,-124,-1.5,175,4.21,Busch Stadium,9,1
2016-06-19,2016,SF,TB,5,1,132,1.5,-170,8.0,-106,-114,-147,-1.5,150,3.45,Tropicana Field,6,4
2016-06-19,2016,STL,TEX,4,5,-124,-1.5,175,9.0,-113,-107,114,1.5,-205,4.98,Busch Stadium,9,-1
2016-06-19,2016,BAL,TOR,11,6,-101,1.5,-165,9.0,-111,-109,-109,-1.5,145,4.52,Camden Yards,17,5
2016-06-19,2016,SD,WSH,6,3,106,1.5,-165,8.5,-110,-110,-116,-1.5,145,4.13,PETCO Park,9,3
2016-06-20,2016,PHI,ARI,1,3,-132,-1.5,155,8.5,-105,-115,117,1.5,-175,4.84,Citizens Bank Park,4,-2
2016-06-20,2016,TEX,BAL,4,3,-113,-1.5,175,9.5,-115,-105,103,1.5,-205,5.04,Rangers Ballpark,7,1
2016-06-20,2016,CWS,BOS,3,1,190,1.5,105,10.0,-119,-101,-220,-1.5,-125,3.45,Fenway Park,4,2
2016-06-20,2016,STL,CHC,3,2,150,1.5,-145,8.0,-120,100,-170,-1.5,125,3.2,Wrigley Field,5,1
2016-06-20,2016,TB,CLE,4,7,103,1.5,-205,8.5,-110,-110,-113,-1.5,175,4.19,Progressive Field,11,-3
2016-06-20,2016,MIA,COL,3,5,-103,1.5,-170,8.0,-120,100,-107,-1.5,150,4.06,Marlins Park,8,-2
2016-06-20,2016,BOS,CWS,1,3,-220,-1.5,-125,10.0,-119,-101,190,1.5,105,6.88,Fenway Park,4,-2
2016-06-20,2016,SEA,DET,7,8,-134,-1.5,115,11.0,-105,-115,119,1.5,-135,6.3,Comerica Park,15,-1
2016-06-20,2016,LAA,HOU,7,10,137,1.5,-155,8.5,-110,-110,-152,-1.5,135,3.59,Minute Maid Park,17,-3
2016-06-20,2016,HOU,LAA,10,7,-152,-1.5,135,8.5,-110,-110,137,1.5,-155,5.13,Minute Maid Park,17,3
2016-06-20,2016,WSH,LAD,1,4,250,1.5,121,6.5,-125,105,-300,-1.5,-141,1.86,Dodger Stadium,5,-3
2016-06-20,2016,COL,MIA,5,3,-107,-1.5,150,8.0,-120,100,-103,1.5,-170,4.14,Marlins Park,8,2
2016-06-20,2016,ARI,PHI,3,1,117,1.5,-175,8.5,-105,-115,-132,-1.5,155,3.92,Citizens Bank Park,4,2
2016-06-20,2016,SF,PIT,0,1,-149,-1.5,110,8.5,-105,-115,134,1.5,-130,5.09,PNC Park,1,-1
2016-06-20,2016,DET,SEA,8,7,119,1.5,-135,11.0,-105,-115,-134,-1.5,115,5.02,Comerica Park,15,1
2016-06-20,2016,PIT,SF,1,0,134,1.5,-130,8.5,-105,-115,-149,-1.5,110,3.63,PNC Park,1,1
2016-06-20,2016,CHC,STL,2,3,-170,-1.5,125,8.0,-120,100,150,1.5,-145,5.04,Wrigley Field,5,-1
2016-06-20,2016,CLE,TB,7,4,-113,-1.5,175,8.5,-110,-110,103,1.5,-205,4.51,Progressive Field,11,3
2016-06-20,2016,BAL,TEX,3,4,103,1.5,-205,9.5,-115,-105,-113,-1.5,175,4.68,Rangers Ballpark,7,-1
2016-06-20,2016,LAD,WSH,4,1,-300,-1.5,-141,6.5,-125,105,250,1.5,121,4.88,Dodger Stadium,5,3
2016-06-21,2016,TOR,ARI,2,4,-205,-1.5,-115,9.0,100,-120,175,1.5,-105,6.05,Rogers Centre,6,-2
2016-06-21,2016,MIA,ATL,2,3,-285,-1.5,-125,7.0,-116,-104,245,1.5,105,5.18,Marlins Park,5,-1
2016-06-21,2016,SD,BAL,10,7,160,1.5,-125,10.0,-115,-105,-180,-1.5,105,3.85,Camden Yards,17,3
2016-06-21,2016,CWS,BOS,3,1,-107,-1.5,155,9.5,-115,-105,-103,1.5,-175,4.91,Fenway Park,4,2
2016-06-21,2016,STL,CHC,4,3,133,1.5,-160,9.0,100,-120,-148,-1.5,140,3.86,Wrigley Field,7,1
2016-06-21,2016,TEX,CIN,2,8,-205,-1.5,-115,10.0,-110,-110,175,1.5,-105,6.72,Rangers Ballpark,10,-6
2016-06-21,2016,TB,CLE,0,6,150,1.5,-145,8.0,-110,-110,-170,-1.5,125,3.2,Progressive Field,6,-6
2016-06-21,2016,NYY,COL,4,8,-170,-1.5,115,9.0,-110,-110,150,1.5,-135,5.67,Yankee Stadium,12,-4
2016-06-21,2016,BOS,CWS,1,3,-103,1.5,-175,9.5,-115,-105,-107,-1.5,155,4.82,Fenway Park,4,-2
2016-06-21,2016,SEA,DET,2,4,119,1.5,-170,9.0,-115,-105,-134,-1.5,150,4.11,Comerica Park,6,-2
2016-06-21,2016,LAA,HOU,2,3,145,1.5,-140,8.5,-105,-115,-160,-1.5,120,3.47,Minute Maid Park,5,-1
2016-06-21,2016,NYM,KC,2,1,-142,-1.5,150,7.5,105,-125,127,1.5,-170,4.4,Citi Field,3,1
2016-06-21,2016,HOU,LAA,3,2,-160,-1.5,120,8.5,-105,-115,145,1.5,-140,5.23,Minute Maid Park,5,1
2016-06-21,2016,WSH,LAD,2,3,118,1.5,-170,7.5,-125,105,-133,-1.5,150,3.44,Dodger Stadium,5,-1
2016-06-21,2016,ATL,MIA,3,2,245,1.5,105,7.0,-116,-104,-285,-1.5,-125,2.03,Marlins Park,5,1
2016-06-21,2016,OAK,MIL,5,3,-160,-1.5,120,8.0,-120,100,145,1.5,-140,4.92,Oakland Coliseum,8,2
2016-06-21,2016,PHI,MIN,10,14,117,1.5,-170,8.0,-105,-115,-132,-1.5,150,3.69,Target Field,24,-4
2016-06-21,2016,KC,NYM,1,2,127,1.5,-170,7.5,105,-125,-142,-1.5,150,3.3,Citi Field,3,-1
2016-06-21,2016,COL,NYY,8,4,150,1.5,-135,9.0,-110,-110,-170,-1.5,115,3.6,Yankee Stadium,12,4
2016-06-21,2016,MIL,OAK,3,5,145,1.5,-140,8.0,-120,100,-160,-1.5,120,3.27,Oakland Coliseum,8,-2
2016-06-21,2016,MIN,PHI,14,10,-132,-1.5,150,8.0,-105,-115,117,1.5,-170,4.55,Target Field,24,4
2016-06-21,2016,SF,PIT,15,4,-182,-1.5,-125,8.0,-105,-115,162,1.5,105,5.16,PNC Park,19,11
2016-06-21,2016,BAL,SD,7,10,-180,-1.5,105,10.0,-115,-105,160,1.5,-125,6.43,Camden Yards,17,-3
2016-06-21,2016,DET,SEA,4,2,-134,-1.5,150,9.0,-115,-105,119,1.5,-170,5.15,Comerica Park,6,2
2016-06-21,2016,PIT,SF,4,15,162,1.5,105,8.0,-105,-115,-182,-1.5,-125,3.05,PNC Park,19,-11
2016-06-21,2016,CHC,STL,3,4,-148,-1.5,140,9.0,100,-120,133,1.5,-160,5.37,Wrigley Field,7,-1
2016-06-21,2016,CLE,TB,6,0,-170,-1.5,125,8.0,-110,-110,150,1.5,-145,5.04,Progressive Field,6,6
2016-06-21,2016,CIN,TEX,8,2,175,1.5,-105,10.0,-110,-110,-205,-1.5,-115,3.64,Rangers Ballpark,10,6
2016-06-21,2016,ARI,TOR,4,2,175,1.5,-105,9.0,100,-120,-205,-1.5,-115,3.27,Rogers Centre,6,2
2016-06-21,2016,LAD,WSH,3,2,-133,-1.5,150,7.5,-125,105,118,1.5,-170,4.28,Dodger Stadium,5,1
2016-06-22,2016,TOR,ARI,5,2,-173,-1.5,110,9.0,-115,-105,153,1.5,-130,5.7,Rogers Centre,7,3
2016-06-22,2016,MIA,ATL,3,0,-163,-1.5,130,7.5,105,-125,148,1.5,-150,4.65,Marlins Park,3,3
2016-06-22,2016,SD,BAL,2,7,160,1.5,-125,10.5,-105,-115,-180,-1.5,105,4.04,Camden Yards,9,-5
2016-06-22,2016,CWS,BOS,8,6,112,1.5,-200,9.5,-105,-115,-122,-1.5,170,4.48,Fenway Park,14,2
2016-06-22,2016,STL,CHC,7,2,220,1.5,105,7.5,-115,-105,-260,-1.5,-125,2.34,Wrigley Field,9,5
2016-06-22,2016,TEX,CIN,6,4,-231,-1.5,-127,9.0,-125,105,201,1.5,107,6.28,Rangers Ballpark,10,2
2016-06-22,2016,TB,CLE,1,6,105,1.5,-200,8.5,-105,-115,-115,-1.5,170,4.15,Progressive Field,7,-5
2016-06-22,2016,NYY,COL,9,8,-134,-1.5,155,9.0,-105,-115,119,1.5,-175,5.15,Yankee Stadium,17,1
2016-06-22,2016,BOS,CWS,6,8,-122,-1.5,170,9.5,-105,-115,112,1.5,-200,5.22,Fenway Park,14,-2
2016-06-22,2016,SEA,DET,1,5,116,1.5,-180,9.0,-105,-115,-126,-1.5,160,4.17,Comerica Park,6,-4
2016-06-22,2016,LAA,HOU,2,3,115,1.5,-185,7.5,-105,-115,-130,-1.5,165,3.49,Minute Maid Park,5,-1
2016-06-22,2016,NYM,KC,4,3,-140,-1.5,170,6.0,-110,-110,125,1.5,-200,3.5,Citi Field,7,1
2016-06-22,2016,HOU,LAA,3,2,-130,-1.5,165,7.5,-105,-115,115,1.5,-185,4.24,Minute Maid Park,5,1
2016-06-22,2016,WSH,LAD,3,4,125,1.5,-175,7.5,100,-120,-140,-1.5,155,3.33,Dodger Stadium,7,-1
2016-06-22,2016,ATL,MIA,0,3,148,1.5,-150,7.5,105,-125,-163,-1.5,130,3.02,Marlins Park,3,-3
2016-06-22,2016,OAK,MIL,2,4,-126,-1.5,170,8.0,-120,100,116,1.5,-200,4.46,Oakland Coliseum,6,-2
2016-06-22,2016,PHI,MIN,5,6,150,1.5,-150,9.0,-115,-105,-170,-1.5,130,3.6,Target Field,11,-1
2016-06-22,2016,KC,NYM,3,4,125,1.5,-200,6.0,-110,-110,-140,-1.5,170,2.67,Citi Field,7,-1
2016-06-22,2016,COL,NYY,8,9,119,1.5,-175,9.0,-105,-115,-134,-1.5,155,4.11,Yankee Stadium,17,-1
2016-06-22,2016,MIL,OAK,4,2,116,1.5,-200,8.0,-120,100,-126,-1.5,170,3.7,Oakland Coliseum,6,2
2016-06-22,2016,MIN,PHI,6,5,-170,-1.5,130,9.0,-115,-105,150,1.5,-150,5.67,Target Field,11,1
2016-06-22,2016,SF,PIT,7,6,105,1.5,-210,7.5,-119,-101,-115,-1.5,180,3.66,PNC Park,13,1
2016-06-22,2016,BAL,SD,7,2,-180,-1.5,105,10.5,-105,-115,160,1.5,-125,6.75,Camden Yards,9,5
2016-06-22,2016,DET,SEA,5,1,-126,-1.5,160,9.0,-105,-115,116,1.5,-180,5.02,Comerica Park,6,4
2016-06-22,2016,PIT,SF,6,7,-115,-1.5,180,7.5,-119,-101,105,1.5,-210,4.01,PNC Park,13,-1
2016-06-22,2016,CHC,STL,2,7,-260,-1.5,-125,7.5,-115,-105,220,1.5,105,5.42,Wrigley Field,9,-5
2016-06-22,2016,CLE,TB,6,1,-115,-1.5,170,8.5,-105,-115,105,1.5,-200,4.55,Progressive Field,7,5
2016-06-22,2016,CIN,TEX,4,6,201,1.5,107,9.0,-125,105,-231,-1.5,-127,2.99,Rangers Ballpark,10,-2
2016-06-22,2016,ARI,TOR,2,5,153,1.5,-130,9.0,-115,-105,-173,-1.5,110,3.56,Rogers Centre,7,-3
2016-06-22,2016,LAD,WSH,4,3,-140,-1.5,155,7.5,100,-120,125,1.5,-175,4.38,Dodger Stadium,7,1
2016-06-23,2016,COL,ARI,6,7,145,1.5,-110,11.0,-120,100,-160,-1.5,-110,4.49,Coors Field,13,-1
2016-06-23,2016,NYM,ATL,3,4,-155,-1.5,105,8.0,-120,100,140,1.5,-125,4.86,Turner Field,7,-1
2016-06-23,2016,CWS,BOS,7,8,215,1.5,122,10.5,-110,-110,-255,-1.5,-142,3.33,Fenway Park,15,-1
2016-06-23,2016,MIA,CHC,4,2,151,1.5,-110,7.0,-120,100,-171,-1.5,-110,2.79,Marlins Park,6,2
2016-06-23,2016,SD,CIN,7,4,-112,-1.5,140,9.5,-110,-110,102,1.5,-160,5.02,Great American Ballpark,11,3
2016-06-23,2016,ARI,COL,7,6,-160,-1.5,-110,11.0,-120,100,145,1.5,-110,6.77,Coors Field,13,1
2016-06-23,2016,BOS,CWS,8,7,-255,-1.5,-142,10.5,-110,-110,215,1.5,122,7.54,Fenway Park,15,1
2016-06-23,2016,SEA,DET,4,5,128,1.5,-160,10.0,-104,-116,-143,-1.5,140,4.39,Comerica Park,9,-1
2016-06-23,2016,OAK,LAA,5,4,129,1.5,-160,8.5,-116,-104,-144,-1.5,140,3.71,Angel Stadium,9,1
2016-06-23,2016,CHC,MIA,2,4,-171,-1.5,-110,7.0,-120,100,151,1.5,-110,4.42,Marlins Park,6,-2
2016-06-23,2016,PHI,MIN,7,3,138,1.5,-160,8.0,-110,-110,-153,-1.5,140,3.36,Target Field,10,4
2016-06-23,2016,ATL,NYM,4,3,140,1.5,-125,8.0,-120,100,-155,-1.5,105,3.33,Turner Field,7,1
2016-06-23,2016,LAA,OAK,4,5,-144,-1.5,140,8.5,-116,-104,129,1.5,-160,5.02,Angel Stadium,9,-1
2016-06-23,2016,MIN,PHI,3,7,-153,-1.5,140,8.0,-110,-110,138,1.5,-160,4.84,Target Field,10,-4
2016-06-23,2016,SF,PIT,5,3,131,1.5,-165,8.5,-105,-115,-146,-1.5,145,3.68,PNC Park,8,2
2016-06-23,2016,CIN,SD,4,7,102,1.5,-160,9.5,-110,-110,-112,-1.5,140,4.7,Great American Ballpark,11,-3
2016-06-23,2016,DET,SEA,5,4,-143,-1.5,140,10.0,-104,-116,128,1.5,-160,5.88,Comerica Park,9,1
2016-06-23,2016,PIT,SF,3,5,-146,-1.5,145,8.5,-105,-115,131,1.5,-165,5.04,PNC Park,8,-2
2016-06-24,2016,COL,ARI,9,10,-131,-1.5,145,11.5,-105,-115,116,1.5,-165,6.52,Coors Field,19,-1
2016-06-24,2016,NYM,ATL,8,6,-215,-1.5,-140,8.0,-108,-112,185,1.5,120,5.46,Turner Field,14,2
2016-06-24,2016,TB,BAL,3,6,136,1.5,-145,9.5,-105,-115,-151,-1.5,125,4.03,Camden Yards,9,-3
2016-06-24,2016,TEX,BOS,7,8,170,1.5,110,9.5,100,-120,-200,-1.5,-130,3.52,Rangers Ballpark,15,-1
2016-06-24,2016,MIA,CHC,4,5,135,1.5,-130,8.0,-113,-107,-150,-1.5,110,3.4,Marlins Park,9,-1
2016-06-24,2016,SD,CIN,13,4,115,1.5,-175,9.0,-120,100,-125,-1.5,155,4.19,Great American Ballpark,17,9
2016-06-24,2016,DET,CLE,5,7,-101,1.5,-165,8.0,-110,-110,-109,-1.5,145,4.02,Comerica Park,12,-2
2016-06-24,2016,ARI,COL,10,9,116,1.5,-165,11.5,-105,-115,-131,-1.5,145,5.32,Coors Field,19,1
2016-06-24,2016,TOR,CWS,2,3,-162,-1.5,-105,8.5,-109,-111,147,1.5,-115,5.26,Guaranteed Rate Field,5,-1
2016-06-24,2016,CLE,DET,7,5,-109,-1.5,145,8.0,-110,-110,-101,1.5,-165,4.17,Comerica Park,12,2
2016-06-24,2016,KC,HOU,4,13,115,1.5,-140,8.0,-118,-102,-130,-1.5,120,3.72,Kauffman Stadium,17,-9
2016-06-24,2016,HOU,KC,13,4,-130,-1.5,120,8.0,-118,-102,115,1.5,-140,4.52,Kauffman Stadium,17,9
2016-06-24,2016,OAK,LAA,7,4,138,1.5,-150,9.0,-120,100,-153,-1.5,130,3.78,Angel Stadium,11,3
2016-06-24,2016,PIT,LAD,8,6,-125,-1.5,170,8.5,-105,-115,115,1.5,-200,4.72,PNC Park,14,2
2016-06-24,2016,CHC,MIA,5,4,-150,-1.5,110,8.0,-113,-107,135,1.5,-130,4.8,Marlins Park,9,1
2016-06-24,2016,WSH,MIL,3,5,-185,-1.5,-115,7.5,-105,-115,165,1.5,-105,4.87,Miller Park,8,-2
2016-06-24,2016,NYY,MIN,5,3,-200,-1.5,105,8.0,100,-120,170,1.5,-125,5.33,Yankee Stadium,8,2
2016-06-24,2016,ATL,NYM,6,8,185,1.5,120,8.0,-108,-112,-215,-1.5,-140,2.81,Turner Field,14,-2
2016-06-24,2016,MIN,NYY,3,5,170,1.5,-125,8.0,100,-120,-200,-1.5,105,2.96,Yankee Stadium,8,-2
2016-06-24,2016,LAA,OAK,4,7,-153,-1.5,130,9.0,-120,100,138,1.5,-150,5.44,Angel Stadium,11,-3
2016-06-24,2016,SF,PHI,5,4,-195,-1.5,105,8.0,-110,-110,175,1.5,-125,5.29,AT&T Park,9,1
2016-06-24,2016,LAD,PIT,6,8,115,1.5,-200,8.5,-105,-115,-125,-1.5,170,3.95,PNC Park,14,-2
2016-06-24,2016,CIN,SD,4,13,-125,-1.5,155,9.0,-120,100,115,1.5,-175,5.0,Great American Ballpark,17,-9
2016-06-24,2016,STL,SEA,3,4,-108,-1.5,140,8.5,-105,-115,-102,1.5,-160,4.41,T-Mobile Park,7,-1
2016-06-24,2016,PHI,SF,4,5,175,1.5,-125,8.0,-110,-110,-195,-1.5,105,2.91,AT&T Park,9,-1
2016-06-24,2016,SEA,STL,4,3,-102,1.5,-160,8.5,-105,-115,-108,-1.5,140,4.29,T-Mobile Park,7,1
2016-06-24,2016,BAL,TB,6,3,-151,-1.5,125,9.5,-105,-115,136,1.5,-145,5.72,Camden Yards,9,3
2016-06-24,2016,BOS,TEX,8,7,-200,-1.5,-130,9.5,100,-120,170,1.5,110,6.33,Rangers Ballpark,15,1
2016-06-24,2016,CWS,TOR,3,2,147,1.5,-115,8.5,-109,-111,-162,-1.5,-105,3.44,Guaranteed Rate Field,5,1
2016-06-24,2016,MIL,WSH,5,3,165,1.5,-105,7.5,-105,-115,-185,-1.5,-115,2.83,Miller Park,8,2
2016-06-25,2016,COL,ARI,11,6,-138,-1.5,135,12.0,-120,100,123,1.5,-155,6.96,Coors Field,17,5
2016-06-25,2016,NYM,ATL,1,0,-145,-1.5,115,7.0,-119,-101,130,1.5,-135,4.14,Turner Field,1,1
2016-06-25,2016,TB,BAL,0,5,151,1.5,-140,9.0,-105,-115,-171,-1.5,120,3.59,Camden Yards,5,-5
2016-06-25,2016,TB,BAL,6,8,136,1.5,-160,8.5,-115,-105,-151,-1.5,140,3.6,Camden Yards,14,-2
2016-06-25,2016,TEX,BOS,10,3,111,1.5,-150,9.5,-115,-105,-121,-1.5,130,4.5,Rangers Ballpark,13,7
2016-06-25,2016,MIA,CHC,9,6,173,1.5,110,8.5,100,-120,-203,-1.5,-130,3.11,Marlins Park,15,3
2016-06-25,2016,SD,CIN,3,0,-154,-1.5,105,9.5,100,-120,139,1.5,-125,5.76,Great American Ballpark,3,3
2016-06-25,2016,DET,CLE,0,6,119,1.5,-145,9.0,-110,-110,-134,-1.5,125,4.11,Comerica Park,6,-6
2016-06-25,2016,ARI,COL,6,11,123,1.5,-155,12.0,-120,100,-138,-1.5,135,5.38,Coors Field,17,-5
2016-06-25,2016,TOR,CWS,10,8,-116,-1.5,145,9.0,-125,105,106,1.5,-165,4.83,Guaranteed Rate Field,18,2
2016-06-25,2016,CLE,DET,6,0,-134,-1.5,125,9.0,-110,-110,119,1.5,-145,5.15,Comerica Park,6,6
2016-06-25,2016,KC,HOU,5,13,114,1.5,-145,9.0,100,-120,-124,-1.5,125,4.21,Kauffman Stadium,18,-8
2016-06-25,2016,HOU,KC,13,5,-124,-1.5,125,9.0,100,-120,114,1.5,-145,4.98,Kauffman Stadium,18,8
2016-06-25,2016,OAK,LAA,7,3,125,1.5,-165,9.0,-110,-110,-140,-1.5,145,4.0,Angel Stadium,10,4
2016-06-25,2016,PIT,LAD,6,1,140,1.5,-120,8.0,100,-120,-155,-1.5,100,3.33,PNC Park,7,5
2016-06-25,2016,CHC,MIA,6,9,-203,-1.5,-130,8.5,100,-120,173,1.5,110,5.69,Marlins Park,15,-3
2016-06-25,2016,WSH,MIL,5,6,-140,-1.5,115,9.5,-110,-110,125,1.5,-135,5.54,Miller Park,11,-1
2016-06-25,2016,NYY,MIN,2,1,-200,-1.5,-110,9.0,-115,-105,170,1.5,-110,6.0,Yankee Stadium,3,1
2016-06-25,2016,ATL,NYM,0,1,130,1.5,-135,7.0,-119,-101,-145,-1.5,115,3.04,Turner Field,1,-1
2016-06-25,2016,MIN,NYY,1,2,170,1.5,-110,9.0,-115,-105,-200,-1.5,-110,3.33,Yankee Stadium,3,-1
2016-06-25,2016,LAA,OAK,3,7,-140,-1.5,145,9.0,-110,-110,125,1.5,-165,5.25,Angel Stadium,10,-4
2016-06-25,2016,SF,PHI,2,3,-310,-1.5,-143,7.0,105,-125,260,1.5,123,5.29,AT&T Park,5,-1
2016-06-25,2016,LAD,PIT,1,6,-155,-1.5,100,8.0,100,-120,140,1.5,-120,4.86,PNC Park,7,-5
2016-06-25,2016,CIN,SD,0,3,139,1.5,-125,9.5,100,-120,-154,-1.5,105,3.97,Great American Ballpark,3,-3
2016-06-25,2016,STL,SEA,4,5,116,1.5,-185,8.5,-105,-115,-126,-1.5,165,3.94,T-Mobile Park,9,-1
2016-06-25,2016,PHI,SF,3,2,260,1.5,123,7.0,105,-125,-310,-1.5,-143,1.94,AT&T Park,5,1
2016-06-25,2016,SEA,STL,5,4,-126,-1.5,165,8.5,-105,-115,116,1.5,-185,4.74,T-Mobile Park,9,1
2016-06-25,2016,BAL,TB,5,0,-171,-1.5,120,9.0,-105,-115,151,1.5,-140,5.68,Camden Yards,5,5
2016-06-25,2016,BAL,TB,8,6,-151,-1.5,140,8.5,-115,-105,136,1.5,-160,5.11,Camden Yards,14,2
2016-06-25,2016,BOS,TEX,3,10,-121,-1.5,130,9.5,-115,-105,111,1.5,-150,5.2,Rangers Ballpark,13,-7
2016-06-25,2016,CWS,TOR,8,10,106,1.5,-165,9.0,-125,105,-116,-1.5,145,4.37,Guaranteed Rate Field,18,-2
2016-06-25,2016,MIL,WSH,6,5,125,1.5,-135,9.5,-110,-110,-140,-1.5,115,4.22,Miller Park,11,1
2016-06-26,2016,COL,ARI,9,7,-131,-1.5,140,12.5,-105,-115,116,1.5,-160,7.09,Coors Field,16,2
2016-06-26,2016,NYM,ATL,2,5,-121,-1.5,140,7.5,-110,-110,111,1.5,-160,4.11,Turner Field,7,-3
2016-06-26,2016,TB,BAL,5,12,118,1.5,-175,9.0,-110,-110,-128,-1.5,155,4.13,Camden Yards,17,-7
2016-06-26,2016,TEX,BOS,6,2,-120,-1.5,160,10.5,100,-120,110,1.5,-180,5.73,Rangers Ballpark,8,4
2016-06-26,2016,MIA,CHC,6,1,-150,-1.5,160,6.5,-120,100,135,1.5,-180,3.9,Marlins Park,7,5
2016-06-26,2016,SD,CIN,0,3,126,1.5,-170,9.5,-105,-115,-141,-1.5,150,4.2,Great American Ballpark,3,-3
2016-06-26,2016,DET,CLE,3,9,-146,-1.5,140,8.5,-109,-111,131,1.5,-160,5.04,Comerica Park,12,-6
2016-06-26,2016,ARI,COL,7,9,116,1.5,-160,12.5,-105,-115,-131,-1.5,140,5.79,Coors Field,16,-2
2016-06-26,2016,TOR,CWS,2,5,101,1.5,-210,9.0,-105,-115,-111,-1.5,180,4.48,Guaranteed Rate Field,7,-3
2016-06-26,2016,CLE,DET,9,3,131,1.5,-160,8.5,-109,-111,-146,-1.5,140,3.68,Comerica Park,12,6
2016-06-26,2016,KC,HOU,6,1,-105,1.5,-174,8.5,-110,-110,-105,-1.5,154,4.35,Kauffman Stadium,7,5
2016-06-26,2016,HOU,KC,1,6,-105,-1.5,154,8.5,-110,-110,-105,1.5,-174,4.35,Kauffman Stadium,7,-5
2016-06-26,2016,OAK,LAA,6,7,104,1.5,-210,8.5,100,-120,-114,-1.5,180,4.17,Angel Stadium,13,-1
2016-06-26,2016,PIT,LAD,4,3,230,1.5,120,7.0,105,-125,-270,-1.5,-139,2.12,PNC Park,7,1
2016-06-26,2016,CHC,MIA,1,6,135,1.5,-180,6.5,-120,100,-150,-1.5,160,2.77,Marlins Park,7,-5
2016-06-26,2016,WSH,MIL,3,2,-142,-1.5,115,9.5,-105,-115,127,1.5,-135,5.57,Miller Park,5,1
2016-06-26,2016,NYY,MIN,1,7,-195,-1.5,-101,9.5,100,-120,175,1.5,-119,6.28,Yankee Stadium,8,-6
2016-06-26,2016,ATL,NYM,5,2,111,1.5,-160,7.5,-110,-110,-121,-1.5,140,3.55,Turner Field,7,3
2016-06-26,2016,MIN,NYY,7,1,175,1.5,-119,9.5,100,-120,-195,-1.5,-101,3.45,Yankee Stadium,8,6
2016-06-26,2016,LAA,OAK,7,6,-114,-1.5,180,8.5,100,-120,104,1.5,-210,4.53,Angel Stadium,13,1
2016-06-26,2016,SF,PHI,8,7,-230,-1.5,101,6.5,-119,-101,200,1.5,-121,4.53,AT&T Park,15,1
2016-06-26,2016,LAD,PIT,3,4,-270,-1.5,-139,7.0,105,-125,230,1.5,120,5.11,PNC Park,7,-1
2016-06-26,2016,CIN,SD,3,0,-141,-1.5,150,9.5,-105,-115,126,1.5,-170,5.56,Great American Ballpark,3,3
2016-06-26,2016,STL,SEA,11,6,106,1.5,-205,8.0,100,-120,-116,-1.5,175,3.88,T-Mobile Park,17,5
2016-06-26,2016,PHI,SF,7,8,200,1.5,-121,6.5,-119,-101,-230,-1.5,101,2.17,AT&T Park,15,-1
2016-06-26,2016,SEA,STL,6,11,-116,-1.5,175,8.0,100,-120,106,1.5,-205,4.3,T-Mobile Park,17,-5
2016-06-26,2016,BAL,TB,12,5,-128,-1.5,155,9.0,-110,-110,118,1.5,-175,5.05,Camden Yards,17,7
2016-06-26,2016,BOS,TEX,2,6,110,1.5,-180,10.5,100,-120,-120,-1.5,160,5.0,Rangers Ballpark,8,-4
2016-06-26,2016,CWS,TOR,5,2,-111,-1.5,180,9.0,-105,-115,101,1.5,-210,4.73,Guaranteed Rate Field,7,3
2016-06-26,2016,MIL,WSH,2,3,127,1.5,-135,9.5,-105,-115,-142,-1.5,115,4.19,Miller Park,5,-1
2016-06-27,2016,PHI,ARI,8,0,115,1.5,-175,8.5,-105,-115,-130,-1.5,155,3.95,Chase Field,8,8
2016-06-27,2016,CLE,ATL,8,3,-144,-1.5,120,7.5,-110,-110,129,1.5,-140,4.43,Turner Field,11,5
2016-06-27,2016,TB,BOS,13,7,-109,-1.5,185,8.0,-119,-101,-101,1.5,-215,4.17,Tropicana Field,20,6
2016-06-27,2016,CIN,CHC,8,11,250,1.5,150,8.5,-105,-115,-290,-1.5,-170,2.43,Great American Ballpark,19,-3
2016-06-27,2016,CHC,CIN,11,8,-290,-1.5,-170,8.5,-105,-115,250,1.5,150,6.32,Great American Ballpark,19,3
2016-06-27,2016,ATL,CLE,3,8,129,1.5,-140,7.5,-110,-110,-144,-1.5,120,3.28,Turner Field,11,-5
2016-06-27,2016,TOR,COL,5,9,-122,-1.5,130,11.0,-123,103,112,1.5,-150,6.05,Coors Field,14,-4
2016-06-27,2016,LAA,HOU,2,4,-113,-1.5,180,7.5,-115,-105,103,1.5,-210,3.98,Angel Stadium,6,-2
2016-06-27,2016,STL,KC,2,6,119,1.5,-180,8.0,-120,100,-129,-1.5,160,3.65,Kauffman Stadium,8,-4
2016-06-27,2016,HOU,LAA,4,2,103,1.5,-210,7.5,-115,-105,-113,-1.5,180,3.69,Angel Stadium,6,2
2016-06-27,2016,PIT,LAD,4,5,-110,-1.5,170,8.5,-110,-110,100,1.5,-200,4.45,PNC Park,9,-1
2016-06-27,2016,WSH,NYM,11,4,105,1.5,-165,7.5,-105,-115,-115,-1.5,145,3.66,Nationals Park,15,7
2016-06-27,2016,TEX,NYY,9,6,119,1.5,-180,10.0,101,-121,-129,-1.5,160,4.57,Yankee Stadium,15,3
2016-06-27,2016,SF,OAK,3,8,-170,-1.5,130,7.5,100,-120,150,1.5,-150,4.72,AT&T Park,11,-5
2016-06-27,2016,ARI,PHI,0,8,-130,-1.5,155,8.5,-105,-115,115,1.5,-175,4.8,Chase Field,8,-8
2016-06-27,2016,LAD,PIT,5,4,100,1.5,-200,8.5,-110,-110,-110,-1.5,170,4.25,PNC Park,9,1
2016-06-27,2016,OAK,SF,8,3,150,1.5,-150,7.5,100,-120,-170,-1.5,130,3.0,AT&T Park,11,5
2016-06-27,2016,KC,STL,6,2,-129,-1.5,160,8.0,-120,100,119,1.5,-180,4.51,Kauffman Stadium,8,4
2016-06-27,2016,BOS,TB,7,13,-101,1.5,-215,8.0,-119,-101,-109,-1.5,185,4.02,Tropicana Field,20,-6
2016-06-27,2016,NYY,TEX,6,9,-129,-1.5,160,10.0,101,-121,119,1.5,-180,5.63,Yankee Stadium,15,-3
2016-06-27,2016,COL,TOR,9,5,112,1.5,-150,11.0,-123,103,-122,-1.5,130,5.19,Coors Field,14,4
2016-06-27,2016,NYM,WSH,4,11,-115,-1.5,145,7.5,-105,-115,105,1.5,-165,4.01,Nationals Park,15,-7
2016-06-28,2016,PHI,ARI,4,3,185,1.5,-120,7.5,-110,-110,-215,-1.5,100,2.63,Chase Field,7,1
2016-06-28,2016,CLE,ATL,5,3,-219,-1.5,-135,7.5,-124,104,189,1.5,115,5.15,Turner Field,8,2
2016-06-28,2016,SD,BAL,7,11,140,1.5,-120,8.5,-120,100,-155,-1.5,100,3.54,PETCO Park,18,-4
2016-06-28,2016,TB,BOS,2,8,-105,1.5,-175,7.5,-110,-110,-105,-1.5,155,3.84,Tropicana Field,10,-6
2016-06-28,2016,CIN,CHC,2,7,200,1.5,120,9.0,105,-125,-230,-1.5,-140,3.0,Great American Ballpark,9,-5
2016-06-28,2016,CHC,CIN,7,2,-230,-1.5,-140,9.0,105,-125,200,1.5,120,6.27,Great American Ballpark,9,5
2016-06-28,2016,ATL,CLE,3,5,189,1.5,115,7.5,-124,104,-219,-1.5,-135,2.6,Turner Field,8,-2
2016-06-28,2016,TOR,COL,14,9,-144,-1.5,105,12.5,-125,105,129,1.5,-125,7.38,Coors Field,23,5
2016-06-28,2016,MIN,CWS,4,0,163,1.5,-130,8.0,-110,-110,-183,-1.5,110,3.04,Guaranteed Rate Field,4,4
2016-06-28,2016,MIA,DET,5,7,102,1.5,-200,10.0,-120,100,-112,-1.5,170,4.95,Comerica Park,12,-2
2016-06-28,2016,LAA,HOU,1,7,117,1.5,-135,9.0,-115,-105,-127,-1.5,115,4.15,Angel Stadium,8,-6
2016-06-28,2016,STL,KC,8,4,-107,-1.5,150,8.0,-105,-115,-103,1.5,-170,4.14,Kauffman Stadium,12,4
2016-06-28,2016,HOU,LAA,7,1,-127,-1.5,115,9.0,-115,-105,117,1.5,-135,5.04,Angel Stadium,8,6
2016-06-28,2016,MIL,LAD,5,6,132,1.5,-130,8.5,100,-120,-147,-1.5,110,3.66,Miller Park,11,-1
2016-06-28,2016,DET,MIA,7,5,-112,-1.5,170,10.0,-120,100,102,1.5,-200,5.28,Comerica Park,12,2
2016-06-28,2016,LAD,MIL,6,5,-147,-1.5,110,8.5,100,-120,132,1.5,-130,5.06,Miller Park,11,1
2016-06-28,2016,CWS,MIN,0,4,-183,-1.5,110,8.0,-110,-110,163,1.5,-130,5.17,Guaranteed Rate Field,4,-4
2016-06-28,2016,WSH,NYM,5,0,-118,-1.5,170,8.5,-115,-105,108,1.5,-200,4.6,Nationals Park,5,5
2016-06-28,2016,TEX,NYY,7,1,-122,-1.5,135,8.0,-110,-110,112,1.5,-155,4.4,Yankee Stadium,8,6
2016-06-28,2016,SF,OAK,11,13,-143,-1.5,150,8.0,-105,-115,128,1.5,-170,4.71,AT&T Park,24,-2
2016-06-28,2016,ARI,PHI,3,4,-215,-1.5,100,7.5,-110,-110,185,1.5,-120,5.12,Chase Field,7,-1
2016-06-28,2016,SEA,PIT,5,2,-170,-1.5,120,8.0,-110,-110,150,1.5,-140,5.04,T-Mobile Park,7,3
2016-06-28,2016,BAL,SD,11,7,-155,-1.5,100,8.5,-120,100,140,1.5,-120,5.17,PETCO Park,18,4
2016-06-28,2016,PIT,SEA,2,5,150,1.5,-140,8.0,-110,-110,-170,-1.5,120,3.2,T-Mobile Park,7,-3
2016-06-28,2016,OAK,SF,13,11,128,1.5,-170,8.0,-105,-115,-143,-1.5,150,3.51,AT&T Park,24,2
2016-06-28,2016,KC,STL,4,8,-103,1.5,-170,8.0,-105,-115,-107,-1.5,150,4.06,Kauffman Stadium,12,-4
2016-06-28,2016,BOS,TB,8,2,-105,-1.5,155,7.5,-110,-110,-105,1.5,-175,3.84,Tropicana Field,10,6
2016-06-28,2016,NYY,TEX,1,7,112,1.5,-155,8.0,-110,-110,-122,-1.5,135,3.77,Yankee Stadium,8,-6
2016-06-28,2016,COL,TOR,9,14,129,1.5,-125,12.5,-125,105,-144,-1.5,105,5.46,Coors Field,23,-5
2016-06-28,2016,NYM,WSH,0,5,108,1.5,-200,8.5,-115,-105,-118,-1.5,170,4.09,Nationals Park,5,-5
2016-06-29,2016,PHI,ARI,9,8,154,1.5,-130,9.0,-120,100,-174,-1.5,110,3.54,Chase Field,17,1
2016-06-29,2016,CLE,ATL,3,0,-212,-1.5,-130,8.0,100,-120,182,1.5,111,5.44,Turner Field,3,3
2016-06-29,2016,SD,BAL,6,12,126,1.5,-140,9.5,-105,-115,-141,-1.5,120,4.2,PETCO Park,18,-6
2016-06-29,2016,TB,BOS,4,0,167,1.5,-105,8.0,100,-120,-187,-1.5,-115,3.0,Tropicana Field,4,4
2016-06-29,2016,CIN,CHC,2,9,162,1.5,-104,9.0,-105,-115,-182,-1.5,-116,3.44,Great American Ballpark,11,-7
2016-06-29,2016,CHC,CIN,9,2,-182,-1.5,-116,9.0,-105,-115,162,1.5,-104,5.81,Great American Ballpark,11,7
2016-06-29,2016,ATL,CLE,0,3,182,1.5,111,8.0,100,-120,-212,-1.5,-130,2.84,Turner Field,3,-3
2016-06-29,2016,TOR,COL,5,3,-116,-1.5,135,12.0,100,-120,106,1.5,-155,6.44,Coors Field,8,2
2016-06-29,2016,MIN,CWS,6,9,-101,1.5,-210,9.0,-105,-115,-109,-1.5,180,4.52,Guaranteed Rate Field,15,-3
2016-06-29,2016,MIA,DET,3,10,119,1.5,-160,10.0,-110,-110,-134,-1.5,140,4.57,Comerica Park,13,-7
2016-06-29,2016,LAA,HOU,4,10,125,1.5,-135,9.0,-123,103,-140,-1.5,115,4.0,Angel Stadium,14,-6
2016-06-29,2016,STL,KC,2,3,-173,-1.5,115,8.0,100,-120,153,1.5,-135,5.07,Busch Stadium,5,-1
2016-06-29,2016,HOU,LAA,10,4,-140,-1.5,115,9.0,-123,103,125,1.5,-135,5.25,Angel Stadium,14,6
2016-06-29,2016,MIL,LAD,7,0,-111,-1.5,180,8.5,-120,100,101,1.5,-210,4.47,Miller Park,7,7
2016-06-29,2016,DET,MIA,10,3,-134,-1.5,140,10.0,-110,-110,119,1.5,-160,5.73,Comerica Park,13,7
2016-06-29,2016,LAD,MIL,0,7,101,1.5,-210,8.5,-120,100,-111,-1.5,180,4.23,Miller Park,7,-7
2016-06-29,2016,CWS,MIN,9,6,-109,-1.5,180,9.0,-105,-115,-101,1.5,-210,4.69,Guaranteed Rate Field,15,3
2016-06-29,2016,WSH,NYM,4,2,-285,-1.5,-131,8.0,-120,100,245,1.5,111,5.92,Nationals Park,6,2
2016-06-29,2016,TEX,NYY,7,9,175,1.5,-115,9.0,-124,104,-195,-1.5,-105,3.27,Yankee Stadium,16,-2
2016-06-29,2016,SF,OAK,1,7,118,1.5,-180,8.0,100,-120,-133,-1.5,160,3.67,Oakland Coliseum,8,-6
2016-06-29,2016,ARI,PHI,8,9,-174,-1.5,110,9.0,-120,100,154,1.5,-130,5.72,Chase Field,17,-1
2016-06-29,2016,SEA,PIT,1,8,-133,-1.5,155,8.5,-115,-105,118,1.5,-175,4.85,T-Mobile Park,9,-7
2016-06-29,2016,BAL,SD,12,6,-141,-1.5,120,9.5,-105,-115,126,1.5,-140,5.56,PETCO Park,18,6
2016-06-29,2016,PIT,SEA,8,1,118,1.5,-175,8.5,-115,-105,-133,-1.5,155,3.9,T-Mobile Park,9,7
2016-06-29,2016,OAK,SF,7,1,-133,-1.5,160,8.0,100,-120,118,1.5,-180,4.57,Oakland Coliseum,8,6
2016-06-29,2016,KC,STL,3,2,153,1.5,-135,8.0,100,-120,-173,-1.5,115,3.16,Busch Stadium,5,1
2016-06-29,2016,BOS,TB,0,4,-187,-1.5,-115,8.0,100,-120,167,1.5,-105,5.21,Tropicana Field,4,-4
2016-06-29,2016,NYY,TEX,9,7,-195,-1.5,-105,9.0,-124,104,175,1.5,-115,5.95,Yankee Stadium,16,2
2016-06-29,2016,COL,TOR,3,5,106,1.5,-155,12.0,100,-120,-116,-1.5,135,5.83,Coors Field,8,-2
2016-06-29,2016,NYM,WSH,2,4,245,1.5,111,8.0,-120,100,-285,-1.5,-131,2.32,Nationals Park,6,-2
2016-06-30,2016,MIA,ATL,5,8,-170,-1.5,-110,8.5,-128,108,150,1.5,-110,5.35,Turner Field,13,-3
2016-06-30,2016,SEA,BAL,5,3,-116,-1.5,180,8.0,-115,-105,106,1.5,-210,4.3,T-Mobile Park,8,2
2016-06-30,2016,NYM,CHC,4,3,125,1.5,-130,7.5,105,-125,-140,-1.5,110,3.33,Citi Field,7,1
2016-06-30,2016,WSH,CIN,13,4,-201,-1.5,-102,8.5,-120,100,171,1.5,-118,5.68,Nationals Park,17,9
2016-06-30,2016,TOR,CLE,1,4,112,1.5,-145,8.5,-110,-110,-122,-1.5,125,4.01,Rogers Centre,5,-3
2016-06-30,2016,MIN,CWS,5,6,141,1.5,-145,9.0,-125,105,-156,-1.5,125,3.73,Guaranteed Rate Field,11,-1
2016-06-30,2016,TB,DET,7,10,-112,-1.5,180,8.5,100,-120,102,1.5,-210,4.49,Tropicana Field,17,-3
2016-06-30,2016,STL,KC,2,4,-142,-1.5,150,8.5,-115,-105,127,1.5,-170,4.99,Busch Stadium,6,-2
2016-06-30,2016,MIL,LAD,1,8,127,1.5,-140,8.5,-115,-105,-142,-1.5,120,3.74,Miller Park,9,-7
2016-06-30,2016,ATL,MIA,8,5,150,1.5,-110,8.5,-128,108,-170,-1.5,-110,3.4,Turner Field,13,3
2016-06-30,2016,LAD,MIL,8,1,-142,-1.5,120,8.5,-115,-105,127,1.5,-140,4.99,Miller Park,9,7
2016-06-30,2016,CWS,MIN,6,5,-156,-1.5,125,9.0,-125,105,141,1.5,-145,5.48,Guaranteed Rate Field,11,1
2016-06-30,2016,CHC,NYM,3,4,-140,-1.5,110,7.5,105,-125,125,1.5,-130,4.38,Citi Field,7,-1
2016-06-30,2016,TEX,NYY,1,2,146,1.5,-145,9.0,-105,-115,-161,-1.5,125,3.66,Yankee Stadium,3,-1
2016-06-30,2016,SF,OAK,12,6,-150,-1.5,103,7.5,-105,-115,135,1.5,-122,4.5,Oakland Coliseum,18,6
2016-06-30,2016,BAL,SEA,3,5,106,1.5,-210,8.0,-115,-105,-116,-1.5,180,3.88,T-Mobile Park,8,-2
2016-06-30,2016,OAK,SF,6,12,135,1.5,-122,7.5,-105,-115,-150,-1.5,103,3.19,Oakland Coliseum,18,-6
2016-06-30,2016,KC,STL,4,2,127,1.5,-170,8.5,-115,-105,-142,-1.5,150,3.74,Busch Stadium,6,2
2016-06-30,2016,DET,TB,10,7,102,1.5,-210,8.5,100,-120,-112,-1.5,180,4.21,Tropicana Field,17,3
2016-06-30,2016,NYY,TEX,2,1,-161,-1.5,125,9.0,-105,-115,146,1.5,-145,5.55,Yankee Stadium,3,1
2016-06-30,2016,CLE,TOR,4,1,-122,-1.5,125,8.5,-110,-110,112,1.5,-145,4.67,Rogers Centre,5,3
2016-06-30,2016,CIN,WSH,4,13,171,1.5,-118,8.5,-120,100,-201,-1.5,-102,3.14,Nationals Park,17,-9
2016-07-01,2016,SF,ARI,6,4,-146,-1.5,110,8.0,-120,100,131,1.5,-130,4.75,Chase Field,10,2
2016-07-01,2016,MIA,ATL,7,5,117,1.5,-205,8.5,-119,-101,-127,-1.5,175,3.92,Turner Field,12,2
2016-07-01,2016,SEA,BAL,5,2,103,1.5,-165,8.0,-120,100,-113,-1.5,145,3.94,T-Mobile Park,7,3
2016-07-01,2016,LAA,BOS,4,5,175,1.5,-110,10.0,-120,100,-205,-1.5,-110,3.64,Fenway Park,9,-1
2016-07-01,2016,NYM,CHC,10,2,-119,-1.5,180,7.0,-119,-101,109,1.5,-210,3.8,Citi Field,12,8
2016-07-01,2016,WSH,CIN,3,2,-180,-1.5,110,8.5,-118,-102,160,1.5,-130,5.46,Nationals Park,5,1
2016-07-01,2016,TOR,CLE,1,2,-140,-1.5,135,9.0,-105,-115,125,1.5,-155,5.25,Rogers Centre,3,-1
2016-07-01,2016,LAD,COL,5,0,-180,-1.5,120,7.5,-105,-115,160,1.5,-140,4.82,Dodger Stadium,5,5
2016-07-01,2016,HOU,CWS,5,0,-195,-1.5,102,8.5,-110,-110,175,1.5,-122,5.62,Minute Maid Park,5,5
2016-07-01,2016,TB,DET,2,10,-114,-1.5,175,8.5,-105,-115,104,1.5,-205,4.53,Tropicana Field,12,-8
2016-07-01,2016,CWS,HOU,0,5,175,1.5,-122,8.5,-110,-110,-195,-1.5,102,3.09,Minute Maid Park,5,-5
2016-07-01,2016,PHI,KC,4,3,111,1.5,-155,8.0,-120,100,-121,-1.5,135,3.79,Citizens Bank Park,7,1
2016-07-01,2016,BOS,LAA,5,4,-205,-1.5,-110,10.0,-120,100,175,1.5,-110,6.72,Fenway Park,9,1
2016-07-01,2016,COL,LAD,0,5,160,1.5,-140,7.5,-105,-115,-180,-1.5,120,2.88,Dodger Stadium,5,-5
2016-07-01,2016,ATL,MIA,5,7,-127,-1.5,175,8.5,-119,-101,117,1.5,-205,4.76,Turner Field,12,-2
2016-07-01,2016,STL,MIL,7,1,-195,-1.5,100,8.5,-110,-110,175,1.5,-120,5.62,Busch Stadium,8,6
2016-07-01,2016,TEX,MIN,3,2,-122,-1.5,135,9.5,-105,-115,112,1.5,-155,5.22,Target Field,5,1
2016-07-01,2016,CHC,NYM,2,10,109,1.5,-210,7.0,-119,-101,-119,-1.5,180,3.35,Citi Field,12,-8
2016-07-01,2016,SD,NYY,7,6,135,1.5,-130,7.5,-105,-115,-150,-1.5,110,3.19,PETCO Park,13,1
2016-07-01,2016,PIT,OAK,7,3,141,1.5,-155,8.0,-120,100,-156,-1.5,135,3.32,Oakland Coliseum,10,4
2016-07-01,2016,KC,PHI,3,4,-121,-1.5,135,8.0,-120,100,111,1.5,-155,4.38,Citizens Bank Park,7,-1
2016-07-01,2016,OAK,PIT,3,7,-156,-1.5,135,8.0,-120,100,141,1.5,-155,4.88,Oakland Coliseum,10,-4
2016-07-01,2016,NYY,SD,6,7,-150,-1.5,110,7.5,-105,-115,135,1.5,-130,4.5,PETCO Park,13,-1
2016-07-01,2016,BAL,SEA,2,5,-113,-1.5,145,8.0,-120,100,103,1.5,-165,4.24,T-Mobile Park,7,-3
2016-07-01,2016,ARI,SF,4,6,131,1.5,-130,8.0,-120,100,-146,-1.5,110,3.46,Chase Field,10,-2
2016-07-01,2016,MIL,STL,1,7,175,1.5,-120,8.5,-110,-110,-195,-1.5,100,3.09,Busch Stadium,8,-6
2016-07-01,2016,DET,TB,10,2,104,1.5,-205,8.5,-105,-115,-114,-1.5,175,4.17,Tropicana Field,12,8
2016-07-01,2016,MIN,TEX,2,3,112,1.5,-155,9.5,-105,-115,-122,-1.5,135,4.48,Target Field,5,-1
2016-07-01,2016,CLE,TOR,2,1,125,1.5,-155,9.0,-105,-115,-140,-1.5,135,4.0,Rogers Centre,3,1
2016-07-01,2016,CIN,WSH,2,3,160,1.5,-130,8.5,-118,-102,-180,-1.5,110,3.27,Nationals Park,5,-1
2016-07-02,2016,SF,ARI,5,6,-107,-1.5,150,8.5,-120,100,-103,1.5,-170,4.39,Chase Field,11,-1
2016-07-02,2016,MIA,ATL,1,9,-280,-1.5,-155,8.0,-103,-117,240,1.5,135,5.89,Turner Field,10,-8
2016-07-02,2016,SEA,BAL,12,6,-145,-1.5,145,8.0,-120,100,130,1.5,-165,4.73,T-Mobile Park,18,6
2016-07-02,2016,LAA,BOS,21,2,143,1.5,-145,10.5,-110,-110,-158,-1.5,125,4.32,Fenway Park,23,19
2016-07-02,2016,NYM,CHC,4,3,200,1.5,120,7.5,105,-125,-230,-1.5,-140,2.5,Citi Field,7,1
2016-07-02,2016,WSH,CIN,4,9,-215,-1.5,-102,8.5,-110,-110,185,1.5,-118,5.8,Nationals Park,13,-5
2016-07-02,2016,TOR,CLE,9,6,-173,-1.5,115,9.0,-115,-105,153,1.5,-135,5.7,Rogers Centre,15,3
2016-07-02,2016,LAD,COL,6,1,-177,-1.5,125,7.5,105,-125,157,1.5,-145,4.79,Dodger Stadium,7,5
2016-07-02,2016,HOU,CWS,6,7,-105,1.5,-175,7.5,-105,-115,-105,-1.5,155,3.84,Minute Maid Park,13,-1
2016-07-02,2016,TB,DET,2,3,117,1.5,-140,8.5,-115,-105,-127,-1.5,120,3.92,Tropicana Field,5,-1
2016-07-02,2016,CWS,HOU,7,6,-105,-1.5,155,7.5,-105,-115,-105,1.5,-175,3.84,Minute Maid Park,13,1
2016-07-02,2016,PHI,KC,2,6,138,1.5,-119,7.5,100,-120,-153,-1.5,-101,3.15,Citizens Bank Park,8,-4
2016-07-02,2016,BOS,LAA,2,21,-158,-1.5,125,10.5,-110,-110,143,1.5,-145,6.43,Fenway Park,23,-19
2016-07-02,2016,COL,LAD,1,6,157,1.5,-145,7.5,105,-125,-177,-1.5,125,2.92,Dodger Stadium,7,-5
2016-07-02,2016,ATL,MIA,9,1,240,1.5,135,8.0,-103,-117,-280,-1.5,-155,2.35,Turner Field,10,8
2016-07-02,2016,STL,MIL,3,0,-185,-1.5,110,8.0,-110,-110,165,1.5,-130,5.19,Busch Stadium,3,3
2016-07-02,2016,TEX,MIN,5,17,109,1.5,-180,9.5,100,-120,-119,-1.5,160,4.55,Target Field,22,-12
2016-07-02,2016,CHC,NYM,3,4,-230,-1.5,-140,7.5,105,-125,200,1.5,120,5.23,Citi Field,7,-1
2016-07-02,2016,SD,NYY,2,1,-144,-1.5,155,7.0,-120,100,129,1.5,-175,4.13,PETCO Park,3,1
2016-07-02,2016,PIT,OAK,4,2,141,1.5,-151,8.5,100,-120,-156,-1.5,131,3.53,Oakland Coliseum,6,2
2016-07-02,2016,KC,PHI,6,2,-153,-1.5,-101,7.5,100,-120,138,1.5,-119,4.54,Citizens Bank Park,8,4
2016-07-02,2016,OAK,PIT,2,4,-156,-1.5,131,8.5,100,-120,141,1.5,-151,5.18,Oakland Coliseum,6,-2
2016-07-02,2016,NYY,SD,1,2,129,1.5,-175,7.0,-120,100,-144,-1.5,155,3.06,PETCO Park,3,-1
2016-07-02,2016,BAL,SEA,6,12,130,1.5,-165,8.0,-120,100,-145,-1.5,145,3.48,T-Mobile Park,18,-6
2016-07-02,2016,ARI,SF,6,5,-103,1.5,-170,8.5,-120,100,-107,-1.5,150,4.31,Chase Field,11,1
2016-07-02,2016,MIL,STL,0,3,165,1.5,-130,8.0,-110,-110,-185,-1.5,110,3.02,Busch Stadium,3,-3
2016-07-02,2016,DET,TB,3,2,-127,-1.5,120,8.5,-115,-105,117,1.5,-140,4.76,Tropicana Field,5,1
2016-07-02,2016,MIN,TEX,17,5,-119,-1.5,160,9.5,100,-120,109,1.5,-180,5.16,Target Field,22,12
2016-07-02,2016,CLE,TOR,6,9,153,1.5,-135,9.0,-115,-105,-173,-1.5,115,3.56,Rogers Centre,15,-3
2016-07-02,2016,CIN,WSH,9,4,185,1.5,-118,8.5,-110,-110,-215,-1.5,-102,2.98,Nationals Park,13,5
2016-07-03,2016,SF,ARI,5,4,116,1.5,-185,8.5,-115,-105,-126,-1.5,165,3.94,Chase Field,9,1
2016-07-03,2016,MIA,ATL,5,2,-163,-1.5,-110,9.0,110,-130,148,1.5,-110,5.58,Fort Bragg Field,7,3
2016-07-03,2016,SEA,BAL,9,4,-146,-1.5,135,8.5,-115,-105,131,1.5,-155,5.04,T-Mobile Park,13,5
2016-07-03,2016,LAA,BOS,5,10,-104,1.5,-200,11.0,100,-120,-106,-1.5,170,5.61,Fenway Park,15,-5
2016-07-03,2016,NYM,CHC,14,3,-103,1.5,-163,6.5,106,-126,-107,-1.5,145,3.3,Citi Field,17,11
2016-07-03,2016,WSH,CIN,12,1,-320,-1.5,-152,8.0,-115,-105,270,1.5,132,6.1,Nationals Park,13,11
2016-07-03,2016,TOR,CLE,17,1,101,1.5,-165,8.0,-110,-110,-111,-1.5,145,3.98,Rogers Centre,18,16
2016-07-03,2016,LAD,COL,4,1,-177,-1.5,130,7.5,110,-130,157,1.5,-150,4.79,Dodger Stadium,5,3
2016-07-03,2016,HOU,CWS,1,4,-115,-1.5,170,7.5,-110,-110,105,1.5,-200,4.01,Minute Maid Park,5,-3
2016-07-03,2016,TB,DET,1,5,-183,-1.5,115,8.5,-120,100,163,1.5,-135,5.5,Tropicana Field,6,-4
2016-07-03,2016,CWS,HOU,4,1,105,1.5,-200,7.5,-110,-110,-115,-1.5,170,3.66,Minute Maid Park,5,3
2016-07-03,2016,PHI,KC,7,2,-110,-1.5,185,7.5,-105,-115,100,1.5,-215,3.93,Citizens Bank Park,9,5
2016-07-03,2016,BOS,LAA,10,5,-106,-1.5,170,11.0,100,-120,-104,1.5,-200,5.66,Fenway Park,15,5
2016-07-03,2016,COL,LAD,1,4,157,1.5,-150,7.5,110,-130,-177,-1.5,130,2.92,Dodger Stadium,5,-3
2016-07-03,2016,ATL,MIA,2,5,148,1.5,-110,9.0,110,-130,-163,-1.5,-110,3.63,Fort Bragg Field,7,-3
2016-07-03,2016,STL,MIL,9,8,-182,-1.5,105,8.0,-120,100,162,1.5,-125,5.16,Busch Stadium,17,1
2016-07-03,2016,TEX,MIN,4,5,-164,-1.5,-112,8.5,-120,100,149,1.5,-108,5.28,Target Field,9,-1
2016-07-03,2016,CHC,NYM,3,14,-107,-1.5,145,6.5,106,-126,-103,1.5,-163,3.36,Citi Field,17,-11
2016-07-03,2016,SD,NYY,3,6,116,1.5,-145,8.0,100,-120,-126,-1.5,125,3.7,PETCO Park,9,-3
2016-07-03,2016,PIT,OAK,6,3,128,1.5,-155,8.5,-110,-110,-143,-1.5,135,3.73,Oakland Coliseum,9,3
2016-07-03,2016,KC,PHI,2,7,100,1.5,-215,7.5,-105,-115,-110,-1.5,185,3.75,Citizens Bank Park,9,-5
2016-07-03,2016,OAK,PIT,3,6,-143,-1.5,135,8.5,-110,-110,128,1.5,-155,5.0,Oakland Coliseum,9,-3
2016-07-03,2016,NYY,SD,6,3,-126,-1.5,125,8.0,100,-120,116,1.5,-145,4.46,PETCO Park,9,3
2016-07-03,2016,BAL,SEA,4,9,131,1.5,-155,8.5,-115,-105,-146,-1.5,135,3.68,T-Mobile Park,13,-5
2016-07-03,2016,ARI,SF,4,5,-126,-1.5,165,8.5,-115,-105,116,1.5,-185,4.74,Chase Field,9,-1
2016-07-03,2016,MIL,STL,8,9,162,1.5,-125,8.0,-120,100,-182,-1.5,105,3.05,Busch Stadium,17,-1
2016-07-03,2016,DET,TB,5,1,163,1.5,-135,8.5,-120,100,-183,-1.5,115,3.23,Tropicana Field,6,4
2016-07-03,2016,MIN,TEX,5,4,149,1.5,-108,8.5,-120,100,-164,-1.5,-112,3.41,Target Field,9,1
2016-07-03,2016,CLE,TOR,1,17,-111,-1.5,145,8.0,-110,-110,101,1.5,-165,4.21,Rogers Centre,18,-16
2016-07-03,2016,CIN,WSH,1,12,270,1.5,132,8.0,-115,-105,-320,-1.5,-152,2.16,Nationals Park,13,-11
2016-07-04,2016,SD,ARI,8,4,126,1.5,-150,9.5,-120,100,-141,-1.5,130,4.2,Chase Field,12,4
2016-07-04,2016,PHI,ATL,8,2,-184,-1.5,110,8.0,-120,100,164,1.5,-130,5.18,Citizens Bank Park,10,6
2016-07-04,2016,LAD,BAL,7,5,-175,-1.5,120,8.0,-110,-110,155,1.5,-140,5.09,Dodger Stadium,12,2
2016-07-04,2016,TEX,BOS,5,12,190,1.5,-110,11.5,-101,-119,-220,-1.5,-110,3.97,Fenway Park,17,-7
2016-07-04,2016,CIN,CHC,4,10,200,1.5,-110,8.5,-115,-105,-230,-1.5,-110,2.83,Wrigley Field,14,-6
2016-07-04,2016,CHC,CIN,10,4,-230,-1.5,-110,8.5,-115,-105,200,1.5,-110,5.92,Wrigley Field,14,6
2016-07-04,2016,DET,CLE,3,5,175,1.5,-121,8.5,-110,-110,-195,-1.5,101,3.09,Progressive Field,8,-2
2016-07-04,2016,SF,COL,3,1,-121,-1.5,170,8.0,100,-120,111,1.5,-200,4.38,AT&T Park,4,2
2016-07-04,2016,NYY,CWS,2,8,-120,-1.5,130,10.0,-101,-119,110,1.5,-150,5.45,Guaranteed Rate Field,10,-6
2016-07-04,2016,CLE,DET,5,3,-195,-1.5,101,8.5,-110,-110,175,1.5,-121,5.62,Progressive Field,8,2
2016-07-04,2016,SEA,HOU,1,2,128,1.5,-160,8.5,-110,-110,-143,-1.5,140,3.73,Minute Maid Park,3,-1
2016-07-04,2016,TOR,KC,6,2,-202,-1.5,-109,8.5,-115,-105,172,1.5,-111,5.69,Rogers Centre,8,4
2016-07-04,2016,TB,LAA,4,2,-121,-1.5,175,8.5,-120,100,111,1.5,-205,4.65,Tropicana Field,6,2
2016-07-04,2016,BAL,LAD,5,7,155,1.5,-140,8.0,-110,-110,-175,-1.5,120,3.14,Dodger Stadium,12,-2
2016-07-04,2016,NYM,MIA,8,6,-179,-1.5,114,8.5,-110,-110,159,1.5,-133,5.45,Citi Field,14,2
2016-07-04,2016,WSH,MIL,0,1,-260,-1.5,-110,7.0,-130,110,220,1.5,-110,5.06,Nationals Park,1,-1
2016-07-04,2016,OAK,MIN,3,1,102,1.5,-185,10.5,-110,-110,-112,-1.5,165,5.2,Target Field,4,2
2016-07-04,2016,MIA,NYM,6,8,159,1.5,-133,8.5,-110,-110,-179,-1.5,114,3.28,Citi Field,14,-2
2016-07-04,2016,CWS,NYY,8,2,110,1.5,-150,10.0,-101,-119,-120,-1.5,130,4.76,Guaranteed Rate Field,10,6
2016-07-04,2016,MIN,OAK,1,3,-112,-1.5,165,10.5,-110,-110,102,1.5,-185,5.55,Target Field,4,-2
2016-07-04,2016,ATL,PHI,2,8,164,1.5,-130,8.0,-120,100,-184,-1.5,110,3.03,Citizens Bank Park,10,-6
2016-07-04,2016,STL,PIT,2,4,-185,-1.5,110,8.5,-125,105,165,1.5,-130,5.52,Busch Stadium,6,-2
2016-07-04,2016,ARI,SD,4,8,-141,-1.5,130,9.5,-120,100,126,1.5,-150,5.56,Chase Field,12,-4
2016-07-04,2016,HOU,SEA,2,1,-143,-1.5,140,8.5,-110,-110,128,1.5,-160,5.0,Minute Maid Park,3,1
2016-07-04,2016,COL,SF,1,3,111,1.5,-200,8.0,100,-120,-121,-1.5,170,3.79,AT&T Park,4,-2
2016-07-04,2016,PIT,STL,4,2,165,1.5,-130,8.5,-125,105,-185,-1.5,110,3.21,Busch Stadium,6,2
2016-07-04,2016,LAA,TB,2,4,111,1.5,-205,8.5,-120,100,-121,-1.5,175,4.03,Tropicana Field,6,-2
2016-07-04,2016,BOS,TEX,12,5,-220,-1.5,-110,11.5,-101,-119,190,1.5,-110,7.91,Fenway Park,17,7
2016-07-04,2016,KC,TOR,2,6,172,1.5,-111,8.5,-115,-105,-202,-1.5,-109,3.13,Rogers Centre,8,-4
2016-07-04,2016,MIL,WSH,1,0,220,1.5,-110,7.0,-130,110,-260,-1.5,-110,2.19,Nationals Park,1,1
2016-07-05,2016,SD,ARI,5,7,138,1.5,-155,10.0,-120,100,-153,-1.5,135,4.2,Chase Field,12,-2
2016-07-05,2016,PHI,ATL,5,1,-101,1.5,-160,9.0,-110,-110,-109,-1.5,140,4.52,Citizens Bank Park,6,4
2016-07-05,2016,LAD,BAL,1,4,-142,-1.5,146,7.5,110,-130,127,1.5,-166,4.4,Dodger Stadium,5,-3
2016-07-05,2016,TEX,BOS,7,2,185,1.5,-105,9.5,-110,-110,-215,-1.5,-115,3.33,Fenway Park,9,5
2016-07-05,2016,CIN,CHC,9,5,275,1.5,130,9.5,-125,105,-325,-1.5,-150,2.53,Wrigley Field,14,4
2016-07-05,2016,CHC,CIN,5,9,-325,-1.5,-150,9.5,-125,105,275,1.5,130,7.26,Wrigley Field,14,-4
2016-07-05,2016,DET,CLE,1,12,170,1.5,-125,8.5,-110,-110,-190,-1.5,105,3.15,Progressive Field,13,-11
2016-07-05,2016,SF,COL,3,7,-215,-1.5,105,7.0,-106,-114,185,1.5,-125,4.78,AT&T Park,10,-4
2016-07-05,2016,NYY,CWS,9,0,-118,-1.5,135,8.0,-115,-105,108,1.5,-155,4.33,Guaranteed Rate Field,9,9
2016-07-05,2016,CLE,DET,12,1,-190,-1.5,105,8.5,-110,-110,170,1.5,-125,5.57,Progressive Field,13,11
2016-07-05,2016,SEA,HOU,2,5,127,1.5,-175,7.5,-106,-114,-142,-1.5,155,3.3,Minute Maid Park,7,-3
2016-07-05,2016,TOR,KC,8,3,-150,-1.5,125,9.5,-125,105,135,1.5,-145,5.7,Rogers Centre,11,5
2016-07-05,2016,TB,LAA,5,13,-187,-1.5,110,8.5,-110,-110,167,1.5,-130,5.54,Tropicana Field,18,-8
2016-07-05,2016,BAL,LAD,4,1,127,1.5,-166,7.5,110,-130,-142,-1.5,146,3.3,Dodger Stadium,5,3
2016-07-05,2016,NYM,MIA,2,5,-147,-1.5,140,7.5,-110,-110,132,1.5,-160,4.46,Citi Field,7,-3
2016-07-05,2016,WSH,MIL,2,5,-170,-1.5,120,8.5,-110,-110,150,1.5,-140,5.35,Nationals Park,7,-3
2016-07-05,2016,OAK,MIN,4,11,-120,-1.5,130,10.0,-105,-115,110,1.5,-150,5.45,Target Field,15,-7
2016-07-05,2016,MIA,NYM,5,2,132,1.5,-160,7.5,-110,-110,-147,-1.5,140,3.23,Citi Field,7,3
2016-07-05,2016,CWS,NYY,0,9,108,1.5,-155,8.0,-115,-105,-118,-1.5,135,3.85,Guaranteed Rate Field,9,-9
2016-07-05,2016,MIN,OAK,11,4,110,1.5,-150,10.0,-105,-115,-120,-1.5,130,4.76,Target Field,15,7
2016-07-05,2016,ATL,PHI,1,5,-109,-1.5,140,9.0,-110,-110,-101,1.5,-160,4.69,Citizens Bank Park,6,-4
2016-07-05,2016,STL,PIT,2,5,-140,-1.5,155,9.0,-105,-115,125,1.5,-175,5.25,Busch Stadium,7,-3
2016-07-05,2016,ARI,SD,7,5,-153,-1.5,135,10.0,-120,100,138,1.5,-155,6.05,Chase Field,12,2
2016-07-05,2016,HOU,SEA,5,2,-142,-1.5,155,7.5,-106,-114,127,1.5,-175,4.4,Minute Maid Park,7,3
2016-07-05,2016,COL,SF,7,3,185,1.5,-125,7.0,-106,-114,-215,-1.5,105,2.46,AT&T Park,10,4
2016-07-05,2016,PIT,STL,5,2,125,1.5,-175,9.0,-105,-115,-140,-1.5,155,4.0,Busch Stadium,7,3
2016-07-05,2016,LAA,TB,13,5,167,1.5,-130,8.5,-110,-110,-187,-1.5,110,3.18,Tropicana Field,18,8
2016-07-05,2016,BOS,TEX,2,7,-215,-1.5,-115,9.5,-110,-110,185,1.5,-105,6.48,Fenway Park,9,-5
2016-07-05,2016,KC,TOR,3,8,135,1.5,-145,9.5,-125,105,-150,-1.5,125,4.04,Rogers Centre,11,-5
2016-07-05,2016,MIL,WSH,5,2,150,1.5,-140,8.5,-110,-110,-170,-1.5,120,3.4,Nationals Park,7,3
2016-07-06,2016,SD,ARI,13,6,103,1.5,-200,9.5,-120,100,-113,-1.5,170,4.68,Chase Field,19,7
2016-07-06,2016,PHI,ATL,4,3,-180,-1.5,105,9.0,-125,105,160,1.5,-125,5.79,Citizens Bank Park,7,1
2016-07-06,2016,LAD,BAL,4,6,-109,-1.5,190,7.5,-110,-110,-101,1.5,-230,3.91,Dodger Stadium,10,-2
2016-07-06,2016,TEX,BOS,6,11,175,1.5,-110,10.5,-110,-110,-195,-1.5,-110,3.82,Fenway Park,17,-5
2016-07-06,2016,CIN,CHC,5,3,164,1.5,-119,10.5,-120,100,-184,-1.5,-101,3.98,Wrigley Field,8,2
2016-07-06,2016,CHC,CIN,3,5,-184,-1.5,-101,10.5,-120,100,164,1.5,-119,6.8,Wrigley Field,8,-2
2016-07-06,2016,DET,CLE,12,2,106,1.5,-205,9.0,-114,-106,-116,-1.5,175,4.37,Progressive Field,14,10
2016-07-06,2016,SF,COL,5,1,-205,-1.5,105,7.0,-105,-115,175,1.5,-125,4.7,AT&T Park,6,4
2016-07-06,2016,NYY,CWS,0,5,-170,-1.5,-115,8.5,-119,-101,150,1.5,-105,5.35,Guaranteed Rate Field,5,-5
2016-07-06,2016,CLE,DET,2,12,-116,-1.5,175,9.0,-114,-106,106,1.5,-205,4.83,Progressive Field,14,-10
2016-07-06,2016,SEA,HOU,8,9,138,1.5,-150,9.0,100,-120,-153,-1.5,130,3.78,Minute Maid Park,17,-1
2016-07-06,2016,TOR,KC,4,2,-175,-1.5,110,8.5,-110,-110,155,1.5,-130,5.41,Rogers Centre,6,2
2016-07-06,2016,TB,LAA,2,7,-150,-1.5,135,9.0,-125,105,135,1.5,-155,5.4,Tropicana Field,9,-5
2016-07-06,2016,BAL,LAD,6,4,-101,1.5,-230,7.5,-110,-110,-109,-1.5,190,3.77,Dodger Stadium,10,2
2016-07-06,2016,NYM,MIA,4,2,-245,-1.5,-126,8.0,-125,105,205,1.5,106,5.68,Citi Field,6,2
2016-07-06,2016,WSH,MIL,7,4,-230,-1.5,-122,9.5,-110,-110,200,1.5,102,6.62,Nationals Park,11,3
2016-07-06,2016,OAK,MIN,0,4,-103,1.5,-215,9.0,-122,102,-107,-1.5,185,4.57,Target Field,4,-4
2016-07-06,2016,MIA,NYM,2,4,205,1.5,106,8.0,-125,105,-245,-1.5,-126,2.62,Citi Field,6,-2
2016-07-06,2016,CWS,NYY,5,0,150,1.5,-105,8.5,-119,-101,-170,-1.5,-115,3.4,Guaranteed Rate Field,5,5
2016-07-06,2016,MIN,OAK,4,0,-107,-1.5,185,9.0,-122,102,-103,1.5,-215,4.65,Target Field,4,4
2016-07-06,2016,ATL,PHI,3,4,160,1.5,-125,9.0,-125,105,-180,-1.5,105,3.46,Citizens Bank Park,7,-1
2016-07-06,2016,STL,PIT,5,7,-175,-1.5,125,8.5,-115,-105,155,1.5,-145,5.41,Busch Stadium,12,-2
2016-07-06,2016,ARI,SD,6,13,-113,-1.5,170,9.5,-120,100,103,1.5,-200,5.04,Chase Field,19,-7
2016-07-06,2016,HOU,SEA,9,8,-153,-1.5,130,9.0,100,-120,138,1.5,-150,5.44,Minute Maid Park,17,1
2016-07-06,2016,COL,SF,1,5,175,1.5,-125,7.0,-105,-115,-205,-1.5,105,2.55,AT&T Park,6,-4
2016-07-06,2016,PIT,STL,7,5,155,1.5,-145,8.5,-115,-105,-175,-1.5,125,3.33,Busch Stadium,12,2
2016-07-06,2016,LAA,TB,7,2,135,1.5,-155,9.0,-125,105,-150,-1.5,135,3.83,Tropicana Field,9,5
2016-07-06,2016,BOS,TEX,11,6,-195,-1.5,-110,10.5,-110,-110,175,1.5,-110,6.94,Fenway Park,17,5
2016-07-06,2016,KC,TOR,2,4,155,1.5,-130,8.5,-110,-110,-175,-1.5,110,3.33,Rogers Centre,6,-2
2016-07-06,2016,MIL,WSH,4,7,200,1.5,102,9.5,-110,-110,-230,-1.5,-122,3.17,Nationals Park,11,-3
2016-07-07,2016,CHC,ATL,3,4,-270,-1.5,-133,9.5,-105,-115,230,1.5,113,6.93,Wrigley Field,7,-1
2016-07-07,2016,ATL,CHC,4,3,230,1.5,113,9.5,-105,-115,-270,-1.5,-133,2.88,Wrigley Field,7,1
2016-07-07,2016,NYY,CLE,5,4,128,1.5,-166,9.0,-105,-115,-143,-1.5,146,3.95,Progressive Field,9,1
2016-07-07,2016,PHI,COL,2,11,150,1.5,-120,12.5,-105,-115,-170,-1.5,100,5.0,Coors Field,13,-9
2016-07-07,2016,TOR,DET,5,4,-125,-1.5,160,9.5,-115,-105,115,1.5,-180,5.28,Rogers Centre,9,1
2016-07-07,2016,OAK,HOU,3,1,108,1.5,-205,8.5,-115,-105,-118,-1.5,175,4.09,Minute Maid Park,4,2
2016-07-07,2016,SEA,KC,3,4,119,1.5,-175,8.5,-110,-110,-134,-1.5,155,3.88,Kauffman Stadium,7,-1
2016-07-07,2016,TB,LAA,1,5,-109,-1.5,185,8.5,-119,-101,-101,1.5,-215,4.43,Tropicana Field,6,-4
2016-07-07,2016,SD,LAD,6,0,133,1.5,-175,7.5,-115,-105,-148,-1.5,155,3.22,Dodger Stadium,6,6
2016-07-07,2016,TEX,MIN,1,10,-118,-1.5,160,11.0,-105,-115,108,1.5,-180,5.95,Rangers Ballpark,11,-9
2016-07-07,2016,WSH,NYM,7,9,-116,-1.5,140,9.0,-110,-110,106,1.5,-160,4.83,Citi Field,16,-2
2016-07-07,2016,CLE,NYY,4,5,-143,-1.5,146,9.0,-105,-115,128,1.5,-166,5.3,Progressive Field,9,-1
2016-07-07,2016,HOU,OAK,1,3,-118,-1.5,175,8.5,-115,-105,108,1.5,-205,4.6,Minute Maid Park,4,-2
2016-07-07,2016,COL,PHI,11,2,-170,-1.5,100,12.5,-105,-115,150,1.5,-120,7.87,Coors Field,13,9
2016-07-07,2016,STL,PIT,5,1,-132,-1.5,160,8.5,-110,-110,117,1.5,-180,4.84,Busch Stadium,6,4
2016-07-07,2016,LAD,SD,0,6,-148,-1.5,155,7.5,-115,-105,133,1.5,-175,4.48,Dodger Stadium,6,-6
2016-07-07,2016,KC,SEA,4,3,-134,-1.5,155,8.5,-110,-110,119,1.5,-175,4.87,Kauffman Stadium,7,1
2016-07-07,2016,PIT,STL,1,5,117,1.5,-180,8.5,-110,-110,-132,-1.5,160,3.92,Busch Stadium,6,-4
2016-07-07,2016,LAA,TB,5,1,-101,1.5,-215,8.5,-119,-101,-109,-1.5,185,4.27,Tropicana Field,6,4
2016-07-07,2016,MIN,TEX,10,1,108,1.5,-180,11.0,-105,-115,-118,-1.5,160,5.29,Rangers Ballpark,11,9
2016-07-07,2016,DET,TOR,4,5,115,1.5,-180,9.5,-115,-105,-125,-1.5,160,4.42,Rogers Centre,9,-1
2016-07-07,2016,NYM,WSH,9,7,106,1.5,-160,9.0,-110,-110,-116,-1.5,140,4.37,Citi Field,16,2
2016-07-08,2016,SF,ARI,6,2,-145,-1.5,150,7.5,-105,-115,130,1.5,-170,4.44,AT&T Park,8,4
2016-07-08,2016,CWS,ATL,8,11,-290,-1.5,-130,8.0,-110,-110,250,1.5,110,5.95,Guaranteed Rate Field,19,-3
2016-07-08,2016,LAA,BAL,9,5,-103,1.5,-200,10.0,-117,-103,-107,-1.5,170,5.07,Camden Yards,14,4
2016-07-08,2016,TB,BOS,5,6,-103,1.5,-205,10.5,100,-120,-107,-1.5,175,5.33,Fenway Park,11,-1
2016-07-08,2016,PIT,CHC,8,4,177,1.5,115,8.0,-120,100,-207,-1.5,-135,2.89,PNC Park,12,4
2016-07-08,2016,MIA,CIN,3,1,-275,-1.5,-134,7.0,-117,-103,235,1.5,114,5.13,Marlins Park,4,2
2016-07-08,2016,NYY,CLE,2,10,150,1.5,-140,8.0,-120,100,-170,-1.5,120,3.2,Progressive Field,12,-8
2016-07-08,2016,PHI,COL,5,3,137,1.5,-145,11.0,-125,105,-152,-1.5,125,4.64,Coors Field,8,2
2016-07-08,2016,ATL,CWS,11,8,250,1.5,110,8.0,-110,-110,-290,-1.5,-130,2.29,Guaranteed Rate Field,19,3
2016-07-08,2016,TOR,DET,6,0,-195,-1.5,-110,10.5,-112,-108,175,1.5,-110,6.94,Rogers Centre,6,6
2016-07-08,2016,OAK,HOU,9,10,153,1.5,-140,8.5,100,-120,-173,-1.5,120,3.36,Minute Maid Park,19,-1
2016-07-08,2016,SEA,KC,3,2,-113,-1.5,150,8.5,-120,100,103,1.5,-170,4.51,Kauffman Stadium,5,1
2016-07-08,2016,BAL,LAA,5,9,-107,-1.5,170,10.0,-117,-103,-103,1.5,-200,5.17,Camden Yards,14,-4
2016-07-08,2016,SD,LAD,6,10,165,1.5,-130,8.0,-105,-115,-185,-1.5,110,3.02,Dodger Stadium,16,-4
2016-07-08,2016,CIN,MIA,1,3,235,1.5,114,7.0,-117,-103,-275,-1.5,-134,2.09,Marlins Park,4,-2
2016-07-08,2016,STL,MIL,3,4,-124,-1.5,130,9.0,-105,-115,114,1.5,-150,4.98,Miller Park,7,-1
2016-07-08,2016,TEX,MIN,6,5,-195,-1.5,-110,9.0,-120,100,175,1.5,-110,5.95,Rangers Ballpark,11,1
2016-07-08,2016,WSH,NYM,3,1,100,1.5,-230,7.0,105,-125,-110,-1.5,190,3.5,Citi Field,4,2
2016-07-08,2016,CLE,NYY,10,2,-170,-1.5,120,8.0,-120,100,150,1.5,-140,5.04,Progressive Field,12,8
2016-07-08,2016,HOU,OAK,10,9,-173,-1.5,120,8.5,100,-120,153,1.5,-140,5.39,Minute Maid Park,19,1
2016-07-08,2016,COL,PHI,3,5,-152,-1.5,125,11.0,-125,105,137,1.5,-145,6.63,Coors Field,8,-2
2016-07-08,2016,CHC,PIT,4,8,-207,-1.5,-135,8.0,-120,100,177,1.5,115,5.39,PNC Park,12,-4
2016-07-08,2016,LAD,SD,10,6,-185,-1.5,110,8.0,-105,-115,165,1.5,-130,5.19,Dodger Stadium,16,4
2016-07-08,2016,KC,SEA,2,3,103,1.5,-170,8.5,-120,100,-113,-1.5,150,4.19,Kauffman Stadium,5,-1
2016-07-08,2016,ARI,SF,2,6,130,1.5,-170,7.5,-105,-115,-145,-1.5,150,3.26,AT&T Park,8,-4
2016-07-08,2016,MIL,STL,4,3,114,1.5,-150,9.0,-105,-115,-124,-1.5,130,4.21,Miller Park,7,1
2016-07-08,2016,BOS,TB,6,5,-107,-1.5,175,10.5,100,-120,-103,1.5,-205,5.43,Fenway Park,11,1
2016-07-08,2016,MIN,TEX,5,6,175,1.5,-110,9.0,-120,100,-195,-1.5,-110,3.27,Rangers Ballpark,11,-1
2016-07-08,2016,DET,TOR,0,6,175,1.5,-110,10.5,-112,-108,-195,-1.5,-110,3.82,Rogers Centre,6,-6
2016-07-08,2016,NYM,WSH,1,3,-110,-1.5,190,7.0,105,-125,100,1.5,-230,3.67,Citi Field,4,-2
2016-07-09,2016,SF,ARI,4,2,-140,-1.5,160,7.5,-117,-103,125,1.5,-180,4.38,AT&T Park,6,2
2016-07-09,2016,CWS,ATL,5,4,-184,-1.5,115,7.5,105,-125,164,1.5,-135,4.86,Guaranteed Rate Field,9,1
2016-07-09,2016,LAA,BAL,2,3,112,1.5,-178,10.5,-115,-105,-122,-1.5,158,4.95,Camden Yards,5,-1
2016-07-09,2016,TB,BOS,1,4,167,1.5,-122,10.0,100,-120,-187,-1.5,102,3.75,Fenway Park,5,-3
2016-07-09,2016,PIT,CHC,12,6,150,1.5,-110,9.0,-115,-105,-170,-1.5,-110,3.6,PNC Park,18,6
2016-07-09,2016,MIA,CIN,4,2,-166,-1.5,120,9.0,105,-125,151,1.5,-140,5.62,Marlins Park,6,2
2016-07-09,2016,NYY,CLE,7,6,154,1.5,-135,7.5,-110,-110,-169,-1.5,115,2.95,Progressive Field,13,1
2016-07-09,2016,PHI,COL,3,8,145,1.5,-135,11.5,-120,100,-160,-1.5,115,4.69,Coors Field,11,-5
2016-07-09,2016,ATL,CWS,4,5,164,1.5,-135,7.5,105,-125,-184,-1.5,115,2.84,Guaranteed Rate Field,9,-1
2016-07-09,2016,TOR,DET,2,3,-260,-1.5,-145,10.0,-115,-105,220,1.5,125,7.22,Rogers Centre,5,-1
2016-07-09,2016,OAK,HOU,3,2,180,1.5,-115,8.0,-120,100,-210,-1.5,-105,2.86,Minute Maid Park,5,1
2016-07-09,2016,SEA,KC,3,5,-117,-1.5,130,9.5,-125,105,107,1.5,-150,5.12,Kauffman Stadium,8,-2
2016-07-09,2016,BAL,LAA,3,2,-122,-1.5,158,10.5,-115,-105,112,1.5,-178,5.77,Camden Yards,5,1
2016-07-09,2016,SD,LAD,3,4,209,1.5,-105,8.5,-119,-101,-239,-1.5,-115,2.75,Dodger Stadium,7,-1
2016-07-09,2016,CIN,MIA,2,4,151,1.5,-140,9.0,105,-125,-166,-1.5,120,3.59,Marlins Park,6,-2
2016-07-09,2016,STL,MIL,8,1,-141,-1.5,110,9.0,100,-120,126,1.5,-130,5.27,Miller Park,9,7
2016-07-09,2016,TEX,MIN,6,8,-159,-1.5,124,10.5,105,-125,144,1.5,-143,6.45,Rangers Ballpark,14,-2
2016-07-09,2016,WSH,NYM,6,1,-210,-1.5,-130,8.0,-124,104,180,1.5,110,5.42,Citi Field,7,5
2016-07-09,2016,CLE,NYY,6,7,-169,-1.5,115,7.5,-110,-110,154,1.5,-135,4.71,Progressive Field,13,-1
2016-07-09,2016,HOU,OAK,2,3,-210,-1.5,-105,8.0,-120,100,180,1.5,-115,5.42,Minute Maid Park,5,-1
2016-07-09,2016,COL,PHI,8,3,-160,-1.5,115,11.5,-120,100,145,1.5,-135,7.08,Coors Field,11,5
2016-07-09,2016,CHC,PIT,6,12,-170,-1.5,-110,9.0,-115,-105,150,1.5,-110,5.67,PNC Park,18,-6
2016-07-09,2016,LAD,SD,4,3,-239,-1.5,-115,8.5,-119,-101,209,1.5,-105,5.99,Dodger Stadium,7,1
2016-07-09,2016,KC,SEA,5,3,107,1.5,-150,9.5,-125,105,-117,-1.5,130,4.59,Kauffman Stadium,8,2
2016-07-09,2016,ARI,SF,2,4,125,1.5,-180,7.5,-117,-103,-140,-1.5,160,3.33,AT&T Park,6,-2
2016-07-09,2016,MIL,STL,1,8,126,1.5,-130,9.0,100,-120,-141,-1.5,110,3.98,Miller Park,9,-7
2016-07-09,2016,BOS,TB,4,1,-187,-1.5,102,10.0,100,-120,167,1.5,-122,6.52,Fenway Park,5,3
2016-07-09,2016,MIN,TEX,8,6,144,1.5,-143,10.5,105,-125,-159,-1.5,124,4.3,Rangers Ballpark,14,2
2016-07-09,2016,DET,TOR,3,2,220,1.5,125,10.0,-115,-105,-260,-1.5,-145,3.13,Rogers Centre,5,1
2016-07-09,2016,NYM,WSH,1,6,180,1.5,110,8.0,-124,104,-210,-1.5,-130,2.86,Citi Field,7,-5
2016-07-10,2016,SF,ARI,4,0,-255,-1.5,-115,7.5,-105,-115,215,1.5,-105,5.39,AT&T Park,4,4
2016-07-10,2016,CWS,ATL,0,2,-163,-1.5,120,9.5,-110,-110,148,1.5,-140,5.89,Guaranteed Rate Field,2,-2
2016-07-10,2016,LAA,BAL,2,4,170,1.5,-101,10.5,-126,106,-200,-1.5,-119,3.89,Camden Yards,6,-2
2016-07-10,2016,TB,BOS,0,4,200,1.5,-110,8.5,-120,100,-230,-1.5,-110,2.83,Fenway Park,4,-4
2016-07-10,2016,PIT,CHC,5,6,137,1.5,-125,9.0,-115,-105,-152,-1.5,105,3.8,PNC Park,11,-1
2016-07-10,2016,MIA,CIN,7,3,-139,-1.5,150,9.0,105,-125,124,1.5,-170,5.23,Marlins Park,10,4
2016-07-10,2016,NYY,CLE,11,7,126,1.5,-175,7.5,100,-120,-141,-1.5,155,3.32,Progressive Field,18,4
2016-07-10,2016,PHI,COL,10,3,175,1.5,100,13.5,-101,-119,-205,-1.5,-120,4.91,Coors Field,13,7
2016-07-10,2016,ATL,CWS,2,0,148,1.5,-140,9.5,-110,-110,-163,-1.5,120,3.83,Guaranteed Rate Field,2,2
2016-07-10,2016,TOR,DET,6,1,-140,-1.5,140,10.0,100,-120,125,1.5,-160,5.83,Rogers Centre,7,5
2016-07-10,2016,OAK,HOU,1,2,175,1.5,-125,8.5,-105,-115,-195,-1.5,105,3.09,Minute Maid Park,3,-1
2016-07-10,2016,SEA,KC,8,5,-122,-1.5,130,10.0,-115,-105,112,1.5,-150,5.5,Kauffman Stadium,13,3
2016-07-10,2016,BAL,LAA,4,2,-200,-1.5,-119,10.5,-126,106,170,1.5,-101,7.0,Camden Yards,6,2
2016-07-10,2016,SD,LAD,1,3,200,1.5,-102,8.0,-120,100,-230,-1.5,-118,2.67,Dodger Stadium,4,-2
2016-07-10,2016,CIN,MIA,3,7,124,1.5,-170,9.0,105,-125,-139,-1.5,150,4.02,Marlins Park,10,-4
2016-07-10,2016,STL,MIL,5,1,125,1.5,-170,8.5,-115,-105,-140,-1.5,150,3.78,Miller Park,6,4
2016-07-10,2016,TEX,MIN,5,15,-163,-1.5,110,10.5,100,-120,148,1.5,-130,6.51,Rangers Ballpark,20,-10
2016-07-10,2016,WSH,NYM,3,2,-113,-1.5,150,8.0,100,-120,103,1.5,-170,4.24,Citi Field,5,1
2016-07-10,2016,CLE,NYY,7,11,-141,-1.5,155,7.5,100,-120,126,1.5,-175,4.39,Progressive Field,18,-4
2016-07-10,2016,HOU,OAK,2,1,-195,-1.5,105,8.5,-105,-115,175,1.5,-125,5.62,Minute Maid Park,3,1
2016-07-10,2016,COL,PHI,3,10,-205,-1.5,-120,13.5,-101,-119,175,1.5,100,9.07,Coors Field,13,-7
2016-07-10,2016,CHC,PIT,6,5,-152,-1.5,105,9.0,-115,-105,137,1.5,-125,5.43,PNC Park,11,1
2016-07-10,2016,LAD,SD,3,1,-230,-1.5,-118,8.0,-120,100,200,1.5,-102,5.58,Dodger Stadium,4,2
2016-07-10,2016,KC,SEA,5,8,112,1.5,-150,10.0,-115,-105,-122,-1.5,130,4.72,Kauffman Stadium,13,-3
2016-07-10,2016,ARI,SF,0,4,215,1.5,-105,7.5,-105,-115,-255,-1.5,-115,2.38,AT&T Park,4,-4
2016-07-10,2016,MIL,STL,1,5,-140,-1.5,150,8.5,-115,-105,125,1.5,-170,4.96,Miller Park,6,-4
2016-07-10,2016,BOS,TB,4,0,-230,-1.5,-110,8.5,-120,100,200,1.5,-110,5.92,Fenway Park,4,4
2016-07-10,2016,MIN,TEX,15,5,148,1.5,-130,10.5,100,-120,-163,-1.5,110,4.23,Rangers Ballpark,20,10
2016-07-10,2016,DET,TOR,1,6,125,1.5,-160,10.0,100,-120,-140,-1.5,140,4.44,Rogers Centre,7,-5
2016-07-10,2016,NYM,WSH,2,3,103,1.5,-170,8.0,100,-120,-113,-1.5,150,3.94,Citi Field,5,-1
2016-07-15,2016,LAD,ARI,13,7,-134,-1.5,120,9.0,-120,100,119,1.5,-140,5.15,Chase Field,20,6
2016-07-15,2016,COL,ATL,11,2,-106,-1.5,145,8.0,-115,-105,-104,1.5,-165,4.12,Turner Field,13,9
2016-07-15,2016,TB,BAL,3,4,-128,-1.5,155,8.5,100,-120,118,1.5,-175,4.77,Tropicana Field,7,-1
2016-07-15,2016,NYY,BOS,3,5,-147,-1.5,125,9.0,-105,-115,132,1.5,-145,5.36,Yankee Stadium,8,-2
2016-07-15,2016,TEX,CHC,0,6,170,1.5,-120,8.5,-104,-116,-200,-1.5,100,3.15,Wrigley Field,6,-6
2016-07-15,2016,MIL,CIN,4,5,140,1.5,-150,9.0,-110,-110,-155,-1.5,130,3.75,Great American Ballpark,9,-1
2016-07-15,2016,MIN,CLE,2,5,138,1.5,-130,8.5,-115,-105,-153,-1.5,110,3.57,Target Field,7,-3
2016-07-15,2016,ATL,COL,2,11,-104,1.5,-165,8.0,-115,-105,-106,-1.5,145,4.08,Turner Field,13,-9
2016-07-15,2016,LAA,CWS,7,0,-132,-1.5,155,8.0,-120,100,117,1.5,-175,4.55,Angel Stadium,7,7
2016-07-15,2016,KC,DET,2,4,126,1.5,-165,8.5,-110,-110,-141,-1.5,145,3.76,Comerica Park,6,-2
2016-07-15,2016,SEA,HOU,3,7,-117,-1.5,180,8.0,-115,-105,107,1.5,-210,4.31,T-Mobile Park,10,-4
2016-07-15,2016,DET,KC,4,2,-141,-1.5,145,8.5,-110,-110,126,1.5,-165,4.97,Comerica Park,6,2
2016-07-15,2016,CWS,LAA,0,7,117,1.5,-175,8.0,-120,100,-132,-1.5,155,3.69,Angel Stadium,7,-7
2016-07-15,2016,ARI,LAD,7,13,119,1.5,-140,9.0,-120,100,-134,-1.5,120,4.11,Chase Field,20,-6
2016-07-15,2016,STL,MIA,6,7,-127,-1.5,165,8.0,-105,-115,117,1.5,-185,4.48,Busch Stadium,13,-1
2016-07-15,2016,CIN,MIL,5,4,-155,-1.5,130,9.0,-110,-110,140,1.5,-150,5.47,Great American Ballpark,9,1
2016-07-15,2016,CLE,MIN,5,2,-153,-1.5,110,8.5,-115,-105,138,1.5,-130,5.14,Target Field,7,3
2016-07-15,2016,PHI,NYM,3,5,105,1.5,-145,8.5,100,-120,-115,-1.5,125,4.15,Citizens Bank Park,8,-2
2016-07-15,2016,BOS,NYY,5,3,132,1.5,-145,9.0,-105,-115,-147,-1.5,125,3.88,Yankee Stadium,8,2
2016-07-15,2016,TOR,OAK,7,8,-150,-1.5,-105,8.0,-110,-110,135,1.5,-115,4.8,Oakland Coliseum,15,-1
2016-07-15,2016,NYM,PHI,5,3,-115,-1.5,125,8.5,100,-120,105,1.5,-145,4.55,Citizens Bank Park,8,2
2016-07-15,2016,WSH,PIT,5,1,-210,-1.5,100,8.0,-105,-115,180,1.5,-120,5.42,Nationals Park,6,4
2016-07-15,2016,SF,SD,1,4,-220,-1.5,-140,7.5,105,-125,190,1.5,120,5.16,PETCO Park,5,-3
2016-07-15,2016,HOU,SEA,7,3,107,1.5,-210,8.0,-115,-105,-117,-1.5,180,3.86,T-Mobile Park,10,4
2016-07-15,2016,SD,SF,4,1,190,1.5,120,7.5,105,-125,-220,-1.5,-140,2.59,PETCO Park,5,3
2016-07-15,2016,MIA,STL,7,6,117,1.5,-185,8.0,-105,-115,-127,-1.5,165,3.69,Busch Stadium,13,1
2016-07-15,2016,BAL,TB,4,3,118,1.5,-175,8.5,100,-120,-128,-1.5,155,3.9,Tropicana Field,7,1
2016-07-15,2016,CHC,TEX,6,0,-200,-1.5,100,8.5,-104,-116,170,1.5,-120,5.67,Wrigley Field,6,6
2016-07-15,2016,OAK,TOR,8,7,135,1.5,-115,8.0,-110,-110,-150,-1.5,-105,3.4,Oakland Coliseum,15,1
2016-07-15,2016,PIT,WSH,1,5,180,1.5,-120,8.0,-105,-115,-210,-1.5,100,2.86,Nationals Park,6,-4
2016-07-16,2016,LAD,ARI,1,2,-170,-1.5,-110,9.0,-110,-110,150,1.5,-110,5.67,Chase Field,3,-1
2016-07-16,2016,COL,ATL,4,3,-120,-1.5,135,8.0,-120,100,110,1.5,-155,4.36,Turner Field,7,1
2016-07-16,2016,TB,BAL,1,2,113,1.5,-140,8.0,-118,-102,-123,-1.5,120,3.76,Tropicana Field,3,-1
2016-07-16,2016,NYY,BOS,2,5,-125,-1.5,155,10.0,-115,-105,115,1.5,-175,5.56,Yankee Stadium,7,-3
2016-07-16,2016,TEX,CHC,1,3,110,1.5,-200,7.5,-114,-106,-120,-1.5,170,3.57,Wrigley Field,4,-2
2016-07-16,2016,MIL,CIN,9,1,-108,-1.5,145,9.5,100,-120,-102,1.5,-165,4.93,Great American Ballpark,10,8
2016-07-16,2016,MIN,CLE,5,4,129,1.5,-130,9.0,-110,-110,-144,-1.5,110,3.93,Target Field,9,1
2016-07-16,2016,ATL,COL,3,4,110,1.5,-155,8.0,-120,100,-120,-1.5,135,3.81,Turner Field,7,-1
2016-07-16,2016,LAA,CWS,1,0,-171,-1.5,115,8.5,-115,-105,151,1.5,-135,5.36,Angel Stadium,1,1
2016-07-16,2016,KC,DET,8,4,-145,-1.5,110,9.0,-105,-115,130,1.5,-130,5.33,Comerica Park,12,4
2016-07-16,2016,SEA,HOU,1,0,114,1.5,-155,7.5,100,-120,-124,-1.5,135,3.5,T-Mobile Park,1,1
2016-07-16,2016,DET,KC,4,8,130,1.5,-130,9.0,-105,-115,-145,-1.5,110,3.91,Comerica Park,12,-4
2016-07-16,2016,CWS,LAA,0,1,151,1.5,-135,8.5,-115,-105,-171,-1.5,115,3.39,Angel Stadium,1,-1
2016-07-16,2016,ARI,LAD,2,1,150,1.5,-110,9.0,-110,-110,-170,-1.5,-110,3.6,Chase Field,3,1
2016-07-16,2016,STL,MIA,5,0,-195,-1.5,100,8.0,-120,100,175,1.5,-120,5.29,Busch Stadium,5,5
2016-07-16,2016,CIN,MIL,1,9,-102,1.5,-165,9.5,100,-120,-108,-1.5,145,4.8,Great American Ballpark,10,-8
2016-07-16,2016,CLE,MIN,4,5,-144,-1.5,110,9.0,-110,-110,129,1.5,-130,5.31,Target Field,9,-1
2016-07-16,2016,PHI,NYM,4,2,-121,-1.5,165,8.5,-125,105,111,1.5,-185,4.65,Citizens Bank Park,6,2
2016-07-16,2016,BOS,NYY,5,2,115,1.5,-175,10.0,-115,-105,-125,-1.5,155,4.65,Yankee Stadium,7,3
2016-07-16,2016,TOR,OAK,4,5,-116,-1.5,135,8.5,-110,-110,106,1.5,-155,4.56,Oakland Coliseum,9,-1
2016-07-16,2016,NYM,PHI,2,4,111,1.5,-185,8.5,-125,105,-121,-1.5,165,4.03,Citizens Bank Park,6,-2
2016-07-16,2016,WSH,PIT,6,0,-124,-1.5,170,8.0,-110,-110,114,1.5,-200,4.43,Nationals Park,6,6
2016-07-16,2016,SF,SD,6,7,-158,-1.5,-110,8.5,-120,100,143,1.5,-110,5.21,PETCO Park,13,-1
2016-07-16,2016,HOU,SEA,0,1,-124,-1.5,135,7.5,100,-120,114,1.5,-155,4.15,T-Mobile Park,1,-1
2016-07-16,2016,SD,SF,7,6,143,1.5,-110,8.5,-120,100,-158,-1.5,-110,3.5,PETCO Park,13,1
2016-07-16,2016,MIA,STL,0,5,175,1.5,-120,8.0,-120,100,-195,-1.5,100,2.91,Busch Stadium,5,-5
2016-07-16,2016,BAL,TB,2,1,-123,-1.5,120,8.0,-118,-102,113,1.5,-140,4.41,Tropicana Field,3,1
2016-07-16,2016,CHC,TEX,3,1,-120,-1.5,170,7.5,-114,-106,110,1.5,-200,4.09,Wrigley Field,4,2
2016-07-16,2016,OAK,TOR,5,4,106,1.5,-155,8.5,-110,-110,-116,-1.5,135,4.13,Oakland Coliseum,9,1
2016-07-16,2016,PIT,WSH,0,6,114,1.5,-200,8.0,-110,-110,-124,-1.5,170,3.74,Nationals Park,6,-6
2016-07-17,2016,LAD,ARI,5,6,-148,-1.5,100,7.5,-115,-105,133,1.5,-120,4.48,Chase Field,11,-1
2016-07-17,2016,COL,ATL,0,1,-104,1.5,-230,7.0,101,-121,-106,-1.5,190,3.57,Turner Field,1,-1
2016-07-17,2016,TB,BAL,5,2,103,1.5,-150,8.0,-110,-110,-113,-1.5,130,3.94,Tropicana Field,7,3
2016-07-17,2016,NYY,BOS,3,1,107,1.5,-170,7.5,-110,-110,-117,-1.5,150,3.62,Yankee Stadium,4,2
2016-07-17,2016,TEX,CHC,4,1,118,1.5,-160,9.0,-130,110,-133,-1.5,140,4.13,Wrigley Field,5,3
2016-07-17,2016,MIL,CIN,0,1,-122,-1.5,115,9.0,-130,110,112,1.5,-135,4.95,Great American Ballpark,1,-1
2016-07-17,2016,MIN,CLE,1,6,126,1.5,-130,9.5,-115,-105,-141,-1.5,110,4.2,Target Field,7,-5
2016-07-17,2016,ATL,COL,1,0,-106,-1.5,190,7.0,101,-121,-104,1.5,-230,3.6,Turner Field,1,1
2016-07-17,2016,LAA,CWS,8,1,-127,-1.5,150,9.5,-120,100,117,1.5,-170,5.31,Angel Stadium,9,7
2016-07-17,2016,KC,DET,2,4,133,1.5,-145,8.5,-110,-110,-148,-1.5,125,3.65,Comerica Park,6,-2
2016-07-17,2016,SEA,HOU,1,8,-101,1.5,-165,8.0,-105,-115,-109,-1.5,145,4.02,T-Mobile Park,9,-7
2016-07-17,2016,DET,KC,4,2,-148,-1.5,125,8.5,-110,-110,133,1.5,-145,5.07,Comerica Park,6,2
2016-07-17,2016,CWS,LAA,1,8,117,1.5,-170,9.5,-120,100,-127,-1.5,150,4.38,Angel Stadium,9,-7
2016-07-17,2016,ARI,LAD,6,5,133,1.5,-120,7.5,-115,-105,-148,-1.5,100,3.22,Chase Field,11,1
2016-07-17,2016,STL,MIA,3,6,-145,-1.5,135,8.0,-115,-105,130,1.5,-155,4.73,Busch Stadium,9,-3
2016-07-17,2016,CIN,MIL,1,0,112,1.5,-135,9.0,-130,110,-122,-1.5,115,4.25,Great American Ballpark,1,1
2016-07-17,2016,CLE,MIN,6,1,-141,-1.5,110,9.5,-115,-105,126,1.5,-130,5.56,Target Field,7,5
2016-07-17,2016,PHI,NYM,0,5,158,1.5,-105,8.0,-109,-111,-178,-1.5,-115,3.1,Citizens Bank Park,5,-5
2016-07-17,2016,BOS,NYY,1,3,-117,-1.5,150,7.5,-110,-110,107,1.5,-170,4.04,Yankee Stadium,4,-2
2016-07-17,2016,TOR,OAK,5,3,-116,-1.5,140,8.0,-105,-115,106,1.5,-160,4.3,Oakland Coliseum,8,2
2016-07-17,2016,NYM,PHI,5,0,-178,-1.5,-115,8.0,-109,-111,158,1.5,-105,5.12,Citizens Bank Park,5,5
2016-07-17,2016,WSH,PIT,1,2,-260,-1.5,-125,7.5,-120,100,220,1.5,105,5.42,Nationals Park,3,-1
2016-07-17,2016,SF,SD,3,5,-240,-1.5,-155,8.5,100,-120,200,1.5,135,6.0,PETCO Park,8,-2
2016-07-17,2016,HOU,SEA,8,1,-109,-1.5,145,8.0,-105,-115,-101,1.5,-165,4.17,T-Mobile Park,9,7
2016-07-17,2016,SD,SF,5,3,200,1.5,135,8.5,100,-120,-240,-1.5,-155,2.83,PETCO Park,8,2
2016-07-17,2016,MIA,STL,6,3,130,1.5,-155,8.0,-115,-105,-145,-1.5,135,3.48,Busch Stadium,9,3
2016-07-17,2016,BAL,TB,2,5,-113,-1.5,130,8.0,-110,-110,103,1.5,-150,4.24,Tropicana Field,7,-3
2016-07-17,2016,CHC,TEX,1,4,-133,-1.5,140,9.0,-130,110,118,1.5,-160,5.14,Wrigley Field,5,-3
2016-07-17,2016,OAK,TOR,3,5,106,1.5,-160,8.0,-105,-115,-116,-1.5,140,3.88,Oakland Coliseum,8,-2
2016-07-17,2016,PIT,WSH,2,1,220,1.5,105,7.5,-120,100,-260,-1.5,-125,2.34,Nationals Park,3,1
2016-07-18,2016,CIN,ATL,8,2,-148,-1.5,145,9.0,-110,-110,133,1.5,-165,5.37,Great American Ballpark,10,6
2016-07-18,2016,NYY,BAL,2,1,-113,1.5,-180,9.0,-110,-110,103,-1.5,160,4.77,Yankee Stadium,3,1
2016-07-18,2016,NYM,CHC,1,5,130,1.5,-170,8.0,-105,-115,-145,-1.5,150,3.48,Wrigley Field,6,-4
2016-07-18,2016,ATL,CIN,2,8,133,1.5,-165,9.0,-110,-110,-148,-1.5,145,3.86,Great American Ballpark,10,-6
2016-07-18,2016,KC,CLE,7,3,137,1.5,-125,8.0,-105,-115,-152,-1.5,105,3.38,Kauffman Stadium,10,4
2016-07-18,2016,TB,COL,4,7,119,1.5,-165,11.0,-115,-105,-129,-1.5,145,5.02,Coors Field,11,-3
2016-07-18,2016,SEA,CWS,4,3,119,1.5,-135,7.5,100,-120,-134,-1.5,115,3.42,T-Mobile Park,7,1
2016-07-18,2016,MIN,DET,0,1,129,1.5,-155,10.0,-121,101,-144,-1.5,135,4.37,Comerica Park,1,-1
2016-07-18,2016,OAK,HOU,7,4,118,1.5,-150,8.5,-105,-115,-128,-1.5,130,3.9,Oakland Coliseum,11,3
2016-07-18,2016,CLE,KC,3,7,-152,-1.5,105,8.0,-105,-115,137,1.5,-125,4.83,Kauffman Stadium,10,-4
2016-07-18,2016,TEX,LAA,5,9,105,1.5,-185,8.0,-120,100,-115,-1.5,165,3.9,Angel Stadium,14,-4
2016-07-18,2016,PHI,MIA,2,3,161,1.5,-105,7.0,-110,-110,-181,-1.5,-115,2.68,Citizens Bank Park,5,-1
2016-07-18,2016,DET,MIN,1,0,-144,-1.5,135,10.0,-121,101,129,1.5,-155,5.9,Comerica Park,1,1
2016-07-18,2016,CHC,NYM,5,1,-145,-1.5,150,8.0,-105,-115,130,1.5,-170,4.73,Wrigley Field,6,4
2016-07-18,2016,BAL,NYY,1,2,103,-1.5,160,9.0,-110,-110,-113,1.5,-180,4.43,Yankee Stadium,3,-1
2016-07-18,2016,HOU,OAK,4,7,-128,-1.5,130,8.5,-105,-115,118,1.5,-150,4.77,Oakland Coliseum,11,-3
2016-07-18,2016,MIA,PHI,3,2,-181,-1.5,-115,7.0,-110,-110,161,1.5,-105,4.51,Citizens Bank Park,5,1
2016-07-18,2016,STL,SD,10,2,-195,-1.5,115,9.5,-105,-115,175,1.5,-135,6.28,Busch Stadium,12,8
2016-07-18,2016,CWS,SEA,3,4,-134,-1.5,115,7.5,100,-120,119,1.5,-135,4.29,T-Mobile Park,7,-1
2016-07-18,2016,SD,STL,2,10,175,1.5,-135,9.5,-105,-115,-195,-1.5,115,3.45,Busch Stadium,12,-8
2016-07-18,2016,COL,TB,7,4,-129,-1.5,145,11.0,-115,-105,119,1.5,-165,6.2,Coors Field,11,3
2016-07-18,2016,LAA,TEX,9,5,-115,-1.5,165,8.0,-120,100,105,1.5,-185,4.28,Angel Stadium,14,4
2016-07-19,2016,TOR,ARI,5,1,-173,-1.5,-120,9.0,100,-120,153,1.5,100,5.7,Chase Field,6,4
2016-07-19,2016,CIN,ATL,4,5,-190,-1.5,100,9.0,-130,110,170,1.5,-120,5.9,Great American Ballpark,9,-1
2016-07-19,2016,NYY,BAL,7,1,-142,-1.5,145,9.0,-115,-105,127,1.5,-165,5.28,Yankee Stadium,8,6
2016-07-19,2016,SF,BOS,0,4,151,1.5,-120,10.0,-125,105,-171,-1.5,100,3.98,Fenway Park,4,-4
2016-07-19,2016,NYM,CHC,2,1,146,1.5,-155,6.5,-115,-105,-161,-1.5,135,2.64,Wrigley Field,3,1
2016-07-19,2016,ATL,CIN,5,4,170,1.5,-120,9.0,-130,110,-190,-1.5,100,3.33,Great American Ballpark,9,1
2016-07-19,2016,KC,CLE,3,7,116,1.5,-145,7.5,105,-125,-126,-1.5,125,3.47,Kauffman Stadium,10,-4
2016-07-19,2016,TB,COL,10,1,114,1.5,-150,12.0,100,-120,-124,-1.5,130,5.61,Coors Field,11,9
2016-07-19,2016,SEA,CWS,1,6,100,1.5,-165,7.5,-110,-110,-110,-1.5,145,3.75,T-Mobile Park,7,-5
2016-07-19,2016,MIN,DET,6,2,129,1.5,-145,9.5,-120,100,-144,-1.5,125,4.15,Comerica Park,8,4
2016-07-19,2016,OAK,HOU,4,3,162,1.5,100,8.5,-125,105,-182,-1.5,-120,3.24,Oakland Coliseum,7,1
2016-07-19,2016,CLE,KC,7,3,-126,-1.5,125,7.5,105,-125,116,1.5,-145,4.18,Kauffman Stadium,10,4
2016-07-19,2016,TEX,LAA,6,8,110,1.5,-175,10.0,-125,105,-120,-1.5,155,4.76,Angel Stadium,14,-2
2016-07-19,2016,WSH,LAD,4,8,111,1.5,-145,8.5,100,-120,-121,-1.5,125,4.03,Nationals Park,12,-4
2016-07-19,2016,PHI,MIA,1,2,-132,-1.5,140,8.5,-110,-110,117,1.5,-160,4.84,Citizens Bank Park,3,-1
2016-07-19,2016,PIT,MIL,3,2,-158,-1.5,130,8.0,100,-120,143,1.5,-150,4.9,PNC Park,5,1
2016-07-19,2016,DET,MIN,2,6,-144,-1.5,125,9.5,-120,100,129,1.5,-145,5.61,Comerica Park,8,-4
2016-07-19,2016,CHC,NYM,1,2,-161,-1.5,135,6.5,-115,-105,146,1.5,-155,4.01,Wrigley Field,3,-1
2016-07-19,2016,BAL,NYY,1,7,127,1.5,-165,9.0,-115,-105,-142,-1.5,145,3.96,Yankee Stadium,8,-6
2016-07-19,2016,HOU,OAK,3,4,-182,-1.5,-120,8.5,-125,105,162,1.5,100,5.49,Oakland Coliseum,7,-1
2016-07-19,2016,MIA,PHI,2,1,117,1.5,-160,8.5,-110,-110,-132,-1.5,140,3.92,Citizens Bank Park,3,1
2016-07-19,2016,MIL,PIT,2,3,143,1.5,-150,8.0,100,-120,-158,-1.5,130,3.29,PNC Park,5,-1
2016-07-19,2016,CWS,SEA,6,1,-110,-1.5,145,7.5,-110,-110,100,1.5,-165,3.93,T-Mobile Park,7,5
2016-07-19,2016,BOS,SF,4,0,-171,-1.5,100,10.0,-125,105,151,1.5,-120,6.31,Fenway Park,4,4
2016-07-19,2016,COL,TB,1,10,-124,-1.5,130,12.0,100,-120,114,1.5,-150,6.64,Coors Field,11,-9
2016-07-19,2016,LAA,TEX,8,6,-120,-1.5,155,10.0,-125,105,110,1.5,-175,5.45,Angel Stadium,14,2
2016-07-19,2016,ARI,TOR,1,5,153,1.5,100,9.0,100,-120,-173,-1.5,-120,3.56,Chase Field,6,-4
2016-07-19,2016,LAD,WSH,8,4,-121,-1.5,125,8.5,100,-120,111,1.5,-145,4.65,Nationals Park,12,4
2016-07-20,2016,TOR,ARI,10,4,-171,-1.5,-105,9.0,-105,-115,151,1.5,-115,5.68,Chase Field,14,6
2016-07-20,2016,CIN,ATL,6,3,-181,-1.5,110,9.0,-104,-116,161,1.5,-130,5.8,Great American Ballpark,9,3
2016-07-20,2016,NYY,BAL,5,0,-230,-1.5,-115,8.5,105,-125,200,1.5,-105,5.92,Yankee Stadium,5,5
2016-07-20,2016,SF,BOS,7,11,205,1.5,105,10.0,-105,-115,-245,-1.5,-125,3.28,Fenway Park,18,-4
2016-07-20,2016,NYM,CHC,2,6,180,1.5,-120,9.5,-115,-105,-210,-1.5,100,3.39,Wrigley Field,8,-4
2016-07-20,2016,ATL,CIN,3,6,161,1.5,-130,9.0,-104,-116,-181,-1.5,110,3.45,Great American Ballpark,9,-3
2016-07-20,2016,KC,CLE,4,11,117,1.5,-145,8.0,-115,-105,-132,-1.5,125,3.69,Kauffman Stadium,15,-7
2016-07-20,2016,TB,COL,11,3,-119,-1.5,130,12.0,-125,105,109,1.5,-150,6.52,Coors Field,14,8
2016-07-20,2016,SEA,CWS,6,5,-182,-1.5,110,8.0,-115,-105,162,1.5,-130,5.16,T-Mobile Park,11,1
2016-07-20,2016,MIN,DET,4,1,150,1.5,-150,8.5,-110,-110,-170,-1.5,130,3.4,Comerica Park,5,3
2016-07-20,2016,OAK,HOU,0,7,105,1.5,-160,8.5,-110,-110,-115,-1.5,140,4.15,Oakland Coliseum,7,-7
2016-07-20,2016,CLE,KC,11,4,-132,-1.5,125,8.0,-115,-105,117,1.5,-145,4.55,Kauffman Stadium,15,7
2016-07-20,2016,TEX,LAA,4,7,132,1.5,-140,9.0,-120,100,-147,-1.5,120,3.88,Angel Stadium,11,-3
2016-07-20,2016,WSH,LAD,8,1,-129,-1.5,150,8.5,-105,-115,119,1.5,-170,4.79,Nationals Park,9,7
2016-07-20,2016,PHI,MIA,4,1,129,1.5,-120,8.5,-120,100,-144,-1.5,100,3.71,Citizens Bank Park,5,3
2016-07-20,2016,PIT,MIL,5,9,-153,-1.5,120,9.0,-110,-110,138,1.5,-140,5.44,PNC Park,14,-4
2016-07-20,2016,DET,MIN,1,4,-170,-1.5,130,8.5,-110,-110,150,1.5,-150,5.35,Comerica Park,5,-3
2016-07-20,2016,CHC,NYM,6,2,-210,-1.5,100,9.5,-115,-105,180,1.5,-120,6.44,Wrigley Field,8,4
2016-07-20,2016,BAL,NYY,0,5,200,1.5,-105,8.5,105,-125,-230,-1.5,-115,2.83,Yankee Stadium,5,-5
2016-07-20,2016,HOU,OAK,7,0,-115,-1.5,140,8.5,-110,-110,105,1.5,-160,4.55,Oakland Coliseum,7,7
2016-07-20,2016,MIA,PHI,1,4,-144,-1.5,100,8.5,-120,100,129,1.5,-120,5.02,Citizens Bank Park,5,-3
2016-07-20,2016,MIL,PIT,9,5,138,1.5,-140,9.0,-110,-110,-153,-1.5,120,3.78,PNC Park,14,4
2016-07-20,2016,STL,SD,4,2,-120,-1.5,150,8.0,-110,-110,105,1.5,-200,4.36,Busch Stadium,6,2
2016-07-20,2016,STL,SD,3,2,-183,-1.5,115,8.5,-115,-105,163,1.5,-135,5.5,Busch Stadium,5,1
2016-07-20,2016,CWS,SEA,5,6,162,1.5,-130,8.0,-115,-105,-182,-1.5,110,3.05,T-Mobile Park,11,-1
2016-07-20,2016,BOS,SF,11,7,-245,-1.5,-125,10.0,-105,-115,205,1.5,105,7.1,Fenway Park,18,4
2016-07-20,2016,SD,STL,2,4,105,1.5,-200,8.0,-110,-110,-120,-1.5,150,3.9,Busch Stadium,6,-2
2016-07-20,2016,SD,STL,2,3,163,1.5,-135,8.5,-115,-105,-183,-1.5,115,3.23,Busch Stadium,5,-1
2016-07-20,2016,COL,TB,3,11,109,1.5,-150,12.0,-125,105,-119,-1.5,130,5.74,Coors Field,14,-8
2016-07-20,2016,LAA,TEX,7,4,-147,-1.5,120,9.0,-120,100,132,1.5,-140,5.36,Angel Stadium,11,3
2016-07-20,2016,ARI,TOR,4,10,151,1.5,-115,9.0,-105,-115,-171,-1.5,-105,3.59,Chase Field,14,-6
2016-07-20,2016,LAD,WSH,1,8,119,1.5,-170,8.5,-105,-115,-129,-1.5,150,3.88,Nationals Park,9,-7
2016-07-21,2016,COL,ATL,7,3,-157,-1.5,110,12.0,100,-120,142,1.5,-130,7.33,Coors Field,10,4
2016-07-21,2016,NYY,BAL,1,4,-123,-1.5,160,8.5,-120,100,113,1.5,-180,4.69,Yankee Stadium,5,-3
2016-07-21,2016,MIN,BOS,2,13,191,1.5,-105,10.0,-125,105,-221,-1.5,-115,3.44,Fenway Park,15,-11
2016-07-21,2016,ATL,COL,3,7,142,1.5,-130,12.0,100,-120,-157,-1.5,110,4.96,Coors Field,10,-4
2016-07-21,2016,DET,CWS,2,1,118,1.5,-155,10.5,-115,-105,-133,-1.5,135,4.82,Guaranteed Rate Field,3,1
2016-07-21,2016,CWS,DET,1,2,-133,-1.5,135,10.5,-115,-105,118,1.5,-155,5.99,Guaranteed Rate Field,3,-1
2016-07-21,2016,WSH,LAD,3,6,-183,-1.5,105,7.0,-125,105,163,1.5,-125,4.53,Nationals Park,9,-3
2016-07-21,2016,PHI,MIA,3,9,-123,-1.5,170,8.0,100,-120,113,1.5,-200,4.41,Citizens Bank Park,12,-6
2016-07-21,2016,PIT,MIL,5,3,-170,-1.5,115,9.5,100,-120,150,1.5,-135,5.98,PNC Park,8,2
2016-07-21,2016,BOS,MIN,13,2,-221,-1.5,-115,10.0,-125,105,191,1.5,-105,6.88,Fenway Park,15,11
2016-07-21,2016,BAL,NYY,4,1,113,1.5,-180,8.5,-120,100,-123,-1.5,160,3.99,Yankee Stadium,5,3
2016-07-21,2016,TB,OAK,7,3,125,1.5,-180,8.0,-120,100,-140,-1.5,160,3.56,Oakland Coliseum,10,4
2016-07-21,2016,MIA,PHI,9,3,113,1.5,-200,8.0,100,-120,-123,-1.5,170,3.76,Citizens Bank Park,12,6
2016-07-21,2016,MIL,PIT,3,5,150,1.5,-135,9.5,100,-120,-170,-1.5,115,3.8,PNC Park,8,-2
2016-07-21,2016,STL,SD,6,5,-210,-1.5,-105,8.5,100,-120,180,1.5,-115,5.76,Busch Stadium,11,1
2016-07-21,2016,SD,STL,5,6,180,1.5,-115,8.5,100,-120,-210,-1.5,-105,3.04,Busch Stadium,11,-1
2016-07-21,2016,OAK,TB,3,7,-140,-1.5,160,8.0,-120,100,125,1.5,-180,4.67,Oakland Coliseum,10,-4
2016-07-21,2016,LAD,WSH,6,3,163,1.5,-125,7.0,-125,105,-183,-1.5,105,2.66,Nationals Park,9,3
2016-07-22,2016,CIN,ARI,6,2,-115,-1.5,170,9.5,112,-132,105,1.5,-200,5.08,Great American Ballpark,8,4
2016-07-22,2016,COL,ATL,4,3,-180,-1.5,-105,10.5,-120,100,160,1.5,-115,6.75,Coors Field,7,1
2016-07-22,2016,CLE,BAL,1,5,-101,1.5,-200,9.5,100,-120,-109,-1.5,170,4.77,Camden Yards,6,-4
2016-07-22,2016,MIN,BOS,2,1,142,1.5,-140,11.0,100,-120,-157,-1.5,120,4.55,Fenway Park,3,1
2016-07-22,2016,MIL,CHC,2,5,140,1.5,-120,9.5,-115,-105,-155,-1.5,100,3.96,Miller Park,7,-3
2016-07-22,2016,ARI,CIN,2,6,105,1.5,-200,9.5,112,-132,-115,-1.5,170,4.63,Great American Ballpark,8,-4
2016-07-22,2016,BAL,CLE,5,1,-109,-1.5,170,9.5,100,-120,-101,1.5,-200,4.95,Camden Yards,6,4
2016-07-22,2016,ATL,COL,3,4,160,1.5,-115,10.5,-120,100,-180,-1.5,-105,4.04,Coors Field,7,-1
2016-07-22,2016,DET,CWS,7,5,-143,-1.5,110,9.5,-115,-105,128,1.5,-130,5.59,Guaranteed Rate Field,12,2
2016-07-22,2016,CWS,DET,5,7,128,1.5,-130,9.5,-115,-105,-143,-1.5,110,4.17,Guaranteed Rate Field,12,-2
2016-07-22,2016,LAA,HOU,1,2,125,1.5,-175,7.5,-115,-105,-140,-1.5,155,3.33,Minute Maid Park,3,-1
2016-07-22,2016,TEX,KC,1,3,115,1.5,-185,7.5,100,-120,-125,-1.5,165,3.49,Kauffman Stadium,4,-2
2016-07-22,2016,HOU,LAA,2,1,-140,-1.5,155,7.5,-115,-105,125,1.5,-175,4.38,Minute Maid Park,3,1
2016-07-22,2016,STL,LAD,4,3,125,1.5,-148,8.0,105,-125,-140,-1.5,125,3.56,Busch Stadium,7,1
2016-07-22,2016,NYM,MIA,5,3,129,1.5,-168,8.0,-110,-110,-144,-1.5,148,3.49,Marlins Park,8,2
2016-07-22,2016,CHC,MIL,5,2,-155,-1.5,100,9.5,-115,-105,140,1.5,-120,5.77,Miller Park,7,3
2016-07-22,2016,BOS,MIN,1,2,-157,-1.5,120,11.0,100,-120,142,1.5,-140,6.72,Fenway Park,3,-1
2016-07-22,2016,MIA,NYM,3,5,-144,-1.5,148,8.0,-110,-110,129,1.5,-168,4.72,Marlins Park,8,-2
2016-07-22,2016,SF,NYY,2,3,-114,-1.5,145,7.5,-120,100,104,1.5,-165,4.0,Yankee Stadium,5,-1
2016-07-22,2016,TB,OAK,0,1,-125,-1.5,130,8.0,-120,100,115,1.5,-150,4.44,Oakland Coliseum,1,-1
2016-07-22,2016,PIT,PHI,0,4,-270,-1.5,-135,8.5,-123,103,230,1.5,115,6.2,PNC Park,4,-4
2016-07-22,2016,PHI,PIT,4,0,230,1.5,115,8.5,-123,103,-270,-1.5,-135,2.58,PNC Park,4,4
2016-07-22,2016,WSH,SD,3,5,-221,-1.5,-125,9.0,-110,-110,191,1.5,105,6.2,Nationals Park,8,-2
2016-07-22,2016,TOR,SEA,1,2,-141,-1.5,130,9.5,105,-125,126,1.5,-150,5.56,Rogers Centre,3,-1
2016-07-22,2016,NYY,SF,3,2,104,1.5,-165,7.5,-120,100,-114,-1.5,145,3.68,Yankee Stadium,5,1
2016-07-22,2016,LAD,STL,3,4,-140,-1.5,125,8.0,105,-125,125,1.5,-148,4.67,Busch Stadium,7,-1
2016-07-22,2016,OAK,TB,1,0,115,1.5,-150,8.0,-120,100,-125,-1.5,130,3.72,Oakland Coliseum,1,1
2016-07-22,2016,KC,TEX,3,1,-125,-1.5,165,7.5,100,-120,115,1.5,-185,4.17,Kauffman Stadium,4,2
2016-07-22,2016,SEA,TOR,2,1,126,1.5,-150,9.5,105,-125,-141,-1.5,130,4.2,Rogers Centre,3,1
2016-07-22,2016,SD,WSH,5,3,191,1.5,105,9.0,-110,-110,-221,-1.5,-125,3.09,Nationals Park,8,2
2016-07-23,2016,CIN,ARI,6,1,115,1.5,-150,9.5,-110,-110,-125,-1.5,130,4.42,Great American Ballpark,7,5
2016-07-23,2016,COL,ATL,8,4,-220,-1.5,-135,12.0,100,-120,190,1.5,115,8.25,Coors Field,12,4
2016-07-23,2016,CLE,BAL,2,5,125,1.5,-160,9.0,-116,-104,-140,-1.5,140,4.0,Camden Yards,7,-3
2016-07-23,2016,MIN,BOS,11,9,200,1.5,102,9.5,-105,-115,-230,-1.5,-122,3.17,Fenway Park,20,2
2016-07-23,2016,MIL,CHC,6,1,132,1.5,-135,8.5,-125,105,-147,-1.5,115,3.66,Miller Park,7,5
2016-07-23,2016,ARI,CIN,1,6,-125,-1.5,130,9.5,-110,-110,115,1.5,-150,5.28,Great American Ballpark,7,-5
2016-07-23,2016,BAL,CLE,5,2,-140,-1.5,140,9.0,-116,-104,125,1.5,-160,5.25,Camden Yards,7,3
2016-07-23,2016,ATL,COL,4,8,190,1.5,115,12.0,100,-120,-220,-1.5,-135,4.14,Coors Field,12,-4
2016-07-23,2016,DET,CWS,3,4,103,1.5,-185,9.5,-105,-115,-113,-1.5,165,4.68,Guaranteed Rate Field,7,-1
2016-07-23,2016,CWS,DET,4,3,-113,-1.5,165,9.5,-105,-115,103,1.5,-185,5.04,Guaranteed Rate Field,7,1
2016-07-23,2016,LAA,HOU,2,7,170,1.5,-120,9.0,105,-125,-200,-1.5,100,3.33,Minute Maid Park,9,-5
2016-07-23,2016,TEX,KC,7,4,-124,-1.5,125,9.0,-113,-107,114,1.5,-145,4.98,Kauffman Stadium,11,3
2016-07-23,2016,HOU,LAA,7,2,-200,-1.5,100,9.0,105,-125,170,1.5,-120,6.0,Minute Maid Park,9,5
2016-07-23,2016,STL,LAD,2,7,124,1.5,-135,7.5,-110,-110,-139,-1.5,115,3.35,Busch Stadium,9,-5
2016-07-23,2016,NYM,MIA,2,7,150,1.5,-160,6.0,-120,100,-170,-1.5,140,2.4,Marlins Park,9,-5
2016-07-23,2016,CHC,MIL,1,6,-147,-1.5,115,8.5,-125,105,132,1.5,-135,5.06,Miller Park,7,-5
2016-07-23,2016,BOS,MIN,9,11,-230,-1.5,-122,9.5,-105,-115,200,1.5,102,6.62,Fenway Park,20,-2
2016-07-23,2016,MIA,NYM,7,2,-170,-1.5,140,6.0,-120,100,150,1.5,-160,3.78,Marlins Park,9,5
2016-07-23,2016,SF,NYY,2,1,-117,-1.5,130,9.0,-115,-105,107,1.5,-150,4.85,Yankee Stadium,3,1
2016-07-23,2016,TB,OAK,3,4,-123,-1.5,125,8.5,-110,-110,113,1.5,-145,4.69,Oakland Coliseum,7,-1
2016-07-23,2016,PIT,PHI,7,4,-172,-1.5,125,8.0,-109,-111,152,1.5,-145,5.06,PNC Park,11,3
2016-07-23,2016,PHI,PIT,4,7,152,1.5,-145,8.0,-109,-111,-172,-1.5,125,3.17,PNC Park,11,-3
2016-07-23,2016,WSH,SD,3,2,-368,-1.5,-160,9.0,-115,-105,308,1.5,140,7.08,Nationals Park,5,1
2016-07-23,2016,TOR,SEA,5,14,-121,-1.5,160,9.5,-125,105,111,1.5,-180,5.2,Rogers Centre,19,-9
2016-07-23,2016,NYY,SF,1,2,107,1.5,-150,9.0,-115,-105,-117,-1.5,130,4.35,Yankee Stadium,3,-1
2016-07-23,2016,LAD,STL,7,2,-139,-1.5,115,7.5,-110,-110,124,1.5,-135,4.36,Busch Stadium,9,5
2016-07-23,2016,OAK,TB,4,3,113,1.5,-145,8.5,-110,-110,-123,-1.5,125,3.99,Oakland Coliseum,7,1
2016-07-23,2016,KC,TEX,4,7,114,1.5,-145,9.0,-113,-107,-124,-1.5,125,4.21,Kauffman Stadium,11,-3
2016-07-23,2016,SEA,TOR,14,5,111,1.5,-180,9.5,-125,105,-121,-1.5,160,4.5,Rogers Centre,19,9
2016-07-23,2016,SD,WSH,2,3,308,1.5,140,9.0,-115,-105,-368,-1.5,-160,2.21,Nationals Park,5,-1
2016-07-24,2016,CIN,ARI,8,9,108,1.5,-145,10.5,-110,-110,-118,-1.5,125,5.05,Great American Ballpark,17,-1
2016-07-24,2016,COL,ATL,7,2,-230,-1.5,-115,12.5,-120,100,200,1.5,-105,8.71,Coors Field,9,5
2016-07-24,2016,CLE,BAL,3,5,-145,-1.5,106,9.0,-105,-115,130,1.5,-126,5.33,Camden Yards,8,-2
2016-07-24,2016,MIN,BOS,7,8,155,1.5,-120,10.0,-120,100,-175,-1.5,100,3.92,Fenway Park,15,-1
2016-07-24,2016,MIL,CHC,5,6,136,1.5,-125,8.0,-115,-105,-151,-1.5,105,3.39,Miller Park,11,-1
2016-07-24,2016,ARI,CIN,9,8,-118,-1.5,125,10.5,-110,-110,108,1.5,-145,5.68,Great American Ballpark,17,1
2016-07-24,2016,BAL,CLE,5,3,130,1.5,-126,9.0,-105,-115,-145,-1.5,106,3.91,Camden Yards,8,2
2016-07-24,2016,ATL,COL,2,7,200,1.5,-105,12.5,-120,100,-230,-1.5,-115,4.17,Coors Field,9,-5
2016-07-24,2016,DET,CWS,4,5,132,1.5,-160,9.0,-115,-105,-147,-1.5,140,3.88,Guaranteed Rate Field,9,-1
2016-07-24,2016,CWS,DET,5,4,-147,-1.5,140,9.0,-115,-105,132,1.5,-160,5.36,Guaranteed Rate Field,9,1
2016-07-24,2016,LAA,HOU,3,13,144,1.5,-145,9.5,105,-125,-159,-1.5,125,3.89,Minute Maid Park,16,-10
2016-07-24,2016,TEX,KC,2,1,106,1.5,-210,9.0,-105,-115,-116,-1.5,180,4.37,Kauffman Stadium,3,1
2016-07-24,2016,HOU,LAA,13,3,-159,-1.5,125,9.5,105,-125,144,1.5,-145,5.83,Minute Maid Park,16,10
2016-07-24,2016,STL,LAD,6,9,131,1.5,-130,9.0,-110,-110,-146,-1.5,110,3.9,Busch Stadium,15,-3
2016-07-24,2016,NYM,MIA,3,0,-113,-1.5,140,8.5,-110,-110,103,1.5,-160,4.51,Marlins Park,3,3
2016-07-24,2016,CHC,MIL,6,5,-151,-1.5,105,8.0,-115,-105,136,1.5,-125,4.81,Miller Park,11,1
2016-07-24,2016,BOS,MIN,8,7,-175,-1.5,100,10.0,-120,100,155,1.5,-120,6.36,Fenway Park,15,1
2016-07-24,2016,MIA,NYM,0,3,103,1.5,-160,8.5,-110,-110,-113,-1.5,140,4.19,Marlins Park,3,-3
2016-07-24,2016,SF,NYY,2,5,127,1.5,-150,9.5,-110,-110,-142,-1.5,130,4.19,Yankee Stadium,7,-3
2016-07-24,2016,TB,OAK,2,3,-129,-1.5,130,9.0,-110,-110,119,1.5,-150,5.07,Oakland Coliseum,5,-1
2016-07-24,2016,PIT,PHI,5,4,-148,-1.5,150,8.0,-114,-106,133,1.5,-170,4.77,PNC Park,9,1
2016-07-24,2016,PHI,PIT,4,5,133,1.5,-170,8.0,-114,-106,-148,-1.5,150,3.43,PNC Park,9,-1
2016-07-24,2016,WSH,SD,6,10,-185,-1.5,110,9.5,-120,100,165,1.5,-130,6.17,Nationals Park,16,-4
2016-07-24,2016,TOR,SEA,2,0,-173,-1.5,110,9.5,111,-131,153,1.5,-130,6.02,Rogers Centre,2,2
2016-07-24,2016,NYY,SF,5,2,-142,-1.5,130,9.5,-110,-110,127,1.5,-150,5.57,Yankee Stadium,7,3
2016-07-24,2016,LAD,STL,9,6,-146,-1.5,110,9.0,-110,-110,131,1.5,-130,5.34,Busch Stadium,15,3
2016-07-24,2016,OAK,TB,3,2,119,1.5,-150,9.0,-110,-110,-129,-1.5,130,4.11,Oakland Coliseum,5,1
2016-07-24,2016,KC,TEX,1,2,-116,-1.5,180,9.0,-105,-115,106,1.5,-210,4.83,Kauffman Stadium,3,-1
2016-07-24,2016,SEA,TOR,0,2,153,1.5,-130,9.5,111,-131,-173,-1.5,110,3.75,Rogers Centre,2,-2
2016-07-24,2016,SD,WSH,10,6,165,1.5,-130,9.5,-120,100,-185,-1.5,110,3.58,Nationals Park,16,4
2016-07-25,2016,MIL,ARI,7,2,-120,-1.5,165,9.5,100,-120,110,1.5,-185,5.18,Miller Park,9,5
2016-07-25,2016,COL,BAL,2,3,147,1.5,-125,10.5,-105,-115,-162,-1.5,105,4.25,Camden Yards,5,-1
2016-07-25,2016,DET,BOS,4,2,117,1.5,-160,10.0,100,-120,-132,-1.5,140,4.61,Fenway Park,6,2
2016-07-25,2016,CWS,CHC,5,4,191,1.5,120,9.0,-105,-115,-221,-1.5,-140,3.09,Guaranteed Rate Field,9,1
2016-07-25,2016,SF,CIN,5,7,-124,-1.5,175,7.5,100,-120,114,1.5,-205,4.15,AT&T Park,12,-2
2016-07-25,2016,BAL,COL,3,2,-162,-1.5,105,10.5,-105,-115,147,1.5,-125,6.49,Camden Yards,5,1
2016-07-25,2016,CHC,CWS,4,5,-221,-1.5,-140,9.0,-105,-115,191,1.5,120,6.2,Guaranteed Rate Field,9,-1
2016-07-25,2016,BOS,DET,2,4,-132,-1.5,140,10.0,100,-120,117,1.5,-160,5.69,Fenway Park,6,-2
2016-07-25,2016,NYY,HOU,2,1,135,1.5,-160,7.0,-105,-115,-150,-1.5,140,2.98,Minute Maid Park,3,1
2016-07-25,2016,LAA,KC,6,2,109,1.5,-200,9.0,-106,-114,-119,-1.5,170,4.31,Kauffman Stadium,8,4
2016-07-25,2016,KC,LAA,2,6,-119,-1.5,170,9.0,-106,-114,109,1.5,-200,4.89,Kauffman Stadium,8,-4
2016-07-25,2016,PHI,MIA,4,0,130,1.5,-170,7.5,-105,-115,-145,-1.5,150,3.26,Marlins Park,4,4
2016-07-25,2016,ARI,MIL,2,7,110,1.5,-185,9.5,100,-120,-120,-1.5,165,4.52,Miller Park,9,-5
2016-07-25,2016,HOU,NYY,1,2,-150,-1.5,140,7.0,-105,-115,135,1.5,-160,4.2,Minute Maid Park,3,-1
2016-07-25,2016,TEX,OAK,7,6,-124,-1.5,150,10.0,-110,-110,114,1.5,-170,5.54,Rangers Ballpark,13,1
2016-07-25,2016,MIA,PHI,0,4,-145,-1.5,150,7.5,-105,-115,130,1.5,-170,4.44,Marlins Park,4,-4
2016-07-25,2016,TOR,SD,4,2,-265,-1.5,-135,10.0,-110,-110,225,1.5,115,7.26,Rogers Centre,6,2
2016-07-25,2016,CIN,SF,7,5,114,1.5,-205,7.5,100,-120,-124,-1.5,175,3.5,AT&T Park,12,2
2016-07-25,2016,OAK,TEX,6,7,114,1.5,-170,10.0,-110,-110,-124,-1.5,150,4.67,Rangers Ballpark,13,-1
2016-07-25,2016,SD,TOR,2,4,225,1.5,115,10.0,-110,-110,-265,-1.5,-135,3.08,Rogers Centre,6,-2
2016-07-26,2016,MIL,ARI,9,4,-117,-1.5,170,9.0,-105,-115,107,1.5,-200,4.85,Miller Park,13,5
2016-07-26,2016,MIN,ATL,0,2,-205,-1.5,-110,9.5,-110,-110,175,1.5,-110,6.39,Target Field,2,-2
2016-07-26,2016,COL,BAL,6,3,161,1.5,-120,9.5,100,-120,-181,-1.5,100,3.64,Camden Yards,9,3
2016-07-26,2016,DET,BOS,9,8,205,1.5,120,11.0,-120,100,-235,-1.5,-140,3.61,Fenway Park,17,1
2016-07-26,2016,CWS,CHC,3,0,170,1.5,100,9.0,-110,-110,-200,-1.5,-120,3.33,Guaranteed Rate Field,3,3
2016-07-26,2016,SF,CIN,9,7,-124,-1.5,170,8.0,-115,-105,114,1.5,-200,4.43,AT&T Park,16,2
2016-07-26,2016,WSH,CLE,6,7,130,1.5,-165,8.0,-120,100,-145,-1.5,145,3.48,Progressive Field,13,-1
2016-07-26,2016,BAL,COL,3,6,-181,-1.5,100,9.5,100,-120,161,1.5,-120,6.12,Camden Yards,9,-3
2016-07-26,2016,CHC,CWS,0,3,-200,-1.5,-120,9.0,-110,-110,170,1.5,100,6.0,Guaranteed Rate Field,3,-3
2016-07-26,2016,BOS,DET,8,9,-235,-1.5,-140,11.0,-120,100,205,1.5,120,7.72,Fenway Park,17,-1
2016-07-26,2016,NYY,HOU,6,3,134,1.5,-160,8.5,100,-120,-149,-1.5,140,3.63,Minute Maid Park,9,3
2016-07-26,2016,LAA,KC,13,0,-120,-1.5,125,9.0,103,-123,110,1.5,-145,4.91,Kauffman Stadium,13,13
2016-07-26,2016,KC,LAA,0,13,110,1.5,-145,9.0,103,-123,-120,-1.5,125,4.29,Kauffman Stadium,13,-13
2016-07-26,2016,TB,LAD,2,3,119,1.5,-200,7.5,-105,-115,-129,-1.5,170,3.42,Dodger Stadium,5,-1
2016-07-26,2016,PHI,MIA,0,5,118,1.5,-185,7.5,-110,-110,-133,-1.5,165,3.44,Marlins Park,5,-5
2016-07-26,2016,ARI,MIL,4,9,107,1.5,-200,9.0,-105,-115,-117,-1.5,170,4.35,Miller Park,13,-5
2016-07-26,2016,ATL,MIN,2,0,175,1.5,-110,9.5,-110,-110,-205,-1.5,-110,3.45,Target Field,2,2
2016-07-26,2016,STL,NYM,3,2,105,1.5,-210,7.5,-110,-110,-115,-1.5,160,3.66,Citi Field,5,1
2016-07-26,2016,STL,NYM,1,3,105,1.5,-200,8.0,-110,-110,-115,-1.5,170,3.9,Citi Field,4,-2
2016-07-26,2016,HOU,NYY,3,6,-149,-1.5,140,8.5,100,-120,134,1.5,-160,5.09,Minute Maid Park,9,-3
2016-07-26,2016,TEX,OAK,3,6,-101,1.5,-160,11.0,-105,-115,-109,-1.5,140,5.53,Rangers Ballpark,9,-3
2016-07-26,2016,MIA,PHI,5,0,-133,-1.5,165,7.5,-110,-110,118,1.5,-185,4.28,Marlins Park,5,5
2016-07-26,2016,SEA,PIT,7,4,126,1.5,-170,7.5,-130,110,-141,-1.5,150,3.32,PNC Park,11,3
2016-07-26,2016,TOR,SD,7,6,-275,-1.5,-135,9.5,100,-120,235,1.5,115,6.97,Rogers Centre,13,1
2016-07-26,2016,PIT,SEA,4,7,-141,-1.5,150,7.5,-130,110,126,1.5,-170,4.39,PNC Park,11,-3
2016-07-26,2016,CIN,SF,7,9,114,1.5,-200,8.0,-115,-105,-124,-1.5,170,3.74,AT&T Park,16,-2
2016-07-26,2016,NYM,STL,2,3,-115,-1.5,160,7.5,-110,-110,105,1.5,-210,4.01,Citi Field,5,-1
2016-07-26,2016,NYM,STL,3,1,-115,-1.5,170,8.0,-110,-110,105,1.5,-200,4.28,Citi Field,4,2
2016-07-26,2016,LAD,TB,3,2,-129,-1.5,170,7.5,-105,-115,119,1.5,-200,4.22,Dodger Stadium,5,1
2016-07-26,2016,OAK,TEX,6,3,-109,-1.5,140,11.0,-105,-115,-101,1.5,-160,5.74,Rangers Ballpark,9,3
2016-07-26,2016,SD,TOR,6,7,235,1.5,115,9.5,100,-120,-275,-1.5,-135,2.84,Rogers Centre,13,-1
2016-07-26,2016,CLE,WSH,7,6,-145,-1.5,145,8.0,-120,100,130,1.5,-165,4.73,Progressive Field,13,1
2016-07-27,2016,MIL,ARI,1,8,-140,-1.5,150,9.0,100,-120,125,1.5,-170,5.25,Miller Park,9,-7
2016-07-27,2016,MIN,ATL,7,9,-160,-1.5,130,8.0,-120,100,145,1.5,-150,4.92,Target Field,16,-2
2016-07-27,2016,COL,BAL,3,1,138,1.5,-155,9.0,105,-125,-153,-1.5,135,3.78,Camden Yards,4,2
2016-07-27,2016,DET,BOS,4,3,115,1.5,-170,10.5,-110,-110,-125,-1.5,150,4.88,Fenway Park,7,1
2016-07-27,2016,CWS,CHC,1,8,250,1.5,134,9.0,-110,-110,-290,-1.5,-154,2.57,Wrigley Field,9,-7
2016-07-27,2016,SF,CIN,1,2,-260,-1.5,-117,7.0,-125,105,220,1.5,-103,5.06,AT&T Park,3,-1
2016-07-27,2016,WSH,CLE,4,1,109,1.5,-205,7.5,-110,-110,-119,-1.5,175,3.59,Progressive Field,5,3
2016-07-27,2016,BAL,COL,1,3,-153,-1.5,135,9.0,105,-125,138,1.5,-155,5.44,Camden Yards,4,-2
2016-07-27,2016,CHC,CWS,8,1,-290,-1.5,-154,9.0,-110,-110,250,1.5,134,6.69,Wrigley Field,9,7
2016-07-27,2016,BOS,DET,3,4,-125,-1.5,150,10.5,-110,-110,115,1.5,-170,5.83,Fenway Park,7,-1
2016-07-27,2016,NYY,HOU,1,4,116,1.5,-185,7.0,100,-120,-126,-1.5,165,3.24,Minute Maid Park,5,-3
2016-07-27,2016,LAA,KC,5,7,114,1.5,-200,7.5,100,-120,-124,-1.5,170,3.5,Kauffman Stadium,12,-2
2016-07-27,2016,KC,LAA,7,5,-124,-1.5,170,7.5,100,-120,114,1.5,-200,4.15,Kauffman Stadium,12,2
2016-07-27,2016,TB,LAD,3,1,149,1.5,-150,8.0,-110,-110,-164,-1.5,130,3.21,Dodger Stadium,4,2
2016-07-27,2016,PHI,MIA,1,11,160,1.5,-150,7.0,-125,105,-180,-1.5,130,2.69,Marlins Park,12,-10
2016-07-27,2016,ARI,MIL,8,1,125,1.5,-170,9.0,100,-120,-140,-1.5,150,4.0,Miller Park,9,7
2016-07-27,2016,ATL,MIN,9,7,145,1.5,-150,8.0,-120,100,-160,-1.5,130,3.27,Target Field,16,2
2016-07-27,2016,STL,NYM,5,4,-133,-1.5,120,9.0,100,-120,118,1.5,-140,5.14,Citi Field,9,1
2016-07-27,2016,HOU,NYY,4,1,-126,-1.5,165,7.0,100,-120,116,1.5,-185,3.9,Minute Maid Park,5,3
2016-07-27,2016,TEX,OAK,4,6,-175,-1.5,115,8.5,-110,-110,155,1.5,-135,5.41,Rangers Ballpark,10,-2
2016-07-27,2016,MIA,PHI,11,1,-180,-1.5,130,7.0,-125,105,160,1.5,-150,4.5,Marlins Park,12,10
2016-07-27,2016,SEA,PIT,1,10,130,1.5,-170,8.5,-108,-112,-145,-1.5,150,3.7,PNC Park,11,-9
2016-07-27,2016,TOR,SD,4,8,-193,-1.5,-101,9.5,-115,-105,173,1.5,-119,6.26,Rogers Centre,12,-4
2016-07-27,2016,PIT,SEA,10,1,-145,-1.5,150,8.5,-108,-112,130,1.5,-170,5.03,PNC Park,11,9
2016-07-27,2016,CIN,SF,2,1,220,1.5,-103,7.0,-125,105,-260,-1.5,-117,2.19,AT&T Park,3,1
2016-07-27,2016,NYM,STL,4,5,118,1.5,-140,9.0,100,-120,-133,-1.5,120,4.13,Citi Field,9,-1
2016-07-27,2016,LAD,TB,1,3,-164,-1.5,130,8.0,-110,-110,149,1.5,-150,4.97,Dodger Stadium,4,-2
2016-07-27,2016,OAK,TEX,6,4,155,1.5,-135,8.5,-110,-110,-175,-1.5,115,3.33,Rangers Ballpark,10,2
2016-07-27,2016,SD,TOR,8,4,173,1.5,-119,9.5,-115,-105,-193,-1.5,-101,3.48,Rogers Centre,12,4
2016-07-27,2016,CLE,WSH,1,4,-119,-1.5,175,7.5,-110,-110,109,1.5,-205,4.08,Progressive Field,5,-3
2016-07-28,2016,MIL,ARI,6,4,-131,-1.5,160,7.5,105,-125,116,1.5,-180,4.25,Miller Park,10,2
2016-07-28,2016,PHI,ATL,7,5,-120,-1.5,140,8.0,100,-120,110,1.5,-160,4.36,Turner Field,12,2
2016-07-28,2016,MIN,BAL,6,2,110,1.5,-155,9.0,-110,-110,-120,-1.5,135,4.29,Target Field,8,4
2016-07-28,2016,LAA,BOS,2,1,157,1.5,105,9.0,-105,-115,-177,-1.5,-125,3.5,Angel Stadium,3,1
2016-07-28,2016,CWS,CHC,1,3,130,1.5,-180,7.0,-105,-115,-145,-1.5,160,3.04,Wrigley Field,4,-2
2016-07-28,2016,NYM,COL,1,2,-155,-1.5,150,6.5,-115,-105,140,1.5,-170,3.95,Citi Field,3,-1
2016-07-28,2016,CHC,CWS,3,1,-145,-1.5,160,7.0,-105,-115,130,1.5,-180,4.14,Wrigley Field,4,2
2016-07-28,2016,TEX,KC,3,2,-176,-1.5,120,9.0,100,-120,156,1.5,-140,5.74,Rangers Ballpark,5,1
2016-07-28,2016,BOS,LAA,1,2,-177,-1.5,-125,9.0,-105,-115,157,1.5,105,5.75,Angel Stadium,3,-1
2016-07-28,2016,STL,MIA,5,4,200,1.5,-110,6.5,-111,-109,-240,-1.5,-110,2.17,Marlins Park,9,1
2016-07-28,2016,ARI,MIL,4,6,116,1.5,-180,7.5,105,-125,-131,-1.5,160,3.47,Miller Park,10,-2
2016-07-28,2016,BAL,MIN,2,6,-120,-1.5,135,9.0,-110,-110,110,1.5,-155,4.91,Target Field,8,-4
2016-07-28,2016,COL,NYM,2,1,140,1.5,-170,6.5,-115,-105,-155,-1.5,150,2.71,Citi Field,3,1
2016-07-28,2016,ATL,PHI,5,7,110,1.5,-160,8.0,100,-120,-120,-1.5,140,3.81,Turner Field,12,-2
2016-07-28,2016,WSH,SF,4,2,134,1.5,-175,7.0,-110,-110,-149,-1.5,155,2.99,AT&T Park,6,2
2016-07-28,2016,MIA,STL,4,5,-240,-1.5,-110,6.5,-111,-109,200,1.5,-110,4.59,Marlins Park,9,-1
2016-07-28,2016,KC,TEX,2,3,156,1.5,-140,9.0,100,-120,-176,-1.5,120,3.52,Rangers Ballpark,5,-1
2016-07-28,2016,SF,WSH,2,4,-149,-1.5,155,7.0,-110,-110,134,1.5,-175,4.19,AT&T Park,6,-2
2016-07-29,2016,LAD,ARI,9,7,-235,-1.5,-110,8.0,-105,-115,205,1.5,-110,5.61,Dodger Stadium,16,2
2016-07-29,2016,PHI,ATL,1,2,-158,-1.5,-101,8.5,100,-120,143,1.5,-119,5.21,Turner Field,3,-1
2016-07-29,2016,TOR,BAL,6,5,-145,-1.5,140,9.0,105,-125,130,1.5,-160,5.33,Rogers Centre,11,1
2016-07-29,2016,LAA,BOS,2,6,156,1.5,100,9.0,-120,100,-176,-1.5,-120,3.52,Angel Stadium,8,-4
2016-07-29,2016,SEA,CHC,1,12,150,1.5,-145,7.5,-109,-111,-170,-1.5,125,3.0,Wrigley Field,13,-11
2016-07-29,2016,SD,CIN,0,6,-118,-1.5,175,9.5,-105,-115,108,1.5,-205,5.14,PETCO Park,6,-6
2016-07-29,2016,OAK,CLE,3,5,136,1.5,-156,9.0,-120,100,-151,-1.5,137,3.81,Progressive Field,8,-2
2016-07-29,2016,NYM,COL,1,6,-185,-1.5,125,8.0,-120,100,165,1.5,-145,5.19,Citi Field,7,-5
2016-07-29,2016,MIN,CWS,2,1,113,1.5,-145,8.5,-105,-115,-123,-1.5,125,3.99,Target Field,3,1
2016-07-29,2016,HOU,DET,6,14,-148,-1.5,115,9.0,-117,-103,133,1.5,-135,5.37,Comerica Park,20,-8
2016-07-29,2016,DET,HOU,14,6,133,1.5,-135,9.0,-117,-103,-148,-1.5,115,3.86,Comerica Park,20,8
2016-07-29,2016,TEX,KC,8,3,-128,-1.5,160,9.0,-125,105,118,1.5,-180,5.05,Rangers Ballpark,11,5
2016-07-29,2016,BOS,LAA,6,2,-176,-1.5,-120,9.0,-120,100,156,1.5,100,5.74,Angel Stadium,8,4
2016-07-29,2016,ARI,LAD,7,9,205,1.5,-110,8.0,-105,-115,-235,-1.5,-110,2.62,Dodger Stadium,16,-2
2016-07-29,2016,STL,MIA,11,6,-111,-1.5,150,7.5,-120,100,101,1.5,-170,3.95,Marlins Park,17,5
2016-07-29,2016,PIT,MIL,1,3,-130,-1.5,125,8.5,-101,-119,115,1.5,-145,4.8,Miller Park,4,-2
2016-07-29,2016,CWS,MIN,1,2,-123,-1.5,125,8.5,-105,-115,113,1.5,-145,4.69,Target Field,3,-1
2016-07-29,2016,COL,NYM,6,1,165,1.5,-145,8.0,-120,100,-185,-1.5,125,3.02,Citi Field,7,5
2016-07-29,2016,TB,NYY,5,1,-121,-1.5,172,7.5,105,-125,111,1.5,-202,4.11,Tropicana Field,6,4
2016-07-29,2016,CLE,OAK,5,3,-151,-1.5,137,9.0,-120,100,136,1.5,-156,5.41,Progressive Field,8,2
2016-07-29,2016,ATL,PHI,2,1,143,1.5,-119,8.5,100,-120,-158,-1.5,-101,3.5,Turner Field,3,1
2016-07-29,2016,MIL,PIT,3,1,115,1.5,-145,8.5,-101,-119,-130,-1.5,125,3.95,Miller Park,4,2
2016-07-29,2016,CIN,SD,6,0,108,1.5,-205,9.5,-105,-115,-118,-1.5,175,4.57,PETCO Park,6,6
2016-07-29,2016,CHC,SEA,12,1,-170,-1.5,125,7.5,-109,-111,150,1.5,-145,4.72,Wrigley Field,13,11
2016-07-29,2016,WSH,SF,4,1,-160,-1.5,100,7.0,-117,-103,145,1.5,-120,4.31,AT&T Park,5,3
2016-07-29,2016,MIA,STL,6,11,101,1.5,-170,7.5,-120,100,-111,-1.5,150,3.73,Marlins Park,17,-5
2016-07-29,2016,NYY,TB,1,5,111,1.5,-202,7.5,105,-125,-121,-1.5,172,3.55,Tropicana Field,6,-4
2016-07-29,2016,KC,TEX,3,8,118,1.5,-180,9.0,-125,105,-128,-1.5,160,4.13,Rangers Ballpark,11,-5
2016-07-29,2016,BAL,TOR,5,6,130,1.5,-160,9.0,105,-125,-145,-1.5,140,3.91,Rogers Centre,11,-1
2016-07-29,2016,SF,WSH,1,4,145,1.5,-120,7.0,-117,-103,-160,-1.5,100,2.86,AT&T Park,5,-3
2016-07-30,2016,LAD,ARI,2,4,-215,-1.5,-105,8.0,-110,-110,185,1.5,-115,5.46,Dodger Stadium,6,-2
2016-07-30,2016,PHI,ATL,9,5,119,1.5,-185,7.5,-115,-105,-134,-1.5,165,3.42,Turner Field,14,4
2016-07-30,2016,TOR,BAL,9,1,-180,-1.5,-101,9.5,-110,-110,160,1.5,-119,6.11,Rogers Centre,10,8
2016-07-30,2016,LAA,BOS,5,2,108,1.5,-150,8.0,-115,-105,-118,-1.5,130,3.85,Angel Stadium,7,3
2016-07-30,2016,SEA,CHC,4,1,195,1.5,-111,7.5,100,-120,-225,-1.5,-109,2.54,Wrigley Field,5,3
2016-07-30,2016,SD,CIN,2,1,112,1.5,-155,8.5,-105,-115,-122,-1.5,135,4.01,PETCO Park,3,1
2016-07-30,2016,OAK,CLE,3,6,145,1.5,-135,9.5,105,-125,-160,-1.5,115,3.88,Progressive Field,9,-3
2016-07-30,2016,NYM,COL,2,7,-140,-1.5,150,8.0,-101,-119,125,1.5,-170,4.67,Citi Field,9,-5
2016-07-30,2016,MIN,CWS,5,6,-123,-1.5,157,9.0,105,-125,113,1.5,-176,4.96,Target Field,11,-1
2016-07-30,2016,HOU,DET,2,3,117,1.5,-165,8.5,105,-125,-132,-1.5,145,3.92,Comerica Park,5,-1
2016-07-30,2016,DET,HOU,3,2,-132,-1.5,145,8.5,105,-125,117,1.5,-165,4.84,Comerica Park,5,1
2016-07-30,2016,TEX,KC,2,1,-120,-1.5,165,10.0,-105,-115,110,1.5,-185,5.45,Rangers Ballpark,3,1
2016-07-30,2016,BOS,LAA,2,5,-118,-1.5,130,8.0,-115,-105,108,1.5,-150,4.33,Angel Stadium,7,-3
2016-07-30,2016,ARI,LAD,4,2,185,1.5,-115,8.0,-110,-110,-215,-1.5,-105,2.81,Dodger Stadium,6,2
2016-07-30,2016,STL,MIA,0,11,-114,-1.5,145,8.0,-110,-110,104,1.5,-165,4.26,Marlins Park,11,-11
2016-07-30,2016,PIT,MIL,3,5,-175,-1.5,-110,8.5,-105,-115,155,1.5,-110,5.41,Miller Park,8,-2
2016-07-30,2016,CWS,MIN,6,5,113,1.5,-176,9.0,105,-125,-123,-1.5,157,4.23,Target Field,11,1
2016-07-30,2016,COL,NYM,7,2,125,1.5,-170,8.0,-101,-119,-140,-1.5,150,3.56,Citi Field,9,5
2016-07-30,2016,TB,NYY,6,3,-119,-1.5,170,7.0,-120,100,109,1.5,-200,3.8,Tropicana Field,9,3
2016-07-30,2016,CLE,OAK,6,3,-160,-1.5,115,9.5,105,-125,145,1.5,-135,5.85,Progressive Field,9,3
2016-07-30,2016,ATL,PHI,5,9,-134,-1.5,165,7.5,-115,-105,119,1.5,-185,4.29,Turner Field,14,-4
2016-07-30,2016,MIL,PIT,5,3,155,1.5,-110,8.5,-105,-115,-175,-1.5,-110,3.33,Miller Park,8,2
2016-07-30,2016,CIN,SD,1,2,-122,-1.5,135,8.5,-105,-115,112,1.5,-155,4.67,PETCO Park,3,-1
2016-07-30,2016,CHC,SEA,1,4,-225,-1.5,-109,7.5,100,-120,195,1.5,-111,5.19,Wrigley Field,5,-3
2016-07-30,2016,WSH,SF,3,5,117,1.5,-160,8.5,-125,105,-127,-1.5,140,3.92,AT&T Park,8,-2
2016-07-30,2016,MIA,STL,11,0,104,1.5,-165,8.0,-110,-110,-114,-1.5,145,3.92,Marlins Park,11,11
2016-07-30,2016,NYY,TB,3,6,109,1.5,-200,7.0,-120,100,-119,-1.5,170,3.35,Tropicana Field,9,-3
2016-07-30,2016,KC,TEX,1,2,110,1.5,-185,10.0,-105,-115,-120,-1.5,165,4.76,Rangers Ballpark,3,-1
2016-07-30,2016,BAL,TOR,1,9,160,1.5,-119,9.5,-110,-110,-180,-1.5,-101,3.65,Rogers Centre,10,-8
2016-07-30,2016,SF,WSH,5,3,-127,-1.5,140,8.5,-125,105,117,1.5,-160,4.76,AT&T Park,8,2
2016-07-31,2016,LAD,ARI,14,3,-177,-1.5,125,8.0,-111,-109,157,1.5,-145,5.11,Dodger Stadium,17,11
2016-07-31,2016,PHI,ATL,1,2,-133,-1.5,120,8.5,-110,-110,118,1.5,-140,4.85,Turner Field,3,-1
2016-07-31,2016,TOR,BAL,2,6,-170,-1.5,120,8.5,-125,105,150,1.5,-140,5.35,Rogers Centre,8,-4
2016-07-31,2016,LAA,BOS,3,5,-123,-1.5,175,8.5,-115,-105,113,1.5,-205,4.69,Angel Stadium,8,-2
2016-07-31,2016,SEA,CHC,6,7,108,1.5,-200,8.5,-120,100,-118,-1.5,170,4.09,Wrigley Field,13,-1
2016-07-31,2016,SD,CIN,2,3,118,1.5,-145,8.5,-125,105,-128,-1.5,125,3.9,PETCO Park,5,-1
2016-07-31,2016,OAK,CLE,0,8,170,1.5,-114,8.0,-105,-115,-200,-1.5,-106,2.96,Progressive Field,8,-8
2016-07-31,2016,NYM,COL,6,4,-200,-1.5,110,6.5,-120,100,170,1.5,-130,4.33,Citi Field,10,2
2016-07-31,2016,MIN,CWS,6,4,-126,-1.5,170,8.5,-110,-110,116,1.5,-200,4.74,Target Field,10,2
2016-07-31,2016,HOU,DET,0,11,-153,-1.5,100,9.5,-110,-110,138,1.5,-120,5.75,Comerica Park,11,-11
2016-07-31,2016,DET,HOU,11,0,138,1.5,-120,9.5,-110,-110,-153,-1.5,100,3.99,Comerica Park,11,11
2016-07-31,2016,TEX,KC,5,3,-130,-1.5,150,10.0,-115,-105,115,1.5,-170,5.65,Rangers Ballpark,8,2
2016-07-31,2016,BOS,LAA,5,3,113,1.5,-205,8.5,-115,-105,-123,-1.5,175,3.99,Angel Stadium,8,2
2016-07-31,2016,ARI,LAD,3,14,157,1.5,-145,8.0,-111,-109,-177,-1.5,125,3.11,Dodger Stadium,17,-11
2016-07-31,2016,STL,MIA,4,5,-117,-1.5,135,7.5,-115,-105,107,1.5,-155,4.04,Marlins Park,9,-1
2016-07-31,2016,PIT,MIL,2,4,-147,-1.5,110,8.5,-110,-110,132,1.5,-130,5.06,Miller Park,6,-2
2016-07-31,2016,CWS,MIN,4,6,116,1.5,-200,8.5,-110,-110,-126,-1.5,170,3.94,Target Field,10,-2
2016-07-31,2016,COL,NYM,4,6,170,1.5,-130,6.5,-120,100,-200,-1.5,110,2.41,Citi Field,10,-2
2016-07-31,2016,TB,NYY,5,3,107,1.5,-170,7.0,105,-125,-117,-1.5,150,3.38,Tropicana Field,8,2
2016-07-31,2016,CLE,OAK,8,0,-200,-1.5,-106,8.0,-105,-115,170,1.5,-114,5.33,Progressive Field,8,8
2016-07-31,2016,ATL,PHI,2,1,118,1.5,-140,8.5,-110,-110,-133,-1.5,120,3.9,Turner Field,3,1
2016-07-31,2016,MIL,PIT,4,2,132,1.5,-130,8.5,-110,-110,-147,-1.5,110,3.66,Miller Park,6,2
2016-07-31,2016,CIN,SD,3,2,-128,-1.5,125,8.5,-125,105,118,1.5,-145,4.77,PETCO Park,5,1
2016-07-31,2016,CHC,SEA,7,6,-118,-1.5,170,8.5,-120,100,108,1.5,-200,4.6,Wrigley Field,13,1
2016-07-31,2016,WSH,SF,1,3,-117,-1.5,135,8.5,-110,-110,107,1.5,-155,4.58,AT&T Park,4,-2
2016-07-31,2016,MIA,STL,5,4,107,1.5,-155,7.5,-115,-105,-117,-1.5,135,3.62,Marlins Park,9,1
2016-07-31,2016,NYY,TB,3,5,-117,-1.5,150,7.0,105,-125,107,1.5,-170,3.77,Tropicana Field,8,-2
2016-07-31,2016,KC,TEX,3,5,115,1.5,-170,10.0,-115,-105,-130,-1.5,150,4.65,Rangers Ballpark,8,-2
2016-07-31,2016,BAL,TOR,6,2,150,1.5,-140,8.5,-125,105,-170,-1.5,120,3.4,Rogers Centre,8,4
2016-07-31,2016,SF,WSH,3,1,107,1.5,-155,8.5,-110,-110,-117,-1.5,135,4.11,AT&T Park,4,2
2016-08-01,2016,WSH,ARI,14,1,-215,-1.5,-135,8.5,-115,-105,185,1.5,115,5.8,Chase Field,15,13
2016-08-01,2016,SEA,BOS,1,2,-130,-1.5,165,8.5,-120,100,115,1.5,-185,4.8,T-Mobile Park,3,-1
2016-08-01,2016,MIA,CHC,0,5,160,1.5,-135,7.5,-110,-110,-180,-1.5,115,2.88,Wrigley Field,5,-5
2016-08-01,2016,MIN,CLE,12,5,190,1.5,102,8.5,100,-120,-220,-1.5,-122,2.93,Progressive Field,17,7
2016-08-01,2016,TOR,HOU,1,2,-105,-1.5,150,8.5,100,-120,-105,1.5,-170,4.35,Minute Maid Park,3,-1
2016-08-01,2016,TB,KC,0,3,-125,-1.5,170,7.0,100,-120,115,1.5,-200,3.89,Tropicana Field,3,-3
2016-08-01,2016,CHC,MIA,5,0,-180,-1.5,115,7.5,-110,-110,160,1.5,-135,4.82,Wrigley Field,5,5
2016-08-01,2016,SD,MIL,7,3,-105,-1.5,185,8.0,100,-120,-105,1.5,-215,4.1,PETCO Park,10,4
2016-08-01,2016,CLE,MIN,5,12,-220,-1.5,-122,8.5,100,-120,190,1.5,102,5.84,Progressive Field,17,-7
2016-08-01,2016,NYY,NYM,6,5,-122,-1.5,135,7.5,-105,-115,112,1.5,-155,4.12,Citi Field,11,1
2016-08-01,2016,NYM,NYY,5,6,112,1.5,-155,7.5,-105,-115,-122,-1.5,135,3.54,Citi Field,11,-1
2016-08-01,2016,MIL,SD,3,7,-105,1.5,-215,8.0,100,-120,-105,-1.5,185,4.1,PETCO Park,10,-4
2016-08-01,2016,BOS,SEA,2,1,115,1.5,-185,8.5,-120,100,-130,-1.5,165,3.95,T-Mobile Park,3,1
2016-08-01,2016,KC,TB,3,0,115,1.5,-200,7.0,100,-120,-125,-1.5,170,3.26,Tropicana Field,3,3
2016-08-01,2016,HOU,TOR,2,1,-105,1.5,-170,8.5,100,-120,-105,-1.5,150,4.35,Minute Maid Park,3,1
2016-08-01,2016,ARI,WSH,1,14,185,1.5,115,8.5,-115,-105,-215,-1.5,-135,2.98,Chase Field,15,-13
2016-08-02,2016,WSH,ARI,10,4,-122,-1.5,130,8.5,-115,-105,112,1.5,-150,4.67,Chase Field,14,6
2016-08-02,2016,PIT,ATL,5,3,-174,-1.5,-105,7.5,-115,-105,154,1.5,-115,4.76,Turner Field,8,2
2016-08-02,2016,TEX,BAL,1,5,-126,-1.5,125,8.5,100,-120,116,1.5,-145,4.74,Camden Yards,6,-4
2016-08-02,2016,SEA,BOS,5,4,150,1.5,-110,8.0,-115,-105,-170,-1.5,-110,3.2,T-Mobile Park,9,1
2016-08-02,2016,MIA,CHC,2,3,-115,-1.5,135,7.0,-110,-110,105,1.5,-155,3.74,Wrigley Field,5,-1
2016-08-02,2016,STL,CIN,5,7,-157,-1.5,100,8.5,-110,-110,142,1.5,-120,5.19,Great American Ballpark,12,-2
2016-08-02,2016,MIN,CLE,10,6,180,1.5,-115,8.0,-105,-115,-210,-1.5,-105,2.86,Progressive Field,16,4
2016-08-02,2016,LAD,COL,3,7,-142,-1.5,110,10.5,-115,-105,127,1.5,-130,6.16,Coors Field,10,-4
2016-08-02,2016,DET,CWS,11,5,-154,-1.5,120,9.5,100,-120,139,1.5,-140,5.76,Comerica Park,16,6
2016-08-02,2016,CWS,DET,5,11,139,1.5,-140,9.5,100,-120,-154,-1.5,120,3.97,Comerica Park,16,-6
2016-08-02,2016,TOR,HOU,2,1,148,1.5,-150,8.0,100,-120,-163,-1.5,130,3.23,Minute Maid Park,3,1
2016-08-02,2016,TB,KC,2,3,-117,-1.5,175,7.5,-110,-110,107,1.5,-205,4.04,Tropicana Field,5,-1
2016-08-02,2016,OAK,LAA,4,5,135,1.5,-170,7.5,-120,100,-150,-1.5,150,3.19,Angel Stadium,9,-1
2016-08-02,2016,COL,LAD,7,3,127,1.5,-130,10.5,-115,-105,-142,-1.5,110,4.63,Coors Field,10,4
2016-08-02,2016,CHC,MIA,3,2,105,1.5,-155,7.0,-110,-110,-115,-1.5,135,3.41,Wrigley Field,5,1
2016-08-02,2016,SD,MIL,2,3,104,1.5,-175,7.5,-105,-115,-114,-1.5,155,3.68,PETCO Park,5,-1
2016-08-02,2016,CLE,MIN,6,10,-210,-1.5,-105,8.0,-105,-115,180,1.5,-115,5.42,Progressive Field,16,-4
2016-08-02,2016,NYY,NYM,1,7,101,1.5,-247,6.5,105,-125,-111,-1.5,203,3.23,Citi Field,8,-6
2016-08-02,2016,NYM,NYY,7,1,-111,-1.5,203,6.5,105,-125,101,1.5,-247,3.42,Citi Field,8,6
2016-08-02,2016,LAA,OAK,5,4,-150,-1.5,150,7.5,-120,100,135,1.5,-170,4.5,Angel Stadium,9,1
2016-08-02,2016,SF,PHI,8,13,-260,-1.5,-145,7.5,-115,-105,220,1.5,125,5.42,Citizens Bank Park,21,-5
2016-08-02,2016,ATL,PIT,3,5,154,1.5,-115,7.5,-115,-105,-174,-1.5,-105,2.95,Turner Field,8,-2
2016-08-02,2016,MIL,SD,3,2,-114,-1.5,155,7.5,-105,-115,104,1.5,-175,4.0,PETCO Park,5,1
2016-08-02,2016,BOS,SEA,4,5,-170,-1.5,-110,8.0,-115,-105,150,1.5,-110,5.04,T-Mobile Park,9,-1
2016-08-02,2016,PHI,SF,13,8,220,1.5,125,7.5,-115,-105,-260,-1.5,-145,2.34,Citizens Bank Park,21,5
2016-08-02,2016,CIN,STL,7,5,142,1.5,-120,8.5,-110,-110,-157,-1.5,100,3.51,Great American Ballpark,12,2
2016-08-02,2016,KC,TB,3,2,107,1.5,-205,7.5,-110,-110,-117,-1.5,175,3.62,Tropicana Field,5,1
2016-08-02,2016,BAL,TEX,5,1,116,1.5,-145,8.5,100,-120,-126,-1.5,125,3.94,Camden Yards,6,4
2016-08-02,2016,HOU,TOR,1,2,-163,-1.5,130,8.0,100,-120,148,1.5,-150,4.96,Minute Maid Park,3,-1
2016-08-02,2016,ARI,WSH,4,10,112,1.5,-150,8.5,-115,-105,-122,-1.5,130,4.01,Chase Field,14,-6
2016-08-03,2016,WSH,ARI,8,3,-207,-1.5,-123,8.0,-110,-110,177,1.5,103,5.39,Chase Field,11,5
2016-08-03,2016,PIT,ATL,4,8,-118,-1.5,140,8.5,-126,106,108,1.5,-160,4.6,Turner Field,12,-4
2016-08-03,2016,TEX,BAL,2,3,102,1.5,-210,8.0,-110,-110,-112,-1.5,180,3.96,Camden Yards,5,-1
2016-08-03,2016,SEA,BOS,3,1,107,1.5,-160,8.0,-115,-105,-117,-1.5,140,3.86,T-Mobile Park,4,2
2016-08-03,2016,MIA,CHC,4,5,200,1.5,-105,9.0,100,-120,-230,-1.5,-115,3.0,Wrigley Field,9,-1
2016-08-03,2016,STL,CIN,5,4,-141,-1.5,110,9.0,-115,-105,126,1.5,-130,5.27,Great American Ballpark,9,1
2016-08-03,2016,MIN,CLE,13,5,160,1.5,-125,9.0,-128,108,-180,-1.5,105,3.46,Progressive Field,18,8
2016-08-03,2016,LAD,COL,2,12,-105,1.5,-200,11.5,-110,-110,-105,-1.5,170,5.89,Coors Field,14,-10
2016-08-03,2016,DET,CWS,2,1,-141,-1.5,150,8.0,-120,100,126,1.5,-170,4.68,Comerica Park,3,1
2016-08-03,2016,CWS,DET,1,2,126,1.5,-170,8.0,-120,100,-141,-1.5,150,3.54,Comerica Park,3,-1
2016-08-03,2016,TOR,HOU,3,1,-101,1.5,-230,8.0,-105,-115,-109,-1.5,190,4.02,Minute Maid Park,4,2
2016-08-03,2016,TB,KC,12,0,-145,-1.5,145,7.0,-122,102,130,1.5,-165,4.14,Tropicana Field,12,12
2016-08-03,2016,OAK,LAA,6,8,114,1.5,-185,9.0,-110,-110,-124,-1.5,165,4.21,Angel Stadium,14,-2
2016-08-03,2016,COL,LAD,12,2,-105,-1.5,170,11.5,-110,-110,-105,1.5,-200,5.89,Coors Field,14,10
2016-08-03,2016,CHC,MIA,5,4,-230,-1.5,-115,9.0,100,-120,200,1.5,-105,6.27,Wrigley Field,9,1
2016-08-03,2016,SD,MIL,12,3,114,1.5,-150,8.5,-115,-105,-124,-1.5,130,3.97,PETCO Park,15,9
2016-08-03,2016,CLE,MIN,5,13,-180,-1.5,105,9.0,-128,108,160,1.5,-125,5.79,Progressive Field,18,-8
2016-08-03,2016,NYY,NYM,9,5,-104,1.5,-175,8.0,100,-120,-106,-1.5,155,4.08,Yankee Stadium,14,4
2016-08-03,2016,NYM,NYY,5,9,-106,-1.5,155,8.0,100,-120,-104,1.5,-175,4.12,Yankee Stadium,14,-4
2016-08-03,2016,LAA,OAK,8,6,-124,-1.5,165,9.0,-110,-110,114,1.5,-185,4.98,Angel Stadium,14,2
2016-08-03,2016,SF,PHI,4,5,-200,-1.5,-125,8.0,-115,-105,170,1.5,105,5.33,Citizens Bank Park,9,-1
2016-08-03,2016,ATL,PIT,8,4,108,1.5,-160,8.5,-126,106,-118,-1.5,140,4.09,Turner Field,12,4
2016-08-03,2016,MIL,SD,3,12,-124,-1.5,130,8.5,-115,-105,114,1.5,-150,4.71,PETCO Park,15,-9
2016-08-03,2016,BOS,SEA,1,3,-117,-1.5,140,8.0,-115,-105,107,1.5,-160,4.31,T-Mobile Park,4,-2
2016-08-03,2016,PHI,SF,5,4,170,1.5,105,8.0,-115,-105,-200,-1.5,-125,2.96,Citizens Bank Park,9,1
2016-08-03,2016,CIN,STL,4,5,126,1.5,-130,9.0,-115,-105,-141,-1.5,110,3.98,Great American Ballpark,9,-1
2016-08-03,2016,KC,TB,0,12,130,1.5,-165,7.0,-122,102,-145,-1.5,145,3.04,Tropicana Field,12,-12
2016-08-03,2016,BAL,TEX,3,2,-112,-1.5,180,8.0,-110,-110,102,1.5,-210,4.23,Camden Yards,5,1
2016-08-03,2016,HOU,TOR,1,3,-109,-1.5,190,8.0,-105,-115,-101,1.5,-230,4.17,Minute Maid Park,4,-2
2016-08-03,2016,ARI,WSH,3,8,177,1.5,103,8.0,-110,-110,-207,-1.5,-123,2.89,Chase Field,11,-5
2016-08-04,2016,PIT,ATL,2,5,-128,-1.5,125,9.0,-115,-105,118,1.5,-145,5.05,Turner Field,7,-3
2016-08-04,2016,TEX,BAL,5,3,117,1.5,-175,10.0,100,-120,-127,-1.5,155,4.61,Camden Yards,8,2
2016-08-04,2016,SEA,BOS,2,3,125,1.5,-140,8.5,-115,-105,-140,-1.5,120,3.78,T-Mobile Park,5,-1
2016-08-04,2016,STL,CIN,0,7,-149,-1.5,100,9.5,105,-125,134,1.5,-120,5.68,Great American Ballpark,7,-7
2016-08-04,2016,MIN,CLE,2,9,140,1.5,-150,9.5,118,-138,-155,-1.5,130,3.96,Progressive Field,11,-7
2016-08-04,2016,LAD,COL,4,2,-170,-1.5,-120,10.5,-110,-110,150,1.5,100,6.61,Coors Field,6,2
2016-08-04,2016,DET,CWS,3,6,-123,-1.5,165,8.5,-101,-119,113,1.5,-185,4.69,Comerica Park,9,-3
2016-08-04,2016,CWS,DET,6,3,113,1.5,-185,8.5,-101,-119,-123,-1.5,165,3.99,Comerica Park,9,3
2016-08-04,2016,TOR,HOU,4,1,-112,-1.5,140,8.5,-105,-115,102,1.5,-160,4.49,Minute Maid Park,5,3
2016-08-04,2016,TB,KC,3,2,-129,-1.5,165,7.5,-101,-119,119,1.5,-185,4.22,Tropicana Field,5,1
2016-08-04,2016,OAK,LAA,8,6,108,1.5,-180,8.5,-120,100,-118,-1.5,160,4.09,Angel Stadium,14,2
2016-08-04,2016,COL,LAD,2,4,150,1.5,100,10.5,-110,-110,-170,-1.5,-120,4.2,Coors Field,6,-2
2016-08-04,2016,CLE,MIN,9,2,-155,-1.5,130,9.5,118,-138,140,1.5,-150,5.77,Progressive Field,11,7
2016-08-04,2016,NYY,NYM,1,4,-144,-1.5,150,8.5,-120,100,129,1.5,-170,5.02,Yankee Stadium,5,-3
2016-08-04,2016,NYM,NYY,4,1,129,1.5,-170,8.5,-120,100,-144,-1.5,150,3.71,Yankee Stadium,5,3
2016-08-04,2016,LAA,OAK,6,8,-118,-1.5,160,8.5,-120,100,108,1.5,-180,4.6,Angel Stadium,14,-2
2016-08-04,2016,SF,PHI,3,2,-117,-1.5,145,8.0,-110,-110,107,1.5,-165,4.31,Citizens Bank Park,5,1
2016-08-04,2016,ATL,PIT,5,2,118,1.5,-145,9.0,-115,-105,-128,-1.5,125,4.13,Turner Field,7,3
2016-08-04,2016,BOS,SEA,3,2,-140,-1.5,120,8.5,-115,-105,125,1.5,-140,4.96,T-Mobile Park,5,1
2016-08-04,2016,PHI,SF,2,3,107,1.5,-165,8.0,-110,-110,-117,-1.5,145,3.86,Citizens Bank Park,5,-1
2016-08-04,2016,CIN,STL,7,0,134,1.5,-120,9.5,105,-125,-149,-1.5,100,4.06,Great American Ballpark,7,7
2016-08-04,2016,KC,TB,2,3,119,1.5,-185,7.5,-101,-119,-129,-1.5,165,3.42,Tropicana Field,5,-1
2016-08-04,2016,BAL,TEX,3,5,-127,-1.5,155,10.0,100,-120,117,1.5,-175,5.59,Camden Yards,8,-2
2016-08-04,2016,HOU,TOR,1,4,102,1.5,-160,8.5,-105,-115,-112,-1.5,140,4.21,Minute Maid Park,5,-3
2016-08-05,2016,MIL,ARI,2,3,106,1.5,-185,9.5,-115,-105,-116,-1.5,165,4.61,Chase Field,5,-1
2016-08-05,2016,STL,ATL,1,0,-230,-1.5,-110,8.5,-119,-101,200,1.5,-110,5.92,Busch Stadium,1,1
2016-08-05,2016,CWS,BAL,5,7,107,1.5,-160,9.5,-115,-105,-117,-1.5,140,4.59,Guaranteed Rate Field,12,-2
2016-08-05,2016,LAD,BOS,0,9,-140,-1.5,160,7.5,-115,-105,125,1.5,-180,4.38,Dodger Stadium,9,-9
2016-08-05,2016,OAK,CHC,2,7,185,1.5,122,8.5,-105,-115,-215,-1.5,-142,2.98,Oakland Coliseum,9,-5
2016-08-05,2016,PIT,CIN,3,2,-158,-1.5,140,8.0,-119,-101,143,1.5,-160,4.9,PNC Park,5,1
2016-08-05,2016,NYY,CLE,13,7,-113,-1.5,180,8.0,-119,-101,103,1.5,-210,4.24,Yankee Stadium,20,6
2016-08-05,2016,MIA,COL,5,3,-122,-1.5,125,11.5,-115,-105,112,1.5,-145,6.32,Coors Field,8,2
2016-08-05,2016,BAL,CWS,7,5,-117,-1.5,140,9.5,-115,-105,107,1.5,-160,5.12,Guaranteed Rate Field,12,2
2016-08-05,2016,NYM,DET,3,4,133,1.5,-165,7.5,100,-120,-148,-1.5,145,3.22,Comerica Park,7,-1
2016-08-05,2016,TEX,HOU,0,5,157,1.5,-140,8.5,100,-120,-177,-1.5,120,3.31,Minute Maid Park,5,-5
2016-08-05,2016,TOR,KC,4,3,-155,-1.5,100,9.0,-125,105,140,1.5,-120,5.47,Kauffman Stadium,7,1
2016-08-05,2016,SEA,LAA,6,4,-220,-1.5,-105,9.0,-115,-105,190,1.5,-115,6.19,T-Mobile Park,10,2
2016-08-05,2016,BOS,LAD,9,0,125,1.5,-180,7.5,-115,-105,-140,-1.5,160,3.33,Dodger Stadium,9,9
2016-08-05,2016,COL,MIA,3,5,112,1.5,-145,11.5,-115,-105,-122,-1.5,125,5.42,Coors Field,8,-2
2016-08-05,2016,ARI,MIL,3,2,-116,-1.5,165,9.5,-115,-105,106,1.5,-185,5.1,Chase Field,5,1
2016-08-05,2016,TB,MIN,2,6,-130,-1.5,170,7.5,-105,-115,115,1.5,-200,4.24,Tropicana Field,8,-4
2016-08-05,2016,DET,NYM,4,3,-148,-1.5,145,7.5,100,-120,133,1.5,-165,4.48,Comerica Park,7,1
2016-08-05,2016,CLE,NYY,7,13,103,1.5,-210,8.0,-119,-101,-113,-1.5,180,3.94,Yankee Stadium,20,-6
2016-08-05,2016,CHC,OAK,7,2,-215,-1.5,-142,8.5,-105,-115,185,1.5,122,5.8,Oakland Coliseum,9,5
2016-08-05,2016,SD,PHI,4,5,-105,1.5,-175,8.0,-110,-110,-105,-1.5,155,4.1,PETCO Park,9,-1
2016-08-05,2016,CIN,PIT,2,3,143,1.5,-160,8.0,-119,-101,-158,-1.5,140,3.29,PNC Park,5,-1
2016-08-05,2016,PHI,SD,5,4,-105,-1.5,155,8.0,-110,-110,-105,1.5,-175,4.1,PETCO Park,9,1
2016-08-05,2016,LAA,SEA,4,6,190,1.5,-115,9.0,-115,-105,-220,-1.5,-105,3.1,T-Mobile Park,10,-2
2016-08-05,2016,WSH,SF,5,1,-160,-1.5,130,8.5,-115,-105,145,1.5,-150,5.23,Nationals Park,6,4
2016-08-05,2016,ATL,STL,0,1,200,1.5,-110,8.5,-119,-101,-230,-1.5,-110,2.83,Busch Stadium,1,-1
2016-08-05,2016,MIN,TB,6,2,115,1.5,-200,7.5,-105,-115,-130,-1.5,170,3.49,Tropicana Field,8,4
2016-08-05,2016,HOU,TEX,5,0,-177,-1.5,120,8.5,100,-120,157,1.5,-140,5.43,Minute Maid Park,5,5
2016-08-05,2016,KC,TOR,3,4,140,1.5,-120,9.0,-125,105,-155,-1.5,100,3.75,Kauffman Stadium,7,-1
2016-08-05,2016,SF,WSH,1,5,145,1.5,-150,8.5,-115,-105,-160,-1.5,130,3.47,Nationals Park,6,-4
2016-08-06,2016,MIL,ARI,15,6,118,1.5,-165,9.5,-120,100,-128,-1.5,145,4.36,Chase Field,21,9
2016-08-06,2016,STL,ATL,5,13,-240,-1.5,-118,9.0,100,-120,200,1.5,-102,6.35,Busch Stadium,18,-8
2016-08-06,2016,CWS,BAL,4,2,132,1.5,-130,9.0,-108,-112,-147,-1.5,110,3.88,Guaranteed Rate Field,6,2
2016-08-06,2016,LAD,BOS,3,0,-111,-1.5,175,9.0,100,-120,101,1.5,-205,4.73,Dodger Stadium,3,3
2016-08-06,2016,OAK,CHC,0,4,176,1.5,106,7.5,-110,-110,-206,-1.5,-126,2.72,Oakland Coliseum,4,-4
2016-08-06,2016,PIT,CIN,5,3,-130,-1.5,157,8.5,-125,105,115,1.5,-176,4.8,PNC Park,8,2
2016-08-06,2016,NYY,CLE,2,5,175,1.5,121,8.5,-115,-105,-195,-1.5,-141,3.09,Yankee Stadium,7,-3
2016-08-06,2016,MIA,COL,6,12,107,1.5,-170,12.0,-110,-110,-117,-1.5,150,5.8,Coors Field,18,-6
2016-08-06,2016,BAL,CWS,2,4,-147,-1.5,110,9.0,-108,-112,132,1.5,-130,5.36,Guaranteed Rate Field,6,-2
2016-08-06,2016,NYM,DET,5,6,165,1.5,-120,9.5,-101,-119,-185,-1.5,100,3.58,Comerica Park,11,-1
2016-08-06,2016,TEX,HOU,3,2,131,1.5,-166,9.0,-105,-115,-146,-1.5,146,3.9,Minute Maid Park,5,1
2016-08-06,2016,TOR,KC,2,4,-154,-1.5,100,7.5,-115,-105,139,1.5,-120,4.55,Kauffman Stadium,6,-2
2016-08-06,2016,SEA,LAA,8,6,107,1.5,-155,7.5,-110,-110,-117,-1.5,135,3.62,T-Mobile Park,14,2
2016-08-06,2016,BOS,LAD,0,3,101,1.5,-205,9.0,100,-120,-111,-1.5,175,4.48,Dodger Stadium,3,-3
2016-08-06,2016,COL,MIA,12,6,-117,-1.5,150,12.0,-110,-110,107,1.5,-170,6.47,Coors Field,18,6
2016-08-06,2016,ARI,MIL,6,15,-128,-1.5,145,9.5,-120,100,118,1.5,-165,5.33,Chase Field,21,-9
2016-08-06,2016,TB,MIN,7,3,-141,-1.5,155,7.0,-130,110,126,1.5,-175,4.1,Tropicana Field,10,4
2016-08-06,2016,DET,NYM,6,5,-185,-1.5,100,9.5,-101,-119,165,1.5,-120,6.17,Comerica Park,11,1
2016-08-06,2016,CLE,NYY,5,2,-195,-1.5,-141,8.5,-115,-105,175,1.5,121,5.62,Yankee Stadium,7,3
2016-08-06,2016,CHC,OAK,4,0,-206,-1.5,-126,7.5,-110,-110,176,1.5,106,5.05,Oakland Coliseum,4,4
2016-08-06,2016,SD,PHI,9,7,-110,-1.5,175,8.5,-110,-110,100,1.5,-204,4.45,PETCO Park,16,2
2016-08-06,2016,CIN,PIT,3,5,115,1.5,-176,8.5,-125,105,-130,-1.5,157,3.95,PNC Park,8,-2
2016-08-06,2016,PHI,SD,7,9,100,1.5,-204,8.5,-110,-110,-110,-1.5,175,4.25,PETCO Park,16,-2
2016-08-06,2016,LAA,SEA,6,8,-117,-1.5,135,7.5,-110,-110,107,1.5,-155,4.04,T-Mobile Park,14,-2
2016-08-06,2016,WSH,SF,1,7,-215,-1.5,-113,8.5,100,-120,185,1.5,-107,5.8,Nationals Park,8,-6
2016-08-06,2016,ATL,STL,13,5,200,1.5,-102,9.0,100,-120,-240,-1.5,-118,3.0,Busch Stadium,18,8
2016-08-06,2016,MIN,TB,3,7,126,1.5,-175,7.0,-130,110,-141,-1.5,155,3.1,Tropicana Field,10,-4
2016-08-06,2016,HOU,TEX,2,3,-146,-1.5,146,9.0,-105,-115,131,1.5,-166,5.34,Minute Maid Park,5,-1
2016-08-06,2016,KC,TOR,4,2,139,1.5,-120,7.5,-115,-105,-154,-1.5,100,3.14,Kauffman Stadium,6,2
2016-08-06,2016,SF,WSH,7,1,185,1.5,-107,8.5,100,-120,-215,-1.5,-113,2.98,Nationals Park,8,6
2016-08-07,2016,MIL,ARI,3,9,114,1.5,-171,9.5,-105,-115,-124,-1.5,152,4.44,Chase Field,12,-6
2016-08-07,2016,STL,ATL,3,6,-205,-1.5,-105,8.0,-120,100,175,1.5,-115,5.38,Busch Stadium,9,-3
2016-08-07,2016,CWS,BAL,2,10,150,1.5,-105,9.0,-125,105,-170,-1.5,-115,3.6,Guaranteed Rate Field,12,-8
2016-08-07,2016,LAD,BOS,8,5,101,1.5,-170,7.0,105,-125,-111,-1.5,150,3.48,Dodger Stadium,13,3
2016-08-07,2016,OAK,CHC,1,3,160,1.5,-110,8.0,106,-126,-180,-1.5,-110,3.08,Oakland Coliseum,4,-2
2016-08-07,2016,PIT,CIN,3,7,-175,-1.5,130,8.0,-115,-105,155,1.5,-150,5.09,PNC Park,10,-4
2016-08-07,2016,NYY,CLE,3,2,100,1.5,-170,8.0,-110,-110,-110,-1.5,150,4.0,Yankee Stadium,5,1
2016-08-07,2016,MIA,COL,10,7,130,1.5,-144,10.5,-103,-117,-145,-1.5,124,4.57,Coors Field,17,3
2016-08-07,2016,BAL,CWS,10,2,-170,-1.5,-115,9.0,-125,105,150,1.5,-105,5.67,Guaranteed Rate Field,12,8
2016-08-07,2016,NYM,DET,3,1,-130,-1.5,125,8.5,-105,-115,115,1.5,-145,4.8,Comerica Park,4,2
2016-08-07,2016,TEX,HOU,5,3,-123,-1.5,130,7.5,-115,-105,113,1.5,-150,4.14,Minute Maid Park,8,2
2016-08-07,2016,TOR,KC,1,7,-154,-1.5,100,8.5,100,-120,139,1.5,-120,5.15,Kauffman Stadium,8,-6
2016-08-07,2016,SEA,LAA,3,1,-129,-1.5,175,7.5,-116,-104,119,1.5,-205,4.22,T-Mobile Park,4,2
2016-08-07,2016,BOS,LAD,5,8,-111,-1.5,150,7.0,105,-125,101,1.5,-170,3.68,Dodger Stadium,13,-3
2016-08-07,2016,COL,MIA,7,10,-145,-1.5,124,10.5,-103,-117,130,1.5,-144,6.21,Coors Field,17,-3
2016-08-07,2016,ARI,MIL,9,3,-124,-1.5,152,9.5,-105,-115,114,1.5,-171,5.26,Chase Field,12,6
2016-08-07,2016,TB,MIN,3,6,-126,-1.5,170,8.0,-105,-115,116,1.5,-200,4.46,Tropicana Field,9,-3
2016-08-07,2016,DET,NYM,1,3,115,1.5,-145,8.5,-105,-115,-130,-1.5,125,3.95,Comerica Park,4,-2
2016-08-07,2016,CLE,NYY,2,3,-110,-1.5,150,8.0,-110,-110,100,1.5,-170,4.19,Yankee Stadium,5,-1
2016-08-07,2016,CHC,OAK,3,1,-180,-1.5,-110,8.0,106,-126,160,1.5,-110,5.14,Oakland Coliseum,4,2
2016-08-07,2016,SD,PHI,5,6,-109,-1.5,175,8.5,100,-120,-101,1.5,-205,4.43,PETCO Park,11,-1
2016-08-07,2016,CIN,PIT,7,3,155,1.5,-150,8.0,-115,-105,-175,-1.5,130,3.14,PNC Park,10,4
2016-08-07,2016,PHI,SD,6,5,-101,1.5,-205,8.5,100,-120,-109,-1.5,175,4.27,PETCO Park,11,1
2016-08-07,2016,LAA,SEA,1,3,119,1.5,-205,7.5,-116,-104,-129,-1.5,175,3.42,T-Mobile Park,4,-2
2016-08-07,2016,WSH,SF,1,0,125,1.5,-135,7.5,-115,-105,-140,-1.5,115,3.33,Nationals Park,1,1
2016-08-07,2016,ATL,STL,6,3,175,1.5,-115,8.0,-120,100,-205,-1.5,-105,2.91,Busch Stadium,9,3
2016-08-07,2016,MIN,TB,6,3,116,1.5,-200,8.0,-105,-115,-126,-1.5,170,3.7,Tropicana Field,9,3
2016-08-07,2016,HOU,TEX,3,5,113,1.5,-150,7.5,-115,-105,-123,-1.5,130,3.52,Minute Maid Park,8,-2
2016-08-07,2016,KC,TOR,7,1,139,1.5,-120,8.5,100,-120,-154,-1.5,100,3.56,Kauffman Stadium,8,6
2016-08-07,2016,SF,WSH,0,1,-140,-1.5,115,7.5,-115,-105,125,1.5,-135,4.38,Nationals Park,1,-1
2016-08-08,2016,MIL,ATL,3,4,-162,-1.5,125,8.5,-112,-108,147,1.5,-145,5.26,Miller Park,7,-1
2016-08-08,2016,OAK,BAL,3,2,137,1.5,-125,8.0,-110,-110,-152,-1.5,105,3.38,Oakland Coliseum,5,1
2016-08-08,2016,STL,CIN,5,4,-196,-1.5,100,8.5,-115,-105,176,1.5,-120,5.63,Busch Stadium,9,1
2016-08-08,2016,TEX,COL,4,3,-124,-1.5,125,10.5,-110,-110,114,1.5,-145,5.81,Coors Field,7,1
2016-08-08,2016,SEA,DET,3,0,-134,-1.5,160,7.5,-115,-105,119,1.5,-180,4.29,T-Mobile Park,3,3
2016-08-08,2016,MIN,HOU,3,1,116,1.5,-150,8.5,-117,-103,-126,-1.5,130,3.94,Target Field,4,2
2016-08-08,2016,PHI,LAD,4,9,225,1.5,-105,8.0,100,-120,-265,-1.5,-115,2.46,Dodger Stadium,13,-5
2016-08-08,2016,SF,MIA,8,7,129,1.5,-180,6.5,110,-130,-144,-1.5,160,2.84,Marlins Park,15,1
2016-08-08,2016,ATL,MIL,4,3,147,1.5,-145,8.5,-112,-108,-162,-1.5,125,3.44,Miller Park,7,1
2016-08-08,2016,HOU,MIN,1,3,-126,-1.5,130,8.5,-117,-103,116,1.5,-150,4.74,Target Field,4,-2
2016-08-08,2016,BAL,OAK,2,3,-152,-1.5,105,8.0,-110,-110,137,1.5,-125,4.83,Oakland Coliseum,5,-1
2016-08-08,2016,LAD,PHI,9,4,-265,-1.5,-115,8.0,100,-120,225,1.5,-105,5.81,Dodger Stadium,13,5
2016-08-08,2016,DET,SEA,0,3,119,1.5,-180,7.5,-115,-105,-134,-1.5,160,3.42,T-Mobile Park,3,-3
2016-08-08,2016,MIA,SF,7,8,-144,-1.5,160,6.5,110,-130,129,1.5,-180,3.84,Marlins Park,15,-1
2016-08-08,2016,CIN,STL,4,5,176,1.5,-120,8.5,-115,-105,-196,-1.5,100,3.08,Busch Stadium,9,-1
2016-08-08,2016,TOR,TB,7,5,-153,-1.5,140,9.0,-110,-110,138,1.5,-160,5.44,Rogers Centre,12,2
2016-08-08,2016,COL,TEX,3,4,114,1.5,-145,10.5,-110,-110,-124,-1.5,125,4.91,Coors Field,7,-1
2016-08-08,2016,TB,TOR,5,7,138,1.5,-160,9.0,-110,-110,-153,-1.5,140,3.78,Rogers Centre,12,-2
2016-08-09,2016,NYM,ARI,3,5,-133,-1.5,165,7.0,-115,-105,118,1.5,-185,4.0,Citi Field,8,-2
2016-08-09,2016,MIL,ATL,1,2,-120,-1.5,165,10.0,-120,100,110,1.5,-185,5.45,Miller Park,3,-1
2016-08-09,2016,OAK,BAL,2,1,125,1.5,-145,9.0,-110,-110,-140,-1.5,125,4.0,Oakland Coliseum,3,1
2016-08-09,2016,NYY,BOS,3,5,141,1.5,-140,9.0,-120,100,-156,-1.5,120,3.73,Fenway Park,8,-2
2016-08-09,2016,LAA,CHC,1,5,200,1.5,100,9.0,-115,-105,-230,-1.5,-120,3.0,Wrigley Field,6,-4
2016-08-09,2016,STL,CIN,4,7,-200,-1.5,100,9.0,-110,-110,170,1.5,-120,6.0,Busch Stadium,11,-3
2016-08-09,2016,WSH,CLE,1,3,-180,-1.5,135,7.0,-115,-105,160,1.5,-155,4.5,Nationals Park,4,-2
2016-08-09,2016,TEX,COL,7,5,-108,-1.5,145,12.5,-105,-115,-102,1.5,-165,6.49,Coors Field,12,2
2016-08-09,2016,KC,CWS,5,7,132,1.5,-140,7.5,-120,100,-147,-1.5,120,3.23,Kauffman Stadium,12,-2
2016-08-09,2016,SEA,DET,6,5,-119,-1.5,170,8.5,100,-120,109,1.5,-200,4.62,T-Mobile Park,11,1
2016-08-09,2016,MIN,HOU,5,7,117,1.5,-135,9.0,-120,100,-132,-1.5,115,4.15,Target Field,12,-2
2016-08-09,2016,CWS,KC,7,5,-147,-1.5,120,7.5,-120,100,132,1.5,-140,4.46,Kauffman Stadium,12,2
2016-08-09,2016,CHC,LAA,5,1,-230,-1.5,-120,9.0,-115,-105,200,1.5,100,6.27,Wrigley Field,6,4
2016-08-09,2016,PHI,LAD,3,9,185,1.5,-120,7.0,-120,100,-215,-1.5,100,2.46,Dodger Stadium,12,-6
2016-08-09,2016,SF,MIA,0,2,-103,-1.5,160,8.5,-105,-115,-107,1.5,-180,4.31,Marlins Park,2,-2
2016-08-09,2016,ATL,MIL,2,1,110,1.5,-185,10.0,-120,100,-120,-1.5,165,4.76,Miller Park,3,1
2016-08-09,2016,HOU,MIN,7,5,-132,-1.5,115,9.0,-120,100,117,1.5,-135,5.12,Target Field,12,2
2016-08-09,2016,ARI,NYM,5,3,118,1.5,-185,7.0,-115,-105,-133,-1.5,165,3.21,Citi Field,8,2
2016-08-09,2016,BOS,NYY,5,3,-156,-1.5,120,9.0,-120,100,141,1.5,-140,5.48,Fenway Park,8,2
2016-08-09,2016,BAL,OAK,1,2,-140,-1.5,125,9.0,-110,-110,125,1.5,-145,5.25,Oakland Coliseum,3,-1
2016-08-09,2016,LAD,PHI,9,3,-215,-1.5,100,7.0,-120,100,185,1.5,-120,4.78,Dodger Stadium,12,6
2016-08-09,2016,SD,PIT,4,6,141,1.5,-160,9.0,100,-120,-156,-1.5,140,3.73,PNC Park,10,-2
2016-08-09,2016,PIT,SD,6,4,-156,-1.5,140,9.0,100,-120,141,1.5,-160,5.48,PNC Park,10,2
2016-08-09,2016,DET,SEA,5,6,109,1.5,-200,8.5,100,-120,-119,-1.5,170,4.07,T-Mobile Park,11,-1
2016-08-09,2016,MIA,SF,2,0,-107,1.5,-180,8.5,-105,-115,-103,-1.5,160,4.39,Marlins Park,2,2
2016-08-09,2016,CIN,STL,7,4,170,1.5,-120,9.0,-110,-110,-200,-1.5,100,3.33,Busch Stadium,11,3
2016-08-09,2016,TOR,TB,2,9,-200,-1.5,-110,9.0,-120,100,170,1.5,-110,6.0,Rogers Centre,11,-7
2016-08-09,2016,COL,TEX,5,7,-102,1.5,-165,12.5,-105,-115,-108,-1.5,145,6.31,Coors Field,12,-2
2016-08-09,2016,TB,TOR,9,2,170,1.5,-110,9.0,-120,100,-200,-1.5,-110,3.33,Rogers Centre,11,7
2016-08-09,2016,CLE,WSH,3,1,160,1.5,-155,7.0,-115,-105,-180,-1.5,135,2.69,Nationals Park,4,2
2016-08-10,2016,NYM,ARI,2,3,-114,-1.5,185,7.5,100,-120,104,1.5,-215,4.0,Citi Field,5,-1
2016-08-10,2016,MIL,ATL,4,3,-141,-1.5,145,9.5,-101,-119,126,1.5,-165,5.56,Miller Park,7,1
2016-08-10,2016,OAK,BAL,1,0,125,1.5,-140,9.0,100,-120,-140,-1.5,120,4.0,Oakland Coliseum,1,1
2016-08-10,2016,NYY,BOS,9,4,175,1.5,-120,9.5,-105,-115,-195,-1.5,100,3.45,Fenway Park,13,5
2016-08-10,2016,LAA,CHC,1,3,175,1.5,-114,9.0,100,-120,-205,-1.5,-106,3.27,Wrigley Field,4,-2
2016-08-10,2016,STL,CIN,3,2,-163,-1.5,135,8.0,-101,-119,148,1.5,-155,4.96,Busch Stadium,5,1
2016-08-10,2016,WSH,CLE,7,4,-124,-1.5,170,8.0,-105,-115,114,1.5,-200,4.43,Nationals Park,11,3
2016-08-10,2016,TEX,COL,5,4,-195,-1.5,100,10.5,-111,-109,175,1.5,-120,6.94,Rangers Ballpark,9,1
2016-08-10,2016,KC,CWS,3,2,-110,-1.5,185,8.0,100,-120,100,1.5,-215,4.19,Kauffman Stadium,5,1
2016-08-10,2016,SEA,DET,3,1,103,1.5,-165,7.0,-125,105,-113,-1.5,145,3.45,T-Mobile Park,4,2
2016-08-10,2016,CWS,KC,2,3,100,1.5,-215,8.0,100,-120,-110,-1.5,185,4.0,Kauffman Stadium,5,-1
2016-08-10,2016,CHC,LAA,3,1,-205,-1.5,-106,9.0,100,-120,175,1.5,-114,6.05,Wrigley Field,4,2
2016-08-10,2016,PHI,LAD,6,2,175,1.5,-120,7.5,-120,100,-205,-1.5,100,2.73,Dodger Stadium,8,4
2016-08-10,2016,SF,MIA,1,0,-112,-1.5,145,7.5,-120,100,102,1.5,-165,3.96,Marlins Park,1,1
2016-08-10,2016,ATL,MIL,3,4,126,1.5,-165,9.5,-101,-119,-141,-1.5,145,4.2,Miller Park,7,-1
2016-08-10,2016,ARI,NYM,3,2,104,1.5,-215,7.5,100,-120,-114,-1.5,185,3.68,Citi Field,5,1
2016-08-10,2016,BOS,NYY,4,9,-195,-1.5,100,9.5,-105,-115,175,1.5,-120,6.28,Fenway Park,13,-5
2016-08-10,2016,BAL,OAK,0,1,-140,-1.5,120,9.0,100,-120,125,1.5,-140,5.25,Oakland Coliseum,1,-1
2016-08-10,2016,LAD,PHI,2,6,-205,-1.5,100,7.5,-120,100,175,1.5,-120,5.04,Dodger Stadium,8,-4
2016-08-10,2016,SD,PIT,4,0,165,1.5,-145,9.5,100,-120,-185,-1.5,125,3.58,PNC Park,4,4
2016-08-10,2016,PIT,SD,0,4,-185,-1.5,125,9.5,100,-120,165,1.5,-145,6.17,PNC Park,4,-4
2016-08-10,2016,DET,SEA,1,3,-113,-1.5,145,7.0,-125,105,103,1.5,-165,3.71,T-Mobile Park,4,-2
2016-08-10,2016,MIA,SF,0,1,102,1.5,-165,7.5,-120,100,-112,-1.5,145,3.71,Marlins Park,1,-1
2016-08-10,2016,CIN,STL,2,3,148,1.5,-155,8.0,-101,-119,-163,-1.5,135,3.23,Busch Stadium,5,-1
2016-08-10,2016,TOR,TB,7,0,-186,-1.5,100,8.5,-114,-106,166,1.5,-120,5.53,Rogers Centre,7,7
2016-08-10,2016,COL,TEX,4,5,175,1.5,-120,10.5,-111,-109,-195,-1.5,100,3.82,Rangers Ballpark,9,-1
2016-08-10,2016,TB,TOR,0,7,166,1.5,-120,8.5,-114,-106,-186,-1.5,100,3.2,Rogers Centre,7,-7
2016-08-10,2016,CLE,WSH,4,7,114,1.5,-200,8.0,-105,-115,-124,-1.5,170,3.74,Nationals Park,11,-3
2016-08-11,2016,NYM,ARI,0,9,-240,-1.5,-103,7.5,-105,-115,200,1.5,-117,5.29,Citi Field,9,-9
2016-08-11,2016,MIL,ATL,11,3,-127,-1.5,160,9.5,-120,100,117,1.5,-180,5.31,Miller Park,14,8
2016-08-11,2016,OAK,BAL,6,9,125,1.5,-135,8.0,-110,-110,-140,-1.5,115,3.56,Oakland Coliseum,15,-3
2016-08-11,2016,NYY,BOS,4,2,119,1.5,-170,9.0,-120,100,-129,-1.5,150,4.11,Fenway Park,6,2
2016-08-11,2016,STL,CHC,3,4,153,1.5,-140,9.0,-115,-105,-173,-1.5,120,3.56,Wrigley Field,7,-1
2016-08-11,2016,LAA,CLE,4,14,215,1.5,116,8.5,-125,105,-255,-1.5,-136,2.7,Progressive Field,18,-10
2016-08-11,2016,TEX,COL,9,12,-140,-1.5,135,10.5,-115,-105,125,1.5,-155,6.13,Rangers Ballpark,21,-3
2016-08-11,2016,KC,CWS,2,1,-160,-1.5,135,7.5,-110,-110,145,1.5,-155,4.62,Kauffman Stadium,3,1
2016-08-11,2016,MIN,HOU,7,15,-101,1.5,-175,9.0,-120,100,-109,-1.5,155,4.52,Target Field,22,-8
2016-08-11,2016,MIN,HOU,2,10,112,1.5,-150,9.5,-110,-110,-122,-1.5,130,4.48,Target Field,12,-8
2016-08-11,2016,CWS,KC,1,2,145,1.5,-155,7.5,-110,-110,-160,-1.5,135,3.06,Kauffman Stadium,3,-1
2016-08-11,2016,CLE,LAA,14,4,-255,-1.5,-136,8.5,-125,105,215,1.5,116,6.11,Progressive Field,18,10
2016-08-11,2016,ATL,MIL,3,11,117,1.5,-180,9.5,-120,100,-127,-1.5,160,4.38,Miller Park,14,-8
2016-08-11,2016,HOU,MIN,15,7,-109,-1.5,155,9.0,-120,100,-101,1.5,-175,4.69,Target Field,22,8
2016-08-11,2016,HOU,MIN,10,2,-122,-1.5,130,9.5,-110,-110,112,1.5,-150,5.22,Target Field,12,8
2016-08-11,2016,ARI,NYM,9,0,200,1.5,-117,7.5,-105,-115,-240,-1.5,-103,2.5,Citi Field,9,9
2016-08-11,2016,BOS,NYY,2,4,-129,-1.5,150,9.0,-120,100,119,1.5,-170,5.07,Fenway Park,6,-2
2016-08-11,2016,BAL,OAK,9,6,-140,-1.5,115,8.0,-110,-110,125,1.5,-135,4.67,Oakland Coliseum,15,3
2016-08-11,2016,SD,PIT,0,4,170,1.5,-130,8.5,-110,-110,-200,-1.5,110,3.15,PNC Park,4,-4
2016-08-11,2016,PIT,SD,4,0,-200,-1.5,110,8.5,-110,-110,170,1.5,-130,5.67,PNC Park,4,4
2016-08-11,2016,CHC,STL,4,3,-173,-1.5,120,9.0,-115,-105,153,1.5,-140,5.7,Wrigley Field,7,1
2016-08-11,2016,COL,TEX,12,9,125,1.5,-155,10.5,-115,-105,-140,-1.5,135,4.67,Rangers Ballpark,21,3
2016-08-12,2016,BOS,ARI,9,4,-260,-1.5,-135,9.5,-121,101,220,1.5,115,6.86,Fenway Park,13,5
2016-08-12,2016,WSH,ATL,5,8,-255,-1.5,-130,7.5,-115,-105,215,1.5,110,5.39,Nationals Park,13,-3
2016-08-12,2016,SF,BAL,2,5,107,1.5,-160,7.5,-101,-119,-117,-1.5,140,3.62,AT&T Park,7,-3
2016-08-12,2016,ARI,BOS,4,9,220,1.5,115,9.5,-121,101,-260,-1.5,-135,2.97,Fenway Park,13,-5
2016-08-12,2016,STL,CHC,2,13,160,1.5,-135,8.0,-125,105,-180,-1.5,115,3.08,Wrigley Field,15,-11
2016-08-12,2016,MIL,CIN,4,7,-105,-1.5,200,8.5,-120,100,-105,1.5,-240,4.35,Miller Park,11,-3
2016-08-12,2016,LAA,CLE,3,13,143,1.5,-145,8.0,-120,100,-158,-1.5,125,3.29,Progressive Field,16,-10
2016-08-12,2016,PHI,COL,10,6,134,1.5,-125,8.5,-110,-110,-149,-1.5,105,3.63,Citizens Bank Park,16,4
2016-08-12,2016,MIA,CWS,2,4,-133,-1.5,160,7.5,-110,-110,118,1.5,-180,4.28,Marlins Park,6,-2
2016-08-12,2016,TEX,DET,8,5,-210,-1.5,-110,9.0,-110,-110,180,1.5,-110,6.1,Rangers Ballpark,13,3
2016-08-12,2016,TOR,HOU,3,5,-104,1.5,-170,9.0,-110,-110,-106,-1.5,150,4.59,Rogers Centre,8,-2
2016-08-12,2016,MIN,KC,3,7,-122,-1.5,170,8.5,-105,-115,112,1.5,-200,4.67,Target Field,10,-4
2016-08-12,2016,CLE,LAA,13,3,-158,-1.5,125,8.0,-120,100,143,1.5,-145,4.9,Progressive Field,16,10
2016-08-12,2016,PIT,LAD,5,1,150,1.5,-140,8.0,100,-120,-170,-1.5,120,3.2,Dodger Stadium,6,4
2016-08-12,2016,CWS,MIA,4,2,118,1.5,-180,7.5,-110,-110,-133,-1.5,160,3.44,Marlins Park,6,2
2016-08-12,2016,CIN,MIL,7,4,-105,1.5,-240,8.5,-120,100,-105,-1.5,200,4.35,Miller Park,11,3
2016-08-12,2016,KC,MIN,7,3,112,1.5,-200,8.5,-105,-115,-122,-1.5,170,4.01,Target Field,10,4
2016-08-12,2016,SD,NYM,8,6,135,1.5,-160,9.0,-120,100,-150,-1.5,140,3.83,Citi Field,14,2
2016-08-12,2016,TB,NYY,3,6,-110,-1.5,145,8.5,-115,-105,100,1.5,-165,4.45,Yankee Stadium,9,-3
2016-08-12,2016,SEA,OAK,3,6,114,1.5,-200,8.0,105,-125,-124,-1.5,170,3.74,Oakland Coliseum,9,-3
2016-08-12,2016,COL,PHI,6,10,-149,-1.5,105,8.5,-110,-110,134,1.5,-125,5.09,Citizens Bank Park,16,-4
2016-08-12,2016,LAD,PIT,1,5,-170,-1.5,120,8.0,100,-120,150,1.5,-140,5.04,Dodger Stadium,6,-4
2016-08-12,2016,NYM,SD,6,8,-150,-1.5,140,9.0,-120,100,135,1.5,-160,5.4,Citi Field,14,-2
2016-08-12,2016,OAK,SEA,6,3,-124,-1.5,170,8.0,105,-125,114,1.5,-200,4.43,Oakland Coliseum,9,3
2016-08-12,2016,BAL,SF,5,2,-117,-1.5,140,7.5,-101,-119,107,1.5,-160,4.04,AT&T Park,7,3
2016-08-12,2016,CHC,STL,13,2,-180,-1.5,115,8.0,-125,105,160,1.5,-135,5.14,Wrigley Field,15,11
2016-08-12,2016,NYY,TB,6,3,100,1.5,-165,8.5,-115,-105,-110,-1.5,145,4.25,Yankee Stadium,9,3
2016-08-12,2016,DET,TEX,5,8,180,1.5,-110,9.0,-110,-110,-210,-1.5,-110,3.21,Rangers Ballpark,13,-3
2016-08-12,2016,HOU,TOR,5,3,-106,-1.5,150,9.0,-110,-110,-104,1.5,-170,4.63,Rogers Centre,8,2
2016-08-12,2016,ATL,WSH,8,5,215,1.5,110,7.5,-115,-105,-255,-1.5,-130,2.38,Nationals Park,13,3
2016-08-13,2016,BOS,ARI,6,3,-210,-1.5,-105,10.5,-105,-115,180,1.5,-115,7.11,Fenway Park,9,3
2016-08-13,2016,WSH,ATL,7,6,-172,-1.5,120,9.0,-120,100,152,1.5,-140,5.69,Nationals Park,13,1
2016-08-13,2016,SF,BAL,6,2,-155,-1.5,145,6.5,-114,-106,140,1.5,-165,3.95,AT&T Park,8,4
2016-08-13,2016,ARI,BOS,3,6,180,1.5,-115,10.5,-105,-115,-210,-1.5,-105,3.75,Fenway Park,9,-3
2016-08-13,2016,STL,CHC,8,4,180,1.5,-110,9.0,-105,-115,-210,-1.5,-110,3.21,Wrigley Field,12,4
2016-08-13,2016,MIL,CIN,5,11,-125,-1.5,160,8.5,100,-120,115,1.5,-180,4.72,Miller Park,16,-6
2016-08-13,2016,LAA,CLE,1,5,114,1.5,-180,9.0,-121,101,-124,-1.5,160,4.21,Progressive Field,6,-4
2016-08-13,2016,PHI,COL,6,3,114,1.5,-155,8.0,-118,-102,-124,-1.5,135,3.74,Citizens Bank Park,9,3
2016-08-13,2016,MIA,CWS,7,8,-170,-1.5,125,8.5,-112,-108,150,1.5,-145,5.35,Marlins Park,15,-1
2016-08-13,2016,TEX,DET,0,2,-182,-1.5,105,9.5,-110,-110,162,1.5,-125,6.13,Rangers Ballpark,2,-2
2016-08-13,2016,TOR,HOU,4,2,-154,-1.5,139,8.0,-110,-110,139,1.5,-159,4.85,Rogers Centre,6,2
2016-08-13,2016,MIN,KC,5,3,-140,-1.5,150,9.0,-114,-106,125,1.5,-170,5.25,Target Field,8,2
2016-08-13,2016,CLE,LAA,5,1,-124,-1.5,160,9.0,-121,101,114,1.5,-180,4.98,Progressive Field,6,4
2016-08-13,2016,PIT,LAD,4,8,-101,1.5,-215,7.5,-110,-110,-109,-1.5,185,3.77,Dodger Stadium,12,-4
2016-08-13,2016,CWS,MIA,8,7,150,1.5,-145,8.5,-112,-108,-170,-1.5,125,3.4,Marlins Park,15,1
2016-08-13,2016,CIN,MIL,11,5,115,1.5,-180,8.5,100,-120,-125,-1.5,160,3.95,Miller Park,16,6
2016-08-13,2016,KC,MIN,3,5,125,1.5,-170,9.0,-114,-106,-140,-1.5,150,4.0,Target Field,8,-2
2016-08-13,2016,SD,NYM,2,3,200,1.5,-110,7.5,-120,100,-240,-1.5,-110,2.5,Citi Field,5,-1
2016-08-13,2016,TB,NYY,4,8,126,1.5,-170,8.0,-105,-115,-141,-1.5,150,3.54,Yankee Stadium,12,-4
2016-08-13,2016,SEA,OAK,4,3,-145,-1.5,110,8.0,-115,-105,130,1.5,-130,4.73,Oakland Coliseum,7,1
2016-08-13,2016,COL,PHI,3,6,-124,-1.5,135,8.0,-118,-102,114,1.5,-155,4.43,Citizens Bank Park,9,-3
2016-08-13,2016,LAD,PIT,8,4,-109,-1.5,185,7.5,-110,-110,-101,1.5,-215,3.91,Dodger Stadium,12,4
2016-08-13,2016,NYM,SD,3,2,-240,-1.5,-110,7.5,-120,100,200,1.5,-110,5.29,Citi Field,5,1
2016-08-13,2016,OAK,SEA,3,4,130,1.5,-130,8.0,-115,-105,-145,-1.5,110,3.48,Oakland Coliseum,7,-1
2016-08-13,2016,BAL,SF,2,6,140,1.5,-165,6.5,-114,-106,-155,-1.5,145,2.71,AT&T Park,8,-4
2016-08-13,2016,CHC,STL,4,8,-210,-1.5,-110,9.0,-105,-115,180,1.5,-110,6.1,Wrigley Field,12,-4
2016-08-13,2016,NYY,TB,8,4,-141,-1.5,150,8.0,-105,-115,126,1.5,-170,4.68,Yankee Stadium,12,4
2016-08-13,2016,DET,TEX,2,0,162,1.5,-125,9.5,-110,-110,-182,-1.5,105,3.63,Rangers Ballpark,2,2
2016-08-13,2016,HOU,TOR,2,4,139,1.5,-159,8.0,-110,-110,-154,-1.5,139,3.35,Rogers Centre,6,-2
2016-08-13,2016,ATL,WSH,6,7,152,1.5,-140,9.0,-120,100,-172,-1.5,120,3.57,Nationals Park,13,-1
2016-08-14,2016,BOS,ARI,16,2,-180,-1.5,105,9.5,-110,-110,160,1.5,-125,6.11,Fenway Park,18,14
2016-08-14,2016,WSH,ATL,9,1,-240,-1.5,-123,9.0,-115,-105,200,1.5,103,6.35,Nationals Park,10,8
2016-08-14,2016,SF,BAL,7,8,-147,-1.5,150,7.5,105,-125,132,1.5,-170,4.46,AT&T Park,15,-1
2016-08-14,2016,ARI,BOS,2,16,160,1.5,-125,9.5,-110,-110,-180,-1.5,105,3.65,Fenway Park,18,-14
2016-08-14,2016,STL,CHC,6,4,150,1.5,-130,8.5,100,-120,-170,-1.5,110,3.4,Wrigley Field,10,2
2016-08-14,2016,MIL,CIN,7,3,-102,1.5,-170,9.5,-110,-110,-108,-1.5,150,4.8,Miller Park,10,4
2016-08-14,2016,LAA,CLE,4,5,200,1.5,110,9.5,100,-120,-240,-1.5,-130,3.17,Progressive Field,9,-1
2016-08-14,2016,PHI,COL,7,6,-101,1.5,-170,9.0,-111,-109,-109,-1.5,150,4.52,Citizens Bank Park,13,1
2016-08-14,2016,MIA,CWS,5,4,138,1.5,-135,7.0,100,-120,-153,-1.5,115,2.94,Marlins Park,9,1
2016-08-14,2016,TEX,DET,0,7,-140,-1.5,145,9.5,-110,-110,125,1.5,-165,5.54,Rangers Ballpark,7,-7
2016-08-14,2016,TOR,HOU,9,2,-158,-1.5,130,8.5,-115,-105,143,1.5,-150,5.21,Rogers Centre,11,7
2016-08-14,2016,MIN,KC,4,11,-113,-1.5,175,9.0,-105,-115,103,1.5,-205,4.77,Target Field,15,-7
2016-08-14,2016,CLE,LAA,5,4,-240,-1.5,-130,9.5,100,-120,200,1.5,110,6.71,Progressive Field,9,1
2016-08-14,2016,PIT,LAD,11,3,157,1.5,-140,8.5,-105,-115,-177,-1.5,120,3.31,Dodger Stadium,14,8
2016-08-14,2016,CWS,MIA,4,5,-153,-1.5,115,7.0,100,-120,138,1.5,-135,4.23,Marlins Park,9,-1
2016-08-14,2016,CIN,MIL,3,7,-108,-1.5,150,9.5,-110,-110,-102,1.5,-170,4.93,Miller Park,10,-4
2016-08-14,2016,KC,MIN,11,4,103,1.5,-205,9.0,-105,-115,-113,-1.5,175,4.43,Target Field,15,7
2016-08-14,2016,SD,NYM,1,5,150,1.5,-140,8.5,-110,-110,-170,-1.5,120,3.4,Citi Field,6,-4
2016-08-14,2016,TB,NYY,12,3,100,1.5,-210,8.5,-125,105,-110,-1.5,180,4.25,Yankee Stadium,15,9
2016-08-14,2016,SEA,OAK,8,4,-117,-1.5,140,9.0,-120,100,107,1.5,-160,4.85,Oakland Coliseum,12,4
2016-08-14,2016,COL,PHI,6,7,-109,-1.5,150,9.0,-111,-109,-101,1.5,-170,4.69,Citizens Bank Park,13,-1
2016-08-14,2016,LAD,PIT,3,11,-177,-1.5,120,8.5,-105,-115,157,1.5,-140,5.43,Dodger Stadium,14,-8
2016-08-14,2016,NYM,SD,5,1,-170,-1.5,120,8.5,-110,-110,150,1.5,-140,5.35,Citi Field,6,4
2016-08-14,2016,OAK,SEA,4,8,107,1.5,-160,9.0,-120,100,-117,-1.5,140,4.35,Oakland Coliseum,12,-4
2016-08-14,2016,BAL,SF,8,7,132,1.5,-170,7.5,105,-125,-147,-1.5,150,3.23,AT&T Park,15,1
2016-08-14,2016,CHC,STL,4,6,-170,-1.5,110,8.5,100,-120,150,1.5,-130,5.35,Wrigley Field,10,-2
2016-08-14,2016,NYY,TB,3,12,-110,-1.5,180,8.5,-125,105,100,1.5,-210,4.45,Yankee Stadium,15,-9
2016-08-14,2016,DET,TEX,7,0,125,1.5,-165,9.5,-110,-110,-140,-1.5,145,4.22,Rangers Ballpark,7,7
2016-08-14,2016,HOU,TOR,2,9,143,1.5,-150,8.5,-115,-105,-158,-1.5,130,3.5,Rogers Centre,11,-7
2016-08-14,2016,ATL,WSH,1,9,200,1.5,103,9.0,-115,-105,-240,-1.5,-123,3.0,Nationals Park,10,-8
2016-08-15,2016,NYM,ARI,6,10,112,1.5,-185,9.0,100,-120,-122,-1.5,165,4.25,Chase Field,16,-4
2016-08-15,2016,CLE,BOS,2,3,100,1.5,-165,9.0,-110,-110,-110,-1.5,145,4.5,Progressive Field,5,-1
2016-08-15,2016,MIA,CIN,6,3,-121,-1.5,130,8.5,-119,-101,111,1.5,-150,4.65,Great American Ballpark,9,3
2016-08-15,2016,BOS,CLE,3,2,-110,-1.5,145,9.0,-110,-110,100,1.5,-165,4.71,Progressive Field,5,1
2016-08-15,2016,WSH,COL,5,4,-205,-1.5,-139,11.0,-105,-115,175,1.5,119,7.39,Coors Field,9,1
2016-08-15,2016,KC,DET,3,1,118,1.5,-180,8.5,-110,-110,-128,-1.5,160,3.9,Comerica Park,4,2
2016-08-15,2016,DET,KC,1,3,-128,-1.5,160,8.5,-110,-110,118,1.5,-180,4.77,Comerica Park,4,-2
2016-08-15,2016,SEA,LAA,3,2,-131,-1.5,125,9.0,-115,-105,116,1.5,-145,5.1,Angel Stadium,5,1
2016-08-15,2016,CIN,MIA,3,6,111,1.5,-150,8.5,-119,-101,-121,-1.5,130,4.03,Great American Ballpark,9,-3
2016-08-15,2016,ARI,NYM,10,6,-122,-1.5,165,9.0,100,-120,112,1.5,-185,4.95,Chase Field,16,4
2016-08-15,2016,TOR,NYY,0,1,-107,-1.5,145,9.5,-110,-110,-103,1.5,-165,4.91,Yankee Stadium,1,-1
2016-08-15,2016,TEX,OAK,5,2,-180,-1.5,105,10.5,-115,-105,160,1.5,-125,6.75,Rangers Ballpark,7,3
2016-08-15,2016,SF,PIT,5,8,-129,-1.5,170,8.0,100,-120,119,1.5,-200,4.51,AT&T Park,13,-3
2016-08-15,2016,TB,SD,8,2,-205,-1.5,100,8.0,-115,-105,175,1.5,-120,5.38,Tropicana Field,10,6
2016-08-15,2016,LAA,SEA,2,3,116,1.5,-145,9.0,-115,-105,-131,-1.5,125,4.17,Angel Stadium,5,-1
2016-08-15,2016,PIT,SF,8,5,119,1.5,-200,8.0,100,-120,-129,-1.5,170,3.65,AT&T Park,13,3
2016-08-15,2016,SD,TB,2,8,175,1.5,-120,8.0,-115,-105,-205,-1.5,100,2.91,Tropicana Field,10,-6
2016-08-15,2016,OAK,TEX,2,5,160,1.5,-125,10.5,-115,-105,-180,-1.5,105,4.04,Rangers Ballpark,7,-3
2016-08-15,2016,NYY,TOR,1,0,-103,1.5,-165,9.5,-110,-110,-107,-1.5,145,4.82,Yankee Stadium,1,1
2016-08-15,2016,COL,WSH,4,5,175,1.5,119,11.0,-105,-115,-205,-1.5,-139,4.0,Coors Field,9,-1
2016-08-16,2016,NYM,ARI,7,5,-159,-1.5,105,8.5,-120,100,144,1.5,-125,5.22,Chase Field,12,2
2016-08-16,2016,MIN,ATL,4,2,-125,-1.5,125,8.5,-120,100,115,1.5,-145,4.72,Turner Field,6,2
2016-08-16,2016,BOS,BAL,5,3,-119,-1.5,135,9.5,-110,-110,109,1.5,-155,5.16,Camden Yards,8,2
2016-08-16,2016,BAL,BOS,3,5,109,1.5,-155,9.5,-110,-110,-119,-1.5,135,4.55,Camden Yards,8,-2
2016-08-16,2016,MIL,CHC,0,4,185,1.5,-115,9.0,-105,-115,-215,-1.5,-105,3.16,Wrigley Field,4,-4
2016-08-16,2016,MIL,CHC,1,4,171,1.5,-130,8.5,-120,100,-191,-1.5,110,3.14,Wrigley Field,5,-3
2016-08-16,2016,MIA,CIN,3,6,102,1.5,-205,8.5,-115,-105,-112,-1.5,175,4.21,Great American Ballpark,9,-3
2016-08-16,2016,CWS,CLE,1,3,155,1.5,-145,7.0,-120,100,-175,-1.5,125,2.75,Progressive Field,4,-2
2016-08-16,2016,WSH,COL,2,6,-134,-1.5,110,12.0,-110,-110,119,1.5,-130,6.87,Coors Field,8,-4
2016-08-16,2016,CLE,CWS,3,1,-175,-1.5,125,7.0,-120,100,155,1.5,-145,4.45,Progressive Field,4,2
2016-08-16,2016,KC,DET,6,1,103,1.5,-205,7.0,-120,100,-113,-1.5,175,3.45,Comerica Park,7,5
2016-08-16,2016,STL,HOU,8,5,157,1.5,-145,7.5,-115,-105,-177,-1.5,125,2.92,Minute Maid Park,13,3
2016-08-16,2016,DET,KC,1,6,-113,-1.5,175,7.0,-120,100,103,1.5,-205,3.71,Comerica Park,7,-5
2016-08-16,2016,SEA,LAA,6,7,-107,-1.5,145,9.5,-105,-115,-103,1.5,-165,4.91,Angel Stadium,13,-1
2016-08-16,2016,PHI,LAD,5,15,170,1.5,-105,8.5,100,-120,-190,-1.5,-115,3.15,Citizens Bank Park,20,-10
2016-08-16,2016,CIN,MIA,6,3,-112,-1.5,175,8.5,-115,-105,102,1.5,-205,4.49,Great American Ballpark,9,3
2016-08-16,2016,CHC,MIL,4,0,-215,-1.5,-105,9.0,-105,-115,185,1.5,-115,6.14,Wrigley Field,4,4
2016-08-16,2016,CHC,MIL,4,1,-191,-1.5,110,8.5,-120,100,171,1.5,-130,5.58,Wrigley Field,5,3
2016-08-16,2016,ATL,MIN,2,4,115,1.5,-145,8.5,-120,100,-125,-1.5,125,3.95,Turner Field,6,-2
2016-08-16,2016,ARI,NYM,5,7,144,1.5,-125,8.5,-120,100,-159,-1.5,105,3.48,Chase Field,12,-2
2016-08-16,2016,TOR,NYY,12,6,-107,1.5,-210,8.0,-105,-115,-103,-1.5,180,4.14,Yankee Stadium,18,6
2016-08-16,2016,TEX,OAK,5,4,-128,-1.5,150,10.5,100,-120,118,1.5,-170,5.89,Rangers Ballpark,9,1
2016-08-16,2016,LAD,PHI,15,5,-190,-1.5,-115,8.5,100,-120,170,1.5,-105,5.57,Citizens Bank Park,20,10
2016-08-16,2016,SF,PIT,3,4,-115,-1.5,190,7.0,-125,105,105,1.5,-230,3.74,AT&T Park,7,-1
2016-08-16,2016,TB,SD,15,1,-190,-1.5,100,8.0,100,-120,170,1.5,-120,5.24,Tropicana Field,16,14
2016-08-16,2016,LAA,SEA,7,6,-103,1.5,-165,9.5,-105,-115,-107,-1.5,145,4.82,Angel Stadium,13,1
2016-08-16,2016,PIT,SF,4,3,105,1.5,-230,7.0,-125,105,-115,-1.5,190,3.41,AT&T Park,7,1
2016-08-16,2016,HOU,STL,5,8,-177,-1.5,125,7.5,-115,-105,157,1.5,-145,4.79,Minute Maid Park,13,-3
2016-08-16,2016,SD,TB,1,15,170,1.5,-120,8.0,100,-120,-190,-1.5,100,2.96,Tropicana Field,16,-14
2016-08-16,2016,OAK,TEX,4,5,118,1.5,-170,10.5,100,-120,-128,-1.5,150,4.82,Rangers Ballpark,9,-1
2016-08-16,2016,NYY,TOR,6,12,-103,-1.5,180,8.0,-105,-115,-107,1.5,-210,4.06,Yankee Stadium,18,-6
2016-08-16,2016,COL,WSH,6,2,119,1.5,-130,12.0,-110,-110,-134,-1.5,110,5.48,Coors Field,8,4
2016-08-17,2016,NYM,ARI,5,13,110,1.5,-180,10.0,-105,-115,-120,-1.5,160,4.76,Chase Field,18,-8
2016-08-17,2016,MIN,ATL,10,3,-105,1.5,-215,8.5,-119,-101,-105,-1.5,185,4.35,Turner Field,13,7
2016-08-17,2016,BOS,BAL,8,1,-113,-1.5,146,8.5,-115,-105,103,1.5,-167,4.51,Camden Yards,9,7
2016-08-17,2016,BAL,BOS,1,8,103,1.5,-167,8.5,-115,-105,-113,-1.5,146,4.19,Camden Yards,9,-7
2016-08-17,2016,MIL,CHC,1,6,285,1.5,135,9.0,100,-120,-335,-1.5,-155,2.34,Wrigley Field,7,-5
2016-08-17,2016,MIA,CIN,2,3,-105,1.5,-215,8.5,-105,-115,-105,-1.5,185,4.35,Great American Ballpark,5,-1
2016-08-17,2016,CWS,CLE,10,7,230,1.5,126,9.0,100,-120,-270,-1.5,-146,2.73,Progressive Field,17,3
2016-08-17,2016,WSH,COL,10,12,-161,-1.5,-110,10.5,-105,-115,146,1.5,-110,6.48,Coors Field,22,-2
2016-08-17,2016,CLE,CWS,7,10,-270,-1.5,-146,9.0,100,-120,230,1.5,126,6.57,Progressive Field,17,-3
2016-08-17,2016,KC,DET,4,1,103,1.5,-205,8.0,-105,-115,-113,-1.5,175,3.94,Comerica Park,5,3
2016-08-17,2016,STL,HOU,8,2,-103,1.5,-205,8.0,-105,-115,-107,-1.5,175,4.06,Minute Maid Park,10,6
2016-08-17,2016,DET,KC,1,4,-113,-1.5,175,8.0,-105,-115,103,1.5,-205,4.24,Comerica Park,5,-3
2016-08-17,2016,SEA,LAA,4,3,118,1.5,-170,9.0,100,-120,-133,-1.5,150,4.13,Angel Stadium,7,1
2016-08-17,2016,PHI,LAD,2,7,175,1.5,106,9.0,-125,105,-195,-1.5,-126,3.27,Citizens Bank Park,9,-5
2016-08-17,2016,CIN,MIA,3,2,-105,-1.5,185,8.5,-105,-115,-105,1.5,-215,4.35,Great American Ballpark,5,1
2016-08-17,2016,CHC,MIL,6,1,-335,-1.5,-155,9.0,100,-120,285,1.5,135,6.93,Wrigley Field,7,5
2016-08-17,2016,ATL,MIN,3,10,-105,-1.5,185,8.5,-119,-101,-105,1.5,-215,4.35,Turner Field,13,-7
2016-08-17,2016,ARI,NYM,13,5,-120,-1.5,160,10.0,-105,-115,110,1.5,-180,5.45,Chase Field,18,8
2016-08-17,2016,TOR,NYY,7,4,-170,-1.5,-115,9.0,-120,100,150,1.5,-105,5.67,Yankee Stadium,11,3
2016-08-17,2016,TEX,OAK,6,2,-251,-1.5,-118,8.5,100,-120,211,1.5,-102,6.08,Rangers Ballpark,8,4
2016-08-17,2016,LAD,PHI,7,2,-195,-1.5,-126,9.0,-125,105,175,1.5,106,5.95,Citizens Bank Park,9,5
2016-08-17,2016,SF,PIT,5,6,-142,-1.5,161,8.5,100,-120,127,1.5,-181,4.99,AT&T Park,11,-1
2016-08-17,2016,TB,SD,2,0,-205,-1.5,105,7.5,-110,-110,175,1.5,-125,5.04,Tropicana Field,2,2
2016-08-17,2016,LAA,SEA,3,4,-133,-1.5,150,9.0,100,-120,118,1.5,-170,5.14,Angel Stadium,7,-1
2016-08-17,2016,PIT,SF,6,5,127,1.5,-181,8.5,100,-120,-142,-1.5,161,3.74,AT&T Park,11,1
2016-08-17,2016,HOU,STL,2,8,-107,-1.5,175,8.0,-105,-115,-103,1.5,-205,4.14,Minute Maid Park,10,-6
2016-08-17,2016,SD,TB,0,2,175,1.5,-125,7.5,-110,-110,-205,-1.5,105,2.73,Tropicana Field,2,-2
2016-08-17,2016,OAK,TEX,2,6,211,1.5,-102,8.5,100,-120,-251,-1.5,-118,2.73,Rangers Ballpark,8,-4
2016-08-17,2016,NYY,TOR,4,7,150,1.5,-105,9.0,-120,100,-170,-1.5,-115,3.6,Yankee Stadium,11,-3
2016-08-17,2016,COL,WSH,12,10,146,1.5,-110,10.5,-105,-115,-161,-1.5,-110,4.27,Coors Field,22,2
2016-08-18,2016,SD,ARI,9,8,104,1.5,-160,9.0,100,-120,-114,-1.5,140,4.41,PETCO Park,17,1
2016-08-18,2016,WSH,ATL,8,2,-140,-1.5,120,9.0,-105,-115,125,1.5,-140,5.25,Turner Field,10,6
2016-08-18,2016,HOU,BAL,5,13,109,1.5,-200,8.5,100,-120,-119,-1.5,170,4.07,Camden Yards,18,-8
2016-08-18,2016,DET,BOS,4,3,-124,-1.5,155,10.0,-120,100,114,1.5,-175,5.54,Comerica Park,7,1
2016-08-18,2016,MIL,CHC,6,9,235,1.5,100,8.0,100,-120,-275,-1.5,-120,2.39,Wrigley Field,15,-3
2016-08-18,2016,MIA,CIN,4,5,-183,-1.5,-110,7.0,-115,-105,163,1.5,-110,4.53,Great American Ballpark,9,-1
2016-08-18,2016,CWS,CLE,4,5,175,1.5,-125,8.5,-105,-115,-195,-1.5,105,3.09,Progressive Field,9,-1
2016-08-18,2016,CLE,CWS,5,4,-195,-1.5,105,8.5,-105,-115,175,1.5,-125,5.62,Progressive Field,9,1
2016-08-18,2016,BOS,DET,3,4,114,1.5,-175,10.0,-120,100,-124,-1.5,155,4.67,Comerica Park,7,-1
2016-08-18,2016,BAL,HOU,13,5,-119,-1.5,170,8.5,100,-120,109,1.5,-200,4.62,Camden Yards,18,8
2016-08-18,2016,MIN,KC,1,8,111,1.5,-185,9.5,-115,-105,-121,-1.5,165,4.5,Kauffman Stadium,9,-7
2016-08-18,2016,SEA,LAA,4,6,-111,-1.5,145,8.0,-120,100,101,1.5,-165,4.21,Angel Stadium,10,-2
2016-08-18,2016,PHI,LAD,5,4,146,1.5,-115,9.0,-105,-115,-161,-1.5,-105,3.66,Citizens Bank Park,9,1
2016-08-18,2016,CIN,MIA,5,4,163,1.5,-110,7.0,-115,-105,-183,-1.5,-110,2.66,Great American Ballpark,9,1
2016-08-18,2016,CHC,MIL,9,6,-275,-1.5,-120,8.0,100,-120,235,1.5,100,5.87,Wrigley Field,15,3
2016-08-18,2016,KC,MIN,8,1,-121,-1.5,165,9.5,-115,-105,111,1.5,-185,5.2,Kauffman Stadium,9,7
2016-08-18,2016,SF,NYM,10,7,-175,-1.5,135,6.0,-120,100,155,1.5,-155,3.82,AT&T Park,17,3
2016-08-18,2016,LAD,PHI,4,5,-161,-1.5,-105,9.0,-105,-115,146,1.5,-115,5.55,Citizens Bank Park,9,-1
2016-08-18,2016,ARI,SD,8,9,-114,-1.5,140,9.0,100,-120,104,1.5,-160,4.79,PETCO Park,17,-1
2016-08-18,2016,LAA,SEA,6,4,101,1.5,-165,8.0,-120,100,-111,-1.5,145,3.98,Angel Stadium,10,2
2016-08-18,2016,NYM,SF,7,10,155,1.5,-155,6.0,-120,100,-175,-1.5,135,2.35,AT&T Park,17,-3
2016-08-18,2016,ATL,WSH,2,8,125,1.5,-140,9.0,-105,-115,-140,-1.5,120,4.0,Turner Field,10,-6
2016-08-19,2016,SD,ARI,7,4,140,1.5,-120,8.0,-105,-115,-155,-1.5,100,3.33,PETCO Park,11,3
2016-08-19,2016,WSH,ATL,7,6,-126,-1.5,130,7.5,-110,-110,116,1.5,-150,4.18,Turner Field,13,1
2016-08-19,2016,HOU,BAL,15,8,-105,1.5,-210,10.0,-102,-118,-105,-1.5,180,5.12,Camden Yards,23,7
2016-08-19,2016,DET,BOS,2,10,104,1.5,-160,9.0,100,-120,-114,-1.5,140,4.41,Comerica Park,12,-8
2016-08-19,2016,COL,CHC,7,6,119,1.5,-135,10.0,-119,-101,-134,-1.5,115,4.57,Coors Field,13,1
2016-08-19,2016,LAD,CIN,2,9,-171,-1.5,-110,9.5,-110,-110,151,1.5,-110,5.99,Great American Ballpark,11,-7
2016-08-19,2016,TOR,CLE,2,3,132,1.5,-165,8.5,-120,100,-147,-1.5,145,3.66,Progressive Field,5,-1
2016-08-19,2016,CHC,COL,6,7,-134,-1.5,115,10.0,-119,-101,119,1.5,-135,5.73,Coors Field,13,-1
2016-08-19,2016,OAK,CWS,9,0,-121,-1.5,130,9.5,-115,-105,111,1.5,-150,5.2,Guaranteed Rate Field,9,9
2016-08-19,2016,BOS,DET,10,2,-114,-1.5,140,9.0,100,-120,104,1.5,-160,4.79,Comerica Park,12,8
2016-08-19,2016,BAL,HOU,8,15,-105,-1.5,180,10.0,-102,-118,-105,1.5,-210,5.12,Camden Yards,23,-7
2016-08-19,2016,MIN,KC,4,5,128,1.5,-160,9.0,-110,-110,-143,-1.5,140,3.95,Kauffman Stadium,9,-1
2016-08-19,2016,NYY,LAA,7,0,-148,-1.5,106,8.5,103,-123,133,1.5,-126,5.07,Angel Stadium,7,7
2016-08-19,2016,CIN,LAD,9,2,151,1.5,-110,9.5,-110,-110,-171,-1.5,-110,3.78,Great American Ballpark,11,7
2016-08-19,2016,PIT,MIA,5,6,-220,-1.5,-105,7.5,-115,-105,190,1.5,-115,5.16,PNC Park,11,-1
2016-08-19,2016,SEA,MIL,7,6,-200,-1.5,111,9.0,-115,-105,170,1.5,-131,6.0,T-Mobile Park,13,1
2016-08-19,2016,KC,MIN,5,4,-143,-1.5,140,9.0,-110,-110,128,1.5,-160,5.3,Kauffman Stadium,9,1
2016-08-19,2016,SF,NYM,8,1,-200,-1.5,109,7.5,-120,100,170,1.5,-129,5.0,AT&T Park,9,7
2016-08-19,2016,LAA,NYY,0,7,133,1.5,-126,8.5,103,-123,-148,-1.5,106,3.65,Angel Stadium,7,-7
2016-08-19,2016,CWS,OAK,0,9,111,1.5,-150,9.5,-115,-105,-121,-1.5,130,4.5,Guaranteed Rate Field,9,-9
2016-08-19,2016,STL,PHI,4,3,-174,-1.5,-115,9.0,-115,-105,154,1.5,-105,5.72,Citizens Bank Park,7,1
2016-08-19,2016,MIA,PIT,6,5,190,1.5,-115,7.5,-115,-105,-220,-1.5,-105,2.59,PNC Park,11,1
2016-08-19,2016,ARI,SD,4,7,-155,-1.5,100,8.0,-105,-115,140,1.5,-120,4.86,PETCO Park,11,-3
2016-08-19,2016,MIL,SEA,6,7,170,1.5,-131,9.0,-115,-105,-200,-1.5,111,3.33,T-Mobile Park,13,-1
2016-08-19,2016,NYM,SF,1,8,170,1.5,-129,7.5,-120,100,-200,-1.5,109,2.78,AT&T Park,9,-7
2016-08-19,2016,PHI,STL,3,4,154,1.5,-105,9.0,-115,-105,-174,-1.5,-115,3.54,Citizens Bank Park,7,-1
2016-08-19,2016,TEX,TB,6,2,-141,-1.5,125,7.5,105,-125,126,1.5,-145,4.39,Tropicana Field,8,4
2016-08-19,2016,TB,TEX,2,6,126,1.5,-145,7.5,105,-125,-141,-1.5,125,3.32,Tropicana Field,8,-4
2016-08-19,2016,CLE,TOR,3,2,-147,-1.5,145,8.5,-120,100,132,1.5,-165,5.06,Progressive Field,5,1
2016-08-19,2016,ATL,WSH,6,7,116,1.5,-150,7.5,-110,-110,-126,-1.5,130,3.47,Turner Field,13,-1
2016-08-20,2016,SD,ARI,1,2,125,1.5,-130,8.5,-115,-105,-140,-1.5,110,3.78,PETCO Park,3,-1
2016-08-20,2016,WSH,ATL,11,9,-279,-1.5,-159,8.5,100,-120,239,1.5,139,6.26,Turner Field,20,2
2016-08-20,2016,HOU,BAL,12,2,126,1.5,-159,9.0,-111,-109,-141,-1.5,139,3.98,Camden Yards,14,10
2016-08-20,2016,DET,BOS,2,3,125,1.5,-127,9.5,-110,-110,-140,-1.5,108,4.22,Comerica Park,5,-1
2016-08-20,2016,COL,CHC,2,9,125,1.5,-125,12.0,-115,-105,-140,-1.5,105,5.33,Coors Field,11,-7
2016-08-20,2016,LAD,CIN,1,11,-141,-1.5,110,9.0,100,-120,126,1.5,-130,5.27,Great American Ballpark,12,-10
2016-08-20,2016,TOR,CLE,6,5,106,1.5,-200,8.5,-120,100,-116,-1.5,170,4.13,Progressive Field,11,1
2016-08-20,2016,CHC,COL,9,2,-140,-1.5,105,12.0,-115,-105,125,1.5,-125,7.0,Coors Field,11,7
2016-08-20,2016,OAK,CWS,2,6,163,1.5,-137,9.0,100,-120,-183,-1.5,117,3.42,Guaranteed Rate Field,8,-4
2016-08-20,2016,BOS,DET,3,2,-140,-1.5,108,9.5,-110,-110,125,1.5,-127,5.54,Comerica Park,5,1
2016-08-20,2016,BAL,HOU,2,12,-141,-1.5,139,9.0,-111,-109,126,1.5,-159,5.27,Camden Yards,14,-10
2016-08-20,2016,MIN,KC,0,10,175,1.5,-121,8.5,-115,-105,-195,-1.5,101,3.09,Kauffman Stadium,10,-10
2016-08-20,2016,NYY,LAA,5,1,103,1.5,-200,9.0,-120,100,-113,-1.5,170,4.43,Angel Stadium,6,4
2016-08-20,2016,CIN,LAD,11,1,126,1.5,-130,9.0,100,-120,-141,-1.5,110,3.98,Great American Ballpark,12,10
2016-08-20,2016,PIT,MIA,1,3,-121,-1.5,175,8.5,100,-120,111,1.5,-205,4.65,PNC Park,4,-2
2016-08-20,2016,SEA,MIL,8,2,-235,-1.5,-115,8.5,-116,-104,205,1.5,-105,5.96,T-Mobile Park,10,6
2016-08-20,2016,KC,MIN,10,0,-195,-1.5,101,8.5,-115,-105,175,1.5,-121,5.62,Kauffman Stadium,10,10
2016-08-20,2016,SF,NYM,5,9,-150,-1.5,140,8.5,100,-120,135,1.5,-160,5.1,AT&T Park,14,-4
2016-08-20,2016,LAA,NYY,1,5,-113,-1.5,170,9.0,-120,100,103,1.5,-200,4.77,Angel Stadium,6,-4
2016-08-20,2016,CWS,OAK,6,2,-183,-1.5,117,9.0,100,-120,163,1.5,-137,5.82,Guaranteed Rate Field,8,4
2016-08-20,2016,STL,PHI,2,4,-123,-1.5,130,8.5,-125,105,113,1.5,-150,4.69,Citizens Bank Park,6,-2
2016-08-20,2016,MIA,PIT,3,1,111,1.5,-205,8.5,100,-120,-121,-1.5,175,4.03,PNC Park,4,2
2016-08-20,2016,ARI,SD,2,1,-140,-1.5,110,8.5,-115,-105,125,1.5,-130,4.96,PETCO Park,3,1
2016-08-20,2016,MIL,SEA,2,8,205,1.5,-105,8.5,-116,-104,-235,-1.5,-115,2.79,T-Mobile Park,10,-6
2016-08-20,2016,NYM,SF,9,5,135,1.5,-160,8.5,100,-120,-150,-1.5,140,3.62,AT&T Park,14,4
2016-08-20,2016,PHI,STL,4,2,113,1.5,-150,8.5,-125,105,-123,-1.5,130,3.99,Citizens Bank Park,6,2
2016-08-20,2016,TEX,TB,2,8,101,1.5,-210,8.0,-110,-110,-111,-1.5,180,3.98,Tropicana Field,10,-6
2016-08-20,2016,TB,TEX,8,2,-111,-1.5,180,8.0,-110,-110,101,1.5,-210,4.21,Tropicana Field,10,6
2016-08-20,2016,CLE,TOR,5,6,-116,-1.5,170,8.5,-120,100,106,1.5,-200,4.56,Progressive Field,11,-1
2016-08-20,2016,ATL,WSH,9,11,239,1.5,139,8.5,100,-120,-279,-1.5,-159,2.51,Turner Field,20,-2
2016-08-21,2016,SD,ARI,9,1,-117,-1.5,170,8.5,-120,100,107,1.5,-200,4.58,PETCO Park,10,8
2016-08-21,2016,WSH,ATL,6,7,-173,-1.5,-110,8.5,-120,100,153,1.5,-110,5.39,Turner Field,13,-1
2016-08-21,2016,HOU,BAL,5,3,-110,-1.5,141,9.5,100,-120,100,1.5,-161,4.98,Camden Yards,8,2
2016-08-21,2016,DET,BOS,10,5,-159,-1.5,135,9.5,-110,-110,144,1.5,-155,5.83,Comerica Park,15,5
2016-08-21,2016,COL,CHC,11,4,144,1.5,-110,13.0,-119,-101,-159,-1.5,-110,5.33,Coors Field,15,7
2016-08-21,2016,LAD,CIN,4,0,-149,-1.5,110,8.5,-110,-110,134,1.5,-130,5.09,Great American Ballpark,4,4
2016-08-21,2016,TOR,CLE,2,3,147,1.5,-150,7.5,-120,100,-162,-1.5,130,3.04,Progressive Field,5,-1
2016-08-21,2016,CHC,COL,4,11,-159,-1.5,-110,13.0,-119,-101,144,1.5,-110,7.98,Coors Field,15,-7
2016-08-21,2016,OAK,CWS,2,4,163,1.5,-150,8.5,-120,100,-183,-1.5,130,3.23,Guaranteed Rate Field,6,-2
2016-08-21,2016,BOS,DET,5,10,144,1.5,-155,9.5,-110,-110,-159,-1.5,135,3.89,Comerica Park,15,-5
2016-08-21,2016,BAL,HOU,3,5,100,1.5,-161,9.5,100,-120,-110,-1.5,141,4.75,Camden Yards,8,-2
2016-08-21,2016,MIN,KC,1,2,157,1.5,-135,7.5,105,-125,-177,-1.5,115,2.92,Kauffman Stadium,3,-1
2016-08-21,2016,NYY,LAA,0,2,-132,-1.5,120,9.0,-125,105,117,1.5,-140,5.12,Angel Stadium,2,-2
2016-08-21,2016,CIN,LAD,0,4,134,1.5,-130,8.5,-110,-110,-149,-1.5,110,3.63,Great American Ballpark,4,-4
2016-08-21,2016,PIT,MIA,2,3,-154,-1.5,138,9.5,-108,-112,139,1.5,-158,5.76,PNC Park,5,-1
2016-08-21,2016,SEA,MIL,6,7,-178,-1.5,115,9.0,-125,105,158,1.5,-135,5.76,T-Mobile Park,13,-1
2016-08-21,2016,KC,MIN,2,1,-177,-1.5,115,7.5,105,-125,157,1.5,-135,4.79,Kauffman Stadium,3,1
2016-08-21,2016,SF,NYM,0,2,115,1.5,-154,7.5,102,-122,-130,-1.5,134,3.49,AT&T Park,2,-2
2016-08-21,2016,LAA,NYY,2,0,117,1.5,-140,9.0,-125,105,-132,-1.5,120,4.15,Angel Stadium,2,2
2016-08-21,2016,CWS,OAK,4,2,-183,-1.5,130,8.5,-120,100,163,1.5,-150,5.5,Guaranteed Rate Field,6,2
2016-08-21,2016,STL,PHI,9,0,-119,-1.5,135,8.5,-120,100,109,1.5,-155,4.62,Citizens Bank Park,9,9
2016-08-21,2016,MIA,PIT,3,2,139,1.5,-158,9.5,-108,-112,-154,-1.5,138,3.97,PNC Park,5,1
2016-08-21,2016,ARI,SD,1,9,107,1.5,-200,8.5,-120,100,-117,-1.5,170,4.11,PETCO Park,10,-8
2016-08-21,2016,MIL,SEA,7,6,158,1.5,-135,9.0,-125,105,-178,-1.5,115,3.49,T-Mobile Park,13,1
2016-08-21,2016,NYM,SF,2,0,-130,-1.5,134,7.5,102,-122,115,1.5,-154,4.24,AT&T Park,2,2
2016-08-21,2016,PHI,STL,0,9,109,1.5,-155,8.5,-120,100,-119,-1.5,135,4.07,Citizens Bank Park,9,-9
2016-08-21,2016,TEX,TB,4,8,104,1.5,-205,8.5,100,-120,-114,-1.5,175,4.17,Tropicana Field,12,-4
2016-08-21,2016,TB,TEX,8,4,-114,-1.5,175,8.5,100,-120,104,1.5,-205,4.53,Tropicana Field,12,4
2016-08-21,2016,CLE,TOR,3,2,-162,-1.5,130,7.5,-120,100,147,1.5,-150,4.64,Progressive Field,5,1
2016-08-21,2016,ATL,WSH,7,6,153,1.5,-110,8.5,-120,100,-173,-1.5,-110,3.36,Turner Field,13,1
2016-08-22,2016,ATL,ARI,8,9,108,1.5,-180,10.0,-110,-110,-118,-1.5,160,4.81,Chase Field,17,-1
2016-08-22,2016,ARI,ATL,9,8,-118,-1.5,160,10.0,-110,-110,108,1.5,-180,5.41,Chase Field,17,1
2016-08-22,2016,WSH,BAL,3,4,145,1.5,-135,9.5,-127,107,-160,-1.5,115,3.88,Camden Yards,7,-1
2016-08-22,2016,TB,BOS,2,6,139,1.5,-125,7.5,100,-120,-154,-1.5,105,3.14,Tropicana Field,8,-4
2016-08-22,2016,SD,CHC,1,5,230,1.5,140,8.0,-110,-110,-270,-1.5,-160,2.42,PETCO Park,6,-4
2016-08-22,2016,LAD,CIN,18,9,-132,-1.5,125,8.5,100,-120,117,1.5,-145,4.84,Great American Ballpark,27,9
2016-08-22,2016,OAK,CLE,0,1,153,1.5,-105,7.0,-115,-105,-173,-1.5,-115,2.77,Oakland Coliseum,1,-1
2016-08-22,2016,MIL,COL,4,2,-102,1.5,-165,9.0,100,-120,-108,-1.5,145,4.54,Miller Park,6,2
2016-08-22,2016,PIT,HOU,1,3,-141,-1.5,153,7.5,100,-120,126,1.5,-173,4.39,PNC Park,4,-2
2016-08-22,2016,CIN,LAD,9,18,117,1.5,-145,8.5,100,-120,-132,-1.5,125,3.92,Great American Ballpark,27,-9
2016-08-22,2016,COL,MIL,2,4,-108,-1.5,145,9.0,100,-120,-102,1.5,-165,4.67,Miller Park,6,-2
2016-08-22,2016,SEA,NYY,7,5,106,1.5,-170,8.0,100,-120,-116,-1.5,150,3.88,T-Mobile Park,12,2
2016-08-22,2016,CLE,OAK,1,0,-173,-1.5,-115,7.0,-115,-105,153,1.5,-105,4.44,Oakland Coliseum,1,1
2016-08-22,2016,HOU,PIT,3,1,126,1.5,-173,7.5,100,-120,-141,-1.5,153,3.32,PNC Park,4,2
2016-08-22,2016,CHC,SD,5,1,-270,-1.5,-160,8.0,-110,-110,230,1.5,140,5.84,PETCO Park,6,4
2016-08-22,2016,NYY,SEA,5,7,-116,-1.5,150,8.0,100,-120,106,1.5,-170,4.3,T-Mobile Park,12,-2
2016-08-22,2016,BOS,TB,6,2,-154,-1.5,105,7.5,100,-120,139,1.5,-125,4.55,Tropicana Field,8,4
2016-08-22,2016,BAL,WSH,4,3,-160,-1.5,115,9.5,-127,107,145,1.5,-135,5.85,Camden Yards,7,1
2016-08-23,2016,ATL,ARI,7,4,109,1.5,-185,9.5,-120,100,-119,-1.5,165,4.55,Chase Field,11,3
2016-08-23,2016,ARI,ATL,4,7,-119,-1.5,165,9.5,-120,100,109,1.5,-185,5.16,Chase Field,11,-3
2016-08-23,2016,WSH,BAL,1,8,144,1.5,-140,9.5,100,-120,-159,-1.5,120,3.89,Camden Yards,9,-7
2016-08-23,2016,TB,BOS,1,2,-123,-1.5,170,8.0,-105,-115,113,1.5,-185,4.41,Tropicana Field,3,-1
2016-08-23,2016,SD,CHC,3,5,220,1.5,120,8.0,100,-120,-260,-1.5,-140,2.5,PETCO Park,8,-2
2016-08-23,2016,TEX,CIN,0,3,-115,-1.5,140,9.0,100,-120,105,1.5,-160,4.81,Great American Ballpark,3,-3
2016-08-23,2016,OAK,CLE,9,1,134,1.5,-125,8.0,-115,-105,-149,-1.5,105,3.42,Oakland Coliseum,10,8
2016-08-23,2016,MIL,COL,6,4,106,1.5,-155,9.0,-110,-110,-116,-1.5,135,4.37,Miller Park,10,2
2016-08-23,2016,PHI,CWS,1,9,144,1.5,-132,9.0,-111,-109,-159,-1.5,122,3.69,Guaranteed Rate Field,10,-8
2016-08-23,2016,MIN,DET,3,8,-102,1.5,-160,9.5,-115,-105,-108,-1.5,140,4.8,Target Field,11,-5
2016-08-23,2016,PIT,HOU,7,1,111,1.5,-151,8.5,-105,-115,-121,-1.5,139,4.03,PNC Park,8,6
2016-08-23,2016,MIA,KC,0,1,-104,1.5,-175,7.5,-110,-110,-106,-1.5,155,3.82,Marlins Park,1,-1
2016-08-23,2016,TOR,LAA,7,2,-145,-1.5,135,9.0,-110,-110,130,1.5,-155,5.33,Rogers Centre,9,5
2016-08-23,2016,SF,LAD,5,9,-112,-1.5,155,6.5,-110,-110,102,1.5,-168,3.43,Dodger Stadium,14,-4
2016-08-23,2016,KC,MIA,1,0,-106,-1.5,155,7.5,-110,-110,-104,1.5,-175,3.86,Marlins Park,1,1
2016-08-23,2016,COL,MIL,4,6,-116,-1.5,135,9.0,-110,-110,106,1.5,-155,4.83,Miller Park,10,-2
2016-08-23,2016,DET,MIN,8,3,-108,-1.5,140,9.5,-115,-105,-102,1.5,-160,4.93,Target Field,11,5
2016-08-23,2016,STL,NYM,4,7,-160,-1.5,130,8.5,-115,-105,145,1.5,-150,5.23,Busch Stadium,11,-3
2016-08-23,2016,SEA,NYY,1,5,-154,-1.5,105,8.0,-110,-110,139,1.5,140,4.85,T-Mobile Park,6,-4
2016-08-23,2016,CLE,OAK,1,9,-149,-1.5,105,8.0,-115,-105,134,1.5,-125,4.79,Oakland Coliseum,10,-8
2016-08-23,2016,CWS,PHI,9,1,-159,-1.5,122,9.0,-111,-109,144,1.5,-132,5.53,Guaranteed Rate Field,10,8
2016-08-23,2016,HOU,PIT,1,7,-121,-1.5,139,8.5,-105,-115,111,1.5,-151,4.65,PNC Park,8,-6
2016-08-23,2016,CHC,SD,5,3,-260,-1.5,-140,8.0,100,-120,220,1.5,120,5.78,PETCO Park,8,2
2016-08-23,2016,NYY,SEA,5,1,139,1.5,140,8.0,-110,-110,-154,-1.5,105,3.35,T-Mobile Park,6,4
2016-08-23,2016,LAD,SF,9,5,102,1.5,-168,6.5,-110,-110,-112,-1.5,155,3.22,Dodger Stadium,14,4
2016-08-23,2016,NYM,STL,7,4,145,1.5,-150,8.5,-115,-105,-160,-1.5,130,3.47,Busch Stadium,11,3
2016-08-23,2016,BOS,TB,2,1,113,1.5,-185,8.0,-105,-115,-123,-1.5,170,3.76,Tropicana Field,3,1
2016-08-23,2016,CIN,TEX,3,0,105,1.5,-160,9.0,100,-120,-115,-1.5,140,4.39,Great American Ballpark,3,3
2016-08-23,2016,LAA,TOR,2,7,130,1.5,-155,9.0,-110,-110,-145,-1.5,135,3.91,Rogers Centre,9,-5
2016-08-23,2016,BAL,WSH,8,1,-159,-1.5,120,9.5,100,-120,144,1.5,-140,5.83,Camden Yards,9,7
2016-08-24,2016,ATL,ARI,9,10,119,1.5,-185,8.0,-119,-101,-129,-1.5,165,3.65,Chase Field,19,-1
2016-08-24,2016,ARI,ATL,10,9,-129,-1.5,165,8.0,-119,-101,119,1.5,-185,4.51,Chase Field,19,1
2016-08-24,2016,WSH,BAL,8,10,-159,-1.5,130,8.5,-122,102,144,1.5,-150,5.22,Nationals Park,18,-2
2016-08-24,2016,TB,BOS,4,3,116,1.5,-140,8.0,-125,105,-131,-1.5,120,3.7,Tropicana Field,7,1
2016-08-24,2016,SD,CHC,3,6,220,1.5,130,8.5,-110,-110,-260,-1.5,-150,2.66,PETCO Park,9,-3
2016-08-24,2016,TEX,CIN,6,5,-210,-1.5,-133,8.5,100,-120,180,1.5,113,5.76,Great American Ballpark,11,1
2016-08-24,2016,OAK,CLE,5,1,111,1.5,-155,7.5,-120,100,-121,-1.5,135,3.55,Oakland Coliseum,6,4
2016-08-24,2016,MIL,COL,7,1,101,1.5,-165,8.0,-105,-115,-111,-1.5,145,3.98,Miller Park,8,6
2016-08-24,2016,PHI,CWS,5,3,-105,-1.5,150,9.5,-105,-115,-105,1.5,-170,4.87,Guaranteed Rate Field,8,2
2016-08-24,2016,MIN,DET,4,9,-105,-1.5,180,9.5,-120,100,-105,1.5,-210,4.87,Target Field,13,-5
2016-08-24,2016,PIT,HOU,4,5,-131,-1.5,165,7.5,100,-120,116,1.5,-185,4.25,PNC Park,9,-1
2016-08-24,2016,MIA,KC,3,0,-200,-1.5,110,7.0,105,-125,170,1.5,-130,4.67,Marlins Park,3,3
2016-08-24,2016,TOR,LAA,2,8,-160,-1.5,135,8.5,-115,-105,145,1.5,-155,5.23,Rogers Centre,10,-6
2016-08-24,2016,SF,LAD,0,1,125,1.5,-173,7.0,-115,-105,-140,-1.5,154,3.11,Dodger Stadium,1,-1
2016-08-24,2016,KC,MIA,0,3,170,1.5,-130,7.0,105,-125,-200,-1.5,110,2.59,Marlins Park,3,-3
2016-08-24,2016,COL,MIL,1,7,-111,-1.5,145,8.0,-105,-115,101,1.5,-165,4.21,Miller Park,8,-6
2016-08-24,2016,DET,MIN,9,4,-105,1.5,-210,9.5,-120,100,-105,-1.5,180,4.87,Target Field,13,5
2016-08-24,2016,STL,NYM,8,1,-102,1.5,-172,7.5,-119,-101,-108,-1.5,152,3.79,Busch Stadium,9,7
2016-08-24,2016,SEA,NYY,0,5,-105,1.5,-170,7.0,102,-122,-105,-1.5,150,3.59,T-Mobile Park,5,-5
2016-08-24,2016,CLE,OAK,1,5,-121,-1.5,135,7.5,-120,100,111,1.5,-155,4.11,Oakland Coliseum,6,-4
2016-08-24,2016,CWS,PHI,3,5,-105,1.5,-170,9.5,-105,-115,-105,-1.5,150,4.87,Guaranteed Rate Field,8,-2
2016-08-24,2016,HOU,PIT,5,4,116,1.5,-185,7.5,100,-120,-131,-1.5,165,3.47,PNC Park,9,1
2016-08-24,2016,CHC,SD,6,3,-260,-1.5,-150,8.5,-110,-110,220,1.5,130,6.14,PETCO Park,9,3
2016-08-24,2016,NYY,SEA,5,0,-105,-1.5,150,7.0,102,-122,-105,1.5,-170,3.59,T-Mobile Park,5,5
2016-08-24,2016,LAD,SF,1,0,-140,-1.5,154,7.0,-115,-105,125,1.5,-173,4.08,Dodger Stadium,1,1
2016-08-24,2016,NYM,STL,1,8,-108,-1.5,152,7.5,-119,-101,-102,1.5,-172,3.89,Busch Stadium,9,-7
2016-08-24,2016,BOS,TB,3,4,-131,-1.5,120,8.0,-125,105,116,1.5,-140,4.54,Tropicana Field,7,-1
2016-08-24,2016,CIN,TEX,5,6,180,1.5,113,8.5,100,-120,-210,-1.5,-133,3.04,Great American Ballpark,11,-1
2016-08-24,2016,LAA,TOR,8,2,145,1.5,-155,8.5,-115,-105,-160,-1.5,135,3.47,Rogers Centre,10,6
2016-08-24,2016,BAL,WSH,10,8,144,1.5,-150,8.5,-122,102,-159,-1.5,130,3.48,Nationals Park,18,2
2016-08-25,2016,ATL,ARI,3,1,161,1.5,-121,9.0,-117,-103,-181,-1.5,101,3.45,Chase Field,4,2
2016-08-25,2016,ARI,ATL,1,3,-181,-1.5,101,9.0,-117,-103,161,1.5,-121,5.8,Chase Field,4,-2
2016-08-25,2016,WSH,BAL,4,0,-210,-1.5,-115,8.5,-101,-119,180,1.5,-105,5.76,Nationals Park,4,4
2016-08-25,2016,TB,BOS,2,1,110,1.5,-165,7.0,-120,100,-120,-1.5,145,3.33,Tropicana Field,3,1
2016-08-25,2016,TEX,CLE,9,0,-151,-1.5,135,9.0,100,-120,136,1.5,-155,5.41,Rangers Ballpark,9,9
2016-08-25,2016,SEA,CWS,6,7,-155,-1.5,-105,9.5,-110,-110,140,1.5,-115,5.77,Guaranteed Rate Field,13,-1
2016-08-25,2016,MIN,DET,5,8,125,1.5,-135,10.0,100,-120,-140,-1.5,115,4.44,Target Field,13,-3
2016-08-25,2016,MIA,KC,2,5,-115,-1.5,185,7.5,100,-120,105,1.5,-215,4.01,Marlins Park,7,-3
2016-08-25,2016,TOR,LAA,3,6,-276,-1.5,-145,10.0,-101,-119,236,1.5,125,7.34,Rogers Centre,9,-3
2016-08-25,2016,SF,LAD,4,0,101,1.5,-210,8.0,-110,-110,-111,-1.5,180,3.98,Dodger Stadium,4,4
2016-08-25,2016,KC,MIA,5,2,105,1.5,-215,7.5,100,-120,-115,-1.5,185,3.66,Marlins Park,7,3
2016-08-25,2016,PIT,MIL,3,2,-120,-1.5,140,9.5,-105,-115,110,1.5,-160,5.18,Miller Park,5,1
2016-08-25,2016,DET,MIN,8,5,-140,-1.5,115,10.0,100,-120,125,1.5,-135,5.83,Target Field,13,3
2016-08-25,2016,STL,NYM,6,10,-170,-1.5,120,8.5,-120,100,150,1.5,-140,5.35,Busch Stadium,16,-4
2016-08-25,2016,MIL,PIT,2,3,110,1.5,-160,9.5,-105,-115,-120,-1.5,140,4.52,Miller Park,5,-1
2016-08-25,2016,CWS,SEA,7,6,140,1.5,-115,9.5,-110,-110,-155,-1.5,-105,3.96,Guaranteed Rate Field,13,1
2016-08-25,2016,LAD,SF,0,4,-111,-1.5,180,8.0,-110,-110,101,1.5,-210,4.21,Dodger Stadium,4,-4
2016-08-25,2016,NYM,STL,10,6,150,1.5,-140,8.5,-120,100,-170,-1.5,120,3.4,Busch Stadium,16,4
2016-08-25,2016,BOS,TB,1,2,-120,-1.5,145,7.0,-120,100,110,1.5,-165,3.82,Tropicana Field,3,-1
2016-08-25,2016,CLE,TEX,0,9,136,1.5,-155,9.0,100,-120,-151,-1.5,135,3.81,Rangers Ballpark,9,-9
2016-08-25,2016,LAA,TOR,6,3,236,1.5,125,10.0,-101,-119,-276,-1.5,-145,2.98,Rogers Centre,9,3
2016-08-25,2016,BAL,WSH,0,4,180,1.5,-105,8.5,-101,-119,-210,-1.5,-115,3.04,Nationals Park,4,-4
2016-08-26,2016,CIN,ARI,3,4,119,1.5,-165,10.5,-105,-115,-134,-1.5,145,4.79,Chase Field,7,-1
2016-08-26,2016,SF,ATL,7,0,-220,-1.5,-105,8.5,-110,-110,190,1.5,-115,5.84,AT&T Park,7,7
2016-08-26,2016,NYY,BAL,14,4,-105,-1.5,175,10.0,100,-120,-105,1.5,-205,5.12,Yankee Stadium,18,10
2016-08-26,2016,KC,BOS,6,3,145,1.5,-142,9.0,-116,-104,-160,-1.5,122,3.67,Fenway Park,9,3
2016-08-26,2016,LAD,CHC,4,6,133,1.5,-136,8.0,-110,-110,-148,-1.5,115,3.43,Dodger Stadium,10,-2
2016-08-26,2016,ARI,CIN,4,3,-134,-1.5,145,10.5,-105,-115,119,1.5,-165,6.01,Chase Field,7,1
2016-08-26,2016,TEX,CLE,1,12,138,1.5,-120,8.5,-115,-105,-153,-1.5,100,3.57,Rangers Ballpark,13,-11
2016-08-26,2016,WSH,COL,8,5,-201,-1.5,-110,9.0,-115,-105,171,1.5,-110,6.01,Nationals Park,13,3
2016-08-26,2016,SEA,CWS,3,1,138,1.5,-170,7.5,107,-127,-153,-1.5,150,3.15,Guaranteed Rate Field,4,2
2016-08-26,2016,LAA,DET,2,4,175,1.5,-113,9.0,105,-125,-205,-1.5,-107,3.27,Comerica Park,6,-2
2016-08-26,2016,TB,HOU,4,5,139,1.5,-160,8.0,-115,-105,-154,-1.5,140,3.35,Minute Maid Park,9,-1
2016-08-26,2016,BOS,KC,3,6,-160,-1.5,122,9.0,-116,-104,145,1.5,-142,5.54,Fenway Park,9,-3
2016-08-26,2016,DET,LAA,4,2,-205,-1.5,-107,9.0,105,-125,175,1.5,-113,6.05,Comerica Park,6,2
2016-08-26,2016,CHC,LAD,6,4,-148,-1.5,115,8.0,-110,-110,133,1.5,-136,4.77,Dodger Stadium,10,2
2016-08-26,2016,SD,MIA,6,7,159,1.5,-140,7.5,-110,-110,-179,-1.5,120,2.9,Marlins Park,13,-1
2016-08-26,2016,PIT,MIL,5,3,-126,-1.5,130,9.0,-125,105,116,1.5,-150,5.02,Miller Park,8,2
2016-08-26,2016,TOR,MIN,15,8,-240,-1.5,-125,10.0,-110,-110,200,1.5,105,7.06,Rogers Centre,23,7
2016-08-26,2016,PHI,NYM,4,9,149,1.5,-150,8.0,-120,100,-164,-1.5,130,3.21,Citi Field,13,-5
2016-08-26,2016,BAL,NYY,4,14,-105,1.5,-205,10.0,100,-120,-105,-1.5,175,5.12,Yankee Stadium,18,-10
2016-08-26,2016,STL,OAK,3,1,-215,-1.5,-110,9.0,-115,-105,185,1.5,-110,6.14,Busch Stadium,4,2
2016-08-26,2016,NYM,PHI,9,4,-164,-1.5,130,8.0,-120,100,149,1.5,-150,4.97,Citi Field,13,5
2016-08-26,2016,MIL,PIT,3,5,116,1.5,-150,9.0,-125,105,-126,-1.5,130,4.17,Miller Park,8,-2
2016-08-26,2016,MIA,SD,7,6,-179,-1.5,120,7.5,-110,-110,159,1.5,-140,4.81,Marlins Park,13,1
2016-08-26,2016,CWS,SEA,1,3,-153,-1.5,150,7.5,107,-127,138,1.5,-170,4.54,Guaranteed Rate Field,4,-2
2016-08-26,2016,ATL,SF,0,7,190,1.5,-115,8.5,-110,-110,-220,-1.5,-105,2.93,AT&T Park,7,-7
2016-08-26,2016,OAK,STL,1,3,185,1.5,-110,9.0,-115,-105,-215,-1.5,-110,3.16,Busch Stadium,4,-2
2016-08-26,2016,HOU,TB,5,4,-154,-1.5,140,8.0,-115,-105,139,1.5,-160,4.85,Minute Maid Park,9,1
2016-08-26,2016,CLE,TEX,12,1,-153,-1.5,100,8.5,-115,-105,138,1.5,-120,5.14,Rangers Ballpark,13,11
2016-08-26,2016,MIN,TOR,8,15,200,1.5,105,10.0,-110,-110,-240,-1.5,-125,3.33,Rogers Centre,23,-7
2016-08-26,2016,COL,WSH,5,8,171,1.5,-110,9.0,-115,-105,-201,-1.5,-110,3.32,Nationals Park,13,-3
2016-08-27,2016,CIN,ARI,13,0,-109,-1.5,135,9.0,-125,105,-101,1.5,-155,4.69,Chase Field,13,13
2016-08-27,2016,SF,ATL,1,3,-126,-1.5,159,8.5,100,-120,116,1.5,-179,4.74,AT&T Park,4,-2
2016-08-27,2016,NYY,BAL,13,5,-120,-1.5,170,9.0,100,-120,110,1.5,-200,4.91,Yankee Stadium,18,8
2016-08-27,2016,KC,BOS,3,8,141,1.5,-150,8.0,-110,-110,-156,-1.5,130,3.32,Fenway Park,11,-5
2016-08-27,2016,LAD,CHC,3,2,-133,-1.5,170,8.5,-104,-116,118,1.5,-200,4.85,Dodger Stadium,5,1
2016-08-27,2016,ARI,CIN,0,13,-101,1.5,-155,9.0,-125,105,-109,-1.5,135,4.52,Chase Field,13,-13
2016-08-27,2016,TEX,CLE,7,0,132,1.5,-135,9.0,-115,-105,-147,-1.5,105,3.88,Rangers Ballpark,7,7
2016-08-27,2016,WSH,COL,4,9,-175,-1.5,115,10.0,100,-120,155,1.5,-135,6.36,Nationals Park,13,-5
2016-08-27,2016,SEA,CWS,3,9,130,1.5,-155,8.5,-110,-110,-145,-1.5,135,3.7,Guaranteed Rate Field,12,-6
2016-08-27,2016,LAA,DET,3,2,180,1.5,-106,9.0,-122,102,-210,-1.5,-114,3.21,Comerica Park,5,1
2016-08-27,2016,TB,HOU,2,6,175,1.5,-134,7.5,-119,-101,-195,-1.5,114,2.73,Minute Maid Park,8,-4
2016-08-27,2016,BOS,KC,8,3,-156,-1.5,130,8.0,-110,-110,141,1.5,-150,4.88,Fenway Park,11,5
2016-08-27,2016,DET,LAA,2,3,-210,-1.5,-114,9.0,-122,102,180,1.5,-106,6.1,Comerica Park,5,-1
2016-08-27,2016,CHC,LAD,2,3,118,1.5,-200,8.5,-104,-116,-133,-1.5,170,3.9,Dodger Stadium,5,-1
2016-08-27,2016,SD,MIA,1,0,107,1.5,-200,8.5,104,-124,-117,-1.5,170,4.11,Marlins Park,1,1
2016-08-27,2016,PIT,MIL,9,6,-161,-1.5,-105,8.5,-105,-115,146,1.5,-115,5.24,Miller Park,15,3
2016-08-27,2016,TOR,MIN,8,7,-205,-1.5,-106,8.5,-120,100,175,1.5,-114,5.71,Rogers Centre,15,1
2016-08-27,2016,PHI,NYM,1,12,180,1.5,-135,7.0,100,-120,-210,-1.5,115,2.5,Citi Field,13,-11
2016-08-27,2016,BAL,NYY,5,13,110,1.5,-200,9.0,100,-120,-120,-1.5,170,4.29,Yankee Stadium,18,-8
2016-08-27,2016,STL,OAK,2,3,-215,-1.5,-105,8.5,101,-121,185,1.5,-115,5.8,Busch Stadium,5,-1
2016-08-27,2016,NYM,PHI,12,1,-210,-1.5,115,7.0,100,-120,180,1.5,-135,4.74,Citi Field,13,11
2016-08-27,2016,MIL,PIT,6,9,146,1.5,-115,8.5,-105,-115,-161,-1.5,-105,3.46,Miller Park,15,-3
2016-08-27,2016,MIA,SD,0,1,-117,-1.5,170,8.5,104,-124,107,1.5,-200,4.58,Marlins Park,1,-1
2016-08-27,2016,CWS,SEA,9,3,-145,-1.5,135,8.5,-110,-110,130,1.5,-155,5.03,Guaranteed Rate Field,12,6
2016-08-27,2016,ATL,SF,3,1,116,1.5,-179,8.5,100,-120,-126,-1.5,159,3.94,AT&T Park,4,2
2016-08-27,2016,OAK,STL,3,2,185,1.5,-115,8.5,101,-121,-215,-1.5,-105,2.98,Busch Stadium,5,1
2016-08-27,2016,HOU,TB,6,2,-195,-1.5,114,7.5,-119,-101,175,1.5,-134,4.96,Minute Maid Park,8,4
2016-08-27,2016,CLE,TEX,0,7,-147,-1.5,105,9.0,-115,-105,132,1.5,-135,5.36,Rangers Ballpark,7,-7
2016-08-27,2016,MIN,TOR,7,8,175,1.5,-114,8.5,-120,100,-205,-1.5,-106,3.09,Rogers Centre,15,-1
2016-08-27,2016,COL,WSH,9,4,155,1.5,-135,10.0,100,-120,-175,-1.5,115,3.92,Nationals Park,13,5
2016-08-28,2016,CIN,ARI,2,11,-118,-1.5,135,9.5,-110,-110,108,1.5,-155,5.14,Chase Field,13,-9
2016-08-28,2016,SF,ATL,13,4,-315,-1.5,-144,8.0,100,-120,265,1.5,125,6.07,AT&T Park,17,9
2016-08-28,2016,NYY,BAL,0,5,111,1.5,-155,9.0,-123,103,-121,-1.5,135,4.27,Yankee Stadium,5,-5
2016-08-28,2016,KC,BOS,10,4,135,1.5,-160,9.0,100,-120,-150,-1.5,140,3.83,Fenway Park,14,6
2016-08-28,2016,LAD,CHC,1,0,153,1.5,-104,8.0,-115,-105,-168,-1.5,-116,3.16,Dodger Stadium,1,1
2016-08-28,2016,ARI,CIN,11,2,108,1.5,-155,9.5,-110,-110,-118,-1.5,135,4.57,Chase Field,13,9
2016-08-28,2016,TEX,CLE,2,1,106,1.5,-150,10.0,100,-120,-116,-1.5,130,4.85,Rangers Ballpark,3,1
2016-08-28,2016,WSH,COL,3,5,-150,-1.5,140,9.5,-110,-110,135,1.5,-160,5.7,Nationals Park,8,-2
2016-08-28,2016,SEA,CWS,1,4,-101,1.5,-210,9.0,-105,-115,-109,-1.5,180,4.52,Guaranteed Rate Field,5,-3
2016-08-28,2016,LAA,DET,5,0,127,1.5,-165,9.5,-120,100,-142,-1.5,145,4.19,Comerica Park,5,5
2016-08-28,2016,TB,HOU,10,4,107,1.5,-210,7.5,106,-126,-117,-1.5,180,3.62,Minute Maid Park,14,6
2016-08-28,2016,BOS,KC,4,10,-150,-1.5,140,9.0,100,-120,135,1.5,-160,5.4,Fenway Park,14,-6
2016-08-28,2016,DET,LAA,0,5,-142,-1.5,145,9.5,-120,100,127,1.5,-165,5.57,Comerica Park,5,-5
2016-08-28,2016,CHC,LAD,0,1,-168,-1.5,-116,8.0,-115,-105,153,1.5,-104,5.01,Dodger Stadium,1,-1
2016-08-28,2016,SD,MIA,3,1,135,1.5,-165,8.5,-110,-110,-150,-1.5,145,3.62,Marlins Park,4,2
2016-08-28,2016,PIT,MIL,3,1,-141,-1.5,115,9.0,-105,-115,126,1.5,-135,5.27,Miller Park,4,2
2016-08-28,2016,TOR,MIN,9,6,-172,-1.5,115,10.5,100,-120,152,1.5,-135,6.64,Rogers Centre,15,3
2016-08-28,2016,PHI,NYM,5,1,116,1.5,-185,8.5,100,-120,-131,-1.5,165,3.94,Citi Field,6,4
2016-08-28,2016,BAL,NYY,5,0,-121,-1.5,135,9.0,-123,103,111,1.5,-155,4.93,Yankee Stadium,5,5
2016-08-28,2016,STL,OAK,4,7,-151,-1.5,140,8.5,-115,-105,136,1.5,-160,5.11,Busch Stadium,11,-3
2016-08-28,2016,NYM,PHI,1,5,-131,-1.5,165,8.5,100,-120,116,1.5,-185,4.82,Citi Field,6,-4
2016-08-28,2016,MIL,PIT,1,3,126,1.5,-135,9.0,-105,-115,-141,-1.5,115,3.98,Miller Park,4,-2
2016-08-28,2016,MIA,SD,1,3,-150,-1.5,145,8.5,-110,-110,135,1.5,-165,5.1,Marlins Park,4,-2
2016-08-28,2016,CWS,SEA,4,1,-109,-1.5,180,9.0,-105,-115,-101,1.5,-210,4.69,Guaranteed Rate Field,5,3
2016-08-28,2016,ATL,SF,4,13,265,1.5,125,8.0,100,-120,-315,-1.5,-144,2.19,AT&T Park,17,-9
2016-08-28,2016,OAK,STL,7,4,136,1.5,-160,8.5,-115,-105,-151,-1.5,140,3.6,Busch Stadium,11,3
2016-08-28,2016,HOU,TB,4,10,-117,-1.5,180,7.5,106,-126,107,1.5,-210,4.04,Minute Maid Park,14,-6
2016-08-28,2016,CLE,TEX,1,2,-116,-1.5,130,10.0,100,-120,106,1.5,-150,5.37,Rangers Ballpark,3,-1
2016-08-28,2016,MIN,TOR,6,9,152,1.5,-135,10.5,100,-120,-172,-1.5,115,4.17,Rogers Centre,15,-3
2016-08-28,2016,COL,WSH,5,3,135,1.5,-160,9.5,-110,-110,-150,-1.5,140,4.04,Nationals Park,8,2
2016-08-29,2016,TOR,BAL,5,1,-142,-1.5,105,11.0,-110,-110,127,1.5,-125,6.45,Camden Yards,6,4
2016-08-29,2016,TB,BOS,4,9,151,1.5,-135,9.5,-115,-105,-171,-1.5,115,3.78,Fenway Park,13,-5
2016-08-29,2016,PIT,CHC,7,8,200,1.5,-110,8.5,-105,-115,-240,-1.5,-110,2.83,Wrigley Field,15,-1
2016-08-29,2016,LAA,CIN,9,2,-177,-1.5,125,8.0,-110,-110,157,1.5,-145,5.11,Angel Stadium,11,7
2016-08-29,2016,MIN,CLE,0,1,175,1.5,-115,9.0,-125,105,-195,-1.5,-105,3.27,Progressive Field,1,-1
2016-08-29,2016,LAD,COL,1,8,-122,-1.5,130,10.5,-105,-115,112,1.5,-150,5.77,Coors Field,9,-7
2016-08-29,2016,DET,CWS,4,3,-200,-1.5,-110,10.0,-120,100,170,1.5,-110,6.67,Comerica Park,7,1
2016-08-29,2016,CWS,DET,3,4,170,1.5,-110,10.0,-120,100,-200,-1.5,-110,3.7,Comerica Park,7,-1
2016-08-29,2016,OAK,HOU,0,6,157,1.5,-140,8.5,-105,-115,-177,-1.5,120,3.31,Minute Maid Park,6,-6
2016-08-29,2016,NYY,KC,5,8,-125,-1.5,125,8.0,-110,-110,115,1.5,-145,4.44,Kauffman Stadium,13,-3
2016-08-29,2016,CIN,LAA,2,9,157,1.5,-145,8.0,-110,-110,-177,-1.5,125,3.11,Angel Stadium,11,-7
2016-08-29,2016,COL,LAD,8,1,112,1.5,-150,10.5,-105,-115,-122,-1.5,130,4.95,Coors Field,9,7
2016-08-29,2016,NYM,MIA,2,1,141,1.5,-125,7.5,-105,-115,-156,-1.5,105,3.11,Citi Field,3,1
2016-08-29,2016,STL,MIL,6,5,-134,-1.5,120,8.0,-110,-110,119,1.5,-140,4.58,Miller Park,11,1
2016-08-29,2016,CLE,MIN,1,0,-195,-1.5,-105,9.0,-125,105,175,1.5,-115,5.95,Progressive Field,1,1
2016-08-29,2016,MIA,NYM,1,2,-156,-1.5,105,7.5,-105,-115,141,1.5,-125,4.57,Citi Field,3,-1
2016-08-29,2016,KC,NYY,8,5,115,1.5,-145,8.0,-110,-110,-125,-1.5,125,3.72,Kauffman Stadium,13,3
2016-08-29,2016,HOU,OAK,6,0,-177,-1.5,120,8.5,-105,-115,157,1.5,-140,5.43,Minute Maid Park,6,6
2016-08-29,2016,WSH,PHI,4,0,-195,-1.5,-120,9.0,-125,105,175,1.5,100,5.95,Citizens Bank Park,4,4
2016-08-29,2016,CHC,PIT,8,7,-240,-1.5,-110,8.5,-105,-115,200,1.5,-110,6.0,Wrigley Field,15,1
2016-08-29,2016,TEX,SEA,6,3,-164,-1.5,130,8.5,-115,-105,149,1.5,-150,5.28,Rangers Ballpark,9,3
2016-08-29,2016,MIL,STL,5,6,119,1.5,-140,8.0,-110,-110,-134,-1.5,120,3.65,Miller Park,11,-1
2016-08-29,2016,BOS,TB,9,4,-171,-1.5,115,9.5,-115,-105,151,1.5,-135,5.99,Fenway Park,13,5
2016-08-29,2016,SEA,TEX,3,6,149,1.5,-150,8.5,-115,-105,-164,-1.5,130,3.41,Rangers Ballpark,9,-3
2016-08-29,2016,BAL,TOR,1,5,127,1.5,-125,11.0,-110,-110,-142,-1.5,105,4.85,Camden Yards,6,-4
2016-08-29,2016,PHI,WSH,0,4,175,1.5,100,9.0,-125,105,-195,-1.5,-120,3.27,Citizens Bank Park,4,-4
2016-08-30,2016,SF,ARI,3,4,-163,-1.5,138,7.0,-115,-105,148,1.5,-158,4.34,AT&T Park,7,-1
2016-08-30,2016,SD,ATL,3,7,170,1.5,-115,8.5,-125,105,-190,-1.5,-105,3.15,Turner Field,10,-4
2016-08-30,2016,TOR,BAL,3,5,-144,-1.5,110,10.0,100,-120,129,1.5,-130,5.9,Camden Yards,8,-2
2016-08-30,2016,TB,BOS,4,3,151,1.5,-132,9.5,-105,-115,-171,-1.5,112,3.78,Fenway Park,7,1
2016-08-30,2016,PIT,CHC,0,3,180,1.5,-122,8.0,-120,100,-210,-1.5,102,2.86,Wrigley Field,3,-3
2016-08-30,2016,LAA,CIN,4,2,-143,-1.5,140,9.5,-120,100,128,1.5,-160,5.59,Angel Stadium,6,2
2016-08-30,2016,MIN,CLE,4,5,175,1.5,-115,10.0,-115,-105,-195,-1.5,-105,3.64,Progressive Field,9,-1
2016-08-30,2016,DET,CWS,8,4,-182,-1.5,102,10.0,-110,-110,162,1.5,-122,6.45,Comerica Park,12,4
2016-08-30,2016,CWS,DET,4,8,162,1.5,-122,10.0,-110,-110,-182,-1.5,102,3.82,Comerica Park,12,-4
2016-08-30,2016,OAK,HOU,1,3,175,1.5,-130,8.0,-115,-105,-195,-1.5,110,2.91,Minute Maid Park,4,-2
2016-08-30,2016,NYY,KC,5,4,-141,-1.5,115,7.5,-110,-110,126,1.5,-135,4.39,Kauffman Stadium,9,1
2016-08-30,2016,CIN,LAA,2,4,128,1.5,-160,9.5,-120,100,-143,-1.5,140,4.17,Angel Stadium,6,-2
2016-08-30,2016,NYM,MIA,7,4,-126,-1.5,165,7.5,-105,-115,116,1.5,-185,4.18,Citi Field,11,3
2016-08-30,2016,STL,MIL,2,1,-163,-1.5,-105,9.5,-105,-115,148,1.5,-115,5.89,Miller Park,3,1
2016-08-30,2016,CLE,MIN,5,4,-195,-1.5,-105,10.0,-115,-105,175,1.5,-115,6.61,Progressive Field,9,1
2016-08-30,2016,MIA,NYM,4,7,116,1.5,-185,7.5,-105,-115,-126,-1.5,165,3.47,Citi Field,11,-3
2016-08-30,2016,KC,NYY,4,5,126,1.5,-135,7.5,-110,-110,-141,-1.5,115,3.32,Kauffman Stadium,9,-1
2016-08-30,2016,HOU,OAK,3,1,-195,-1.5,110,8.0,-115,-105,175,1.5,-130,5.29,Minute Maid Park,4,2
2016-08-30,2016,WSH,PHI,3,2,-215,-1.5,-130,7.5,-105,-115,185,1.5,110,5.12,Citizens Bank Park,5,1
2016-08-30,2016,CHC,PIT,3,0,-210,-1.5,102,8.0,-120,100,180,1.5,-122,5.42,Wrigley Field,3,3
2016-08-30,2016,ATL,SD,7,3,-190,-1.5,-105,8.5,-125,105,170,1.5,-115,5.57,Turner Field,10,4
2016-08-30,2016,TEX,SEA,8,7,-154,-1.5,140,8.5,-115,-105,139,1.5,-160,5.15,Rangers Ballpark,15,1
2016-08-30,2016,ARI,SF,4,3,148,1.5,-158,7.0,-115,-105,-163,-1.5,138,2.82,AT&T Park,7,1
2016-08-30,2016,MIL,STL,1,2,148,1.5,-115,9.5,-105,-115,-163,-1.5,-105,3.83,Miller Park,3,-1
2016-08-30,2016,BOS,TB,3,4,-171,-1.5,112,9.5,-105,-115,151,1.5,-132,5.99,Fenway Park,7,-1
2016-08-30,2016,SEA,TEX,7,8,139,1.5,-160,8.5,-115,-105,-154,-1.5,140,3.56,Rangers Ballpark,15,-1
2016-08-30,2016,BAL,TOR,5,3,129,1.5,-130,10.0,100,-120,-144,-1.5,110,4.37,Camden Yards,8,2
2016-08-30,2016,PHI,WSH,2,3,185,1.5,110,7.5,-105,-115,-215,-1.5,-130,2.63,Citizens Bank Park,5,-1
2016-08-31,2016,SF,ARI,4,2,-174,-1.5,116,8.5,-125,105,154,1.5,-136,5.4,AT&T Park,6,2
2016-08-31,2016,SD,ATL,1,8,128,1.5,-170,9.0,-125,105,-143,-1.5,150,3.95,Turner Field,9,-7
2016-08-31,2016,TOR,BAL,5,3,-160,-1.5,-110,9.5,-121,101,145,1.5,-110,5.85,Camden Yards,8,2
2016-08-31,2016,TB,BOS,6,8,146,1.5,-145,10.0,-120,100,-161,-1.5,125,4.07,Fenway Park,14,-2
2016-08-31,2016,PIT,CHC,5,6,156,1.5,-135,8.5,100,-120,-176,-1.5,115,3.32,Wrigley Field,11,-1
2016-08-31,2016,LAA,CIN,3,0,103,1.5,-165,8.5,-118,-102,-113,-1.5,145,4.19,Angel Stadium,3,3
2016-08-31,2016,MIN,CLE,4,8,270,1.5,126,9.0,100,-120,-320,-1.5,-146,2.43,Progressive Field,12,-4
2016-08-31,2016,LAD,COL,0,7,132,1.5,-149,11.0,-105,-115,-147,-1.5,129,4.74,Coors Field,7,-7
2016-08-31,2016,LAD,COL,10,8,-160,-1.5,-110,12.0,100,-120,145,1.5,-110,7.38,Coors Field,18,2
2016-08-31,2016,DET,CWS,3,2,-119,-1.5,175,7.5,100,-120,109,1.5,-205,4.08,Comerica Park,5,1
2016-08-31,2016,CWS,DET,2,3,109,1.5,-205,7.5,100,-120,-119,-1.5,175,3.59,Comerica Park,5,-1
2016-08-31,2016,OAK,HOU,3,4,200,1.5,-105,9.0,-125,105,-230,-1.5,-115,3.0,Minute Maid Park,7,-1
2016-08-31,2016,NYY,KC,5,4,135,1.5,-165,8.0,-105,-115,-150,-1.5,145,3.4,Kauffman Stadium,9,1
2016-08-31,2016,CIN,LAA,0,3,-113,-1.5,145,8.5,-118,-102,103,1.5,-165,4.51,Angel Stadium,3,-3
2016-08-31,2016,COL,LAD,7,0,-147,-1.5,129,11.0,-105,-115,132,1.5,-149,6.55,Coors Field,7,7
2016-08-31,2016,COL,LAD,8,10,145,1.5,-110,12.0,100,-120,-160,-1.5,-110,4.9,Coors Field,18,-2
2016-08-31,2016,NYM,MIA,5,2,-162,-1.5,135,8.5,100,-120,147,1.5,-155,5.26,Citi Field,7,3
2016-08-31,2016,STL,MIL,1,3,-148,-1.5,105,9.0,-119,-101,133,1.5,-125,5.37,Miller Park,4,-2
2016-08-31,2016,CLE,MIN,8,4,-320,-1.5,-146,9.0,100,-120,270,1.5,126,6.86,Progressive Field,12,4
2016-08-31,2016,MIA,NYM,2,5,147,1.5,-155,8.5,100,-120,-162,-1.5,135,3.44,Citi Field,7,-3
2016-08-31,2016,KC,NYY,4,5,-150,-1.5,145,8.0,-105,-115,135,1.5,-165,4.8,Kauffman Stadium,9,-1
2016-08-31,2016,HOU,OAK,4,3,-230,-1.5,-115,9.0,-125,105,200,1.5,-105,6.27,Minute Maid Park,7,1
2016-08-31,2016,WSH,PHI,2,1,-210,-1.5,-134,9.5,-107,-113,180,1.5,114,6.44,Citizens Bank Park,3,1
2016-08-31,2016,CHC,PIT,6,5,-176,-1.5,115,8.5,100,-120,156,1.5,-135,5.42,Wrigley Field,11,1
2016-08-31,2016,ATL,SD,8,1,-143,-1.5,150,9.0,-125,105,128,1.5,-170,5.3,Turner Field,9,7
2016-08-31,2016,TEX,SEA,14,1,-106,-1.5,180,9.5,-101,-119,-104,1.5,-210,4.89,Rangers Ballpark,15,13
2016-08-31,2016,ARI,SF,2,4,154,1.5,-136,8.5,-125,105,-174,-1.5,116,3.35,AT&T Park,6,-2
2016-08-31,2016,MIL,STL,3,1,133,1.5,-125,9.0,-119,-101,-148,-1.5,105,3.86,Miller Park,4,2
2016-08-31,2016,BOS,TB,8,6,-161,-1.5,125,10.0,-120,100,146,1.5,-145,6.17,Fenway Park,14,2
2016-08-31,2016,SEA,TEX,1,14,-104,1.5,-210,9.5,-101,-119,-106,-1.5,180,4.84,Rangers Ballpark,15,-13
2016-08-31,2016,BAL,TOR,3,5,145,1.5,-110,9.5,-121,101,-160,-1.5,-110,3.88,Camden Yards,8,-2
2016-08-31,2016,PHI,WSH,1,2,180,1.5,114,9.5,-107,-113,-210,-1.5,-134,3.39,Citizens Bank Park,3,-1
2016-09-01,2016,SD,ATL,6,9,130,1.5,-155,9.0,-105,-115,-145,-1.5,135,3.91,Turner Field,15,-3
2016-09-01,2016,SF,CHC,4,5,125,1.5,-175,8.0,-110,-110,-140,-1.5,155,3.56,Wrigley Field,9,-1
2016-09-01,2016,MIN,CWS,8,5,103,1.5,-160,8.0,-125,105,-113,-1.5,140,3.94,Target Field,13,3
2016-09-01,2016,NYM,MIA,4,6,-261,-1.5,-119,7.5,-101,-119,221,1.5,-101,5.42,Citi Field,10,-2
2016-09-01,2016,CWS,MIN,5,8,-113,-1.5,140,8.0,-125,105,103,1.5,-160,4.24,Target Field,13,-3
2016-09-01,2016,MIA,NYM,6,4,221,1.5,-101,7.5,-101,-119,-261,-1.5,-119,2.34,Citi Field,10,2
2016-09-01,2016,ATL,SD,9,6,-145,-1.5,135,9.0,-105,-115,130,1.5,-155,5.33,Turner Field,15,3
2016-09-01,2016,CHC,SF,5,4,-140,-1.5,155,8.0,-110,-110,125,1.5,-175,4.67,Wrigley Field,9,1
2016-09-02,2016,COL,ARI,14,7,109,1.5,-145,11.5,-115,-105,-119,-1.5,125,5.5,Coors Field,21,7
2016-09-02,2016,PHI,ATL,4,8,-141,-1.5,150,8.5,-125,105,126,1.5,-170,4.97,Citizens Bank Park,12,-4
2016-09-02,2016,NYY,BAL,0,8,128,1.5,-170,9.0,-110,-110,-143,-1.5,150,3.95,Camden Yards,8,-8
2016-09-02,2016,OAK,BOS,2,16,145,1.5,-120,7.5,-101,-119,-160,-1.5,100,3.06,Oakland Coliseum,18,-14
2016-09-02,2016,SF,CHC,1,2,205,1.5,-105,8.0,-105,-115,-235,-1.5,-115,2.62,Wrigley Field,3,-1
2016-09-02,2016,STL,CIN,2,3,-142,-1.5,115,8.0,-110,-110,127,1.5,-135,4.69,Great American Ballpark,5,-1
2016-09-02,2016,MIA,CLE,2,6,271,1.5,135,7.5,-120,100,-321,-1.5,-156,2.02,Progressive Field,8,-4
2016-09-02,2016,ARI,COL,7,14,-119,-1.5,125,11.5,-115,-105,109,1.5,-145,6.25,Coors Field,21,-7
2016-09-02,2016,MIN,CWS,4,11,106,1.5,-155,8.5,-125,105,-116,-1.5,135,4.13,Target Field,15,-7
2016-09-02,2016,KC,DET,6,7,-144,-1.5,150,7.5,-120,100,129,1.5,-170,4.43,Kauffman Stadium,13,-1
2016-09-02,2016,TEX,HOU,10,8,-109,-1.5,175,9.5,-115,-105,-101,1.5,-205,4.95,Rangers Ballpark,18,2
2016-09-02,2016,DET,KC,7,6,129,1.5,-170,7.5,-120,100,-144,-1.5,150,3.28,Kauffman Stadium,13,1
2016-09-02,2016,SEA,LAA,11,8,-129,-1.5,165,9.0,-105,-115,119,1.5,-185,5.07,T-Mobile Park,19,3
2016-09-02,2016,SD,LAD,4,2,215,1.5,-105,7.5,105,-125,-255,-1.5,-115,2.38,Dodger Stadium,6,2
2016-09-02,2016,CLE,MIA,6,2,-321,-1.5,-156,7.5,-120,100,271,1.5,135,5.72,Progressive Field,8,4
2016-09-02,2016,PIT,MIL,0,1,-184,-1.5,115,7.0,-125,105,164,1.5,-135,4.54,PNC Park,1,-1
2016-09-02,2016,CWS,MIN,11,4,-116,-1.5,135,8.5,-125,105,106,1.5,-155,4.56,Target Field,15,7
2016-09-02,2016,WSH,NYM,4,1,145,1.5,-160,7.5,-115,-105,-160,-1.5,140,3.06,Citi Field,5,3
2016-09-02,2016,BAL,NYY,8,0,-143,-1.5,150,9.0,-110,-110,128,1.5,-170,5.3,Camden Yards,8,8
2016-09-02,2016,BOS,OAK,16,2,-160,-1.5,100,7.5,-101,-119,145,1.5,-120,4.62,Oakland Coliseum,18,14
2016-09-02,2016,ATL,PHI,8,4,126,1.5,-170,8.5,-125,105,-141,-1.5,150,3.76,Citizens Bank Park,12,4
2016-09-02,2016,MIL,PIT,1,0,164,1.5,-135,7.0,-125,105,-184,-1.5,115,2.65,PNC Park,1,1
2016-09-02,2016,LAD,SD,2,4,-255,-1.5,-115,7.5,105,-125,215,1.5,-105,5.39,Dodger Stadium,6,-2
2016-09-02,2016,LAA,SEA,8,11,119,1.5,-185,9.0,-105,-115,-129,-1.5,165,4.11,T-Mobile Park,19,-3
2016-09-02,2016,CHC,SF,2,1,-235,-1.5,-115,8.0,-105,-115,205,1.5,-105,5.61,Wrigley Field,3,1
2016-09-02,2016,CIN,STL,3,2,127,1.5,-135,8.0,-110,-110,-142,-1.5,115,3.52,Great American Ballpark,5,1
2016-09-02,2016,TOR,TB,3,8,-155,-1.5,105,8.0,-105,-115,140,1.5,-125,4.86,Tropicana Field,11,-5
2016-09-02,2016,HOU,TEX,8,10,-101,1.5,-205,9.5,-115,-105,-109,-1.5,175,4.77,Rangers Ballpark,18,-2
2016-09-02,2016,TB,TOR,8,3,140,1.5,-125,8.0,-105,-115,-155,-1.5,105,3.33,Tropicana Field,11,5
2016-09-02,2016,NYM,WSH,1,4,-160,-1.5,140,7.5,-115,-105,145,1.5,-160,4.62,Citi Field,5,-3
2016-09-03,2016,COL,ARI,4,9,-181,-1.5,-104,13.0,-101,-119,161,1.5,-116,8.37,Coors Field,13,-5
2016-09-03,2016,PHI,ATL,4,6,-119,-1.5,175,8.0,-105,-115,109,1.5,-205,4.35,Citizens Bank Park,10,-2
2016-09-03,2016,NYY,BAL,0,2,150,1.5,-145,8.5,-115,-105,-170,-1.5,125,3.4,Camden Yards,2,-2
2016-09-03,2016,OAK,BOS,2,11,175,1.5,109,8.0,-120,100,-205,-1.5,-129,2.91,Oakland Coliseum,13,-9
2016-09-03,2016,SF,CHC,3,2,116,1.5,-205,7.0,-120,100,-131,-1.5,175,3.24,Wrigley Field,5,1
2016-09-03,2016,STL,CIN,1,9,-120,-1.5,135,9.0,-110,-110,110,1.5,-155,4.91,Great American Ballpark,10,-8
2016-09-03,2016,MIA,CLE,3,8,102,1.5,-210,7.0,-110,-110,-112,-1.5,180,3.47,Progressive Field,11,-5
2016-09-03,2016,ARI,COL,9,4,161,1.5,-116,13.0,-101,-119,-181,-1.5,-104,4.98,Coors Field,13,5
2016-09-03,2016,MIN,CWS,11,3,-141,-1.5,135,10.0,-108,-112,126,1.5,-155,5.85,Target Field,14,8
2016-09-03,2016,KC,DET,5,2,-124,-1.5,175,8.0,-105,-115,114,1.5,-205,4.43,Kauffman Stadium,7,3
2016-09-03,2016,TEX,HOU,12,4,125,1.5,-127,10.0,-115,-105,-140,-1.5,107,4.44,Rangers Ballpark,16,8
2016-09-03,2016,DET,KC,2,5,114,1.5,-205,8.0,-105,-115,-124,-1.5,175,3.74,Kauffman Stadium,7,-3
2016-09-03,2016,SEA,LAA,3,10,-126,-1.5,165,8.5,100,-120,116,1.5,-185,4.74,T-Mobile Park,13,-7
2016-09-03,2016,SD,LAD,1,5,245,1.5,112,7.5,-105,-115,-285,-1.5,-132,2.17,Dodger Stadium,6,-4
2016-09-03,2016,CLE,MIA,8,3,-112,-1.5,180,7.0,-110,-110,102,1.5,-210,3.7,Progressive Field,11,5
2016-09-03,2016,PIT,MIL,4,7,-195,-1.5,105,8.0,-120,100,175,1.5,-125,5.29,PNC Park,11,-3
2016-09-03,2016,CWS,MIN,3,11,126,1.5,-155,10.0,-108,-112,-141,-1.5,135,4.42,Target Field,14,-8
2016-09-03,2016,WSH,NYM,1,3,-134,-1.5,121,8.0,-104,-116,119,1.5,-141,4.58,Citi Field,4,-2
2016-09-03,2016,BAL,NYY,2,0,-170,-1.5,125,8.5,-115,-105,150,1.5,-145,5.35,Camden Yards,2,2
2016-09-03,2016,BOS,OAK,11,2,-205,-1.5,-129,8.0,-120,100,175,1.5,109,5.38,Oakland Coliseum,13,9
2016-09-03,2016,ATL,PHI,6,4,109,1.5,-205,8.0,-105,-115,-119,-1.5,175,3.83,Citizens Bank Park,10,2
2016-09-03,2016,MIL,PIT,7,4,175,1.5,-125,8.0,-120,100,-195,-1.5,105,2.91,PNC Park,11,3
2016-09-03,2016,LAD,SD,5,1,-285,-1.5,-132,7.5,-105,-115,245,1.5,112,5.55,Dodger Stadium,6,4
2016-09-03,2016,LAA,SEA,10,3,116,1.5,-185,8.5,100,-120,-126,-1.5,165,3.94,T-Mobile Park,13,7
2016-09-03,2016,CHC,SF,2,3,-131,-1.5,175,7.0,-120,100,116,1.5,-205,3.97,Wrigley Field,5,-1
2016-09-03,2016,CIN,STL,9,1,110,1.5,-155,9.0,-110,-110,-120,-1.5,135,4.29,Great American Ballpark,10,8
2016-09-03,2016,TOR,TB,5,7,-141,-1.5,115,8.5,100,-120,126,1.5,-135,4.97,Tropicana Field,12,-2
2016-09-03,2016,HOU,TEX,4,12,-140,-1.5,107,10.0,-115,-105,125,1.5,-127,5.83,Rangers Ballpark,16,-8
2016-09-03,2016,TB,TOR,7,5,126,1.5,-135,8.5,100,-120,-141,-1.5,115,3.76,Tropicana Field,12,2
2016-09-03,2016,NYM,WSH,3,1,119,1.5,-141,8.0,-104,-116,-134,-1.5,121,3.65,Citi Field,4,2
2016-09-04,2016,COL,ARI,5,8,-195,-1.5,-121,12.5,-120,100,175,1.5,101,8.26,Coors Field,13,-3
2016-09-04,2016,PHI,ATL,0,2,156,1.5,-101,8.0,-120,100,-176,-1.5,-119,3.13,Citizens Bank Park,2,-2
2016-09-04,2016,NYY,BAL,5,2,106,1.5,-200,9.0,-101,-119,-116,-1.5,170,4.37,Camden Yards,7,3
2016-09-04,2016,OAK,BOS,1,0,111,1.5,-155,8.5,-118,-102,-121,-1.5,135,4.03,Oakland Coliseum,1,1
2016-09-04,2016,SF,CHC,2,3,127,1.5,-181,8.0,100,-120,-142,-1.5,161,3.52,Wrigley Field,5,-1
2016-09-04,2016,STL,CIN,5,2,-210,-1.5,-140,8.5,-125,105,180,1.5,120,5.76,Great American Ballpark,7,3
2016-09-04,2016,MIA,CLE,5,6,185,1.5,106,8.5,-105,-115,-215,-1.5,-129,2.98,Progressive Field,11,-1
2016-09-04,2016,ARI,COL,8,5,175,1.5,101,12.5,-120,100,-195,-1.5,-121,4.55,Coors Field,13,3
2016-09-04,2016,MIN,CWS,11,13,-134,-1.5,145,10.5,-105,-115,119,1.5,-165,6.01,Target Field,24,-2
2016-09-04,2016,KC,DET,5,6,-105,-1.5,180,9.0,100,-120,-105,1.5,-210,4.61,Kauffman Stadium,11,-1
2016-09-04,2016,TEX,HOU,6,7,-159,-1.5,125,9.0,100,-120,144,1.5,-145,5.53,Rangers Ballpark,13,-1
2016-09-04,2016,DET,KC,6,5,-105,1.5,-210,9.0,100,-120,-105,-1.5,180,4.61,Kauffman Stadium,11,1
2016-09-04,2016,SEA,LAA,2,4,-115,-1.5,180,8.0,-105,-115,105,1.5,-210,4.28,T-Mobile Park,6,-2
2016-09-04,2016,SD,LAD,4,7,181,1.5,-115,8.0,-115,-105,-211,-1.5,-105,2.85,Dodger Stadium,11,-3
2016-09-04,2016,CLE,MIA,6,5,-215,-1.5,-129,8.5,-105,-115,185,1.5,106,5.8,Progressive Field,11,1
2016-09-04,2016,PIT,MIL,0,10,-185,-1.5,110,9.0,-105,-115,165,1.5,-130,5.84,PNC Park,10,-10
2016-09-04,2016,CWS,MIN,13,11,119,1.5,-165,10.5,-105,-115,-134,-1.5,145,4.79,Target Field,24,2
2016-09-04,2016,WSH,NYM,1,5,106,1.5,-205,8.0,-115,-105,-116,-1.5,175,3.88,Citi Field,6,-4
2016-09-04,2016,BAL,NYY,2,5,-116,-1.5,170,9.0,-101,-119,106,1.5,-200,4.83,Camden Yards,7,-3
2016-09-04,2016,BOS,OAK,0,1,-121,-1.5,135,8.5,-118,-102,111,1.5,-155,4.65,Oakland Coliseum,1,-1
2016-09-04,2016,ATL,PHI,2,0,-176,-1.5,-119,8.0,-120,100,156,1.5,-101,5.1,Citizens Bank Park,2,2
2016-09-04,2016,MIL,PIT,10,0,165,1.5,-130,9.0,-105,-115,-185,-1.5,110,3.4,PNC Park,10,10
2016-09-04,2016,LAD,SD,7,4,-211,-1.5,-105,8.0,-115,-105,181,1.5,-115,5.43,Dodger Stadium,11,3
2016-09-04,2016,LAA,SEA,4,2,105,1.5,-210,8.0,-105,-115,-115,-1.5,180,3.9,T-Mobile Park,6,2
2016-09-04,2016,CHC,SF,3,2,-142,-1.5,161,8.0,100,-120,127,1.5,-181,4.69,Wrigley Field,5,1
2016-09-04,2016,CIN,STL,2,5,180,1.5,120,8.5,-125,105,-210,-1.5,-140,3.04,Great American Ballpark,7,-3
2016-09-04,2016,TOR,TB,5,3,-111,-1.5,145,7.0,-125,105,101,1.5,-165,3.68,Tropicana Field,8,2
2016-09-04,2016,HOU,TEX,7,6,144,1.5,-145,9.0,100,-120,-159,-1.5,125,3.69,Rangers Ballpark,13,1
2016-09-04,2016,TB,TOR,3,5,101,1.5,-165,7.0,-125,105,-111,-1.5,145,3.48,Tropicana Field,8,-2
2016-09-04,2016,NYM,WSH,5,1,-116,-1.5,175,8.0,-115,-105,106,1.5,-205,4.3,Citi Field,6,4
2016-09-05,2016,LAD,ARI,10,2,-164,-1.5,135,7.5,-105,-115,149,1.5,-155,4.66,Dodger Stadium,12,8
2016-09-05,2016,WSH,ATL,6,4,-267,-1.5,-122,7.5,-110,-110,227,1.5,102,5.46,Nationals Park,10,2
2016-09-05,2016,TB,BAL,3,7,-113,-1.5,175,8.5,-120,100,103,1.5,-205,4.51,Tropicana Field,10,-4
2016-09-05,2016,SD,BOS,2,1,180,1.5,118,8.0,-121,101,-210,-1.5,-138,2.86,PETCO Park,3,1
2016-09-05,2016,MIL,CHC,2,7,163,1.5,-107,8.0,-105,-115,-183,-1.5,-112,3.04,Miller Park,9,-5
2016-09-05,2016,NYM,CIN,5,0,-105,-1.5,150,9.0,-110,-110,-105,1.5,-170,4.61,Great American Ballpark,5,5
2016-09-05,2016,HOU,CLE,6,2,-105,-1.5,150,9.0,-115,-105,-105,1.5,-170,4.61,Progressive Field,8,4
2016-09-05,2016,SF,COL,0,6,-105,-1.5,140,13.0,100,-120,-105,1.5,-160,6.66,Coors Field,6,-6
2016-09-05,2016,DET,CWS,5,3,-108,-1.5,150,8.0,100,-120,-102,1.5,-170,4.15,Guaranteed Rate Field,8,2
2016-09-05,2016,CWS,DET,3,5,-102,1.5,-170,8.0,100,-120,-108,-1.5,150,4.04,Guaranteed Rate Field,8,-2
2016-09-05,2016,CLE,HOU,2,6,-105,1.5,-170,9.0,-115,-105,-105,-1.5,150,4.61,Progressive Field,8,-4
2016-09-05,2016,MIN,KC,5,11,119,1.5,-131,9.0,114,-134,-134,-1.5,112,4.11,Target Field,16,-6
2016-09-05,2016,OAK,LAA,7,10,-130,-1.5,145,9.0,-110,-110,115,1.5,-170,5.09,Oakland Coliseum,17,-3
2016-09-05,2016,ARI,LAD,2,10,149,1.5,-155,7.5,-105,-115,-164,-1.5,135,3.01,Dodger Stadium,12,-8
2016-09-05,2016,PHI,MIA,6,2,-116,-1.5,140,8.0,100,-120,106,1.5,-160,4.3,Marlins Park,8,4
2016-09-05,2016,CHC,MIL,7,2,-183,-1.5,-112,8.0,-105,-115,163,1.5,-107,5.17,Miller Park,9,5
2016-09-05,2016,KC,MIN,11,5,-134,-1.5,112,9.0,114,-134,119,1.5,-131,5.15,Target Field,16,6
2016-09-05,2016,CIN,NYM,0,5,-105,1.5,-170,9.0,-110,-110,-105,-1.5,150,4.61,Great American Ballpark,5,-5
2016-09-05,2016,TOR,NYY,3,5,138,1.5,-165,8.5,-110,-110,-153,-1.5,145,3.57,Yankee Stadium,8,-2
2016-09-05,2016,LAA,OAK,10,7,115,1.5,-170,9.0,-110,-110,-130,-1.5,145,4.19,Oakland Coliseum,17,3
2016-09-05,2016,MIA,PHI,2,6,106,1.5,-160,8.0,100,-120,-116,-1.5,140,3.88,Marlins Park,8,-4
2016-09-05,2016,STL,PIT,12,6,-105,-1.5,145,8.5,-127,107,-105,1.5,-165,4.35,PNC Park,18,6
2016-09-05,2016,BOS,SD,1,2,-210,-1.5,-138,8.0,-121,101,180,1.5,118,5.42,PETCO Park,3,-1
2016-09-05,2016,TEX,SEA,6,14,-122,-1.5,145,7.5,101,-121,112,1.5,-165,4.12,T-Mobile Park,20,-8
2016-09-05,2016,COL,SF,6,0,-105,1.5,-160,13.0,100,-120,-105,-1.5,140,6.66,Coors Field,6,6
2016-09-05,2016,PIT,STL,6,12,-105,1.5,-165,8.5,-127,107,-105,-1.5,145,4.35,PNC Park,18,-6
2016-09-05,2016,BAL,TB,7,3,103,1.5,-205,8.5,-120,100,-113,-1.5,175,4.19,Tropicana Field,10,4
2016-09-05,2016,SEA,TEX,14,6,112,1.5,-165,7.5,101,-121,-122,-1.5,145,3.54,T-Mobile Park,20,8
2016-09-05,2016,NYY,TOR,5,3,-153,-1.5,145,8.5,-110,-110,138,1.5,-165,5.14,Yankee Stadium,8,2
2016-09-05,2016,ATL,WSH,4,6,227,1.5,102,7.5,-110,-110,-267,-1.5,-122,2.29,Nationals Park,10,-2
2016-09-06,2016,LAD,ARI,5,2,-190,-1.5,105,8.0,-120,100,170,1.5,-125,5.24,Dodger Stadium,7,3
2016-09-06,2016,WSH,ATL,9,7,-230,-1.5,-115,9.0,-120,100,200,1.5,-105,6.27,Nationals Park,16,2
2016-09-06,2016,TB,BAL,2,11,-134,-1.5,150,8.0,-117,-103,119,1.5,-170,4.58,Tropicana Field,13,-9
2016-09-06,2016,SD,BOS,1,5,175,1.5,100,8.5,100,-120,-195,-1.5,-120,3.09,PETCO Park,6,-4
2016-09-06,2016,MIL,CHC,12,5,153,1.5,-115,9.0,-115,-105,-168,-1.5,-105,3.56,Miller Park,17,7
2016-09-06,2016,NYM,CIN,5,3,110,1.5,-180,9.0,-120,100,-120,-1.5,160,4.29,Great American Ballpark,8,2
2016-09-06,2016,HOU,CLE,4,3,175,1.5,-115,8.5,-110,-110,-205,-1.5,-105,3.09,Progressive Field,7,1
2016-09-06,2016,SF,COL,3,2,145,1.5,-135,11.0,105,-125,-160,-1.5,115,4.49,Coors Field,5,1
2016-09-06,2016,DET,CWS,0,2,-123,-1.5,135,9.5,-120,100,113,1.5,-155,5.24,Guaranteed Rate Field,2,-2
2016-09-06,2016,CWS,DET,2,0,113,1.5,-155,9.5,-120,100,-123,-1.5,135,4.46,Guaranteed Rate Field,2,2
2016-09-06,2016,CLE,HOU,3,4,-205,-1.5,-105,8.5,-110,-110,175,1.5,-115,5.71,Progressive Field,7,-1
2016-09-06,2016,MIN,KC,3,10,-122,-1.5,155,9.0,100,-120,112,1.5,-175,4.95,Target Field,13,-7
2016-09-06,2016,OAK,LAA,3,2,-101,1.5,-160,9.0,-125,105,-109,-1.5,140,4.52,Oakland Coliseum,5,1
2016-09-06,2016,ARI,LAD,2,5,170,1.5,-125,8.0,-120,100,-190,-1.5,105,2.96,Dodger Stadium,7,-3
2016-09-06,2016,PHI,MIA,4,3,125,1.5,-175,8.0,-105,-115,-140,-1.5,155,3.56,Marlins Park,7,1
2016-09-06,2016,CHC,MIL,5,12,-168,-1.5,-105,9.0,-115,-105,153,1.5,-115,5.64,Miller Park,17,-7
2016-09-06,2016,KC,MIN,10,3,112,1.5,-175,9.0,100,-120,-122,-1.5,155,4.25,Target Field,13,7
2016-09-06,2016,CIN,NYM,3,5,-120,-1.5,160,9.0,-120,100,110,1.5,-180,4.91,Great American Ballpark,8,-2
2016-09-06,2016,TOR,NYY,6,7,-161,-1.5,-105,9.0,-120,100,146,1.5,-115,5.55,Yankee Stadium,13,-1
2016-09-06,2016,LAA,OAK,2,3,-109,-1.5,140,9.0,-125,105,-101,1.5,-160,4.69,Oakland Coliseum,5,-1
2016-09-06,2016,MIA,PHI,3,4,-140,-1.5,155,8.0,-105,-115,125,1.5,-175,4.67,Marlins Park,7,-1
2016-09-06,2016,STL,PIT,9,7,-117,-1.5,145,8.5,-120,100,107,1.5,-165,4.58,PNC Park,16,2
2016-09-06,2016,BOS,SD,5,1,-195,-1.5,-120,8.5,100,-120,175,1.5,100,5.62,PETCO Park,6,4
2016-09-06,2016,TEX,SEA,10,7,140,1.5,-155,8.5,-105,-115,-155,-1.5,135,3.54,T-Mobile Park,17,3
2016-09-06,2016,COL,SF,2,3,-160,-1.5,115,11.0,105,-125,145,1.5,-135,6.77,Coors Field,5,-1
2016-09-06,2016,PIT,STL,7,9,107,1.5,-165,8.5,-120,100,-117,-1.5,145,4.11,PNC Park,16,-2
2016-09-06,2016,BAL,TB,11,2,119,1.5,-170,8.0,-117,-103,-134,-1.5,150,3.65,Tropicana Field,13,9
2016-09-06,2016,SEA,TEX,7,10,-155,-1.5,135,8.5,-105,-115,140,1.5,-155,5.17,T-Mobile Park,17,-3
2016-09-06,2016,NYY,TOR,7,6,146,1.5,-115,9.0,-120,100,-161,-1.5,-105,3.66,Yankee Stadium,13,1
2016-09-06,2016,ATL,WSH,7,9,200,1.5,-105,9.0,-120,100,-230,-1.5,-115,3.0,Nationals Park,16,-2
2016-09-07,2016,LAD,ARI,3,1,-126,-1.5,175,7.5,-104,-116,116,1.5,-205,4.18,Dodger Stadium,4,2
2016-09-07,2016,WSH,ATL,5,4,-230,-1.5,-105,8.5,-105,-115,200,1.5,-115,5.92,Nationals Park,9,1
2016-09-07,2016,TB,BAL,7,6,112,1.5,-155,7.5,-115,-105,-122,-1.5,135,3.54,Tropicana Field,13,1
2016-09-07,2016,SD,BOS,2,7,201,1.5,116,7.5,100,-120,-241,-1.5,-136,2.49,PETCO Park,9,-5
2016-09-07,2016,MIL,CHC,2,1,155,1.5,-109,9.5,-115,-105,-175,-1.5,-111,3.73,Miller Park,3,1
2016-09-07,2016,NYM,CIN,6,3,-161,-1.5,-104,7.5,-105,-115,146,1.5,-116,4.63,Great American Ballpark,9,3
2016-09-07,2016,HOU,CLE,5,6,161,1.5,-130,8.5,-115,-105,-181,-1.5,110,3.26,Progressive Field,11,-1
2016-09-07,2016,SF,COL,5,6,-119,-1.5,125,11.5,-115,-105,109,1.5,-145,6.25,Coors Field,11,-1
2016-09-07,2016,DET,CWS,4,7,116,1.5,-175,9.0,-115,-105,-126,-1.5,155,4.17,Guaranteed Rate Field,11,-3
2016-09-07,2016,CWS,DET,7,4,-126,-1.5,155,9.0,-115,-105,116,1.5,-175,5.02,Guaranteed Rate Field,11,3
2016-09-07,2016,CLE,HOU,6,5,-181,-1.5,110,8.5,-115,-105,161,1.5,-130,5.48,Progressive Field,11,1
2016-09-07,2016,MIN,KC,6,5,142,1.5,-133,8.5,-105,-115,-157,-1.5,113,3.51,Target Field,11,1
2016-09-07,2016,OAK,LAA,4,1,-149,-1.5,130,8.5,-109,-111,134,1.5,-150,5.09,Oakland Coliseum,5,3
2016-09-07,2016,ARI,LAD,1,3,116,1.5,-205,7.5,-104,-116,-126,-1.5,175,3.47,Dodger Stadium,4,-2
2016-09-07,2016,PHI,MIA,0,6,118,1.5,-185,8.0,-105,-115,-133,-1.5,165,3.67,Marlins Park,6,-6
2016-09-07,2016,CHC,MIL,1,2,-175,-1.5,-111,9.5,-115,-105,155,1.5,-109,6.05,Miller Park,3,-1
2016-09-07,2016,KC,MIN,5,6,-157,-1.5,113,8.5,-105,-115,142,1.5,-133,5.19,Target Field,11,-1
2016-09-07,2016,CIN,NYM,3,6,146,1.5,-116,7.5,-105,-115,-161,-1.5,-104,3.05,Great American Ballpark,9,-3
2016-09-07,2016,TOR,NYY,0,2,-176,-1.5,-117,9.0,-125,105,156,1.5,-103,5.74,Yankee Stadium,2,-2
2016-09-07,2016,LAA,OAK,1,4,134,1.5,-150,8.5,-109,-111,-149,-1.5,130,3.63,Oakland Coliseum,5,-3
2016-09-07,2016,MIA,PHI,6,0,-133,-1.5,165,8.0,-105,-115,118,1.5,-185,4.57,Marlins Park,6,6
2016-09-07,2016,STL,PIT,3,4,111,1.5,-200,8.5,-115,-105,-121,-1.5,170,4.03,PNC Park,7,-1
2016-09-07,2016,BOS,SD,7,2,-241,-1.5,-136,7.5,100,-120,201,1.5,116,5.3,PETCO Park,9,5
2016-09-07,2016,TEX,SEA,3,8,106,1.5,-200,9.0,-105,-115,-116,-1.5,170,4.37,T-Mobile Park,11,-5
2016-09-07,2016,COL,SF,6,5,109,1.5,-145,11.5,-115,-105,-119,-1.5,125,5.5,Coors Field,11,1
2016-09-07,2016,PIT,STL,4,3,-121,-1.5,170,8.5,-115,-105,111,1.5,-200,4.65,PNC Park,7,1
2016-09-07,2016,BAL,TB,6,7,-122,-1.5,135,7.5,-115,-105,112,1.5,-155,4.12,Tropicana Field,13,-1
2016-09-07,2016,SEA,TEX,8,3,-116,-1.5,170,9.0,-105,-115,106,1.5,-200,4.83,T-Mobile Park,11,5
2016-09-07,2016,NYY,TOR,2,0,156,1.5,-103,9.0,-125,105,-176,-1.5,-117,3.52,Yankee Stadium,2,2
2016-09-07,2016,ATL,WSH,4,5,200,1.5,-115,8.5,-105,-115,-230,-1.5,-105,2.83,Nationals Park,9,-1
2016-09-08,2016,PIT,CIN,4,1,-173,-1.5,125,8.5,-115,-105,153,1.5,-145,5.39,PNC Park,5,3
2016-09-08,2016,HOU,CLE,7,10,125,1.5,-165,9.0,-120,100,-140,-1.5,145,4.0,Progressive Field,17,-3
2016-09-08,2016,SD,COL,14,1,-129,-1.5,160,8.0,-115,-105,119,1.5,-180,4.51,PETCO Park,15,13
2016-09-08,2016,CLE,HOU,10,7,-140,-1.5,145,9.0,-120,100,125,1.5,-165,5.25,Progressive Field,17,3
2016-09-08,2016,STL,MIL,5,12,-156,-1.5,135,8.0,-120,100,141,1.5,-155,4.88,Busch Stadium,17,-7
2016-09-08,2016,TB,NYY,4,5,119,1.5,-185,8.5,-115,-105,-129,-1.5,165,3.88,Yankee Stadium,9,-1
2016-09-08,2016,WSH,PHI,1,4,-210,-1.5,-109,9.5,-110,-110,180,1.5,-111,6.44,Nationals Park,5,-3
2016-09-08,2016,CIN,PIT,1,4,153,1.5,-145,8.5,-115,-105,-173,-1.5,125,3.36,PNC Park,5,-3
2016-09-08,2016,COL,SD,1,14,119,1.5,-180,8.0,-115,-105,-129,-1.5,160,3.65,PETCO Park,15,-13
2016-09-08,2016,TEX,SEA,3,6,119,1.5,-175,8.5,-126,106,-134,-1.5,155,3.88,T-Mobile Park,9,-3
2016-09-08,2016,MIL,STL,12,5,141,1.5,-155,8.0,-120,100,-156,-1.5,135,3.32,Busch Stadium,17,7
2016-09-08,2016,NYY,TB,5,4,-129,-1.5,165,8.5,-115,-105,119,1.5,-185,4.79,Yankee Stadium,9,1
2016-09-08,2016,SEA,TEX,6,3,-134,-1.5,155,8.5,-126,106,119,1.5,-175,4.87,T-Mobile Park,9,3
2016-09-08,2016,PHI,WSH,4,1,180,1.5,-111,9.5,-110,-110,-210,-1.5,-109,3.39,Nationals Park,5,3
2016-09-09,2016,SF,ARI,7,6,-205,-1.5,-128,9.5,100,-120,175,1.5,108,6.39,Chase Field,13,1
2016-09-09,2016,NYM,ATL,6,4,116,1.5,-205,8.5,-120,100,-126,-1.5,175,3.94,Turner Field,10,2
2016-09-09,2016,DET,BAL,4,3,-103,1.5,-170,8.5,-120,100,-107,-1.5,150,4.31,Comerica Park,7,1
2016-09-09,2016,TOR,BOS,3,13,-101,1.5,-165,9.0,-120,100,-109,-1.5,145,4.52,Rogers Centre,16,-10
2016-09-09,2016,HOU,CHC,0,2,129,1.5,-137,8.0,-105,-115,-144,-1.5,116,3.49,Minute Maid Park,2,-2
2016-09-09,2016,PIT,CIN,3,4,-161,-1.5,130,9.0,-115,-105,146,1.5,-150,5.55,PNC Park,7,-1
2016-09-09,2016,MIN,CLE,4,5,142,1.5,-114,8.5,-120,100,-157,-1.5,-106,3.51,Target Field,9,-1
2016-09-09,2016,SD,COL,1,4,103,1.5,-155,8.0,-120,100,-113,-1.5,135,3.94,PETCO Park,5,-3
2016-09-09,2016,KC,CWS,2,7,108,1.5,-205,7.5,-110,-110,-118,-1.5,175,3.61,Guaranteed Rate Field,9,-5
2016-09-09,2016,BAL,DET,3,4,-107,-1.5,150,8.5,-120,100,-103,1.5,-170,4.39,Comerica Park,7,-1
2016-09-09,2016,CHC,HOU,2,0,-144,-1.5,116,8.0,-105,-115,129,1.5,-137,4.72,Minute Maid Park,2,2
2016-09-09,2016,CWS,KC,7,2,-118,-1.5,175,7.5,-110,-110,108,1.5,-205,4.06,Guaranteed Rate Field,9,5
2016-09-09,2016,TEX,LAA,2,1,-134,-1.5,120,7.5,-120,100,119,1.5,-140,4.29,Angel Stadium,3,1
2016-09-09,2016,MIA,LAD,4,1,148,1.5,-120,6.0,-110,-110,-163,-1.5,100,2.42,Marlins Park,5,3
2016-09-09,2016,LAD,MIA,1,4,-163,-1.5,100,6.0,-110,-110,148,1.5,-120,3.72,Marlins Park,5,-3
2016-09-09,2016,STL,MIL,4,3,-265,-1.5,-120,8.0,-120,100,225,1.5,100,5.81,Busch Stadium,7,1
2016-09-09,2016,CLE,MIN,5,4,-157,-1.5,-106,8.5,-120,100,142,1.5,-114,5.19,Target Field,9,1
2016-09-09,2016,ATL,NYM,4,6,-126,-1.5,175,8.5,-120,100,116,1.5,-205,4.74,Turner Field,10,-2
2016-09-09,2016,TB,NYY,5,7,154,1.5,-139,8.5,-121,101,-174,-1.5,119,3.35,Yankee Stadium,12,-2
2016-09-09,2016,SEA,OAK,3,2,-142,-1.5,115,8.5,100,-120,127,1.5,-135,4.99,Oakland Coliseum,5,1
2016-09-09,2016,WSH,PHI,5,4,-275,-1.5,-148,9.0,-120,100,235,1.5,128,6.6,Nationals Park,9,1
2016-09-09,2016,CIN,PIT,4,3,146,1.5,-150,9.0,-115,-105,-161,-1.5,130,3.66,PNC Park,7,1
2016-09-09,2016,COL,SD,4,1,-113,-1.5,135,8.0,-120,100,103,1.5,-155,4.24,PETCO Park,5,3
2016-09-09,2016,OAK,SEA,2,3,127,1.5,-135,8.5,100,-120,-142,-1.5,115,3.74,Oakland Coliseum,5,-1
2016-09-09,2016,ARI,SF,6,7,175,1.5,108,9.5,100,-120,-205,-1.5,-128,3.45,Chase Field,13,-1
2016-09-09,2016,MIL,STL,3,4,225,1.5,100,8.0,-120,100,-265,-1.5,-120,2.46,Busch Stadium,7,-1
2016-09-09,2016,NYY,TB,7,5,-174,-1.5,119,8.5,-121,101,154,1.5,-139,5.4,Yankee Stadium,12,2
2016-09-09,2016,LAA,TEX,1,2,119,1.5,-140,7.5,-120,100,-134,-1.5,120,3.42,Angel Stadium,3,-1
2016-09-09,2016,BOS,TOR,13,3,-109,-1.5,145,9.0,-120,100,-101,1.5,-165,4.69,Rogers Centre,16,10
2016-09-09,2016,PHI,WSH,4,5,235,1.5,128,9.0,-120,100,-275,-1.5,-148,2.69,Nationals Park,9,-1
2016-09-10,2016,SF,ARI,11,3,-186,-1.5,-129,9.0,-105,-115,166,1.5,109,5.85,Chase Field,14,8
2016-09-10,2016,NYM,ATL,3,4,-130,-1.5,120,9.0,103,-123,115,1.5,-140,5.09,Turner Field,7,-1
2016-09-10,2016,DET,BAL,3,11,-124,-1.5,155,10.0,-119,-101,114,1.5,-175,5.54,Comerica Park,14,-8
2016-09-10,2016,TOR,BOS,3,2,-156,-1.5,130,9.5,-115,-105,141,1.5,-150,5.79,Rogers Centre,5,1
2016-09-10,2016,HOU,CHC,2,1,-110,-1.5,185,7.5,-115,-105,100,1.5,-215,3.93,Minute Maid Park,3,1
2016-09-10,2016,PIT,CIN,7,8,-170,-1.5,120,9.0,-105,-115,150,1.5,-140,5.67,PNC Park,15,-1
2016-09-10,2016,MIN,CLE,2,1,119,1.5,-140,9.5,-105,-115,-134,-1.5,120,4.34,Target Field,3,1
2016-09-10,2016,SD,COL,6,3,113,1.5,-155,8.0,-101,-119,-123,-1.5,135,3.76,PETCO Park,9,3
2016-09-10,2016,KC,CWS,6,5,-133,-1.5,106,9.5,100,-120,118,1.5,-126,5.42,Guaranteed Rate Field,11,1
2016-09-10,2016,BAL,DET,11,3,114,1.5,-175,10.0,-119,-101,-124,-1.5,155,4.67,Comerica Park,14,8
2016-09-10,2016,CHC,HOU,1,2,100,1.5,-215,7.5,-115,-105,-110,-1.5,185,3.75,Minute Maid Park,3,-1
2016-09-10,2016,CWS,KC,5,6,118,1.5,-126,9.5,100,-120,-133,-1.5,106,4.36,Guaranteed Rate Field,11,-1
2016-09-10,2016,TEX,LAA,8,5,-149,-1.5,101,9.0,100,-120,134,1.5,-121,5.39,Angel Stadium,13,3
2016-09-10,2016,MIA,LAD,0,5,185,1.5,111,7.5,-122,102,-215,-1.5,-131,2.63,Marlins Park,5,-5
2016-09-10,2016,LAD,MIA,5,0,-215,-1.5,-131,7.5,-122,102,185,1.5,111,5.12,Marlins Park,5,5
2016-09-10,2016,STL,MIL,5,1,-195,-1.5,109,8.5,-105,-115,175,1.5,-129,5.62,Busch Stadium,6,4
2016-09-10,2016,CLE,MIN,1,2,-134,-1.5,120,9.5,-105,-115,119,1.5,-140,5.44,Target Field,3,-1
2016-09-10,2016,ATL,NYM,4,3,115,1.5,-140,9.0,103,-123,-130,-1.5,120,4.19,Turner Field,7,1
2016-09-10,2016,TB,NYY,1,5,126,1.5,-170,8.0,-110,-110,-141,-1.5,150,3.54,Yankee Stadium,6,-4
2016-09-10,2016,SEA,OAK,14,3,-106,-1.5,151,8.0,-115,-105,-104,1.5,-172,4.12,Oakland Coliseum,17,11
2016-09-10,2016,WSH,PHI,3,0,-305,-1.5,-121,7.0,-120,100,255,1.5,101,5.27,Nationals Park,3,3
2016-09-10,2016,CIN,PIT,8,7,150,1.5,-140,9.0,-105,-115,-170,-1.5,120,3.6,PNC Park,15,1
2016-09-10,2016,COL,SD,3,6,-123,-1.5,135,8.0,-101,-119,113,1.5,-155,4.41,PETCO Park,9,-3
2016-09-10,2016,OAK,SEA,3,14,-104,1.5,-172,8.0,-115,-105,-106,-1.5,151,4.08,Oakland Coliseum,17,-11
2016-09-10,2016,ARI,SF,3,11,166,1.5,109,9.0,-105,-115,-186,-1.5,-129,3.38,Chase Field,14,-8
2016-09-10,2016,MIL,STL,1,5,175,1.5,-129,8.5,-105,-115,-195,-1.5,109,3.09,Busch Stadium,6,-4
2016-09-10,2016,NYY,TB,5,1,-141,-1.5,150,8.0,-110,-110,126,1.5,-170,4.68,Yankee Stadium,6,4
2016-09-10,2016,LAA,TEX,5,8,134,1.5,-121,9.0,100,-120,-149,-1.5,101,3.85,Angel Stadium,13,-3
2016-09-10,2016,BOS,TOR,2,3,141,1.5,-150,9.5,-115,-105,-156,-1.5,130,3.94,Rogers Centre,5,-1
2016-09-10,2016,PHI,WSH,0,3,255,1.5,101,7.0,-120,100,-305,-1.5,-121,1.97,Nationals Park,3,-3
2016-09-11,2016,SF,ARI,5,3,104,1.5,-200,9.5,100,-120,-114,-1.5,170,4.66,Chase Field,8,2
2016-09-11,2016,NYM,ATL,10,3,-132,-1.5,120,9.0,-110,-110,117,1.5,-140,5.12,Turner Field,13,7
2016-09-11,2016,DET,BAL,1,3,-163,-1.5,130,8.0,-115,-105,148,1.5,-150,4.96,Comerica Park,4,-2
2016-09-11,2016,TOR,BOS,8,11,-151,-1.5,140,9.0,-115,-105,136,1.5,-160,5.41,Rogers Centre,19,-3
2016-09-11,2016,HOU,CHC,5,9,128,1.5,-140,7.5,-112,-108,-143,-1.5,120,3.29,Minute Maid Park,14,-4
2016-09-11,2016,PIT,CIN,0,8,-149,-1.5,145,8.5,-120,100,134,1.5,-165,5.09,PNC Park,8,-8
2016-09-11,2016,MIN,CLE,1,7,185,1.5,115,8.5,-105,-115,-215,-1.5,-135,2.98,Target Field,8,-6
2016-09-11,2016,SD,COL,2,3,116,1.5,-140,9.0,100,-120,-131,-1.5,120,4.17,PETCO Park,5,-1
2016-09-11,2016,KC,CWS,2,0,146,1.5,-150,7.5,-105,-115,-161,-1.5,130,3.05,Guaranteed Rate Field,2,2
2016-09-11,2016,BAL,DET,3,1,148,1.5,-150,8.0,-115,-105,-163,-1.5,130,3.23,Comerica Park,4,2
2016-09-11,2016,CHC,HOU,9,5,-143,-1.5,120,7.5,-112,-108,128,1.5,-140,4.41,Minute Maid Park,14,4
2016-09-11,2016,CWS,KC,0,2,-161,-1.5,130,7.5,-105,-115,146,1.5,-150,4.63,Guaranteed Rate Field,2,-2
2016-09-11,2016,TEX,LAA,2,3,-112,-1.5,140,9.5,-115,-105,102,1.5,-160,5.02,Angel Stadium,5,-1
2016-09-11,2016,MIA,LAD,3,0,170,1.5,100,7.5,-110,-110,-200,-1.5,-120,2.78,Marlins Park,3,3
2016-09-11,2016,LAD,MIA,0,3,-200,-1.5,-120,7.5,-110,-110,170,1.5,100,5.0,Marlins Park,3,-3
2016-09-11,2016,STL,MIL,1,2,-174,-1.5,125,8.5,100,-120,154,1.5,-145,5.4,Busch Stadium,3,-1
2016-09-11,2016,CLE,MIN,7,1,-215,-1.5,-135,8.5,-105,-115,185,1.5,115,5.8,Target Field,8,6
2016-09-11,2016,ATL,NYM,3,10,117,1.5,-140,9.0,-110,-110,-132,-1.5,120,4.15,Turner Field,13,-7
2016-09-11,2016,TB,NYY,4,2,113,1.5,-200,10.0,-105,-115,-123,-1.5,170,4.69,Yankee Stadium,6,2
2016-09-11,2016,SEA,OAK,3,2,-155,-1.5,110,9.0,100,-120,140,1.5,-130,5.47,Oakland Coliseum,5,1
2016-09-11,2016,WSH,PHI,3,2,-235,-1.5,-119,8.5,-120,100,205,1.5,-101,5.96,Nationals Park,5,1
2016-09-11,2016,CIN,PIT,8,0,134,1.5,-165,8.5,-120,100,-149,-1.5,145,3.63,PNC Park,8,8
2016-09-11,2016,COL,SD,3,2,-131,-1.5,120,9.0,100,-120,116,1.5,-140,5.1,PETCO Park,5,1
2016-09-11,2016,OAK,SEA,2,3,140,1.5,-130,9.0,100,-120,-155,-1.5,110,3.75,Oakland Coliseum,5,-1
2016-09-11,2016,ARI,SF,3,5,-114,-1.5,170,9.5,100,-120,104,1.5,-200,5.06,Chase Field,8,-2
2016-09-11,2016,MIL,STL,2,1,154,1.5,-145,8.5,100,-120,-174,-1.5,125,3.35,Busch Stadium,3,1
2016-09-11,2016,NYY,TB,2,4,-123,-1.5,170,10.0,-105,-115,113,1.5,-200,5.52,Yankee Stadium,6,-2
2016-09-11,2016,LAA,TEX,3,2,102,1.5,-160,9.5,-115,-105,-112,-1.5,140,4.7,Angel Stadium,5,1
2016-09-11,2016,BOS,TOR,11,8,136,1.5,-160,9.0,-115,-105,-151,-1.5,140,3.81,Rogers Centre,19,3
2016-09-11,2016,PHI,WSH,2,3,205,1.5,-101,8.5,-120,100,-235,-1.5,-119,2.79,Nationals Park,5,-1
2016-09-12,2016,COL,ARI,9,12,-134,-1.5,111,10.0,100,-120,119,1.5,-131,5.73,Chase Field,21,-3
2016-09-12,2016,MIA,ATL,7,12,108,1.5,-205,8.5,-105,-115,-118,-1.5,175,4.09,Turner Field,19,-5
2016-09-12,2016,BOS,BAL,12,2,-205,-1.5,-110,9.5,-115,-105,175,1.5,-110,6.39,Fenway Park,14,10
2016-09-12,2016,BAL,BOS,2,12,175,1.5,-110,9.5,-115,-105,-205,-1.5,-110,3.45,Fenway Park,14,-10
2016-09-12,2016,STL,CHC,1,4,127,1.5,-135,7.5,-104,-116,-142,-1.5,115,3.3,Busch Stadium,5,-3
2016-09-12,2016,MIL,CIN,0,3,-103,1.5,-215,9.0,-115,-105,-107,-1.5,185,4.57,Great American Ballpark,3,-3
2016-09-12,2016,CWS,CLE,11,4,175,1.5,109,8.0,-120,100,-195,-1.5,-129,2.91,Guaranteed Rate Field,15,7
2016-09-12,2016,ARI,COL,12,9,119,1.5,-131,10.0,100,-120,-134,-1.5,111,4.57,Chase Field,21,3
2016-09-12,2016,CLE,CWS,4,11,-195,-1.5,-129,8.0,-120,100,175,1.5,109,5.29,Guaranteed Rate Field,15,-7
2016-09-12,2016,MIN,DET,2,4,122,1.5,-170,9.0,100,-120,-137,-1.5,150,4.05,Comerica Park,6,-2
2016-09-12,2016,TEX,HOU,4,3,119,1.5,-167,9.5,-110,-110,-134,-1.5,148,4.34,Minute Maid Park,7,1
2016-09-12,2016,OAK,KC,16,3,131,1.5,-159,9.0,-105,-115,-146,-1.5,139,3.9,Kauffman Stadium,19,13
2016-09-12,2016,SEA,LAA,8,1,106,1.5,-200,9.0,-120,100,-116,-1.5,170,4.37,Angel Stadium,9,7
2016-09-12,2016,NYY,LAD,2,8,140,1.5,-120,8.5,-115,-105,-155,-1.5,100,3.54,Yankee Stadium,10,-6
2016-09-12,2016,ATL,MIA,12,7,-118,-1.5,175,8.5,-105,-115,108,1.5,-205,4.6,Turner Field,19,5
2016-09-12,2016,CIN,MIL,3,0,-107,-1.5,185,9.0,-115,-105,-103,1.5,-215,4.65,Great American Ballpark,3,3
2016-09-12,2016,DET,MIN,4,2,-137,-1.5,150,9.0,100,-120,122,1.5,-170,5.2,Comerica Park,6,2
2016-09-12,2016,WSH,NYM,8,1,-131,-1.5,155,9.5,-111,-109,116,1.5,-175,5.39,Nationals Park,9,7
2016-09-12,2016,LAD,NYY,8,2,-155,-1.5,100,8.5,-115,-105,140,1.5,-120,5.17,Yankee Stadium,10,6
2016-09-12,2016,KC,OAK,3,16,-146,-1.5,139,9.0,-105,-115,131,1.5,-159,5.34,Kauffman Stadium,19,-13
2016-09-12,2016,PIT,PHI,2,6,-140,-1.5,125,7.5,-110,-110,125,1.5,-145,4.38,Citizens Bank Park,8,-4
2016-09-12,2016,PHI,PIT,6,2,125,1.5,-145,7.5,-110,-110,-140,-1.5,125,3.33,Citizens Bank Park,8,4
2016-09-12,2016,SF,SD,0,4,-305,-1.5,-146,8.5,-119,-101,255,1.5,126,6.4,AT&T Park,4,-4
2016-09-12,2016,LAA,SEA,1,8,-116,-1.5,170,9.0,-120,100,106,1.5,-200,4.83,Angel Stadium,9,-7
2016-09-12,2016,SD,SF,4,0,255,1.5,126,8.5,-119,-101,-305,-1.5,-146,2.39,AT&T Park,4,4
2016-09-12,2016,CHC,STL,4,1,-142,-1.5,115,7.5,-104,-116,127,1.5,-135,4.4,Busch Stadium,5,3
2016-09-12,2016,TOR,TB,3,2,-170,-1.5,116,9.0,100,-120,150,1.5,-136,5.67,Rogers Centre,5,1
2016-09-12,2016,HOU,TEX,3,4,-134,-1.5,148,9.5,-110,-110,119,1.5,-167,5.44,Minute Maid Park,7,-1
2016-09-12,2016,TB,TOR,2,3,150,1.5,-136,9.0,100,-120,-170,-1.5,116,3.6,Rogers Centre,5,-1
2016-09-12,2016,NYM,WSH,1,8,116,1.5,-175,9.5,-111,-109,-131,-1.5,155,4.4,Nationals Park,9,-7
2016-09-13,2016,COL,ARI,4,11,148,1.5,-140,10.0,-105,-115,-163,-1.5,120,4.03,Chase Field,15,-7
2016-09-13,2016,MIA,ATL,7,5,115,1.5,-185,9.0,-105,-115,-125,-1.5,165,4.19,Turner Field,12,2
2016-09-13,2016,BOS,BAL,3,6,-156,-1.5,125,10.0,-109,-111,141,1.5,-145,6.09,Fenway Park,9,-3
2016-09-13,2016,BAL,BOS,6,3,141,1.5,-145,10.0,-109,-111,-156,-1.5,125,4.15,Fenway Park,9,3
2016-09-13,2016,STL,CHC,4,2,-112,1.5,-180,8.5,-110,-110,102,-1.5,160,4.49,Busch Stadium,6,2
2016-09-13,2016,MIL,CIN,4,6,113,1.5,-180,9.0,-105,-115,-123,-1.5,160,4.23,Great American Ballpark,10,-2
2016-09-13,2016,CWS,CLE,8,1,-119,-1.5,170,8.0,100,-120,109,1.5,-200,4.35,Guaranteed Rate Field,9,7
2016-09-13,2016,ARI,COL,11,4,-163,-1.5,120,10.0,-105,-115,148,1.5,-140,6.2,Chase Field,15,7
2016-09-13,2016,CLE,CWS,1,8,109,1.5,-200,8.0,100,-120,-119,-1.5,170,3.83,Guaranteed Rate Field,9,-7
2016-09-13,2016,MIN,DET,8,1,149,1.5,-135,9.0,-120,100,-164,-1.5,115,3.61,Comerica Park,9,7
2016-09-13,2016,TEX,HOU,3,2,131,1.5,-155,9.0,-105,-115,-146,-1.5,135,3.9,Minute Maid Park,5,1
2016-09-13,2016,OAK,KC,5,4,150,1.5,-150,8.0,-105,-115,-170,-1.5,130,3.2,Kauffman Stadium,9,1
2016-09-13,2016,SEA,LAA,8,0,-130,-1.5,130,9.0,-105,-115,115,1.5,-150,5.09,Angel Stadium,8,8
2016-09-13,2016,NYY,LAD,3,0,-104,1.5,-170,8.0,-115,-105,-106,-1.5,150,4.08,Yankee Stadium,3,3
2016-09-13,2016,ATL,MIA,5,7,-125,-1.5,165,9.0,-105,-115,115,1.5,-185,5.0,Turner Field,12,-2
2016-09-13,2016,CIN,MIL,6,4,-123,-1.5,160,9.0,-105,-115,113,1.5,-180,4.96,Great American Ballpark,10,2
2016-09-13,2016,DET,MIN,1,8,-164,-1.5,115,9.0,-120,100,149,1.5,-135,5.59,Comerica Park,9,-7
2016-09-13,2016,WSH,NYM,3,4,105,1.5,-170,8.0,-105,-115,-115,-1.5,150,3.9,Nationals Park,7,-1
2016-09-13,2016,LAD,NYY,0,3,-106,-1.5,150,8.0,-115,-105,-104,1.5,-170,4.12,Yankee Stadium,3,-3
2016-09-13,2016,KC,OAK,4,5,-170,-1.5,130,8.0,-105,-115,150,1.5,-150,5.04,Kauffman Stadium,9,-1
2016-09-13,2016,PIT,PHI,5,3,-151,-1.5,105,9.0,-110,-110,136,1.5,-125,5.41,Citizens Bank Park,8,2
2016-09-13,2016,PHI,PIT,3,5,136,1.5,-125,9.0,-110,-110,-151,-1.5,105,3.81,Citizens Bank Park,8,-2
2016-09-13,2016,SF,SD,4,6,-150,-1.5,145,8.0,-103,-117,135,1.5,-165,4.8,AT&T Park,10,-2
2016-09-13,2016,LAA,SEA,0,8,115,1.5,-150,9.0,-105,-115,-130,-1.5,130,4.19,Angel Stadium,8,-8
2016-09-13,2016,SD,SF,6,4,135,1.5,-165,8.0,-103,-117,-150,-1.5,145,3.4,AT&T Park,10,2
2016-09-13,2016,CHC,STL,2,4,102,-1.5,160,8.5,-110,-110,-112,1.5,-180,4.21,Busch Stadium,6,-2
2016-09-13,2016,TOR,TB,2,6,-175,-1.5,105,9.0,105,-125,155,1.5,-125,5.73,Rogers Centre,8,-4
2016-09-13,2016,HOU,TEX,2,3,-146,-1.5,135,9.0,-105,-115,131,1.5,-155,5.34,Minute Maid Park,5,-1
2016-09-13,2016,TB,TOR,6,2,155,1.5,-125,9.0,105,-125,-175,-1.5,105,3.53,Rogers Centre,8,4
2016-09-13,2016,NYM,WSH,4,3,-115,-1.5,150,8.0,-105,-115,105,1.5,-170,4.28,Nationals Park,7,1
2016-09-14,2016,COL,ARI,6,11,115,1.5,-170,10.5,-105,-115,-130,-1.5,150,4.88,Chase Field,17,-5
2016-09-14,2016,MIA,ATL,7,5,-145,-1.5,115,7.0,-115,-105,130,1.5,-135,4.14,Turner Field,12,2
2016-09-14,2016,BOS,BAL,0,1,-157,-1.5,130,9.5,-107,-113,142,1.5,-150,5.8,Fenway Park,1,-1
2016-09-14,2016,BAL,BOS,1,0,142,1.5,-150,9.5,-107,-113,-157,-1.5,130,3.93,Fenway Park,1,1
2016-09-14,2016,STL,CHC,0,7,119,1.5,-150,7.0,-120,100,-134,-1.5,130,3.2,Busch Stadium,7,-7
2016-09-14,2016,MIL,CIN,7,0,106,1.5,-205,9.0,-110,-110,-116,-1.5,175,4.37,Great American Ballpark,7,7
2016-09-14,2016,CWS,CLE,1,6,104,1.5,-159,8.5,-110,-110,-114,-1.5,139,4.17,Guaranteed Rate Field,7,-5
2016-09-14,2016,ARI,COL,11,6,-130,-1.5,150,10.5,-105,-115,115,1.5,-170,5.93,Chase Field,17,5
2016-09-14,2016,CLE,CWS,6,1,-114,-1.5,139,8.5,-110,-110,104,1.5,-159,4.53,Guaranteed Rate Field,7,5
2016-09-14,2016,MIN,DET,6,9,155,1.5,-135,9.0,-108,-112,-175,-1.5,115,3.53,Comerica Park,15,-3
2016-09-14,2016,TEX,HOU,4,8,151,1.5,-141,8.5,-115,-105,-171,-1.5,121,3.39,Minute Maid Park,12,-4
2016-09-14,2016,OAK,KC,8,0,112,1.5,-205,7.5,-110,-110,-122,-1.5,175,3.54,Kauffman Stadium,8,8
2016-09-14,2016,SEA,LAA,2,1,-157,-1.5,-103,8.5,-105,-115,142,1.5,-117,5.19,Angel Stadium,3,1
2016-09-14,2016,NYY,LAD,0,2,151,1.5,-110,7.0,-125,105,-171,-1.5,-110,2.79,Yankee Stadium,2,-2
2016-09-14,2016,ATL,MIA,5,7,130,1.5,-135,7.0,-115,-105,-145,-1.5,115,3.04,Turner Field,12,-2
2016-09-14,2016,CIN,MIL,0,7,-116,-1.5,175,9.0,-110,-110,106,1.5,-205,4.83,Great American Ballpark,7,-7
2016-09-14,2016,DET,MIN,9,6,-175,-1.5,115,9.0,-108,-112,155,1.5,-135,5.73,Comerica Park,15,3
2016-09-14,2016,WSH,NYM,1,0,-185,-1.5,110,9.0,-110,-110,165,1.5,-130,5.84,Nationals Park,1,1
2016-09-14,2016,LAD,NYY,2,0,-171,-1.5,-110,7.0,-125,105,151,1.5,-110,4.42,Yankee Stadium,2,2
2016-09-14,2016,KC,OAK,0,8,-122,-1.5,175,7.5,-110,-110,112,1.5,-205,4.12,Kauffman Stadium,8,-8
2016-09-14,2016,PIT,PHI,2,6,-111,-1.5,145,9.0,-120,100,101,1.5,-165,4.73,Citizens Bank Park,8,-4
2016-09-14,2016,PHI,PIT,6,2,101,1.5,-165,9.0,-120,100,-111,-1.5,145,4.48,Citizens Bank Park,8,4
2016-09-14,2016,SF,SD,1,3,-265,-1.5,-127,7.5,-105,-115,225,1.5,107,5.45,AT&T Park,4,-2
2016-09-14,2016,LAA,SEA,1,2,142,1.5,-117,8.5,-105,-115,-157,-1.5,-103,3.51,Angel Stadium,3,-1
2016-09-14,2016,SD,SF,3,1,225,1.5,107,7.5,-105,-115,-265,-1.5,-127,2.31,AT&T Park,4,2
2016-09-14,2016,CHC,STL,7,0,-134,-1.5,130,7.0,-120,100,119,1.5,-150,4.01,Busch Stadium,7,7
2016-09-14,2016,TOR,TB,1,8,-143,-1.5,141,8.5,-121,101,128,1.5,-161,5.0,Rogers Centre,9,-7
2016-09-14,2016,HOU,TEX,8,4,-171,-1.5,121,8.5,-115,-105,151,1.5,-141,5.36,Minute Maid Park,12,4
2016-09-14,2016,TB,TOR,8,1,128,1.5,-161,8.5,-121,101,-143,-1.5,141,3.73,Rogers Centre,9,7
2016-09-14,2016,NYM,WSH,0,1,165,1.5,-130,9.0,-110,-110,-185,-1.5,110,3.4,Nationals Park,1,-1
2016-09-15,2016,LAD,ARI,3,7,-220,-1.5,-139,10.0,-105,-115,190,1.5,119,6.88,Chase Field,10,-4
2016-09-15,2016,TB,BAL,7,6,110,1.5,-180,9.0,-120,100,-120,-1.5,160,4.29,Camden Yards,13,1
2016-09-15,2016,NYY,BOS,5,7,118,1.5,-185,8.0,-117,-103,-128,-1.5,165,3.67,Fenway Park,12,-2
2016-09-15,2016,MIL,CHC,5,4,190,1.5,-106,9.0,-110,-110,-220,-1.5,-114,3.1,Wrigley Field,9,1
2016-09-15,2016,CWS,CLE,2,1,127,1.5,-135,9.5,-105,-115,-142,-1.5,115,4.19,Guaranteed Rate Field,3,1
2016-09-15,2016,CLE,CWS,1,2,-142,-1.5,115,9.5,-105,-115,127,1.5,-135,5.57,Guaranteed Rate Field,3,-1
2016-09-15,2016,MIN,DET,5,1,135,1.5,-145,9.5,-114,-106,-150,-1.5,125,4.04,Comerica Park,6,4
2016-09-15,2016,OAK,KC,14,5,134,1.5,-155,9.0,-105,-115,-149,-1.5,135,3.85,Kauffman Stadium,19,9
2016-09-15,2016,TOR,LAA,7,2,-170,-1.5,-114,9.0,101,-121,150,1.5,-105,5.67,Angel Stadium,9,5
2016-09-15,2016,ARI,LAD,7,3,190,1.5,119,10.0,-105,-115,-220,-1.5,-139,3.45,Chase Field,10,4
2016-09-15,2016,CHC,MIL,4,5,-220,-1.5,-114,9.0,-110,-110,190,1.5,-106,6.19,Wrigley Field,9,-1
2016-09-15,2016,DET,MIN,1,5,-150,-1.5,125,9.5,-114,-106,135,1.5,-145,5.7,Comerica Park,6,-4
2016-09-15,2016,BOS,NYY,7,5,-128,-1.5,165,8.0,-117,-103,118,1.5,-185,4.49,Fenway Park,12,2
2016-09-15,2016,KC,OAK,5,14,-149,-1.5,135,9.0,-105,-115,134,1.5,-155,5.39,Kauffman Stadium,19,-9
2016-09-15,2016,PIT,PHI,15,2,112,1.5,-200,8.0,-112,-108,-122,-1.5,170,3.77,Citizens Bank Park,17,13
2016-09-15,2016,PHI,PIT,2,15,-122,-1.5,170,8.0,-112,-108,112,1.5,-200,4.4,Citizens Bank Park,17,-13
2016-09-15,2016,STL,SF,2,6,145,1.5,-167,7.0,-110,-110,-160,-1.5,148,2.86,AT&T Park,8,-4
2016-09-15,2016,SF,STL,6,2,-160,-1.5,148,7.0,-110,-110,145,1.5,-167,4.31,AT&T Park,8,4
2016-09-15,2016,BAL,TB,6,7,-120,-1.5,160,9.0,-120,100,110,1.5,-180,4.91,Camden Yards,13,-1
2016-09-15,2016,LAA,TOR,2,7,150,1.5,-105,9.0,101,-121,-170,-1.5,-114,3.6,Angel Stadium,9,-5
2016-09-16,2016,LAD,ARI,3,2,-141,-1.5,114,9.0,-115,-105,126,1.5,-134,5.27,Chase Field,5,1
2016-09-16,2016,WSH,ATL,7,2,-265,-1.5,-146,7.5,-105,-115,225,1.5,126,5.45,Turner Field,9,5
2016-09-16,2016,TB,BAL,4,5,-104,-1.5,151,9.0,-104,-116,-106,1.5,-171,4.59,Camden Yards,9,-1
2016-09-16,2016,NYY,BOS,4,7,153,1.5,-140,10.0,-119,-101,-173,-1.5,120,3.95,Fenway Park,11,-3
2016-09-16,2016,MIL,CHC,4,5,148,1.5,-140,9.0,-105,-115,-163,-1.5,120,3.63,Wrigley Field,9,-1
2016-09-16,2016,PIT,CIN,9,7,-119,-1.5,134,10.0,-110,-110,109,1.5,-154,5.43,Great American Ballpark,16,2
2016-09-16,2016,DET,CLE,4,11,165,1.5,-126,8.0,100,-120,-185,-1.5,106,3.02,Progressive Field,15,-7
2016-09-16,2016,SD,COL,7,8,144,1.5,-132,12.5,-105,-115,-159,-1.5,112,5.12,Coors Field,15,-1
2016-09-16,2016,KC,CWS,4,7,117,1.5,-155,7.0,-121,101,-127,-1.5,135,3.23,Kauffman Stadium,11,-3
2016-09-16,2016,CLE,DET,11,4,-185,-1.5,106,8.0,100,-120,165,1.5,-126,5.19,Progressive Field,15,7
2016-09-16,2016,SEA,HOU,0,6,-131,-1.5,165,8.0,-105,-115,116,1.5,-185,4.54,T-Mobile Park,6,-6
2016-09-16,2016,CWS,KC,7,4,-127,-1.5,135,7.0,-121,101,117,1.5,-155,3.92,Kauffman Stadium,11,3
2016-09-16,2016,TOR,LAA,5,0,-145,-1.5,108,9.0,-118,-102,130,1.5,-128,5.33,Angel Stadium,5,5
2016-09-16,2016,ARI,LAD,2,3,126,1.5,-134,9.0,-115,-105,-141,-1.5,114,3.98,Chase Field,5,-1
2016-09-16,2016,PHI,MIA,4,3,126,1.5,-135,8.5,-111,-109,-141,-1.5,115,3.76,Citizens Bank Park,7,1
2016-09-16,2016,CHC,MIL,5,4,-163,-1.5,120,9.0,-105,-115,148,1.5,-140,5.58,Wrigley Field,9,1
2016-09-16,2016,NYM,MIN,3,0,-174,-1.5,120,8.5,100,-120,154,1.5,-140,5.4,Citi Field,3,3
2016-09-16,2016,MIN,NYM,0,3,154,1.5,-140,8.5,100,-120,-174,-1.5,120,3.35,Citi Field,3,-3
2016-09-16,2016,BOS,NYY,7,4,-173,-1.5,120,10.0,-119,-101,153,1.5,-140,6.34,Fenway Park,11,3
2016-09-16,2016,TEX,OAK,7,6,-201,-1.5,-101,9.0,-120,100,171,1.5,-119,6.01,Rangers Ballpark,13,1
2016-09-16,2016,MIA,PHI,3,4,-141,-1.5,115,8.5,-111,-109,126,1.5,-135,4.97,Citizens Bank Park,7,-1
2016-09-16,2016,CIN,PIT,7,9,109,1.5,-154,10.0,-110,-110,-119,-1.5,134,4.78,Great American Ballpark,16,-2
2016-09-16,2016,COL,SD,8,7,-159,-1.5,112,12.5,-105,-115,144,1.5,-132,7.67,Coors Field,15,1
2016-09-16,2016,HOU,SEA,6,0,116,1.5,-185,8.0,-105,-115,-131,-1.5,165,3.7,T-Mobile Park,6,6
2016-09-16,2016,STL,SF,2,8,105,1.5,-210,7.5,-120,100,-115,-1.5,180,3.66,AT&T Park,10,-6
2016-09-16,2016,SF,STL,8,2,-115,-1.5,180,7.5,-120,100,105,1.5,-210,4.01,AT&T Park,10,6
2016-09-16,2016,BAL,TB,5,4,-106,1.5,-171,9.0,-104,-116,-104,-1.5,151,4.63,Camden Yards,9,1
2016-09-16,2016,OAK,TEX,6,7,171,1.5,-119,9.0,-120,100,-201,-1.5,-101,3.32,Rangers Ballpark,13,-1
2016-09-16,2016,LAA,TOR,0,5,130,1.5,-128,9.0,-118,-102,-145,-1.5,108,3.91,Angel Stadium,5,-5
2016-09-16,2016,ATL,WSH,2,7,225,1.5,126,7.5,-105,-115,-265,-1.5,-146,2.31,Turner Field,9,-5
2016-09-17,2016,LAD,ARI,6,2,-154,-1.5,105,11.0,100,-120,139,1.5,-125,6.67,Chase Field,8,4
2016-09-17,2016,WSH,ATL,3,7,-164,-1.5,-105,9.0,-115,-105,149,1.5,-115,5.59,Turner Field,10,-4
2016-09-17,2016,TB,BAL,5,2,125,1.5,-155,9.0,-120,100,-140,-1.5,135,4.0,Camden Yards,7,3
2016-09-17,2016,NYY,BOS,5,6,222,1.5,114,9.5,-110,-110,-262,-1.5,-134,2.95,Fenway Park,11,-1
2016-09-17,2016,MIL,CHC,11,3,178,1.5,-126,8.5,-110,-110,-208,-1.5,106,3.06,Wrigley Field,14,8
2016-09-17,2016,PIT,CIN,10,4,-113,-1.5,135,8.5,-110,-110,103,1.5,-155,4.51,Great American Ballpark,14,6
2016-09-17,2016,PIT,CIN,7,3,-116,-1.5,140,9.0,-113,-107,106,1.5,-160,4.83,Great American Ballpark,10,4
2016-09-17,2016,DET,CLE,0,1,119,1.5,-167,8.0,100,-120,-134,-1.5,148,3.65,Progressive Field,1,-1
2016-09-17,2016,SD,COL,0,8,170,1.5,100,12.5,-105,-115,-200,-1.5,-120,4.63,Coors Field,8,-8
2016-09-17,2016,KC,CWS,3,2,-128,-1.5,144,9.0,100,-120,118,1.5,-163,5.05,Kauffman Stadium,5,1
2016-09-17,2016,CLE,DET,1,0,-134,-1.5,148,8.0,100,-120,119,1.5,-167,4.58,Progressive Field,1,1
2016-09-17,2016,SEA,HOU,1,2,-141,-1.5,148,8.0,-109,-111,126,1.5,-168,4.68,T-Mobile Park,3,-1
2016-09-17,2016,CWS,KC,2,3,118,1.5,-163,9.0,100,-120,-128,-1.5,144,4.13,Kauffman Stadium,5,-1
2016-09-17,2016,TOR,LAA,1,6,-140,-1.5,115,9.0,-115,-105,125,1.5,-135,5.25,Angel Stadium,7,-5
2016-09-17,2016,ARI,LAD,2,6,139,1.5,-125,11.0,100,-120,-154,-1.5,105,4.6,Chase Field,8,-4
2016-09-17,2016,PHI,MIA,8,0,-109,-1.5,175,8.0,-120,100,-101,1.5,-205,4.17,Citizens Bank Park,8,8
2016-09-17,2016,CHC,MIL,3,11,-208,-1.5,106,8.5,-110,-110,178,1.5,-126,5.74,Wrigley Field,14,-8
2016-09-17,2016,NYM,MIN,3,2,-150,-1.5,145,8.0,105,-125,135,1.5,-165,4.8,Citi Field,5,1
2016-09-17,2016,MIN,NYM,2,3,135,1.5,-165,8.0,105,-125,-150,-1.5,145,3.4,Citi Field,5,-1
2016-09-17,2016,BOS,NYY,6,5,-262,-1.5,-134,9.5,-110,-110,222,1.5,114,6.88,Fenway Park,11,1
2016-09-17,2016,TEX,OAK,2,11,-253,-1.5,-132,9.5,-110,-110,213,1.5,113,6.81,Rangers Ballpark,13,-9
2016-09-17,2016,MIA,PHI,0,8,-101,1.5,-205,8.0,-120,100,-109,-1.5,175,4.02,Citizens Bank Park,8,-8
2016-09-17,2016,CIN,PIT,4,10,103,1.5,-155,8.5,-110,-110,-113,-1.5,135,4.19,Great American Ballpark,14,-6
2016-09-17,2016,CIN,PIT,3,7,106,1.5,-160,9.0,-113,-107,-116,-1.5,140,4.37,Great American Ballpark,10,-4
2016-09-17,2016,COL,SD,8,0,-200,-1.5,-120,12.5,-105,-115,170,1.5,100,8.33,Coors Field,8,8
2016-09-17,2016,HOU,SEA,2,1,126,1.5,-168,8.0,-109,-111,-141,-1.5,148,3.54,T-Mobile Park,3,1
2016-09-17,2016,STL,SF,3,2,118,1.5,-200,7.5,-114,-106,-128,-1.5,170,3.44,AT&T Park,5,1
2016-09-17,2016,SF,STL,2,3,-128,-1.5,170,7.5,-114,-106,118,1.5,-200,4.21,AT&T Park,5,-1
2016-09-17,2016,BAL,TB,2,5,-140,-1.5,135,9.0,-120,100,125,1.5,-155,5.25,Camden Yards,7,-3
2016-09-17,2016,OAK,TEX,11,2,213,1.5,113,9.5,-110,-110,-253,-1.5,-132,3.04,Rangers Ballpark,13,9
2016-09-17,2016,LAA,TOR,6,1,125,1.5,-135,9.0,-115,-105,-140,-1.5,115,4.0,Angel Stadium,7,5
2016-09-17,2016,ATL,WSH,7,3,149,1.5,-115,9.0,-115,-105,-164,-1.5,-105,3.61,Turner Field,10,4
2016-09-18,2016,LAD,ARI,9,10,-129,-1.5,125,9.0,105,-125,119,1.5,-145,5.07,Chase Field,19,-1
2016-09-18,2016,WSH,ATL,2,6,-143,-1.5,111,9.0,100,-120,128,1.5,-131,5.3,Turner Field,8,-4
2016-09-18,2016,TB,BAL,1,2,139,1.5,-155,9.0,-120,100,-154,-1.5,135,3.77,Camden Yards,3,-1
2016-09-18,2016,NYY,BOS,4,5,159,1.5,-125,9.0,-120,100,-179,-1.5,105,3.47,Fenway Park,9,-1
2016-09-18,2016,MIL,CHC,3,1,290,1.5,133,8.5,-104,-116,-350,-1.5,-153,2.18,Wrigley Field,4,2
2016-09-18,2016,PIT,CIN,4,7,-133,-1.5,120,8.5,-115,-105,118,1.5,-140,4.85,Great American Ballpark,11,-3
2016-09-18,2016,DET,CLE,9,5,126,1.5,-165,9.0,-116,-104,-141,-1.5,145,3.98,Progressive Field,14,4
2016-09-18,2016,SD,COL,3,6,166,1.5,-114,12.5,-110,-110,-186,-1.5,-106,4.7,Coors Field,9,-3
2016-09-18,2016,KC,CWS,10,3,-117,-1.5,173,7.5,-105,-115,107,1.5,-202,4.04,Kauffman Stadium,13,7
2016-09-18,2016,CLE,DET,5,9,-141,-1.5,145,9.0,-116,-104,126,1.5,-165,5.27,Progressive Field,14,-4
2016-09-18,2016,SEA,HOU,7,3,-110,-1.5,180,9.0,-118,-102,100,1.5,-210,4.71,T-Mobile Park,10,4
2016-09-18,2016,CWS,KC,3,10,107,1.5,-202,7.5,-105,-115,-117,-1.5,173,3.62,Kauffman Stadium,13,-7
2016-09-18,2016,TOR,LAA,0,4,-158,-1.5,-101,9.5,100,-120,143,1.5,-119,5.82,Angel Stadium,4,-4
2016-09-18,2016,ARI,LAD,10,9,119,1.5,-145,9.0,105,-125,-129,-1.5,125,4.11,Chase Field,19,1
2016-09-18,2016,PHI,MIA,4,5,110,1.5,-150,9.0,-120,100,-120,-1.5,130,4.29,Citizens Bank Park,9,-1
2016-09-18,2016,CHC,MIL,1,3,-350,-1.5,-153,8.5,-104,-116,290,1.5,133,6.61,Wrigley Field,4,-2
2016-09-18,2016,NYM,MIN,3,2,-132,-1.5,161,8.5,-115,-105,117,1.5,-181,4.84,Citi Field,5,1
2016-09-18,2016,MIN,NYM,2,3,117,1.5,-181,8.5,-115,-105,-132,-1.5,161,3.92,Citi Field,5,-1
2016-09-18,2016,BOS,NYY,5,4,-179,-1.5,105,9.0,-120,100,159,1.5,-125,5.77,Fenway Park,9,1
2016-09-18,2016,TEX,OAK,2,5,-172,-1.5,108,11.0,100,-120,152,1.5,-128,6.96,Rangers Ballpark,7,-3
2016-09-18,2016,MIA,PHI,5,4,-120,-1.5,130,9.0,-120,100,110,1.5,-150,4.91,Citizens Bank Park,9,1
2016-09-18,2016,CIN,PIT,7,4,118,1.5,-140,8.5,-115,-105,-133,-1.5,120,3.9,Great American Ballpark,11,3
2016-09-18,2016,COL,SD,6,3,-186,-1.5,-106,12.5,-110,-110,166,1.5,-114,8.13,Coors Field,9,3
2016-09-18,2016,HOU,SEA,3,7,100,1.5,-210,9.0,-118,-102,-110,-1.5,180,4.5,T-Mobile Park,10,-4
2016-09-18,2016,STL,SF,3,0,-115,-1.5,135,8.5,-110,-110,105,1.5,-155,4.55,AT&T Park,3,3
2016-09-18,2016,SF,STL,0,3,105,1.5,-155,8.5,-110,-110,-115,-1.5,135,4.15,AT&T Park,3,-3
2016-09-18,2016,BAL,TB,2,1,-154,-1.5,135,9.0,-120,100,139,1.5,-155,5.46,Camden Yards,3,1
2016-09-18,2016,OAK,TEX,5,2,152,1.5,-128,11.0,100,-120,-172,-1.5,108,4.37,Rangers Ballpark,7,3
2016-09-18,2016,LAA,TOR,4,0,143,1.5,-119,9.5,100,-120,-158,-1.5,-101,3.91,Angel Stadium,4,4
2016-09-18,2016,ATL,WSH,6,2,128,1.5,-131,9.0,100,-120,-143,-1.5,111,3.95,Turner Field,8,4
2016-09-19,2016,SD,ARI,3,2,-153,-1.5,140,8.5,-110,-110,138,1.5,-160,5.14,PETCO Park,5,1
2016-09-19,2016,NYM,ATL,3,7,-265,-1.5,-121,7.0,-120,100,225,1.5,101,5.08,Citi Field,10,-4
2016-09-19,2016,BOS,BAL,5,2,-126,-1.5,120,9.0,-110,-110,116,1.5,-140,5.02,Camden Yards,7,3
2016-09-19,2016,BAL,BOS,2,5,116,1.5,-140,9.0,-110,-110,-126,-1.5,120,4.17,Camden Yards,7,-3
2016-09-19,2016,CIN,CHC,2,5,235,1.5,125,9.5,-115,-105,-275,-1.5,-145,2.84,Wrigley Field,7,-3
2016-09-19,2016,CHC,CIN,5,2,-275,-1.5,-145,9.5,-115,-105,235,1.5,125,6.97,Wrigley Field,7,3
2016-09-19,2016,STL,COL,5,3,-116,-1.5,130,11.0,-120,100,106,1.5,-150,5.91,Coors Field,8,2
2016-09-19,2016,KC,CWS,8,3,-123,-1.5,166,8.5,-105,-115,113,1.5,-186,4.69,Kauffman Stadium,11,5
2016-09-19,2016,OAK,HOU,2,4,104,1.5,-160,8.0,-115,-105,-114,-1.5,140,3.92,Oakland Coliseum,6,-2
2016-09-19,2016,CWS,KC,3,8,113,1.5,-186,8.5,-105,-115,-123,-1.5,166,3.99,Kauffman Stadium,11,-5
2016-09-19,2016,TEX,LAA,3,2,-132,-1.5,142,10.5,-119,-101,117,1.5,-162,5.97,Rangers Ballpark,5,1
2016-09-19,2016,SF,LAD,1,2,161,1.5,-159,5.5,-115,-105,-181,-1.5,139,2.11,Dodger Stadium,3,-1
2016-09-19,2016,WSH,MIA,3,4,119,1.5,-185,8.5,100,-120,-129,-1.5,165,3.88,Marlins Park,7,-1
2016-09-19,2016,ATL,NYM,7,3,225,1.5,101,7.0,-120,100,-265,-1.5,-121,2.15,Citi Field,10,4
2016-09-19,2016,HOU,OAK,4,2,-114,-1.5,140,8.0,-115,-105,104,1.5,-160,4.26,Oakland Coliseum,6,2
2016-09-19,2016,ARI,SD,2,3,138,1.5,-160,8.5,-110,-110,-153,-1.5,140,3.57,PETCO Park,5,-1
2016-09-19,2016,TOR,SEA,3,2,107,1.5,-205,8.5,-106,-114,-117,-1.5,175,4.11,T-Mobile Park,5,1
2016-09-19,2016,LAD,SF,2,1,-181,-1.5,139,5.5,-115,-105,161,1.5,-159,3.54,Dodger Stadium,3,1
2016-09-19,2016,COL,STL,3,5,106,1.5,-150,11.0,-120,100,-116,-1.5,130,5.34,Coors Field,8,-2
2016-09-19,2016,LAA,TEX,2,3,117,1.5,-162,10.5,-119,-101,-132,-1.5,142,4.84,Rangers Ballpark,5,-1
2016-09-19,2016,SEA,TOR,2,3,-117,-1.5,175,8.5,-106,-114,107,1.5,-205,4.58,T-Mobile Park,5,-1
2016-09-19,2016,MIA,WSH,4,3,-129,-1.5,165,8.5,100,-120,119,1.5,-185,4.79,Marlins Park,7,1
2016-09-20,2016,SD,ARI,5,2,110,1.5,-155,8.5,-115,-105,-120,-1.5,135,4.05,PETCO Park,7,3
2016-09-20,2016,NYM,ATL,4,5,-123,-1.5,170,8.0,-120,100,113,1.5,-200,4.41,Citi Field,9,-1
2016-09-20,2016,BOS,BAL,5,2,138,1.5,-150,8.5,-112,-108,-153,-1.5,130,3.57,Camden Yards,7,3
2016-09-20,2016,BAL,BOS,2,5,-153,-1.5,130,8.5,-112,-108,138,1.5,-150,5.14,Camden Yards,7,-3
2016-09-20,2016,CIN,CHC,1,6,255,1.5,120,8.0,105,-125,-295,-1.5,-140,2.25,Wrigley Field,7,-5
2016-09-20,2016,CHC,CIN,6,1,-295,-1.5,-140,8.0,105,-125,255,1.5,120,5.97,Wrigley Field,7,5
2016-09-20,2016,KC,CLE,1,2,142,1.5,-150,8.5,-115,-105,-157,-1.5,130,3.51,Progressive Field,3,-1
2016-09-20,2016,STL,COL,10,5,-123,-1.5,120,12.0,-105,-115,113,1.5,-140,6.62,Coors Field,15,5
2016-09-20,2016,PHI,CWS,7,6,-108,-1.5,180,9.0,100,-120,-102,1.5,-210,4.67,Citizens Bank Park,13,1
2016-09-20,2016,MIN,DET,1,8,101,1.5,-155,9.5,-105,-115,-111,-1.5,135,4.73,Target Field,9,-7
2016-09-20,2016,OAK,HOU,1,2,115,1.5,-135,7.5,-110,-110,-130,-1.5,115,3.49,Oakland Coliseum,3,-1
2016-09-20,2016,CLE,KC,2,1,-157,-1.5,130,8.5,-115,-105,142,1.5,-150,5.19,Progressive Field,3,1
2016-09-20,2016,TEX,LAA,5,4,-193,-1.5,100,10.5,-110,-110,173,1.5,-120,6.92,Rangers Ballpark,9,1
2016-09-20,2016,SF,LAD,2,0,132,1.5,-170,7.0,100,-120,-147,-1.5,150,3.02,Dodger Stadium,2,2
2016-09-20,2016,WSH,MIA,0,1,159,1.5,-145,7.0,110,-130,-179,-1.5,125,2.7,Marlins Park,1,-1
2016-09-20,2016,PIT,MIL,6,3,-123,-1.5,130,9.0,-105,-115,113,1.5,-150,4.96,Miller Park,9,3
2016-09-20,2016,DET,MIN,8,1,-111,-1.5,135,9.5,-105,-115,101,1.5,-155,5.0,Target Field,9,7
2016-09-20,2016,ATL,NYM,5,4,113,1.5,-200,8.0,-120,100,-123,-1.5,170,3.76,Citi Field,9,1
2016-09-20,2016,TB,NYY,3,5,105,1.5,-160,7.0,-110,-110,-115,-1.5,140,3.41,Tropicana Field,8,-2
2016-09-20,2016,HOU,OAK,2,1,-130,-1.5,115,7.5,-110,-110,115,1.5,-135,4.24,Oakland Coliseum,3,1
2016-09-20,2016,CWS,PHI,6,7,-102,1.5,-210,9.0,100,-120,-108,-1.5,180,4.54,Citizens Bank Park,13,-1
2016-09-20,2016,MIL,PIT,3,6,113,1.5,-150,9.0,-105,-115,-123,-1.5,130,4.23,Miller Park,9,-3
2016-09-20,2016,ARI,SD,2,5,-120,-1.5,135,8.5,-115,-105,110,1.5,-155,4.64,PETCO Park,7,-3
2016-09-20,2016,TOR,SEA,10,2,-114,-1.5,130,7.5,-105,-115,104,1.5,-150,4.0,T-Mobile Park,12,8
2016-09-20,2016,LAD,SF,0,2,-147,-1.5,150,7.0,100,-120,132,1.5,-170,4.17,Dodger Stadium,2,-2
2016-09-20,2016,COL,STL,5,10,113,1.5,-140,12.0,-105,-115,-123,-1.5,120,5.63,Coors Field,15,-5
2016-09-20,2016,NYY,TB,5,3,-115,-1.5,140,7.0,-110,-110,105,1.5,-160,3.74,Tropicana Field,8,2
2016-09-20,2016,LAA,TEX,4,5,173,1.5,-120,10.5,-110,-110,-193,-1.5,100,3.85,Rangers Ballpark,9,-1
2016-09-20,2016,SEA,TOR,2,10,104,1.5,-150,7.5,-105,-115,-114,-1.5,130,3.68,T-Mobile Park,12,-8
2016-09-20,2016,MIA,WSH,1,0,-179,-1.5,125,7.0,110,-130,159,1.5,-145,4.49,Marlins Park,1,1
2016-09-21,2016,SD,ARI,2,3,117,1.5,-149,7.5,-110,-110,-127,-1.5,129,3.46,PETCO Park,5,-1
2016-09-21,2016,NYM,ATL,3,4,-178,-1.5,-101,8.5,-110,-110,158,1.5,-116,5.44,Citi Field,7,-1
2016-09-21,2016,BOS,BAL,5,1,-105,-1.5,145,10.0,-115,-105,-105,1.5,-165,5.12,Camden Yards,6,4
2016-09-21,2016,BAL,BOS,1,5,-105,1.5,-165,10.0,-115,-105,-105,-1.5,145,5.12,Camden Yards,6,-4
2016-09-21,2016,CIN,CHC,2,9,251,1.5,111,9.0,-115,-105,-291,-1.5,-131,2.56,Wrigley Field,11,-7
2016-09-21,2016,CHC,CIN,9,2,-291,-1.5,-131,9.0,-115,-105,251,1.5,111,6.7,Wrigley Field,11,7
2016-09-21,2016,KC,CLE,3,4,165,1.5,-135,7.5,-110,-110,-185,-1.5,115,2.83,Progressive Field,7,-1
2016-09-21,2016,STL,COL,1,11,-130,-1.5,110,12.5,-105,-115,115,1.5,-130,7.07,Coors Field,12,-10
2016-09-21,2016,PHI,CWS,8,3,134,1.5,-131,7.0,-109,-111,-149,-1.5,111,2.99,Citizens Bank Park,11,5
2016-09-21,2016,OAK,HOU,5,6,154,1.5,-106,8.0,-115,-105,-174,-1.5,-114,3.15,Oakland Coliseum,11,-1
2016-09-21,2016,CLE,KC,4,3,-185,-1.5,115,7.5,-110,-110,165,1.5,-135,4.87,Progressive Field,7,1
2016-09-21,2016,TEX,LAA,4,5,-149,-1.5,131,11.0,-109,-111,134,1.5,-151,6.58,Rangers Ballpark,9,-1
2016-09-21,2016,SF,LAD,3,9,136,1.5,-165,7.5,-102,-118,-151,-1.5,145,3.18,Dodger Stadium,12,-6
2016-09-21,2016,WSH,MIA,8,3,-210,-1.5,-127,7.5,105,-125,180,1.5,107,5.08,Marlins Park,11,5
2016-09-21,2016,PIT,MIL,4,1,-132,-1.5,120,9.0,103,-123,117,1.5,-140,5.12,Miller Park,5,3
2016-09-21,2016,ATL,NYM,4,3,158,1.5,-116,8.5,-110,-110,-178,-1.5,-101,3.29,Citi Field,7,1
2016-09-21,2016,TB,NYY,5,11,114,1.5,-155,7.0,100,-120,-124,-1.5,135,3.27,Tropicana Field,16,-6
2016-09-21,2016,HOU,OAK,6,5,-174,-1.5,-114,8.0,-115,-105,154,1.5,-106,5.08,Oakland Coliseum,11,1
2016-09-21,2016,CWS,PHI,3,8,-149,-1.5,111,7.0,-109,-111,134,1.5,-131,4.19,Citizens Bank Park,11,-5
2016-09-21,2016,MIL,PIT,1,4,117,1.5,-140,9.0,103,-123,-132,-1.5,120,4.15,Miller Park,5,-3
2016-09-21,2016,ARI,SD,3,2,-127,-1.5,129,7.5,-110,-110,117,1.5,-149,4.2,PETCO Park,5,1
2016-09-21,2016,TOR,SEA,1,2,-124,-1.5,124,8.0,-120,100,114,1.5,-144,4.43,T-Mobile Park,3,-1
2016-09-21,2016,LAD,SF,9,3,-151,-1.5,145,7.5,-102,-118,136,1.5,-165,4.51,Dodger Stadium,12,6
2016-09-21,2016,COL,STL,11,1,115,1.5,-130,12.5,-105,-115,-130,-1.5,110,5.81,Coors Field,12,10
2016-09-21,2016,NYY,TB,11,5,-124,-1.5,135,7.0,100,-120,114,1.5,-155,3.88,Tropicana Field,16,6
2016-09-21,2016,LAA,TEX,5,4,134,1.5,-151,11.0,-109,-111,-149,-1.5,131,4.7,Rangers Ballpark,9,1
2016-09-21,2016,SEA,TOR,2,1,114,1.5,-144,8.0,-120,100,-124,-1.5,124,3.74,T-Mobile Park,3,1
2016-09-21,2016,MIA,WSH,3,8,180,1.5,107,7.5,105,-125,-210,-1.5,-127,2.68,Marlins Park,11,-5
2016-09-22,2016,MIA,ATL,3,6,-140,-1.5,160,9.0,-112,-108,125,1.5,-180,5.25,Marlins Park,9,-3
2016-09-22,2016,BOS,BAL,5,3,-124,-1.5,132,8.5,-110,-110,114,1.5,-152,4.71,Camden Yards,8,2
2016-09-22,2016,BAL,BOS,3,5,114,1.5,-152,8.5,-110,-110,-124,-1.5,132,3.97,Camden Yards,8,-2
2016-09-22,2016,KC,CLE,2,5,127,1.5,-160,8.5,-120,100,-142,-1.5,140,3.74,Progressive Field,7,-3
2016-09-22,2016,LAD,COL,7,4,-258,-1.5,-109,8.0,-110,-110,218,1.5,-111,5.77,Dodger Stadium,11,3
2016-09-22,2016,MIN,DET,2,9,130,1.5,-128,10.0,-101,-119,-145,-1.5,108,4.35,Target Field,11,-7
2016-09-22,2016,MIN,DET,2,4,137,1.5,-126,7.5,105,-125,-152,-1.5,106,3.16,Target Field,6,-2
2016-09-22,2016,LAA,HOU,2,0,147,1.5,-150,8.5,-120,100,-162,-1.5,130,3.44,Minute Maid Park,2,2
2016-09-22,2016,CLE,KC,5,2,-142,-1.5,140,8.5,-120,100,127,1.5,-160,4.99,Progressive Field,7,3
2016-09-22,2016,HOU,LAA,0,2,-162,-1.5,130,8.5,-120,100,147,1.5,-150,5.26,Minute Maid Park,2,-2
2016-09-22,2016,COL,LAD,4,7,218,1.5,-111,8.0,-110,-110,-258,-1.5,-109,2.52,Dodger Stadium,11,-3
2016-09-22,2016,ATL,MIA,6,3,125,1.5,-180,9.0,-112,-108,-140,-1.5,160,4.0,Marlins Park,9,3
2016-09-22,2016,PIT,MIL,1,3,-121,-1.5,139,9.0,-119,-101,111,1.5,-159,4.93,Miller Park,4,-2
2016-09-22,2016,DET,MIN,9,2,-145,-1.5,108,10.0,-101,-119,130,1.5,-128,5.92,Target Field,11,7
2016-09-22,2016,DET,MIN,4,2,-152,-1.5,106,7.5,105,-125,137,1.5,-126,4.52,Target Field,6,2
2016-09-22,2016,PHI,NYM,8,9,144,1.5,-166,8.0,100,-120,-159,-1.5,146,3.28,Citi Field,17,-1
2016-09-22,2016,TB,NYY,2,0,-131,-1.5,165,8.0,-110,-110,116,1.5,-185,4.54,Tropicana Field,2,2
2016-09-22,2016,NYM,PHI,9,8,-159,-1.5,146,8.0,100,-120,144,1.5,-166,4.91,Citi Field,17,1
2016-09-22,2016,MIL,PIT,3,1,111,1.5,-159,9.0,-119,-101,-121,-1.5,139,4.27,Miller Park,4,2
2016-09-22,2016,SF,SD,2,1,-157,-1.5,105,7.5,-110,-110,142,1.5,-125,4.58,PETCO Park,3,1
2016-09-22,2016,SD,SF,1,2,142,1.5,-125,7.5,-110,-110,-157,-1.5,105,3.1,PETCO Park,3,-1
2016-09-22,2016,NYY,TB,0,2,116,1.5,-185,8.0,-110,-110,-131,-1.5,165,3.7,Tropicana Field,2,-2
2016-09-23,2016,BAL,ARI,3,2,-230,-1.5,-115,10.5,100,-120,200,1.5,-105,7.32,Camden Yards,5,1
2016-09-23,2016,MIA,ATL,2,3,-150,-1.5,149,8.5,-118,-102,135,1.5,-169,5.1,Marlins Park,5,-1
2016-09-23,2016,ARI,BAL,2,3,200,1.5,-105,10.5,100,-120,-230,-1.5,-115,3.5,Camden Yards,5,-1
2016-09-23,2016,TB,BOS,1,2,106,1.5,-156,7.5,102,-122,-116,-1.5,136,3.64,Tropicana Field,3,-1
2016-09-23,2016,STL,CHC,0,5,175,1.5,-129,7.5,100,-120,-195,-1.5,109,2.73,Wrigley Field,5,-5
2016-09-23,2016,MIL,CIN,5,4,-116,-1.5,170,8.0,-115,-105,106,1.5,-200,4.3,Miller Park,9,1
2016-09-23,2016,CWS,CLE,4,10,160,1.5,-131,9.0,-115,-105,-180,-1.5,111,3.46,Progressive Field,14,-6
2016-09-23,2016,LAD,COL,5,2,-175,-1.5,125,7.5,-115,-105,155,1.5,-145,4.77,Dodger Stadium,7,3
2016-09-23,2016,CLE,CWS,10,4,-180,-1.5,111,9.0,-115,-105,160,1.5,-131,5.79,Progressive Field,14,6
2016-09-23,2016,KC,DET,3,8,116,1.5,-185,8.0,100,-120,-131,-1.5,165,3.7,Comerica Park,11,-5
2016-09-23,2016,LAA,HOU,10,6,131,1.5,-164,9.0,100,-120,-146,-1.5,144,3.9,Minute Maid Park,16,4
2016-09-23,2016,DET,KC,8,3,-131,-1.5,165,8.0,100,-120,116,1.5,-185,4.54,Comerica Park,11,5
2016-09-23,2016,HOU,LAA,6,10,-146,-1.5,144,9.0,100,-120,131,1.5,-164,5.34,Minute Maid Park,16,-4
2016-09-23,2016,COL,LAD,2,5,155,1.5,-145,7.5,-115,-105,-175,-1.5,125,2.94,Dodger Stadium,7,-3
2016-09-23,2016,ATL,MIA,3,2,135,1.5,-169,8.5,-118,-102,-150,-1.5,149,3.62,Marlins Park,5,1
2016-09-23,2016,CIN,MIL,4,5,106,1.5,-200,8.0,-115,-105,-116,-1.5,170,3.88,Miller Park,9,-1
2016-09-23,2016,SEA,MIN,10,1,-176,-1.5,-117,9.0,-108,-112,156,1.5,-103,5.74,Target Field,11,9
2016-09-23,2016,PHI,NYM,5,10,134,1.5,-171,8.0,-125,105,-149,-1.5,151,3.42,Citi Field,15,-5
2016-09-23,2016,TOR,NYY,9,0,-215,-1.5,-110,9.5,100,-120,185,1.5,-110,6.48,Rogers Centre,9,9
2016-09-23,2016,TEX,OAK,3,0,-156,-1.5,105,8.0,100,-120,141,1.5,-125,4.88,Oakland Coliseum,3,3
2016-09-23,2016,NYM,PHI,10,5,-149,-1.5,151,8.0,-125,105,134,1.5,-171,4.79,Citi Field,15,5
2016-09-23,2016,WSH,PIT,5,6,108,1.5,-205,8.0,-114,-106,-118,-1.5,175,3.85,PNC Park,11,-1
2016-09-23,2016,SF,SD,2,7,-156,-1.5,110,8.0,-120,100,141,1.5,-130,4.88,PETCO Park,9,-5
2016-09-23,2016,MIN,SEA,1,10,156,1.5,-103,9.0,-108,-112,-176,-1.5,-117,3.52,Target Field,11,-9
2016-09-23,2016,SD,SF,7,2,141,1.5,-130,8.0,-120,100,-156,-1.5,110,3.32,PETCO Park,9,5
2016-09-23,2016,CHC,STL,5,0,-195,-1.5,109,7.5,100,-120,175,1.5,-129,4.96,Wrigley Field,5,5
2016-09-23,2016,BOS,TB,2,1,-116,-1.5,136,7.5,102,-122,106,1.5,-156,4.03,Tropicana Field,3,1
2016-09-23,2016,OAK,TEX,0,3,141,1.5,-125,8.0,100,-120,-156,-1.5,105,3.32,Oakland Coliseum,3,-3
2016-09-23,2016,NYY,TOR,0,9,185,1.5,-110,9.5,100,-120,-215,-1.5,-110,3.33,Rogers Centre,9,-9
2016-09-23,2016,PIT,WSH,6,5,-118,-1.5,175,8.0,-114,-106,108,1.5,-205,4.33,PNC Park,11,1
2016-09-24,2016,BAL,ARI,6,1,-151,-1.5,135,9.0,-104,-116,136,1.5,-155,5.41,Camden Yards,7,5
2016-09-24,2016,MIA,ATL,6,4,-205,-1.5,-101,8.5,-119,-101,175,1.5,-119,5.71,Marlins Park,10,2
2016-09-24,2016,ARI,BAL,1,6,136,1.5,-155,9.0,-104,-116,-151,-1.5,135,3.81,Camden Yards,7,-5
2016-09-24,2016,TB,BOS,4,6,130,1.5,-130,8.0,-109,-111,-145,-1.5,110,3.48,Tropicana Field,10,-2
2016-09-24,2016,STL,CHC,10,4,126,1.5,-180,8.0,-105,-115,-141,-1.5,160,3.54,Wrigley Field,14,6
2016-09-24,2016,MIL,CIN,1,6,-106,-1.5,180,9.0,-115,-105,-104,1.5,-210,4.63,Miller Park,7,-5
2016-09-24,2016,CWS,CLE,8,1,129,1.5,-160,8.5,100,-120,-144,-1.5,140,3.71,Progressive Field,9,7
2016-09-24,2016,LAD,COL,14,1,-340,-1.5,-146,6.5,-115,-105,290,1.5,126,5.02,Dodger Stadium,15,13
2016-09-24,2016,CLE,CWS,1,8,-144,-1.5,140,8.5,100,-120,129,1.5,-160,5.02,Progressive Field,9,-7
2016-09-24,2016,KC,DET,7,4,146,1.5,-150,8.0,-110,-110,-161,-1.5,130,3.25,Comerica Park,11,3
2016-09-24,2016,LAA,HOU,10,4,126,1.5,-165,8.5,-115,-105,-141,-1.5,145,3.76,Minute Maid Park,14,6
2016-09-24,2016,DET,KC,4,7,-161,-1.5,130,8.0,-110,-110,146,1.5,-150,4.93,Comerica Park,11,-3
2016-09-24,2016,HOU,LAA,4,10,-141,-1.5,145,8.5,-115,-105,126,1.5,-165,4.97,Minute Maid Park,14,-6
2016-09-24,2016,COL,LAD,1,14,290,1.5,126,6.5,-115,-105,-340,-1.5,-146,1.67,Dodger Stadium,15,-13
2016-09-24,2016,ATL,MIA,4,6,175,1.5,-119,8.5,-119,-101,-205,-1.5,-101,3.09,Marlins Park,10,-2
2016-09-24,2016,CIN,MIL,6,1,-104,1.5,-210,9.0,-115,-105,-106,-1.5,180,4.59,Miller Park,7,5
2016-09-24,2016,SEA,MIN,2,3,-140,-1.5,115,9.5,-105,-115,125,1.5,-135,5.54,Target Field,5,-1
2016-09-24,2016,PHI,NYM,10,8,181,1.5,-110,8.5,100,-120,-211,-1.5,-110,3.02,Citi Field,18,2
2016-09-24,2016,TOR,NYY,3,0,-235,-1.5,-115,8.5,-120,100,205,1.5,-105,5.96,Rogers Centre,3,3
2016-09-24,2016,TEX,OAK,5,0,-117,-1.5,134,8.0,-105,-115,107,1.5,-154,4.31,Oakland Coliseum,5,5
2016-09-24,2016,NYM,PHI,8,10,-211,-1.5,-110,8.5,100,-120,181,1.5,-110,5.77,Citi Field,18,-2
2016-09-24,2016,WSH,PIT,6,1,100,1.5,-215,8.0,-116,-104,-110,-1.5,185,4.0,PNC Park,7,5
2016-09-24,2016,SF,SD,9,6,-240,-1.5,-142,7.0,-124,104,200,1.5,122,4.94,PETCO Park,15,3
2016-09-24,2016,MIN,SEA,3,2,125,1.5,-135,9.5,-105,-115,-140,-1.5,115,4.22,Target Field,5,1
2016-09-24,2016,SD,SF,6,9,200,1.5,122,7.0,-124,104,-240,-1.5,-142,2.33,PETCO Park,15,-3
2016-09-24,2016,CHC,STL,4,10,-141,-1.5,160,8.0,-105,-115,126,1.5,-180,4.68,Wrigley Field,14,-6
2016-09-24,2016,BOS,TB,6,4,-145,-1.5,110,8.0,-109,-111,130,1.5,-130,4.73,Tropicana Field,10,2
2016-09-24,2016,OAK,TEX,0,5,107,1.5,-154,8.0,-105,-115,-117,-1.5,134,3.86,Oakland Coliseum,5,-5
2016-09-24,2016,NYY,TOR,0,3,205,1.5,-105,8.5,-120,100,-235,-1.5,-115,2.79,Rogers Centre,3,-3
2016-09-24,2016,PIT,WSH,1,6,-110,-1.5,185,8.0,-116,-104,100,1.5,-215,4.19,PNC Park,7,-5
2016-09-25,2016,BAL,ARI,2,1,-260,-1.5,-145,9.5,-120,100,220,1.5,125,6.86,Camden Yards,3,1
2016-09-25,2016,ARI,BAL,1,2,220,1.5,125,9.5,-120,100,-260,-1.5,-145,2.97,Camden Yards,3,-1
2016-09-25,2016,TB,BOS,2,3,114,1.5,-152,8.0,-110,-110,-124,-1.5,132,3.74,Tropicana Field,5,-1
2016-09-25,2016,STL,CHC,1,3,153,1.5,-145,8.5,-115,-105,-173,-1.5,125,3.36,Wrigley Field,4,-2
2016-09-25,2016,MIL,CIN,2,4,-131,-1.5,165,8.5,-119,-101,116,1.5,-185,4.82,Miller Park,6,-2
2016-09-25,2016,CWS,CLE,3,0,149,1.5,-145,8.5,-125,105,-164,-1.5,125,3.41,Progressive Field,3,3
2016-09-25,2016,LAD,COL,4,3,-144,-1.5,150,8.0,-105,-115,129,1.5,-170,4.72,Dodger Stadium,7,1
2016-09-25,2016,CLE,CWS,0,3,-164,-1.5,125,8.5,-125,105,149,1.5,-145,5.28,Progressive Field,3,-3
2016-09-25,2016,KC,DET,12,9,138,1.5,-155,9.0,-110,-110,-153,-1.5,135,3.78,Comerica Park,21,3
2016-09-25,2016,LAA,HOU,1,4,165,1.5,-130,9.0,-107,-113,-185,-1.5,110,3.4,Minute Maid Park,5,-3
2016-09-25,2016,DET,KC,9,12,-153,-1.5,135,9.0,-110,-110,138,1.5,-155,5.44,Comerica Park,21,-3
2016-09-25,2016,HOU,LAA,4,1,-185,-1.5,110,9.0,-107,-113,165,1.5,-130,5.84,Minute Maid Park,5,3
2016-09-25,2016,COL,LAD,3,4,129,1.5,-170,8.0,-105,-115,-144,-1.5,150,3.49,Dodger Stadium,7,-1
2016-09-25,2016,CIN,MIL,4,2,116,1.5,-185,8.5,-119,-101,-131,-1.5,165,3.94,Miller Park,6,2
2016-09-25,2016,SEA,MIN,4,3,-146,-1.5,109,9.0,-120,100,131,1.5,-129,5.34,Target Field,7,1
2016-09-25,2016,PHI,NYM,0,17,175,1.5,-119,8.5,-110,-110,-195,-1.5,-101,3.09,Citi Field,17,-17
2016-09-25,2016,TOR,NYY,4,3,-126,-1.5,165,8.5,-105,-115,116,1.5,-185,4.74,Rogers Centre,7,1
2016-09-25,2016,TEX,OAK,1,7,101,1.5,-210,8.5,-109,-111,-111,-1.5,180,4.23,Oakland Coliseum,8,-6
2016-09-25,2016,NYM,PHI,17,0,-195,-1.5,-101,8.5,-110,-110,175,1.5,-119,5.62,Citi Field,17,17
2016-09-25,2016,WSH,PIT,10,7,125,1.5,-180,8.0,-115,-105,-140,-1.5,160,3.56,PNC Park,17,3
2016-09-25,2016,SF,SD,3,4,-119,-1.5,140,8.5,-110,-110,109,1.5,-160,4.62,PETCO Park,7,-1
2016-09-25,2016,MIN,SEA,3,4,131,1.5,-129,9.0,-120,100,-146,-1.5,109,3.9,Target Field,7,-1
2016-09-25,2016,SD,SF,4,3,109,1.5,-160,8.5,-110,-110,-119,-1.5,140,4.07,PETCO Park,7,1
2016-09-25,2016,CHC,STL,3,1,-173,-1.5,125,8.5,-115,-105,153,1.5,-145,5.39,Wrigley Field,4,2
2016-09-25,2016,BOS,TB,3,2,-124,-1.5,132,8.0,-110,-110,114,1.5,-152,4.43,Tropicana Field,5,1
2016-09-25,2016,OAK,TEX,7,1,-111,-1.5,180,8.5,-109,-111,101,1.5,-210,4.47,Oakland Coliseum,8,6
2016-09-25,2016,NYY,TOR,3,4,116,1.5,-185,8.5,-105,-115,-126,-1.5,165,3.94,Rogers Centre,7,-1
2016-09-25,2016,PIT,WSH,7,10,-140,-1.5,160,8.0,-115,-105,125,1.5,-180,4.67,PNC Park,17,-3
2016-09-26,2016,WSH,ARI,4,14,-176,-1.5,120,8.0,-115,-105,156,1.5,-140,5.1,Nationals Park,18,-10
2016-09-26,2016,PIT,CHC,2,12,148,1.5,-119,7.5,-110,-110,-163,-1.5,-101,3.02,PNC Park,14,-10
2016-09-26,2016,STL,CIN,2,15,-255,-1.5,-126,8.5,100,-120,215,1.5,106,6.11,Busch Stadium,17,-13
2016-09-26,2016,DET,CLE,4,7,157,1.5,-110,8.5,-110,-110,-177,-1.5,-110,3.31,Comerica Park,11,-3
2016-09-26,2016,TB,CWS,1,7,-130,-1.5,125,9.0,-110,-110,115,1.5,-145,5.09,Guaranteed Rate Field,8,-6
2016-09-26,2016,CLE,DET,7,4,-177,-1.5,-110,8.5,-110,-110,157,1.5,-110,5.43,Comerica Park,11,3
2016-09-26,2016,SEA,HOU,4,3,113,1.5,-185,8.0,100,-120,-123,-1.5,165,3.76,Minute Maid Park,7,1
2016-09-26,2016,OAK,LAA,1,2,-108,-1.5,140,9.0,-125,105,-102,1.5,-160,4.67,Angel Stadium,3,-1
2016-09-26,2016,NYM,MIA,3,7,109,1.5,-205,8.0,-110,-110,-119,-1.5,175,3.83,Marlins Park,10,-4
2016-09-26,2016,TEX,MIL,3,8,-180,-1.5,105,9.5,-115,-105,160,1.5,-125,6.11,Rangers Ballpark,11,-5
2016-09-26,2016,MIA,NYM,7,3,-119,-1.5,175,8.0,-110,-110,109,1.5,-205,4.35,Marlins Park,10,4
2016-09-26,2016,TOR,NYY,5,7,-210,-1.5,-105,8.5,-115,-105,180,1.5,-115,5.76,Rogers Centre,12,-2
2016-09-26,2016,LAA,OAK,2,1,-102,1.5,-160,9.0,-125,105,-108,-1.5,140,4.54,Angel Stadium,3,1
2016-09-26,2016,CHC,PIT,12,2,-163,-1.5,-101,7.5,-110,-110,148,1.5,-119,4.65,PNC Park,14,10
2016-09-26,2016,HOU,SEA,3,4,-123,-1.5,165,8.0,100,-120,113,1.5,-185,4.41,Minute Maid Park,7,-1
2016-09-26,2016,CIN,STL,15,2,215,1.5,106,8.5,100,-120,-255,-1.5,-126,2.7,Busch Stadium,17,13
2016-09-26,2016,CWS,TB,7,1,115,1.5,-145,9.0,-110,-110,-130,-1.5,125,4.19,Guaranteed Rate Field,8,6
2016-09-26,2016,MIL,TEX,8,3,160,1.5,-125,9.5,-115,-105,-180,-1.5,105,3.65,Rangers Ballpark,11,5
2016-09-26,2016,NYY,TOR,7,5,180,1.5,-115,8.5,-115,-105,-210,-1.5,-105,3.04,Rogers Centre,12,2
2016-09-26,2016,ARI,WSH,14,4,156,1.5,-140,8.0,-115,-105,-176,-1.5,120,3.13,Nationals Park,18,10
2016-09-27,2016,WSH,ARI,4,2,-270,-1.5,-125,7.5,105,-125,230,1.5,105,5.47,Nationals Park,6,2
2016-09-27,2016,PHI,ATL,6,7,133,1.5,-170,7.5,-110,-110,-148,-1.5,150,3.22,Turner Field,13,-1
2016-09-27,2016,TOR,BAL,5,1,-125,-1.5,160,8.5,-110,-110,115,1.5,-180,4.72,Rogers Centre,6,4
2016-09-27,2016,NYY,BOS,6,4,190,1.5,120,8.5,-120,100,-220,-1.5,-140,2.93,Yankee Stadium,10,2
2016-09-27,2016,PIT,CHC,4,6,133,1.5,-130,8.5,-110,-110,-148,-1.5,110,3.65,PNC Park,10,-2
2016-09-27,2016,STL,CIN,12,5,-230,-1.5,-110,8.5,100,-120,200,1.5,-110,5.92,Busch Stadium,17,7
2016-09-27,2016,DET,CLE,12,0,-280,-1.5,-140,8.5,100,-120,240,1.5,120,6.26,Comerica Park,12,12
2016-09-27,2016,SF,COL,12,3,-200,-1.5,110,8.0,-110,-110,170,1.5,-130,5.33,AT&T Park,15,9
2016-09-27,2016,TB,CWS,6,13,152,1.5,-145,7.5,105,-125,-172,-1.5,125,2.98,Guaranteed Rate Field,19,-7
2016-09-27,2016,CLE,DET,0,12,240,1.5,120,8.5,100,-120,-280,-1.5,-140,2.5,Comerica Park,12,-12
2016-09-27,2016,SEA,HOU,4,8,100,1.5,-205,8.0,-105,-115,-110,-1.5,175,4.0,Minute Maid Park,12,-4
2016-09-27,2016,MIN,KC,3,4,152,1.5,-130,8.5,-125,105,-172,-1.5,110,3.37,Kauffman Stadium,7,-1
2016-09-27,2016,OAK,LAA,1,8,109,1.5,-185,8.5,-115,-105,-119,-1.5,165,4.07,Angel Stadium,9,-7
2016-09-27,2016,SD,LAD,7,1,205,1.5,120,8.0,-115,-105,-235,-1.5,-140,2.62,PETCO Park,8,6
2016-09-27,2016,NYM,MIA,12,1,-174,-1.5,100,7.5,-105,-115,154,1.5,-120,4.76,Marlins Park,13,11
2016-09-27,2016,TEX,MIL,6,4,-190,-1.5,100,9.5,100,-120,170,1.5,-120,6.22,Rangers Ballpark,10,2
2016-09-27,2016,KC,MIN,4,3,-172,-1.5,110,8.5,-125,105,152,1.5,-130,5.38,Kauffman Stadium,7,1
2016-09-27,2016,MIA,NYM,1,12,154,1.5,-120,7.5,-105,-115,-174,-1.5,100,2.95,Marlins Park,13,-11
2016-09-27,2016,BOS,NYY,4,6,-220,-1.5,-140,8.5,-120,100,190,1.5,120,5.84,Yankee Stadium,10,-2
2016-09-27,2016,LAA,OAK,8,1,-119,-1.5,165,8.5,-115,-105,109,1.5,-185,4.62,Angel Stadium,9,7
2016-09-27,2016,ATL,PHI,7,6,-148,-1.5,150,7.5,-110,-110,133,1.5,-170,4.48,Turner Field,13,1
2016-09-27,2016,CHC,PIT,6,4,-148,-1.5,110,8.5,-110,-110,133,1.5,-130,5.07,PNC Park,10,2
2016-09-27,2016,LAD,SD,1,7,-235,-1.5,-140,8.0,-115,-105,205,1.5,120,5.61,PETCO Park,8,-6
2016-09-27,2016,HOU,SEA,8,4,-110,-1.5,175,8.0,-105,-115,100,1.5,-205,4.19,Minute Maid Park,12,4
2016-09-27,2016,COL,SF,3,12,170,1.5,-130,8.0,-110,-110,-200,-1.5,110,2.96,AT&T Park,15,-9
2016-09-27,2016,CIN,STL,5,12,200,1.5,-110,8.5,100,-120,-230,-1.5,-110,2.83,Busch Stadium,17,-7
2016-09-27,2016,CWS,TB,13,6,-172,-1.5,125,7.5,105,-125,152,1.5,-145,4.74,Guaranteed Rate Field,19,7
2016-09-27,2016,MIL,TEX,4,6,170,1.5,-120,9.5,100,-120,-190,-1.5,100,3.52,Rangers Ballpark,10,-2
2016-09-27,2016,BAL,TOR,1,5,115,1.5,-180,8.5,-110,-110,-125,-1.5,160,3.95,Rogers Centre,6,-4
2016-09-27,2016,ARI,WSH,2,4,230,1.5,105,7.5,105,-125,-270,-1.5,-125,2.27,Nationals Park,6,-2
2016-09-28,2016,WSH,ARI,0,3,-163,-1.5,125,8.5,100,-120,148,1.5,-145,5.27,Nationals Park,3,-3
2016-09-28,2016,PHI,ATL,2,12,136,1.5,-160,8.5,-110,-110,-151,-1.5,140,3.6,Turner Field,14,-10
2016-09-28,2016,TOR,BAL,2,3,-151,-1.5,135,9.0,100,-120,136,1.5,-155,5.41,Rogers Centre,5,-1
2016-09-28,2016,NYY,BOS,5,3,114,1.5,-145,9.0,-115,-105,-124,-1.5,125,4.21,Yankee Stadium,8,2
2016-09-28,2016,PIT,CHC,8,4,152,1.5,-110,7.5,100,-120,-172,-1.5,-110,2.98,PNC Park,12,4
2016-09-28,2016,STL,CIN,1,2,-178,-1.5,125,8.0,-104,-116,158,1.5,-145,5.12,Busch Stadium,3,-1
2016-09-28,2016,DET,CLE,6,3,-130,-1.5,150,8.5,-110,-110,115,1.5,-170,4.8,Comerica Park,9,3
2016-09-28,2016,SF,COL,0,2,-181,-1.5,115,7.5,-105,-115,161,1.5,-135,4.83,AT&T Park,2,-2
2016-09-28,2016,TB,CWS,0,1,-113,-1.5,145,8.5,-110,-110,103,1.5,-165,4.51,Guaranteed Rate Field,1,-1
2016-09-28,2016,CLE,DET,3,6,115,1.5,-170,8.5,-110,-110,-130,-1.5,150,3.95,Comerica Park,9,-3
2016-09-28,2016,SEA,HOU,12,4,-127,-1.5,130,8.5,-120,100,117,1.5,-150,4.76,Minute Maid Park,16,8
2016-09-28,2016,MIN,KC,2,5,115,1.5,-180,8.0,-110,-110,-130,-1.5,160,3.72,Kauffman Stadium,7,-3
2016-09-28,2016,OAK,LAA,6,8,104,1.5,-200,8.5,-110,-110,-114,-1.5,170,4.17,Angel Stadium,14,-2
2016-09-28,2016,SD,LAD,6,5,165,1.5,-105,8.0,-115,-105,-185,-1.5,-115,3.02,PETCO Park,11,1
2016-09-28,2016,NYM,MIA,5,2,105,1.5,-205,8.5,100,-120,-115,-1.5,175,4.15,Marlins Park,7,3
2016-09-28,2016,TEX,MIL,8,5,-215,-1.5,-113,9.0,-110,-110,185,1.5,-107,6.14,Rangers Ballpark,13,3
2016-09-28,2016,KC,MIN,5,2,-130,-1.5,160,8.0,-110,-110,115,1.5,-180,4.52,Kauffman Stadium,7,3
2016-09-28,2016,MIA,NYM,2,5,-115,-1.5,175,8.5,100,-120,105,1.5,-205,4.55,Marlins Park,7,-3
2016-09-28,2016,BOS,NYY,3,5,-124,-1.5,125,9.0,-115,-105,114,1.5,-145,4.98,Yankee Stadium,8,-2
2016-09-28,2016,LAA,OAK,8,6,-114,-1.5,170,8.5,-110,-110,104,1.5,-200,4.53,Angel Stadium,14,2
2016-09-28,2016,ATL,PHI,12,2,-151,-1.5,140,8.5,-110,-110,136,1.5,-160,5.11,Turner Field,14,10
2016-09-28,2016,CHC,PIT,4,8,-172,-1.5,-110,7.5,100,-120,152,1.5,-110,4.74,PNC Park,12,-4
2016-09-28,2016,LAD,SD,5,6,-185,-1.5,-115,8.0,-115,-105,165,1.5,-105,5.19,PETCO Park,11,-1
2016-09-28,2016,HOU,SEA,4,12,117,1.5,-150,8.5,-120,100,-127,-1.5,130,3.92,Minute Maid Park,16,-8
2016-09-28,2016,COL,SF,2,0,161,1.5,-135,7.5,-105,-115,-181,-1.5,115,2.87,AT&T Park,2,2
2016-09-28,2016,CIN,STL,2,1,158,1.5,-145,8.0,-104,-116,-178,-1.5,125,3.1,Busch Stadium,3,1
2016-09-28,2016,CWS,TB,1,0,103,1.5,-165,8.5,-110,-110,-113,-1.5,145,4.19,Guaranteed Rate Field,1,1
2016-09-28,2016,MIL,TEX,5,8,185,1.5,-107,9.0,-110,-110,-215,-1.5,-113,3.16,Rangers Ballpark,13,-3
2016-09-28,2016,BAL,TOR,3,2,136,1.5,-155,9.0,100,-120,-151,-1.5,135,3.81,Rogers Centre,5,1
2016-09-28,2016,ARI,WSH,3,0,148,1.5,-145,8.5,100,-120,-163,-1.5,125,3.43,Nationals Park,3,3
2016-09-29,2016,WSH,ARI,5,3,-134,-1.5,164,7.5,-104,-116,119,1.5,-184,4.29,Nationals Park,8,2
2016-09-29,2016,PHI,ATL,2,5,110,1.5,-200,8.5,100,-120,-120,-1.5,170,4.05,Turner Field,7,-3
2016-09-29,2016,TOR,BAL,0,4,-200,-1.5,104,8.5,-114,-106,170,1.5,-124,5.67,Rogers Centre,4,-4
2016-09-29,2016,NYY,BOS,5,1,-161,-1.5,130,9.0,100,-120,146,1.5,-149,5.55,Yankee Stadium,6,4
2016-09-29,2016,PIT,CHC,1,1,-150,-1.5,140,7.5,-101,-119,135,1.5,-160,4.5,PNC Park,2,0
2016-09-29,2016,STL,CIN,4,3,-196,-1.5,114,7.0,-120,100,176,1.5,-134,4.64,Busch Stadium,7,1
2016-09-29,2016,SF,COL,7,2,-205,-1.5,101,7.0,105,-125,175,1.5,-121,4.7,AT&T Park,9,5
2016-09-29,2016,TB,CWS,5,3,109,1.5,-205,7.5,110,-130,-119,-1.5,175,3.59,Guaranteed Rate Field,8,2
2016-09-29,2016,MIN,KC,7,6,174,1.5,-120,7.5,-110,-110,-194,-1.5,100,2.74,Kauffman Stadium,13,1
2016-09-29,2016,SD,LAD,4,9,143,1.5,-125,7.5,-116,-104,-158,-1.5,105,3.09,PETCO Park,13,-5
2016-09-29,2016,KC,MIN,6,7,-194,-1.5,100,7.5,-110,-110,174,1.5,-120,4.95,Kauffman Stadium,13,-1
2016-09-29,2016,BOS,NYY,1,5,146,1.5,-149,9.0,100,-120,-161,-1.5,130,3.66,Yankee Stadium,6,-4
2016-09-29,2016,SEA,OAK,3,2,-158,-1.5,130,8.0,-120,100,143,1.5,-150,4.9,T-Mobile Park,5,1
2016-09-29,2016,ATL,PHI,5,2,-120,-1.5,170,8.5,100,-120,110,1.5,-200,4.64,Turner Field,7,3
2016-09-29,2016,CHC,PIT,1,1,135,1.5,-160,7.5,-101,-119,-150,-1.5,140,3.19,PNC Park,2,0
2016-09-29,2016,LAD,SD,9,4,-158,-1.5,105,7.5,-116,-104,143,1.5,-125,4.59,PETCO Park,13,5
2016-09-29,2016,OAK,SEA,2,3,143,1.5,-150,8.0,-120,100,-158,-1.5,130,3.29,T-Mobile Park,5,-1
2016-09-29,2016,COL,SF,2,7,175,1.5,-121,7.0,105,-125,-205,-1.5,101,2.55,AT&T Park,9,-5
2016-09-29,2016,CIN,STL,3,4,176,1.5,-134,7.0,-120,100,-196,-1.5,114,2.54,Busch Stadium,7,-1
2016-09-29,2016,CWS,TB,3,5,-119,-1.5,175,7.5,110,-130,109,1.5,-205,4.08,Guaranteed Rate Field,8,-2
2016-09-29,2016,BAL,TOR,4,0,170,1.5,-124,8.5,-114,-106,-200,-1.5,104,3.15,Rogers Centre,4,4
2016-09-29,2016,ARI,WSH,3,5,119,1.5,-184,7.5,-104,-116,-134,-1.5,164,3.42,Nationals Park,8,-2
2016-09-30,2016,SD,ARI,3,5,114,1.5,-168,10.5,-115,-105,-124,-1.5,148,4.91,Chase Field,8,-2
2016-09-30,2016,DET,ATL,6,2,-140,-1.5,118,8.5,-110,-110,125,1.5,-138,4.96,Turner Field,8,4
2016-09-30,2016,NYY,BAL,1,8,-160,-1.5,130,8.0,-110,-110,145,1.5,-150,4.92,Yankee Stadium,9,-7
2016-09-30,2016,TOR,BOS,3,5,140,1.5,-155,8.5,-110,-110,-155,-1.5,135,3.54,Fenway Park,8,-2
2016-09-30,2016,CIN,CHC,3,7,152,1.5,-105,9.5,-105,-115,-172,-1.5,-115,3.77,Great American Ballpark,10,-4
2016-09-30,2016,CHC,CIN,7,3,-172,-1.5,-115,9.5,-105,-115,152,1.5,-105,6.01,Great American Ballpark,10,4
2016-09-30,2016,KC,CLE,2,7,117,1.5,-145,8.5,100,-120,-127,-1.5,125,3.92,Kauffman Stadium,9,-5
2016-09-30,2016,MIL,COL,1,4,125,1.5,-155,11.5,-119,-101,-140,-1.5,135,5.11,Coors Field,5,-3
2016-09-30,2016,MIN,CWS,3,7,139,1.5,-150,8.5,-101,-119,-154,-1.5,130,3.56,Guaranteed Rate Field,10,-4
2016-09-30,2016,ATL,DET,2,6,125,1.5,-138,8.5,-110,-110,-140,-1.5,118,3.78,Turner Field,8,-4
2016-09-30,2016,LAA,HOU,7,1,115,1.5,-145,8.5,-110,-110,-130,-1.5,125,3.95,Angel Stadium,8,6
2016-09-30,2016,CLE,KC,7,2,-127,-1.5,125,8.5,100,-120,117,1.5,-145,4.76,Kauffman Stadium,9,5
2016-09-30,2016,HOU,LAA,1,7,-130,-1.5,125,8.5,-110,-110,115,1.5,-145,4.8,Angel Stadium,8,-6
2016-09-30,2016,SF,LAD,9,3,-160,-1.5,155,6.5,-110,-110,145,1.5,-175,4.0,AT&T Park,12,6
2016-09-30,2016,WSH,MIA,4,7,-145,-1.5,139,8.5,102,-122,130,1.5,-158,5.03,Nationals Park,11,-3
2016-09-30,2016,COL,MIL,4,1,-140,-1.5,135,11.5,-119,-101,125,1.5,-155,6.71,Coors Field,5,3
2016-09-30,2016,CWS,MIN,7,3,-154,-1.5,130,8.5,-101,-119,139,1.5,-150,5.15,Guaranteed Rate Field,10,4
2016-09-30,2016,PHI,NYM,1,5,156,1.5,-110,8.5,-111,-109,-176,-1.5,-110,3.32,Citizens Bank Park,6,-4
2016-09-30,2016,BAL,NYY,8,1,145,1.5,-150,8.0,-110,-110,-160,-1.5,130,3.27,Yankee Stadium,9,7
2016-09-30,2016,SEA,OAK,5,1,-199,-1.5,105,8.5,-110,-110,179,1.5,-125,5.66,T-Mobile Park,6,4
2016-09-30,2016,NYM,PHI,5,1,-176,-1.5,-110,8.5,-111,-109,156,1.5,-110,5.42,Citizens Bank Park,6,4
2016-09-30,2016,STL,PIT,7,0,-186,-1.5,119,7.5,-110,-110,166,1.5,-139,4.88,Busch Stadium,7,7
2016-09-30,2016,ARI,SD,5,3,-124,-1.5,148,10.5,-115,-105,114,1.5,-168,5.81,Chase Field,8,2
2016-09-30,2016,OAK,SEA,1,5,179,1.5,-125,8.5,-110,-110,-199,-1.5,105,3.05,T-Mobile Park,6,-4
2016-09-30,2016,LAD,SF,3,9,145,1.5,-175,6.5,-110,-110,-160,-1.5,155,2.65,AT&T Park,12,-6
2016-09-30,2016,PIT,STL,0,7,166,1.5,-139,7.5,-110,-110,-186,-1.5,119,2.82,Busch Stadium,7,-7
2016-09-30,2016,TEX,TB,3,1,-215,-1.5,-110,8.5,-115,-105,185,1.5,-110,5.8,Rangers Ballpark,4,2
2016-09-30,2016,TB,TEX,1,3,185,1.5,-110,8.5,-115,-105,-215,-1.5,-110,2.98,Rangers Ballpark,4,-2
2016-09-30,2016,BOS,TOR,5,3,-155,-1.5,135,8.5,-110,-110,140,1.5,-155,5.17,Fenway Park,8,2
2016-09-30,2016,MIA,WSH,7,4,130,1.5,-158,8.5,102,-122,-145,-1.5,139,3.7,Nationals Park,11,3
2016-10-01,2016,SD,ARI,5,9,116,1.5,-171,9.5,-120,100,-131,-1.5,151,4.4,Chase Field,14,-4
2016-10-01,2016,DET,ATL,3,5,-188,-1.5,-121,9.0,-120,100,168,1.5,101,5.88,Turner Field,8,-2
2016-10-01,2016,NYY,BAL,7,3,105,1.5,-151,8.5,100,-120,-115,-1.5,131,4.15,Yankee Stadium,10,4
2016-10-01,2016,TOR,BOS,4,3,-118,-1.5,140,9.0,-108,-112,108,1.5,-160,4.87,Fenway Park,7,1
2016-10-01,2016,CIN,CHC,7,4,190,1.5,127,8.0,-120,100,-220,-1.5,-147,2.76,Great American Ballpark,11,3
2016-10-01,2016,CHC,CIN,4,7,-220,-1.5,-147,8.0,-120,100,190,1.5,127,5.5,Great American Ballpark,11,-3
2016-10-01,2016,KC,CLE,3,6,128,1.5,-130,9.0,-103,-117,-143,-1.5,110,3.95,Kauffman Stadium,9,-3
2016-10-01,2016,MIL,COL,4,3,116,1.5,-162,12.5,-110,-110,-131,-1.5,143,5.79,Coors Field,7,1
2016-10-01,2016,MIN,CWS,6,0,112,1.5,-200,9.0,-110,-110,-122,-1.5,170,4.25,Guaranteed Rate Field,6,6
2016-10-01,2016,ATL,DET,5,3,168,1.5,101,9.0,-120,100,-188,-1.5,-121,3.36,Turner Field,8,2
2016-10-01,2016,LAA,HOU,0,3,105,1.5,-160,8.0,100,-120,-115,-1.5,140,3.9,Angel Stadium,3,-3
2016-10-01,2016,CLE,KC,6,3,-143,-1.5,110,9.0,-103,-117,128,1.5,-130,5.3,Kauffman Stadium,9,3
2016-10-01,2016,HOU,LAA,3,0,-115,-1.5,140,8.0,100,-120,105,1.5,-160,4.28,Angel Stadium,3,3
2016-10-01,2016,SF,LAD,3,0,185,1.5,109,7.0,-120,100,-215,-1.5,-129,2.46,AT&T Park,3,3
2016-10-01,2016,WSH,MIA,2,1,-170,-1.5,125,8.0,-105,-115,150,1.5,-145,5.04,Nationals Park,3,1
2016-10-01,2016,COL,MIL,3,4,-131,-1.5,143,12.5,-110,-110,116,1.5,-162,7.09,Coors Field,7,-1
2016-10-01,2016,CWS,MIN,0,6,-122,-1.5,170,9.0,-110,-110,112,1.5,-200,4.95,Guaranteed Rate Field,6,-6
2016-10-01,2016,PHI,NYM,3,5,150,1.5,-110,8.5,-120,100,-170,-1.5,-110,3.4,Citizens Bank Park,8,-2
2016-10-01,2016,BAL,NYY,3,7,-115,-1.5,131,8.5,100,-120,105,1.5,-151,4.55,Yankee Stadium,10,-4
2016-10-01,2016,SEA,OAK,8,9,-171,-1.5,120,7.5,-120,100,151,1.5,-137,4.73,T-Mobile Park,17,-1
2016-10-01,2016,NYM,PHI,5,3,-170,-1.5,-110,8.5,-120,100,150,1.5,-110,5.35,Citizens Bank Park,8,2
2016-10-01,2016,STL,PIT,4,3,-173,-1.5,119,8.5,-125,105,153,1.5,-139,5.39,Busch Stadium,7,1
2016-10-01,2016,ARI,SD,9,5,-131,-1.5,151,9.5,-120,100,116,1.5,-171,5.39,Chase Field,14,4
2016-10-01,2016,OAK,SEA,9,8,151,1.5,-137,7.5,-120,100,-171,-1.5,120,2.99,T-Mobile Park,17,1
2016-10-01,2016,LAD,SF,0,3,-215,-1.5,-129,7.0,-120,100,185,1.5,109,4.78,AT&T Park,3,-3
2016-10-01,2016,PIT,STL,3,4,153,1.5,-139,8.5,-125,105,-173,-1.5,119,3.36,Busch Stadium,7,-1
2016-10-01,2016,TEX,TB,1,4,106,1.5,-155,9.0,-115,-105,-116,-1.5,135,4.37,Rangers Ballpark,5,-3
2016-10-01,2016,TB,TEX,4,1,-116,-1.5,135,9.0,-115,-105,106,1.5,-155,4.83,Rangers Ballpark,5,3
2016-10-01,2016,BOS,TOR,3,4,108,1.5,-160,9.0,-108,-112,-118,-1.5,140,4.33,Fenway Park,7,-1
2016-10-01,2016,MIA,WSH,1,2,150,1.5,-145,8.0,-105,-115,-170,-1.5,125,3.2,Nationals Park,3,-1
2016-10-02,2016,SD,ARI,2,3,141,1.5,-150,10.0,-115,-105,-156,-1.5,130,4.15,Chase Field,5,-1
2016-10-02,2016,DET,ATL,0,1,-153,-1.5,105,7.5,-105,-115,138,1.5,-125,4.54,Turner Field,1,-1
2016-10-02,2016,NYY,BAL,2,5,127,1.5,-130,8.5,-106,-114,-142,-1.5,110,3.74,Yankee Stadium,7,-3
2016-10-02,2016,TOR,BOS,2,1,104,1.5,-200,8.5,-110,-110,-114,-1.5,170,4.17,Fenway Park,3,1
2016-10-02,2016,CIN,CHC,4,7,200,1.5,134,8.5,-115,-105,-240,-1.5,-153,2.83,Great American Ballpark,11,-3
2016-10-02,2016,CHC,CIN,7,4,-240,-1.5,-153,8.5,-115,-105,200,1.5,134,6.0,Great American Ballpark,11,3
2016-10-02,2016,KC,CLE,2,3,110,1.5,-155,8.0,-110,-110,-120,-1.5,135,3.81,Kauffman Stadium,5,-1
2016-10-02,2016,MIL,COL,6,4,136,1.5,-150,11.0,-125,105,-151,-1.5,130,4.66,Coors Field,10,2
2016-10-02,2016,MIN,CWS,6,3,225,1.5,105,7.5,-110,-110,-265,-1.5,-125,2.31,Guaranteed Rate Field,9,3
2016-10-02,2016,ATL,DET,1,0,138,1.5,-125,7.5,-105,-115,-153,-1.5,105,3.15,Turner Field,1,1
2016-10-02,2016,LAA,HOU,8,1,-124,-1.5,165,8.5,100,-120,114,1.5,-185,4.71,Angel Stadium,9,7
2016-10-02,2016,CLE,KC,3,2,-120,-1.5,135,8.0,-110,-110,110,1.5,-155,4.36,Kauffman Stadium,5,1
2016-10-02,2016,HOU,LAA,1,8,114,1.5,-185,8.5,100,-120,-124,-1.5,165,3.97,Angel Stadium,9,-7
2016-10-02,2016,SF,LAD,7,1,-116,-1.5,185,7.5,-113,-107,106,1.5,-215,4.03,AT&T Park,8,6
2016-10-02,2016,WSH,MIA,10,7,-260,-1.5,-113,7.0,-114,-106,220,1.5,-107,5.06,Nationals Park,17,3
2016-10-02,2016,COL,MIL,4,6,-151,-1.5,130,11.0,-125,105,136,1.5,-150,6.62,Coors Field,10,-2
2016-10-02,2016,CWS,MIN,3,6,-265,-1.5,-125,7.5,-110,-110,225,1.5,105,5.45,Guaranteed Rate Field,9,-3
2016-10-02,2016,PHI,NYM,5,2,-151,-1.5,135,8.5,-109,-111,136,1.5,-155,5.11,Citizens Bank Park,7,3
2016-10-02,2016,BAL,NYY,5,2,-142,-1.5,110,8.5,-106,-114,127,1.5,-130,4.99,Yankee Stadium,7,3
2016-10-02,2016,SEA,OAK,2,3,-121,-1.5,165,7.5,-110,-110,111,1.5,-185,4.11,T-Mobile Park,5,-1
2016-10-02,2016,NYM,PHI,2,5,136,1.5,-155,8.5,-109,-111,-151,-1.5,135,3.6,Citizens Bank Park,7,-3
2016-10-02,2016,STL,PIT,10,4,-215,-1.5,-110,8.5,-109,-111,185,1.5,-110,5.8,Busch Stadium,14,6
2016-10-02,2016,ARI,SD,3,2,-156,-1.5,130,10.0,-115,-105,141,1.5,-150,6.09,Chase Field,5,1
2016-10-02,2016,OAK,SEA,3,2,111,1.5,-185,7.5,-110,-110,-121,-1.5,165,3.55,T-Mobile Park,5,1
2016-10-02,2016,LAD,SF,1,7,106,1.5,-215,7.5,-113,-107,-116,-1.5,185,3.64,AT&T Park,8,-6
2016-10-02,2016,PIT,STL,4,10,185,1.5,-110,8.5,-109,-111,-215,-1.5,-110,2.98,Busch Stadium,14,-6
2016-10-02,2016,TEX,TB,4,6,-155,-1.5,132,9.5,-110,-110,140,1.5,-143,5.77,Rangers Ballpark,10,-2
2016-10-02,2016,TB,TEX,6,4,140,1.5,-143,9.5,-110,-110,-155,-1.5,132,3.96,Rangers Ballpark,10,2
2016-10-02,2016,BOS,TOR,1,2,-114,-1.5,170,8.5,-110,-110,104,1.5,-200,4.53,Fenway Park,3,-1
2016-10-02,2016,MIA,WSH,7,10,220,1.5,-107,7.0,-114,-106,-260,-1.5,-113,2.19,Nationals Park,17,-3
2017-04-02,2017,SF,ARI,5,6,-144,-1.5,110,8.5,-120,100,129,1.5,-130,5.02,Chase Field,11,-1
2017-04-02,2017,STL,CHC,4,3,116,1.5,-155,7.0,-120,100,-126,-1.5,135,3.24,Busch Stadium,7,1
2017-04-02,2017,TB,NYY,7,3,100,1.5,-175,7.0,-110,-110,-110,-1.5,151,3.5,Tropicana Field,10,4
2017-04-02,2017,ARI,SF,6,5,129,1.5,-130,8.5,-120,100,-144,-1.5,110,3.71,Chase Field,11,1
2017-04-02,2017,CHC,STL,3,4,-126,-1.5,135,7.0,-120,100,116,1.5,-155,3.9,Busch Stadium,7,-1
2017-04-02,2017,NYY,TB,3,7,-110,-1.5,151,7.0,-110,-110,100,1.5,-175,3.67,Tropicana Field,10,-4
2017-04-03,2017,NYM,ATL,6,0,-183,-1.5,120,7.0,-125,105,163,1.5,-140,4.53,Citi Field,6,6
2017-04-03,2017,TOR,BAL,2,3,116,1.5,-180,8.5,-120,100,-131,-1.5,155,3.94,Camden Yards,5,-1
2017-04-03,2017,PIT,BOS,3,5,130,1.5,-155,8.5,-115,-105,-145,-1.5,135,3.7,Fenway Park,8,-2
2017-04-03,2017,PHI,CIN,4,3,101,1.5,-205,8.5,-115,-105,-111,-1.5,172,4.23,Great American Ballpark,7,1
2017-04-03,2017,TEX,CLE,5,8,-101,1.5,-160,8.0,-110,-110,-109,-1.5,140,4.02,Rangers Ballpark,13,-3
2017-04-03,2017,MIL,COL,5,7,115,1.5,-150,8.5,-115,-105,-125,-1.5,130,3.95,Miller Park,12,-2
2017-04-03,2017,SEA,HOU,0,3,141,1.5,-155,8.5,-120,100,-156,-1.5,135,3.53,Minute Maid Park,3,-3
2017-04-03,2017,MIN,KC,7,1,-103,1.5,-174,8.0,-102,-118,-107,-1.5,150,4.06,Target Field,8,6
2017-04-03,2017,OAK,LAA,4,2,100,-1.5,180,8.0,-115,-105,-110,1.5,-215,4.0,Oakland Coliseum,6,2
2017-04-03,2017,SD,LAD,3,14,300,1.5,132,6.5,-120,100,-360,-1.5,-152,1.63,Dodger Stadium,17,-11
2017-04-03,2017,WSH,MIA,4,2,-215,-1.5,100,8.5,-114,-106,185,1.5,-120,5.8,Nationals Park,6,2
2017-04-03,2017,COL,MIL,7,5,-125,-1.5,130,8.5,-115,-105,115,1.5,-150,4.72,Miller Park,12,2
2017-04-03,2017,KC,MIN,1,7,-107,-1.5,150,8.0,-102,-118,-103,1.5,-174,4.14,Target Field,8,-6
2017-04-03,2017,ATL,NYM,0,6,163,1.5,-140,7.0,-125,105,-183,-1.5,120,2.66,Citi Field,6,-6
2017-04-03,2017,LAA,OAK,2,4,-110,1.5,-215,8.0,-115,-105,100,-1.5,180,4.19,Oakland Coliseum,6,-2
2017-04-03,2017,CIN,PHI,3,4,-111,-1.5,172,8.5,-115,-105,101,1.5,-205,4.47,Great American Ballpark,7,-1
2017-04-03,2017,BOS,PIT,5,3,-145,-1.5,135,8.5,-115,-105,130,1.5,-155,5.03,Fenway Park,8,2
2017-04-03,2017,LAD,SD,14,3,-360,-1.5,-152,6.5,-120,100,300,1.5,132,5.09,Dodger Stadium,17,11
2017-04-03,2017,HOU,SEA,3,0,-156,-1.5,135,8.5,-120,100,141,1.5,-155,5.18,Minute Maid Park,3,3
2017-04-03,2017,CLE,TEX,8,5,-109,-1.5,140,8.0,-110,-110,-101,1.5,-160,4.17,Rangers Ballpark,13,3
2017-04-03,2017,BAL,TOR,3,2,-131,-1.5,155,8.5,-120,100,116,1.5,-180,4.82,Camden Yards,5,1
2017-04-03,2017,MIA,WSH,2,4,185,1.5,-120,8.5,-114,-106,-215,-1.5,100,2.98,Nationals Park,6,-2
2017-04-04,2017,SF,ARI,8,4,-134,-1.5,120,9.0,-115,-105,119,1.5,-140,5.15,Chase Field,12,4
2017-04-04,2017,STL,CHC,1,2,130,1.5,-135,7.0,-110,-110,-145,-1.5,115,3.04,Busch Stadium,3,-1
2017-04-04,2017,TEX,CLE,3,4,153,1.5,-110,9.0,-125,105,-168,-1.5,-110,3.56,Rangers Ballpark,7,-1
2017-04-04,2017,MIL,COL,5,6,-102,1.5,-175,8.0,-110,-110,-108,-1.5,151,4.04,Miller Park,11,-1
2017-04-04,2017,DET,CWS,6,3,-125,-1.5,125,7.5,105,-125,115,1.5,-145,4.17,Guaranteed Rate Field,9,3
2017-04-04,2017,CWS,DET,3,6,115,1.5,-145,7.5,105,-125,-125,-1.5,125,3.49,Guaranteed Rate Field,9,-3
2017-04-04,2017,SEA,HOU,1,2,145,1.5,-145,8.5,-115,-105,-160,-1.5,125,3.47,Minute Maid Park,3,-1
2017-04-04,2017,OAK,LAA,6,7,107,1.5,-155,7.5,-120,100,-117,-1.5,135,3.62,Oakland Coliseum,13,-1
2017-04-04,2017,SD,LAD,4,0,203,1.5,-105,7.5,100,-120,-233,-1.5,-115,2.48,Dodger Stadium,4,4
2017-04-04,2017,COL,MIL,6,5,-108,-1.5,151,8.0,-110,-110,-102,1.5,-175,4.15,Miller Park,11,1
2017-04-04,2017,TB,NYY,0,5,-114,-1.5,180,7.5,-120,100,104,1.5,-215,4.0,Tropicana Field,5,-5
2017-04-04,2017,LAA,OAK,7,6,-117,-1.5,135,7.5,-120,100,107,1.5,-155,4.04,Oakland Coliseum,13,1
2017-04-04,2017,LAD,SD,0,4,-233,-1.5,-115,7.5,100,-120,203,1.5,-105,5.25,Dodger Stadium,4,-4
2017-04-04,2017,HOU,SEA,2,1,-160,-1.5,125,8.5,-115,-105,145,1.5,-145,5.23,Minute Maid Park,3,1
2017-04-04,2017,ARI,SF,4,8,119,1.5,-140,9.0,-115,-105,-134,-1.5,120,4.11,Chase Field,12,-4
2017-04-04,2017,CHC,STL,2,1,-145,-1.5,115,7.0,-110,-110,130,1.5,-135,4.14,Busch Stadium,3,1
2017-04-04,2017,NYY,TB,5,0,104,1.5,-215,7.5,-120,100,-114,-1.5,180,3.68,Tropicana Field,5,5
2017-04-04,2017,CLE,TEX,4,3,-168,-1.5,-110,9.0,-125,105,153,1.5,-110,5.64,Rangers Ballpark,7,1
2017-04-05,2017,SF,ARI,6,8,-101,1.5,-205,9.5,-110,-110,-109,-1.5,172,4.77,Chase Field,14,-2
2017-04-05,2017,NYM,ATL,1,3,-205,-1.5,105,7.0,-120,100,175,1.5,-125,4.7,Citi Field,4,-2
2017-04-05,2017,TOR,BAL,1,3,107,1.5,-205,8.5,-119,-101,-117,-1.5,172,4.11,Camden Yards,4,-2
2017-04-05,2017,PIT,BOS,0,3,150,1.5,-145,7.5,-115,-105,-165,-1.5,125,3.0,Fenway Park,3,-3
2017-04-05,2017,PHI,CIN,0,2,-105,1.5,-220,8.5,-110,-110,-105,-1.5,184,4.35,Great American Ballpark,2,-2
2017-04-05,2017,TEX,CLE,6,9,105,1.5,-165,8.0,-120,100,-115,-1.5,144,3.9,Rangers Ballpark,15,-3
2017-04-05,2017,MIL,COL,6,1,118,1.5,-150,9.0,-110,-110,-128,-1.5,130,4.13,Miller Park,7,5
2017-04-05,2017,SEA,HOU,3,5,-103,1.5,-215,7.5,-115,-105,-107,-1.5,180,3.81,Minute Maid Park,8,-2
2017-04-05,2017,MIN,KC,9,1,-117,-1.5,176,8.5,-101,-119,107,1.5,-210,4.58,Target Field,10,8
2017-04-05,2017,OAK,LAA,0,5,-102,1.5,-160,8.5,105,-125,-108,-1.5,140,4.29,Oakland Coliseum,5,-5
2017-04-05,2017,SD,LAD,1,3,205,1.5,-110,7.5,-110,-110,-245,-1.5,-110,2.46,Dodger Stadium,4,-2
2017-04-05,2017,WSH,MIA,6,4,-160,-1.5,130,8.5,-128,108,145,1.5,-150,5.23,Nationals Park,10,2
2017-04-05,2017,COL,MIL,1,6,-128,-1.5,130,9.0,-110,-110,118,1.5,-150,5.05,Miller Park,7,-5
2017-04-05,2017,KC,MIN,1,9,107,1.5,-210,8.5,-101,-119,-117,-1.5,176,4.11,Target Field,10,-8
2017-04-05,2017,ATL,NYM,3,1,175,1.5,-125,7.0,-120,100,-205,-1.5,105,2.55,Citi Field,4,2
2017-04-05,2017,TB,NYY,4,1,120,1.5,-150,7.5,100,-120,-135,-1.5,130,3.41,Tropicana Field,5,3
2017-04-05,2017,LAA,OAK,5,0,-108,-1.5,140,8.5,105,-125,-102,1.5,-160,4.41,Oakland Coliseum,5,5
2017-04-05,2017,CIN,PHI,2,0,-105,-1.5,184,8.5,-110,-110,-105,1.5,-220,4.35,Great American Ballpark,2,2
2017-04-05,2017,BOS,PIT,3,0,-165,-1.5,125,7.5,-115,-105,150,1.5,-145,4.67,Fenway Park,3,3
2017-04-05,2017,LAD,SD,3,1,-245,-1.5,-110,7.5,-110,-110,205,1.5,-110,5.33,Dodger Stadium,4,2
2017-04-05,2017,HOU,SEA,5,3,-107,-1.5,180,7.5,-115,-105,-103,1.5,-215,3.88,Minute Maid Park,8,2
2017-04-05,2017,ARI,SF,8,6,-109,-1.5,172,9.5,-110,-110,-101,1.5,-205,4.95,Chase Field,14,2
2017-04-05,2017,NYY,TB,1,4,-135,-1.5,130,7.5,100,-120,120,1.5,-150,4.31,Tropicana Field,5,-3
2017-04-05,2017,CLE,TEX,9,6,-115,-1.5,144,8.0,-120,100,105,1.5,-165,4.28,Rangers Ballpark,15,3
2017-04-05,2017,BAL,TOR,3,1,-117,-1.5,172,8.5,-119,-101,107,1.5,-205,4.58,Camden Yards,4,2
2017-04-05,2017,MIA,WSH,4,6,145,1.5,-150,8.5,-128,108,-160,-1.5,130,3.47,Nationals Park,10,-2
2017-04-06,2017,SF,ARI,3,9,100,1.5,-220,9.5,105,-125,-110,-1.5,184,4.75,Chase Field,12,-6
2017-04-06,2017,NYM,ATL,6,2,-140,-1.5,151,7.0,-125,105,125,1.5,-175,4.08,Citi Field,8,4
2017-04-06,2017,STL,CHC,4,6,116,1.5,-148,7.5,-115,-105,-126,-1.5,129,3.47,Busch Stadium,10,-2
2017-04-06,2017,PHI,CIN,4,7,117,1.5,-200,9.0,105,-125,-127,-1.5,170,4.15,Great American Ballpark,11,-3
2017-04-06,2017,MIL,COL,1,2,-103,-1.5,184,9.5,100,-120,-107,1.5,-220,4.82,Miller Park,3,-1
2017-04-06,2017,DET,CWS,2,11,-113,-1.5,140,9.0,-105,-115,103,1.5,-160,4.77,Guaranteed Rate Field,13,-9
2017-04-06,2017,CWS,DET,11,2,103,1.5,-160,9.0,-105,-115,-113,-1.5,140,4.43,Guaranteed Rate Field,13,9
2017-04-06,2017,SEA,HOU,4,2,142,1.5,-150,9.0,100,-120,-157,-1.5,130,3.72,Minute Maid Park,6,2
2017-04-06,2017,MIN,KC,5,3,-107,-1.5,192,8.0,-115,-105,-103,1.5,-230,4.14,Target Field,8,2
2017-04-06,2017,OAK,LAA,5,1,-109,-1.5,176,8.0,-115,-105,-101,1.5,-210,4.17,Oakland Coliseum,6,4
2017-04-06,2017,SD,LAD,2,10,210,1.5,105,8.5,-120,100,-250,-1.5,-125,2.74,Dodger Stadium,12,-8
2017-04-06,2017,WSH,MIA,3,4,-175,-1.5,120,9.0,-110,-110,155,1.5,-140,5.73,Nationals Park,7,-1
2017-04-06,2017,COL,MIL,2,1,-107,1.5,-220,9.5,100,-120,-103,-1.5,184,4.91,Miller Park,3,1
2017-04-06,2017,KC,MIN,3,5,-103,1.5,-230,8.0,-115,-105,-107,-1.5,192,4.06,Target Field,8,-2
2017-04-06,2017,ATL,NYM,2,6,125,1.5,-175,7.0,-125,105,-140,-1.5,151,3.11,Citi Field,8,-4
2017-04-06,2017,LAA,OAK,1,5,-101,1.5,-210,8.0,-115,-105,-109,-1.5,176,4.02,Oakland Coliseum,6,-4
2017-04-06,2017,CIN,PHI,7,4,-127,-1.5,170,9.0,105,-125,117,1.5,-200,5.04,Great American Ballpark,11,3
2017-04-06,2017,LAD,SD,10,2,-250,-1.5,-125,8.5,-120,100,210,1.5,105,6.07,Dodger Stadium,12,8
2017-04-06,2017,HOU,SEA,2,4,-157,-1.5,130,9.0,100,-120,142,1.5,-150,5.5,Minute Maid Park,6,-2
2017-04-06,2017,ARI,SF,9,3,-110,-1.5,184,9.5,105,-125,100,1.5,-220,4.98,Chase Field,12,6
2017-04-06,2017,CHC,STL,6,4,-126,-1.5,129,7.5,-115,-105,116,1.5,-148,4.18,Busch Stadium,10,2
2017-04-06,2017,TOR,TB,5,2,-139,-1.5,120,8.0,-105,-115,124,1.5,-140,4.65,Tropicana Field,7,3
2017-04-06,2017,TB,TOR,2,5,124,1.5,-140,8.0,-105,-115,-139,-1.5,120,3.57,Tropicana Field,7,-3
2017-04-06,2017,MIA,WSH,4,3,155,1.5,-140,9.0,-110,-110,-175,-1.5,120,3.53,Nationals Park,7,1
2017-04-07,2017,CLE,ARI,3,7,-133,-1.5,110,10.0,-115,-105,118,1.5,-130,5.71,Chase Field,10,-4
2017-04-07,2017,PIT,ATL,5,4,-143,-1.5,151,8.0,-105,-115,128,1.5,-175,4.71,PNC Park,9,1
2017-04-07,2017,NYY,BAL,5,6,-106,1.5,-220,8.5,105,-125,-104,-1.5,184,4.37,Camden Yards,11,-1
2017-04-07,2017,DET,BOS,6,5,-133,-1.5,160,8.0,-120,100,118,1.5,-185,4.57,Comerica Park,11,1
2017-04-07,2017,MIL,CHC,2,1,162,1.5,-105,9.0,-120,100,-182,-1.5,-115,3.44,Miller Park,3,1
2017-04-07,2017,STL,CIN,0,2,-167,-1.5,125,8.0,-110,-110,152,1.5,-145,5.0,Busch Stadium,2,-2
2017-04-07,2017,ARI,CLE,7,3,118,1.5,-130,10.0,-115,-105,-133,-1.5,110,4.59,Chase Field,10,4
2017-04-07,2017,LAD,COL,1,2,-154,-1.5,-105,12.5,-112,-108,139,1.5,-115,7.58,Coors Field,3,-1
2017-04-07,2017,MIN,CWS,3,1,101,1.5,-205,8.5,102,-122,-111,-1.5,172,4.23,Guaranteed Rate Field,4,2
2017-04-07,2017,BOS,DET,5,6,118,1.5,-185,8.0,-120,100,-133,-1.5,160,3.67,Comerica Park,11,-1
2017-04-07,2017,KC,HOU,5,1,130,1.5,-155,9.0,100,-120,-145,-1.5,135,3.91,Minute Maid Park,6,4
2017-04-07,2017,HOU,KC,1,5,-145,-1.5,135,9.0,100,-120,130,1.5,-155,5.33,Minute Maid Park,6,-4
2017-04-07,2017,SEA,LAA,1,5,115,1.5,-180,8.5,-105,-115,-130,-1.5,155,3.95,Angel Stadium,6,-4
2017-04-07,2017,COL,LAD,2,1,139,1.5,-115,12.5,-112,-108,-154,-1.5,-105,5.23,Coors Field,3,1
2017-04-07,2017,NYM,MIA,2,7,104,1.5,-170,7.5,105,-125,-114,-1.5,148,3.68,Citi Field,9,-5
2017-04-07,2017,CHC,MIL,1,2,-182,-1.5,-115,9.0,-120,100,162,1.5,-105,5.81,Miller Park,3,-1
2017-04-07,2017,CWS,MIN,1,3,-111,-1.5,172,8.5,102,-122,101,1.5,-205,4.47,Guaranteed Rate Field,4,-2
2017-04-07,2017,MIA,NYM,7,2,-114,-1.5,148,7.5,105,-125,104,1.5,-170,4.0,Citi Field,9,5
2017-04-07,2017,BAL,NYY,6,5,-104,-1.5,184,8.5,105,-125,-106,1.5,-220,4.33,Camden Yards,11,1
2017-04-07,2017,TEX,OAK,10,5,-157,-1.5,130,10.0,-120,100,142,1.5,-150,6.11,Rangers Ballpark,15,5
2017-04-07,2017,WSH,PHI,7,6,-175,-1.5,-110,7.0,-125,105,155,1.5,-110,4.45,Citizens Bank Park,13,1
2017-04-07,2017,ATL,PIT,4,5,128,1.5,-175,8.0,-105,-115,-143,-1.5,151,3.51,PNC Park,9,-1
2017-04-07,2017,SF,SD,6,7,-103,1.5,-215,8.5,-125,105,-107,-1.5,180,4.31,PETCO Park,13,-1
2017-04-07,2017,LAA,SEA,5,1,-130,-1.5,155,8.5,-105,-115,115,1.5,-180,4.8,Angel Stadium,6,4
2017-04-07,2017,SD,SF,7,6,-107,-1.5,180,8.5,-125,105,-103,1.5,-215,4.39,PETCO Park,13,1
2017-04-07,2017,CIN,STL,2,0,152,1.5,-145,8.0,-110,-110,-167,-1.5,125,3.17,Busch Stadium,2,2
2017-04-07,2017,TOR,TB,8,10,-114,-1.5,144,7.5,-118,-102,104,1.5,-165,4.0,Tropicana Field,18,-2
2017-04-07,2017,OAK,TEX,5,10,142,1.5,-150,10.0,-120,100,-157,-1.5,130,4.13,Rangers Ballpark,15,-5
2017-04-07,2017,TB,TOR,10,8,104,1.5,-165,7.5,-118,-102,-114,-1.5,144,3.68,Tropicana Field,18,2
2017-04-07,2017,PHI,WSH,6,7,155,1.5,-110,7.0,-125,105,-175,-1.5,-110,2.75,Citizens Bank Park,13,-1
2017-04-08,2017,CLE,ARI,2,11,-110,-1.5,142,9.5,-105,-115,100,1.5,-162,4.98,Chase Field,13,-9
2017-04-08,2017,PIT,ATL,6,4,-152,-1.5,140,8.5,-110,-110,137,1.5,-160,5.13,PNC Park,10,2
2017-04-08,2017,NYY,BAL,4,5,101,1.5,-210,7.5,-115,-105,-111,-1.5,176,3.73,Camden Yards,9,-1
2017-04-08,2017,DET,BOS,4,1,-118,-1.5,170,8.5,-110,-110,108,1.5,-200,4.6,Comerica Park,5,3
2017-04-08,2017,MIL,CHC,6,11,200,1.5,125,9.0,-105,-115,-240,-1.5,-145,3.0,Miller Park,17,-5
2017-04-08,2017,STL,CIN,10,4,-205,-1.5,105,8.5,-105,-115,175,1.5,-125,5.71,Busch Stadium,14,6
2017-04-08,2017,ARI,CLE,11,2,100,1.5,-162,9.5,-105,-115,-110,-1.5,142,4.75,Chase Field,13,9
2017-04-08,2017,LAD,COL,2,4,-215,-1.5,-133,9.0,-114,-106,185,1.5,113,6.14,Coors Field,6,-2
2017-04-08,2017,MIN,CWS,2,6,108,1.5,-200,9.0,100,-120,-118,-1.5,170,4.33,Guaranteed Rate Field,8,-4
2017-04-08,2017,BOS,DET,1,4,108,1.5,-200,8.5,-110,-110,-118,-1.5,170,4.09,Comerica Park,5,-3
2017-04-08,2017,KC,HOU,7,3,153,1.5,-140,7.5,-115,-105,-173,-1.5,120,2.96,Minute Maid Park,10,4
2017-04-08,2017,HOU,KC,3,7,-173,-1.5,120,7.5,-115,-105,153,1.5,-140,4.75,Minute Maid Park,10,-4
2017-04-08,2017,SEA,LAA,4,5,-126,-1.5,130,8.0,-105,-115,116,1.5,-150,4.46,Angel Stadium,9,-1
2017-04-08,2017,COL,LAD,4,2,185,1.5,113,9.0,-114,-106,-215,-1.5,-133,3.16,Coors Field,6,2
2017-04-08,2017,NYM,MIA,1,8,-119,-1.5,170,8.0,-115,-105,109,1.5,-200,4.35,Citi Field,9,-7
2017-04-08,2017,CHC,MIL,11,6,-240,-1.5,-145,9.0,-105,-115,200,1.5,125,6.35,Miller Park,17,5
2017-04-08,2017,CWS,MIN,6,2,-118,-1.5,170,9.0,100,-120,108,1.5,-200,4.87,Guaranteed Rate Field,8,4
2017-04-08,2017,MIA,NYM,8,1,109,1.5,-200,8.0,-115,-105,-119,-1.5,170,3.83,Citi Field,9,7
2017-04-08,2017,BAL,NYY,5,4,-111,-1.5,176,7.5,-115,-105,101,1.5,-210,3.95,Camden Yards,9,1
2017-04-08,2017,TEX,OAK,1,6,-170,-1.5,110,9.0,100,-120,150,1.5,-130,5.67,Rangers Ballpark,7,-5
2017-04-08,2017,WSH,PHI,3,17,100,1.5,-210,8.5,-110,-110,-110,-1.5,176,4.25,Citizens Bank Park,20,-14
2017-04-08,2017,ATL,PIT,4,6,137,1.5,-160,8.5,-110,-110,-152,-1.5,140,3.59,PNC Park,10,-2
2017-04-08,2017,SF,SD,1,2,-215,-1.5,-135,7.5,-120,100,185,1.5,115,5.12,PETCO Park,3,-1
2017-04-08,2017,LAA,SEA,5,4,116,1.5,-150,8.0,-105,-115,-126,-1.5,130,3.7,Angel Stadium,9,1
2017-04-08,2017,SD,SF,2,1,185,1.5,115,7.5,-120,100,-215,-1.5,-135,2.63,PETCO Park,3,1
2017-04-08,2017,CIN,STL,4,10,175,1.5,-125,8.5,-105,-115,-205,-1.5,105,3.09,Busch Stadium,14,-6
2017-04-08,2017,TOR,TB,2,3,110,1.5,-210,7.5,-118,-102,-120,-1.5,176,3.57,Tropicana Field,5,-1
2017-04-08,2017,OAK,TEX,6,1,150,1.5,-130,9.0,100,-120,-170,-1.5,110,3.6,Rangers Ballpark,7,5
2017-04-08,2017,TB,TOR,3,2,-120,-1.5,176,7.5,-118,-102,110,1.5,-210,4.09,Tropicana Field,5,1
2017-04-08,2017,PHI,WSH,17,3,-110,-1.5,176,8.5,-110,-110,100,1.5,-210,4.45,Citizens Bank Park,20,14
2017-04-09,2017,CLE,ARI,2,3,-172,-1.5,-115,9.5,100,-120,152,1.5,-105,6.01,Chase Field,5,-1
2017-04-09,2017,PIT,ATL,6,5,-131,-1.5,166,7.5,-105,-115,116,1.5,-195,4.25,PNC Park,11,1
2017-04-09,2017,NYY,BAL,7,3,118,1.5,-185,8.5,-120,100,-128,-1.5,160,3.9,Camden Yards,10,4
2017-04-09,2017,DET,BOS,5,7,-112,-1.5,180,8.5,-110,-110,102,1.5,-215,4.49,Comerica Park,12,-2
2017-04-09,2017,MIL,CHC,4,7,156,1.5,-110,8.0,-125,105,-176,-1.5,-110,3.13,Miller Park,11,-3
2017-04-09,2017,STL,CIN,0,8,-181,-1.5,110,8.0,-120,100,161,1.5,-130,5.15,Busch Stadium,8,-8
2017-04-09,2017,ARI,CLE,3,2,152,1.5,-105,9.5,100,-120,-172,-1.5,-115,3.77,Chase Field,5,1
2017-04-09,2017,LAD,COL,10,6,-116,-1.5,130,10.0,-105,-115,106,1.5,-150,5.37,Coors Field,16,4
2017-04-09,2017,MIN,CWS,4,1,120,1.5,-180,8.0,-115,-105,-135,-1.5,155,3.64,Guaranteed Rate Field,5,3
2017-04-09,2017,BOS,DET,7,5,102,1.5,-215,8.5,-110,-110,-112,-1.5,180,4.21,Comerica Park,12,2
2017-04-09,2017,KC,HOU,4,5,170,1.5,-119,8.5,100,-120,-200,-1.5,-101,3.15,Minute Maid Park,9,-1
2017-04-09,2017,HOU,KC,5,4,-200,-1.5,-101,8.5,100,-120,170,1.5,-119,5.67,Minute Maid Park,9,1
2017-04-09,2017,SEA,LAA,9,10,118,1.5,-190,8.5,100,-120,-128,-1.5,163,3.9,Angel Stadium,19,-1
2017-04-09,2017,COL,LAD,6,10,106,1.5,-150,10.0,-105,-115,-116,-1.5,130,4.85,Coors Field,16,-4
2017-04-09,2017,NYM,MIA,5,2,-190,-1.5,115,7.0,-105,-115,170,1.5,-135,4.59,Citi Field,7,3
2017-04-09,2017,CHC,MIL,7,4,-176,-1.5,-110,8.0,-125,105,156,1.5,-110,5.1,Miller Park,11,3
2017-04-09,2017,CWS,MIN,1,4,-135,-1.5,155,8.0,-115,-105,120,1.5,-180,4.6,Guaranteed Rate Field,5,-3
2017-04-09,2017,MIA,NYM,2,5,170,1.5,-135,7.0,-105,-115,-190,-1.5,115,2.59,Citi Field,7,-3
2017-04-09,2017,BAL,NYY,3,7,-128,-1.5,160,8.5,-120,100,118,1.5,-185,4.77,Camden Yards,10,-4
2017-04-09,2017,TEX,OAK,8,1,115,1.5,-150,10.0,100,-120,-125,-1.5,130,4.65,Rangers Ballpark,9,7
2017-04-09,2017,WSH,PHI,3,4,-165,-1.5,-110,8.0,-120,100,150,1.5,-110,4.98,Citizens Bank Park,7,-1
2017-04-09,2017,ATL,PIT,5,6,116,1.5,-195,7.5,-105,-115,-131,-1.5,166,3.47,PNC Park,11,-1
2017-04-09,2017,SF,SD,5,3,-163,-1.5,100,7.0,-125,105,148,1.5,-120,4.34,PETCO Park,8,2
2017-04-09,2017,LAA,SEA,10,9,-128,-1.5,163,8.5,100,-120,118,1.5,-190,4.77,Angel Stadium,19,1
2017-04-09,2017,SD,SF,3,5,148,1.5,-120,7.0,-125,105,-163,-1.5,100,2.82,PETCO Park,8,-2
2017-04-09,2017,CIN,STL,8,0,161,1.5,-130,8.0,-120,100,-181,-1.5,110,3.07,Busch Stadium,8,8
2017-04-09,2017,TOR,TB,2,7,-116,-1.5,144,8.0,-110,-110,106,1.5,-165,4.3,Tropicana Field,9,-5
2017-04-09,2017,OAK,TEX,1,8,-125,-1.5,130,10.0,100,-120,115,1.5,-150,5.56,Rangers Ballpark,9,-7
2017-04-09,2017,TB,TOR,7,2,106,1.5,-165,8.0,-110,-110,-116,-1.5,144,3.88,Tropicana Field,9,5
2017-04-09,2017,PHI,WSH,4,3,150,1.5,-110,8.0,-120,100,-165,-1.5,-110,3.2,Citizens Bank Park,7,1
2017-04-10,2017,SF,ARI,4,1,-128,-1.5,170,8.0,100,-120,118,1.5,-200,4.49,AT&T Park,5,3
2017-04-10,2017,DET,BOS,2,1,100,1.5,-190,7.5,-110,-110,-110,-1.5,163,3.75,Comerica Park,3,1
2017-04-10,2017,LAD,CHC,2,3,136,1.5,-155,7.0,-125,105,-151,-1.5,135,2.97,Wrigley Field,5,-1
2017-04-10,2017,PIT,CIN,1,7,-143,-1.5,151,8.5,-120,100,128,1.5,-175,5.0,PNC Park,8,-6
2017-04-10,2017,SD,COL,5,3,165,1.5,-119,11.0,105,-125,-185,-1.5,-101,4.15,Coors Field,8,2
2017-04-10,2017,BOS,DET,1,2,-110,-1.5,163,7.5,-110,-110,100,1.5,-190,3.93,Comerica Park,3,-1
2017-04-10,2017,SEA,HOU,6,0,-138,-1.5,155,7.5,105,-125,123,1.5,-180,4.35,T-Mobile Park,6,6
2017-04-10,2017,OAK,KC,2,0,107,1.5,-205,8.5,-120,100,-117,-1.5,172,4.11,Kauffman Stadium,2,2
2017-04-10,2017,CHC,LAD,3,2,-151,-1.5,135,7.0,-125,105,136,1.5,-155,4.21,Wrigley Field,5,1
2017-04-10,2017,PHI,NYM,3,4,132,1.5,-132,8.0,-105,-115,-147,-1.5,113,3.45,Citizens Bank Park,7,-1
2017-04-10,2017,TB,NYY,1,8,121,1.5,-180,8.0,-120,100,-136,-1.5,155,3.62,Yankee Stadium,9,-7
2017-04-10,2017,KC,OAK,0,2,-117,-1.5,172,8.5,-120,100,107,1.5,-205,4.58,Kauffman Stadium,2,-2
2017-04-10,2017,NYM,PHI,4,3,-147,-1.5,113,8.0,-105,-115,132,1.5,-132,4.76,Citizens Bank Park,7,1
2017-04-10,2017,CIN,PIT,7,1,128,1.5,-175,8.5,-120,100,-143,-1.5,151,3.73,PNC Park,8,6
2017-04-10,2017,COL,SD,3,5,-185,-1.5,-101,11.0,105,-125,165,1.5,-119,7.14,Coors Field,8,-2
2017-04-10,2017,HOU,SEA,0,6,123,1.5,-180,7.5,105,-125,-138,-1.5,155,3.36,T-Mobile Park,6,-6
2017-04-10,2017,ARI,SF,1,4,118,1.5,-200,8.0,100,-120,-128,-1.5,170,3.67,AT&T Park,5,-3
2017-04-10,2017,WSH,STL,14,6,-120,-1.5,170,8.5,-110,-110,110,1.5,-200,4.64,Nationals Park,20,8
2017-04-10,2017,NYY,TB,8,1,-136,-1.5,155,8.0,-120,100,121,1.5,-180,4.61,Yankee Stadium,9,7
2017-04-10,2017,STL,WSH,6,14,110,1.5,-200,8.5,-110,-110,-120,-1.5,170,4.05,Nationals Park,20,-8
2017-04-11,2017,SF,ARI,3,4,-112,-1.5,180,7.5,-125,105,102,1.5,-215,3.96,AT&T Park,7,-1
2017-04-11,2017,MIA,ATL,8,4,-129,-1.5,155,8.5,105,-125,119,1.5,-180,4.79,Marlins Park,12,4
2017-04-11,2017,BOS,BAL,8,1,-115,-1.5,175,9.0,-110,-110,105,1.5,-208,4.81,Fenway Park,9,7
2017-04-11,2017,BAL,BOS,1,8,105,1.5,-208,9.0,-110,-110,-115,-1.5,175,4.39,Fenway Park,9,-7
2017-04-11,2017,PIT,CIN,2,6,-183,-1.5,110,8.5,-115,-105,163,1.5,-130,5.5,PNC Park,8,-4
2017-04-11,2017,CWS,CLE,1,2,255,1.5,120,8.5,104,-124,-295,-1.5,-140,2.39,Progressive Field,3,-1
2017-04-11,2017,SD,COL,2,3,160,1.5,-120,12.0,-105,-115,-180,-1.5,100,4.62,Coors Field,5,-1
2017-04-11,2017,CLE,CWS,2,1,-295,-1.5,-140,8.5,104,-124,255,1.5,120,6.35,Progressive Field,3,1
2017-04-11,2017,MIN,DET,1,2,116,1.5,-175,9.5,105,-125,-131,-1.5,151,4.4,Comerica Park,3,-1
2017-04-11,2017,SEA,HOU,5,7,118,1.5,-150,8.5,-108,-112,-128,-1.5,130,3.9,T-Mobile Park,12,-2
2017-04-11,2017,TEX,LAA,5,6,104,1.5,-190,8.0,100,-120,-114,-1.5,163,3.92,Angel Stadium,11,-1
2017-04-11,2017,ATL,MIA,4,8,119,1.5,-180,8.5,105,-125,-129,-1.5,155,3.88,Marlins Park,12,-4
2017-04-11,2017,TOR,MIL,3,4,-166,-1.5,120,8.0,-115,-105,151,1.5,-140,4.99,Rogers Centre,7,-1
2017-04-11,2017,DET,MIN,2,1,-131,-1.5,151,9.5,105,-125,116,1.5,-175,5.39,Comerica Park,3,1
2017-04-11,2017,PHI,NYM,4,14,131,1.5,-125,9.0,-115,-105,-146,-1.5,105,3.9,Citizens Bank Park,18,-10
2017-04-11,2017,NYM,PHI,14,4,-146,-1.5,105,9.0,-115,-105,131,1.5,-125,5.34,Citizens Bank Park,18,10
2017-04-11,2017,CIN,PIT,6,2,163,1.5,-130,8.5,-115,-105,-183,-1.5,110,3.23,PNC Park,8,4
2017-04-11,2017,COL,SD,3,2,-180,-1.5,100,12.0,-105,-115,160,1.5,-120,7.71,Coors Field,5,1
2017-04-11,2017,HOU,SEA,7,5,-128,-1.5,130,8.5,-108,-112,118,1.5,-150,4.77,T-Mobile Park,12,2
2017-04-11,2017,ARI,SF,4,3,102,1.5,-215,7.5,-125,105,-112,-1.5,180,3.71,AT&T Park,7,1
2017-04-11,2017,WSH,STL,8,3,-140,-1.5,155,8.5,-115,-105,125,1.5,-180,4.96,Nationals Park,11,5
2017-04-11,2017,LAA,TEX,6,5,-114,-1.5,163,8.0,100,-120,104,1.5,-190,4.26,Angel Stadium,11,1
2017-04-11,2017,MIL,TOR,4,3,151,1.5,-140,8.0,-115,-105,-166,-1.5,120,3.19,Rogers Centre,7,1
2017-04-11,2017,STL,WSH,3,8,125,1.5,-180,8.5,-115,-105,-140,-1.5,155,3.78,Nationals Park,11,-5
2017-04-12,2017,SF,ARI,6,2,-111,-1.5,171,8.5,-110,-110,101,1.5,-203,4.47,AT&T Park,8,4
2017-04-12,2017,MIA,ATL,4,5,-109,-1.5,180,8.0,-108,-112,-101,1.5,-215,4.17,Marlins Park,9,-1
2017-04-12,2017,BOS,BAL,5,12,-137,-1.5,140,9.5,-112,-108,122,1.5,-160,5.49,Fenway Park,17,-7
2017-04-12,2017,BAL,BOS,12,5,122,1.5,-160,9.5,-112,-108,-137,-1.5,140,4.28,Fenway Park,17,7
2017-04-12,2017,LAD,CHC,2,0,116,1.5,-195,7.0,105,-125,-126,-1.5,166,3.24,Wrigley Field,2,2
2017-04-12,2017,PIT,CIN,2,9,-147,-1.5,153,8.0,-125,105,132,1.5,-176,4.76,PNC Park,11,-7
2017-04-12,2017,CWS,CLE,2,1,220,1.5,101,8.0,-110,-110,-260,-1.5,-121,2.5,Progressive Field,3,1
2017-04-12,2017,SD,COL,6,0,138,1.5,-140,12.0,100,-120,-153,-1.5,120,5.04,Coors Field,6,6
2017-04-12,2017,CLE,CWS,1,2,-260,-1.5,-121,8.0,-110,-110,220,1.5,101,5.78,Progressive Field,3,-1
2017-04-12,2017,MIN,DET,3,5,122,1.5,-180,8.5,-105,-115,-137,-1.5,155,3.83,Comerica Park,8,-2
2017-04-12,2017,SEA,HOU,5,10,113,1.5,-155,8.5,-105,-115,-123,-1.5,135,3.99,T-Mobile Park,15,-5
2017-04-12,2017,OAK,KC,8,3,106,1.5,-205,8.5,-120,100,-116,-1.5,172,4.13,Kauffman Stadium,11,5
2017-04-12,2017,TEX,LAA,8,3,122,1.5,-175,8.5,100,-120,-137,-1.5,151,3.83,Angel Stadium,11,5
2017-04-12,2017,CHC,LAD,0,2,-126,-1.5,166,7.0,105,-125,116,1.5,-195,3.9,Wrigley Field,2,-2
2017-04-12,2017,ATL,MIA,5,4,-101,1.5,-215,8.0,-108,-112,-109,-1.5,180,4.02,Marlins Park,9,1
2017-04-12,2017,TOR,MIL,0,2,-218,-1.5,-110,8.5,-115,-105,188,1.5,-110,5.83,Rogers Centre,2,-2
2017-04-12,2017,DET,MIN,5,3,-137,-1.5,155,8.5,-105,-115,122,1.5,-180,4.91,Comerica Park,8,2
2017-04-12,2017,PHI,NYM,4,5,-118,-1.5,184,8.0,-119,-101,108,1.5,-220,4.33,Citizens Bank Park,9,-1
2017-04-12,2017,TB,NYY,4,8,115,1.5,-180,8.0,-118,-102,-125,-1.5,155,3.72,Yankee Stadium,12,-4
2017-04-12,2017,KC,OAK,3,8,-116,-1.5,172,8.5,-120,100,106,1.5,-205,4.56,Kauffman Stadium,11,-5
2017-04-12,2017,NYM,PHI,5,4,108,1.5,-220,8.0,-119,-101,-118,-1.5,184,3.85,Citizens Bank Park,9,1
2017-04-12,2017,CIN,PIT,9,2,132,1.5,-176,8.0,-125,105,-147,-1.5,153,3.45,PNC Park,11,7
2017-04-12,2017,COL,SD,0,6,-153,-1.5,120,12.0,100,-120,138,1.5,-140,7.26,Coors Field,6,-6
2017-04-12,2017,HOU,SEA,10,5,-123,-1.5,135,8.5,-105,-115,113,1.5,-155,4.69,T-Mobile Park,15,5
2017-04-12,2017,ARI,SF,2,6,101,1.5,-203,8.5,-110,-110,-111,-1.5,171,4.23,AT&T Park,8,-4
2017-04-12,2017,WSH,STL,1,6,-180,-1.5,122,8.0,-105,-115,160,1.5,-143,5.14,Nationals Park,7,-5
2017-04-12,2017,NYY,TB,8,4,-125,-1.5,155,8.0,-118,-102,115,1.5,-180,4.44,Yankee Stadium,12,4
2017-04-12,2017,LAA,TEX,3,8,-137,-1.5,151,8.5,100,-120,122,1.5,-175,4.91,Angel Stadium,11,-5
2017-04-12,2017,MIL,TOR,2,0,188,1.5,-110,8.5,-115,-105,-218,-1.5,-110,2.95,Rogers Centre,2,2
2017-04-12,2017,STL,WSH,6,1,160,1.5,-143,8.0,-105,-115,-180,-1.5,122,3.08,Nationals Park,7,5
2017-04-13,2017,TOR,BAL,1,2,-119,-1.5,172,8.5,100,-120,109,1.5,-205,4.62,Rogers Centre,3,-1
2017-04-13,2017,PIT,BOS,3,4,150,1.5,-133,9.5,-110,-110,-170,-1.5,113,3.8,Fenway Park,7,-1
2017-04-13,2017,LAD,CHC,0,4,111,1.5,-205,7.0,-110,-110,-121,-1.5,172,3.32,Wrigley Field,4,-4
2017-04-13,2017,MIL,CIN,5,1,-114,-1.5,142,9.0,-108,-112,104,1.5,-162,4.79,Great American Ballpark,6,4
2017-04-13,2017,CWS,CLE,10,4,175,1.5,-119,8.0,-111,-109,-205,-1.5,-101,2.91,Progressive Field,14,6
2017-04-13,2017,SF,COL,1,3,-172,-1.5,135,6.5,-115,-105,152,1.5,-156,4.11,AT&T Park,4,-2
2017-04-13,2017,CLE,CWS,4,10,-205,-1.5,-101,8.0,-111,-109,175,1.5,-119,5.38,Progressive Field,14,-6
2017-04-13,2017,MIN,DET,11,5,118,1.5,-182,8.5,100,-120,-128,-1.5,157,3.9,Comerica Park,16,6
2017-04-13,2017,OAK,KC,1,3,123,1.5,-180,9.0,-105,-115,-138,-1.5,155,4.04,Kauffman Stadium,4,-2
2017-04-13,2017,TEX,LAA,8,3,-129,-1.5,128,8.0,-107,-113,119,1.5,-148,4.51,Angel Stadium,11,5
2017-04-13,2017,CHC,LAD,4,0,-121,-1.5,172,7.0,-110,-110,111,1.5,-205,3.83,Wrigley Field,4,4
2017-04-13,2017,NYM,MIA,9,8,118,1.5,-181,8.0,-105,-115,-128,-1.5,156,3.67,Marlins Park,17,1
2017-04-13,2017,CIN,MIL,1,5,104,1.5,-162,9.0,-108,-112,-114,-1.5,142,4.41,Great American Ballpark,6,-4
2017-04-13,2017,DET,MIN,5,11,-128,-1.5,157,8.5,100,-120,118,1.5,-182,4.77,Comerica Park,16,-6
2017-04-13,2017,MIA,NYM,8,9,-128,-1.5,156,8.0,-105,-115,118,1.5,-181,4.49,Marlins Park,17,-1
2017-04-13,2017,TB,NYY,2,3,127,1.5,-170,8.0,-110,-110,-142,-1.5,148,3.52,Yankee Stadium,5,-1
2017-04-13,2017,KC,OAK,3,1,-138,-1.5,155,9.0,-105,-115,123,1.5,-180,5.22,Kauffman Stadium,4,2
2017-04-13,2017,BOS,PIT,4,3,-170,-1.5,113,9.5,-110,-110,150,1.5,-133,5.98,Fenway Park,7,1
2017-04-13,2017,COL,SF,3,1,152,1.5,-156,6.5,-115,-105,-172,-1.5,135,2.58,AT&T Park,4,2
2017-04-13,2017,NYY,TB,3,2,-142,-1.5,148,8.0,-110,-110,127,1.5,-170,4.69,Yankee Stadium,5,1
2017-04-13,2017,LAA,TEX,3,8,119,1.5,-148,8.0,-107,-113,-129,-1.5,128,3.65,Angel Stadium,11,-5
2017-04-13,2017,BAL,TOR,2,1,109,1.5,-205,8.5,100,-120,-119,-1.5,172,4.07,Rogers Centre,3,1
2017-04-14,2017,LAD,ARI,7,1,-255,-1.5,-105,6.0,-120,100,215,1.5,-115,4.31,Dodger Stadium,8,6
2017-04-14,2017,SD,ATL,2,5,126,1.5,-173,8.0,-108,-112,-141,-1.5,150,3.54,Suntrust Park,7,-3
2017-04-14,2017,TOR,BAL,4,6,-136,-1.5,146,8.0,-110,-110,121,1.5,-168,4.61,Rogers Centre,10,-2
2017-04-14,2017,TB,BOS,10,5,117,1.5,-195,8.0,-120,100,-127,-1.5,166,3.69,Fenway Park,15,5
2017-04-14,2017,PIT,CHC,4,2,145,1.5,-151,7.0,-120,100,-160,-1.5,131,2.86,Wrigley Field,6,2
2017-04-14,2017,MIL,CIN,10,4,103,1.5,-200,9.0,-105,-115,-113,-1.5,170,4.43,Great American Ballpark,14,6
2017-04-14,2017,DET,CLE,7,6,141,1.5,-160,8.5,-105,-115,-156,-1.5,140,3.53,Progressive Field,13,1
2017-04-14,2017,SF,COL,8,2,-142,-1.5,163,6.5,-115,-105,127,1.5,-190,3.81,AT&T Park,10,6
2017-04-14,2017,MIN,CWS,1,2,-161,-1.5,125,9.5,100,-120,146,1.5,-145,5.86,Target Field,3,-1
2017-04-14,2017,CLE,DET,6,7,-156,-1.5,140,8.5,-105,-115,141,1.5,-160,5.18,Progressive Field,13,-1
2017-04-14,2017,OAK,HOU,2,7,108,1.5,-165,7.5,110,-130,-118,-1.5,144,3.61,Oakland Coliseum,9,-5
2017-04-14,2017,LAA,KC,1,7,116,1.5,-175,9.0,-115,-105,-131,-1.5,151,4.17,Kauffman Stadium,8,-6
2017-04-14,2017,KC,LAA,7,1,-131,-1.5,151,9.0,-115,-105,116,1.5,-175,5.1,Kauffman Stadium,8,6
2017-04-14,2017,ARI,LAD,1,7,215,1.5,-115,6.0,-120,100,-255,-1.5,-105,1.9,Dodger Stadium,8,-6
2017-04-14,2017,NYM,MIA,2,3,-161,-1.5,104,7.5,-105,-115,146,1.5,-124,4.63,Marlins Park,5,-1
2017-04-14,2017,CIN,MIL,4,10,-113,-1.5,170,9.0,-105,-115,103,1.5,-200,4.77,Great American Ballpark,14,-6
2017-04-14,2017,CWS,MIN,2,1,146,1.5,-145,9.5,100,-120,-161,-1.5,125,3.86,Target Field,3,1
2017-04-14,2017,MIA,NYM,3,2,146,1.5,-124,7.5,-105,-115,-161,-1.5,104,3.05,Marlins Park,5,1
2017-04-14,2017,STL,NYY,3,4,117,1.5,-205,7.5,-110,-110,-127,-1.5,172,3.46,Yankee Stadium,7,-1
2017-04-14,2017,HOU,OAK,7,2,-118,-1.5,144,7.5,110,-130,108,1.5,-165,4.06,Oakland Coliseum,9,5
2017-04-14,2017,WSH,PHI,3,2,-182,-1.5,120,7.5,-105,-115,162,1.5,-140,4.84,Nationals Park,5,1
2017-04-14,2017,CHC,PIT,2,4,-160,-1.5,131,7.0,-120,100,145,1.5,-151,4.31,Wrigley Field,6,-2
2017-04-14,2017,ATL,SD,5,2,-141,-1.5,150,8.0,-108,-112,126,1.5,-173,4.68,Suntrust Park,7,3
2017-04-14,2017,TEX,SEA,1,2,120,1.5,-180,7.5,-120,100,-135,-1.5,155,3.41,T-Mobile Park,3,-1
2017-04-14,2017,COL,SF,2,8,127,1.5,-190,6.5,-115,-105,-142,-1.5,163,2.86,AT&T Park,10,-6
2017-04-14,2017,NYY,STL,4,3,-127,-1.5,172,7.5,-110,-110,117,1.5,-205,4.2,Yankee Stadium,7,1
2017-04-14,2017,BOS,TB,5,10,-127,-1.5,166,8.0,-120,100,117,1.5,-195,4.48,Fenway Park,15,-5
2017-04-14,2017,SEA,TEX,2,1,-135,-1.5,155,7.5,-120,100,120,1.5,-180,4.31,T-Mobile Park,3,1
2017-04-14,2017,BAL,TOR,6,4,121,1.5,-168,8.0,-110,-110,-136,-1.5,146,3.62,Rogers Centre,10,2
2017-04-14,2017,PHI,WSH,2,3,162,1.5,-140,7.5,-105,-115,-182,-1.5,120,2.86,Nationals Park,5,-1
2017-04-15,2017,LAD,ARI,8,4,-180,-1.5,115,7.5,-115,-105,160,1.5,-135,4.82,Dodger Stadium,12,4
2017-04-15,2017,SD,ATL,2,4,-105,-1.5,160,8.5,-115,-105,-105,1.5,-185,4.35,Suntrust Park,6,-2
2017-04-15,2017,TOR,BAL,2,1,-122,-1.5,156,9.0,-120,100,112,1.5,-181,4.95,Rogers Centre,3,1
2017-04-15,2017,TB,BOS,1,2,190,1.5,-108,8.5,-112,-108,-220,-1.5,-112,2.93,Fenway Park,3,-1
2017-04-15,2017,PIT,CHC,8,7,216,1.5,-101,10.5,-110,-110,-256,-1.5,-119,3.32,Wrigley Field,15,1
2017-04-15,2017,MIL,CIN,5,7,101,1.5,-200,8.5,-115,-105,-111,-1.5,170,4.23,Great American Ballpark,12,-2
2017-04-15,2017,DET,CLE,6,13,150,1.5,-145,8.0,-110,-110,-165,-1.5,125,3.2,Progressive Field,19,-7
2017-04-15,2017,SF,COL,0,5,-130,-1.5,163,7.5,-120,100,115,1.5,-190,4.24,AT&T Park,5,-5
2017-04-15,2017,MIN,CWS,6,0,-113,-1.5,170,7.0,-115,-105,103,1.5,-200,3.71,Target Field,6,6
2017-04-15,2017,CLE,DET,13,6,-165,-1.5,125,8.0,-110,-110,150,1.5,-145,4.98,Progressive Field,19,7
2017-04-15,2017,OAK,HOU,6,10,140,1.5,-120,7.5,-109,-111,-155,-1.5,100,3.13,Oakland Coliseum,16,-4
2017-04-15,2017,LAA,KC,2,3,-115,-1.5,142,9.0,-110,-110,105,1.5,-162,4.81,Kauffman Stadium,5,-1
2017-04-15,2017,KC,LAA,3,2,105,1.5,-162,9.0,-110,-110,-115,-1.5,142,4.39,Kauffman Stadium,5,1
2017-04-15,2017,ARI,LAD,4,8,160,1.5,-135,7.5,-115,-105,-180,-1.5,115,2.88,Dodger Stadium,12,-4
2017-04-15,2017,NYM,MIA,4,5,-121,-1.5,135,7.5,-110,-110,111,1.5,-155,4.11,Marlins Park,9,-1
2017-04-15,2017,CIN,MIL,7,5,-111,-1.5,170,8.5,-115,-105,101,1.5,-200,4.47,Great American Ballpark,12,2
2017-04-15,2017,CWS,MIN,0,6,103,1.5,-200,7.0,-115,-105,-113,-1.5,170,3.45,Target Field,6,-6
2017-04-15,2017,MIA,NYM,5,4,111,1.5,-155,7.5,-110,-110,-121,-1.5,135,3.55,Marlins Park,9,1
2017-04-15,2017,STL,NYY,2,3,-142,-1.5,125,8.0,-121,101,127,1.5,-145,4.69,Yankee Stadium,5,-1
2017-04-15,2017,HOU,OAK,10,6,-155,-1.5,100,7.5,-109,-111,140,1.5,-120,4.56,Oakland Coliseum,16,4
2017-04-15,2017,WSH,PHI,2,4,-155,-1.5,140,8.0,-110,-110,140,1.5,-160,4.86,Nationals Park,6,-2
2017-04-15,2017,CHC,PIT,7,8,-256,-1.5,-119,10.5,-110,-110,216,1.5,-101,7.55,Wrigley Field,15,-1
2017-04-15,2017,ATL,SD,4,2,-105,1.5,-185,8.5,-115,-105,-105,-1.5,160,4.35,Suntrust Park,6,2
2017-04-15,2017,TEX,SEA,0,5,160,1.5,-135,7.5,-120,100,-180,-1.5,115,2.88,T-Mobile Park,5,-5
2017-04-15,2017,COL,SF,5,0,115,1.5,-190,7.5,-120,100,-130,-1.5,163,3.49,AT&T Park,5,5
2017-04-15,2017,NYY,STL,3,2,127,1.5,-145,8.0,-121,101,-142,-1.5,125,3.52,Yankee Stadium,5,1
2017-04-15,2017,BOS,TB,2,1,-220,-1.5,-112,8.5,-112,-108,190,1.5,-108,5.84,Fenway Park,3,1
2017-04-15,2017,SEA,TEX,5,0,-180,-1.5,115,7.5,-120,100,160,1.5,-135,4.82,T-Mobile Park,5,5
2017-04-15,2017,BAL,TOR,1,2,112,1.5,-181,9.0,-120,100,-122,-1.5,156,4.25,Rogers Centre,3,-1
2017-04-15,2017,PHI,WSH,4,2,140,1.5,-160,8.0,-110,-110,-155,-1.5,140,3.33,Nationals Park,6,2
2017-04-16,2017,LAD,ARI,1,3,-196,-1.5,110,8.0,-115,-105,176,1.5,-130,5.3,Dodger Stadium,4,-2
2017-04-16,2017,SD,ATL,2,9,118,1.5,-180,8.0,-120,100,-128,-1.5,155,3.67,Suntrust Park,11,-7
2017-04-16,2017,TOR,BAL,4,11,-108,-1.5,184,8.0,-115,-105,-102,1.5,-220,4.15,Rogers Centre,15,-7
2017-04-16,2017,TB,BOS,5,7,166,1.5,-125,9.5,-119,-101,-186,-1.5,105,3.57,Fenway Park,12,-2
2017-04-16,2017,PIT,CHC,6,1,148,1.5,-152,8.0,-120,100,-163,-1.5,132,3.23,Wrigley Field,7,5
2017-04-16,2017,MIL,CIN,4,2,105,1.5,-210,9.0,-105,-115,-115,-1.5,176,4.39,Great American Ballpark,6,2
2017-04-16,2017,DET,CLE,4,1,189,1.5,-110,9.5,105,-125,-219,-1.5,-110,3.29,Progressive Field,5,3
2017-04-16,2017,SF,COL,3,4,-134,-1.5,160,7.5,-105,-115,119,1.5,-185,4.29,AT&T Park,7,-1
2017-04-16,2017,MIN,CWS,1,3,-159,-1.5,131,9.5,-110,-110,144,1.5,-151,5.83,Target Field,4,-2
2017-04-16,2017,CLE,DET,1,4,-219,-1.5,-110,9.5,105,-125,189,1.5,-110,6.52,Progressive Field,5,-3
2017-04-16,2017,LAA,KC,0,1,102,1.5,-210,8.5,-110,-110,-112,-1.5,176,4.21,Kauffman Stadium,1,-1
2017-04-16,2017,KC,LAA,1,0,-112,-1.5,176,8.5,-110,-110,102,1.5,-210,4.49,Kauffman Stadium,1,1
2017-04-16,2017,ARI,LAD,3,1,176,1.5,-130,8.0,-115,-105,-196,-1.5,110,2.9,Dodger Stadium,4,2
2017-04-16,2017,NYM,MIA,2,4,-109,-1.5,144,8.5,-105,-115,-101,1.5,-165,4.43,Marlins Park,6,-2
2017-04-16,2017,CIN,MIL,2,4,-115,-1.5,176,9.0,-105,-115,105,1.5,-210,4.81,Great American Ballpark,6,-2
2017-04-16,2017,CWS,MIN,3,1,144,1.5,-151,9.5,-110,-110,-159,-1.5,131,3.89,Target Field,4,2
2017-04-16,2017,MIA,NYM,4,2,-101,1.5,-165,8.5,-105,-115,-109,-1.5,144,4.27,Marlins Park,6,2
2017-04-16,2017,STL,NYY,3,9,122,1.5,-175,8.5,-115,-105,-137,-1.5,151,3.83,Yankee Stadium,12,-6
2017-04-16,2017,WSH,PHI,6,4,-180,-1.5,120,9.0,-115,-105,160,1.5,-140,5.79,Nationals Park,10,2
2017-04-16,2017,CHC,PIT,1,6,-163,-1.5,132,8.0,-120,100,148,1.5,-152,4.96,Wrigley Field,7,-5
2017-04-16,2017,ATL,SD,9,2,-128,-1.5,155,8.0,-120,100,118,1.5,-180,4.49,Suntrust Park,11,7
2017-04-16,2017,TEX,SEA,7,8,-111,1.5,-230,8.0,-120,100,101,-1.5,192,4.21,T-Mobile Park,15,-1
2017-04-16,2017,COL,SF,4,3,119,1.5,-185,7.5,-105,-115,-134,-1.5,160,3.42,AT&T Park,7,1
2017-04-16,2017,NYY,STL,9,3,-137,-1.5,151,8.5,-115,-105,122,1.5,-175,4.91,Yankee Stadium,12,6
2017-04-16,2017,BOS,TB,7,5,-186,-1.5,105,9.5,-119,-101,166,1.5,-125,6.18,Fenway Park,12,2
2017-04-16,2017,SEA,TEX,8,7,101,-1.5,192,8.0,-120,100,-111,1.5,-230,3.98,T-Mobile Park,15,1
2017-04-16,2017,BAL,TOR,11,4,-102,1.5,-220,8.0,-115,-105,-108,-1.5,184,4.04,Rogers Centre,15,7
2017-04-16,2017,PHI,WSH,4,6,160,1.5,-140,9.0,-115,-105,-180,-1.5,120,3.46,Nationals Park,10,-2
2017-04-17,2017,LAD,ARI,2,4,-161,-1.5,135,7.5,-105,-115,146,1.5,-155,4.63,Dodger Stadium,6,-2
2017-04-17,2017,SD,ATL,4,5,140,1.5,-160,8.5,-110,-110,-155,-1.5,140,3.54,Suntrust Park,9,-1
2017-04-17,2017,TB,BOS,3,4,118,1.5,-175,10.0,-110,-110,-128,-1.5,151,4.59,Fenway Park,7,-1
2017-04-17,2017,MIL,CHC,6,3,175,1.5,-130,6.5,-110,-110,-205,-1.5,110,2.36,Wrigley Field,9,3
2017-04-17,2017,MIN,CLE,1,3,126,1.5,-140,8.5,-110,-110,-141,-1.5,120,3.76,Target Field,4,-2
2017-04-17,2017,NYY,CWS,7,4,-170,-1.5,125,8.5,-105,-115,150,1.5,-145,5.35,Yankee Stadium,11,3
2017-04-17,2017,LAA,HOU,0,3,140,1.5,-155,8.5,100,-120,-155,-1.5,135,3.54,Minute Maid Park,3,-3
2017-04-17,2017,HOU,LAA,3,0,-155,-1.5,135,8.5,100,-120,140,1.5,-155,5.17,Minute Maid Park,3,3
2017-04-17,2017,ARI,LAD,4,2,146,1.5,-155,7.5,-105,-115,-161,-1.5,135,3.05,Dodger Stadium,6,2
2017-04-17,2017,SEA,MIA,6,1,-132,-1.5,155,8.5,100,-120,117,1.5,-180,4.84,T-Mobile Park,7,5
2017-04-17,2017,CHC,MIL,3,6,-205,-1.5,110,6.5,-110,-110,175,1.5,-130,4.37,Wrigley Field,9,-3
2017-04-17,2017,CLE,MIN,3,1,-141,-1.5,120,8.5,-110,-110,126,1.5,-140,4.97,Target Field,4,2
2017-04-17,2017,CWS,NYY,4,7,150,1.5,-145,8.5,-105,-115,-170,-1.5,125,3.4,Yankee Stadium,11,-3
2017-04-17,2017,TEX,OAK,7,0,130,1.5,-175,7.5,-115,-105,-145,-1.5,151,3.26,Oakland Coliseum,7,7
2017-04-17,2017,STL,PIT,2,1,-113,-1.5,177,8.0,-110,-110,103,1.5,-211,4.24,Busch Stadium,3,1
2017-04-17,2017,ATL,SD,5,4,-155,-1.5,140,8.5,-110,-110,140,1.5,-160,5.17,Suntrust Park,9,1
2017-04-17,2017,MIA,SEA,1,6,117,1.5,-180,8.5,100,-120,-132,-1.5,155,3.92,T-Mobile Park,7,-5
2017-04-17,2017,PIT,STL,1,2,103,1.5,-211,8.0,-110,-110,-113,-1.5,177,3.94,Busch Stadium,3,-1
2017-04-17,2017,BOS,TB,4,3,-128,-1.5,151,10.0,-110,-110,118,1.5,-175,5.61,Fenway Park,7,1
2017-04-17,2017,OAK,TEX,0,7,-145,-1.5,151,7.5,-115,-105,130,1.5,-175,4.44,Oakland Coliseum,7,-7
2017-04-18,2017,SD,ARI,2,11,114,1.5,-155,8.0,-110,-110,-124,-1.5,135,3.74,PETCO Park,13,-9
2017-04-18,2017,WSH,ATL,3,1,-174,-1.5,-120,8.0,-105,-115,154,1.5,100,5.08,Suntrust Park,4,2
2017-04-18,2017,CIN,BAL,9,3,137,1.5,-126,9.0,-106,-114,-152,-1.5,106,3.8,Great American Ballpark,12,6
2017-04-18,2017,TOR,BOS,7,8,-175,-1.5,100,8.5,-120,100,155,1.5,-120,5.41,Rogers Centre,15,-1
2017-04-18,2017,MIL,CHC,7,9,155,1.5,-140,9.0,100,-120,-175,-1.5,120,3.53,Wrigley Field,16,-2
2017-04-18,2017,BAL,CIN,3,9,-152,-1.5,106,9.0,-106,-114,137,1.5,-126,5.43,Great American Ballpark,12,-6
2017-04-18,2017,MIN,CLE,4,11,111,1.5,-160,9.0,105,-125,-121,-1.5,140,4.27,Target Field,15,-7
2017-04-18,2017,LAD,COL,3,4,-183,-1.5,125,7.5,100,-120,163,1.5,-145,4.85,Dodger Stadium,7,-1
2017-04-18,2017,NYY,CWS,1,4,-181,-1.5,115,7.0,105,-125,161,1.5,-135,4.51,Yankee Stadium,5,-3
2017-04-18,2017,TB,DET,5,1,-115,-1.5,172,7.5,-120,100,105,1.5,-205,4.01,Tropicana Field,6,4
2017-04-18,2017,LAA,HOU,5,2,131,1.5,-155,8.5,-110,-110,-146,-1.5,135,3.68,Minute Maid Park,7,3
2017-04-18,2017,SF,KC,2,1,110,1.5,-195,9.5,-110,-110,-120,-1.5,166,4.52,Kauffman Stadium,3,1
2017-04-18,2017,HOU,LAA,2,5,-146,-1.5,135,8.5,-110,-110,131,1.5,-155,5.04,Minute Maid Park,7,-3
2017-04-18,2017,COL,LAD,4,3,163,1.5,-145,7.5,100,-120,-183,-1.5,125,2.85,Dodger Stadium,7,1
2017-04-18,2017,SEA,MIA,0,5,100,1.5,-170,8.5,-105,-115,-110,-1.5,148,4.25,T-Mobile Park,5,-5
2017-04-18,2017,CHC,MIL,9,7,-175,-1.5,120,9.0,100,-120,155,1.5,-140,5.73,Wrigley Field,16,2
2017-04-18,2017,CLE,MIN,11,4,-121,-1.5,140,9.0,105,-125,111,1.5,-160,4.93,Target Field,15,7
2017-04-18,2017,PHI,NYM,6,2,175,1.5,-130,7.5,-120,100,-195,-1.5,110,2.73,Citi Field,8,4
2017-04-18,2017,CWS,NYY,4,1,161,1.5,-135,7.0,105,-125,-181,-1.5,115,2.68,Yankee Stadium,5,3
2017-04-18,2017,TEX,OAK,2,4,-138,-1.5,120,7.0,100,-120,123,1.5,-140,4.06,Oakland Coliseum,6,-2
2017-04-18,2017,NYM,PHI,2,6,-195,-1.5,110,7.5,-120,100,175,1.5,-130,4.96,Citi Field,8,-4
2017-04-18,2017,STL,PIT,2,1,-137,-1.5,155,8.0,-105,-115,122,1.5,-180,4.62,Busch Stadium,3,1
2017-04-18,2017,ARI,SD,11,2,-124,-1.5,135,8.0,-110,-110,114,1.5,-155,4.43,PETCO Park,13,9
2017-04-18,2017,MIA,SEA,5,0,-110,-1.5,148,8.5,-105,-115,100,1.5,-170,4.45,T-Mobile Park,5,5
2017-04-18,2017,KC,SF,1,2,-120,-1.5,166,9.5,-110,-110,110,1.5,-195,5.18,Kauffman Stadium,3,-1
2017-04-18,2017,PIT,STL,1,2,122,1.5,-180,8.0,-105,-115,-137,-1.5,155,3.6,Busch Stadium,3,-1
2017-04-18,2017,DET,TB,1,5,105,1.5,-205,7.5,-120,100,-115,-1.5,172,3.66,Tropicana Field,6,-4
2017-04-18,2017,OAK,TEX,4,2,123,1.5,-140,7.0,100,-120,-138,-1.5,120,3.14,Oakland Coliseum,6,2
2017-04-18,2017,BOS,TOR,8,7,155,1.5,-120,8.5,-120,100,-175,-1.5,100,3.33,Rogers Centre,15,1
2017-04-18,2017,ATL,WSH,1,3,154,1.5,100,8.0,-105,-115,-174,-1.5,-120,3.15,Suntrust Park,4,-2
2017-04-19,2017,SD,ARI,1,0,115,1.5,-150,7.0,-110,-110,-130,-1.5,130,3.26,PETCO Park,1,1
2017-04-19,2017,WSH,ATL,14,4,-110,-1.5,151,8.5,-110,-110,100,1.5,-175,4.45,Suntrust Park,18,10
2017-04-19,2017,CIN,BAL,0,2,-105,-1.5,180,9.0,-107,-113,-105,1.5,-215,4.61,Great American Ballpark,2,-2
2017-04-19,2017,TOR,BOS,3,0,103,1.5,-160,8.0,-110,-110,-113,-1.5,140,3.94,Rogers Centre,3,3
2017-04-19,2017,MIL,CHC,4,7,175,1.5,-130,6.5,-120,100,-205,-1.5,110,2.36,Wrigley Field,11,-3
2017-04-19,2017,BAL,CIN,2,0,-105,1.5,-215,9.0,-107,-113,-105,-1.5,180,4.61,Great American Ballpark,2,2
2017-04-19,2017,LAD,COL,4,2,-250,-1.5,-105,6.0,-110,-110,210,1.5,-115,4.29,Dodger Stadium,6,2
2017-04-19,2017,NYY,CWS,9,1,-235,-1.5,-115,7.5,-110,-110,205,1.5,-105,5.26,Yankee Stadium,10,8
2017-04-19,2017,TB,DET,8,7,-180,-1.5,115,7.5,-115,-105,160,1.5,-135,4.82,Tropicana Field,15,1
2017-04-19,2017,LAA,HOU,1,5,155,1.5,-140,8.5,100,-120,-175,-1.5,120,3.33,Minute Maid Park,6,-4
2017-04-19,2017,SF,KC,0,2,-121,-1.5,140,7.5,-120,100,111,1.5,-160,4.11,Kauffman Stadium,2,-2
2017-04-19,2017,HOU,LAA,5,1,-175,-1.5,120,8.5,100,-120,155,1.5,-140,5.41,Minute Maid Park,6,4
2017-04-19,2017,COL,LAD,2,4,210,1.5,-115,6.0,-110,-110,-250,-1.5,-105,1.94,Dodger Stadium,6,-2
2017-04-19,2017,SEA,MIA,10,5,-145,-1.5,140,8.0,100,-120,130,1.5,-160,4.73,T-Mobile Park,15,5
2017-04-19,2017,CHC,MIL,7,4,-205,-1.5,110,6.5,-120,100,175,1.5,-130,4.37,Wrigley Field,11,3
2017-04-19,2017,PHI,NYM,4,5,127,1.5,-185,7.0,-115,-105,-142,-1.5,160,3.08,Citi Field,9,-1
2017-04-19,2017,CWS,NYY,1,9,205,1.5,-105,7.5,-110,-110,-235,-1.5,-115,2.46,Yankee Stadium,10,-8
2017-04-19,2017,TEX,OAK,1,9,109,1.5,-200,8.5,-105,-115,-119,-1.5,170,4.07,Oakland Coliseum,10,-8
2017-04-19,2017,NYM,PHI,5,4,-142,-1.5,160,7.0,-115,-105,127,1.5,-185,4.11,Citi Field,9,1
2017-04-19,2017,STL,PIT,2,1,-124,-1.5,170,8.0,100,-120,114,1.5,-200,4.43,Busch Stadium,3,1
2017-04-19,2017,ARI,SD,0,1,-130,-1.5,130,7.0,-110,-110,115,1.5,-150,3.96,PETCO Park,1,-1
2017-04-19,2017,MIA,SEA,5,10,130,1.5,-160,8.0,100,-120,-145,-1.5,140,3.48,T-Mobile Park,15,-5
2017-04-19,2017,KC,SF,2,0,111,1.5,-160,7.5,-120,100,-121,-1.5,140,3.55,Kauffman Stadium,2,2
2017-04-19,2017,PIT,STL,1,2,114,1.5,-200,8.0,100,-120,-124,-1.5,170,3.74,Busch Stadium,3,-1
2017-04-19,2017,DET,TB,7,8,160,1.5,-135,7.5,-115,-105,-180,-1.5,115,2.88,Tropicana Field,15,-1
2017-04-19,2017,OAK,TEX,9,1,-119,-1.5,170,8.5,-105,-115,109,1.5,-200,4.62,Oakland Coliseum,10,8
2017-04-19,2017,BOS,TOR,0,3,-113,-1.5,140,8.0,-110,-110,103,1.5,-160,4.24,Rogers Centre,3,-3
2017-04-19,2017,ATL,WSH,4,14,100,1.5,-175,8.5,-110,-110,-110,-1.5,151,4.25,Suntrust Park,18,-10
2017-04-20,2017,SD,ARI,4,1,-104,1.5,-175,8.0,-115,-105,-106,-1.5,151,4.08,PETCO Park,5,3
2017-04-20,2017,WSH,ATL,3,2,-162,-1.5,105,8.0,100,-120,147,1.5,-125,4.95,Suntrust Park,5,1
2017-04-20,2017,CIN,BAL,1,2,102,1.5,-160,8.5,-110,-110,-112,-1.5,140,4.21,Great American Ballpark,3,-1
2017-04-20,2017,TOR,BOS,1,4,167,1.5,-102,7.0,-115,-105,-187,-1.5,-118,2.62,Rogers Centre,5,-3
2017-04-20,2017,BAL,CIN,2,1,-112,-1.5,140,8.5,-110,-110,102,1.5,-160,4.49,Great American Ballpark,3,1
2017-04-20,2017,MIN,CLE,2,6,-103,1.5,-170,8.0,-115,-105,-107,-1.5,148,4.06,Target Field,8,-4
2017-04-20,2017,TB,DET,8,1,-128,-1.5,163,8.0,-120,100,118,1.5,-190,4.49,Tropicana Field,9,7
2017-04-20,2017,LAA,HOU,1,2,150,1.5,-150,7.5,-110,-110,-165,-1.5,130,3.0,Minute Maid Park,3,-1
2017-04-20,2017,TEX,KC,1,0,106,1.5,-160,8.5,-120,100,-116,-1.5,140,4.13,Rangers Ballpark,1,1
2017-04-20,2017,HOU,LAA,2,1,-165,-1.5,130,7.5,-110,-110,150,1.5,-150,4.67,Minute Maid Park,3,1
2017-04-20,2017,STL,MIL,5,7,-125,-1.5,125,8.5,-115,-105,115,1.5,-145,4.72,Miller Park,12,-2
2017-04-20,2017,CLE,MIN,6,2,-107,-1.5,148,8.0,-115,-105,-103,1.5,-170,4.14,Target Field,8,4
2017-04-20,2017,PHI,NYM,6,4,167,1.5,-153,6.5,100,-120,-187,-1.5,132,2.43,Citi Field,10,2
2017-04-20,2017,SEA,OAK,6,9,-147,-1.5,110,7.0,-125,105,132,1.5,-130,4.17,Oakland Coliseum,15,-3
2017-04-20,2017,NYM,PHI,4,6,-187,-1.5,132,6.5,100,-120,167,1.5,-153,4.24,Citi Field,10,-2
2017-04-20,2017,ARI,SD,1,4,-106,-1.5,151,8.0,-115,-105,-104,1.5,-175,4.12,PETCO Park,5,-3
2017-04-20,2017,OAK,SEA,9,6,132,1.5,-130,7.0,-125,105,-147,-1.5,110,3.02,Oakland Coliseum,15,3
2017-04-20,2017,MIL,STL,7,5,115,1.5,-145,8.5,-115,-105,-125,-1.5,125,3.95,Miller Park,12,2
2017-04-20,2017,DET,TB,1,8,118,1.5,-190,8.0,-120,100,-128,-1.5,163,3.67,Tropicana Field,9,-7
2017-04-20,2017,KC,TEX,0,1,-116,-1.5,140,8.5,-120,100,106,1.5,-160,4.56,Rangers Ballpark,1,-1
2017-04-20,2017,BOS,TOR,4,1,-187,-1.5,-118,7.0,-115,-105,167,1.5,-102,4.56,Rogers Centre,5,3
2017-04-20,2017,ATL,WSH,2,3,147,1.5,-125,8.0,100,-120,-162,-1.5,105,3.24,Suntrust Park,5,-1
2017-04-21,2017,LAD,ARI,5,13,-141,-1.5,110,9.5,-110,-110,126,1.5,-130,5.56,Chase Field,18,-8
2017-04-21,2017,PHI,ATL,4,3,-101,1.5,-170,8.0,100,-120,-109,-1.5,148,4.02,Citizens Bank Park,7,1
2017-04-21,2017,BOS,BAL,0,2,-105,1.5,-210,8.0,-110,-110,-105,-1.5,176,4.1,Camden Yards,2,-2
2017-04-21,2017,BAL,BOS,2,0,-105,-1.5,176,8.0,-110,-110,-105,1.5,-210,4.1,Camden Yards,2,2
2017-04-21,2017,CIN,CHC,5,6,152,1.5,-114,8.0,100,-120,-167,-1.5,-106,3.17,Great American Ballpark,11,-1
2017-04-21,2017,CHC,CIN,6,5,-167,-1.5,-106,8.0,100,-120,152,1.5,-114,5.0,Great American Ballpark,11,1
2017-04-21,2017,CWS,CLE,0,3,146,1.5,-120,7.0,-105,-115,-161,-1.5,100,2.85,Guaranteed Rate Field,3,-3
2017-04-21,2017,SF,COL,5,6,-125,-1.5,130,9.0,-115,-105,115,1.5,-150,5.0,Coors Field,11,-1
2017-04-21,2017,CLE,CWS,3,0,-161,-1.5,100,7.0,-105,-115,146,1.5,-120,4.32,Guaranteed Rate Field,3,3
2017-04-21,2017,MIN,DET,6,3,120,1.5,-140,8.0,-120,100,-135,-1.5,120,3.64,Target Field,9,3
2017-04-21,2017,TB,HOU,3,6,104,1.5,-160,8.5,100,-120,-114,-1.5,140,4.17,Tropicana Field,9,-3
2017-04-21,2017,TEX,KC,6,2,-144,-1.5,144,8.5,-120,100,129,1.5,-165,5.02,Rangers Ballpark,8,4
2017-04-21,2017,TOR,LAA,8,7,133,1.5,-160,8.5,-115,-105,-148,-1.5,140,3.65,Angel Stadium,15,1
2017-04-21,2017,ARI,LAD,13,5,126,1.5,-130,9.5,-110,-110,-141,-1.5,110,4.2,Chase Field,18,8
2017-04-21,2017,SD,MIA,5,3,-109,-1.5,184,8.0,-105,-115,-101,1.5,-220,4.17,PETCO Park,8,2
2017-04-21,2017,STL,MIL,6,3,-105,-1.5,151,8.5,-120,100,-105,1.5,-175,4.35,Miller Park,9,3
2017-04-21,2017,DET,MIN,3,6,-135,-1.5,120,8.0,-120,100,120,1.5,-140,4.6,Target Field,9,-3
2017-04-21,2017,WSH,NYM,4,3,111,1.5,-205,7.0,-110,-110,-121,-1.5,172,3.32,Citi Field,7,1
2017-04-21,2017,PIT,NYY,6,3,-105,-1.5,188,7.5,-120,100,-105,1.5,-225,3.84,PNC Park,9,3
2017-04-21,2017,SEA,OAK,1,3,109,1.5,-210,8.0,-118,-102,-119,-1.5,176,3.83,Oakland Coliseum,4,-2
2017-04-21,2017,ATL,PHI,3,4,-109,-1.5,148,8.0,100,-120,-101,1.5,-170,4.17,Citizens Bank Park,7,-1
2017-04-21,2017,NYY,PIT,3,6,-105,1.5,-225,7.5,-120,100,-105,-1.5,188,3.84,PNC Park,9,-3
2017-04-21,2017,MIA,SD,3,5,-101,1.5,-220,8.0,-105,-115,-109,-1.5,184,4.02,PETCO Park,8,-2
2017-04-21,2017,OAK,SEA,3,1,-119,-1.5,176,8.0,-118,-102,109,1.5,-210,4.35,Oakland Coliseum,4,2
2017-04-21,2017,COL,SF,6,5,115,1.5,-150,9.0,-115,-105,-125,-1.5,130,4.19,Coors Field,11,1
2017-04-21,2017,MIL,STL,3,6,-105,1.5,-175,8.5,-120,100,-105,-1.5,151,4.35,Miller Park,9,-3
2017-04-21,2017,HOU,TB,6,3,-114,-1.5,140,8.5,100,-120,104,1.5,-160,4.53,Tropicana Field,9,3
2017-04-21,2017,KC,TEX,2,6,129,1.5,-165,8.5,-120,100,-144,-1.5,144,3.71,Rangers Ballpark,8,-4
2017-04-21,2017,LAA,TOR,7,8,-148,-1.5,140,8.5,-115,-105,133,1.5,-160,5.07,Angel Stadium,15,-1
2017-04-21,2017,NYM,WSH,3,4,-121,-1.5,172,7.0,-110,-110,111,1.5,-205,3.83,Citi Field,7,-1
2017-04-22,2017,LAD,ARI,5,11,-116,-1.5,140,9.5,100,-120,106,1.5,-160,5.1,Chase Field,16,-6
2017-04-22,2017,PHI,ATL,4,3,-112,-1.5,176,7.5,100,-120,102,1.5,-210,3.96,Citizens Bank Park,7,1
2017-04-22,2017,BOS,BAL,2,4,-101,1.5,-205,8.5,105,-125,-109,-1.5,172,4.27,Camden Yards,6,-2
2017-04-22,2017,BAL,BOS,4,2,-109,-1.5,172,8.5,105,-125,-101,1.5,-205,4.43,Camden Yards,6,2
2017-04-22,2017,CIN,CHC,8,12,153,1.5,-110,7.5,-110,-110,-173,-1.5,-110,2.96,Great American Ballpark,20,-4
2017-04-22,2017,CHC,CIN,12,8,-173,-1.5,-110,7.5,-110,-110,153,1.5,-110,4.75,Great American Ballpark,20,4
2017-04-22,2017,CWS,CLE,0,7,205,1.5,117,8.0,100,-120,-235,-1.5,-137,2.62,Guaranteed Rate Field,7,-7
2017-04-22,2017,SF,COL,3,12,-117,-1.5,140,10.5,-120,100,107,1.5,-160,5.66,Coors Field,15,-9
2017-04-22,2017,CLE,CWS,7,0,-235,-1.5,-137,8.0,100,-120,205,1.5,117,5.61,Guaranteed Rate Field,7,7
2017-04-22,2017,MIN,DET,4,5,-126,-1.5,166,9.5,100,-120,116,1.5,-195,5.3,Target Field,9,-1
2017-04-22,2017,TB,HOU,6,3,109,1.5,-159,8.5,100,-120,-119,-1.5,139,4.07,Tropicana Field,9,3
2017-04-22,2017,TEX,KC,2,1,105,1.5,-155,8.5,-110,-110,-115,-1.5,135,4.15,Rangers Ballpark,3,1
2017-04-22,2017,TOR,LAA,4,5,141,1.5,-150,9.0,100,-120,-156,-1.5,130,3.73,Angel Stadium,9,-1
2017-04-22,2017,ARI,LAD,11,5,106,1.5,-160,9.5,100,-120,-116,-1.5,140,4.61,Chase Field,16,6
2017-04-22,2017,SD,MIA,3,6,115,1.5,-140,8.5,-105,-115,-125,-1.5,120,3.95,PETCO Park,9,-3
2017-04-22,2017,STL,MIL,4,1,104,1.5,-210,9.0,-105,-115,-114,-1.5,176,4.41,Miller Park,5,3
2017-04-22,2017,DET,MIN,5,4,116,1.5,-195,9.5,100,-120,-126,-1.5,166,4.4,Target Field,9,1
2017-04-22,2017,WSH,NYM,3,1,104,1.5,-220,6.5,-125,105,-114,-1.5,184,3.19,Citi Field,4,2
2017-04-22,2017,PIT,NYY,5,11,106,1.5,-160,6.5,-125,105,-116,-1.5,140,3.16,PNC Park,16,-6
2017-04-22,2017,SEA,OAK,3,4,111,1.5,-200,8.0,100,-120,-121,-1.5,170,3.79,Oakland Coliseum,7,-1
2017-04-22,2017,ATL,PHI,3,4,102,1.5,-210,7.5,100,-120,-112,-1.5,176,3.71,Citizens Bank Park,7,-1
2017-04-22,2017,NYY,PIT,11,5,-116,-1.5,140,6.5,-125,105,106,1.5,-160,3.49,PNC Park,16,6
2017-04-22,2017,MIA,SD,6,3,-125,-1.5,120,8.5,-105,-115,115,1.5,-140,4.72,PETCO Park,9,3
2017-04-22,2017,OAK,SEA,4,3,-121,-1.5,170,8.0,100,-120,111,1.5,-200,4.38,Oakland Coliseum,7,1
2017-04-22,2017,COL,SF,12,3,107,1.5,-160,10.5,-120,100,-117,-1.5,140,5.07,Coors Field,15,9
2017-04-22,2017,MIL,STL,1,4,-114,-1.5,176,9.0,-105,-115,104,1.5,-210,4.79,Miller Park,5,-3
2017-04-22,2017,HOU,TB,3,6,-119,-1.5,139,8.5,100,-120,109,1.5,-159,4.62,Tropicana Field,9,-3
2017-04-22,2017,KC,TEX,1,2,-115,-1.5,135,8.5,-110,-110,105,1.5,-155,4.55,Rangers Ballpark,3,-1
2017-04-22,2017,LAA,TOR,5,4,-156,-1.5,130,9.0,100,-120,141,1.5,-150,5.48,Angel Stadium,9,1
2017-04-22,2017,NYM,WSH,1,3,-114,-1.5,184,6.5,-125,105,104,1.5,-220,3.46,Citi Field,4,-2
2017-04-23,2017,LAD,ARI,6,2,-155,-1.5,102,9.0,-125,105,140,1.5,-122,5.47,Chase Field,8,4
2017-04-23,2017,PHI,ATL,5,2,-105,-1.5,184,8.5,-105,-115,-105,1.5,-220,4.35,Citizens Bank Park,7,3
2017-04-23,2017,BOS,BAL,6,2,103,1.5,-210,8.0,-110,-110,-113,-1.5,176,3.94,Camden Yards,8,4
2017-04-23,2017,BAL,BOS,2,6,-113,-1.5,176,8.0,-110,-110,103,1.5,-210,4.24,Camden Yards,8,-4
2017-04-23,2017,CIN,CHC,7,5,160,1.5,-103,9.5,100,-120,-180,-1.5,-117,3.65,Great American Ballpark,12,2
2017-04-23,2017,CHC,CIN,5,7,-180,-1.5,-117,9.5,100,-120,160,1.5,-103,6.11,Great American Ballpark,12,-2
2017-04-23,2017,CWS,CLE,6,2,175,1.5,100,8.0,-110,-110,-195,-1.5,-120,2.91,Guaranteed Rate Field,8,4
2017-04-23,2017,SF,COL,0,8,-101,1.5,-195,11.5,-112,-108,-109,-1.5,166,5.78,Coors Field,8,-8
2017-04-23,2017,CLE,CWS,2,6,-195,-1.5,-120,8.0,-110,-110,175,1.5,100,5.29,Guaranteed Rate Field,8,-4
2017-04-23,2017,MIN,DET,4,13,-114,-1.5,176,8.5,100,-120,104,1.5,-210,4.53,Target Field,17,-9
2017-04-23,2017,TB,HOU,4,6,111,1.5,-155,8.5,100,-120,-121,-1.5,135,4.03,Tropicana Field,10,-2
2017-04-23,2017,TEX,KC,5,2,-200,-1.5,-101,8.0,-115,-105,170,1.5,-119,5.33,Rangers Ballpark,7,3
2017-04-23,2017,TOR,LAA,6,2,-122,-1.5,130,8.0,-115,-105,112,1.5,-150,4.4,Angel Stadium,8,4
2017-04-23,2017,ARI,LAD,2,6,140,1.5,-122,9.0,-125,105,-155,-1.5,102,3.75,Chase Field,8,-4
2017-04-23,2017,SD,MIA,3,7,108,1.5,-150,9.0,110,-130,-118,-1.5,130,4.33,PETCO Park,10,-4
2017-04-23,2017,STL,MIL,6,4,-114,-1.5,144,8.5,-101,-119,104,1.5,-165,4.53,Miller Park,10,2
2017-04-23,2017,DET,MIN,13,4,104,1.5,-210,8.5,100,-120,-114,-1.5,176,4.17,Target Field,17,9
2017-04-23,2017,WSH,NYM,6,3,-153,-1.5,110,7.0,100,-120,138,1.5,-130,4.23,Citi Field,9,3
2017-04-23,2017,PIT,NYY,2,1,-102,1.5,-170,7.5,-110,-110,-108,-1.5,148,3.79,PNC Park,3,1
2017-04-23,2017,SEA,OAK,11,1,113,1.5,-190,8.5,100,-120,-123,-1.5,163,3.99,Oakland Coliseum,12,10
2017-04-23,2017,ATL,PHI,2,5,-105,1.5,-220,8.5,-105,-115,-105,-1.5,184,4.35,Citizens Bank Park,7,-3
2017-04-23,2017,NYY,PIT,1,2,-108,-1.5,148,7.5,-110,-110,-102,1.5,-170,3.89,PNC Park,3,-1
2017-04-23,2017,MIA,SD,7,3,-118,-1.5,130,9.0,110,-130,108,1.5,-150,4.87,PETCO Park,10,4
2017-04-23,2017,OAK,SEA,1,11,-123,-1.5,163,8.5,100,-120,113,1.5,-190,4.69,Oakland Coliseum,12,-10
2017-04-23,2017,COL,SF,8,0,-109,-1.5,166,11.5,-112,-108,-101,1.5,-195,6.0,Coors Field,8,8
2017-04-23,2017,MIL,STL,4,6,104,1.5,-165,8.5,-101,-119,-114,-1.5,144,4.17,Miller Park,10,-2
2017-04-23,2017,HOU,TB,6,4,-121,-1.5,135,8.5,100,-120,111,1.5,-155,4.65,Tropicana Field,10,2
2017-04-23,2017,KC,TEX,2,5,170,1.5,-119,8.0,-115,-105,-200,-1.5,-101,2.96,Rangers Ballpark,7,-3
2017-04-23,2017,LAA,TOR,2,6,112,1.5,-150,8.0,-115,-105,-122,-1.5,130,3.77,Angel Stadium,8,-4
2017-04-23,2017,NYM,WSH,3,6,138,1.5,-130,7.0,100,-120,-153,-1.5,110,2.94,Citi Field,9,-3
2017-04-24,2017,SD,ARI,6,7,143,1.5,-152,9.0,-125,105,-158,-1.5,132,3.7,Chase Field,13,-1
2017-04-24,2017,TB,BAL,3,6,-126,-1.5,135,7.5,-115,-105,116,1.5,-155,4.18,Camden Yards,9,-3
2017-04-24,2017,PIT,CHC,3,14,123,1.5,-145,8.0,-105,-115,-138,-1.5,125,3.59,PNC Park,17,-11
2017-04-24,2017,MIL,CIN,11,7,-105,1.5,-170,8.5,-115,-105,-105,-1.5,148,4.35,Miller Park,18,4
2017-04-24,2017,WSH,COL,4,8,140,1.5,-140,12.0,100,-120,-155,-1.5,120,5.0,Coors Field,12,-4
2017-04-24,2017,KC,CWS,1,12,-107,-1.5,148,7.5,100,-120,-103,1.5,-170,3.88,Guaranteed Rate Field,13,-11
2017-04-24,2017,CWS,KC,12,1,-103,1.5,-170,7.5,100,-120,-107,-1.5,148,3.81,Guaranteed Rate Field,13,11
2017-04-24,2017,TOR,LAA,1,2,116,1.5,-185,8.0,100,-120,-131,-1.5,160,3.7,Angel Stadium,3,-1
2017-04-24,2017,SF,LAD,2,1,123,1.5,-140,8.0,100,-120,-138,-1.5,120,3.59,AT&T Park,3,1
2017-04-24,2017,CIN,MIL,7,11,-105,-1.5,148,8.5,-115,-105,-105,1.5,-170,4.35,Miller Park,18,-4
2017-04-24,2017,TEX,MIN,2,3,-144,-1.5,140,10.0,-110,-110,129,1.5,-160,5.9,Rangers Ballpark,5,-1
2017-04-24,2017,CHC,PIT,14,3,-138,-1.5,125,8.0,-105,-115,123,1.5,-145,4.64,PNC Park,17,11
2017-04-24,2017,ARI,SD,7,6,-158,-1.5,132,9.0,-125,105,143,1.5,-152,5.51,Chase Field,13,1
2017-04-24,2017,LAD,SF,1,2,-138,-1.5,120,8.0,100,-120,123,1.5,-140,4.64,AT&T Park,3,-1
2017-04-24,2017,BAL,TB,6,3,116,1.5,-155,7.5,-115,-105,-126,-1.5,135,3.47,Camden Yards,9,3
2017-04-24,2017,MIN,TEX,3,2,129,1.5,-160,10.0,-110,-110,-144,-1.5,140,4.37,Rangers Ballpark,5,1
2017-04-24,2017,LAA,TOR,2,1,-131,-1.5,160,8.0,100,-120,116,1.5,-185,4.54,Angel Stadium,3,1
2017-04-24,2017,COL,WSH,8,4,-155,-1.5,120,12.0,100,-120,140,1.5,-140,7.29,Coors Field,12,4
2017-04-25,2017,SD,ARI,3,9,119,1.5,-170,10.0,-125,105,-134,-1.5,148,4.57,Chase Field,12,-6
2017-04-25,2017,TB,BAL,2,0,145,1.5,-160,8.0,-110,-110,-160,-1.5,140,3.27,Camden Yards,2,2
2017-04-25,2017,PIT,CHC,0,1,113,1.5,-165,7.5,105,-125,-123,-1.5,144,3.52,PNC Park,1,-1
2017-04-25,2017,MIL,CIN,9,1,-125,-1.5,160,9.0,100,-120,115,1.5,-185,5.0,Miller Park,10,8
2017-04-25,2017,HOU,CLE,4,2,-117,-1.5,148,8.5,-110,-110,107,1.5,-170,4.58,Progressive Field,6,2
2017-04-25,2017,WSH,COL,15,12,-117,-1.5,125,10.5,105,-125,107,1.5,-145,5.66,Coors Field,27,3
2017-04-25,2017,KC,CWS,5,10,-148,-1.5,105,8.5,-125,105,133,1.5,-125,5.07,Guaranteed Rate Field,15,-5
2017-04-25,2017,SEA,DET,9,19,-130,-1.5,120,9.0,-110,-110,115,1.5,-140,5.09,Comerica Park,28,-10
2017-04-25,2017,CLE,HOU,2,4,107,1.5,-170,8.5,-110,-110,-117,-1.5,148,4.11,Progressive Field,6,-2
2017-04-25,2017,CWS,KC,10,5,133,1.5,-125,8.5,-125,105,-148,-1.5,105,3.65,Guaranteed Rate Field,15,5
2017-04-25,2017,OAK,LAA,1,2,120,1.5,-175,8.5,-105,-115,-135,-1.5,151,3.86,Angel Stadium,3,-1
2017-04-25,2017,SF,LAD,1,2,210,1.5,115,6.5,-105,-115,-250,-1.5,-135,2.1,AT&T Park,3,-1
2017-04-25,2017,CIN,MIL,1,9,115,1.5,-185,9.0,100,-120,-125,-1.5,160,4.19,Miller Park,10,-8
2017-04-25,2017,TEX,MIN,1,8,100,1.5,-165,10.0,-120,100,-110,-1.5,144,5.0,Rangers Ballpark,9,-7
2017-04-25,2017,LAA,OAK,2,1,-135,-1.5,151,8.5,-105,-115,120,1.5,-175,4.88,Angel Stadium,3,1
2017-04-25,2017,CHC,PIT,1,0,-123,-1.5,144,7.5,105,-125,113,1.5,-165,4.14,PNC Park,1,1
2017-04-25,2017,ARI,SD,9,3,-134,-1.5,148,10.0,-125,105,119,1.5,-170,5.73,Chase Field,12,6
2017-04-25,2017,DET,SEA,19,9,115,1.5,-140,9.0,-110,-110,-130,-1.5,120,4.19,Comerica Park,28,10
2017-04-25,2017,LAD,SF,2,1,-250,-1.5,-135,6.5,-105,-115,210,1.5,115,4.64,AT&T Park,3,1
2017-04-25,2017,TOR,STL,6,5,140,1.5,-155,7.5,110,-130,-155,-1.5,135,3.13,Busch Stadium,11,1
2017-04-25,2017,BAL,TB,0,2,-160,-1.5,140,8.0,-110,-110,145,1.5,-160,4.92,Camden Yards,2,-2
2017-04-25,2017,MIN,TEX,8,1,-110,-1.5,144,10.0,-120,100,100,1.5,-165,5.24,Rangers Ballpark,9,7
2017-04-25,2017,STL,TOR,5,6,-155,-1.5,135,7.5,110,-130,140,1.5,-155,4.56,Busch Stadium,11,-1
2017-04-25,2017,COL,WSH,12,15,107,1.5,-145,10.5,105,-125,-117,-1.5,125,5.07,Coors Field,27,-3
2017-04-26,2017,SD,ARI,8,5,117,1.5,-175,10.0,-110,-110,-127,-1.5,151,4.61,Chase Field,13,3
2017-04-26,2017,NYM,ATL,2,8,-140,-1.5,155,7.5,-105,-115,125,1.5,-180,4.38,Citi Field,10,-6
2017-04-26,2017,TB,BAL,4,5,131,1.5,-160,8.5,-105,-115,-146,-1.5,140,3.68,Camden Yards,9,-1
2017-04-26,2017,NYY,BOS,3,1,109,1.5,-200,8.0,-107,-113,-119,-1.5,170,3.83,Fenway Park,4,2
2017-04-26,2017,PIT,CHC,6,5,144,1.5,-125,8.5,-110,-110,-159,-1.5,105,3.48,PNC Park,11,1
2017-04-26,2017,MIL,CIN,9,4,-126,-1.5,166,9.5,-115,-105,116,1.5,-195,5.3,Miller Park,13,5
2017-04-26,2017,HOU,CLE,6,7,110,1.5,-215,9.0,-101,-119,-120,-1.5,180,4.29,Progressive Field,13,-1
2017-04-26,2017,WSH,COL,11,4,109,1.5,-190,10.5,-110,-110,-119,-1.5,163,5.02,Coors Field,15,7
2017-04-26,2017,KC,CWS,2,5,122,1.5,-175,8.5,-110,-110,-137,-1.5,151,3.83,Guaranteed Rate Field,7,-3
2017-04-26,2017,SEA,DET,8,0,-129,-1.5,132,8.0,-110,-110,119,1.5,-152,4.51,Comerica Park,8,8
2017-04-26,2017,CLE,HOU,7,6,-120,-1.5,180,9.0,-101,-119,110,1.5,-215,4.91,Progressive Field,13,1
2017-04-26,2017,CWS,KC,5,2,-137,-1.5,151,8.5,-110,-110,122,1.5,-175,4.91,Guaranteed Rate Field,7,3
2017-04-26,2017,OAK,LAA,5,8,137,1.5,-165,7.5,-110,-110,-152,-1.5,144,3.16,Angel Stadium,13,-3
2017-04-26,2017,SF,LAD,4,3,-102,1.5,-185,6.5,-110,-110,-108,-1.5,160,3.28,AT&T Park,7,1
2017-04-26,2017,PHI,MIA,7,4,-101,1.5,-165,7.5,-110,-110,-109,-1.5,144,3.77,Citizens Bank Park,11,3
2017-04-26,2017,CIN,MIL,4,9,116,1.5,-195,9.5,-115,-105,-126,-1.5,166,4.4,Miller Park,13,-5
2017-04-26,2017,TEX,MIN,14,3,-142,-1.5,148,9.0,100,-120,127,1.5,-170,5.28,Rangers Ballpark,17,11
2017-04-26,2017,ATL,NYM,8,2,125,1.5,-180,7.5,-105,-115,-140,-1.5,155,3.33,Citi Field,10,6
2017-04-26,2017,BOS,NYY,1,3,-119,-1.5,170,8.0,-107,-113,109,1.5,-200,4.35,Fenway Park,4,-2
2017-04-26,2017,LAA,OAK,8,5,-152,-1.5,144,7.5,-110,-110,137,1.5,-165,4.52,Angel Stadium,13,3
2017-04-26,2017,MIA,PHI,4,7,-109,-1.5,144,7.5,-110,-110,-101,1.5,-165,3.91,Citizens Bank Park,11,-3
2017-04-26,2017,CHC,PIT,5,6,-159,-1.5,105,8.5,-110,-110,144,1.5,-125,5.22,PNC Park,11,-1
2017-04-26,2017,ARI,SD,5,8,-127,-1.5,151,10.0,-110,-110,117,1.5,-175,5.59,Chase Field,13,-3
2017-04-26,2017,DET,SEA,0,8,119,1.5,-152,8.0,-110,-110,-129,-1.5,132,3.65,Comerica Park,8,-8
2017-04-26,2017,LAD,SF,3,4,-108,-1.5,160,6.5,-110,-110,-102,1.5,-185,3.38,AT&T Park,7,-1
2017-04-26,2017,BAL,TB,5,4,-146,-1.5,140,8.5,-105,-115,131,1.5,-160,5.04,Camden Yards,9,1
2017-04-26,2017,MIN,TEX,3,14,127,1.5,-170,9.0,100,-120,-142,-1.5,148,3.96,Rangers Ballpark,17,-11
2017-04-26,2017,COL,WSH,4,11,-119,-1.5,163,10.5,-110,-110,109,1.5,-190,5.71,Coors Field,15,-7
2017-04-27,2017,SD,ARI,2,6,170,1.5,-115,10.5,-105,-115,-200,-1.5,-105,3.89,Chase Field,8,-4
2017-04-27,2017,NYM,ATL,5,7,-171,-1.5,130,8.0,100,-120,151,1.5,-150,5.05,Citi Field,12,-2
2017-04-27,2017,NYY,BOS,3,0,165,1.5,-130,7.0,-125,105,-185,-1.5,110,2.64,Fenway Park,3,3
2017-04-27,2017,HOU,CLE,3,4,172,1.5,-121,8.5,-110,-110,-202,-1.5,101,3.13,Progressive Field,7,-1
2017-04-27,2017,WSH,COL,16,5,-116,-1.5,135,11.0,-115,-105,106,1.5,-155,5.91,Coors Field,21,11
2017-04-27,2017,SEA,DET,2,1,124,1.5,-165,9.0,-102,-118,-139,-1.5,144,4.02,Comerica Park,3,1
2017-04-27,2017,CLE,HOU,4,3,-202,-1.5,101,8.5,-110,-110,172,1.5,-121,5.69,Progressive Field,7,1
2017-04-27,2017,OAK,LAA,1,2,111,1.5,-205,8.5,100,-120,-121,-1.5,172,4.03,Angel Stadium,3,-1
2017-04-27,2017,SF,LAD,1,5,119,1.5,-147,8.0,100,-120,-129,-1.5,127,3.65,AT&T Park,6,-4
2017-04-27,2017,PHI,MIA,3,2,-109,-1.5,180,8.5,-119,-101,-101,1.5,-215,4.43,Citizens Bank Park,5,1
2017-04-27,2017,ATL,NYM,7,5,151,1.5,-150,8.0,100,-120,-171,-1.5,130,3.19,Citi Field,12,2
2017-04-27,2017,BOS,NYY,0,3,-185,-1.5,110,7.0,-125,105,165,1.5,-130,4.54,Fenway Park,3,-3
2017-04-27,2017,LAA,OAK,2,1,-121,-1.5,172,8.5,100,-120,111,1.5,-205,4.65,Angel Stadium,3,1
2017-04-27,2017,MIA,PHI,2,3,-101,1.5,-215,8.5,-119,-101,-109,-1.5,180,4.27,Citizens Bank Park,5,-1
2017-04-27,2017,ARI,SD,6,2,-200,-1.5,-105,10.5,-105,-115,170,1.5,-115,7.0,Chase Field,8,4
2017-04-27,2017,DET,SEA,1,2,-139,-1.5,144,9.0,-102,-118,124,1.5,-165,5.23,Comerica Park,3,-1
2017-04-27,2017,LAD,SF,5,1,-129,-1.5,127,8.0,100,-120,119,1.5,-147,4.51,AT&T Park,6,4
2017-04-27,2017,TOR,STL,4,8,185,1.5,-120,7.5,-120,100,-215,-1.5,100,2.63,Busch Stadium,12,-4
2017-04-27,2017,TOR,STL,4,6,175,1.5,-127,8.0,-102,-118,-195,-1.5,106,2.91,Busch Stadium,10,-2
2017-04-27,2017,STL,TOR,8,4,-215,-1.5,100,7.5,-120,100,185,1.5,-120,5.12,Busch Stadium,12,4
2017-04-27,2017,STL,TOR,6,4,-195,-1.5,106,8.0,-102,-118,175,1.5,-127,5.29,Busch Stadium,10,2
2017-04-27,2017,COL,WSH,5,16,106,1.5,-155,11.0,-115,-105,-116,-1.5,135,5.34,Coors Field,21,-11
2017-04-28,2017,COL,ARI,3,1,151,1.5,-145,9.0,-110,-110,-171,-1.5,125,3.59,Chase Field,4,2
2017-04-28,2017,MIL,ATL,8,10,-136,-1.5,146,8.5,-120,100,121,1.5,-168,4.9,Miller Park,18,-2
2017-04-28,2017,NYY,BAL,14,11,-107,-1.5,176,9.0,-115,-105,-103,1.5,-210,4.65,Yankee Stadium,25,3
2017-04-28,2017,CHC,BOS,4,5,100,1.5,-210,8.5,-120,100,-110,-1.5,176,4.25,Fenway Park,9,-1
2017-04-28,2017,BOS,CHC,5,4,-110,-1.5,176,8.5,-120,100,100,1.5,-210,4.45,Fenway Park,9,1
2017-04-28,2017,STL,CIN,7,5,-140,-1.5,151,8.0,100,-120,125,1.5,-175,4.67,Busch Stadium,12,2
2017-04-28,2017,SEA,CLE,3,1,170,1.5,-120,8.5,-101,-119,-200,-1.5,100,3.15,Progressive Field,4,2
2017-04-28,2017,ARI,COL,1,3,-171,-1.5,125,9.0,-110,-110,151,1.5,-145,5.68,Chase Field,4,-2
2017-04-28,2017,DET,CWS,3,7,-130,-1.5,163,9.0,100,-120,115,1.5,-190,5.09,Comerica Park,10,-4
2017-04-28,2017,CWS,DET,7,3,115,1.5,-190,9.0,100,-120,-130,-1.5,163,4.19,Comerica Park,10,4
2017-04-28,2017,OAK,HOU,4,9,146,1.5,-147,8.5,-110,-110,-161,-1.5,127,3.46,Minute Maid Park,13,-5
2017-04-28,2017,MIN,KC,6,4,116,1.5,-185,8.0,-105,-115,-131,-1.5,160,3.7,Kauffman Stadium,10,2
2017-04-28,2017,TEX,LAA,3,6,108,1.5,-153,9.5,-112,-108,-118,-1.5,133,4.57,Rangers Ballpark,9,-3
2017-04-28,2017,PHI,LAD,3,5,161,1.5,-140,8.0,-110,-110,-181,-1.5,120,3.07,Dodger Stadium,8,-2
2017-04-28,2017,PIT,MIA,12,2,117,1.5,-200,8.0,100,-120,-127,-1.5,170,3.69,Marlins Park,14,10
2017-04-28,2017,ATL,MIL,10,8,121,1.5,-168,8.5,-120,100,-136,-1.5,146,3.85,Miller Park,18,2
2017-04-28,2017,KC,MIN,4,6,-131,-1.5,160,8.0,-105,-115,116,1.5,-185,4.54,Kauffman Stadium,10,-2
2017-04-28,2017,WSH,NYM,5,7,-137,-1.5,160,7.5,100,-120,122,1.5,-185,4.34,Nationals Park,12,-2
2017-04-28,2017,BAL,NYY,11,14,-103,1.5,-210,9.0,-115,-105,-107,-1.5,176,4.57,Yankee Stadium,25,-3
2017-04-28,2017,HOU,OAK,9,4,-161,-1.5,127,8.5,-110,-110,146,1.5,-147,5.24,Minute Maid Park,13,5
2017-04-28,2017,LAD,PHI,5,3,-181,-1.5,120,8.0,-110,-110,161,1.5,-140,5.15,Dodger Stadium,8,2
2017-04-28,2017,MIA,PIT,2,12,-127,-1.5,170,8.0,100,-120,117,1.5,-200,4.48,Marlins Park,14,-10
2017-04-28,2017,SF,SD,4,3,-138,-1.5,160,7.5,-102,-118,123,1.5,-185,4.35,AT&T Park,7,1
2017-04-28,2017,CLE,SEA,1,3,-200,-1.5,100,8.5,-101,-119,170,1.5,-120,5.67,Progressive Field,4,-2
2017-04-28,2017,SD,SF,3,4,123,1.5,-185,7.5,-102,-118,-138,-1.5,160,3.36,AT&T Park,7,-1
2017-04-28,2017,CIN,STL,5,7,125,1.5,-175,8.0,100,-120,-140,-1.5,151,3.56,Busch Stadium,12,-2
2017-04-28,2017,TOR,TB,4,7,-128,-1.5,163,8.5,-105,-115,118,1.5,-190,4.77,Rogers Centre,11,-3
2017-04-28,2017,LAA,TEX,6,3,-118,-1.5,133,9.5,-112,-108,108,1.5,-153,5.14,Rangers Ballpark,9,3
2017-04-28,2017,TB,TOR,7,4,118,1.5,-190,8.5,-105,-115,-128,-1.5,163,3.9,Rogers Centre,11,3
2017-04-28,2017,NYM,WSH,7,5,122,1.5,-185,7.5,100,-120,-137,-1.5,160,3.38,Nationals Park,12,2
2017-04-29,2017,COL,ARI,7,6,125,1.5,-170,9.0,-105,-115,-140,-1.5,148,4.0,Chase Field,13,1
2017-04-29,2017,MIL,ATL,3,11,-121,-1.5,170,9.0,-110,-110,111,1.5,-200,4.93,Miller Park,14,-8
2017-04-29,2017,NYY,BAL,12,4,-176,-1.5,110,9.0,-115,-105,156,1.5,-130,5.74,Yankee Stadium,16,8
2017-04-29,2017,CHC,BOS,7,4,-115,-1.5,130,10.5,-120,100,105,1.5,-150,5.62,Fenway Park,11,3
2017-04-29,2017,BOS,CHC,4,7,105,1.5,-150,10.5,-120,100,-115,-1.5,130,5.12,Fenway Park,11,-3
2017-04-29,2017,SEA,CLE,3,4,151,1.5,-145,8.0,-105,-115,-171,-1.5,125,3.19,Progressive Field,7,-1
2017-04-29,2017,ARI,COL,6,7,-140,-1.5,148,9.0,-105,-115,125,1.5,-170,5.25,Chase Field,13,-1
2017-04-29,2017,DET,CWS,4,6,-165,-1.5,135,7.5,-110,-110,150,1.5,-156,4.67,Comerica Park,10,-2
2017-04-29,2017,CWS,DET,6,4,150,1.5,-156,7.5,-110,-110,-165,-1.5,135,3.0,Comerica Park,10,2
2017-04-29,2017,OAK,HOU,2,1,157,1.5,-145,8.5,100,-120,-177,-1.5,125,3.31,Minute Maid Park,3,1
2017-04-29,2017,TEX,LAA,6,3,-162,-1.5,135,8.0,-116,-104,147,1.5,-155,4.95,Rangers Ballpark,9,3
2017-04-29,2017,PHI,LAD,5,6,200,1.5,-125,8.0,-120,100,-230,-1.5,105,2.67,Dodger Stadium,11,-1
2017-04-29,2017,PIT,MIA,4,0,126,1.5,-180,7.5,-120,100,-141,-1.5,155,3.32,Marlins Park,4,4
2017-04-29,2017,ATL,MIL,11,3,111,1.5,-200,9.0,-110,-110,-121,-1.5,170,4.27,Miller Park,14,8
2017-04-29,2017,WSH,NYM,3,5,-180,-1.5,120,8.5,100,-120,160,1.5,-140,5.46,Nationals Park,8,-2
2017-04-29,2017,BAL,NYY,4,12,156,1.5,-130,9.0,-115,-105,-176,-1.5,110,3.52,Yankee Stadium,16,-8
2017-04-29,2017,HOU,OAK,1,2,-177,-1.5,125,8.5,100,-120,157,1.5,-145,5.43,Minute Maid Park,3,-1
2017-04-29,2017,LAD,PHI,6,5,-230,-1.5,105,8.0,-120,100,200,1.5,-125,5.58,Dodger Stadium,11,1
2017-04-29,2017,MIA,PIT,0,4,-141,-1.5,155,7.5,-120,100,126,1.5,-180,4.39,Marlins Park,4,-4
2017-04-29,2017,SF,SD,4,12,-118,-1.5,172,7.5,-110,-110,108,1.5,-205,4.06,AT&T Park,16,-8
2017-04-29,2017,CLE,SEA,4,3,-171,-1.5,125,8.0,-105,-115,151,1.5,-145,5.05,Progressive Field,7,1
2017-04-29,2017,SD,SF,12,4,108,1.5,-205,7.5,-110,-110,-118,-1.5,172,3.61,AT&T Park,16,8
2017-04-29,2017,TOR,TB,4,1,-114,-1.5,180,8.0,-110,-110,104,1.5,-215,4.26,Rogers Centre,5,3
2017-04-29,2017,LAA,TEX,3,6,147,1.5,-155,8.0,-116,-104,-162,-1.5,135,3.24,Rangers Ballpark,9,-3
2017-04-29,2017,TB,TOR,1,4,104,1.5,-215,8.0,-110,-110,-114,-1.5,180,3.92,Rogers Centre,5,-3
2017-04-29,2017,NYM,WSH,5,3,160,1.5,-140,8.5,100,-120,-180,-1.5,120,3.27,Nationals Park,8,2
2017-04-30,2017,COL,ARI,0,2,111,1.5,-184,10.5,-115,-105,-121,-1.5,157,4.98,Chase Field,2,-2
2017-04-30,2017,MIL,ATL,4,3,-105,1.5,-170,9.0,-110,-110,-105,-1.5,148,4.61,Miller Park,7,1
2017-04-30,2017,NYY,BAL,4,7,-119,-1.5,166,8.0,-105,-115,109,1.5,-195,4.35,Yankee Stadium,11,-3
2017-04-30,2017,CHC,BOS,2,6,104,1.5,-210,8.5,-115,-105,-114,-1.5,176,4.17,Fenway Park,8,-4
2017-04-30,2017,BOS,CHC,6,2,-114,-1.5,176,8.5,-115,-105,104,1.5,-210,4.53,Fenway Park,8,4
2017-04-30,2017,STL,CIN,4,5,-175,-1.5,110,8.5,-110,-110,155,1.5,-130,5.41,Busch Stadium,9,-1
2017-04-30,2017,SEA,CLE,4,12,140,1.5,-140,9.5,-120,100,-155,-1.5,120,3.96,Progressive Field,16,-8
2017-04-30,2017,ARI,COL,2,0,-121,-1.5,157,10.5,-115,-105,111,1.5,-184,5.75,Chase Field,2,2
2017-04-30,2017,DET,CWS,7,3,-124,-1.5,170,8.5,-102,-118,114,1.5,-200,4.71,Comerica Park,10,4
2017-04-30,2017,CWS,DET,3,7,114,1.5,-200,8.5,-102,-118,-124,-1.5,170,3.97,Comerica Park,10,-4
2017-04-30,2017,OAK,HOU,2,7,177,1.5,-130,7.5,-105,-115,-197,-1.5,110,2.71,Minute Maid Park,9,-5
2017-04-30,2017,MIN,KC,7,5,114,1.5,-185,9.0,-110,-110,-124,-1.5,160,4.21,Kauffman Stadium,12,2
2017-04-30,2017,TEX,LAA,2,5,113,1.5,-150,9.0,-121,101,-123,-1.5,130,4.23,Rangers Ballpark,7,-3
2017-04-30,2017,PHI,LAD,3,5,175,1.5,-115,8.5,-105,-115,-205,-1.5,-105,3.09,Dodger Stadium,8,-2
2017-04-30,2017,PIT,MIA,3,10,106,1.5,-205,8.5,-105,-115,-116,-1.5,172,4.13,Marlins Park,13,-7
2017-04-30,2017,ATL,MIL,3,4,-105,-1.5,148,9.0,-110,-110,-105,1.5,-170,4.61,Miller Park,7,-1
2017-04-30,2017,KC,MIN,5,7,-124,-1.5,160,9.0,-110,-110,114,1.5,-185,4.98,Kauffman Stadium,12,-2
2017-04-30,2017,WSH,NYM,23,5,107,1.5,-170,7.5,-110,-110,-117,-1.5,148,3.62,Nationals Park,28,18
2017-04-30,2017,BAL,NYY,7,4,109,1.5,-195,8.0,-105,-115,-119,-1.5,166,3.83,Yankee Stadium,11,3
2017-04-30,2017,HOU,OAK,7,2,-197,-1.5,110,7.5,-105,-115,177,1.5,-130,4.97,Minute Maid Park,9,5
2017-04-30,2017,LAD,PHI,5,3,-205,-1.5,-105,8.5,-105,-115,175,1.5,-115,5.71,Dodger Stadium,8,2
2017-04-30,2017,MIA,PIT,10,3,-116,-1.5,172,8.5,-105,-115,106,1.5,-205,4.56,Marlins Park,13,7
2017-04-30,2017,SF,SD,2,5,-131,-1.5,166,8.5,100,-120,116,1.5,-195,4.82,AT&T Park,7,-3
2017-04-30,2017,CLE,SEA,12,4,-155,-1.5,120,9.5,-120,100,140,1.5,-140,5.77,Progressive Field,16,8
2017-04-30,2017,SD,SF,5,2,116,1.5,-195,8.5,100,-120,-131,-1.5,166,3.94,AT&T Park,7,3
2017-04-30,2017,CIN,STL,5,4,155,1.5,-130,8.5,-110,-110,-175,-1.5,110,3.33,Busch Stadium,9,1
2017-04-30,2017,TOR,TB,3,1,103,1.5,-170,7.5,-110,-110,-113,-1.5,148,3.69,Rogers Centre,4,2
2017-04-30,2017,LAA,TEX,5,2,-123,-1.5,130,9.0,-121,101,113,1.5,-150,4.96,Rangers Ballpark,7,3
2017-04-30,2017,TB,TOR,1,3,-113,-1.5,148,7.5,-110,-110,103,1.5,-170,3.98,Rogers Centre,4,-2
2017-04-30,2017,NYM,WSH,5,23,-117,-1.5,148,7.5,-110,-110,107,1.5,-170,4.04,Nationals Park,28,-18
2017-05-01,2017,NYM,ATL,7,5,-102,1.5,-200,8.5,-115,-105,-108,-1.5,170,4.29,Suntrust Park,12,2
2017-05-01,2017,BOS,BAL,2,5,-139,-1.5,155,8.5,-110,-110,124,1.5,-180,4.94,Fenway Park,7,-3
2017-05-01,2017,BAL,BOS,5,2,124,1.5,-180,8.5,-110,-110,-139,-1.5,155,3.79,Fenway Park,7,3
2017-05-01,2017,PHI,CHC,10,2,147,1.5,-135,10.0,-120,100,-162,-1.5,115,4.05,Wrigley Field,12,8
2017-05-01,2017,PIT,CIN,3,4,-108,-1.5,151,8.0,-110,-110,-102,1.5,-175,4.15,Great American Ballpark,7,-1
2017-05-01,2017,DET,CLE,7,1,117,1.5,-145,8.5,-110,-110,-132,-1.5,125,3.92,Comerica Park,8,6
2017-05-01,2017,KC,CWS,6,1,-190,-1.5,115,8.5,-105,-115,170,1.5,-135,5.57,Kauffman Stadium,7,5
2017-05-01,2017,CLE,DET,1,7,-132,-1.5,125,8.5,-110,-110,117,1.5,-145,4.84,Comerica Park,8,-6
2017-05-01,2017,TEX,HOU,2,6,200,1.5,-110,8.5,-116,-104,-230,-1.5,-110,2.83,Minute Maid Park,8,-4
2017-05-01,2017,CWS,KC,1,6,170,1.5,-135,8.5,-105,-115,-190,-1.5,115,3.15,Kauffman Stadium,7,-5
2017-05-01,2017,SF,LAD,4,3,210,1.5,-125,6.0,-120,100,-250,-1.5,105,1.94,Dodger Stadium,7,1
2017-05-01,2017,TB,MIA,4,2,128,1.5,-180,8.0,100,-120,-143,-1.5,155,3.51,Marlins Park,6,2
2017-05-01,2017,STL,MIL,5,7,-161,-1.5,144,7.5,105,-125,146,1.5,-165,4.63,Busch Stadium,12,-2
2017-05-01,2017,ATL,NYM,5,7,-108,-1.5,170,8.5,-115,-105,-102,1.5,-200,4.41,Suntrust Park,12,-2
2017-05-01,2017,TOR,NYY,7,1,158,1.5,-145,7.5,100,-120,-178,-1.5,125,2.91,Yankee Stadium,8,6
2017-05-01,2017,CHC,PHI,2,10,-162,-1.5,115,10.0,-120,100,147,1.5,-135,6.18,Wrigley Field,12,-8
2017-05-01,2017,CIN,PIT,4,3,-102,1.5,-175,8.0,-110,-110,-108,-1.5,151,4.04,Great American Ballpark,7,1
2017-05-01,2017,LAD,SF,3,4,-250,-1.5,105,6.0,-120,100,210,1.5,-125,4.29,Dodger Stadium,7,-1
2017-05-01,2017,MIL,STL,7,5,146,1.5,-165,7.5,105,-125,-161,-1.5,144,3.05,Busch Stadium,12,2
2017-05-01,2017,MIA,TB,2,4,-143,-1.5,155,8.0,100,-120,128,1.5,-180,4.71,Marlins Park,6,-2
2017-05-01,2017,HOU,TEX,6,2,-230,-1.5,-110,8.5,-116,-104,200,1.5,-110,5.92,Minute Maid Park,8,4
2017-05-01,2017,NYY,TOR,1,7,-178,-1.5,125,7.5,100,-120,158,1.5,-145,4.8,Yankee Stadium,8,-6
2017-05-02,2017,WSH,ARI,3,6,-142,-1.5,144,8.0,-115,-105,127,1.5,-165,4.69,Nationals Park,9,-3
2017-05-02,2017,NYM,ATL,7,9,-111,-1.5,144,8.5,-120,100,101,1.5,-165,4.47,Suntrust Park,16,-2
2017-05-02,2017,BOS,BAL,5,2,-226,-1.5,-120,9.0,101,-121,196,1.5,100,6.24,Fenway Park,7,3
2017-05-02,2017,BAL,BOS,2,5,196,1.5,100,9.0,101,-121,-226,-1.5,-120,3.04,Fenway Park,7,-3
2017-05-02,2017,PHI,CHC,3,8,185,1.5,-110,7.5,106,-126,-215,-1.5,-110,2.63,Wrigley Field,11,-5
2017-05-02,2017,PIT,CIN,12,3,131,1.5,-160,9.0,110,-130,-146,-1.5,140,3.9,Great American Ballpark,15,9
2017-05-02,2017,DET,CLE,5,2,115,1.5,-145,7.5,110,-130,-130,-1.5,125,3.49,Comerica Park,7,3
2017-05-02,2017,SD,COL,6,2,-109,-1.5,188,7.5,100,-120,-101,1.5,-225,3.91,PETCO Park,8,4
2017-05-02,2017,KC,CWS,0,6,-101,1.5,-170,7.0,-130,110,-109,-1.5,148,3.52,Kauffman Stadium,6,-6
2017-05-02,2017,CLE,DET,2,5,-130,-1.5,125,7.5,110,-130,115,1.5,-145,4.24,Comerica Park,7,-3
2017-05-02,2017,TEX,HOU,7,8,150,1.5,-150,9.5,-105,-115,-165,-1.5,130,3.8,Minute Maid Park,15,-1
2017-05-02,2017,CWS,KC,6,0,-109,-1.5,148,7.0,-130,110,-101,1.5,-170,3.65,Kauffman Stadium,6,6
2017-05-02,2017,SEA,LAA,4,6,-147,-1.5,151,7.0,-105,-115,132,1.5,-175,4.17,T-Mobile Park,10,-2
2017-05-02,2017,SF,LAD,5,13,152,1.5,-150,7.5,-115,-105,-172,-1.5,130,2.98,Dodger Stadium,18,-8
2017-05-02,2017,TB,MIA,3,1,109,1.5,-185,8.0,-110,-110,-119,-1.5,160,3.83,Marlins Park,4,2
2017-05-02,2017,STL,MIL,2,1,-192,-1.5,110,7.5,-120,100,172,1.5,-130,4.93,Busch Stadium,3,1
2017-05-02,2017,OAK,MIN,1,9,116,1.5,-190,8.5,-105,-115,-131,-1.5,163,3.94,Target Field,10,-8
2017-05-02,2017,ATL,NYM,9,7,101,1.5,-165,8.5,-120,100,-111,-1.5,144,4.23,Suntrust Park,16,2
2017-05-02,2017,TOR,NYY,5,11,165,1.5,-125,9.0,100,-120,-185,-1.5,105,3.4,Yankee Stadium,16,-6
2017-05-02,2017,MIN,OAK,9,1,-131,-1.5,163,8.5,-105,-115,116,1.5,-190,4.82,Target Field,10,8
2017-05-02,2017,CHC,PHI,8,3,-215,-1.5,-110,7.5,106,-126,185,1.5,-110,5.12,Wrigley Field,11,5
2017-05-02,2017,CIN,PIT,3,12,-146,-1.5,140,9.0,110,-130,131,1.5,-160,5.34,Great American Ballpark,15,-9
2017-05-02,2017,COL,SD,2,6,-101,1.5,-225,7.5,100,-120,-109,-1.5,188,3.77,PETCO Park,8,-4
2017-05-02,2017,LAA,SEA,6,4,132,1.5,-175,7.0,-105,-115,-147,-1.5,151,3.02,T-Mobile Park,10,2
2017-05-02,2017,LAD,SF,13,5,-172,-1.5,130,7.5,-115,-105,152,1.5,-150,4.74,Dodger Stadium,18,8
2017-05-02,2017,MIL,STL,1,2,172,1.5,-130,7.5,-120,100,-192,-1.5,110,2.76,Busch Stadium,3,-1
2017-05-02,2017,MIA,TB,1,3,-119,-1.5,160,8.0,-110,-110,109,1.5,-185,4.35,Marlins Park,4,-2
2017-05-02,2017,HOU,TEX,8,7,-165,-1.5,130,9.5,-105,-115,150,1.5,-150,5.92,Minute Maid Park,15,1
2017-05-02,2017,NYY,TOR,11,5,-185,-1.5,105,9.0,100,-120,165,1.5,-125,5.84,Yankee Stadium,16,6
2017-05-02,2017,ARI,WSH,6,3,127,1.5,-165,8.0,-115,-105,-142,-1.5,144,3.52,Nationals Park,9,3
2017-05-03,2017,WSH,ARI,2,1,-148,-1.5,148,8.0,-120,100,133,1.5,-170,4.77,Nationals Park,3,1
2017-05-03,2017,NYM,ATL,16,5,-140,-1.5,115,8.5,-110,-110,125,1.5,-135,4.96,Suntrust Park,21,11
2017-05-03,2017,BOS,BAL,4,2,-139,-1.5,154,9.0,-103,-117,124,1.5,-177,5.23,Fenway Park,6,2
2017-05-03,2017,BAL,BOS,2,4,124,1.5,-177,9.0,-103,-117,-139,-1.5,154,4.02,Fenway Park,6,-2
2017-05-03,2017,PHI,CHC,4,5,200,1.5,-115,7.0,105,-125,-240,-1.5,-105,2.33,Wrigley Field,9,-1
2017-05-03,2017,PIT,CIN,2,7,-101,-1.5,151,8.5,-110,-110,-109,1.5,-175,4.27,Great American Ballpark,9,-5
2017-05-03,2017,DET,CLE,2,3,144,1.5,-120,8.0,-105,-115,-159,-1.5,100,3.28,Comerica Park,5,-1
2017-05-03,2017,SD,COL,3,11,104,1.5,-160,8.0,-120,100,-114,-1.5,140,3.92,PETCO Park,14,-8
2017-05-03,2017,KC,CWS,6,1,-165,-1.5,127,7.5,-115,-105,150,1.5,-147,4.67,Kauffman Stadium,7,5
2017-05-03,2017,CLE,DET,3,2,-159,-1.5,100,8.0,-105,-115,144,1.5,-120,4.91,Comerica Park,5,1
2017-05-03,2017,TEX,HOU,1,10,157,1.5,-135,8.5,100,-120,-177,-1.5,115,3.31,Minute Maid Park,11,-9
2017-05-03,2017,CWS,KC,1,6,150,1.5,-147,7.5,-115,-105,-165,-1.5,127,3.0,Kauffman Stadium,7,-5
2017-05-03,2017,SEA,LAA,8,7,-124,-1.5,170,8.0,-119,-101,114,1.5,-200,4.43,T-Mobile Park,15,1
2017-05-03,2017,SF,LAD,4,1,148,1.5,-150,7.5,106,-126,-163,-1.5,130,3.02,Dodger Stadium,5,3
2017-05-03,2017,TB,MIA,6,10,-124,-1.5,170,8.5,-105,-115,114,1.5,-200,4.71,Tropicana Field,16,-4
2017-05-03,2017,OAK,MIN,4,7,116,1.5,-200,8.5,-110,-110,-126,-1.5,170,3.94,Target Field,11,-3
2017-05-03,2017,ATL,NYM,5,16,125,1.5,-135,8.5,-110,-110,-140,-1.5,115,3.78,Suntrust Park,21,-11
2017-05-03,2017,TOR,NYY,6,8,-124,-1.5,130,8.0,-120,100,114,1.5,-150,4.43,Yankee Stadium,14,-2
2017-05-03,2017,MIN,OAK,7,4,-126,-1.5,170,8.5,-110,-110,116,1.5,-200,4.74,Target Field,11,3
2017-05-03,2017,CHC,PHI,5,4,-240,-1.5,-105,7.0,105,-125,200,1.5,-115,4.94,Wrigley Field,9,1
2017-05-03,2017,CIN,PIT,7,2,-109,1.5,-175,8.5,-110,-110,-101,-1.5,151,4.43,Great American Ballpark,9,5
2017-05-03,2017,COL,SD,11,3,-114,-1.5,140,8.0,-120,100,104,1.5,-160,4.26,PETCO Park,14,8
2017-05-03,2017,LAA,SEA,7,8,114,1.5,-200,8.0,-119,-101,-124,-1.5,170,3.74,T-Mobile Park,15,-1
2017-05-03,2017,LAD,SF,1,4,-163,-1.5,130,7.5,106,-126,148,1.5,-150,4.65,Dodger Stadium,5,-3
2017-05-03,2017,MIA,TB,10,6,114,1.5,-200,8.5,-105,-115,-124,-1.5,170,3.97,Tropicana Field,16,4
2017-05-03,2017,HOU,TEX,10,1,-177,-1.5,115,8.5,100,-120,157,1.5,-135,5.43,Minute Maid Park,11,9
2017-05-03,2017,NYY,TOR,8,6,114,1.5,-150,8.0,-120,100,-124,-1.5,130,3.74,Yankee Stadium,14,2
2017-05-03,2017,ARI,WSH,1,2,133,1.5,-170,8.0,-120,100,-148,-1.5,148,3.43,Nationals Park,3,-1
2017-05-04,2017,WSH,ARI,4,2,-285,-1.5,-140,8.0,-105,-115,245,1.5,120,5.92,Nationals Park,6,2
2017-05-04,2017,BOS,BAL,3,8,-124,-1.5,155,9.5,-115,-105,114,1.5,-180,5.26,Fenway Park,11,-5
2017-05-04,2017,BAL,BOS,8,3,114,1.5,-180,9.5,-115,-105,-124,-1.5,155,4.44,Fenway Park,11,5
2017-05-04,2017,PHI,CHC,4,5,153,1.5,-150,7.0,105,-125,-173,-1.5,130,2.77,Wrigley Field,9,-1
2017-05-04,2017,PIT,CIN,2,4,102,1.5,-215,8.0,-109,-111,-112,-1.5,180,3.96,Great American Ballpark,6,-2
2017-05-04,2017,SD,COL,2,3,-126,-1.5,172,8.0,-120,100,116,1.5,-205,4.46,PETCO Park,5,-1
2017-05-04,2017,KC,CWS,3,8,-148,-1.5,144,7.5,100,-120,133,1.5,-165,4.48,Kauffman Stadium,11,-5
2017-05-04,2017,TEX,HOU,10,4,139,1.5,-155,8.5,-115,-105,-154,-1.5,135,3.56,Minute Maid Park,14,6
2017-05-04,2017,CWS,KC,8,3,133,1.5,-165,7.5,100,-120,-148,-1.5,144,3.22,Kauffman Stadium,11,5
2017-05-04,2017,SEA,LAA,11,3,-158,-1.5,125,8.5,-110,-110,143,1.5,-145,5.21,T-Mobile Park,14,8
2017-05-04,2017,TB,MIA,5,1,-118,-1.5,166,8.5,-110,-110,108,1.5,-195,4.6,Tropicana Field,6,4
2017-05-04,2017,STL,MIL,4,5,-151,-1.5,150,7.5,105,-125,136,1.5,-173,4.51,Busch Stadium,9,-1
2017-05-04,2017,OAK,MIN,8,5,102,1.5,-205,9.0,-125,105,-112,-1.5,172,4.46,Target Field,13,3
2017-05-04,2017,MIN,OAK,5,8,-112,-1.5,172,9.0,-125,105,102,1.5,-205,4.75,Target Field,13,-3
2017-05-04,2017,CHC,PHI,5,4,-173,-1.5,130,7.0,105,-125,153,1.5,-150,4.44,Wrigley Field,9,1
2017-05-04,2017,CIN,PIT,4,2,-112,-1.5,180,8.0,-109,-111,102,1.5,-215,4.23,Great American Ballpark,6,2
2017-05-04,2017,COL,SD,3,2,116,1.5,-205,8.0,-120,100,-126,-1.5,172,3.7,PETCO Park,5,1
2017-05-04,2017,LAA,SEA,3,11,143,1.5,-145,8.5,-110,-110,-158,-1.5,125,3.5,T-Mobile Park,14,-8
2017-05-04,2017,MIL,STL,5,4,136,1.5,-173,7.5,105,-125,-151,-1.5,150,3.18,Busch Stadium,9,1
2017-05-04,2017,MIA,TB,1,5,108,1.5,-195,8.5,-110,-110,-118,-1.5,166,4.09,Tropicana Field,6,-4
2017-05-04,2017,HOU,TEX,4,10,-154,-1.5,135,8.5,-115,-105,139,1.5,-155,5.15,Minute Maid Park,14,-6
2017-05-04,2017,ARI,WSH,2,4,245,1.5,120,8.0,-105,-115,-285,-1.5,-140,2.32,Nationals Park,6,-2
2017-05-05,2017,COL,ARI,3,6,-114,-1.5,166,11.0,-120,100,104,1.5,-195,5.86,Coors Field,9,-3
2017-05-05,2017,STL,ATL,10,0,105,1.5,-210,8.0,-120,100,-115,-1.5,176,3.9,Suntrust Park,10,10
2017-05-05,2017,CWS,BAL,2,4,165,1.5,-125,8.5,-125,105,-185,-1.5,105,3.21,Camden Yards,6,-2
2017-05-05,2017,MIN,BOS,4,3,136,1.5,-120,9.5,-105,-115,-151,-1.5,100,4.03,Target Field,7,1
2017-05-05,2017,NYY,CHC,3,2,119,1.5,-195,6.5,-125,105,-134,-1.5,166,2.97,Wrigley Field,5,1
2017-05-05,2017,SF,CIN,3,13,105,1.5,-205,9.0,-120,100,-115,-1.5,172,4.39,Great American Ballpark,16,-10
2017-05-05,2017,KC,CLE,3,1,150,1.5,-115,8.0,-120,100,-170,-1.5,-105,3.2,Kauffman Stadium,4,2
2017-05-05,2017,ARI,COL,6,3,104,1.5,-195,11.0,-120,100,-114,-1.5,166,5.39,Coors Field,9,3
2017-05-05,2017,BAL,CWS,4,2,-185,-1.5,105,8.5,-125,105,165,1.5,-125,5.52,Camden Yards,6,2
2017-05-05,2017,OAK,DET,2,7,-126,-1.5,172,7.5,100,-120,116,1.5,-205,4.18,Oakland Coliseum,9,-5
2017-05-05,2017,LAA,HOU,6,7,116,1.5,-150,7.5,-105,-115,-126,-1.5,130,3.47,Angel Stadium,13,-1
2017-05-05,2017,CLE,KC,1,3,-170,-1.5,-105,8.0,-120,100,150,1.5,-115,5.04,Kauffman Stadium,4,-2
2017-05-05,2017,HOU,LAA,7,6,-126,-1.5,130,7.5,-105,-115,116,1.5,-150,4.18,Angel Stadium,13,1
2017-05-05,2017,SD,LAD,2,8,160,1.5,-110,7.5,-115,-105,-180,-1.5,-110,2.88,PETCO Park,10,-6
2017-05-05,2017,NYM,MIA,8,7,-105,-1.5,180,9.0,-106,-114,-105,1.5,-215,4.61,Citi Field,15,1
2017-05-05,2017,PIT,MIL,4,0,-135,-1.5,163,8.5,-120,100,120,1.5,-190,4.88,PNC Park,4,4
2017-05-05,2017,BOS,MIN,3,4,-151,-1.5,100,9.5,-105,-115,136,1.5,-120,5.72,Target Field,7,-1
2017-05-05,2017,MIA,NYM,7,8,-105,1.5,-215,9.0,-106,-114,-105,-1.5,180,4.61,Citi Field,15,-1
2017-05-05,2017,CHC,NYY,2,3,-134,-1.5,166,6.5,-125,105,119,1.5,-195,3.72,Wrigley Field,5,-1
2017-05-05,2017,DET,OAK,7,2,116,1.5,-205,7.5,100,-120,-126,-1.5,172,3.47,Oakland Coliseum,9,5
2017-05-05,2017,WSH,PHI,4,2,-162,-1.5,-101,8.0,-120,100,147,1.5,-119,4.95,Citizens Bank Park,6,2
2017-05-05,2017,MIL,PIT,0,4,120,1.5,-190,8.5,-120,100,-135,-1.5,163,3.86,PNC Park,4,-4
2017-05-05,2017,LAD,SD,8,2,-180,-1.5,-110,7.5,-115,-105,160,1.5,-110,4.82,PETCO Park,10,6
2017-05-05,2017,TEX,SEA,3,1,-121,-1.5,140,7.5,-101,-119,111,1.5,-160,4.11,T-Mobile Park,4,2
2017-05-05,2017,CIN,SF,13,3,-115,-1.5,172,9.0,-120,100,105,1.5,-205,4.81,Great American Ballpark,16,10
2017-05-05,2017,ATL,STL,0,10,-115,-1.5,176,8.0,-120,100,105,1.5,-210,4.28,Suntrust Park,10,-10
2017-05-05,2017,TOR,TB,8,4,138,1.5,-165,7.5,-104,-116,-153,-1.5,144,3.15,Tropicana Field,12,4
2017-05-05,2017,SEA,TEX,1,3,111,1.5,-160,7.5,-101,-119,-121,-1.5,140,3.55,T-Mobile Park,4,-2
2017-05-05,2017,TB,TOR,4,8,-153,-1.5,144,7.5,-104,-116,138,1.5,-165,4.54,Tropicana Field,12,-4
2017-05-05,2017,PHI,WSH,2,4,147,1.5,-119,8.0,-120,100,-162,-1.5,-101,3.24,Citizens Bank Park,6,-2
2017-05-06,2017,COL,ARI,9,1,-135,-1.5,144,11.5,103,-123,120,1.5,-165,6.61,Coors Field,10,8
2017-05-06,2017,STL,ATL,5,3,114,1.5,-205,8.5,-105,-115,-124,-1.5,172,3.97,Suntrust Park,8,2
2017-05-06,2017,CWS,BAL,5,6,180,1.5,-105,8.5,-120,100,-210,-1.5,-115,3.04,Camden Yards,11,-1
2017-05-06,2017,MIN,BOS,1,11,118,1.5,-142,9.5,100,-120,-133,-1.5,121,4.36,Target Field,12,-10
2017-05-06,2017,NYY,CHC,11,6,116,1.5,-190,8.0,100,-120,-131,-1.5,163,3.7,Wrigley Field,17,5
2017-05-06,2017,SF,CIN,2,14,115,1.5,-180,9.0,-105,-115,-130,-1.5,155,4.19,Great American Ballpark,16,-12
2017-05-06,2017,KC,CLE,1,3,-109,-1.5,176,8.5,-120,100,-101,1.5,-210,4.43,Kauffman Stadium,4,-2
2017-05-06,2017,ARI,COL,1,9,120,1.5,-165,11.5,103,-123,-135,-1.5,144,5.23,Coors Field,10,-8
2017-05-06,2017,BAL,CWS,6,5,-210,-1.5,-115,8.5,-120,100,180,1.5,-105,5.76,Camden Yards,11,1
2017-05-06,2017,OAK,DET,6,5,-121,-1.5,166,8.5,-120,100,111,1.5,-195,4.65,Oakland Coliseum,11,1
2017-05-06,2017,LAA,HOU,2,1,-104,1.5,-170,7.5,100,-120,-106,-1.5,148,3.82,Angel Stadium,3,1
2017-05-06,2017,CLE,KC,3,1,-101,1.5,-210,8.5,-120,100,-109,-1.5,176,4.27,Kauffman Stadium,4,2
2017-05-06,2017,HOU,LAA,1,2,-106,-1.5,148,7.5,100,-120,-104,1.5,-170,3.86,Angel Stadium,3,-1
2017-05-06,2017,SD,LAD,2,10,200,1.5,115,6.5,-125,105,-240,-1.5,-135,2.17,PETCO Park,12,-8
2017-05-06,2017,NYM,MIA,11,3,-141,-1.5,148,8.5,-117,-103,126,1.5,-170,4.97,Citi Field,14,8
2017-05-06,2017,PIT,MIL,2,1,-165,-1.5,125,8.0,-105,-115,150,1.5,-145,4.98,PNC Park,3,1
2017-05-06,2017,BOS,MIN,11,1,-133,-1.5,121,9.5,100,-120,118,1.5,-142,5.42,Target Field,12,10
2017-05-06,2017,MIA,NYM,3,11,126,1.5,-170,8.5,-117,-103,-141,-1.5,148,3.76,Citi Field,14,-8
2017-05-06,2017,CHC,NYY,6,11,-131,-1.5,163,8.0,100,-120,116,1.5,-190,4.54,Wrigley Field,17,-5
2017-05-06,2017,DET,OAK,5,6,111,1.5,-195,8.5,-120,100,-121,-1.5,166,4.03,Oakland Coliseum,11,-1
2017-05-06,2017,WSH,PHI,6,2,116,1.5,-195,8.5,-120,100,-126,-1.5,166,3.94,Citizens Bank Park,8,4
2017-05-06,2017,MIL,PIT,1,2,150,1.5,-145,8.0,-105,-115,-165,-1.5,125,3.2,PNC Park,3,-1
2017-05-06,2017,LAD,SD,10,2,-240,-1.5,-135,6.5,-125,105,200,1.5,115,4.59,PETCO Park,12,8
2017-05-06,2017,TEX,SEA,2,8,104,1.5,-205,9.0,100,-120,-114,-1.5,172,4.41,T-Mobile Park,10,-6
2017-05-06,2017,CIN,SF,14,2,-130,-1.5,155,9.0,-105,-115,115,1.5,-180,5.09,Great American Ballpark,16,12
2017-05-06,2017,ATL,STL,3,5,-124,-1.5,172,8.5,-105,-115,114,1.5,-205,4.71,Suntrust Park,8,-2
2017-05-06,2017,TOR,TB,1,6,123,1.5,-180,8.0,100,-120,-138,-1.5,155,3.59,Tropicana Field,7,-5
2017-05-06,2017,SEA,TEX,8,2,-114,-1.5,172,9.0,100,-120,104,1.5,-205,4.79,T-Mobile Park,10,6
2017-05-06,2017,TB,TOR,6,1,-138,-1.5,155,8.0,100,-120,123,1.5,-180,4.64,Tropicana Field,7,5
2017-05-06,2017,PHI,WSH,2,6,-126,-1.5,166,8.5,-120,100,116,1.5,-195,4.74,Citizens Bank Park,8,-4
2017-05-07,2017,COL,ARI,5,2,-113,-1.5,151,12.0,-105,-115,103,1.5,-175,6.37,Coors Field,7,3
2017-05-07,2017,STL,ATL,6,4,-109,-1.5,145,9.0,-115,-105,-101,1.5,-166,4.69,Suntrust Park,10,2
2017-05-07,2017,CWS,BAL,0,4,107,1.5,-205,8.5,-110,-110,-117,-1.5,172,4.11,Camden Yards,4,-4
2017-05-07,2017,MIN,BOS,6,17,160,1.5,-110,7.0,100,-120,-180,-1.5,-110,2.69,Target Field,23,-11
2017-05-07,2017,NYY,CHC,5,4,117,1.5,-205,7.0,105,-125,-132,-1.5,172,3.23,Wrigley Field,9,1
2017-05-07,2017,SF,CIN,0,4,-122,-1.5,135,8.5,100,-120,112,1.5,-155,4.67,Great American Ballpark,4,-4
2017-05-07,2017,KC,CLE,0,1,-105,1.5,-170,9.0,-110,-110,-105,-1.5,148,4.61,Kauffman Stadium,1,-1
2017-05-07,2017,ARI,COL,2,5,103,1.5,-175,12.0,-105,-115,-113,-1.5,151,5.91,Coors Field,7,-3
2017-05-07,2017,BAL,CWS,4,0,-117,-1.5,172,8.5,-110,-110,107,1.5,-205,4.58,Camden Yards,4,4
2017-05-07,2017,OAK,DET,8,6,-131,-1.5,163,8.0,-118,-102,116,1.5,-190,4.54,Oakland Coliseum,14,2
2017-05-07,2017,LAA,HOU,3,5,109,1.5,-162,8.0,-105,-115,-119,-1.5,141,3.83,Angel Stadium,8,-2
2017-05-07,2017,CLE,KC,1,0,-105,-1.5,148,9.0,-110,-110,-105,1.5,-170,4.61,Kauffman Stadium,1,1
2017-05-07,2017,HOU,LAA,5,3,-119,-1.5,141,8.0,-105,-115,109,1.5,-162,4.35,Angel Stadium,8,2
2017-05-07,2017,NYM,MIA,0,7,-118,-1.5,172,8.5,-115,-105,108,1.5,-205,4.6,Citi Field,7,-7
2017-05-07,2017,PIT,MIL,2,6,-106,-1.5,184,8.5,-105,-115,-104,1.5,-220,4.37,PNC Park,8,-4
2017-05-07,2017,BOS,MIN,17,6,-180,-1.5,-110,7.0,100,-120,160,1.5,-110,4.5,Target Field,23,11
2017-05-07,2017,MIA,NYM,7,0,108,1.5,-205,8.5,-115,-105,-118,-1.5,172,4.09,Citi Field,7,7
2017-05-07,2017,CHC,NYY,4,5,-132,-1.5,172,7.0,105,-125,117,1.5,-205,3.98,Wrigley Field,9,-1
2017-05-07,2017,DET,OAK,6,8,116,1.5,-190,8.0,-118,-102,-131,-1.5,163,3.7,Oakland Coliseum,14,-2
2017-05-07,2017,WSH,PHI,5,6,-111,-1.5,140,8.5,-115,-105,101,1.5,-160,4.47,Citizens Bank Park,11,-1
2017-05-07,2017,MIL,PIT,6,2,-104,1.5,-220,8.5,-105,-115,-106,-1.5,184,4.33,PNC Park,8,4
2017-05-07,2017,TEX,SEA,3,4,147,1.5,-150,8.5,-120,100,-162,-1.5,130,3.44,T-Mobile Park,7,-1
2017-05-07,2017,CIN,SF,4,0,112,1.5,-155,8.5,100,-120,-122,-1.5,135,4.01,Great American Ballpark,4,4
2017-05-07,2017,ATL,STL,4,6,-101,1.5,-166,9.0,-115,-105,-109,-1.5,145,4.52,Suntrust Park,10,-2
2017-05-07,2017,TOR,TB,2,1,114,1.5,-190,8.0,-120,100,-124,-1.5,163,3.74,Tropicana Field,3,1
2017-05-07,2017,SEA,TEX,4,3,-162,-1.5,130,8.5,-120,100,147,1.5,-150,5.26,T-Mobile Park,7,1
2017-05-07,2017,TB,TOR,1,2,-124,-1.5,163,8.0,-120,100,114,1.5,-190,4.43,Tropicana Field,3,-1
2017-05-07,2017,PHI,WSH,6,5,101,1.5,-160,8.5,-115,-105,-111,-1.5,140,4.23,Citizens Bank Park,11,1
2017-05-08,2017,WSH,BAL,4,6,112,1.5,-205,9.0,-120,100,-122,-1.5,172,4.25,Camden Yards,10,-2
2017-05-08,2017,NYY,CIN,10,4,-127,-1.5,138,8.5,-115,-105,117,1.5,-159,4.76,Great American Ballpark,14,6
2017-05-08,2017,TOR,CLE,4,2,-114,-1.5,180,8.0,-115,-105,104,1.5,-215,4.26,Rogers Centre,6,2
2017-05-08,2017,TB,KC,3,7,-140,-1.5,151,7.5,-120,100,125,1.5,-175,4.38,Tropicana Field,10,-4
2017-05-08,2017,OAK,LAA,3,2,-131,-1.5,163,8.0,-105,-115,116,1.5,-190,4.54,Oakland Coliseum,5,1
2017-05-08,2017,PIT,LAD,1,12,205,1.5,-110,8.0,-105,-115,-235,-1.5,-110,2.62,Dodger Stadium,13,-11
2017-05-08,2017,STL,MIA,9,4,-116,-1.5,148,8.5,101,-121,106,1.5,-170,4.56,Marlins Park,13,5
2017-05-08,2017,SF,NYM,3,4,138,1.5,-165,7.0,105,-125,-153,-1.5,144,2.94,Citi Field,7,-1
2017-05-08,2017,CIN,NYY,4,10,117,1.5,-159,8.5,-115,-105,-127,-1.5,138,3.92,Great American Ballpark,14,-6
2017-05-08,2017,LAA,OAK,2,3,116,1.5,-190,8.0,-105,-115,-131,-1.5,163,3.7,Oakland Coliseum,5,-1
2017-05-08,2017,LAD,PIT,12,1,-235,-1.5,-110,8.0,-105,-115,205,1.5,-110,5.61,Dodger Stadium,13,11
2017-05-08,2017,TEX,SD,1,5,113,1.5,-200,7.5,-110,-110,-123,-1.5,170,3.52,PETCO Park,6,-4
2017-05-08,2017,NYM,SF,4,3,-153,-1.5,144,7.0,105,-125,138,1.5,-165,4.23,Citi Field,7,1
2017-05-08,2017,MIA,STL,4,9,106,1.5,-170,8.5,101,-121,-116,-1.5,148,4.13,Marlins Park,13,-5
2017-05-08,2017,KC,TB,7,3,125,1.5,-175,7.5,-120,100,-140,-1.5,151,3.33,Tropicana Field,10,4
2017-05-08,2017,SD,TEX,5,1,-123,-1.5,170,7.5,-110,-110,113,1.5,-200,4.14,PETCO Park,6,4
2017-05-08,2017,CLE,TOR,2,4,104,1.5,-215,8.0,-115,-105,-114,-1.5,180,3.92,Rogers Centre,6,-2
2017-05-08,2017,BAL,WSH,6,4,-122,-1.5,172,9.0,-120,100,112,1.5,-205,4.95,Camden Yards,10,2
2017-05-09,2017,DET,ARI,7,3,-101,1.5,-215,8.0,-115,-105,-109,-1.5,180,4.02,Chase Field,10,4
2017-05-09,2017,HOU,ATL,8,3,-190,-1.5,105,8.5,-115,-105,170,1.5,-125,5.57,Minute Maid Park,11,5
2017-05-09,2017,WSH,BAL,4,5,-160,-1.5,100,8.5,-120,100,145,1.5,-120,5.23,Camden Yards,9,-1
2017-05-09,2017,MIL,BOS,11,7,115,1.5,-150,8.5,-110,-110,-125,-1.5,130,3.95,Miller Park,18,4
2017-05-09,2017,COL,CHC,10,4,130,1.5,-130,11.0,-110,-110,-145,-1.5,110,4.78,Coors Field,14,6
2017-05-09,2017,COL,CHC,1,8,128,1.5,-135,10.5,-125,105,-143,-1.5,115,4.61,Coors Field,9,-7
2017-05-09,2017,NYY,CIN,3,5,-102,-1.5,144,8.5,-120,100,-108,1.5,-165,4.29,Great American Ballpark,8,-2
2017-05-09,2017,TOR,CLE,0,6,162,1.5,-110,8.0,100,-120,-182,-1.5,-110,3.05,Rogers Centre,6,-6
2017-05-09,2017,CHC,COL,4,10,-145,-1.5,110,11.0,-110,-110,130,1.5,-130,6.51,Coors Field,14,-6
2017-05-09,2017,CHC,COL,8,1,-143,-1.5,115,10.5,-125,105,128,1.5,-135,6.18,Coors Field,9,7
2017-05-09,2017,MIN,CWS,7,2,-108,-1.5,144,9.0,100,-120,-102,1.5,-165,4.67,Guaranteed Rate Field,9,5
2017-05-09,2017,ARI,DET,3,7,-109,-1.5,180,8.0,-115,-105,-101,1.5,-215,4.17,Chase Field,10,-4
2017-05-09,2017,ATL,HOU,3,8,170,1.5,-125,8.5,-115,-105,-190,-1.5,105,3.15,Minute Maid Park,11,-5
2017-05-09,2017,TB,KC,6,7,-165,-1.5,125,8.0,-125,105,150,1.5,-145,4.98,Tropicana Field,13,-1
2017-05-09,2017,OAK,LAA,3,7,-131,-1.5,148,8.0,-105,-115,116,1.5,-170,4.54,Oakland Coliseum,10,-4
2017-05-09,2017,PIT,LAD,3,4,172,1.5,-130,7.5,105,-125,-192,-1.5,110,2.76,Dodger Stadium,7,-1
2017-05-09,2017,STL,MIA,6,5,105,1.5,-195,8.5,-105,-115,-115,-1.5,166,4.15,Marlins Park,11,1
2017-05-09,2017,BOS,MIL,7,11,-125,-1.5,130,8.5,-110,-110,115,1.5,-150,4.72,Miller Park,18,-4
2017-05-09,2017,CWS,MIN,2,7,-102,1.5,-165,9.0,100,-120,-108,-1.5,144,4.54,Guaranteed Rate Field,9,-5
2017-05-09,2017,SF,NYM,1,6,-101,1.5,-215,7.0,-125,105,-109,-1.5,180,3.52,Citi Field,7,-5
2017-05-09,2017,CIN,NYY,5,3,-108,1.5,-165,8.5,-120,100,-102,-1.5,144,4.41,Great American Ballpark,8,2
2017-05-09,2017,LAA,OAK,7,3,116,1.5,-170,8.0,-105,-115,-131,-1.5,148,3.7,Oakland Coliseum,10,4
2017-05-09,2017,SEA,PHI,10,9,104,1.5,-205,8.0,-110,-110,-114,-1.5,172,3.92,Citizens Bank Park,19,1
2017-05-09,2017,LAD,PIT,4,3,-192,-1.5,110,7.5,105,-125,172,1.5,-130,4.93,Dodger Stadium,7,1
2017-05-09,2017,TEX,SD,11,0,-116,-1.5,120,8.5,100,-120,106,1.5,-140,4.56,PETCO Park,11,11
2017-05-09,2017,PHI,SEA,9,10,-114,-1.5,172,8.0,-110,-110,104,1.5,-205,4.26,Citizens Bank Park,19,-1
2017-05-09,2017,NYM,SF,6,1,-109,-1.5,180,7.0,-125,105,-101,1.5,-215,3.65,Citi Field,7,5
2017-05-09,2017,MIA,STL,5,6,-115,-1.5,166,8.5,-105,-115,105,1.5,-195,4.55,Marlins Park,11,-1
2017-05-09,2017,KC,TB,7,6,150,1.5,-145,8.0,-125,105,-165,-1.5,125,3.2,Tropicana Field,13,1
2017-05-09,2017,SD,TEX,0,11,106,1.5,-140,8.5,100,-120,-116,-1.5,120,4.13,PETCO Park,11,-11
2017-05-09,2017,CLE,TOR,6,0,-182,-1.5,-110,8.0,100,-120,162,1.5,-110,5.16,Rogers Centre,6,6
2017-05-09,2017,BAL,WSH,5,4,145,1.5,-120,8.5,-120,100,-160,-1.5,100,3.47,Camden Yards,9,1
2017-05-10,2017,DET,ARI,1,7,121,1.5,-170,10.5,-101,-119,-136,-1.5,148,4.75,Chase Field,8,-6
2017-05-10,2017,HOU,ATL,4,2,-205,-1.5,100,9.0,-115,-105,175,1.5,-120,6.05,Minute Maid Park,6,2
2017-05-10,2017,WSH,BAL,7,6,-178,-1.5,125,7.5,-115,-105,158,1.5,-145,4.8,Nationals Park,13,1
2017-05-10,2017,MIL,BOS,7,4,-121,-1.5,163,9.0,-125,105,111,1.5,-190,4.93,Miller Park,11,3
2017-05-10,2017,COL,CHC,3,0,118,1.5,-142,10.0,102,-122,-128,-1.5,122,4.59,Coors Field,3,3
2017-05-10,2017,TOR,CLE,8,7,153,1.5,-109,7.5,-120,100,-168,-1.5,-111,2.96,Rogers Centre,15,1
2017-05-10,2017,CHC,COL,0,3,-128,-1.5,122,10.0,102,-122,118,1.5,-142,5.61,Coors Field,3,-3
2017-05-10,2017,ARI,DET,7,1,-136,-1.5,148,10.5,-101,-119,121,1.5,-170,6.05,Chase Field,8,6
2017-05-10,2017,ATL,HOU,2,4,175,1.5,-120,9.0,-115,-105,-205,-1.5,100,3.27,Minute Maid Park,6,-2
2017-05-10,2017,TB,KC,12,1,-180,-1.5,121,7.5,-120,100,160,1.5,-140,4.82,Tropicana Field,13,11
2017-05-10,2017,OAK,LAA,3,1,-145,-1.5,144,7.5,-105,-115,130,1.5,-165,4.44,Oakland Coliseum,4,2
2017-05-10,2017,PIT,LAD,2,5,185,1.5,-115,7.5,100,-120,-215,-1.5,-105,2.63,Dodger Stadium,7,-3
2017-05-10,2017,STL,MIA,7,5,105,1.5,-210,9.0,-105,-115,-115,-1.5,176,4.39,Marlins Park,12,2
2017-05-10,2017,BOS,MIL,4,7,111,1.5,-190,9.0,-125,105,-121,-1.5,163,4.27,Miller Park,11,-3
2017-05-10,2017,SF,NYM,6,5,116,1.5,-180,8.5,-105,-115,-131,-1.5,155,3.94,Citi Field,11,1
2017-05-10,2017,LAA,OAK,1,3,130,1.5,-165,7.5,-105,-115,-145,-1.5,144,3.26,Oakland Coliseum,4,-2
2017-05-10,2017,SEA,PHI,11,6,-121,-1.5,135,9.0,-115,-105,111,1.5,-155,4.93,Citizens Bank Park,17,5
2017-05-10,2017,LAD,PIT,5,2,-215,-1.5,-105,7.5,100,-120,185,1.5,-115,5.12,Dodger Stadium,7,3
2017-05-10,2017,TEX,SD,4,3,-195,-1.5,-101,8.5,-115,-105,175,1.5,-119,5.62,Rangers Ballpark,7,1
2017-05-10,2017,PHI,SEA,6,11,111,1.5,-155,9.0,-115,-105,-121,-1.5,135,4.27,Citizens Bank Park,17,-5
2017-05-10,2017,NYM,SF,5,6,-131,-1.5,155,8.5,-105,-115,116,1.5,-180,4.82,Citi Field,11,-1
2017-05-10,2017,MIA,STL,5,7,-115,-1.5,176,9.0,-105,-115,105,1.5,-210,4.81,Marlins Park,12,-2
2017-05-10,2017,KC,TB,1,12,160,1.5,-140,7.5,-120,100,-180,-1.5,121,2.88,Tropicana Field,13,-11
2017-05-10,2017,SD,TEX,3,4,175,1.5,-119,8.5,-115,-105,-195,-1.5,-101,3.09,Rangers Ballpark,7,-1
2017-05-10,2017,CLE,TOR,7,8,-168,-1.5,-111,7.5,-120,100,153,1.5,-109,4.7,Rogers Centre,15,-1
2017-05-10,2017,BAL,WSH,6,7,158,1.5,-145,7.5,-115,-105,-178,-1.5,125,2.91,Nationals Park,13,-1
2017-05-11,2017,PIT,ARI,1,2,123,1.5,-185,8.0,-120,100,-138,-1.5,160,3.59,Chase Field,3,-1
2017-05-11,2017,MIL,BOS,1,4,133,1.5,-125,8.5,-105,-115,-148,-1.5,105,3.65,Miller Park,5,-3
2017-05-11,2017,SF,CIN,2,3,-107,-1.5,181,9.0,100,-120,-103,1.5,-217,4.65,AT&T Park,5,-1
2017-05-11,2017,LAD,COL,7,10,-135,-1.5,115,11.0,102,-122,120,1.5,-135,6.32,Coors Field,17,-3
2017-05-11,2017,MIN,CWS,7,6,111,1.5,-195,8.5,-120,100,-121,-1.5,166,4.03,Guaranteed Rate Field,13,1
2017-05-11,2017,LAA,DET,1,7,-131,-1.5,166,7.5,100,-120,116,1.5,-195,4.25,Angel Stadium,8,-6
2017-05-11,2017,NYY,HOU,2,3,-126,-1.5,176,7.5,-105,-115,116,1.5,-210,4.18,Yankee Stadium,5,-1
2017-05-11,2017,TB,KC,0,6,-124,-1.5,172,7.5,-105,-115,114,1.5,-205,4.15,Tropicana Field,6,-6
2017-05-11,2017,DET,LAA,7,1,116,1.5,-195,7.5,100,-120,-131,-1.5,166,3.47,Angel Stadium,8,6
2017-05-11,2017,COL,LAD,10,7,120,1.5,-135,11.0,102,-122,-135,-1.5,115,5.0,Coors Field,17,3
2017-05-11,2017,BOS,MIL,4,1,-148,-1.5,105,8.5,-105,-115,133,1.5,-125,5.07,Miller Park,5,3
2017-05-11,2017,CWS,MIN,6,7,-121,-1.5,166,8.5,-120,100,111,1.5,-195,4.65,Guaranteed Rate Field,13,-1
2017-05-11,2017,HOU,NYY,3,2,116,1.5,-210,7.5,-105,-115,-126,-1.5,176,3.47,Yankee Stadium,5,1
2017-05-11,2017,ARI,PIT,2,1,-138,-1.5,160,8.0,-120,100,123,1.5,-185,4.64,Chase Field,3,1
2017-05-11,2017,TEX,SD,5,2,-138,-1.5,144,9.5,100,-120,123,1.5,-165,5.51,Rangers Ballpark,7,3
2017-05-11,2017,TOR,SEA,7,2,-158,-1.5,135,8.5,-125,105,143,1.5,-155,5.21,Rogers Centre,9,5
2017-05-11,2017,CIN,SF,3,2,-103,1.5,-217,9.0,100,-120,-107,-1.5,181,4.57,AT&T Park,5,1
2017-05-11,2017,KC,TB,6,0,114,1.5,-205,7.5,-105,-115,-124,-1.5,172,3.5,Tropicana Field,6,6
2017-05-11,2017,SD,TEX,2,5,123,1.5,-165,9.5,100,-120,-138,-1.5,144,4.26,Rangers Ballpark,7,-3
2017-05-11,2017,SEA,TOR,2,7,143,1.5,-155,8.5,-125,105,-158,-1.5,135,3.5,Rogers Centre,9,-5
2017-05-12,2017,PIT,ARI,4,11,135,1.5,-152,10.5,-120,100,-150,-1.5,132,4.47,Chase Field,15,-7
2017-05-12,2017,MIA,ATL,4,8,-122,-1.5,163,9.0,-105,-115,112,1.5,-190,4.95,Marlins Park,12,-4
2017-05-12,2017,KC,BAL,3,2,-103,1.5,-170,8.5,100,-120,-107,-1.5,148,4.31,Kauffman Stadium,5,1
2017-05-12,2017,TB,BOS,5,4,153,1.5,-150,9.0,100,-120,-168,-1.5,130,3.56,Fenway Park,9,1
2017-05-12,2017,STL,CHC,2,3,-142,-1.5,148,8.5,-110,-110,127,1.5,-170,4.99,Busch Stadium,5,-1
2017-05-12,2017,SF,CIN,3,2,-159,-1.5,150,7.0,-115,-105,144,1.5,-173,4.3,AT&T Park,5,1
2017-05-12,2017,MIN,CLE,1,0,130,1.5,-155,8.5,-110,-110,-145,-1.5,135,3.7,Progressive Field,1,1
2017-05-12,2017,LAD,COL,6,2,-205,-1.5,-130,10.0,100,-120,175,1.5,110,6.72,Coors Field,8,4
2017-05-12,2017,SD,CWS,6,3,108,1.5,-205,8.0,-105,-115,-118,-1.5,172,3.85,Guaranteed Rate Field,9,3
2017-05-12,2017,LAA,DET,7,0,-147,-1.5,144,8.5,-120,100,132,1.5,-165,5.06,Angel Stadium,7,7
2017-05-12,2017,NYY,HOU,1,5,111,1.5,-150,8.0,-110,-110,-121,-1.5,130,3.79,Yankee Stadium,6,-4
2017-05-12,2017,BAL,KC,2,3,-107,-1.5,148,8.5,100,-120,-103,1.5,-170,4.39,Kauffman Stadium,5,-1
2017-05-12,2017,DET,LAA,0,7,132,1.5,-165,8.5,-120,100,-147,-1.5,144,3.66,Angel Stadium,7,-7
2017-05-12,2017,COL,LAD,2,6,175,1.5,110,10.0,100,-120,-205,-1.5,-130,3.64,Coors Field,8,-4
2017-05-12,2017,ATL,MIA,8,4,112,1.5,-190,9.0,-105,-115,-122,-1.5,163,4.25,Marlins Park,12,4
2017-05-12,2017,NYM,MIL,4,7,-116,-1.5,144,9.0,-110,-110,106,1.5,-165,4.83,Miller Park,11,-3
2017-05-12,2017,CLE,MIN,0,1,-145,-1.5,135,8.5,-110,-110,130,1.5,-155,5.03,Progressive Field,1,-1
2017-05-12,2017,MIL,NYM,7,4,106,1.5,-165,9.0,-110,-110,-116,-1.5,144,4.37,Miller Park,11,3
2017-05-12,2017,HOU,NYY,5,1,-121,-1.5,130,8.0,-110,-110,111,1.5,-150,4.38,Yankee Stadium,6,4
2017-05-12,2017,TEX,OAK,5,2,-111,-1.5,170,9.5,-110,-110,101,1.5,-200,5.0,Rangers Ballpark,7,3
2017-05-12,2017,ARI,PIT,11,4,-150,-1.5,132,10.5,-120,100,135,1.5,-152,6.3,Chase Field,15,7
2017-05-12,2017,CWS,SD,3,6,-118,-1.5,172,8.0,-105,-115,108,1.5,-205,4.33,Guaranteed Rate Field,9,-3
2017-05-12,2017,TOR,SEA,4,0,-144,-1.5,144,8.5,-115,-105,129,1.5,-165,5.02,Rogers Centre,4,4
2017-05-12,2017,CIN,SF,2,3,144,1.5,-173,7.0,-115,-105,-159,-1.5,150,2.87,AT&T Park,5,-1
2017-05-12,2017,CHC,STL,3,2,127,1.5,-170,8.5,-110,-110,-142,-1.5,148,3.74,Busch Stadium,5,1
2017-05-12,2017,BOS,TB,4,5,-168,-1.5,130,9.0,100,-120,153,1.5,-150,5.64,Fenway Park,9,-1
2017-05-12,2017,OAK,TEX,2,5,101,1.5,-200,9.5,-110,-110,-111,-1.5,170,4.73,Rangers Ballpark,7,-3
2017-05-12,2017,SEA,TOR,0,4,129,1.5,-165,8.5,-115,-105,-144,-1.5,144,3.71,Rogers Centre,4,-4
2017-05-13,2017,PIT,ARI,4,3,150,1.5,-132,10.5,-115,-105,-165,-1.5,112,4.2,Chase Field,7,1
2017-05-13,2017,MIA,ATL,1,3,-132,-1.5,160,9.5,-105,-115,117,1.5,-185,5.41,Marlins Park,4,-2
2017-05-13,2017,KC,BAL,4,3,-129,-1.5,160,9.0,-110,-110,119,1.5,-185,5.07,Kauffman Stadium,7,1
2017-05-13,2017,TB,BOS,3,6,245,1.5,109,7.0,-120,100,-285,-1.5,-129,2.03,Fenway Park,9,-3
2017-05-13,2017,STL,CHC,5,3,-124,-1.5,170,7.5,-120,100,114,1.5,-200,4.15,Busch Stadium,8,2
2017-05-13,2017,SF,CIN,3,1,-116,-1.5,176,8.5,-120,100,106,1.5,-210,4.56,AT&T Park,4,2
2017-05-13,2017,MIN,CLE,4,1,143,1.5,-143,9.0,-110,-110,-158,-1.5,124,3.7,Progressive Field,5,3
2017-05-13,2017,LAD,COL,4,0,-121,-1.5,125,10.0,-105,-115,111,1.5,-145,5.48,Coors Field,4,4
2017-05-13,2017,SD,CWS,4,5,-141,-1.5,115,9.5,100,-120,126,1.5,-135,5.56,Guaranteed Rate Field,9,-1
2017-05-13,2017,LAA,DET,3,4,-145,-1.5,151,8.5,-115,-105,130,1.5,-175,5.03,Angel Stadium,7,-1
2017-05-13,2017,BAL,KC,3,4,119,1.5,-185,9.0,-110,-110,-129,-1.5,160,4.11,Kauffman Stadium,7,-1
2017-05-13,2017,DET,LAA,4,3,130,1.5,-175,8.5,-115,-105,-145,-1.5,151,3.7,Angel Stadium,7,1
2017-05-13,2017,COL,LAD,0,4,111,1.5,-145,10.0,-105,-115,-121,-1.5,125,4.74,Coors Field,4,-4
2017-05-13,2017,ATL,MIA,3,1,117,1.5,-185,9.5,-105,-115,-132,-1.5,160,4.38,Marlins Park,4,2
2017-05-13,2017,NYM,MIL,4,11,-114,-1.5,144,9.5,-110,-110,104,1.5,-165,5.06,Miller Park,15,-7
2017-05-13,2017,CLE,MIN,1,4,-158,-1.5,124,9.0,-110,-110,143,1.5,-143,5.51,Progressive Field,5,-3
2017-05-13,2017,MIL,NYM,11,4,104,1.5,-165,9.5,-110,-110,-114,-1.5,144,4.66,Miller Park,15,7
2017-05-13,2017,TEX,OAK,6,5,-101,1.5,-165,9.5,-115,-105,-109,-1.5,144,4.77,Rangers Ballpark,11,1
2017-05-13,2017,WSH,PHI,6,4,-185,-1.5,110,9.0,100,-120,165,1.5,-130,5.84,Nationals Park,10,2
2017-05-13,2017,ARI,PIT,3,4,-165,-1.5,112,10.5,-115,-105,150,1.5,-132,6.54,Chase Field,7,-1
2017-05-13,2017,CWS,SD,5,4,126,1.5,-135,9.5,100,-120,-141,-1.5,115,4.2,Guaranteed Rate Field,9,1
2017-05-13,2017,TOR,SEA,7,2,-147,-1.5,139,8.5,-105,-115,132,1.5,-159,5.06,Rogers Centre,9,5
2017-05-13,2017,CIN,SF,1,3,106,1.5,-210,8.5,-120,100,-116,-1.5,176,4.13,AT&T Park,4,-2
2017-05-13,2017,CHC,STL,3,5,114,1.5,-200,7.5,-120,100,-124,-1.5,170,3.5,Busch Stadium,8,-2
2017-05-13,2017,BOS,TB,6,3,-285,-1.5,-129,7.0,-120,100,245,1.5,109,5.18,Fenway Park,9,3
2017-05-13,2017,OAK,TEX,5,6,-109,-1.5,144,9.5,-115,-105,-101,1.5,-165,4.95,Rangers Ballpark,11,-1
2017-05-13,2017,SEA,TOR,2,7,132,1.5,-159,8.5,-105,-115,-147,-1.5,139,3.66,Rogers Centre,9,-5
2017-05-13,2017,PHI,WSH,4,6,165,1.5,-130,9.0,100,-120,-185,-1.5,110,3.4,Nationals Park,10,-2
2017-05-14,2017,PIT,ARI,6,4,145,1.5,-150,9.0,105,-125,-160,-1.5,130,3.67,Chase Field,10,2
2017-05-14,2017,MIA,ATL,3,1,-138,-1.5,151,9.0,-125,105,123,1.5,-175,5.22,Marlins Park,4,2
2017-05-14,2017,KC,BAL,9,8,116,1.5,-140,9.5,-110,-110,-131,-1.5,121,4.4,Kauffman Stadium,17,1
2017-05-14,2017,TB,BOS,11,2,157,1.5,-140,8.5,-105,-115,-177,-1.5,120,3.31,Fenway Park,13,9
2017-05-14,2017,STL,CHC,5,0,111,1.5,-155,8.5,-115,-105,-121,-1.5,135,4.03,Busch Stadium,5,5
2017-05-14,2017,SF,CIN,8,3,-149,-1.5,148,8.0,-105,-115,134,1.5,-170,4.79,AT&T Park,11,5
2017-05-14,2017,MIN,CLE,3,8,153,1.5,-140,9.0,-110,-110,-168,-1.5,120,3.56,Progressive Field,11,-5
2017-05-14,2017,LAD,COL,6,9,-137,-1.5,110,11.5,-119,-101,122,1.5,-130,6.65,Coors Field,15,-3
2017-05-14,2017,SD,CWS,3,9,175,1.5,-116,8.5,-110,-110,-205,-1.5,-104,3.09,Guaranteed Rate Field,12,-6
2017-05-14,2017,LAA,DET,4,1,106,1.5,-155,8.0,-120,100,-116,-1.5,135,3.88,Angel Stadium,5,3
2017-05-14,2017,NYY,HOU,11,6,-148,-1.5,144,9.0,101,-121,133,1.5,-165,5.37,Yankee Stadium,17,5
2017-05-14,2017,NYY,HOU,7,10,-124,-1.5,166,8.5,-110,-110,114,1.5,-195,4.71,Yankee Stadium,17,-3
2017-05-14,2017,BAL,KC,8,9,-131,-1.5,121,9.5,-110,-110,116,1.5,-140,5.39,Kauffman Stadium,17,-1
2017-05-14,2017,DET,LAA,1,4,-116,-1.5,135,8.0,-120,100,106,1.5,-155,4.3,Angel Stadium,5,-3
2017-05-14,2017,COL,LAD,9,6,122,1.5,-130,11.5,-119,-101,-137,-1.5,110,5.18,Coors Field,15,3
2017-05-14,2017,ATL,MIA,1,3,123,1.5,-175,9.0,-125,105,-138,-1.5,151,4.04,Marlins Park,4,-2
2017-05-14,2017,NYM,MIL,9,11,-151,-1.5,108,8.5,100,-120,136,1.5,-128,5.11,Miller Park,20,-2
2017-05-14,2017,CLE,MIN,8,3,-168,-1.5,120,9.0,-110,-110,153,1.5,-140,5.64,Progressive Field,11,5
2017-05-14,2017,MIL,NYM,11,9,136,1.5,-128,8.5,100,-120,-151,-1.5,108,3.6,Miller Park,20,2
2017-05-14,2017,HOU,NYY,6,11,133,1.5,-165,9.0,101,-121,-148,-1.5,144,3.86,Yankee Stadium,17,-5
2017-05-14,2017,HOU,NYY,10,7,114,1.5,-195,8.5,-110,-110,-124,-1.5,166,3.97,Yankee Stadium,17,3
2017-05-14,2017,TEX,OAK,6,4,-138,-1.5,148,9.5,-110,-110,123,1.5,-170,5.51,Rangers Ballpark,10,2
2017-05-14,2017,WSH,PHI,3,4,-185,-1.5,115,9.5,-105,-115,165,1.5,-135,6.17,Nationals Park,7,-1
2017-05-14,2017,WSH,PHI,6,5,-221,-1.5,-115,7.5,-110,-110,191,1.5,-105,5.16,Nationals Park,11,1
2017-05-14,2017,ARI,PIT,4,6,-160,-1.5,130,9.0,105,-125,145,1.5,-150,5.54,Chase Field,10,-2
2017-05-14,2017,CWS,SD,9,3,-205,-1.5,-104,8.5,-110,-110,175,1.5,-116,5.71,Guaranteed Rate Field,12,6
2017-05-14,2017,TOR,SEA,3,2,-136,-1.5,144,9.0,100,-120,121,1.5,-165,5.19,Rogers Centre,5,1
2017-05-14,2017,CIN,SF,3,8,134,1.5,-170,8.0,-105,-115,-149,-1.5,148,3.42,AT&T Park,11,-5
2017-05-14,2017,CHC,STL,0,5,-121,-1.5,135,8.5,-115,-105,111,1.5,-155,4.65,Busch Stadium,5,-5
2017-05-14,2017,BOS,TB,2,11,-177,-1.5,120,8.5,-105,-115,157,1.5,-140,5.43,Fenway Park,13,-9
2017-05-14,2017,OAK,TEX,4,6,123,1.5,-170,9.5,-110,-110,-138,-1.5,148,4.26,Rangers Ballpark,10,-2
2017-05-14,2017,SEA,TOR,2,3,121,1.5,-165,9.0,100,-120,-136,-1.5,144,4.07,Rogers Centre,5,-1
2017-05-14,2017,PHI,WSH,4,3,165,1.5,-135,9.5,-105,-115,-185,-1.5,115,3.58,Nationals Park,7,1
2017-05-14,2017,PHI,WSH,5,6,191,1.5,-105,7.5,-110,-110,-221,-1.5,-115,2.58,Nationals Park,11,-1
2017-05-15,2017,NYM,ARI,3,7,-104,1.5,-210,9.5,-105,-115,-106,-1.5,176,4.84,Chase Field,10,-4
2017-05-15,2017,TOR,ATL,6,10,-134,-1.5,151,9.0,-114,-106,119,1.5,-175,5.15,Rogers Centre,16,-4
2017-05-15,2017,TB,CLE,7,8,145,1.5,-165,7.5,110,-130,-160,-1.5,144,3.06,Progressive Field,15,-1
2017-05-15,2017,LAA,CWS,5,3,-210,-1.5,100,8.5,-115,-105,180,1.5,-120,5.76,Angel Stadium,8,2
2017-05-15,2017,MIA,HOU,2,7,-102,1.5,-170,8.5,-120,100,-108,-1.5,148,4.29,Marlins Park,9,-5
2017-05-15,2017,CWS,LAA,3,5,180,1.5,-120,8.5,-115,-105,-210,-1.5,100,3.04,Angel Stadium,8,-2
2017-05-15,2017,SF,LAD,8,4,114,1.5,-160,8.0,-110,-110,-124,-1.5,140,3.74,AT&T Park,12,4
2017-05-15,2017,HOU,MIA,7,2,-108,-1.5,148,8.5,-120,100,-102,1.5,-170,4.41,Marlins Park,9,5
2017-05-15,2017,SD,MIL,6,5,-131,-1.5,172,7.5,105,-125,116,1.5,-205,4.25,PETCO Park,11,1
2017-05-15,2017,ARI,NYM,7,3,-106,-1.5,176,9.5,-105,-115,-104,1.5,-210,4.89,Chase Field,10,4
2017-05-15,2017,SEA,OAK,6,5,-121,-1.5,172,8.5,-110,-110,111,1.5,-205,4.65,T-Mobile Park,11,1
2017-05-15,2017,MIL,SD,5,6,116,1.5,-205,7.5,105,-125,-131,-1.5,172,3.47,PETCO Park,11,-1
2017-05-15,2017,OAK,SEA,5,6,111,1.5,-205,8.5,-110,-110,-121,-1.5,172,4.03,T-Mobile Park,11,-1
2017-05-15,2017,LAD,SF,4,8,-124,-1.5,140,8.0,-110,-110,114,1.5,-160,4.43,AT&T Park,12,-4
2017-05-15,2017,CLE,TB,8,7,-160,-1.5,144,7.5,110,-130,145,1.5,-165,4.62,Progressive Field,15,1
2017-05-15,2017,ATL,TOR,10,6,119,1.5,-175,9.0,-114,-106,-134,-1.5,151,4.11,Rogers Centre,16,4
2017-05-16,2017,NYM,ARI,4,5,145,1.5,-135,9.5,-105,-115,-160,-1.5,115,3.88,Chase Field,9,-1
2017-05-16,2017,TOR,ATL,5,9,-138,-1.5,148,8.5,105,-125,123,1.5,-170,4.93,Rogers Centre,14,-4
2017-05-16,2017,DET,BAL,11,13,-113,-1.5,172,10.0,-105,-115,103,1.5,-205,5.31,Comerica Park,24,-2
2017-05-16,2017,STL,BOS,3,6,-101,-1.5,176,8.0,-110,-110,-109,1.5,-210,4.02,Busch Stadium,9,-3
2017-05-16,2017,CIN,CHC,5,9,175,1.5,-115,11.0,-115,-105,-195,-1.5,-105,4.0,Wrigley Field,14,-4
2017-05-16,2017,CHC,CIN,9,5,-195,-1.5,-105,11.0,-115,-105,175,1.5,-115,7.27,Wrigley Field,14,4
2017-05-16,2017,TB,CLE,6,4,138,1.5,-170,9.0,-105,-115,-153,-1.5,148,3.78,Progressive Field,10,2
2017-05-16,2017,MIN,COL,3,7,-114,-1.5,170,10.0,100,-120,104,1.5,-200,5.33,Target Field,10,-4
2017-05-16,2017,LAA,CWS,7,6,-187,-1.5,120,7.5,-125,105,167,1.5,-140,4.89,Angel Stadium,13,1
2017-05-16,2017,BAL,DET,13,11,103,1.5,-205,10.0,-105,-115,-113,-1.5,172,4.93,Comerica Park,24,2
2017-05-16,2017,MIA,HOU,2,12,143,1.5,-125,7.5,-120,100,-158,-1.5,105,3.09,Marlins Park,14,-10
2017-05-16,2017,NYY,KC,7,1,-115,-1.5,135,9.5,-110,-110,105,1.5,-155,5.08,Kauffman Stadium,8,6
2017-05-16,2017,CWS,LAA,6,7,167,1.5,-140,7.5,-125,105,-187,-1.5,120,2.81,Angel Stadium,13,-1
2017-05-16,2017,SF,LAD,2,1,129,1.5,-130,7.5,-120,100,-144,-1.5,110,3.28,AT&T Park,3,1
2017-05-16,2017,HOU,MIA,12,2,-158,-1.5,105,7.5,-120,100,143,1.5,-125,4.59,Marlins Park,14,10
2017-05-16,2017,SD,MIL,2,6,-123,-1.5,166,7.5,100,-120,113,1.5,-195,4.14,PETCO Park,8,-4
2017-05-16,2017,COL,MIN,7,3,104,1.5,-200,10.0,100,-120,-114,-1.5,170,4.9,Target Field,10,4
2017-05-16,2017,ARI,NYM,5,4,-160,-1.5,115,9.5,-105,-115,145,1.5,-135,5.85,Chase Field,9,1
2017-05-16,2017,KC,NYY,1,7,105,1.5,-155,9.5,-110,-110,-115,-1.5,135,4.63,Kauffman Stadium,8,-6
2017-05-16,2017,SEA,OAK,6,9,-107,-1.5,176,8.5,-110,-110,-103,1.5,-210,4.39,T-Mobile Park,15,-3
2017-05-16,2017,TEX,PHI,5,1,-185,-1.5,115,8.5,-125,105,165,1.5,-135,5.52,Rangers Ballpark,6,4
2017-05-16,2017,WSH,PIT,8,4,-152,-1.5,110,8.5,-104,-116,137,1.5,-130,5.13,PNC Park,12,4
2017-05-16,2017,MIL,SD,6,2,113,1.5,-195,7.5,100,-120,-123,-1.5,166,3.52,PETCO Park,8,4
2017-05-16,2017,OAK,SEA,9,6,-103,1.5,-210,8.5,-110,-110,-107,-1.5,176,4.31,T-Mobile Park,15,3
2017-05-16,2017,LAD,SF,1,2,-144,-1.5,110,7.5,-120,100,129,1.5,-130,4.43,AT&T Park,3,-1
2017-05-16,2017,BOS,STL,6,3,-109,1.5,-210,8.0,-110,-110,-101,-1.5,176,4.17,Busch Stadium,9,3
2017-05-16,2017,CLE,TB,4,6,-153,-1.5,148,9.0,-105,-115,138,1.5,-170,5.44,Progressive Field,10,-2
2017-05-16,2017,PHI,TEX,1,5,165,1.5,-135,8.5,-125,105,-185,-1.5,115,3.21,Rangers Ballpark,6,-4
2017-05-16,2017,ATL,TOR,9,5,123,1.5,-170,8.5,105,-125,-138,-1.5,148,3.81,Rogers Centre,14,4
2017-05-16,2017,PIT,WSH,4,8,137,1.5,-130,8.5,-104,-116,-152,-1.5,110,3.59,PNC Park,12,-4
2017-05-17,2017,NYM,ARI,4,5,116,1.5,-180,9.5,-115,-105,-126,-1.5,155,4.4,Chase Field,9,-1
2017-05-17,2017,TOR,ATL,4,8,101,1.5,-215,8.5,-105,-115,-111,-1.5,180,4.23,Suntrust Park,12,-4
2017-05-17,2017,DET,BAL,5,4,-143,-1.5,140,9.5,-105,-115,128,1.5,-160,5.59,Comerica Park,9,1
2017-05-17,2017,STL,BOS,4,5,101,1.5,-170,8.5,100,-120,-111,-1.5,148,4.23,Busch Stadium,9,-1
2017-05-17,2017,CIN,CHC,5,7,173,1.5,-111,11.0,-110,-110,-193,-1.5,-109,4.03,Wrigley Field,12,-2
2017-05-17,2017,CHC,CIN,7,5,-193,-1.5,-109,11.0,-110,-110,173,1.5,-111,7.25,Wrigley Field,12,2
2017-05-17,2017,TB,CLE,7,4,150,1.5,-135,10.0,-115,-105,-165,-1.5,115,4.0,Progressive Field,11,3
2017-05-17,2017,LAA,CWS,12,8,-179,-1.5,120,8.0,-105,-115,159,1.5,-140,5.13,Angel Stadium,20,4
2017-05-17,2017,BAL,DET,4,5,128,1.5,-160,9.5,-105,-115,-143,-1.5,140,4.17,Comerica Park,9,-1
2017-05-17,2017,MIA,HOU,0,3,153,1.5,-117,8.0,100,-120,-168,-1.5,-103,3.16,Marlins Park,3,-3
2017-05-17,2017,NYY,KC,11,7,-136,-1.5,120,8.5,-115,-105,121,1.5,-140,4.9,Kauffman Stadium,18,4
2017-05-17,2017,CWS,LAA,8,12,159,1.5,-140,8.0,-105,-115,-179,-1.5,120,3.09,Angel Stadium,20,-4
2017-05-17,2017,SF,LAD,1,6,165,1.5,-105,6.5,-122,102,-185,-1.5,-115,2.45,AT&T Park,7,-5
2017-05-17,2017,HOU,MIA,3,0,-168,-1.5,-103,8.0,100,-120,153,1.5,-117,5.01,Marlins Park,3,3
2017-05-17,2017,SD,MIL,1,3,-126,-1.5,170,7.5,100,-120,116,1.5,-200,4.18,PETCO Park,4,-2
2017-05-17,2017,ARI,NYM,5,4,-126,-1.5,155,9.5,-115,-105,116,1.5,-180,5.3,Chase Field,9,1
2017-05-17,2017,KC,NYY,7,11,121,1.5,-140,8.5,-115,-105,-136,-1.5,120,3.85,Kauffman Stadium,18,-4
2017-05-17,2017,SEA,OAK,4,0,-112,-1.5,184,8.5,-110,-110,102,1.5,-220,4.49,T-Mobile Park,4,4
2017-05-17,2017,TEX,PHI,9,3,-132,-1.5,151,10.5,-125,105,117,1.5,-175,5.97,Rangers Ballpark,12,6
2017-05-17,2017,WSH,PIT,1,6,114,1.5,-200,8.5,-120,100,-124,-1.5,170,3.97,PNC Park,7,-5
2017-05-17,2017,MIL,SD,3,1,116,1.5,-200,7.5,100,-120,-126,-1.5,170,3.47,PETCO Park,4,2
2017-05-17,2017,OAK,SEA,0,4,102,1.5,-220,8.5,-110,-110,-112,-1.5,184,4.21,T-Mobile Park,4,-4
2017-05-17,2017,LAD,SF,6,1,-185,-1.5,-115,6.5,-122,102,165,1.5,-105,4.22,AT&T Park,7,5
2017-05-17,2017,BOS,STL,5,4,-111,-1.5,148,8.5,100,-120,101,1.5,-170,4.47,Busch Stadium,9,1
2017-05-17,2017,CLE,TB,4,7,-165,-1.5,115,10.0,-115,-105,150,1.5,-135,6.23,Progressive Field,11,-3
2017-05-17,2017,PHI,TEX,3,9,117,1.5,-175,10.5,-125,105,-132,-1.5,151,4.84,Rangers Ballpark,12,-6
2017-05-17,2017,ATL,TOR,8,4,-111,-1.5,180,8.5,-105,-115,101,1.5,-215,4.47,Suntrust Park,12,4
2017-05-17,2017,PIT,WSH,6,1,-124,-1.5,170,8.5,-120,100,114,1.5,-200,4.71,PNC Park,7,5
2017-05-18,2017,TOR,ATL,9,0,-111,-1.5,148,8.0,-110,-110,101,1.5,-170,4.21,Suntrust Park,9,9
2017-05-18,2017,DET,BAL,6,5,116,1.5,-145,10.0,-110,-110,-131,-1.5,125,4.63,Comerica Park,11,1
2017-05-18,2017,OAK,BOS,8,3,101,1.5,-165,8.0,-115,-105,-111,-1.5,144,3.98,Oakland Coliseum,11,5
2017-05-18,2017,CIN,CHC,5,9,185,1.5,-111,10.5,-114,-106,-215,-1.5,-109,3.68,Wrigley Field,14,-4
2017-05-18,2017,CHC,CIN,9,5,-215,-1.5,-109,10.5,-114,-106,185,1.5,-111,7.17,Wrigley Field,14,4
2017-05-18,2017,MIN,COL,1,5,-132,-1.5,160,8.0,-110,-110,117,1.5,-185,4.55,Target Field,6,-4
2017-05-18,2017,MIN,COL,2,0,-145,-1.5,144,8.0,-120,100,130,1.5,-165,4.73,Target Field,2,2
2017-05-18,2017,SEA,CWS,5,4,-173,-1.5,120,9.0,-105,-115,153,1.5,-140,5.7,T-Mobile Park,9,1
2017-05-18,2017,BAL,DET,5,6,-131,-1.5,125,10.0,-110,-110,116,1.5,-145,5.67,Comerica Park,11,-1
2017-05-18,2017,NYY,KC,1,5,-117,-1.5,130,9.0,-105,-115,107,1.5,-150,4.85,Kauffman Stadium,6,-4
2017-05-18,2017,MIA,LAD,2,7,176,1.5,-115,8.5,-101,-119,-196,-1.5,-105,3.08,Dodger Stadium,9,-5
2017-05-18,2017,LAD,MIA,7,2,-196,-1.5,-105,8.5,-101,-119,176,1.5,-115,5.63,Dodger Stadium,9,5
2017-05-18,2017,SD,MIL,2,4,-111,-1.5,184,8.5,100,-120,101,1.5,-220,4.47,PETCO Park,6,-2
2017-05-18,2017,COL,MIN,5,1,117,1.5,-185,8.0,-110,-110,-132,-1.5,160,3.69,Target Field,6,4
2017-05-18,2017,COL,MIN,0,2,130,1.5,-165,8.0,-120,100,-145,-1.5,144,3.48,Target Field,2,-2
2017-05-18,2017,KC,NYY,5,1,107,1.5,-150,9.0,-105,-115,-117,-1.5,130,4.35,Kauffman Stadium,6,4
2017-05-18,2017,BOS,OAK,3,8,-111,-1.5,144,8.0,-115,-105,101,1.5,-165,4.21,Oakland Coliseum,11,-5
2017-05-18,2017,TEX,PHI,8,4,-140,-1.5,130,10.0,-119,-101,125,1.5,-150,5.83,Rangers Ballpark,12,4
2017-05-18,2017,WSH,PIT,4,10,-127,-1.5,118,10.0,-105,-115,117,1.5,-138,5.59,PNC Park,14,-6
2017-05-18,2017,MIL,SD,4,2,101,1.5,-220,8.5,100,-120,-111,-1.5,184,4.23,PETCO Park,6,2
2017-05-18,2017,CWS,SEA,4,5,153,1.5,-140,9.0,-105,-115,-173,-1.5,120,3.56,T-Mobile Park,9,-1
2017-05-18,2017,PHI,TEX,4,8,125,1.5,-150,10.0,-119,-101,-140,-1.5,130,4.44,Rangers Ballpark,12,-4
2017-05-18,2017,ATL,TOR,0,9,101,1.5,-170,8.0,-110,-110,-111,-1.5,148,3.98,Suntrust Park,9,-9
2017-05-18,2017,PIT,WSH,10,4,117,1.5,-138,10.0,-105,-115,-127,-1.5,118,4.61,PNC Park,14,6
2017-05-19,2017,SD,ARI,1,10,133,1.5,-125,8.5,-105,-115,-148,-1.5,105,3.65,PETCO Park,11,-9
2017-05-19,2017,WSH,ATL,4,7,-172,-1.5,-120,10.0,100,-120,152,1.5,100,6.32,Suntrust Park,11,-3
2017-05-19,2017,TOR,BAL,3,5,116,1.5,-190,9.0,-110,-110,-126,-1.5,163,4.17,Camden Yards,8,-2
2017-05-19,2017,OAK,BOS,3,2,171,1.5,-104,7.5,105,-125,-191,-1.5,-116,2.77,Oakland Coliseum,5,1
2017-05-19,2017,MIL,CHC,6,3,160,1.5,-145,7.5,-105,-115,-180,-1.5,125,2.88,Wrigley Field,9,3
2017-05-19,2017,COL,CIN,12,6,-103,1.5,-220,8.5,-125,105,-107,-1.5,184,4.31,Great American Ballpark,18,6
2017-05-19,2017,HOU,CLE,3,5,-129,-1.5,155,8.0,-116,-104,119,1.5,-180,4.51,Minute Maid Park,8,-2
2017-05-19,2017,CIN,COL,6,12,-107,-1.5,184,8.5,-125,105,-103,1.5,-220,4.39,Great American Ballpark,18,-6
2017-05-19,2017,SEA,CWS,1,2,-121,-1.5,166,7.5,-115,-105,111,1.5,-195,4.11,T-Mobile Park,3,-1
2017-05-19,2017,TEX,DET,5,3,135,1.5,-165,9.0,100,-120,-150,-1.5,144,3.83,Comerica Park,8,2
2017-05-19,2017,CLE,HOU,5,3,119,1.5,-180,8.0,-116,-104,-129,-1.5,155,3.65,Minute Maid Park,8,2
2017-05-19,2017,MIN,KC,4,3,-109,-1.5,180,8.5,-110,-110,-101,1.5,-215,4.43,Target Field,7,1
2017-05-19,2017,NYM,LAA,3,0,-168,-1.5,125,8.0,-115,-105,153,1.5,-145,5.01,Citi Field,3,3
2017-05-19,2017,MIA,LAD,2,7,200,1.5,-105,8.0,100,-120,-240,-1.5,-115,2.67,Dodger Stadium,9,-5
2017-05-19,2017,LAD,MIA,7,2,-240,-1.5,-115,8.0,100,-120,200,1.5,-105,5.65,Dodger Stadium,9,5
2017-05-19,2017,CHC,MIL,3,6,-180,-1.5,125,7.5,-105,-115,160,1.5,-145,4.82,Wrigley Field,9,-3
2017-05-19,2017,KC,MIN,3,4,-101,1.5,-215,8.5,-110,-110,-109,-1.5,180,4.27,Target Field,7,-1
2017-05-19,2017,LAA,NYM,0,3,153,1.5,-145,8.0,-115,-105,-168,-1.5,125,3.16,Citi Field,3,-3
2017-05-19,2017,TB,NYY,5,4,113,1.5,-150,8.0,-103,-117,-123,-1.5,131,3.76,Tropicana Field,9,1
2017-05-19,2017,BOS,OAK,2,3,-191,-1.5,-116,7.5,105,-125,171,1.5,-104,4.92,Oakland Coliseum,5,-1
2017-05-19,2017,PIT,PHI,2,7,-128,-1.5,163,9.5,100,-120,118,1.5,-190,5.33,PNC Park,9,-5
2017-05-19,2017,PHI,PIT,7,2,118,1.5,-190,9.5,100,-120,-128,-1.5,163,4.36,PNC Park,9,5
2017-05-19,2017,ARI,SD,10,1,-148,-1.5,105,8.5,-105,-115,133,1.5,-125,5.07,PETCO Park,11,9
2017-05-19,2017,CWS,SEA,2,1,111,1.5,-195,7.5,-115,-105,-121,-1.5,166,3.55,T-Mobile Park,3,1
2017-05-19,2017,STL,SF,5,6,-146,-1.5,144,8.5,100,-120,131,1.5,-165,5.04,Busch Stadium,11,-1
2017-05-19,2017,SF,STL,6,5,131,1.5,-165,8.5,100,-120,-146,-1.5,144,3.68,Busch Stadium,11,1
2017-05-19,2017,NYY,TB,4,5,-123,-1.5,131,8.0,-103,-117,113,1.5,-150,4.41,Tropicana Field,9,-1
2017-05-19,2017,DET,TEX,3,5,-150,-1.5,144,9.0,100,-120,135,1.5,-165,5.4,Comerica Park,8,-2
2017-05-19,2017,BAL,TOR,5,3,-126,-1.5,163,9.0,-110,-110,116,1.5,-190,5.02,Camden Yards,8,2
2017-05-19,2017,ATL,WSH,7,4,152,1.5,100,10.0,100,-120,-172,-1.5,-120,3.97,Suntrust Park,11,3
2017-05-20,2017,SD,ARI,1,9,-102,1.5,-168,7.5,-109,-111,-108,-1.5,146,3.79,PETCO Park,10,-8
2017-05-20,2017,WSH,ATL,2,5,-230,-1.5,-150,9.0,100,-120,200,1.5,130,6.27,Suntrust Park,7,-3
2017-05-20,2017,TOR,BAL,5,7,145,1.5,-150,9.0,-110,-110,-160,-1.5,130,3.67,Camden Yards,12,-2
2017-05-20,2017,OAK,BOS,8,3,108,1.5,-154,9.0,-120,100,-118,-1.5,134,4.33,Oakland Coliseum,11,5
2017-05-20,2017,COL,CIN,8,12,101,1.5,-210,9.5,100,-120,-111,-1.5,176,4.73,Great American Ballpark,20,-4
2017-05-20,2017,HOU,CLE,0,3,-113,-1.5,163,9.0,-115,-105,103,1.5,-190,4.77,Minute Maid Park,3,-3
2017-05-20,2017,CIN,COL,12,8,-111,-1.5,176,9.5,100,-120,101,1.5,-210,5.0,Great American Ballpark,20,4
2017-05-20,2017,SEA,CWS,1,16,-176,-1.5,125,8.5,-120,100,156,1.5,-145,5.42,T-Mobile Park,17,-15
2017-05-20,2017,TEX,DET,3,9,132,1.5,-165,8.5,-110,-110,-147,-1.5,144,3.66,Comerica Park,12,-6
2017-05-20,2017,CLE,HOU,3,0,103,1.5,-190,9.0,-115,-105,-113,-1.5,163,4.43,Minute Maid Park,3,3
2017-05-20,2017,NYM,LAA,7,5,-133,-1.5,160,8.0,-115,-105,118,1.5,-185,4.57,Citi Field,12,2
2017-05-20,2017,MIA,LAD,10,6,151,1.5,-145,8.5,-115,-105,-171,-1.5,125,3.39,Dodger Stadium,16,4
2017-05-20,2017,LAD,MIA,6,10,-171,-1.5,125,8.5,-115,-105,151,1.5,-145,5.36,Dodger Stadium,16,-4
2017-05-20,2017,LAA,NYM,5,7,118,1.5,-185,8.0,-115,-105,-133,-1.5,160,3.67,Citi Field,12,-2
2017-05-20,2017,TB,NYY,9,5,106,1.5,-166,8.5,-105,-115,-116,-1.5,145,4.13,Tropicana Field,14,4
2017-05-20,2017,BOS,OAK,3,8,-118,-1.5,134,9.0,-120,100,108,1.5,-154,4.87,Oakland Coliseum,11,-5
2017-05-20,2017,PIT,PHI,6,3,-121,-1.5,172,8.5,-104,-116,111,1.5,-205,4.65,PNC Park,9,3
2017-05-20,2017,PHI,PIT,3,6,111,1.5,-205,8.5,-104,-116,-121,-1.5,172,4.03,PNC Park,9,-3
2017-05-20,2017,ARI,SD,9,1,-108,-1.5,146,7.5,-109,-111,-102,1.5,-168,3.89,PETCO Park,10,8
2017-05-20,2017,CWS,SEA,16,1,156,1.5,-145,8.5,-120,100,-176,-1.5,125,3.32,T-Mobile Park,17,15
2017-05-20,2017,STL,SF,1,3,-137,-1.5,155,8.0,100,-120,122,1.5,-180,4.62,Busch Stadium,4,-2
2017-05-20,2017,SF,STL,3,1,122,1.5,-180,8.0,100,-120,-137,-1.5,155,3.6,Busch Stadium,4,2
2017-05-20,2017,NYY,TB,5,9,-116,-1.5,145,8.5,-105,-115,106,1.5,-166,4.56,Tropicana Field,14,-4
2017-05-20,2017,DET,TEX,9,3,-147,-1.5,144,8.5,-110,-110,132,1.5,-165,5.06,Comerica Park,12,6
2017-05-20,2017,BAL,TOR,7,5,-160,-1.5,130,9.0,-110,-110,145,1.5,-150,5.54,Camden Yards,12,2
2017-05-20,2017,ATL,WSH,5,2,200,1.5,130,9.0,100,-120,-230,-1.5,-150,3.0,Suntrust Park,7,3
2017-05-21,2017,SD,ARI,5,1,102,1.5,-165,8.0,-134,114,-112,-1.5,144,3.96,PETCO Park,6,4
2017-05-21,2017,WSH,ATL,3,2,-190,-1.5,-123,9.0,100,-120,170,1.5,103,5.9,Suntrust Park,5,1
2017-05-21,2017,TOR,BAL,3,1,104,1.5,-205,8.5,-101,-119,-114,-1.5,172,4.17,Camden Yards,4,2
2017-05-21,2017,OAK,BOS,3,12,109,1.5,-150,8.5,-125,105,-119,-1.5,130,4.07,Oakland Coliseum,15,-9
2017-05-21,2017,MIL,CHC,6,13,181,1.5,-113,10.5,-105,-115,-211,-1.5,-107,3.74,Wrigley Field,19,-7
2017-05-21,2017,COL,CIN,6,4,102,1.5,-205,9.5,-120,100,-112,-1.5,172,4.7,Great American Ballpark,10,2
2017-05-21,2017,HOU,CLE,6,8,-107,1.5,-170,8.5,-119,-101,-103,-1.5,148,4.39,Minute Maid Park,14,-2
2017-05-21,2017,CIN,COL,4,6,-112,-1.5,172,9.5,-120,100,102,1.5,-205,5.02,Great American Ballpark,10,-2
2017-05-21,2017,SEA,CWS,1,8,-122,-1.5,163,9.0,100,-120,112,1.5,-190,4.95,T-Mobile Park,9,-7
2017-05-21,2017,TEX,DET,5,2,-127,-1.5,133,9.0,100,-120,117,1.5,-152,5.04,Comerica Park,7,3
2017-05-21,2017,CLE,HOU,8,6,-103,-1.5,148,8.5,-119,-101,-107,1.5,-170,4.31,Minute Maid Park,14,2
2017-05-21,2017,MIN,KC,4,6,-124,-1.5,163,9.0,100,-120,114,1.5,-190,4.98,Target Field,10,-2
2017-05-21,2017,MIN,KC,8,4,-106,-1.5,184,8.5,-101,-119,-104,1.5,-220,4.37,Target Field,12,4
2017-05-21,2017,NYM,LAA,5,12,-111,-1.5,180,8.5,-115,-105,101,1.5,-215,4.47,Citi Field,17,-7
2017-05-21,2017,MIA,LAD,3,6,172,1.5,-120,9.5,100,-120,-192,-1.5,100,3.49,Dodger Stadium,9,-3
2017-05-21,2017,LAD,MIA,6,3,-192,-1.5,100,9.5,100,-120,172,1.5,-120,6.25,Dodger Stadium,9,3
2017-05-21,2017,CHC,MIL,13,6,-211,-1.5,-107,10.5,-105,-115,181,1.5,-113,7.12,Wrigley Field,19,7
2017-05-21,2017,KC,MIN,6,4,114,1.5,-190,9.0,100,-120,-124,-1.5,163,4.21,Target Field,10,2
2017-05-21,2017,KC,MIN,4,8,-104,1.5,-220,8.5,-101,-119,-106,-1.5,184,4.33,Target Field,12,-4
2017-05-21,2017,LAA,NYM,12,5,101,1.5,-215,8.5,-115,-105,-111,-1.5,180,4.23,Citi Field,17,7
2017-05-21,2017,TB,NYY,2,3,-141,-1.5,151,8.0,-115,-105,126,1.5,-175,4.68,Tropicana Field,5,-1
2017-05-21,2017,BOS,OAK,12,3,-119,-1.5,130,8.5,-125,105,109,1.5,-150,4.62,Oakland Coliseum,15,9
2017-05-21,2017,PIT,PHI,1,0,105,1.5,-155,8.5,-115,-105,-115,-1.5,135,4.15,PNC Park,1,1
2017-05-21,2017,PHI,PIT,0,1,-115,-1.5,135,8.5,-115,-105,105,1.5,-155,4.55,PNC Park,1,-1
2017-05-21,2017,ARI,SD,1,5,-112,-1.5,144,8.0,-134,114,102,1.5,-165,4.23,PETCO Park,6,-4
2017-05-21,2017,CWS,SEA,8,1,112,1.5,-190,9.0,100,-120,-122,-1.5,163,4.25,T-Mobile Park,9,7
2017-05-21,2017,STL,SF,8,3,-175,-1.5,115,9.0,-105,-115,155,1.5,-135,5.73,Busch Stadium,11,5
2017-05-21,2017,SF,STL,3,8,155,1.5,-135,9.0,-105,-115,-175,-1.5,115,3.53,Busch Stadium,11,-5
2017-05-21,2017,NYY,TB,3,2,126,1.5,-175,8.0,-115,-105,-141,-1.5,151,3.54,Tropicana Field,5,1
2017-05-21,2017,DET,TEX,2,5,117,1.5,-152,9.0,100,-120,-127,-1.5,133,4.15,Comerica Park,7,-3
2017-05-21,2017,BAL,TOR,1,3,-114,-1.5,172,8.5,-101,-119,104,1.5,-205,4.53,Camden Yards,4,-2
2017-05-21,2017,ATL,WSH,2,3,170,1.5,103,9.0,100,-120,-190,-1.5,-123,3.33,Suntrust Park,5,-1
2017-05-22,2017,CWS,ARI,1,5,175,1.5,-115,9.0,-120,100,-205,-1.5,-105,3.27,Chase Field,6,-4
2017-05-22,2017,PIT,ATL,2,5,-128,-1.5,131,8.5,100,-120,118,1.5,-151,4.77,Suntrust Park,7,-3
2017-05-22,2017,MIN,BAL,14,7,119,1.5,-170,10.0,-115,-105,-129,-1.5,148,4.57,Camden Yards,21,7
2017-05-22,2017,SF,CHC,6,4,185,1.5,-105,10.0,-110,-110,-215,-1.5,-115,3.51,Wrigley Field,10,2
2017-05-22,2017,CLE,CIN,1,5,-124,-1.5,129,9.5,100,-120,114,1.5,-148,5.26,Great American Ballpark,6,-4
2017-05-22,2017,CIN,CLE,5,1,114,1.5,-148,9.5,100,-120,-124,-1.5,129,4.44,Great American Ballpark,6,4
2017-05-22,2017,PHI,COL,1,8,-109,-1.5,184,8.5,-110,-110,-101,1.5,-220,4.43,Citizens Bank Park,9,-7
2017-05-22,2017,ARI,CWS,5,1,-205,-1.5,-105,9.0,-120,100,175,1.5,-115,6.05,Chase Field,6,4
2017-05-22,2017,HOU,DET,1,0,-144,-1.5,148,8.5,-120,100,129,1.5,-170,5.02,Minute Maid Park,1,1
2017-05-22,2017,DET,HOU,0,1,129,1.5,-170,8.5,-120,100,-144,-1.5,148,3.71,Minute Maid Park,1,-1
2017-05-22,2017,NYY,KC,4,2,-190,-1.5,115,8.0,-110,-110,170,1.5,-135,5.24,Yankee Stadium,6,2
2017-05-22,2017,TB,LAA,2,3,-112,-1.5,176,8.5,-110,-110,102,1.5,-210,4.49,Tropicana Field,5,-1
2017-05-22,2017,BAL,MIN,7,14,-129,-1.5,148,10.0,-115,-105,119,1.5,-170,5.63,Camden Yards,21,-7
2017-05-22,2017,KC,NYY,2,4,170,1.5,-135,8.0,-110,-110,-190,-1.5,115,2.96,Yankee Stadium,6,-2
2017-05-22,2017,COL,PHI,8,1,-101,1.5,-220,8.5,-110,-110,-109,-1.5,184,4.27,Citizens Bank Park,9,7
2017-05-22,2017,ATL,PIT,5,2,118,1.5,-151,8.5,100,-120,-128,-1.5,131,3.9,Suntrust Park,7,3
2017-05-22,2017,CHC,SF,4,6,-215,-1.5,-115,10.0,-110,-110,185,1.5,-105,6.83,Wrigley Field,10,-2
2017-05-22,2017,LAA,TB,3,2,102,1.5,-210,8.5,-110,-110,-112,-1.5,176,4.21,Tropicana Field,5,1
2017-05-23,2017,CWS,ARI,4,5,151,1.5,-130,11.0,-115,-105,-166,-1.5,110,4.38,Chase Field,9,-1
2017-05-23,2017,PIT,ATL,5,6,-101,1.5,-215,9.5,100,-120,-109,-1.5,180,4.77,Suntrust Park,11,-1
2017-05-23,2017,MIN,BAL,2,0,114,1.5,-190,9.5,-115,-105,-124,-1.5,163,4.44,Camden Yards,2,2
2017-05-23,2017,TEX,BOS,6,11,175,1.5,-130,9.5,-105,-115,-195,-1.5,110,3.45,Fenway Park,17,-5
2017-05-23,2017,SF,CHC,1,4,152,1.5,-150,7.0,-104,-116,-172,-1.5,130,2.78,Wrigley Field,5,-3
2017-05-23,2017,CLE,CIN,8,7,-171,-1.5,-110,8.5,-120,100,151,1.5,-110,5.36,Great American Ballpark,15,1
2017-05-23,2017,CIN,CLE,7,8,151,1.5,-110,8.5,-120,100,-171,-1.5,-110,3.39,Great American Ballpark,15,-1
2017-05-23,2017,PHI,COL,2,8,121,1.5,-145,8.5,-115,-105,-136,-1.5,125,3.85,Citizens Bank Park,10,-6
2017-05-23,2017,ARI,CWS,5,4,-166,-1.5,110,11.0,-115,-105,151,1.5,-130,6.86,Chase Field,9,1
2017-05-23,2017,HOU,DET,6,2,-225,-1.5,-115,8.5,-125,105,195,1.5,-105,5.88,Minute Maid Park,8,4
2017-05-23,2017,DET,HOU,2,6,195,1.5,-105,8.5,-125,105,-225,-1.5,-115,2.88,Minute Maid Park,8,-4
2017-05-23,2017,NYY,KC,2,6,-136,-1.5,155,9.0,100,-120,121,1.5,-180,5.19,Yankee Stadium,8,-4
2017-05-23,2017,TB,LAA,0,4,-111,-1.5,172,8.5,-110,-110,101,1.5,-205,4.47,Tropicana Field,4,-4
2017-05-23,2017,STL,LAD,1,2,205,1.5,-105,7.0,-125,105,-245,-1.5,-115,2.3,Dodger Stadium,3,-1
2017-05-23,2017,OAK,MIA,9,11,-123,-1.5,155,9.0,-105,-115,113,1.5,-180,4.96,Oakland Coliseum,20,-2
2017-05-23,2017,TOR,MIL,4,3,-110,-1.5,144,8.5,-110,-110,100,1.5,-165,4.45,Miller Park,7,1
2017-05-23,2017,BAL,MIN,0,2,-124,-1.5,163,9.5,-115,-105,114,1.5,-190,5.26,Camden Yards,2,-2
2017-05-23,2017,SD,NYM,3,9,132,1.5,-170,8.0,-120,100,-147,-1.5,148,3.45,Citi Field,12,-6
2017-05-23,2017,KC,NYY,6,2,121,1.5,-180,9.0,100,-120,-136,-1.5,155,4.07,Yankee Stadium,8,4
2017-05-23,2017,MIA,OAK,11,9,113,1.5,-180,9.0,-105,-115,-123,-1.5,155,4.23,Oakland Coliseum,20,2
2017-05-23,2017,COL,PHI,8,2,-136,-1.5,125,8.5,-115,-105,121,1.5,-145,4.9,Citizens Bank Park,10,6
2017-05-23,2017,ATL,PIT,6,5,-109,-1.5,180,9.5,100,-120,-101,1.5,-215,4.95,Suntrust Park,11,1
2017-05-23,2017,NYM,SD,9,3,-147,-1.5,148,8.0,-120,100,132,1.5,-170,4.76,Citi Field,12,6
2017-05-23,2017,WSH,SEA,10,1,-147,-1.5,139,9.0,-115,-105,132,1.5,-159,5.36,Nationals Park,11,9
2017-05-23,2017,CHC,SF,4,1,-172,-1.5,130,7.0,-104,-116,152,1.5,-150,4.43,Wrigley Field,5,3
2017-05-23,2017,LAD,STL,2,1,-245,-1.5,-115,7.0,-125,105,205,1.5,-105,4.97,Dodger Stadium,3,1
2017-05-23,2017,LAA,TB,4,0,101,1.5,-205,8.5,-110,-110,-111,-1.5,172,4.23,Tropicana Field,4,4
2017-05-23,2017,BOS,TEX,11,6,-195,-1.5,110,9.5,-105,-115,175,1.5,-130,6.28,Fenway Park,17,5
2017-05-23,2017,MIL,TOR,3,4,100,1.5,-165,8.5,-110,-110,-110,-1.5,144,4.25,Miller Park,7,-1
2017-05-23,2017,SEA,WSH,1,10,132,1.5,-159,9.0,-115,-105,-147,-1.5,139,3.88,Nationals Park,11,-9
2017-05-24,2017,CWS,ARI,6,8,109,1.5,-200,9.0,100,-120,-119,-1.5,170,4.31,Chase Field,14,-2
2017-05-24,2017,PIT,ATL,12,5,127,1.5,-175,9.0,100,-120,-142,-1.5,151,3.96,Suntrust Park,17,7
2017-05-24,2017,MIN,BAL,4,3,-105,1.5,-225,9.0,100,-120,-105,-1.5,188,4.61,Camden Yards,7,1
2017-05-24,2017,TEX,BOS,4,9,250,1.5,121,8.0,-115,-105,-300,-1.5,-141,2.29,Fenway Park,13,-5
2017-05-24,2017,SF,CHC,4,5,162,1.5,-135,7.0,-119,-101,-182,-1.5,115,2.67,Wrigley Field,9,-1
2017-05-24,2017,CLE,CIN,3,4,-194,-1.5,-103,9.5,-115,-105,174,1.5,-117,6.27,Progressive Field,7,-1
2017-05-24,2017,CIN,CLE,4,3,174,1.5,-117,9.5,-115,-105,-194,-1.5,-103,3.47,Progressive Field,7,1
2017-05-24,2017,PHI,COL,2,7,111,1.5,-159,9.0,102,-122,-121,-1.5,137,4.27,Citizens Bank Park,9,-5
2017-05-24,2017,ARI,CWS,8,6,-119,-1.5,170,9.0,100,-120,109,1.5,-200,4.89,Chase Field,14,2
2017-05-24,2017,HOU,DET,3,6,-168,-1.5,126,9.0,-105,-115,153,1.5,-146,5.64,Minute Maid Park,9,-3
2017-05-24,2017,DET,HOU,6,3,153,1.5,-146,9.0,-105,-115,-168,-1.5,126,3.56,Minute Maid Park,9,3
2017-05-24,2017,NYY,KC,3,0,-217,-1.5,-117,8.5,-120,100,187,1.5,-103,5.82,Yankee Stadium,3,3
2017-05-24,2017,TB,LAA,5,2,-131,-1.5,155,8.5,-105,-115,116,1.5,-180,4.82,Tropicana Field,7,3
2017-05-24,2017,STL,LAD,6,1,116,1.5,-200,7.5,100,-120,-131,-1.5,170,3.47,Dodger Stadium,7,5
2017-05-24,2017,OAK,MIA,4,1,-145,-1.5,148,9.0,102,-122,130,1.5,-170,5.33,Oakland Coliseum,5,3
2017-05-24,2017,TOR,MIL,8,4,-116,-1.5,140,8.5,-102,-118,106,1.5,-160,4.56,Miller Park,12,4
2017-05-24,2017,BAL,MIN,3,4,-105,-1.5,188,9.0,100,-120,-105,1.5,-225,4.61,Camden Yards,7,-1
2017-05-24,2017,SD,NYM,6,5,147,1.5,-155,8.5,-110,-110,-162,-1.5,135,3.44,Citi Field,11,1
2017-05-24,2017,KC,NYY,0,3,187,1.5,-103,8.5,-120,100,-217,-1.5,-117,2.96,Yankee Stadium,3,-3
2017-05-24,2017,MIA,OAK,1,4,130,1.5,-170,9.0,102,-122,-145,-1.5,148,3.91,Oakland Coliseum,5,-3
2017-05-24,2017,COL,PHI,7,2,-121,-1.5,137,9.0,102,-122,111,1.5,-159,4.93,Citizens Bank Park,9,5
2017-05-24,2017,ATL,PIT,5,12,-142,-1.5,151,9.0,100,-120,127,1.5,-175,5.28,Suntrust Park,17,-7
2017-05-24,2017,NYM,SD,5,6,-162,-1.5,135,8.5,-110,-110,147,1.5,-155,5.26,Citi Field,11,-1
2017-05-24,2017,WSH,SEA,5,1,-153,-1.5,135,9.0,-120,100,138,1.5,-155,5.44,Nationals Park,6,4
2017-05-24,2017,CHC,SF,5,4,-182,-1.5,115,7.0,-119,-101,162,1.5,-135,4.52,Wrigley Field,9,1
2017-05-24,2017,LAD,STL,1,6,-131,-1.5,170,7.5,100,-120,116,1.5,-200,4.25,Dodger Stadium,7,-5
2017-05-24,2017,LAA,TB,2,5,116,1.5,-180,8.5,-105,-115,-131,-1.5,155,3.94,Tropicana Field,7,-3
2017-05-24,2017,BOS,TEX,9,4,-300,-1.5,-141,8.0,-115,-105,250,1.5,121,6.0,Fenway Park,13,5
2017-05-24,2017,MIL,TOR,4,8,106,1.5,-160,8.5,-102,-118,-116,-1.5,140,4.13,Miller Park,12,-4
2017-05-24,2017,SEA,WSH,1,5,138,1.5,-155,9.0,-120,100,-153,-1.5,135,3.78,Nationals Park,6,-4
2017-05-25,2017,MIL,ARI,0,4,-107,-1.5,176,9.0,100,-120,-103,1.5,-210,4.65,Miller Park,4,-4
2017-05-25,2017,PIT,ATL,9,4,104,1.5,-215,9.0,105,-125,-114,-1.5,180,4.41,Suntrust Park,13,5
2017-05-25,2017,TEX,BOS,2,6,170,1.5,-119,9.0,-115,-105,-200,-1.5,-101,3.33,Fenway Park,8,-4
2017-05-25,2017,SF,CHC,1,5,103,1.5,-210,8.0,100,-120,-113,-1.5,176,3.94,Wrigley Field,6,-4
2017-05-25,2017,PHI,COL,2,1,-109,-1.5,184,8.0,-110,-110,-101,1.5,-220,4.17,Citizens Bank Park,3,1
2017-05-25,2017,HOU,DET,7,6,-107,-1.5,180,9.5,100,-120,-103,1.5,-215,4.91,Minute Maid Park,13,1
2017-05-25,2017,DET,HOU,6,7,-103,1.5,-215,9.5,100,-120,-107,-1.5,180,4.82,Minute Maid Park,13,-1
2017-05-25,2017,TB,LAA,4,0,-166,-1.5,124,9.0,-110,-110,151,1.5,-143,5.62,Tropicana Field,4,4
2017-05-25,2017,STL,LAD,3,7,129,1.5,-180,7.5,100,-120,-144,-1.5,155,3.28,Dodger Stadium,10,-4
2017-05-25,2017,ARI,MIL,4,0,-103,1.5,-210,9.0,100,-120,-107,-1.5,176,4.57,Miller Park,4,4
2017-05-25,2017,SD,NYM,4,3,141,1.5,-160,9.0,105,-125,-156,-1.5,140,3.73,Citi Field,7,1
2017-05-25,2017,COL,PHI,1,2,-101,1.5,-220,8.0,-110,-110,-109,-1.5,184,4.02,Citizens Bank Park,3,-1
2017-05-25,2017,ATL,PIT,4,9,-114,-1.5,180,9.0,105,-125,104,1.5,-215,4.79,Suntrust Park,13,-5
2017-05-25,2017,NYM,SD,3,4,-156,-1.5,140,9.0,105,-125,141,1.5,-160,5.48,Citi Field,7,-1
2017-05-25,2017,WSH,SEA,2,4,-135,-1.5,148,9.0,-125,105,120,1.5,-170,5.17,Nationals Park,6,-2
2017-05-25,2017,CHC,SF,5,1,-113,-1.5,176,8.0,100,-120,103,1.5,-210,4.24,Wrigley Field,6,4
2017-05-25,2017,LAD,STL,7,3,-144,-1.5,155,7.5,100,-120,129,1.5,-180,4.43,Dodger Stadium,10,4
2017-05-25,2017,LAA,TB,0,4,151,1.5,-143,9.0,-110,-110,-166,-1.5,124,3.59,Tropicana Field,4,-4
2017-05-25,2017,BOS,TEX,6,2,-200,-1.5,-101,9.0,-115,-105,170,1.5,-119,6.0,Fenway Park,8,4
2017-05-25,2017,SEA,WSH,4,2,120,1.5,-170,9.0,-125,105,-135,-1.5,148,4.09,Nationals Park,6,2
2017-05-26,2017,MIL,ARI,2,4,-107,-1.5,180,9.0,100,-120,-103,1.5,-215,4.65,Miller Park,6,-2
2017-05-26,2017,SF,ATL,0,2,-104,1.5,-170,8.0,-110,-110,-106,-1.5,148,4.08,AT&T Park,2,-2
2017-05-26,2017,HOU,BAL,2,0,-145,-1.5,141,9.0,100,-120,130,1.5,-161,5.33,Minute Maid Park,2,2
2017-05-26,2017,SEA,BOS,0,3,139,1.5,-140,9.5,100,-120,-154,-1.5,120,3.97,Fenway Park,3,-3
2017-05-26,2017,LAD,CHC,4,0,-135,-1.5,171,7.0,105,-125,120,1.5,-199,4.02,Dodger Stadium,4,4
2017-05-26,2017,PHI,CIN,2,5,-133,-1.5,160,8.0,-120,100,118,1.5,-185,4.57,Citizens Bank Park,7,-3
2017-05-26,2017,KC,CLE,6,4,153,1.5,-138,8.5,-105,-115,-173,-1.5,118,3.36,Progressive Field,10,2
2017-05-26,2017,STL,COL,0,10,-111,-1.5,144,11.0,-105,-115,101,1.5,-165,5.79,Coors Field,10,-10
2017-05-26,2017,DET,CWS,2,8,-105,1.5,-215,9.5,-110,-110,-105,-1.5,180,4.87,Guaranteed Rate Field,10,-6
2017-05-26,2017,CWS,DET,8,2,-105,-1.5,180,9.5,-110,-110,-105,1.5,-215,4.87,Guaranteed Rate Field,10,6
2017-05-26,2017,BAL,HOU,0,2,130,1.5,-161,9.0,100,-120,-145,-1.5,141,3.91,Minute Maid Park,2,-2
2017-05-26,2017,CLE,KC,4,6,-173,-1.5,118,8.5,-105,-115,153,1.5,-138,5.39,Progressive Field,10,-2
2017-05-26,2017,MIA,LAA,8,5,-127,-1.5,163,8.0,-120,100,117,1.5,-190,4.48,Marlins Park,13,3
2017-05-26,2017,CHC,LAD,0,4,120,1.5,-199,7.0,105,-125,-135,-1.5,171,3.18,Dodger Stadium,4,-4
2017-05-26,2017,LAA,MIA,5,8,117,1.5,-190,8.0,-120,100,-127,-1.5,163,3.69,Marlins Park,13,-3
2017-05-26,2017,ARI,MIL,4,2,-103,1.5,-215,9.0,100,-120,-107,-1.5,180,4.57,Miller Park,6,2
2017-05-26,2017,TB,MIN,5,2,-140,-1.5,120,8.5,-120,100,125,1.5,-140,4.96,Target Field,7,3
2017-05-26,2017,PIT,NYM,1,8,130,1.5,-135,8.0,-105,-115,-145,-1.5,115,3.48,PNC Park,9,-7
2017-05-26,2017,OAK,NYY,4,1,149,1.5,-143,9.5,100,-120,-164,-1.5,124,3.82,Yankee Stadium,5,3
2017-05-26,2017,NYY,OAK,1,4,-164,-1.5,124,9.5,100,-120,149,1.5,-143,5.9,Yankee Stadium,5,-3
2017-05-26,2017,CIN,PHI,5,2,118,1.5,-185,8.0,-120,100,-133,-1.5,160,3.67,Citizens Bank Park,7,3
2017-05-26,2017,NYM,PIT,8,1,-145,-1.5,115,8.0,-105,-115,130,1.5,-135,4.73,PNC Park,9,7
2017-05-26,2017,WSH,SD,5,1,-255,-1.5,-126,7.5,-115,-105,215,1.5,106,5.39,Nationals Park,6,4
2017-05-26,2017,BOS,SEA,3,0,-154,-1.5,120,9.5,100,-120,139,1.5,-140,5.76,Fenway Park,3,3
2017-05-26,2017,ATL,SF,2,0,-106,-1.5,148,8.0,-110,-110,-104,1.5,-170,4.12,AT&T Park,2,2
2017-05-26,2017,COL,STL,10,0,101,1.5,-165,11.0,-105,-115,-111,-1.5,144,5.47,Coors Field,10,10
2017-05-26,2017,MIN,TB,2,5,125,1.5,-140,8.5,-120,100,-140,-1.5,120,3.78,Target Field,7,-3
2017-05-26,2017,TOR,TEX,7,6,-143,-1.5,142,10.0,-105,-115,128,1.5,-163,5.88,Rogers Centre,13,1
2017-05-26,2017,TEX,TOR,6,7,128,1.5,-163,10.0,-105,-115,-143,-1.5,142,4.39,Rogers Centre,13,-1
2017-05-26,2017,SD,WSH,1,5,215,1.5,106,7.5,-115,-105,-255,-1.5,-126,2.38,Nationals Park,6,-4
2017-05-27,2017,MIL,ARI,6,1,117,1.5,-140,8.5,100,-120,-132,-1.5,120,3.92,Miller Park,7,5
2017-05-27,2017,SF,ATL,6,3,-113,-1.5,179,7.5,-115,-105,103,1.5,-214,3.98,AT&T Park,9,3
2017-05-27,2017,HOU,BAL,5,2,-201,-1.5,100,8.0,-118,-102,171,1.5,-120,5.34,Minute Maid Park,7,3
2017-05-27,2017,SEA,BOS,0,6,119,1.5,-180,10.5,-101,-119,-129,-1.5,155,4.79,Fenway Park,6,-6
2017-05-27,2017,LAD,CHC,5,0,-115,-1.5,180,8.0,102,-122,105,1.5,-215,4.28,Dodger Stadium,5,5
2017-05-27,2017,PHI,CIN,4,3,-128,-1.5,166,9.0,-120,100,118,1.5,-195,5.05,Citizens Bank Park,7,1
2017-05-27,2017,KC,CLE,5,2,150,1.5,-150,8.0,-105,-115,-165,-1.5,130,3.2,Progressive Field,7,3
2017-05-27,2017,STL,COL,3,0,-106,-1.5,144,10.5,-120,100,-104,1.5,-165,5.4,Coors Field,3,3
2017-05-27,2017,DET,CWS,0,3,-151,-1.5,105,9.0,-110,-110,136,1.5,-125,5.41,Guaranteed Rate Field,3,-3
2017-05-27,2017,DET,CWS,4,3,-119,-1.5,135,9.5,-105,-115,109,1.5,-155,5.16,Guaranteed Rate Field,7,1
2017-05-27,2017,CWS,DET,3,0,136,1.5,-125,9.0,-110,-110,-151,-1.5,105,3.81,Guaranteed Rate Field,3,3
2017-05-27,2017,CWS,DET,3,4,109,1.5,-155,9.5,-105,-115,-119,-1.5,135,4.55,Guaranteed Rate Field,7,-1
2017-05-27,2017,BAL,HOU,2,5,171,1.5,-120,8.0,-118,-102,-201,-1.5,100,2.95,Minute Maid Park,7,-3
2017-05-27,2017,CLE,KC,2,5,-165,-1.5,130,8.0,-105,-115,150,1.5,-150,4.98,Progressive Field,7,-3
2017-05-27,2017,MIA,LAA,2,5,-101,1.5,-170,9.0,105,-125,-109,-1.5,148,4.52,Marlins Park,7,-3
2017-05-27,2017,CHC,LAD,0,5,105,1.5,-215,8.0,102,-122,-115,-1.5,180,3.9,Dodger Stadium,5,-5
2017-05-27,2017,LAA,MIA,5,2,-109,-1.5,148,9.0,105,-125,-101,1.5,-170,4.69,Marlins Park,7,3
2017-05-27,2017,ARI,MIL,1,6,-132,-1.5,120,8.5,100,-120,117,1.5,-140,4.84,Miller Park,7,-5
2017-05-27,2017,TB,MIN,3,5,-119,-1.5,130,9.0,-110,-110,109,1.5,-150,4.89,Target Field,8,-2
2017-05-27,2017,PIT,NYM,5,4,-138,-1.5,155,8.0,-120,100,123,1.5,-180,4.64,PNC Park,9,1
2017-05-27,2017,OAK,NYY,2,3,126,1.5,-150,10.0,-105,-115,-141,-1.5,130,4.42,Yankee Stadium,5,-1
2017-05-27,2017,NYY,OAK,3,2,-141,-1.5,130,10.0,-105,-115,126,1.5,-150,5.85,Yankee Stadium,5,1
2017-05-27,2017,CIN,PHI,3,4,118,1.5,-195,9.0,-120,100,-128,-1.5,166,4.13,Citizens Bank Park,7,-1
2017-05-27,2017,NYM,PIT,4,5,123,1.5,-180,8.0,-120,100,-138,-1.5,155,3.59,PNC Park,9,-1
2017-05-27,2017,WSH,SD,3,0,-270,-1.5,-128,7.5,-120,100,230,1.5,107,5.47,Nationals Park,3,3
2017-05-27,2017,BOS,SEA,6,0,-129,-1.5,155,10.5,-101,-119,119,1.5,-180,5.91,Fenway Park,6,6
2017-05-27,2017,ATL,SF,3,6,103,1.5,-214,7.5,-115,-105,-113,-1.5,179,3.69,AT&T Park,9,-3
2017-05-27,2017,COL,STL,0,3,-104,1.5,-165,10.5,-120,100,-106,-1.5,144,5.35,Coors Field,3,-3
2017-05-27,2017,MIN,TB,5,3,109,1.5,-150,9.0,-110,-110,-119,-1.5,130,4.31,Target Field,8,2
2017-05-27,2017,TOR,TEX,3,1,-111,-1.5,192,7.5,-110,-110,101,1.5,-230,3.95,Rogers Centre,4,2
2017-05-27,2017,TEX,TOR,1,3,101,1.5,-230,7.5,-110,-110,-111,-1.5,192,3.73,Rogers Centre,4,-2
2017-05-27,2017,SD,WSH,0,3,230,1.5,107,7.5,-120,100,-270,-1.5,-128,2.27,Nationals Park,3,-3
2017-05-28,2017,MIL,ARI,9,5,-131,-1.5,163,8.5,-115,-105,116,1.5,-190,4.82,Miller Park,14,4
2017-05-28,2017,SF,ATL,7,1,-210,-1.5,109,8.0,105,-125,180,1.5,-129,5.42,AT&T Park,8,6
2017-05-28,2017,HOU,BAL,8,4,-230,-1.5,-121,8.5,100,-120,200,1.5,101,5.92,Minute Maid Park,12,4
2017-05-28,2017,SEA,BOS,5,0,171,1.5,-110,9.5,100,-120,-191,-1.5,-110,3.51,Fenway Park,5,5
2017-05-28,2017,LAD,CHC,9,4,-160,-1.5,144,6.5,-110,-110,145,1.5,-165,4.0,Dodger Stadium,13,5
2017-05-28,2017,PHI,CIN,4,8,101,1.5,-155,9.0,-120,100,-111,-1.5,135,4.48,Citizens Bank Park,12,-4
2017-05-28,2017,KC,CLE,1,10,116,1.5,-190,8.5,-125,105,-126,-1.5,163,3.94,Progressive Field,11,-9
2017-05-28,2017,STL,COL,4,8,120,1.5,-165,10.5,-115,-105,-135,-1.5,144,4.77,Coors Field,12,-4
2017-05-28,2017,DET,CWS,3,7,-114,-1.5,137,10.0,-119,-101,104,1.5,-157,5.33,Guaranteed Rate Field,10,-4
2017-05-28,2017,CWS,DET,7,3,104,1.5,-157,10.0,-119,-101,-114,-1.5,137,4.9,Guaranteed Rate Field,10,4
2017-05-28,2017,BAL,HOU,4,8,200,1.5,101,8.5,100,-120,-230,-1.5,-121,2.83,Minute Maid Park,12,-4
2017-05-28,2017,CLE,KC,10,1,-126,-1.5,163,8.5,-125,105,116,1.5,-190,4.74,Progressive Field,11,9
2017-05-28,2017,MIA,LAA,9,2,101,1.5,-170,9.0,-105,-115,-111,-1.5,148,4.48,Marlins Park,11,7
2017-05-28,2017,CHC,LAD,4,9,145,1.5,-165,6.5,-110,-110,-160,-1.5,144,2.65,Dodger Stadium,13,-5
2017-05-28,2017,LAA,MIA,2,9,-111,-1.5,148,9.0,-105,-115,101,1.5,-170,4.73,Marlins Park,11,-7
2017-05-28,2017,ARI,MIL,5,9,116,1.5,-190,8.5,-115,-105,-131,-1.5,163,3.94,Miller Park,14,-4
2017-05-28,2017,TB,MIN,8,6,-105,-1.5,148,9.5,100,-120,-105,1.5,-171,4.87,Target Field,14,2
2017-05-28,2017,PIT,NYM,2,7,-121,-1.5,176,9.0,-115,-105,111,1.5,-210,4.93,PNC Park,9,-5
2017-05-28,2017,OAK,NYY,5,9,165,1.5,-130,8.5,101,-121,-185,-1.5,110,3.21,Yankee Stadium,14,-4
2017-05-28,2017,NYY,OAK,9,5,-185,-1.5,110,8.5,101,-121,165,1.5,-130,5.52,Yankee Stadium,14,4
2017-05-28,2017,CIN,PHI,8,4,-111,-1.5,135,9.0,-120,100,101,1.5,-155,4.73,Citizens Bank Park,12,4
2017-05-28,2017,NYM,PIT,7,2,111,1.5,-210,9.0,-115,-105,-121,-1.5,176,4.27,PNC Park,9,5
2017-05-28,2017,WSH,SD,3,5,-145,-1.5,140,8.0,-115,-105,130,1.5,-160,4.73,Nationals Park,8,-2
2017-05-28,2017,BOS,SEA,0,5,-191,-1.5,-110,9.5,100,-120,171,1.5,-110,6.24,Fenway Park,5,-5
2017-05-28,2017,ATL,SF,1,7,180,1.5,-129,8.0,105,-125,-210,-1.5,109,2.86,AT&T Park,8,-6
2017-05-28,2017,COL,STL,8,4,-135,-1.5,144,10.5,-115,-105,120,1.5,-165,6.03,Coors Field,12,4
2017-05-28,2017,MIN,TB,6,8,-105,1.5,-171,9.5,100,-120,-105,-1.5,148,4.87,Target Field,14,-2
2017-05-28,2017,TOR,TEX,1,3,-176,-1.5,115,9.5,100,-120,156,1.5,-135,6.06,Rogers Centre,4,-2
2017-05-28,2017,TEX,TOR,3,1,156,1.5,-135,9.5,100,-120,-176,-1.5,115,3.71,Rogers Centre,4,2
2017-05-28,2017,SD,WSH,5,3,130,1.5,-160,8.0,-115,-105,-145,-1.5,140,3.48,Nationals Park,8,2
2017-05-29,2017,PIT,ARI,4,3,104,1.5,-165,9.5,-110,-110,-114,-1.5,144,4.66,PNC Park,7,1
2017-05-29,2017,LAA,ATL,3,6,-126,-1.5,164,7.5,-110,-110,116,1.5,-195,4.18,Angel Stadium,9,-3
2017-05-29,2017,NYY,BAL,2,3,-105,1.5,-212,9.5,100,-120,-105,-1.5,178,4.87,Camden Yards,5,-1
2017-05-29,2017,CWS,BOS,5,4,150,1.5,-105,10.0,100,-120,-165,-1.5,-115,4.0,Guaranteed Rate Field,9,1
2017-05-29,2017,SD,CHC,5,2,185,1.5,115,8.5,-110,-110,-215,-1.5,-135,2.98,PETCO Park,7,3
2017-05-29,2017,TOR,CIN,17,2,-210,-1.5,-105,9.5,-110,-110,180,1.5,-115,6.44,Rogers Centre,19,15
2017-05-29,2017,OAK,CLE,3,5,220,1.5,113,9.0,-105,-115,-260,-1.5,-133,2.81,Progressive Field,8,-2
2017-05-29,2017,SEA,COL,6,5,132,1.5,-151,11.0,-125,105,-147,-1.5,131,4.74,Coors Field,11,1
2017-05-29,2017,BOS,CWS,4,5,-165,-1.5,-115,10.0,100,-120,150,1.5,-105,6.23,Guaranteed Rate Field,9,-1
2017-05-29,2017,KC,DET,7,10,-105,1.5,-165,9.0,-125,105,-105,-1.5,144,4.61,Kauffman Stadium,17,-3
2017-05-29,2017,MIN,HOU,8,16,106,1.5,-160,9.0,-112,-108,-116,-1.5,140,4.37,Target Field,24,-8
2017-05-29,2017,DET,KC,10,7,-105,-1.5,144,9.0,-125,105,-105,1.5,-165,4.61,Kauffman Stadium,17,3
2017-05-29,2017,ATL,LAA,6,3,116,1.5,-195,7.5,-110,-110,-126,-1.5,164,3.47,Angel Stadium,9,3
2017-05-29,2017,STL,LAD,1,5,-106,-1.5,176,9.0,105,-125,-104,1.5,-210,4.63,Busch Stadium,6,-4
2017-05-29,2017,PHI,MIA,1,4,149,1.5,-145,9.5,-105,-115,-164,-1.5,125,3.82,Marlins Park,5,-3
2017-05-29,2017,NYM,MIL,4,2,-132,-1.5,163,8.5,-110,-110,117,1.5,-190,4.84,Citi Field,6,2
2017-05-29,2017,HOU,MIN,16,8,-116,-1.5,140,9.0,-112,-108,106,1.5,-160,4.83,Target Field,24,8
2017-05-29,2017,MIL,NYM,2,4,117,1.5,-190,8.5,-110,-110,-132,-1.5,163,3.92,Citi Field,6,-2
2017-05-29,2017,BAL,NYY,3,2,-105,-1.5,178,9.5,100,-120,-105,1.5,-212,4.87,Camden Yards,5,1
2017-05-29,2017,CLE,OAK,5,3,-260,-1.5,-133,9.0,-105,-115,220,1.5,113,6.5,Progressive Field,8,2
2017-05-29,2017,MIA,PHI,4,1,-164,-1.5,125,9.5,-105,-115,149,1.5,-145,5.9,Marlins Park,5,3
2017-05-29,2017,ARI,PIT,3,4,-114,-1.5,144,9.5,-110,-110,104,1.5,-165,5.06,PNC Park,7,-1
2017-05-29,2017,CHC,SD,2,5,-215,-1.5,-135,8.5,-110,-110,185,1.5,115,5.8,PETCO Park,7,-3
2017-05-29,2017,COL,SEA,5,6,-147,-1.5,131,11.0,-125,105,132,1.5,-151,6.55,Coors Field,11,-1
2017-05-29,2017,WSH,SF,3,0,-109,-1.5,145,8.5,-110,-110,-101,1.5,-166,4.43,AT&T Park,3,3
2017-05-29,2017,LAD,STL,5,1,-104,1.5,-210,9.0,105,-125,-106,-1.5,176,4.59,Busch Stadium,6,4
2017-05-29,2017,TEX,TB,8,10,-131,-1.5,148,9.5,-105,-115,116,1.5,-170,5.39,Rangers Ballpark,18,-2
2017-05-29,2017,TB,TEX,10,8,116,1.5,-170,9.5,-105,-115,-131,-1.5,148,4.4,Rangers Ballpark,18,2
2017-05-29,2017,CIN,TOR,2,17,180,1.5,-115,9.5,-110,-110,-210,-1.5,-105,3.39,Rogers Centre,19,-15
2017-05-29,2017,SF,WSH,0,3,-101,1.5,-166,8.5,-110,-110,-109,-1.5,145,4.27,AT&T Park,3,-3
2017-05-30,2017,PIT,ARI,0,3,-121,-1.5,163,8.5,-110,-110,111,1.5,-190,4.65,PNC Park,3,-3
2017-05-30,2017,LAA,ATL,9,3,-119,-1.5,166,8.5,100,-120,109,1.5,-195,4.62,Angel Stadium,12,6
2017-05-30,2017,NYY,BAL,8,3,-168,-1.5,100,8.5,-105,-115,153,1.5,-120,5.33,Camden Yards,11,5
2017-05-30,2017,CWS,BOS,7,13,150,1.5,-115,7.0,-115,-105,-170,-1.5,-105,2.8,Guaranteed Rate Field,20,-6
2017-05-30,2017,SD,CHC,6,2,131,1.5,-130,8.5,-110,-110,-146,-1.5,110,3.68,PETCO Park,8,4
2017-05-30,2017,TOR,CIN,6,4,-205,-1.5,-105,9.5,-115,-105,175,1.5,-115,6.39,Rogers Centre,10,2
2017-05-30,2017,OAK,CLE,4,9,150,1.5,-145,9.0,-105,-115,-170,-1.5,125,3.6,Progressive Field,13,-5
2017-05-30,2017,SEA,COL,10,4,134,1.5,-150,11.0,-110,-110,-149,-1.5,130,4.7,Coors Field,14,6
2017-05-30,2017,BOS,CWS,13,7,-170,-1.5,-105,7.0,-115,-105,150,1.5,-115,4.41,Guaranteed Rate Field,20,6
2017-05-30,2017,KC,DET,1,0,118,1.5,-140,9.0,-115,-105,-133,-1.5,120,4.13,Kauffman Stadium,1,1
2017-05-30,2017,MIN,HOU,2,7,-107,-1.5,170,9.0,-110,-110,-103,1.5,-200,4.65,Target Field,9,-5
2017-05-30,2017,DET,KC,0,1,-133,-1.5,120,9.0,-115,-105,118,1.5,-140,5.14,Kauffman Stadium,1,-1
2017-05-30,2017,ATL,LAA,3,9,109,1.5,-195,8.5,100,-120,-119,-1.5,166,4.07,Angel Stadium,12,-6
2017-05-30,2017,STL,LAD,4,9,107,1.5,-162,8.0,-115,-105,-117,-1.5,141,3.86,Busch Stadium,13,-5
2017-05-30,2017,PHI,MIA,2,7,109,1.5,-205,8.5,-105,-115,-119,-1.5,172,4.07,Marlins Park,9,-5
2017-05-30,2017,NYM,MIL,5,4,-132,-1.5,151,9.0,-120,100,117,1.5,-175,5.12,Citi Field,9,1
2017-05-30,2017,HOU,MIN,7,2,-103,1.5,-200,9.0,-110,-110,-107,-1.5,170,4.57,Target Field,9,5
2017-05-30,2017,MIL,NYM,4,5,117,1.5,-175,9.0,-120,100,-132,-1.5,151,4.15,Citi Field,9,-1
2017-05-30,2017,BAL,NYY,3,8,153,1.5,-120,8.5,-105,-115,-168,-1.5,100,3.36,Camden Yards,11,-5
2017-05-30,2017,CLE,OAK,9,4,-170,-1.5,125,9.0,-105,-115,150,1.5,-145,5.67,Progressive Field,13,5
2017-05-30,2017,MIA,PHI,7,2,-119,-1.5,172,8.5,-105,-115,109,1.5,-205,4.62,Marlins Park,9,5
2017-05-30,2017,ARI,PIT,3,0,111,1.5,-190,8.5,-110,-110,-121,-1.5,163,4.03,PNC Park,3,3
2017-05-30,2017,CHC,SD,2,6,-146,-1.5,110,8.5,-110,-110,131,1.5,-130,5.04,PETCO Park,8,-4
2017-05-30,2017,COL,SEA,4,10,-149,-1.5,130,11.0,-110,-110,134,1.5,-150,6.58,Coors Field,14,-6
2017-05-30,2017,WSH,SF,6,3,118,1.5,-195,7.5,-110,-110,-128,-1.5,166,3.44,AT&T Park,9,3
2017-05-30,2017,LAD,STL,9,4,-117,-1.5,141,8.0,-115,-105,107,1.5,-162,4.31,Busch Stadium,13,5
2017-05-30,2017,TEX,TB,9,5,-103,1.5,-165,10.0,-110,-110,-107,-1.5,144,5.07,Rangers Ballpark,14,4
2017-05-30,2017,TB,TEX,5,9,-107,-1.5,144,10.0,-110,-110,-103,1.5,-165,5.17,Rangers Ballpark,14,-4
2017-05-30,2017,CIN,TOR,4,6,175,1.5,-115,9.5,-115,-105,-205,-1.5,-105,3.45,Rogers Centre,10,-2
2017-05-30,2017,SF,WSH,3,6,-128,-1.5,166,7.5,-110,-110,118,1.5,-195,4.21,AT&T Park,9,-3
2017-05-31,2017,PIT,ARI,5,6,-108,-1.5,180,9.0,100,-120,-102,1.5,-215,4.67,PNC Park,11,-1
2017-05-31,2017,LAA,ATL,2,1,-118,-1.5,170,7.5,-115,-105,108,1.5,-200,4.06,Angel Stadium,3,1
2017-05-31,2017,NYY,BAL,4,10,101,1.5,-204,9.0,105,-125,-111,-1.5,171,4.48,Camden Yards,14,-6
2017-05-31,2017,CWS,BOS,1,4,121,1.5,-141,9.5,100,-120,-136,-1.5,120,4.3,Guaranteed Rate Field,5,-3
2017-05-31,2017,SD,CHC,2,1,180,1.5,115,7.5,-120,100,-210,-1.5,-135,2.68,PETCO Park,3,1
2017-05-31,2017,TOR,CIN,5,4,-117,-1.5,163,9.5,-121,101,107,1.5,-190,5.12,Rogers Centre,9,1
2017-05-31,2017,OAK,CLE,3,1,141,1.5,-155,9.0,-110,-110,-156,-1.5,135,3.73,Progressive Field,4,2
2017-05-31,2017,SEA,COL,5,0,-183,-1.5,110,8.0,-105,-115,163,1.5,-130,5.17,T-Mobile Park,5,5
2017-05-31,2017,BOS,CWS,4,1,-136,-1.5,120,9.5,100,-120,121,1.5,-141,5.47,Guaranteed Rate Field,5,3
2017-05-31,2017,KC,DET,5,6,-115,-1.5,170,9.0,-120,100,105,1.5,-200,4.81,Kauffman Stadium,11,-1
2017-05-31,2017,MIN,HOU,6,17,128,1.5,-135,10.0,100,-120,-143,-1.5,115,4.39,Target Field,23,-11
2017-05-31,2017,DET,KC,6,5,105,1.5,-200,9.0,-120,100,-115,-1.5,170,4.39,Kauffman Stadium,11,1
2017-05-31,2017,ATL,LAA,1,2,108,1.5,-200,7.5,-115,-105,-118,-1.5,170,3.61,Angel Stadium,3,-1
2017-05-31,2017,STL,LAD,2,1,-132,-1.5,160,8.0,-115,-105,117,1.5,-185,4.55,Busch Stadium,3,1
2017-05-31,2017,PHI,MIA,2,10,109,1.5,-210,7.5,-110,-110,-119,-1.5,176,3.59,Marlins Park,12,-8
2017-05-31,2017,NYM,MIL,1,7,-200,-1.5,105,7.5,100,-120,170,1.5,-125,5.0,Citi Field,8,-6
2017-05-31,2017,HOU,MIN,17,6,-143,-1.5,115,10.0,100,-120,128,1.5,-135,5.88,Target Field,23,11
2017-05-31,2017,MIL,NYM,7,1,170,1.5,-125,7.5,100,-120,-200,-1.5,105,2.78,Citi Field,8,6
2017-05-31,2017,BAL,NYY,10,4,-111,-1.5,171,9.0,105,-125,101,1.5,-204,4.73,Camden Yards,14,6
2017-05-31,2017,CLE,OAK,1,3,-156,-1.5,135,9.0,-110,-110,141,1.5,-155,5.48,Progressive Field,4,-2
2017-05-31,2017,MIA,PHI,10,2,-119,-1.5,176,7.5,-110,-110,109,1.5,-210,4.08,Marlins Park,12,8
2017-05-31,2017,ARI,PIT,6,5,-102,1.5,-215,9.0,100,-120,-108,-1.5,180,4.54,PNC Park,11,1
2017-05-31,2017,CHC,SD,1,2,-210,-1.5,-135,7.5,-120,100,180,1.5,115,5.08,PETCO Park,3,-1
2017-05-31,2017,COL,SEA,0,5,163,1.5,-130,8.0,-105,-115,-183,-1.5,110,3.04,T-Mobile Park,5,-5
2017-05-31,2017,WSH,SF,3,1,-161,-1.5,-105,7.5,105,-125,146,1.5,-115,4.63,AT&T Park,4,2
2017-05-31,2017,LAD,STL,1,2,117,1.5,-185,8.0,-115,-105,-132,-1.5,160,3.69,Busch Stadium,3,-1
2017-05-31,2017,TEX,TB,5,7,132,1.5,-130,9.5,-110,-110,-147,-1.5,110,4.09,Rangers Ballpark,12,-2
2017-05-31,2017,TB,TEX,7,5,-147,-1.5,110,9.5,-110,-110,132,1.5,-130,5.65,Rangers Ballpark,12,2
2017-05-31,2017,CIN,TOR,4,5,107,1.5,-190,9.5,-121,101,-117,-1.5,163,4.59,Rogers Centre,9,-1
2017-05-31,2017,SF,WSH,1,3,146,1.5,-115,7.5,105,-125,-161,-1.5,-105,3.05,AT&T Park,4,-2
2017-06-01,2017,MIA,ARI,2,3,111,1.5,-155,8.0,-110,-110,-121,-1.5,135,3.79,Marlins Park,5,-1
2017-06-01,2017,BOS,BAL,5,7,-123,-1.5,114,9.0,-105,-115,113,1.5,-133,4.96,Camden Yards,12,-2
2017-06-01,2017,BAL,BOS,7,5,113,1.5,-133,9.0,-105,-115,-123,-1.5,114,4.23,Camden Yards,12,2
2017-06-01,2017,OAK,CLE,0,8,195,1.5,-115,8.5,-110,-110,-225,-1.5,-105,2.88,Progressive Field,8,-8
2017-06-01,2017,SEA,COL,3,6,-126,-1.5,163,9.0,-122,102,116,1.5,-190,5.02,T-Mobile Park,9,-3
2017-06-01,2017,MIN,LAA,4,2,-104,1.5,-210,8.5,-115,-105,-106,-1.5,176,4.33,Angel Stadium,6,2
2017-06-01,2017,STL,LAD,2,0,-101,-1.5,192,8.0,-101,-119,-109,1.5,-230,4.02,Busch Stadium,2,2
2017-06-01,2017,ARI,MIA,3,2,-121,-1.5,135,8.0,-110,-110,111,1.5,-155,4.38,Marlins Park,5,1
2017-06-01,2017,NYM,MIL,1,2,-140,-1.5,151,9.0,105,-125,125,1.5,-175,5.25,Citi Field,3,-1
2017-06-01,2017,LAA,MIN,2,4,-106,-1.5,176,8.5,-115,-105,-104,1.5,-210,4.37,Angel Stadium,6,-2
2017-06-01,2017,MIL,NYM,2,1,125,1.5,-175,9.0,105,-125,-140,-1.5,151,4.0,Citi Field,3,1
2017-06-01,2017,TOR,NYY,2,12,-150,-1.5,140,8.5,-120,100,135,1.5,-160,5.1,Rogers Centre,14,-10
2017-06-01,2017,CLE,OAK,8,0,-225,-1.5,-105,8.5,-110,-110,195,1.5,-115,5.88,Progressive Field,8,8
2017-06-01,2017,COL,SEA,6,3,116,1.5,-190,9.0,-122,102,-126,-1.5,163,4.17,T-Mobile Park,9,3
2017-06-01,2017,LAD,STL,0,2,-109,1.5,-230,8.0,-101,-119,-101,-1.5,192,4.17,Busch Stadium,2,-2
2017-06-01,2017,NYY,TOR,12,2,135,1.5,-160,8.5,-120,100,-150,-1.5,140,3.62,Rogers Centre,14,10
2017-06-02,2017,MIA,ARI,7,5,-116,-1.5,172,8.5,-115,-105,106,1.5,-205,4.56,Marlins Park,12,2
2017-06-02,2017,CIN,ATL,3,2,-119,-1.5,163,9.5,-120,100,109,1.5,-190,5.16,Great American Ballpark,5,1
2017-06-02,2017,BOS,BAL,2,3,-128,-1.5,126,9.5,-115,-105,118,1.5,-146,5.33,Camden Yards,5,-1
2017-06-02,2017,BAL,BOS,3,2,118,1.5,-146,9.5,-115,-105,-128,-1.5,126,4.36,Camden Yards,5,1
2017-06-02,2017,STL,CHC,2,3,165,1.5,-130,9.0,-120,100,-185,-1.5,110,3.4,Wrigley Field,5,-1
2017-06-02,2017,ATL,CIN,2,3,109,1.5,-190,9.5,-120,100,-119,-1.5,163,4.55,Great American Ballpark,5,-1
2017-06-02,2017,KC,CLE,4,0,101,1.5,-165,9.0,-120,100,-111,-1.5,144,4.48,Kauffman Stadium,4,4
2017-06-02,2017,SD,COL,8,5,102,1.5,-165,7.5,-105,-115,-112,-1.5,144,3.71,PETCO Park,13,3
2017-06-02,2017,DET,CWS,15,5,-200,-1.5,-105,9.5,100,-120,170,1.5,-115,6.33,Comerica Park,20,10
2017-06-02,2017,CWS,DET,5,15,170,1.5,-115,9.5,100,-120,-200,-1.5,-105,3.52,Comerica Park,20,-10
2017-06-02,2017,TEX,HOU,1,7,111,1.5,-155,8.5,-113,-107,-121,-1.5,135,4.03,Rangers Ballpark,8,-6
2017-06-02,2017,CLE,KC,0,4,-111,-1.5,144,9.0,-120,100,101,1.5,-165,4.73,Kauffman Stadium,4,-4
2017-06-02,2017,MIN,LAA,11,5,118,1.5,-190,8.5,-115,-105,-128,-1.5,163,3.9,Angel Stadium,16,6
2017-06-02,2017,MIL,LAD,1,2,175,1.5,110,7.5,-110,-110,-205,-1.5,-130,2.73,Miller Park,3,-1
2017-06-02,2017,ARI,MIA,5,7,106,1.5,-205,8.5,-115,-105,-116,-1.5,172,4.13,Marlins Park,12,-2
2017-06-02,2017,LAD,MIL,2,1,-205,-1.5,-130,7.5,-110,-110,175,1.5,110,5.04,Miller Park,3,1
2017-06-02,2017,LAA,MIN,5,11,-128,-1.5,163,8.5,-115,-105,118,1.5,-190,4.77,Angel Stadium,16,-6
2017-06-02,2017,PIT,NYM,12,7,100,1.5,-215,8.5,-110,-110,-110,-1.5,180,4.25,Citi Field,19,5
2017-06-02,2017,TOR,NYY,7,5,112,1.5,-147,9.0,100,-120,-122,-1.5,127,4.25,Rogers Centre,12,2
2017-06-02,2017,WSH,OAK,13,3,-144,-1.5,114,7.5,-110,-110,129,1.5,-134,4.43,Oakland Coliseum,16,10
2017-06-02,2017,SF,PHI,10,0,116,1.5,-185,9.0,-124,104,-126,-1.5,160,4.17,Citizens Bank Park,10,10
2017-06-02,2017,NYM,PIT,7,12,-110,-1.5,180,8.5,-110,-110,100,1.5,-215,4.45,Citi Field,19,-5
2017-06-02,2017,COL,SD,5,8,-112,-1.5,144,7.5,-105,-115,102,1.5,-165,3.96,PETCO Park,13,-3
2017-06-02,2017,TB,SEA,4,12,-118,-1.5,139,9.0,-108,-112,108,1.5,-159,4.87,T-Mobile Park,16,-8
2017-06-02,2017,PHI,SF,0,10,-126,-1.5,160,9.0,-124,104,116,1.5,-185,5.02,Citizens Bank Park,10,-10
2017-06-02,2017,CHC,STL,3,2,-185,-1.5,110,9.0,-120,100,165,1.5,-130,5.84,Wrigley Field,5,1
2017-06-02,2017,SEA,TB,12,4,108,1.5,-159,9.0,-108,-112,-118,-1.5,139,4.33,T-Mobile Park,16,8
2017-06-02,2017,HOU,TEX,7,1,-121,-1.5,135,8.5,-113,-107,111,1.5,-155,4.65,Rangers Ballpark,8,6
2017-06-02,2017,NYY,TOR,5,7,-122,-1.5,127,9.0,100,-120,112,1.5,-147,4.95,Rogers Centre,12,-2
2017-06-02,2017,OAK,WSH,3,13,129,1.5,-134,7.5,-110,-110,-144,-1.5,114,3.28,Oakland Coliseum,16,-10
2017-06-03,2017,MIA,ARI,3,0,-141,-1.5,151,8.5,-108,-112,126,1.5,-175,4.97,Marlins Park,3,3
2017-06-03,2017,CIN,ATL,5,6,-180,-1.5,105,10.5,-111,-109,160,1.5,-125,6.75,Great American Ballpark,11,-1
2017-06-03,2017,BOS,BAL,5,2,-121,-1.5,130,8.5,-107,-113,111,1.5,-150,4.65,Camden Yards,7,3
2017-06-03,2017,BAL,BOS,2,5,111,1.5,-150,8.5,-107,-113,-121,-1.5,130,4.03,Camden Yards,7,-3
2017-06-03,2017,STL,CHC,3,5,134,1.5,-165,9.0,-105,-115,-149,-1.5,144,3.85,Wrigley Field,8,-2
2017-06-03,2017,ATL,CIN,6,5,160,1.5,-125,10.5,-111,-109,-180,-1.5,105,4.04,Great American Ballpark,11,1
2017-06-03,2017,KC,CLE,12,5,167,1.5,-102,8.5,-120,100,-187,-1.5,-118,3.18,Kauffman Stadium,17,7
2017-06-03,2017,SD,COL,1,10,-102,1.5,-170,8.0,-105,-115,-108,-1.5,148,4.04,PETCO Park,11,-9
2017-06-03,2017,DET,CWS,10,1,-132,-1.5,148,10.0,-109,-111,117,1.5,-170,5.69,Comerica Park,11,9
2017-06-03,2017,CWS,DET,1,10,117,1.5,-170,10.0,-109,-111,-132,-1.5,148,4.61,Comerica Park,11,-9
2017-06-03,2017,TEX,HOU,5,6,156,1.5,-105,9.5,100,-120,-176,-1.5,-115,3.71,Rangers Ballpark,11,-1
2017-06-03,2017,CLE,KC,5,12,-187,-1.5,-118,8.5,-120,100,167,1.5,-102,5.54,Kauffman Stadium,17,-7
2017-06-03,2017,MIN,LAA,2,7,-106,-1.5,144,8.0,100,-120,-104,1.5,-165,4.12,Angel Stadium,9,-5
2017-06-03,2017,MIL,LAD,8,10,146,1.5,-119,9.0,-116,-104,-161,-1.5,-101,3.66,Miller Park,18,-2
2017-06-03,2017,ARI,MIA,0,3,126,1.5,-175,8.5,-108,-112,-141,-1.5,151,3.76,Marlins Park,3,-3
2017-06-03,2017,LAD,MIL,10,8,-161,-1.5,-101,9.0,-116,-104,146,1.5,-119,5.55,Miller Park,18,2
2017-06-03,2017,LAA,MIN,7,2,-104,1.5,-165,8.0,100,-120,-106,-1.5,144,4.08,Angel Stadium,9,5
2017-06-03,2017,PIT,NYM,2,4,127,1.5,-170,9.0,-115,-105,-142,-1.5,148,3.96,Citi Field,6,-2
2017-06-03,2017,TOR,NYY,0,7,-147,-1.5,135,9.0,-105,-115,132,1.5,-155,5.36,Rogers Centre,7,-7
2017-06-03,2017,WSH,OAK,4,10,106,1.5,-210,9.0,-124,104,-116,-1.5,176,4.37,Oakland Coliseum,14,-6
2017-06-03,2017,SF,PHI,3,5,-133,-1.5,125,8.5,100,-120,118,1.5,-145,4.85,Citizens Bank Park,8,-2
2017-06-03,2017,NYM,PIT,4,2,-142,-1.5,148,9.0,-115,-105,127,1.5,-170,5.28,Citi Field,6,2
2017-06-03,2017,COL,SD,10,1,-108,-1.5,148,8.0,-105,-115,-102,1.5,-170,4.15,PETCO Park,11,9
2017-06-03,2017,TB,SEA,2,9,-102,1.5,-202,9.0,-103,-117,-108,-1.5,171,4.54,T-Mobile Park,11,-7
2017-06-03,2017,PHI,SF,5,3,118,1.5,-145,8.5,100,-120,-133,-1.5,125,3.9,Citizens Bank Park,8,2
2017-06-03,2017,CHC,STL,5,3,-149,-1.5,144,9.0,-105,-115,134,1.5,-165,5.39,Wrigley Field,8,2
2017-06-03,2017,SEA,TB,9,2,-108,-1.5,171,9.0,-103,-117,-102,1.5,-202,4.67,T-Mobile Park,11,7
2017-06-03,2017,HOU,TEX,6,5,-176,-1.5,-115,9.5,100,-120,156,1.5,-105,6.06,Rangers Ballpark,11,1
2017-06-03,2017,NYY,TOR,7,0,132,1.5,-155,9.0,-105,-115,-147,-1.5,135,3.88,Rogers Centre,7,7
2017-06-03,2017,OAK,WSH,10,4,-116,-1.5,176,9.0,-124,104,106,1.5,-210,4.83,Oakland Coliseum,14,6
2017-06-04,2017,MIA,ARI,6,5,-140,-1.5,148,9.0,-105,-115,125,1.5,-170,5.25,Marlins Park,11,1
2017-06-04,2017,CIN,ATL,8,13,-112,-1.5,170,10.0,-115,-105,102,1.5,-200,5.28,Great American Ballpark,21,-5
2017-06-04,2017,BOS,BAL,7,3,-188,-1.5,-119,9.0,-110,-110,168,1.5,-101,5.88,Camden Yards,10,4
2017-06-04,2017,BAL,BOS,3,7,168,1.5,-101,9.0,-110,-110,-188,-1.5,-119,3.36,Camden Yards,10,-4
2017-06-04,2017,STL,CHC,6,7,155,1.5,-140,9.0,100,-120,-175,-1.5,120,3.53,Wrigley Field,13,-1
2017-06-04,2017,ATL,CIN,13,8,102,1.5,-200,10.0,-115,-105,-112,-1.5,170,4.95,Great American Ballpark,21,5
2017-06-04,2017,KC,CLE,0,8,125,1.5,-135,9.0,100,-120,-140,-1.5,115,4.0,Kauffman Stadium,8,-8
2017-06-04,2017,SD,COL,1,3,125,1.5,-130,8.5,-105,-115,-140,-1.5,110,3.78,PETCO Park,4,-2
2017-06-04,2017,DET,CWS,7,4,-260,-1.5,-125,10.0,-110,-110,220,1.5,105,7.22,Comerica Park,11,3
2017-06-04,2017,CWS,DET,4,7,220,1.5,105,10.0,-110,-110,-260,-1.5,-125,3.13,Comerica Park,11,-3
2017-06-04,2017,TEX,HOU,2,7,130,1.5,-130,10.5,-105,-115,-145,-1.5,110,4.57,Rangers Ballpark,9,-5
2017-06-04,2017,CLE,KC,8,0,-140,-1.5,115,9.0,100,-120,125,1.5,-135,5.25,Kauffman Stadium,8,8
2017-06-04,2017,MIN,LAA,3,2,-134,-1.5,115,8.0,-120,100,119,1.5,-135,4.58,Angel Stadium,5,1
2017-06-04,2017,MIL,LAD,3,0,129,1.5,-135,9.5,-110,-110,-144,-1.5,115,4.15,Miller Park,3,3
2017-06-04,2017,ARI,MIA,5,6,125,1.5,-170,9.0,-105,-115,-140,-1.5,148,4.0,Marlins Park,11,-1
2017-06-04,2017,LAD,MIL,0,3,-144,-1.5,115,9.5,-110,-110,129,1.5,-135,5.61,Miller Park,3,-3
2017-06-04,2017,LAA,MIN,2,3,119,1.5,-135,8.0,-120,100,-134,-1.5,115,3.65,Angel Stadium,5,-1
2017-06-04,2017,PIT,NYM,11,1,111,1.5,-195,9.5,100,-120,-121,-1.5,166,4.5,Citi Field,12,10
2017-06-04,2017,TOR,NYY,3,2,-108,-1.5,184,8.5,-110,-110,-102,1.5,-220,4.41,Rogers Centre,5,1
2017-06-04,2017,WSH,OAK,11,10,-109,1.5,-220,9.5,100,-120,-101,-1.5,184,4.95,Oakland Coliseum,21,1
2017-06-04,2017,SF,PHI,7,9,-111,-1.5,144,9.5,-110,-110,101,1.5,-165,5.0,Citizens Bank Park,16,-2
2017-06-04,2017,NYM,PIT,1,11,-121,-1.5,166,9.5,100,-120,111,1.5,-195,5.2,Citi Field,12,-10
2017-06-04,2017,COL,SD,3,1,-140,-1.5,110,8.5,-105,-115,125,1.5,-130,4.96,PETCO Park,4,2
2017-06-04,2017,TB,SEA,1,7,116,1.5,-185,8.5,-115,-105,-131,-1.5,160,3.94,T-Mobile Park,8,-6
2017-06-04,2017,PHI,SF,9,7,101,1.5,-165,9.5,-110,-110,-111,-1.5,144,4.73,Citizens Bank Park,16,2
2017-06-04,2017,CHC,STL,7,6,-175,-1.5,120,9.0,100,-120,155,1.5,-140,5.73,Wrigley Field,13,1
2017-06-04,2017,SEA,TB,7,1,-131,-1.5,160,8.5,-115,-105,116,1.5,-185,4.82,T-Mobile Park,8,6
2017-06-04,2017,HOU,TEX,7,2,-145,-1.5,110,10.5,-105,-115,130,1.5,-130,6.21,Rangers Ballpark,9,5
2017-06-04,2017,NYY,TOR,2,3,-102,1.5,-220,8.5,-110,-110,-108,-1.5,184,4.29,Rogers Centre,5,-1
2017-06-04,2017,OAK,WSH,10,11,-101,-1.5,184,9.5,100,-120,-109,1.5,-220,4.77,Oakland Coliseum,21,-1
2017-06-05,2017,PHI,ATL,11,4,118,1.5,-180,9.5,-110,-110,-133,-1.5,155,4.36,Suntrust Park,15,7
2017-06-05,2017,MIA,CHC,1,3,106,1.5,-200,8.0,-110,-110,-116,-1.5,170,3.88,Wrigley Field,4,-2
2017-06-05,2017,STL,CIN,2,4,-160,-1.5,-105,9.5,-105,-115,145,1.5,-115,5.85,Great American Ballpark,6,-2
2017-06-05,2017,KC,HOU,3,7,119,1.5,-140,10.0,-105,-115,-129,-1.5,120,4.57,Kauffman Stadium,10,-4
2017-06-05,2017,HOU,KC,7,3,-129,-1.5,120,10.0,-105,-115,119,1.5,-140,5.63,Kauffman Stadium,10,4
2017-06-05,2017,WSH,LAD,4,2,127,1.5,-180,8.0,-115,-105,-142,-1.5,155,3.52,Dodger Stadium,6,2
2017-06-05,2017,CHC,MIA,3,1,-116,-1.5,170,8.0,-110,-110,106,1.5,-200,4.3,Wrigley Field,4,2
2017-06-05,2017,SF,MIL,7,2,-132,-1.5,120,8.0,-110,-110,117,1.5,-140,4.55,Miller Park,9,5
2017-06-05,2017,TOR,OAK,3,5,-107,1.5,-220,8.0,-120,100,-103,-1.5,184,4.14,Oakland Coliseum,8,-2
2017-06-05,2017,ATL,PHI,4,11,-133,-1.5,155,9.5,-110,-110,118,1.5,-180,5.42,Suntrust Park,15,-7
2017-06-05,2017,MIL,SF,2,7,117,1.5,-140,8.0,-110,-110,-132,-1.5,120,3.69,Miller Park,9,-5
2017-06-05,2017,CIN,STL,4,2,145,1.5,-115,9.5,-105,-115,-160,-1.5,-105,3.88,Great American Ballpark,6,2
2017-06-05,2017,OAK,TOR,5,3,-103,-1.5,184,8.0,-120,100,-107,1.5,-220,4.06,Oakland Coliseum,8,2
2017-06-05,2017,LAD,WSH,2,4,-142,-1.5,155,8.0,-115,-105,127,1.5,-180,4.69,Dodger Stadium,6,-2
2017-06-06,2017,SD,ARI,2,10,139,1.5,-155,9.0,100,-120,-154,-1.5,135,3.77,Chase Field,12,-8
2017-06-06,2017,PHI,ATL,3,1,-106,-1.5,140,8.5,-120,100,-104,1.5,-160,4.37,Suntrust Park,4,2
2017-06-06,2017,PIT,BAL,5,6,108,1.5,-180,9.0,-125,105,-118,-1.5,155,4.33,Camden Yards,11,-1
2017-06-06,2017,NYY,BOS,4,5,-124,-1.5,163,8.5,-105,-115,114,1.5,-190,4.71,Yankee Stadium,9,-1
2017-06-06,2017,MIA,CHC,2,10,175,1.5,-120,7.5,100,-120,-205,-1.5,100,2.73,Wrigley Field,12,-8
2017-06-06,2017,STL,CIN,1,13,-135,-1.5,120,9.5,-110,-110,120,1.5,-140,5.46,Great American Ballpark,14,-12
2017-06-06,2017,COL,CLE,11,3,-105,1.5,-160,11.0,-110,-110,-105,-1.5,140,5.63,Coors Field,14,8
2017-06-06,2017,CLE,COL,3,11,-105,-1.5,140,11.0,-110,-110,-105,1.5,-160,5.63,Coors Field,14,-8
2017-06-06,2017,TB,CWS,2,4,-172,-1.5,130,7.5,105,-125,152,1.5,-150,4.74,Tropicana Field,6,-2
2017-06-06,2017,LAA,DET,5,3,129,1.5,-155,9.5,-110,-110,-144,-1.5,135,4.15,Comerica Park,8,2
2017-06-06,2017,KC,HOU,9,7,111,1.5,-145,9.5,100,-120,-121,-1.5,125,4.5,Kauffman Stadium,16,2
2017-06-06,2017,HOU,KC,7,9,-121,-1.5,125,9.5,100,-120,111,1.5,-145,5.2,Kauffman Stadium,16,-2
2017-06-06,2017,DET,LAA,3,5,-144,-1.5,135,9.5,-110,-110,129,1.5,-155,5.61,Comerica Park,8,-2
2017-06-06,2017,WSH,LAD,2,1,-109,-1.5,148,7.0,100,-120,-101,1.5,-170,3.65,Dodger Stadium,3,1
2017-06-06,2017,CHC,MIA,10,2,-205,-1.5,100,7.5,100,-120,175,1.5,-120,5.04,Wrigley Field,12,8
2017-06-06,2017,SF,MIL,2,5,103,1.5,-200,9.0,-105,-115,-113,-1.5,170,4.43,Miller Park,7,-3
2017-06-06,2017,SEA,MIN,12,3,-193,-1.5,100,9.0,100,-120,173,1.5,-120,5.93,T-Mobile Park,15,9
2017-06-06,2017,TEX,NYM,10,8,121,1.5,-135,9.5,-125,105,-136,-1.5,115,4.3,Rangers Ballpark,18,2
2017-06-06,2017,BOS,NYY,5,4,114,1.5,-190,8.5,-105,-115,-124,-1.5,163,3.97,Yankee Stadium,9,1
2017-06-06,2017,TOR,OAK,1,4,-127,-1.5,135,8.5,-110,-110,117,1.5,-155,4.76,Oakland Coliseum,5,-3
2017-06-06,2017,ATL,PHI,1,3,-104,1.5,-160,8.5,-120,100,-106,-1.5,140,4.33,Suntrust Park,4,-2
2017-06-06,2017,BAL,PIT,6,5,-118,-1.5,155,9.0,-125,105,108,1.5,-180,4.87,Camden Yards,11,1
2017-06-06,2017,ARI,SD,10,2,-154,-1.5,135,9.0,100,-120,139,1.5,-155,5.46,Chase Field,12,8
2017-06-06,2017,MIN,SEA,3,12,173,1.5,-120,9.0,100,-120,-193,-1.5,100,3.3,T-Mobile Park,15,-9
2017-06-06,2017,MIL,SF,5,2,-113,-1.5,170,9.0,-105,-115,103,1.5,-200,4.77,Miller Park,7,3
2017-06-06,2017,CIN,STL,13,1,120,1.5,-140,9.5,-110,-110,-135,-1.5,120,4.32,Great American Ballpark,14,12
2017-06-06,2017,CWS,TB,4,2,152,1.5,-150,7.5,105,-125,-172,-1.5,130,2.98,Tropicana Field,6,2
2017-06-06,2017,NYM,TEX,8,10,-136,-1.5,115,9.5,-125,105,121,1.5,-135,5.47,Rangers Ballpark,18,-2
2017-06-06,2017,OAK,TOR,4,1,117,1.5,-155,8.5,-110,-110,-127,-1.5,135,3.92,Oakland Coliseum,5,3
2017-06-06,2017,LAD,WSH,1,2,-101,1.5,-170,7.0,100,-120,-109,-1.5,148,3.52,Dodger Stadium,3,-1
2017-06-07,2017,SD,ARI,4,7,185,1.5,-116,8.5,-115,-105,-215,-1.5,-104,2.98,Chase Field,11,-3
2017-06-07,2017,PHI,ATL,1,14,118,1.5,-175,9.0,105,-125,-133,-1.5,151,4.13,Suntrust Park,15,-13
2017-06-07,2017,PIT,BAL,6,9,140,1.5,-155,9.0,-120,100,-155,-1.5,135,3.75,Camden Yards,15,-3
2017-06-07,2017,NYY,BOS,8,0,-102,-1.5,184,9.0,-115,-105,-108,1.5,-220,4.54,Yankee Stadium,8,8
2017-06-07,2017,MIA,CHC,6,5,170,1.5,-130,9.0,-125,105,-200,-1.5,110,3.33,Wrigley Field,11,1
2017-06-07,2017,STL,CIN,4,6,-105,-1.5,148,9.5,-121,101,-105,1.5,-170,4.87,Great American Ballpark,10,-2
2017-06-07,2017,COL,CLE,8,1,-101,1.5,-160,11.0,100,-120,-109,-1.5,140,5.53,Coors Field,9,7
2017-06-07,2017,CLE,COL,1,8,-109,-1.5,140,11.0,100,-120,-101,1.5,-160,5.74,Coors Field,9,-7
2017-06-07,2017,TB,CWS,3,1,-190,-1.5,120,8.5,-105,-115,170,1.5,-140,5.57,Tropicana Field,4,2
2017-06-07,2017,LAA,DET,0,4,120,1.5,-170,9.5,-115,-105,-135,-1.5,148,4.32,Comerica Park,4,-4
2017-06-07,2017,KC,HOU,7,5,-109,-1.5,180,9.5,-110,-110,-101,1.5,-215,4.95,Kauffman Stadium,12,2
2017-06-07,2017,HOU,KC,5,7,-101,1.5,-215,9.5,-110,-110,-109,-1.5,180,4.77,Kauffman Stadium,12,-2
2017-06-07,2017,DET,LAA,4,0,-135,-1.5,148,9.5,-115,-105,120,1.5,-170,5.46,Comerica Park,4,4
2017-06-07,2017,WSH,LAD,1,2,151,1.5,-160,6.5,-105,-115,-166,-1.5,140,2.59,Dodger Stadium,3,-1
2017-06-07,2017,CHC,MIA,5,6,-200,-1.5,110,9.0,-125,105,170,1.5,-130,6.0,Wrigley Field,11,-1
2017-06-07,2017,SF,MIL,3,6,103,1.5,-205,9.0,-105,-115,-113,-1.5,172,4.43,Miller Park,9,-3
2017-06-07,2017,SEA,MIN,6,5,-101,1.5,-170,9.5,-105,-115,-109,-1.5,148,4.77,T-Mobile Park,11,1
2017-06-07,2017,TEX,NYM,3,4,-147,-1.5,135,9.0,-120,100,132,1.5,-155,5.36,Rangers Ballpark,7,-1
2017-06-07,2017,BOS,NYY,0,8,-108,1.5,-220,9.0,-115,-105,-102,-1.5,184,4.67,Yankee Stadium,8,-8
2017-06-07,2017,TOR,OAK,7,5,-111,-1.5,140,9.0,-110,-110,101,1.5,-160,4.73,Oakland Coliseum,12,2
2017-06-07,2017,ATL,PHI,14,1,-133,-1.5,151,9.0,105,-125,118,1.5,-175,5.14,Suntrust Park,15,13
2017-06-07,2017,BAL,PIT,9,6,-155,-1.5,135,9.0,-120,100,140,1.5,-155,5.47,Camden Yards,15,3
2017-06-07,2017,ARI,SD,7,4,-215,-1.5,-104,8.5,-115,-105,185,1.5,-116,5.8,Chase Field,11,3
2017-06-07,2017,MIN,SEA,5,6,-109,-1.5,148,9.5,-105,-115,-101,1.5,-170,4.95,T-Mobile Park,11,-1
2017-06-07,2017,MIL,SF,6,3,-113,-1.5,172,9.0,-105,-115,103,1.5,-205,4.77,Miller Park,9,3
2017-06-07,2017,CIN,STL,6,4,-105,1.5,-170,9.5,-121,101,-105,-1.5,148,4.87,Great American Ballpark,10,2
2017-06-07,2017,CWS,TB,1,3,170,1.5,-140,8.5,-105,-115,-190,-1.5,120,3.15,Tropicana Field,4,-2
2017-06-07,2017,NYM,TEX,4,3,132,1.5,-155,9.0,-120,100,-147,-1.5,135,3.88,Rangers Ballpark,7,1
2017-06-07,2017,OAK,TOR,5,7,101,1.5,-160,9.0,-110,-110,-111,-1.5,140,4.48,Oakland Coliseum,12,-2
2017-06-07,2017,LAD,WSH,2,1,-166,-1.5,140,6.5,-105,-115,151,1.5,-160,4.06,Dodger Stadium,3,1
2017-06-08,2017,SD,ARI,3,15,118,1.5,-170,9.5,100,-120,-133,-1.5,148,4.36,Chase Field,18,-12
2017-06-08,2017,PHI,ATL,1,3,109,1.5,-180,9.5,-110,-110,-119,-1.5,155,4.55,Suntrust Park,4,-2
2017-06-08,2017,WSH,BAL,6,1,-150,-1.5,140,9.0,101,-121,135,1.5,-160,5.4,Nationals Park,7,5
2017-06-08,2017,NYY,BOS,9,1,-124,-1.5,163,8.0,-119,-101,114,1.5,-190,4.43,Yankee Stadium,10,8
2017-06-08,2017,COL,CHC,4,1,170,1.5,-130,9.0,-110,-110,-190,-1.5,110,3.33,Wrigley Field,5,3
2017-06-08,2017,STL,CIN,2,5,-112,-1.5,140,9.0,-115,-105,102,1.5,-160,4.75,Great American Ballpark,7,-3
2017-06-08,2017,CHC,COL,1,4,-190,-1.5,110,9.0,-110,-110,170,1.5,-130,5.9,Wrigley Field,5,-3
2017-06-08,2017,TB,CWS,7,5,-170,-1.5,115,8.0,-115,-105,150,1.5,-135,5.04,Tropicana Field,12,2
2017-06-08,2017,LAA,DET,11,4,170,1.5,-115,8.5,-110,-110,-200,-1.5,-105,3.15,Comerica Park,15,7
2017-06-08,2017,KC,HOU,1,6,170,1.5,103,9.0,-115,-105,-190,-1.5,-123,3.33,Kauffman Stadium,7,-5
2017-06-08,2017,HOU,KC,6,1,-190,-1.5,-123,9.0,-115,-105,170,1.5,103,5.9,Kauffman Stadium,7,5
2017-06-08,2017,DET,LAA,4,11,-200,-1.5,-105,8.5,-110,-110,170,1.5,-115,5.67,Comerica Park,15,-7
2017-06-08,2017,PIT,MIA,1,7,-143,-1.5,151,8.5,-120,100,128,1.5,-175,5.0,PNC Park,8,-6
2017-06-08,2017,SF,MIL,9,5,-111,-1.5,140,9.0,100,-120,101,1.5,-160,4.73,Miller Park,14,4
2017-06-08,2017,SEA,MIN,1,2,-111,-1.5,166,9.0,-110,-110,101,1.5,-195,4.73,T-Mobile Park,3,-1
2017-06-08,2017,BOS,NYY,1,9,114,1.5,-190,8.0,-119,-101,-124,-1.5,163,3.74,Yankee Stadium,10,-8
2017-06-08,2017,ATL,PHI,3,1,-119,-1.5,155,9.5,-110,-110,109,1.5,-180,5.16,Suntrust Park,4,2
2017-06-08,2017,MIA,PIT,7,1,128,1.5,-175,8.5,-120,100,-143,-1.5,151,3.73,PNC Park,8,6
2017-06-08,2017,ARI,SD,15,3,-133,-1.5,148,9.5,100,-120,118,1.5,-170,5.42,Chase Field,18,12
2017-06-08,2017,MIN,SEA,2,1,101,1.5,-195,9.0,-110,-110,-111,-1.5,166,4.48,T-Mobile Park,3,1
2017-06-08,2017,MIL,SF,5,9,101,1.5,-160,9.0,100,-120,-111,-1.5,140,4.48,Miller Park,14,-4
2017-06-08,2017,CIN,STL,5,2,102,1.5,-160,9.0,-115,-105,-112,-1.5,140,4.46,Great American Ballpark,7,3
2017-06-08,2017,CWS,TB,5,7,150,1.5,-135,8.0,-115,-105,-170,-1.5,115,3.2,Tropicana Field,12,-2
2017-06-08,2017,BAL,WSH,1,6,135,1.5,-160,9.0,101,-121,-150,-1.5,140,3.83,Nationals Park,7,-5
2017-06-09,2017,MIL,ARI,8,6,126,1.5,-160,10.0,-105,-115,-141,-1.5,140,4.42,Chase Field,14,2
2017-06-09,2017,NYM,ATL,2,3,-115,-1.5,130,9.5,-115,-105,105,1.5,-150,5.08,Suntrust Park,5,-1
2017-06-09,2017,NYY,BAL,8,2,-170,-1.5,110,9.5,-110,-110,150,1.5,-130,5.98,Yankee Stadium,10,6
2017-06-09,2017,DET,BOS,3,5,118,1.5,-169,11.0,-120,100,-133,-1.5,147,5.05,Fenway Park,8,-2
2017-06-09,2017,COL,CHC,5,3,129,1.5,-159,9.0,-104,-116,-144,-1.5,138,3.93,Wrigley Field,8,2
2017-06-09,2017,LAD,CIN,7,2,-204,-1.5,101,8.0,-120,100,174,1.5,-121,5.37,Dodger Stadium,9,5
2017-06-09,2017,CWS,CLE,3,7,250,1.5,130,9.0,100,-120,-300,-1.5,-150,2.57,Progressive Field,10,-4
2017-06-09,2017,CHC,COL,3,5,-144,-1.5,138,9.0,-104,-116,129,1.5,-159,5.31,Wrigley Field,8,-2
2017-06-09,2017,CLE,CWS,7,3,-300,-1.5,-150,9.0,100,-120,250,1.5,130,6.75,Progressive Field,10,4
2017-06-09,2017,BOS,DET,5,3,-133,-1.5,147,11.0,-120,100,118,1.5,-169,6.28,Fenway Park,8,2
2017-06-09,2017,LAA,HOU,9,4,153,1.5,-140,8.5,-110,-110,-168,-1.5,120,3.36,Minute Maid Park,13,5
2017-06-09,2017,SD,KC,6,3,-117,-1.5,170,8.0,100,-120,107,1.5,-203,4.31,PETCO Park,9,3
2017-06-09,2017,HOU,LAA,4,9,-168,-1.5,120,8.5,-110,-110,153,1.5,-140,5.33,Minute Maid Park,13,-5
2017-06-09,2017,CIN,LAD,2,7,174,1.5,-121,8.0,-120,100,-204,-1.5,101,2.92,Dodger Stadium,9,-5
2017-06-09,2017,PIT,MIA,7,12,-128,-1.5,151,9.5,-115,-105,118,1.5,-175,5.33,PNC Park,19,-5
2017-06-09,2017,ARI,MIL,6,8,-141,-1.5,140,10.0,-105,-115,126,1.5,-160,5.85,Chase Field,14,-2
2017-06-09,2017,SF,MIN,0,4,-133,-1.5,155,8.0,100,-120,118,1.5,-180,4.57,AT&T Park,4,-4
2017-06-09,2017,ATL,NYM,3,2,105,1.5,-150,9.5,-115,-105,-115,-1.5,130,4.63,Suntrust Park,5,1
2017-06-09,2017,BAL,NYY,2,8,150,1.5,-130,9.5,-110,-110,-170,-1.5,110,3.8,Yankee Stadium,10,-6
2017-06-09,2017,TB,OAK,13,4,-133,-1.5,155,8.5,-121,101,118,1.5,-180,4.85,Tropicana Field,17,9
2017-06-09,2017,STL,PHI,3,2,-185,-1.5,-105,9.0,-110,-110,165,1.5,-115,5.84,Busch Stadium,5,1
2017-06-09,2017,MIA,PIT,12,7,118,1.5,-175,9.5,-115,-105,-128,-1.5,151,4.36,PNC Park,19,5
2017-06-09,2017,KC,SD,3,6,107,1.5,-203,8.0,100,-120,-117,-1.5,170,3.86,PETCO Park,9,-3
2017-06-09,2017,TOR,SEA,2,4,-117,-1.5,125,8.5,-110,-110,107,1.5,-145,4.58,T-Mobile Park,6,-2
2017-06-09,2017,MIN,SF,4,0,118,1.5,-180,8.0,100,-120,-133,-1.5,155,3.67,AT&T Park,4,4
2017-06-09,2017,PHI,STL,2,3,165,1.5,-115,9.0,-110,-110,-185,-1.5,-105,3.4,Busch Stadium,5,-1
2017-06-09,2017,OAK,TB,4,13,118,1.5,-180,8.5,-121,101,-133,-1.5,155,3.9,Tropicana Field,17,-9
2017-06-09,2017,WSH,TEX,2,5,-180,-1.5,110,9.0,-125,105,160,1.5,-130,5.79,Nationals Park,7,-3
2017-06-09,2017,SEA,TOR,4,2,107,1.5,-145,8.5,-110,-110,-117,-1.5,125,4.11,T-Mobile Park,6,2
2017-06-09,2017,TEX,WSH,5,2,160,1.5,-130,9.0,-125,105,-180,-1.5,110,3.46,Nationals Park,7,3
2017-06-10,2017,MIL,ARI,2,3,135,1.5,-155,10.5,-118,-102,-150,-1.5,135,4.47,Chase Field,5,-1
2017-06-10,2017,NYM,ATL,6,1,-102,1.5,-215,9.5,-115,-105,-108,-1.5,180,4.8,Suntrust Park,7,5
2017-06-10,2017,NYM,ATL,8,1,-171,-1.5,-118,10.0,-108,-112,151,1.5,-103,6.31,Suntrust Park,9,7
2017-06-10,2017,NYY,BAL,16,3,-260,-1.5,-140,10.5,100,-120,220,1.5,120,7.58,Yankee Stadium,19,13
2017-06-10,2017,DET,BOS,3,11,170,1.5,-110,9.0,-101,-119,-190,-1.5,-110,3.33,Fenway Park,14,-8
2017-06-10,2017,COL,CHC,9,1,125,1.5,-150,13.0,-105,-115,-140,-1.5,130,5.78,Wrigley Field,10,8
2017-06-10,2017,LAD,CIN,5,4,-227,-1.5,-101,8.0,100,-120,197,1.5,-119,5.55,Dodger Stadium,9,1
2017-06-10,2017,CWS,CLE,5,3,195,1.5,106,10.0,-120,100,-225,-1.5,-126,3.39,Progressive Field,8,2
2017-06-10,2017,CHC,COL,1,9,-140,-1.5,130,13.0,-105,-115,125,1.5,-150,7.58,Wrigley Field,10,-8
2017-06-10,2017,CLE,CWS,3,5,-225,-1.5,-126,10.0,-120,100,195,1.5,106,6.92,Progressive Field,8,-2
2017-06-10,2017,BOS,DET,11,3,-190,-1.5,-110,9.0,-101,-119,170,1.5,-110,5.9,Fenway Park,14,8
2017-06-10,2017,LAA,HOU,1,3,175,1.5,-132,9.5,105,-125,-195,-1.5,110,3.45,Minute Maid Park,4,-2
2017-06-10,2017,SD,KC,6,12,109,1.5,-155,8.5,100,-120,-119,-1.5,135,4.07,PETCO Park,18,-6
2017-06-10,2017,HOU,LAA,3,1,-195,-1.5,110,9.5,105,-125,175,1.5,-132,6.28,Minute Maid Park,4,2
2017-06-10,2017,CIN,LAD,4,5,197,1.5,-119,8.0,100,-120,-227,-1.5,-101,2.69,Dodger Stadium,9,-1
2017-06-10,2017,PIT,MIA,7,6,106,1.5,-150,10.0,100,-120,-116,-1.5,130,4.85,PNC Park,13,1
2017-06-10,2017,ARI,MIL,3,2,-150,-1.5,135,10.5,-118,-102,135,1.5,-155,6.3,Chase Field,5,1
2017-06-10,2017,SF,MIN,2,3,-167,-1.5,140,7.0,-120,100,152,1.5,-160,4.38,AT&T Park,5,-1
2017-06-10,2017,ATL,NYM,1,6,-108,-1.5,180,9.5,-115,-105,-102,1.5,-215,4.93,Suntrust Park,7,-5
2017-06-10,2017,ATL,NYM,1,8,151,1.5,-103,10.0,-108,-112,-171,-1.5,-118,3.98,Suntrust Park,9,-7
2017-06-10,2017,BAL,NYY,3,16,220,1.5,120,10.5,100,-120,-260,-1.5,-140,3.28,Yankee Stadium,19,-13
2017-06-10,2017,TB,OAK,6,5,-109,-1.5,184,8.5,-105,-115,-101,1.5,-220,4.43,Tropicana Field,11,1
2017-06-10,2017,TB,OAK,2,7,-101,1.5,-170,8.0,-105,-115,-109,-1.5,148,4.02,Tropicana Field,9,-5
2017-06-10,2017,STL,PHI,7,0,-240,-1.5,-125,8.5,-115,-105,200,1.5,105,6.0,Busch Stadium,7,7
2017-06-10,2017,MIA,PIT,6,7,-116,-1.5,130,10.0,100,-120,106,1.5,-150,5.37,PNC Park,13,-1
2017-06-10,2017,KC,SD,12,6,-119,-1.5,135,8.5,100,-120,109,1.5,-155,4.62,PETCO Park,18,6
2017-06-10,2017,TOR,SEA,4,2,-126,-1.5,130,8.5,-108,-112,116,1.5,-150,4.74,T-Mobile Park,6,2
2017-06-10,2017,MIN,SF,3,2,152,1.5,-160,7.0,-120,100,-167,-1.5,140,2.78,AT&T Park,5,1
2017-06-10,2017,PHI,STL,0,7,200,1.5,105,8.5,-115,-105,-240,-1.5,-125,2.83,Busch Stadium,7,-7
2017-06-10,2017,OAK,TB,5,6,-101,1.5,-220,8.5,-105,-115,-109,-1.5,184,4.27,Tropicana Field,11,-1
2017-06-10,2017,OAK,TB,7,2,-109,-1.5,148,8.0,-105,-115,-101,1.5,-170,4.17,Tropicana Field,9,5
2017-06-10,2017,WSH,TEX,3,6,-165,-1.5,125,9.5,105,-125,150,1.5,-145,5.92,Nationals Park,9,-3
2017-06-10,2017,SEA,TOR,2,4,116,1.5,-150,8.5,-108,-112,-126,-1.5,130,3.94,T-Mobile Park,6,-2
2017-06-10,2017,TEX,WSH,6,3,150,1.5,-145,9.5,105,-125,-165,-1.5,125,3.8,Nationals Park,9,3
2017-06-11,2017,MIL,ARI,1,11,135,1.5,-160,9.0,-105,-115,-150,-1.5,140,3.83,Chase Field,12,-10
2017-06-11,2017,NYM,ATL,2,1,126,1.5,-160,8.5,-110,-110,-141,-1.5,140,3.76,Suntrust Park,3,1
2017-06-11,2017,NYY,BAL,14,3,-176,-1.5,-106,11.0,100,-120,156,1.5,-114,7.01,Yankee Stadium,17,11
2017-06-11,2017,DET,BOS,8,3,150,1.5,-130,10.5,-115,-105,-165,-1.5,110,4.2,Fenway Park,11,5
2017-06-11,2017,COL,CHC,5,7,204,1.5,100,11.0,-115,-105,-234,-1.5,-120,3.62,Wrigley Field,12,-2
2017-06-11,2017,LAD,CIN,9,7,-180,-1.5,110,8.5,-115,-105,160,1.5,-130,5.46,Dodger Stadium,16,2
2017-06-11,2017,CWS,CLE,2,4,170,1.5,-130,8.5,-105,-115,-190,-1.5,110,3.15,Progressive Field,6,-2
2017-06-11,2017,CHC,COL,7,5,-234,-1.5,-120,11.0,-115,-105,204,1.5,100,7.71,Wrigley Field,12,2
2017-06-11,2017,CLE,CWS,4,2,-190,-1.5,110,8.5,-105,-115,170,1.5,-130,5.57,Progressive Field,6,2
2017-06-11,2017,BOS,DET,3,8,-165,-1.5,110,10.5,-115,-105,150,1.5,-130,6.54,Fenway Park,11,-5
2017-06-11,2017,LAA,HOU,12,6,160,1.5,-130,9.0,-105,-115,-180,-1.5,110,3.46,Minute Maid Park,18,6
2017-06-11,2017,SD,KC,3,8,-108,-1.5,176,8.5,100,-120,-102,1.5,-210,4.41,PETCO Park,11,-5
2017-06-11,2017,HOU,LAA,6,12,-180,-1.5,110,9.0,-105,-115,160,1.5,-130,5.79,Minute Maid Park,18,-6
2017-06-11,2017,CIN,LAD,7,9,160,1.5,-130,8.5,-115,-105,-180,-1.5,110,3.27,Dodger Stadium,16,-2
2017-06-11,2017,PIT,MIA,3,1,-170,-1.5,117,9.5,100,-120,150,1.5,-137,5.98,PNC Park,4,2
2017-06-11,2017,ARI,MIL,11,1,-150,-1.5,140,9.0,-105,-115,135,1.5,-160,5.4,Chase Field,12,10
2017-06-11,2017,SF,MIN,13,8,-129,-1.5,163,9.0,100,-120,119,1.5,-190,5.07,AT&T Park,21,5
2017-06-11,2017,ATL,NYM,1,2,-141,-1.5,140,8.5,-110,-110,126,1.5,-160,4.97,Suntrust Park,3,-1
2017-06-11,2017,BAL,NYY,3,14,156,1.5,-114,11.0,100,-120,-176,-1.5,-106,4.3,Yankee Stadium,17,-11
2017-06-11,2017,TB,OAK,5,4,-210,-1.5,-101,7.5,-120,100,180,1.5,-119,5.08,Tropicana Field,9,1
2017-06-11,2017,STL,PHI,6,5,-138,-1.5,144,9.0,-119,-101,123,1.5,-166,5.22,Busch Stadium,11,1
2017-06-11,2017,MIA,PIT,1,3,150,1.5,-137,9.5,100,-120,-170,-1.5,117,3.8,PNC Park,4,-2
2017-06-11,2017,KC,SD,8,3,-102,1.5,-210,8.5,100,-120,-108,-1.5,176,4.29,PETCO Park,11,5
2017-06-11,2017,TOR,SEA,4,0,146,1.5,-145,8.0,-120,100,-161,-1.5,125,3.25,T-Mobile Park,4,4
2017-06-11,2017,MIN,SF,8,13,119,1.5,-190,9.0,100,-120,-129,-1.5,163,4.11,AT&T Park,21,-5
2017-06-11,2017,PHI,STL,5,6,123,1.5,-166,9.0,-119,-101,-138,-1.5,144,4.04,Busch Stadium,11,-1
2017-06-11,2017,OAK,TB,4,5,180,1.5,-119,7.5,-120,100,-210,-1.5,-101,2.68,Tropicana Field,9,-1
2017-06-11,2017,WSH,TEX,1,5,-265,-1.5,-139,9.0,-125,105,225,1.5,119,6.53,Nationals Park,6,-4
2017-06-11,2017,SEA,TOR,0,4,-161,-1.5,125,8.0,-120,100,146,1.5,-145,4.93,T-Mobile Park,4,-4
2017-06-11,2017,TEX,WSH,5,1,225,1.5,119,9.0,-125,105,-265,-1.5,-139,2.77,Nationals Park,6,4
2017-06-12,2017,WSH,ATL,10,11,-243,-1.5,-124,8.5,-110,-110,203,1.5,104,6.02,Nationals Park,21,-1
2017-06-12,2017,CWS,BAL,10,7,106,1.5,-155,10.5,-110,-110,-116,-1.5,135,5.1,Guaranteed Rate Field,17,3
2017-06-12,2017,PHI,BOS,5,6,205,1.5,110,10.5,-115,-105,-235,-1.5,-130,3.44,Fenway Park,11,-1
2017-06-12,2017,NYM,CHC,6,1,-131,-1.5,163,8.5,-120,100,116,1.5,-190,4.82,Citi Field,7,5
2017-06-12,2017,SD,CIN,9,3,-122,-1.5,170,9.0,105,-125,112,1.5,-200,4.95,PETCO Park,12,6
2017-06-12,2017,PIT,COL,7,2,-128,-1.5,169,9.0,100,-120,118,1.5,-199,5.05,PNC Park,9,5
2017-06-12,2017,BAL,CWS,7,10,-116,-1.5,135,10.5,-110,-110,106,1.5,-155,5.64,Guaranteed Rate Field,17,-3
2017-06-12,2017,TEX,HOU,6,1,112,1.5,-199,8.5,-105,-115,-122,-1.5,171,4.01,Minute Maid Park,7,5
2017-06-12,2017,NYY,LAA,5,3,-138,-1.5,115,8.0,-111,-109,123,1.5,-135,4.64,Angel Stadium,8,2
2017-06-12,2017,SEA,MIN,14,3,115,1.5,-170,11.0,-110,-110,-125,-1.5,148,5.12,Target Field,17,11
2017-06-12,2017,CHC,NYM,1,6,116,1.5,-190,8.5,-120,100,-131,-1.5,163,3.94,Citi Field,7,-5
2017-06-12,2017,LAA,NYY,3,5,123,1.5,-135,8.0,-111,-109,-138,-1.5,115,3.59,Angel Stadium,8,-2
2017-06-12,2017,BOS,PHI,6,5,-235,-1.5,-130,10.5,-115,-105,205,1.5,110,7.37,Fenway Park,11,1
2017-06-12,2017,COL,PIT,2,7,118,1.5,-199,9.0,100,-120,-128,-1.5,169,4.13,PNC Park,9,-5
2017-06-12,2017,CIN,SD,3,9,112,1.5,-200,9.0,105,-125,-122,-1.5,170,4.25,PETCO Park,12,-6
2017-06-12,2017,MIN,SEA,3,14,-125,-1.5,148,11.0,-110,-110,115,1.5,-170,6.11,Target Field,17,-11
2017-06-12,2017,HOU,TEX,1,6,-122,-1.5,171,8.5,-105,-115,112,1.5,-199,4.67,Minute Maid Park,7,-5
2017-06-12,2017,ATL,WSH,11,10,203,1.5,104,8.5,-110,-110,-243,-1.5,-124,2.81,Nationals Park,21,1
2017-06-13,2017,DET,ARI,6,7,-104,1.5,-165,9.0,-115,-105,-106,-1.5,144,4.59,Comerica Park,13,-1
2017-06-13,2017,WSH,ATL,10,5,-190,-1.5,100,10.0,-115,-105,170,1.5,-120,6.55,Nationals Park,15,5
2017-06-13,2017,CWS,BAL,6,1,114,1.5,-140,10.0,-115,-105,-124,-1.5,120,4.67,Guaranteed Rate Field,7,5
2017-06-13,2017,PHI,BOS,3,4,250,1.5,125,9.5,-115,-105,-300,-1.5,-145,2.71,Fenway Park,7,-1
2017-06-13,2017,NYM,CHC,3,14,118,1.5,-145,8.5,-115,-105,-133,-1.5,125,3.9,Citi Field,17,-11
2017-06-13,2017,SD,CIN,6,2,-108,-1.5,171,8.5,-105,-115,-102,1.5,-204,4.41,PETCO Park,8,4
2017-06-13,2017,LAD,CLE,7,5,-180,-1.5,-115,7.5,-120,100,160,1.5,-105,4.82,Progressive Field,12,2
2017-06-13,2017,PIT,COL,5,2,-115,-1.5,172,8.0,-120,100,105,1.5,-205,4.28,PNC Park,7,3
2017-06-13,2017,BAL,CWS,1,6,-124,-1.5,120,10.0,-115,-105,114,1.5,-140,5.54,Guaranteed Rate Field,7,-5
2017-06-13,2017,ARI,DET,7,6,-106,-1.5,144,9.0,-115,-105,-104,1.5,-165,4.63,Comerica Park,13,1
2017-06-13,2017,TEX,HOU,4,2,167,1.5,-125,9.5,100,-120,-187,-1.5,105,3.56,Minute Maid Park,6,2
2017-06-13,2017,SF,KC,1,8,-112,-1.5,188,7.5,100,-120,102,1.5,-225,3.96,AT&T Park,9,-7
2017-06-13,2017,NYY,LAA,2,3,-126,-1.5,131,8.5,-125,105,116,1.5,-151,4.74,Angel Stadium,5,-1
2017-06-13,2017,CLE,LAD,5,7,160,1.5,-105,7.5,-120,100,-180,-1.5,-115,2.88,Progressive Field,12,-2
2017-06-13,2017,OAK,MIA,1,8,117,1.5,-175,9.0,-110,-110,-127,-1.5,151,4.15,Marlins Park,9,-7
2017-06-13,2017,STL,MIL,6,0,-162,-1.5,135,9.0,-110,-110,147,1.5,-155,5.56,Busch Stadium,6,6
2017-06-13,2017,STL,MIL,5,8,-113,-1.5,170,8.5,-115,-105,103,1.5,-200,4.51,Busch Stadium,13,-3
2017-06-13,2017,SEA,MIN,7,20,-111,-1.5,141,11.0,-110,-110,101,1.5,-161,5.79,Target Field,27,-13
2017-06-13,2017,CHC,NYM,14,3,-133,-1.5,125,8.5,-115,-105,118,1.5,-145,4.85,Citi Field,17,11
2017-06-13,2017,LAA,NYY,3,2,116,1.5,-151,8.5,-125,105,-126,-1.5,131,3.94,Angel Stadium,5,1
2017-06-13,2017,MIA,OAK,8,1,-127,-1.5,151,9.0,-110,-110,117,1.5,-175,5.04,Marlins Park,9,7
2017-06-13,2017,BOS,PHI,4,3,-300,-1.5,-145,9.5,-115,-105,250,1.5,125,7.13,Fenway Park,7,1
2017-06-13,2017,COL,PIT,2,5,105,1.5,-205,8.0,-120,100,-115,-1.5,172,3.9,PNC Park,7,-3
2017-06-13,2017,CIN,SD,2,6,-102,1.5,-204,8.5,-105,-115,-108,-1.5,171,4.29,PETCO Park,8,-4
2017-06-13,2017,MIN,SEA,20,7,101,1.5,-161,11.0,-110,-110,-111,-1.5,141,5.47,Target Field,27,13
2017-06-13,2017,KC,SF,8,1,102,1.5,-225,7.5,100,-120,-112,-1.5,188,3.71,AT&T Park,9,7
2017-06-13,2017,MIL,STL,0,6,147,1.5,-155,9.0,-110,-110,-162,-1.5,135,3.64,Busch Stadium,6,-6
2017-06-13,2017,MIL,STL,8,5,103,1.5,-200,8.5,-115,-105,-113,-1.5,170,4.19,Busch Stadium,13,3
2017-06-13,2017,TOR,TB,1,8,-153,-1.5,140,8.5,-115,-105,138,1.5,-160,5.14,Rogers Centre,9,-7
2017-06-13,2017,HOU,TEX,2,4,-187,-1.5,105,9.5,100,-120,167,1.5,-125,6.19,Minute Maid Park,6,-2
2017-06-13,2017,TB,TOR,8,1,138,1.5,-160,8.5,-115,-105,-153,-1.5,140,3.57,Rogers Centre,9,7
2017-06-13,2017,ATL,WSH,5,10,170,1.5,-120,10.0,-115,-105,-190,-1.5,100,3.7,Nationals Park,15,-5
2017-06-14,2017,DET,ARI,1,2,-119,-1.5,160,10.0,-127,107,109,1.5,-185,5.43,Comerica Park,3,-1
2017-06-14,2017,WSH,ATL,2,13,-177,-1.5,112,9.5,-110,-110,157,1.5,-132,6.07,Nationals Park,15,-11
2017-06-14,2017,CWS,BAL,6,10,116,1.5,-135,10.0,-115,-105,-131,-1.5,115,4.63,Guaranteed Rate Field,16,-4
2017-06-14,2017,PHI,BOS,3,7,109,1.5,-149,10.0,100,-120,-119,-1.5,129,4.78,Citizens Bank Park,10,-4
2017-06-14,2017,NYM,CHC,9,4,111,1.5,-155,9.0,-104,-116,-121,-1.5,135,4.27,Citi Field,13,5
2017-06-14,2017,SD,CIN,4,2,-115,-1.5,163,9.0,-105,-115,105,1.5,-190,4.81,PETCO Park,6,2
2017-06-14,2017,LAD,CLE,6,4,120,1.5,-185,9.0,105,-125,-135,-1.5,160,4.09,Progressive Field,10,2
2017-06-14,2017,PIT,COL,1,5,101,1.5,-168,8.5,-120,100,-111,-1.5,147,4.23,PNC Park,6,-4
2017-06-14,2017,BAL,CWS,10,6,-131,-1.5,115,10.0,-115,-105,116,1.5,-135,5.67,Guaranteed Rate Field,16,4
2017-06-14,2017,ARI,DET,2,1,109,1.5,-185,10.0,-127,107,-119,-1.5,160,4.78,Comerica Park,3,1
2017-06-14,2017,TEX,HOU,2,13,130,1.5,-157,9.5,-115,-105,-145,-1.5,137,4.13,Minute Maid Park,15,-11
2017-06-14,2017,SF,KC,2,7,-160,-1.5,125,8.0,100,-120,145,1.5,-145,4.92,AT&T Park,9,-5
2017-06-14,2017,NYY,LAA,5,7,-145,-1.5,105,8.0,-105,-115,130,1.5,-125,4.73,Angel Stadium,12,-2
2017-06-14,2017,CLE,LAD,4,6,-135,-1.5,160,9.0,105,-125,120,1.5,-185,5.17,Progressive Field,10,-2
2017-06-14,2017,OAK,MIA,6,11,153,1.5,-145,8.5,-120,100,-168,-1.5,125,3.36,Marlins Park,17,-5
2017-06-14,2017,STL,MIL,6,7,-176,-1.5,117,9.0,-105,-115,156,1.5,-137,5.74,Busch Stadium,13,-1
2017-06-14,2017,SEA,MIN,6,4,119,1.5,-175,10.5,-110,-110,-129,-1.5,151,4.79,Target Field,10,2
2017-06-14,2017,CHC,NYM,4,9,-121,-1.5,135,9.0,-104,-116,111,1.5,-155,4.93,Citi Field,13,-5
2017-06-14,2017,LAA,NYY,7,5,130,1.5,-125,8.0,-105,-115,-145,-1.5,105,3.48,Angel Stadium,12,2
2017-06-14,2017,MIA,OAK,11,6,-168,-1.5,125,8.5,-120,100,153,1.5,-145,5.33,Marlins Park,17,5
2017-06-14,2017,BOS,PHI,7,3,-119,-1.5,129,10.0,100,-120,109,1.5,-149,5.43,Citizens Bank Park,10,4
2017-06-14,2017,COL,PIT,5,1,-111,-1.5,147,8.5,-120,100,101,1.5,-168,4.47,PNC Park,6,4
2017-06-14,2017,CIN,SD,2,4,105,1.5,-190,9.0,-105,-115,-115,-1.5,163,4.39,PETCO Park,6,-2
2017-06-14,2017,MIN,SEA,4,6,-129,-1.5,151,10.5,-110,-110,119,1.5,-175,5.91,Target Field,10,-2
2017-06-14,2017,KC,SF,7,2,145,1.5,-145,8.0,100,-120,-160,-1.5,125,3.27,AT&T Park,9,5
2017-06-14,2017,MIL,STL,7,6,156,1.5,-137,9.0,-105,-115,-176,-1.5,117,3.52,Busch Stadium,13,1
2017-06-14,2017,TOR,TB,7,6,-145,-1.5,135,8.5,-110,-110,130,1.5,-155,5.03,Rogers Centre,13,1
2017-06-14,2017,HOU,TEX,13,2,-145,-1.5,137,9.5,-115,-105,130,1.5,-157,5.62,Minute Maid Park,15,11
2017-06-14,2017,TB,TOR,6,7,130,1.5,-155,8.5,-110,-110,-145,-1.5,135,3.7,Rogers Centre,13,-1
2017-06-14,2017,ATL,WSH,13,2,157,1.5,-132,9.5,-110,-110,-177,-1.5,112,3.7,Nationals Park,15,11
2017-06-15,2017,CWS,BAL,5,2,126,1.5,-130,11.5,-105,-115,-141,-1.5,110,5.09,Guaranteed Rate Field,7,3
2017-06-15,2017,PHI,BOS,1,0,230,1.5,148,8.0,-110,-110,-270,-1.5,-170,2.42,Citizens Bank Park,1,1
2017-06-15,2017,LAD,CLE,5,12,-107,-1.5,140,9.5,100,-120,-103,1.5,-160,4.91,Progressive Field,17,-7
2017-06-15,2017,SF,COL,9,10,149,1.5,-127,11.5,-110,-110,-164,-1.5,107,4.62,Coors Field,19,-1
2017-06-15,2017,BAL,CWS,2,5,-141,-1.5,110,11.5,-105,-115,126,1.5,-130,6.73,Guaranteed Rate Field,7,-3
2017-06-15,2017,TB,DET,3,5,145,1.5,-145,9.5,-105,-115,-160,-1.5,125,3.88,Comerica Park,8,-2
2017-06-15,2017,LAA,KC,2,7,-111,-1.5,176,8.5,-110,-110,101,1.5,-210,4.47,Angel Stadium,9,-5
2017-06-15,2017,KC,LAA,7,2,101,1.5,-210,8.5,-110,-110,-111,-1.5,176,4.23,Angel Stadium,9,5
2017-06-15,2017,CLE,LAD,12,5,-103,1.5,-160,9.5,100,-120,-107,-1.5,140,4.82,Progressive Field,17,7
2017-06-15,2017,STL,MIL,4,6,-149,-1.5,140,9.0,-115,-105,134,1.5,-160,5.39,Busch Stadium,10,-2
2017-06-15,2017,SEA,MIN,2,6,120,1.5,-167,10.5,-101,-119,-135,-1.5,146,4.77,Target Field,8,-4
2017-06-15,2017,WSH,NYM,8,3,-118,-1.5,140,8.5,-119,-101,108,1.5,-160,4.6,Citi Field,11,5
2017-06-15,2017,OAK,NYY,8,7,-108,1.5,-165,8.5,-105,-115,-102,-1.5,144,4.41,Oakland Coliseum,15,1
2017-06-15,2017,NYY,OAK,7,8,-102,-1.5,144,8.5,-105,-115,-108,1.5,-165,4.29,Oakland Coliseum,15,-1
2017-06-15,2017,BOS,PHI,0,1,-270,-1.5,-170,8.0,-110,-110,230,1.5,148,5.84,Citizens Bank Park,1,-1
2017-06-15,2017,MIN,SEA,6,2,-135,-1.5,146,10.5,-101,-119,120,1.5,-167,6.03,Target Field,8,4
2017-06-15,2017,COL,SF,10,9,-164,-1.5,107,11.5,-110,-110,149,1.5,-127,7.14,Coors Field,19,1
2017-06-15,2017,MIL,STL,6,4,134,1.5,-160,9.0,-115,-105,-149,-1.5,140,3.85,Busch Stadium,10,2
2017-06-15,2017,DET,TB,5,3,-160,-1.5,125,9.5,-105,-115,145,1.5,-145,5.85,Comerica Park,8,2
2017-06-15,2017,NYM,WSH,3,8,108,1.5,-160,8.5,-119,-101,-118,-1.5,140,4.09,Citi Field,11,-5
2017-06-16,2017,PHI,ARI,4,5,-123,-1.5,163,8.5,-119,-101,113,1.5,-190,4.69,Citizens Bank Park,9,-1
2017-06-16,2017,MIA,ATL,5,0,101,1.5,-210,9.0,-105,-115,-111,-1.5,176,4.48,Suntrust Park,5,5
2017-06-16,2017,STL,BAL,11,2,-133,-1.5,115,9.0,-120,100,118,1.5,-135,5.14,Camden Yards,13,9
2017-06-16,2017,HOU,BOS,1,2,-131,-1.5,155,9.0,105,-125,116,1.5,-180,5.1,Minute Maid Park,3,-1
2017-06-16,2017,PIT,CHC,5,9,-103,1.5,-170,9.0,-120,100,-107,-1.5,148,4.57,PNC Park,14,-4
2017-06-16,2017,LAD,CIN,3,1,-167,-1.5,-110,9.5,-105,-115,152,1.5,-110,5.94,Great American Ballpark,4,2
2017-06-16,2017,MIN,CLE,1,8,138,1.5,-120,9.5,-110,-110,-153,-1.5,100,3.99,Target Field,9,-7
2017-06-16,2017,SF,COL,8,10,111,1.5,-185,11.5,100,-120,-121,-1.5,160,5.45,Coors Field,18,-2
2017-06-16,2017,TOR,CWS,4,11,-205,-1.5,-109,9.0,-110,-110,175,1.5,-111,6.05,Rogers Centre,15,-7
2017-06-16,2017,TB,DET,4,13,116,1.5,-180,10.0,-110,-110,-131,-1.5,155,4.63,Comerica Park,17,-9
2017-06-16,2017,BOS,HOU,2,1,116,1.5,-180,9.0,105,-125,-131,-1.5,155,4.17,Minute Maid Park,3,1
2017-06-16,2017,LAA,KC,1,3,-109,-1.5,180,9.0,-104,-116,-101,1.5,-215,4.69,Angel Stadium,4,-2
2017-06-16,2017,KC,LAA,3,1,-101,1.5,-215,9.0,-104,-116,-109,-1.5,180,4.52,Angel Stadium,4,2
2017-06-16,2017,CIN,LAD,1,3,152,1.5,-110,9.5,-105,-115,-167,-1.5,-110,3.77,Great American Ballpark,4,-2
2017-06-16,2017,ATL,MIA,0,5,-111,-1.5,176,9.0,-105,-115,101,1.5,-210,4.73,Suntrust Park,5,-5
2017-06-16,2017,SD,MIL,5,6,144,1.5,-145,10.0,-115,-105,-159,-1.5,125,4.1,Miller Park,11,-1
2017-06-16,2017,CLE,MIN,8,1,-153,-1.5,100,9.5,-110,-110,138,1.5,-120,5.75,Target Field,9,7
2017-06-16,2017,WSH,NYM,7,2,-148,-1.5,115,7.5,-110,-110,133,1.5,-135,4.48,Citi Field,9,5
2017-06-16,2017,OAK,NYY,7,6,119,1.5,-145,8.0,-120,100,-129,-1.5,125,3.65,Oakland Coliseum,13,1
2017-06-16,2017,NYY,OAK,6,7,-129,-1.5,125,8.0,-120,100,119,1.5,-145,4.51,Oakland Coliseum,13,-1
2017-06-16,2017,ARI,PHI,5,4,113,1.5,-190,8.5,-119,-101,-123,-1.5,163,3.99,Citizens Bank Park,9,1
2017-06-16,2017,CHC,PIT,9,5,-107,-1.5,148,9.0,-120,100,-103,1.5,-170,4.65,PNC Park,14,4
2017-06-16,2017,MIL,SD,6,5,-159,-1.5,125,10.0,-115,-105,144,1.5,-145,6.14,Miller Park,11,1
2017-06-16,2017,TEX,SEA,10,4,104,1.5,-160,10.5,101,-121,-114,-1.5,140,5.15,Rangers Ballpark,14,6
2017-06-16,2017,COL,SF,10,8,-121,-1.5,160,11.5,100,-120,111,1.5,-185,6.3,Coors Field,18,2
2017-06-16,2017,BAL,STL,2,11,118,1.5,-135,9.0,-120,100,-133,-1.5,115,4.13,Camden Yards,13,-9
2017-06-16,2017,DET,TB,13,4,-131,-1.5,155,10.0,-110,-110,116,1.5,-180,5.67,Comerica Park,17,9
2017-06-16,2017,SEA,TEX,4,10,-114,-1.5,140,10.5,101,-121,104,1.5,-160,5.59,Rangers Ballpark,14,-6
2017-06-16,2017,CWS,TOR,11,4,175,1.5,-111,9.0,-110,-110,-205,-1.5,-109,3.27,Rogers Centre,15,7
2017-06-16,2017,NYM,WSH,2,7,133,1.5,-135,7.5,-110,-110,-148,-1.5,115,3.22,Citi Field,9,-5
2017-06-17,2017,PHI,ARI,1,5,119,1.5,-145,9.0,-115,-105,-129,-1.5,125,4.11,Citizens Bank Park,6,-4
2017-06-17,2017,MIA,ATL,7,8,100,1.5,-205,9.0,100,-120,-110,-1.5,172,4.5,Suntrust Park,15,-1
2017-06-17,2017,STL,BAL,7,15,104,1.5,-190,10.5,100,-120,-114,-1.5,163,5.15,Camden Yards,22,-8
2017-06-17,2017,HOU,BOS,7,1,-113,-1.5,170,9.0,-107,-113,103,1.5,-200,4.77,Minute Maid Park,8,6
2017-06-17,2017,PIT,CHC,4,3,109,1.5,-150,9.0,-110,-110,-119,-1.5,130,4.31,PNC Park,7,1
2017-06-17,2017,LAD,CIN,10,2,-147,-1.5,110,11.0,-112,-108,132,1.5,-130,6.55,Great American Ballpark,12,8
2017-06-17,2017,MIN,CLE,3,9,109,1.5,-150,11.0,100,-120,-119,-1.5,130,5.26,Target Field,12,-6
2017-06-17,2017,MIN,CLE,2,6,108,1.5,-150,10.0,-115,-105,-118,-1.5,130,4.81,Target Field,8,-4
2017-06-17,2017,SF,COL,1,5,175,1.5,102,13.0,-115,-105,-195,-1.5,-122,4.73,Coors Field,6,-4
2017-06-17,2017,TOR,CWS,2,5,-235,-1.5,-127,9.0,100,-120,205,1.5,107,6.31,Rogers Centre,7,-3
2017-06-17,2017,TB,DET,3,2,-113,-1.5,140,10.0,102,-122,103,1.5,-160,5.31,Comerica Park,5,1
2017-06-17,2017,BOS,HOU,1,7,103,1.5,-200,9.0,-107,-113,-113,-1.5,170,4.43,Minute Maid Park,8,-6
2017-06-17,2017,LAA,KC,9,0,-146,-1.5,146,9.0,100,-120,131,1.5,-168,5.34,Angel Stadium,9,9
2017-06-17,2017,KC,LAA,0,9,131,1.5,-168,9.0,100,-120,-146,-1.5,146,3.9,Angel Stadium,9,-9
2017-06-17,2017,CIN,LAD,2,10,132,1.5,-130,11.0,-112,-108,-147,-1.5,110,4.74,Great American Ballpark,12,-8
2017-06-17,2017,ATL,MIA,8,7,-110,-1.5,172,9.0,100,-120,100,1.5,-205,4.71,Suntrust Park,15,1
2017-06-17,2017,SD,MIL,7,5,153,1.5,-140,9.5,100,-120,-168,-1.5,120,3.75,Miller Park,12,2
2017-06-17,2017,CLE,MIN,9,3,-119,-1.5,130,11.0,100,-120,109,1.5,-150,5.98,Target Field,12,6
2017-06-17,2017,CLE,MIN,6,2,-118,-1.5,130,10.0,-115,-105,108,1.5,-150,5.41,Target Field,8,4
2017-06-17,2017,WSH,NYM,7,4,-171,-1.5,-110,8.5,100,-120,151,1.5,-110,5.36,Citi Field,11,3
2017-06-17,2017,OAK,NYY,5,2,111,1.5,-155,10.0,100,-120,-121,-1.5,135,4.74,Oakland Coliseum,7,3
2017-06-17,2017,NYY,OAK,2,5,-121,-1.5,135,10.0,100,-120,111,1.5,-155,5.48,Oakland Coliseum,7,-3
2017-06-17,2017,ARI,PHI,5,1,-129,-1.5,125,9.0,-115,-105,119,1.5,-145,5.07,Citizens Bank Park,6,4
2017-06-17,2017,CHC,PIT,3,4,-119,-1.5,130,9.0,-110,-110,109,1.5,-150,4.89,PNC Park,7,-1
2017-06-17,2017,MIL,SD,5,7,-168,-1.5,120,9.5,100,-120,153,1.5,-140,5.96,Miller Park,12,-2
2017-06-17,2017,TEX,SEA,10,4,-135,-1.5,130,12.0,-115,-105,120,1.5,-150,6.89,Rangers Ballpark,14,6
2017-06-17,2017,COL,SF,5,1,-195,-1.5,-122,13.0,-115,-105,175,1.5,102,8.59,Coors Field,6,4
2017-06-17,2017,BAL,STL,15,7,-114,-1.5,163,10.5,100,-120,104,1.5,-190,5.59,Camden Yards,22,8
2017-06-17,2017,DET,TB,2,3,103,1.5,-160,10.0,102,-122,-113,-1.5,140,4.93,Comerica Park,5,-1
2017-06-17,2017,SEA,TEX,4,10,120,1.5,-150,12.0,-115,-105,-135,-1.5,130,5.45,Rangers Ballpark,14,-6
2017-06-17,2017,CWS,TOR,5,2,205,1.5,107,9.0,100,-120,-235,-1.5,-127,2.95,Rogers Centre,7,3
2017-06-17,2017,NYM,WSH,4,7,151,1.5,-110,8.5,100,-120,-171,-1.5,-110,3.39,Citi Field,11,-3
2017-06-18,2017,PHI,ARI,4,5,162,1.5,101,9.5,100,-120,-182,-1.5,-121,3.63,Citizens Bank Park,9,-1
2017-06-18,2017,MIA,ATL,4,5,-101,1.5,-210,10.0,-105,-115,-109,-1.5,176,5.02,Suntrust Park,9,-1
2017-06-18,2017,STL,BAL,5,8,-105,1.5,-205,11.0,-111,-109,-105,-1.5,172,5.63,Camden Yards,13,-3
2017-06-18,2017,HOU,BOS,5,6,-127,-1.5,160,8.5,-120,100,117,1.5,-185,4.76,Minute Maid Park,11,-1
2017-06-18,2017,PIT,CHC,1,7,-111,-1.5,166,9.0,-115,-105,101,1.5,-195,4.73,PNC Park,8,-6
2017-06-18,2017,LAD,CIN,8,7,-175,-1.5,-117,11.0,-110,-110,155,1.5,-103,7.0,Great American Ballpark,15,1
2017-06-18,2017,MIN,CLE,2,5,128,1.5,-125,10.0,-110,-110,-143,-1.5,105,4.39,Target Field,7,-3
2017-06-18,2017,SF,COL,5,7,161,1.5,-103,12.5,100,-120,-181,-1.5,-117,4.79,Coors Field,12,-2
2017-06-18,2017,TOR,CWS,7,3,-225,-1.5,-119,9.5,-112,-108,195,1.5,-101,6.58,Rogers Centre,10,4
2017-06-18,2017,TB,DET,9,1,-105,1.5,-200,10.5,-115,-105,-105,-1.5,170,5.38,Comerica Park,10,8
2017-06-18,2017,BOS,HOU,6,5,117,1.5,-185,8.5,-120,100,-127,-1.5,160,3.92,Minute Maid Park,11,1
2017-06-18,2017,LAA,KC,3,7,101,1.5,-160,9.0,-110,-110,-111,-1.5,140,4.48,Angel Stadium,10,-4
2017-06-18,2017,KC,LAA,7,3,-111,-1.5,140,9.0,-110,-110,101,1.5,-160,4.73,Angel Stadium,10,4
2017-06-18,2017,CIN,LAD,7,8,155,1.5,-103,11.0,-110,-110,-175,-1.5,-117,4.31,Great American Ballpark,15,-1
2017-06-18,2017,ATL,MIA,5,4,-109,-1.5,176,10.0,-105,-115,-101,1.5,-210,5.22,Suntrust Park,9,1
2017-06-18,2017,SD,MIL,1,2,145,1.5,-136,9.0,100,-120,-160,-1.5,116,3.67,Miller Park,3,-1
2017-06-18,2017,CLE,MIN,5,2,-143,-1.5,105,10.0,-110,-110,128,1.5,-125,5.88,Target Field,7,3
2017-06-18,2017,WSH,NYM,1,5,119,1.5,-175,9.0,-110,-110,-129,-1.5,151,4.11,Citi Field,6,-4
2017-06-18,2017,OAK,NYY,4,3,119,1.5,-135,11.0,-119,-101,-134,-1.5,115,5.02,Oakland Coliseum,7,1
2017-06-18,2017,NYY,OAK,3,4,-134,-1.5,115,11.0,-119,-101,119,1.5,-135,6.3,Oakland Coliseum,7,-1
2017-06-18,2017,ARI,PHI,5,4,-182,-1.5,-121,9.5,100,-120,162,1.5,101,6.13,Citizens Bank Park,9,1
2017-06-18,2017,CHC,PIT,7,1,101,1.5,-195,9.0,-115,-105,-111,-1.5,166,4.48,PNC Park,8,6
2017-06-18,2017,MIL,SD,2,1,-160,-1.5,116,9.0,100,-120,145,1.5,-136,5.54,Miller Park,3,1
2017-06-18,2017,TEX,SEA,3,7,-192,-1.5,-103,10.5,-115,-105,172,1.5,-117,6.9,Rangers Ballpark,10,-4
2017-06-18,2017,COL,SF,7,5,-181,-1.5,-117,12.5,100,-120,161,1.5,-103,8.05,Coors Field,12,2
2017-06-18,2017,BAL,STL,8,5,-105,-1.5,172,11.0,-111,-109,-105,1.5,-205,5.63,Camden Yards,13,3
2017-06-18,2017,DET,TB,1,9,-105,-1.5,170,10.5,-115,-105,-105,1.5,-200,5.38,Comerica Park,10,-8
2017-06-18,2017,SEA,TEX,7,3,172,1.5,-117,10.5,-115,-105,-192,-1.5,-103,3.86,Rangers Ballpark,10,4
2017-06-18,2017,CWS,TOR,3,7,195,1.5,-101,9.5,-112,-108,-225,-1.5,-119,3.22,Rogers Centre,10,-4
2017-06-18,2017,NYM,WSH,5,1,-129,-1.5,151,9.0,-110,-110,119,1.5,-175,5.07,Citi Field,6,4
2017-06-19,2017,SF,ATL,0,9,-141,-1.5,115,9.0,-115,-105,126,1.5,-135,5.27,Suntrust Park,9,-9
2017-06-19,2017,CLE,BAL,12,0,-165,-1.5,-107,9.0,100,-120,150,1.5,-113,5.6,Camden Yards,12,12
2017-06-19,2017,KC,BOS,4,2,101,1.5,-165,9.5,100,-120,-111,-1.5,144,4.73,Kauffman Stadium,6,2
2017-06-19,2017,SD,CHC,2,3,180,1.5,-105,8.0,-120,100,-210,-1.5,-115,2.86,Wrigley Field,5,-1
2017-06-19,2017,TB,CIN,3,7,-148,-1.5,144,9.0,-115,-105,133,1.5,-165,5.37,Tropicana Field,10,-4
2017-06-19,2017,BAL,CLE,0,12,150,1.5,-113,9.0,100,-120,-165,-1.5,-107,3.6,Camden Yards,12,-12
2017-06-19,2017,SEA,DET,6,2,-137,-1.5,144,10.0,-110,-110,122,1.5,-165,5.78,T-Mobile Park,8,4
2017-06-19,2017,OAK,HOU,1,4,143,1.5,-119,10.0,-105,-115,-158,-1.5,-101,4.12,Oakland Coliseum,5,-3
2017-06-19,2017,BOS,KC,2,4,-111,-1.5,144,9.5,100,-120,101,1.5,-165,5.0,Kauffman Stadium,6,-2
2017-06-19,2017,NYM,LAD,6,10,255,1.5,110,7.0,-130,110,-305,-1.5,-130,1.97,Dodger Stadium,16,-4
2017-06-19,2017,WSH,MIA,7,8,-105,1.5,-215,9.5,-115,-105,-105,-1.5,180,4.87,Marlins Park,15,-1
2017-06-19,2017,PIT,MIL,8,1,-129,-1.5,130,9.0,-110,-110,119,1.5,-150,5.07,Miller Park,9,7
2017-06-19,2017,LAD,NYM,10,6,-305,-1.5,-130,7.0,-130,110,255,1.5,110,5.27,Dodger Stadium,16,4
2017-06-19,2017,HOU,OAK,4,1,-158,-1.5,-101,10.0,-105,-115,143,1.5,-119,6.12,Oakland Coliseum,5,3
2017-06-19,2017,MIL,PIT,1,8,119,1.5,-150,9.0,-110,-110,-129,-1.5,130,4.11,Miller Park,9,-7
2017-06-19,2017,CHC,SD,3,2,-210,-1.5,-115,8.0,-120,100,180,1.5,-105,5.42,Wrigley Field,5,1
2017-06-19,2017,DET,SEA,2,6,122,1.5,-165,10.0,-110,-110,-137,-1.5,144,4.5,T-Mobile Park,8,-4
2017-06-19,2017,ATL,SF,9,0,126,1.5,-135,9.0,-115,-105,-141,-1.5,115,3.98,Suntrust Park,9,9
2017-06-19,2017,CIN,TB,7,3,133,1.5,-165,9.0,-115,-105,-148,-1.5,144,3.86,Tropicana Field,10,4
2017-06-19,2017,TOR,TEX,7,6,-126,-1.5,115,10.5,-105,-115,116,1.5,-135,5.85,Rangers Ballpark,13,1
2017-06-19,2017,TEX,TOR,6,7,116,1.5,-135,10.5,-105,-115,-126,-1.5,115,4.86,Rangers Ballpark,13,-1
2017-06-19,2017,MIA,WSH,8,7,-105,-1.5,180,9.5,-115,-105,-105,1.5,-215,4.87,Marlins Park,15,1
2017-06-20,2017,COL,ARI,4,3,-126,-1.5,155,11.0,-110,-110,116,1.5,-180,6.13,Coors Field,7,1
2017-06-20,2017,SF,ATL,6,3,101,1.5,-200,9.5,100,-120,-111,-1.5,170,4.73,Suntrust Park,9,3
2017-06-20,2017,CLE,BAL,5,6,-155,-1.5,-101,11.0,-110,-110,140,1.5,-119,6.69,Camden Yards,11,-1
2017-06-20,2017,KC,BOS,3,8,165,1.5,-110,8.5,101,-121,-185,-1.5,-110,3.21,Kauffman Stadium,11,-5
2017-06-20,2017,SD,CHC,0,4,176,1.5,-119,8.5,-120,100,-196,-1.5,-101,3.08,Wrigley Field,4,-4
2017-06-20,2017,TB,CIN,6,5,-143,-1.5,140,9.5,119,-139,128,1.5,-160,5.59,Tropicana Field,11,1
2017-06-20,2017,BAL,CLE,6,5,140,1.5,-119,11.0,-110,-110,-155,-1.5,-101,4.58,Camden Yards,11,1
2017-06-20,2017,ARI,COL,3,4,116,1.5,-180,11.0,-110,-110,-126,-1.5,155,5.09,Coors Field,7,-1
2017-06-20,2017,MIN,CWS,9,7,-178,-1.5,115,9.5,-110,-110,158,1.5,-135,6.08,Target Field,16,2
2017-06-20,2017,SEA,DET,5,4,-119,-1.5,170,9.0,-120,100,109,1.5,-200,4.89,T-Mobile Park,9,1
2017-06-20,2017,OAK,HOU,4,8,-113,-1.5,172,9.0,-105,-115,103,1.5,-205,4.77,Oakland Coliseum,12,-4
2017-06-20,2017,BOS,KC,8,3,-185,-1.5,-110,8.5,101,-121,165,1.5,-110,5.52,Kauffman Stadium,11,5
2017-06-20,2017,NYY,LAA,3,8,-295,-1.5,-158,10.5,114,-134,255,1.5,138,7.84,Yankee Stadium,11,-5
2017-06-20,2017,NYM,LAD,0,12,189,1.5,-110,9.0,-105,-115,-219,-1.5,-110,3.11,Dodger Stadium,12,-12
2017-06-20,2017,WSH,MIA,12,3,-123,-1.5,130,9.0,-110,-110,113,1.5,-150,4.96,Marlins Park,15,9
2017-06-20,2017,PIT,MIL,7,3,111,1.5,-195,9.5,100,-120,-121,-1.5,166,4.5,Miller Park,10,4
2017-06-20,2017,CWS,MIN,7,9,158,1.5,-135,9.5,-110,-110,-178,-1.5,115,3.68,Target Field,16,-2
2017-06-20,2017,LAD,NYM,12,0,-219,-1.5,-110,9.0,-105,-115,189,1.5,-110,6.18,Dodger Stadium,12,12
2017-06-20,2017,LAA,NYY,8,3,255,1.5,138,10.5,114,-134,-295,-1.5,-158,2.96,Yankee Stadium,11,5
2017-06-20,2017,HOU,OAK,8,4,103,1.5,-205,9.0,-105,-115,-113,-1.5,172,4.43,Oakland Coliseum,12,4
2017-06-20,2017,STL,PHI,8,1,-161,-1.5,-108,10.0,-115,-105,146,1.5,-112,6.17,Citizens Bank Park,9,7
2017-06-20,2017,MIL,PIT,3,7,-121,-1.5,166,9.5,100,-120,111,1.5,-195,5.2,Miller Park,10,-4
2017-06-20,2017,CHC,SD,4,0,-196,-1.5,-101,8.5,-120,100,176,1.5,-119,5.63,Wrigley Field,4,4
2017-06-20,2017,DET,SEA,4,5,109,1.5,-200,9.0,-120,100,-119,-1.5,170,4.31,T-Mobile Park,9,-1
2017-06-20,2017,ATL,SF,3,6,-111,-1.5,170,9.5,100,-120,101,1.5,-200,5.0,Suntrust Park,9,-3
2017-06-20,2017,PHI,STL,1,8,146,1.5,-112,10.0,-115,-105,-161,-1.5,-108,4.07,Citizens Bank Park,9,-7
2017-06-20,2017,CIN,TB,5,6,128,1.5,-160,9.5,119,-139,-143,-1.5,140,4.17,Tropicana Field,11,-1
2017-06-20,2017,TOR,TEX,1,6,-131,-1.5,120,11.0,-105,-115,116,1.5,-140,6.24,Rangers Ballpark,7,-5
2017-06-20,2017,TEX,TOR,6,1,116,1.5,-140,11.0,-105,-115,-131,-1.5,120,5.09,Rangers Ballpark,7,5
2017-06-20,2017,MIA,WSH,3,12,113,1.5,-150,9.0,-110,-110,-123,-1.5,130,4.23,Marlins Park,15,-9
2017-06-21,2017,COL,ARI,5,16,-151,-1.5,117,12.0,-101,-119,136,1.5,-137,7.22,Coors Field,21,-11
2017-06-21,2017,SF,ATL,3,5,-127,-1.5,130,8.5,-105,-115,117,1.5,-150,4.76,Suntrust Park,8,-2
2017-06-21,2017,CLE,BAL,5,1,-185,-1.5,-125,9.5,-105,-115,165,1.5,105,6.17,Camden Yards,6,4
2017-06-21,2017,KC,BOS,6,4,125,1.5,-135,9.5,-110,-110,-140,-1.5,115,4.22,Kauffman Stadium,10,2
2017-06-21,2017,SD,CHC,3,2,176,1.5,-111,9.5,-105,-115,-206,-1.5,-109,3.44,Wrigley Field,5,1
2017-06-21,2017,TB,CIN,8,3,-105,-1.5,184,9.0,100,-120,-105,1.5,-220,4.61,Tropicana Field,11,5
2017-06-21,2017,BAL,CLE,1,5,165,1.5,105,9.5,-105,-115,-185,-1.5,-125,3.58,Camden Yards,6,-4
2017-06-21,2017,ARI,COL,16,5,136,1.5,-137,12.0,-101,-119,-151,-1.5,117,5.08,Coors Field,21,11
2017-06-21,2017,MIN,CWS,4,2,-190,-1.5,105,9.5,-105,-115,170,1.5,-125,6.22,Target Field,6,2
2017-06-21,2017,SEA,DET,7,5,-138,-1.5,151,8.5,100,-120,123,1.5,-175,4.93,T-Mobile Park,12,2
2017-06-21,2017,OAK,HOU,1,5,102,1.5,-165,9.0,-120,100,-112,-1.5,144,4.46,Oakland Coliseum,6,-4
2017-06-21,2017,BOS,KC,4,6,-140,-1.5,115,9.5,-110,-110,125,1.5,-135,5.54,Kauffman Stadium,10,-2
2017-06-21,2017,NYY,LAA,8,4,-210,-1.5,-127,10.0,-115,-105,180,1.5,107,6.77,Yankee Stadium,12,4
2017-06-21,2017,NYM,LAD,2,8,205,1.5,109,9.0,-120,100,-235,-1.5,-129,2.95,Dodger Stadium,10,-6
2017-06-21,2017,WSH,MIA,1,2,-137,-1.5,113,7.5,-119,-101,122,1.5,-133,4.34,Marlins Park,3,-1
2017-06-21,2017,PIT,MIL,3,4,111,1.5,-180,9.5,-105,-115,-121,-1.5,155,4.5,Miller Park,7,-1
2017-06-21,2017,CWS,MIN,2,4,170,1.5,-125,9.5,-105,-115,-190,-1.5,105,3.52,Target Field,6,-2
2017-06-21,2017,LAD,NYM,8,2,-235,-1.5,-129,9.0,-120,100,205,1.5,109,6.31,Dodger Stadium,10,6
2017-06-21,2017,LAA,NYY,4,8,180,1.5,107,10.0,-115,-105,-210,-1.5,-127,3.57,Yankee Stadium,12,-4
2017-06-21,2017,HOU,OAK,5,1,-112,-1.5,144,9.0,-120,100,102,1.5,-165,4.75,Oakland Coliseum,6,4
2017-06-21,2017,STL,PHI,7,6,-129,-1.5,130,9.0,-115,-105,119,1.5,-150,5.07,Citizens Bank Park,13,1
2017-06-21,2017,MIL,PIT,4,3,-121,-1.5,155,9.5,-105,-115,111,1.5,-180,5.2,Miller Park,7,1
2017-06-21,2017,CHC,SD,2,3,-206,-1.5,-109,9.5,-105,-115,176,1.5,-111,6.4,Wrigley Field,5,-1
2017-06-21,2017,DET,SEA,5,7,123,1.5,-175,8.5,100,-120,-138,-1.5,151,3.81,T-Mobile Park,12,-2
2017-06-21,2017,ATL,SF,5,3,117,1.5,-150,8.5,-105,-115,-127,-1.5,130,3.92,Suntrust Park,8,2
2017-06-21,2017,PHI,STL,6,7,119,1.5,-150,9.0,-115,-105,-129,-1.5,130,4.11,Citizens Bank Park,13,-1
2017-06-21,2017,CIN,TB,3,8,-105,1.5,-220,9.0,100,-120,-105,-1.5,184,4.61,Tropicana Field,11,-5
2017-06-21,2017,TOR,TEX,7,5,108,1.5,-195,10.5,-120,100,-118,-1.5,166,5.05,Rangers Ballpark,12,2
2017-06-21,2017,TEX,TOR,5,7,-118,-1.5,166,10.5,-120,100,108,1.5,-195,5.68,Rangers Ballpark,12,-2
2017-06-21,2017,MIA,WSH,2,1,122,1.5,-133,7.5,-119,-101,-137,-1.5,113,3.38,Marlins Park,3,1
2017-06-22,2017,COL,ARI,3,10,-138,-1.5,122,11.5,-110,-110,123,1.5,-142,6.67,Coors Field,13,-7
2017-06-22,2017,SF,ATL,11,12,155,1.5,-135,9.0,-105,-115,-175,-1.5,115,3.53,Suntrust Park,23,-1
2017-06-22,2017,CLE,BAL,6,3,-132,-1.5,120,10.5,-115,-105,117,1.5,-140,5.97,Camden Yards,9,3
2017-06-22,2017,MIA,CHC,1,11,123,1.5,-135,8.5,-120,100,-138,-1.5,115,3.81,Marlins Park,12,-10
2017-06-22,2017,BAL,CLE,3,6,117,1.5,-140,10.5,-115,-105,-132,-1.5,120,4.84,Camden Yards,9,-3
2017-06-22,2017,ARI,COL,10,3,123,1.5,-142,11.5,-110,-110,-138,-1.5,122,5.16,Coors Field,13,7
2017-06-22,2017,MIN,CWS,0,9,105,1.5,-160,10.0,-110,-110,-115,-1.5,140,4.88,Target Field,9,-9
2017-06-22,2017,SEA,DET,9,6,-140,-1.5,150,9.5,100,-120,125,1.5,-172,5.54,T-Mobile Park,15,3
2017-06-22,2017,OAK,HOU,9,12,-105,-1.5,176,10.0,-105,-115,-105,1.5,-210,5.12,Oakland Coliseum,21,-3
2017-06-22,2017,NYY,LAA,5,10,-265,-1.5,-146,9.0,-113,-107,225,1.5,126,6.53,Yankee Stadium,15,-5
2017-06-22,2017,NYM,LAD,3,6,151,1.5,-145,8.5,100,-120,-171,-1.5,125,3.39,Dodger Stadium,9,-3
2017-06-22,2017,CHC,MIA,11,1,-138,-1.5,115,8.5,-120,100,123,1.5,-135,4.93,Marlins Park,12,10
2017-06-22,2017,PIT,MIL,2,4,114,1.5,-190,9.0,-120,100,-124,-1.5,163,4.21,Miller Park,6,-2
2017-06-22,2017,CWS,MIN,9,0,-115,-1.5,140,10.0,-110,-110,105,1.5,-160,5.35,Target Field,9,9
2017-06-22,2017,LAD,NYM,6,3,-171,-1.5,125,8.5,100,-120,151,1.5,-145,5.36,Dodger Stadium,9,3
2017-06-22,2017,LAA,NYY,10,5,225,1.5,126,9.0,-113,-107,-265,-1.5,-146,2.77,Yankee Stadium,15,5
2017-06-22,2017,HOU,OAK,12,9,-105,1.5,-210,10.0,-105,-115,-105,-1.5,176,5.12,Oakland Coliseum,21,3
2017-06-22,2017,STL,PHI,1,5,-141,-1.5,118,8.0,-101,-119,126,1.5,-138,4.68,Citizens Bank Park,6,-4
2017-06-22,2017,MIL,PIT,4,2,-124,-1.5,163,9.0,-120,100,114,1.5,-190,4.98,Miller Park,6,2
2017-06-22,2017,DET,SEA,6,9,125,1.5,-172,9.5,100,-120,-140,-1.5,150,4.22,T-Mobile Park,15,-3
2017-06-22,2017,ATL,SF,12,11,-175,-1.5,115,9.0,-105,-115,155,1.5,-135,5.73,Suntrust Park,23,1
2017-06-22,2017,PHI,STL,5,1,126,1.5,-138,8.0,-101,-119,-141,-1.5,118,3.54,Citizens Bank Park,6,4
2017-06-22,2017,TOR,TEX,4,11,-114,-1.5,130,10.0,-109,-111,104,1.5,-150,5.33,Rangers Ballpark,15,-7
2017-06-22,2017,TEX,TOR,11,4,104,1.5,-150,10.0,-109,-111,-114,-1.5,130,4.9,Rangers Ballpark,15,7
2017-06-23,2017,PHI,ARI,6,1,161,1.5,-112,11.0,100,-120,-181,-1.5,-108,4.21,Chase Field,7,5
2017-06-23,2017,MIL,ATL,4,5,-103,1.5,-220,9.0,-105,-115,-107,-1.5,184,4.57,Suntrust Park,9,-1
2017-06-23,2017,TB,BAL,15,5,-240,-1.5,-115,8.5,-120,100,200,1.5,-105,6.0,Tropicana Field,20,10
2017-06-23,2017,LAA,BOS,4,9,147,1.5,-142,9.5,-102,-118,-162,-1.5,122,3.85,Fenway Park,13,-5
2017-06-23,2017,MIA,CHC,2,0,104,1.5,-154,9.0,-115,-105,-114,-1.5,135,4.41,Marlins Park,2,2
2017-06-23,2017,WSH,CIN,6,5,-239,-1.5,-125,9.0,-110,-110,209,1.5,105,6.35,Nationals Park,11,1
2017-06-23,2017,MIN,CLE,5,0,146,1.5,-138,9.5,-110,-110,-161,-1.5,118,3.86,Progressive Field,5,5
2017-06-23,2017,LAD,COL,6,1,-245,-1.5,-115,7.5,-115,-105,205,1.5,-105,5.33,Dodger Stadium,7,5
2017-06-23,2017,OAK,CWS,3,0,-107,-1.5,140,10.5,-105,-115,-103,1.5,-160,5.43,Guaranteed Rate Field,3,3
2017-06-23,2017,SD,DET,1,0,114,1.5,-167,8.0,-116,-104,-124,-1.5,146,3.74,PETCO Park,1,1
2017-06-23,2017,SEA,HOU,13,3,-101,1.5,-170,9.5,-115,-105,-109,-1.5,148,4.77,T-Mobile Park,16,10
2017-06-23,2017,TOR,KC,4,5,-140,-1.5,115,9.5,-105,-115,125,1.5,-135,5.54,Kauffman Stadium,9,-1
2017-06-23,2017,BOS,LAA,9,4,-162,-1.5,122,9.5,-102,-118,147,1.5,-142,5.87,Fenway Park,13,5
2017-06-23,2017,COL,LAD,1,6,205,1.5,-105,7.5,-115,-105,-245,-1.5,-115,2.46,Dodger Stadium,7,-5
2017-06-23,2017,CHC,MIA,0,2,-114,-1.5,135,9.0,-115,-105,104,1.5,-154,4.79,Marlins Park,2,-2
2017-06-23,2017,ATL,MIL,5,4,-107,-1.5,184,9.0,-105,-115,-103,1.5,-220,4.65,Suntrust Park,9,1
2017-06-23,2017,CLE,MIN,0,5,-161,-1.5,118,9.5,-110,-110,146,1.5,-138,5.86,Progressive Field,5,-5
2017-06-23,2017,SF,NYM,4,11,-121,-1.5,165,8.5,-120,100,111,1.5,-194,4.65,AT&T Park,15,-7
2017-06-23,2017,TEX,NYY,1,2,116,1.5,-175,10.0,100,-120,-131,-1.5,151,4.63,Yankee Stadium,3,-1
2017-06-23,2017,CWS,OAK,0,3,-103,1.5,-160,10.5,-105,-115,-107,-1.5,140,5.33,Guaranteed Rate Field,3,-3
2017-06-23,2017,ARI,PHI,1,6,-181,-1.5,-108,11.0,100,-120,161,1.5,-112,7.09,Chase Field,7,-5
2017-06-23,2017,STL,PIT,3,4,-109,-1.5,176,9.0,105,-125,-101,1.5,-210,4.69,Busch Stadium,7,-1
2017-06-23,2017,DET,SD,0,1,-124,-1.5,146,8.0,-116,-104,114,1.5,-167,4.43,PETCO Park,1,-1
2017-06-23,2017,HOU,SEA,3,13,-109,-1.5,148,9.5,-115,-105,-101,1.5,-170,4.95,T-Mobile Park,16,-10
2017-06-23,2017,NYM,SF,11,4,111,1.5,-194,8.5,-120,100,-121,-1.5,165,4.03,AT&T Park,15,7
2017-06-23,2017,PIT,STL,4,3,-101,1.5,-210,9.0,105,-125,-109,-1.5,176,4.52,Busch Stadium,7,1
2017-06-23,2017,BAL,TB,5,15,200,1.5,-105,8.5,-120,100,-240,-1.5,-115,2.83,Tropicana Field,20,-10
2017-06-23,2017,NYY,TEX,2,1,-131,-1.5,151,10.0,100,-120,116,1.5,-175,5.67,Yankee Stadium,3,1
2017-06-23,2017,KC,TOR,5,4,125,1.5,-135,9.5,-105,-115,-140,-1.5,115,4.22,Kauffman Stadium,9,1
2017-06-23,2017,CIN,WSH,5,6,209,1.5,105,9.0,-110,-110,-239,-1.5,-125,2.91,Nationals Park,11,-1
2017-06-24,2017,PHI,ARI,2,9,199,1.5,104,9.5,-110,-110,-229,-1.5,-124,3.18,Chase Field,11,-7
2017-06-24,2017,MIL,ATL,1,3,101,1.5,-205,9.5,-101,-119,-111,-1.5,172,4.73,Suntrust Park,4,-2
2017-06-24,2017,TB,BAL,3,8,-172,-1.5,120,9.0,-111,-109,152,1.5,-140,5.69,Tropicana Field,11,-5
2017-06-24,2017,LAA,BOS,6,3,158,1.5,-130,9.5,-110,-110,-178,-1.5,110,3.68,Fenway Park,9,3
2017-06-24,2017,MIA,CHC,3,5,145,1.5,-119,8.5,-110,-110,-160,-1.5,-101,3.47,Marlins Park,8,-2
2017-06-24,2017,WSH,CIN,18,3,-145,-1.5,135,10.0,-115,-105,130,1.5,-155,5.92,Nationals Park,21,15
2017-06-24,2017,MIN,CLE,4,2,250,1.5,126,9.0,-120,100,-300,-1.5,-146,2.57,Progressive Field,6,2
2017-06-24,2017,LAD,COL,4,0,-265,-1.5,-123,7.0,-120,100,225,1.5,103,5.08,Dodger Stadium,4,4
2017-06-24,2017,OAK,CWS,10,2,-111,-1.5,140,10.5,-110,-110,101,1.5,-160,5.52,Guaranteed Rate Field,12,8
2017-06-24,2017,SD,DET,7,3,-112,-1.5,176,8.5,-120,100,102,1.5,-210,4.49,PETCO Park,10,4
2017-06-24,2017,SEA,HOU,2,5,143,1.5,-125,9.5,100,-120,-158,-1.5,105,3.91,T-Mobile Park,7,-3
2017-06-24,2017,TOR,KC,2,3,-116,-1.5,135,9.0,-120,100,106,1.5,-155,4.83,Kauffman Stadium,5,-1
2017-06-24,2017,BOS,LAA,3,6,-178,-1.5,110,9.5,-110,-110,158,1.5,-130,6.08,Fenway Park,9,-3
2017-06-24,2017,COL,LAD,0,4,225,1.5,103,7.0,-120,100,-265,-1.5,-123,2.15,Dodger Stadium,4,-4
2017-06-24,2017,CHC,MIA,5,3,-160,-1.5,-101,8.5,-110,-110,145,1.5,-119,5.23,Marlins Park,8,2
2017-06-24,2017,ATL,MIL,3,1,-111,-1.5,172,9.5,-101,-119,101,1.5,-205,5.0,Suntrust Park,4,2
2017-06-24,2017,CLE,MIN,2,4,-300,-1.5,-146,9.0,-120,100,250,1.5,126,6.75,Progressive Field,6,-2
2017-06-24,2017,SF,NYM,2,5,-112,-1.5,180,7.5,-110,-110,102,1.5,-215,3.96,AT&T Park,7,-3
2017-06-24,2017,TEX,NYY,8,1,151,1.5,-126,11.0,-117,-103,-171,-1.5,106,4.38,Yankee Stadium,9,7
2017-06-24,2017,CWS,OAK,2,10,101,1.5,-160,10.5,-110,-110,-111,-1.5,140,5.22,Guaranteed Rate Field,12,-8
2017-06-24,2017,ARI,PHI,9,2,-229,-1.5,-124,9.5,-110,-110,199,1.5,104,6.61,Chase Field,11,7
2017-06-24,2017,STL,PIT,3,7,-115,-1.5,176,8.0,-110,-110,105,1.5,-210,4.28,Busch Stadium,10,-4
2017-06-24,2017,DET,SD,3,7,102,1.5,-210,8.5,-120,100,-112,-1.5,176,4.21,PETCO Park,10,-4
2017-06-24,2017,HOU,SEA,5,2,-158,-1.5,105,9.5,100,-120,143,1.5,-125,5.82,T-Mobile Park,7,3
2017-06-24,2017,NYM,SF,5,2,102,1.5,-215,7.5,-110,-110,-112,-1.5,180,3.71,AT&T Park,7,3
2017-06-24,2017,PIT,STL,7,3,105,1.5,-210,8.0,-110,-110,-115,-1.5,176,3.9,Busch Stadium,10,4
2017-06-24,2017,BAL,TB,8,3,152,1.5,-140,9.0,-111,-109,-172,-1.5,120,3.57,Tropicana Field,11,5
2017-06-24,2017,NYY,TEX,1,8,-171,-1.5,106,11.0,-117,-103,151,1.5,-126,6.94,Yankee Stadium,9,-7
2017-06-24,2017,KC,TOR,3,2,106,1.5,-155,9.0,-120,100,-116,-1.5,135,4.37,Kauffman Stadium,5,1
2017-06-24,2017,CIN,WSH,3,18,130,1.5,-155,10.0,-115,-105,-145,-1.5,135,4.35,Nationals Park,21,-15
2017-06-25,2017,PHI,ARI,1,2,156,1.5,-130,9.5,-110,-110,-176,-1.5,110,3.71,Chase Field,3,-1
2017-06-25,2017,MIL,ATL,7,0,-105,1.5,-210,9.0,-115,-105,-105,-1.5,176,4.61,Suntrust Park,7,7
2017-06-25,2017,TB,BAL,5,8,-160,-1.5,130,9.5,-110,-110,145,1.5,-150,5.85,Tropicana Field,13,-3
2017-06-25,2017,LAA,BOS,4,2,150,1.5,-135,11.0,-110,-110,-165,-1.5,115,4.4,Fenway Park,6,2
2017-06-25,2017,MIA,CHC,4,2,126,1.5,-130,8.5,-115,-105,-141,-1.5,110,3.76,Marlins Park,6,2
2017-06-25,2017,WSH,CIN,2,6,-156,-1.5,115,10.0,-120,100,141,1.5,-135,6.09,Nationals Park,8,-4
2017-06-25,2017,MIN,CLE,4,0,152,1.5,-140,9.5,-116,-104,-172,-1.5,120,3.77,Progressive Field,4,4
2017-06-25,2017,LAD,COL,12,6,-160,-1.5,130,8.5,-120,100,145,1.5,-150,5.23,Dodger Stadium,18,6
2017-06-25,2017,OAK,CWS,5,3,-124,-1.5,130,10.0,-110,-110,114,1.5,-150,5.54,Guaranteed Rate Field,8,2
2017-06-25,2017,SD,DET,5,7,116,1.5,-155,9.0,-125,105,-126,-1.5,135,4.17,PETCO Park,12,-2
2017-06-25,2017,SEA,HOU,2,8,-111,-1.5,180,10.5,-120,100,101,1.5,-215,5.52,T-Mobile Park,10,-6
2017-06-25,2017,TOR,KC,8,2,-135,-1.5,120,9.0,100,-120,120,1.5,-140,5.17,Kauffman Stadium,10,6
2017-06-25,2017,BOS,LAA,2,4,-165,-1.5,115,11.0,-110,-110,150,1.5,-135,6.85,Fenway Park,6,-2
2017-06-25,2017,COL,LAD,6,12,145,1.5,-150,8.5,-120,100,-160,-1.5,130,3.47,Dodger Stadium,18,-6
2017-06-25,2017,CHC,MIA,2,4,-141,-1.5,110,8.5,-115,-105,126,1.5,-130,4.97,Marlins Park,6,-2
2017-06-25,2017,ATL,MIL,0,7,-105,-1.5,176,9.0,-115,-105,-105,1.5,-210,4.61,Suntrust Park,7,-7
2017-06-25,2017,CLE,MIN,0,4,-172,-1.5,120,9.5,-116,-104,152,1.5,-140,6.01,Progressive Field,4,-4
2017-06-25,2017,SF,NYM,2,8,-158,-1.5,130,9.0,-113,-107,143,1.5,-150,5.51,AT&T Park,10,-6
2017-06-25,2017,TEX,NYY,7,6,205,1.5,115,10.5,-101,-119,-245,-1.5,-135,3.44,Yankee Stadium,13,1
2017-06-25,2017,CWS,OAK,3,5,114,1.5,-150,10.0,-110,-110,-124,-1.5,130,4.67,Guaranteed Rate Field,8,-2
2017-06-25,2017,ARI,PHI,2,1,-176,-1.5,110,9.5,-110,-110,156,1.5,-130,6.06,Chase Field,3,1
2017-06-25,2017,STL,PIT,8,4,-161,-1.5,130,8.5,-105,-115,146,1.5,-150,5.24,Busch Stadium,12,4
2017-06-25,2017,DET,SD,7,5,-126,-1.5,135,9.0,-125,105,116,1.5,-155,5.02,PETCO Park,12,2
2017-06-25,2017,HOU,SEA,8,2,101,1.5,-215,10.5,-120,100,-111,-1.5,180,5.22,T-Mobile Park,10,6
2017-06-25,2017,NYM,SF,8,2,143,1.5,-150,9.0,-113,-107,-158,-1.5,130,3.7,AT&T Park,10,6
2017-06-25,2017,PIT,STL,4,8,146,1.5,-150,8.5,-105,-115,-161,-1.5,130,3.46,Busch Stadium,12,-4
2017-06-25,2017,BAL,TB,8,5,145,1.5,-150,9.5,-110,-110,-160,-1.5,130,3.88,Tropicana Field,13,3
2017-06-25,2017,NYY,TEX,6,7,-245,-1.5,-135,10.5,-101,-119,205,1.5,115,7.46,Yankee Stadium,13,-1
2017-06-25,2017,KC,TOR,2,8,120,1.5,-140,9.0,100,-120,-135,-1.5,120,4.09,Kauffman Stadium,10,-6
2017-06-25,2017,CIN,WSH,6,2,141,1.5,-135,10.0,-120,100,-156,-1.5,115,4.15,Nationals Park,8,4
2017-06-26,2017,PHI,ARI,1,6,185,1.5,-108,8.0,-111,-109,-215,-1.5,-112,2.81,Chase Field,7,-5
2017-06-26,2017,MIN,BOS,1,4,172,1.5,-125,8.0,-114,-106,-202,-1.5,105,2.94,Fenway Park,5,-3
2017-06-26,2017,WSH,CHC,4,5,-157,-1.5,125,10.0,-115,-105,142,1.5,-145,6.11,Nationals Park,9,-1
2017-06-26,2017,STL,CIN,8,2,-150,-1.5,144,9.0,-115,-105,135,1.5,-165,5.4,Busch Stadium,10,6
2017-06-26,2017,TEX,CLE,9,15,156,1.5,-130,8.5,-110,-110,-176,-1.5,110,3.32,Progressive Field,24,-6
2017-06-26,2017,SF,COL,9,2,-131,-1.5,163,7.0,-115,-105,116,1.5,-190,3.97,AT&T Park,11,7
2017-06-26,2017,NYY,CWS,6,5,-155,-1.5,-101,10.0,100,-120,140,1.5,-119,6.08,Guaranteed Rate Field,11,1
2017-06-26,2017,LAD,LAA,0,4,-224,-1.5,-112,9.0,-120,100,194,1.5,-108,6.22,Dodger Stadium,4,-4
2017-06-26,2017,LAA,LAD,4,0,194,1.5,-108,9.0,-120,100,-224,-1.5,-112,3.06,Dodger Stadium,4,4
2017-06-26,2017,BOS,MIN,4,1,-202,-1.5,105,8.0,-114,-106,172,1.5,-125,5.35,Fenway Park,5,3
2017-06-26,2017,CWS,NYY,5,6,140,1.5,-119,10.0,100,-120,-155,-1.5,-101,4.17,Guaranteed Rate Field,11,-1
2017-06-26,2017,ARI,PHI,6,1,-215,-1.5,-112,8.0,-111,-109,185,1.5,-108,5.46,Chase Field,7,5
2017-06-26,2017,COL,SF,2,9,116,1.5,-190,7.0,-115,-105,-131,-1.5,163,3.24,AT&T Park,11,-7
2017-06-26,2017,CIN,STL,2,8,135,1.5,-165,9.0,-115,-105,-150,-1.5,144,3.83,Busch Stadium,10,-6
2017-06-26,2017,CLE,TEX,15,9,-176,-1.5,110,8.5,-110,-110,156,1.5,-130,5.42,Progressive Field,24,6
2017-06-26,2017,CHC,WSH,5,4,142,1.5,-145,10.0,-115,-105,-157,-1.5,125,4.13,Nationals Park,9,1
2017-06-27,2017,STL,ARI,5,6,-121,-1.5,130,9.0,-105,-115,111,1.5,-150,4.93,Chase Field,11,-1
2017-06-27,2017,SD,ATL,0,3,-115,-1.5,176,8.0,-101,-119,105,1.5,-210,4.28,PETCO Park,3,-3
2017-06-27,2017,TOR,BAL,1,3,-176,-1.5,115,9.5,-113,-107,156,1.5,-135,6.06,Rogers Centre,4,-2
2017-06-27,2017,MIN,BOS,2,9,175,1.5,-110,10.0,100,-120,-205,-1.5,-110,3.64,Fenway Park,11,-7
2017-06-27,2017,WSH,CHC,6,1,-181,-1.5,120,7.5,-110,-110,161,1.5,-140,4.83,Nationals Park,7,5
2017-06-27,2017,MIL,CIN,6,8,116,1.5,-180,10.5,-104,-116,-131,-1.5,155,4.86,Great American Ballpark,14,-2
2017-06-27,2017,TEX,CLE,2,1,157,1.5,-120,10.5,-110,-110,-177,-1.5,100,4.09,Progressive Field,3,1
2017-06-27,2017,SF,COL,4,3,101,1.5,-158,8.5,-115,-105,-111,-1.5,138,4.23,AT&T Park,7,1
2017-06-27,2017,NYY,CWS,3,4,-145,-1.5,110,8.0,-105,-115,130,1.5,-130,4.73,Guaranteed Rate Field,7,-1
2017-06-27,2017,KC,DET,3,5,128,1.5,-165,9.5,100,-120,-143,-1.5,144,4.17,Comerica Park,8,-2
2017-06-27,2017,OAK,HOU,6,4,141,1.5,-155,9.0,-110,-110,-156,-1.5,135,3.73,Minute Maid Park,10,2
2017-06-27,2017,DET,KC,5,3,-143,-1.5,144,9.5,100,-120,128,1.5,-165,5.59,Comerica Park,8,2
2017-06-27,2017,LAD,LAA,4,0,-218,-1.5,103,8.0,-107,-113,188,1.5,-123,5.48,Dodger Stadium,4,4
2017-06-27,2017,LAA,LAD,0,4,188,1.5,-123,8.0,-107,-113,-218,-1.5,103,2.78,Dodger Stadium,4,-4
2017-06-27,2017,NYM,MIA,3,6,155,1.5,-145,9.0,100,-120,-175,-1.5,125,3.53,Marlins Park,9,-3
2017-06-27,2017,CIN,MIL,8,6,-131,-1.5,155,10.5,-104,-116,116,1.5,-180,5.95,Great American Ballpark,14,2
2017-06-27,2017,BOS,MIN,9,2,-205,-1.5,-110,10.0,100,-120,175,1.5,-110,6.72,Fenway Park,11,7
2017-06-27,2017,MIA,NYM,6,3,-175,-1.5,125,9.0,100,-120,155,1.5,-145,5.73,Marlins Park,9,3
2017-06-27,2017,CWS,NYY,4,3,130,1.5,-130,8.0,-105,-115,-145,-1.5,110,3.48,Guaranteed Rate Field,7,1
2017-06-27,2017,HOU,OAK,4,6,-156,-1.5,135,9.0,-110,-110,141,1.5,-155,5.48,Minute Maid Park,10,-2
2017-06-27,2017,SEA,PHI,2,8,-195,-1.5,-110,8.5,-102,-118,175,1.5,-110,5.62,T-Mobile Park,10,-6
2017-06-27,2017,TB,PIT,4,2,-101,1.5,-215,9.0,-110,-110,-109,-1.5,180,4.52,PNC Park,6,2
2017-06-27,2017,ATL,SD,3,0,105,1.5,-210,8.0,-101,-119,-115,-1.5,176,3.9,PETCO Park,3,3
2017-06-27,2017,PHI,SEA,8,2,175,1.5,-110,8.5,-102,-118,-195,-1.5,-110,3.09,T-Mobile Park,10,6
2017-06-27,2017,COL,SF,3,4,-111,-1.5,138,8.5,-115,-105,101,1.5,-158,4.47,AT&T Park,7,-1
2017-06-27,2017,ARI,STL,6,5,111,1.5,-150,9.0,-105,-115,-121,-1.5,130,4.27,Chase Field,11,1
2017-06-27,2017,PIT,TB,2,4,-109,-1.5,180,9.0,-110,-110,-101,1.5,-215,4.69,PNC Park,6,-2
2017-06-27,2017,CLE,TEX,1,2,-177,-1.5,100,10.5,-110,-110,157,1.5,-120,6.71,Progressive Field,3,-1
2017-06-27,2017,BAL,TOR,3,1,156,1.5,-135,9.5,-113,-107,-176,-1.5,115,3.71,Rogers Centre,4,2
2017-06-27,2017,CHC,WSH,1,6,161,1.5,-140,7.5,-110,-110,-181,-1.5,120,2.87,Nationals Park,7,-5
2017-06-28,2017,STL,ARI,4,3,121,1.5,-175,10.0,100,-120,-136,-1.5,151,4.52,Chase Field,7,1
2017-06-28,2017,SD,ATL,7,4,-135,-1.5,163,8.0,-112,-108,120,1.5,-190,4.6,PETCO Park,11,3
2017-06-28,2017,TOR,BAL,4,0,-215,-1.5,-115,9.5,-105,-115,185,1.5,-105,6.48,Rogers Centre,4,4
2017-06-28,2017,MIN,BOS,4,1,147,1.5,-138,10.5,-105,-115,-162,-1.5,119,4.25,Fenway Park,5,3
2017-06-28,2017,WSH,CHC,8,4,-182,-1.5,110,8.5,-114,-106,162,1.5,-130,5.49,Nationals Park,12,4
2017-06-28,2017,MIL,CIN,3,4,-111,-1.5,144,9.5,-115,-105,101,1.5,-165,5.0,Great American Ballpark,7,-1
2017-06-28,2017,TEX,CLE,3,5,121,1.5,-174,9.0,-110,-110,-136,-1.5,150,4.07,Progressive Field,8,-2
2017-06-28,2017,SF,COL,5,3,109,1.5,-152,8.5,-120,100,-119,-1.5,133,4.07,AT&T Park,8,2
2017-06-28,2017,NYY,CWS,12,3,-121,-1.5,135,9.0,105,-125,111,1.5,-155,4.93,Guaranteed Rate Field,15,9
2017-06-28,2017,KC,DET,8,2,128,1.5,-155,9.5,-115,-105,-143,-1.5,135,4.17,Comerica Park,10,6
2017-06-28,2017,OAK,HOU,8,11,152,1.5,-135,9.5,-110,-110,-172,-1.5,115,3.77,Minute Maid Park,19,-3
2017-06-28,2017,DET,KC,2,8,-143,-1.5,135,9.5,-115,-105,128,1.5,-155,5.59,Comerica Park,10,-6
2017-06-28,2017,LAD,LAA,2,3,-133,-1.5,120,8.0,-120,100,118,1.5,-140,4.57,Angel Stadium,5,-1
2017-06-28,2017,LAA,LAD,3,2,118,1.5,-140,8.0,-120,100,-133,-1.5,120,3.67,Angel Stadium,5,1
2017-06-28,2017,NYM,MIA,8,0,103,1.5,-200,9.0,-110,-110,-113,-1.5,170,4.43,Marlins Park,8,8
2017-06-28,2017,CIN,MIL,4,3,101,1.5,-165,9.5,-115,-105,-111,-1.5,144,4.73,Great American Ballpark,7,1
2017-06-28,2017,BOS,MIN,1,4,-162,-1.5,119,10.5,-105,-115,147,1.5,-138,6.49,Fenway Park,5,-3
2017-06-28,2017,MIA,NYM,0,8,-113,-1.5,170,9.0,-110,-110,103,1.5,-200,4.77,Marlins Park,8,-8
2017-06-28,2017,CWS,NYY,3,12,111,1.5,-155,9.0,105,-125,-121,-1.5,135,4.27,Guaranteed Rate Field,15,-9
2017-06-28,2017,HOU,OAK,11,8,-172,-1.5,115,9.5,-110,-110,152,1.5,-135,6.01,Minute Maid Park,19,3
2017-06-28,2017,SEA,PHI,4,5,-230,-1.5,-115,9.0,-110,-110,200,1.5,-105,6.27,T-Mobile Park,9,-1
2017-06-28,2017,TB,PIT,2,6,-101,1.5,-210,8.5,-119,-101,-109,-1.5,176,4.27,PNC Park,8,-4
2017-06-28,2017,ATL,SD,4,7,120,1.5,-190,8.0,-112,-108,-135,-1.5,163,3.64,PETCO Park,11,-3
2017-06-28,2017,PHI,SEA,5,4,200,1.5,-105,9.0,-110,-110,-230,-1.5,-115,3.0,T-Mobile Park,9,1
2017-06-28,2017,COL,SF,3,5,-119,-1.5,133,8.5,-120,100,109,1.5,-152,4.62,AT&T Park,8,-2
2017-06-28,2017,ARI,STL,3,4,-136,-1.5,151,10.0,100,-120,121,1.5,-175,5.76,Chase Field,7,-1
2017-06-28,2017,PIT,TB,6,2,-109,-1.5,176,8.5,-119,-101,-101,1.5,-210,4.43,PNC Park,8,4
2017-06-28,2017,CLE,TEX,5,3,-136,-1.5,150,9.0,-110,-110,121,1.5,-174,5.19,Progressive Field,8,2
2017-06-28,2017,BAL,TOR,0,4,185,1.5,-105,9.5,-105,-115,-215,-1.5,-115,3.33,Rogers Centre,4,-4
2017-06-28,2017,CHC,WSH,4,8,162,1.5,-130,8.5,-114,-106,-182,-1.5,110,3.24,Nationals Park,12,-4
2017-06-29,2017,STL,ARI,10,4,119,1.5,-167,10.5,-110,-110,-134,-1.5,146,4.79,Chase Field,14,6
2017-06-29,2017,SD,ATL,6,0,-141,-1.5,160,7.5,-110,-110,126,1.5,-185,4.39,PETCO Park,6,6
2017-06-29,2017,TOR,BAL,0,2,-199,-1.5,-111,10.0,-120,100,179,1.5,-109,6.66,Rogers Centre,2,-2
2017-06-29,2017,MIN,BOS,3,6,170,1.5,-112,10.0,-105,-115,-200,-1.5,-108,3.7,Fenway Park,9,-3
2017-06-29,2017,WSH,CHC,4,5,-112,-1.5,172,9.5,-110,-110,102,1.5,-205,5.02,Nationals Park,9,-1
2017-06-29,2017,MIL,CIN,11,3,-101,1.5,-205,10.0,100,-120,-109,-1.5,172,5.02,Great American Ballpark,14,8
2017-06-29,2017,TEX,CLE,1,5,225,1.5,130,9.5,-120,100,-265,-1.5,-150,2.92,Progressive Field,6,-4
2017-06-29,2017,NYY,CWS,3,4,-169,-1.5,-110,10.0,-110,-110,154,1.5,-110,6.28,Guaranteed Rate Field,7,-1
2017-06-29,2017,KC,DET,3,7,156,1.5,-125,9.5,-121,101,-176,-1.5,106,3.71,Comerica Park,10,-4
2017-06-29,2017,OAK,HOU,1,6,181,1.5,-114,9.0,-112,-108,-211,-1.5,-106,3.2,Minute Maid Park,7,-5
2017-06-29,2017,DET,KC,7,3,-176,-1.5,106,9.5,-121,101,156,1.5,-125,6.06,Comerica Park,10,4
2017-06-29,2017,LAD,LAA,6,2,-251,-1.5,-144,7.5,104,-124,211,1.5,124,5.36,Angel Stadium,8,4
2017-06-29,2017,LAA,LAD,2,6,211,1.5,124,7.5,104,-124,-251,-1.5,-144,2.41,Angel Stadium,8,-4
2017-06-29,2017,NYM,MIA,6,3,126,1.5,-163,9.0,-110,-110,-141,-1.5,142,3.98,Marlins Park,9,3
2017-06-29,2017,CIN,MIL,3,11,-109,-1.5,172,10.0,100,-120,-101,1.5,-205,5.22,Great American Ballpark,14,-8
2017-06-29,2017,BOS,MIN,6,3,-200,-1.5,-108,10.0,-105,-115,170,1.5,-112,6.67,Fenway Park,9,3
2017-06-29,2017,MIA,NYM,3,6,-141,-1.5,142,9.0,-110,-110,126,1.5,-163,5.27,Marlins Park,9,-3
2017-06-29,2017,CWS,NYY,4,3,154,1.5,-110,10.0,-110,-110,-169,-1.5,-110,3.94,Guaranteed Rate Field,7,1
2017-06-29,2017,HOU,OAK,6,1,-211,-1.5,-106,9.0,-112,-108,181,1.5,-114,6.11,Minute Maid Park,7,5
2017-06-29,2017,TB,PIT,0,4,-107,-1.5,148,7.5,-115,-105,-103,1.5,-170,3.88,PNC Park,4,-4
2017-06-29,2017,ATL,SD,0,6,126,1.5,-185,7.5,-110,-110,-141,-1.5,160,3.32,PETCO Park,6,-6
2017-06-29,2017,ARI,STL,4,10,-134,-1.5,146,10.5,-110,-110,119,1.5,-167,6.01,Chase Field,14,-6
2017-06-29,2017,PIT,TB,4,0,-103,1.5,-170,7.5,-115,-105,-107,-1.5,148,3.81,PNC Park,4,4
2017-06-29,2017,CLE,TEX,5,1,-265,-1.5,-150,9.5,-120,100,225,1.5,130,6.9,Progressive Field,6,4
2017-06-29,2017,BAL,TOR,2,0,179,1.5,-109,10.0,-120,100,-199,-1.5,-111,3.58,Rogers Centre,2,2
2017-06-29,2017,CHC,WSH,5,4,102,1.5,-205,9.5,-110,-110,-112,-1.5,172,4.7,Nationals Park,9,1
2017-06-30,2017,COL,ARI,6,3,139,1.5,-150,9.0,-110,-110,-154,-1.5,130,3.77,Chase Field,9,3
2017-06-30,2017,OAK,ATL,1,3,-175,-1.5,122,8.0,-105,-115,155,1.5,-142,5.09,Oakland Coliseum,4,-2
2017-06-30,2017,TB,BAL,6,4,-126,-1.5,122,11.0,-106,-114,116,1.5,-142,6.13,Camden Yards,10,2
2017-06-30,2017,TOR,BOS,4,7,-119,-1.5,163,9.0,-120,100,109,1.5,-190,4.89,Rogers Centre,11,-3
2017-06-30,2017,CIN,CHC,5,0,-119,-1.5,170,9.5,100,-120,109,1.5,-200,5.16,Great American Ballpark,5,5
2017-06-30,2017,CHC,CIN,0,5,109,1.5,-200,9.5,100,-120,-119,-1.5,170,4.55,Great American Ballpark,5,-5
2017-06-30,2017,ARI,COL,3,6,-154,-1.5,130,9.0,-110,-110,139,1.5,-150,5.46,Chase Field,9,-3
2017-06-30,2017,TEX,CWS,7,8,-138,-1.5,112,10.0,-105,-115,123,1.5,-132,5.8,Guaranteed Rate Field,15,-1
2017-06-30,2017,NYY,HOU,13,4,160,1.5,-131,8.0,-110,-110,-180,-1.5,111,3.08,Minute Maid Park,17,9
2017-06-30,2017,MIN,KC,1,8,116,1.5,-190,9.0,100,-120,-131,-1.5,163,4.17,Kauffman Stadium,9,-7
2017-06-30,2017,SEA,LAA,10,0,-132,-1.5,115,9.0,100,-120,117,1.5,-135,5.12,Angel Stadium,10,10
2017-06-30,2017,SD,LAD,4,10,182,1.5,110,7.5,105,-125,-212,-1.5,-129,2.66,PETCO Park,14,-6
2017-06-30,2017,MIL,MIA,3,2,102,1.5,-165,10.0,-115,-105,-112,-1.5,144,4.95,Miller Park,5,1
2017-06-30,2017,MIA,MIL,2,3,-112,-1.5,144,10.0,-115,-105,102,1.5,-165,5.28,Miller Park,5,-1
2017-06-30,2017,KC,MIN,8,1,-131,-1.5,163,9.0,100,-120,116,1.5,-190,5.1,Kauffman Stadium,9,7
2017-06-30,2017,PHI,NYM,1,2,235,1.5,112,8.5,-110,-110,-275,-1.5,-132,2.54,Citi Field,3,-1
2017-06-30,2017,HOU,NYY,4,13,-180,-1.5,111,8.0,-110,-110,160,1.5,-131,5.14,Minute Maid Park,17,-9
2017-06-30,2017,ATL,OAK,3,1,155,1.5,-142,8.0,-105,-115,-175,-1.5,122,3.14,Oakland Coliseum,4,2
2017-06-30,2017,NYM,PHI,2,1,-275,-1.5,-132,8.5,-110,-110,235,1.5,112,6.23,Citi Field,3,1
2017-06-30,2017,SF,PIT,13,5,107,1.5,-194,8.0,-120,100,-117,-1.5,165,3.86,PNC Park,18,8
2017-06-30,2017,LAD,SD,10,4,-212,-1.5,-129,7.5,105,-125,182,1.5,110,5.1,PETCO Park,14,6
2017-06-30,2017,LAA,SEA,0,10,117,1.5,-135,9.0,100,-120,-132,-1.5,115,4.15,Angel Stadium,10,-10
2017-06-30,2017,PIT,SF,5,13,-117,-1.5,165,8.0,-120,100,107,1.5,-194,4.31,PNC Park,18,-8
2017-06-30,2017,WSH,STL,1,8,111,1.5,-200,9.0,-115,-105,-121,-1.5,170,4.27,Busch Stadium,9,-7
2017-06-30,2017,BAL,TB,4,6,116,1.5,-142,11.0,-106,-114,-126,-1.5,122,5.09,Camden Yards,10,-2
2017-06-30,2017,CWS,TEX,8,7,123,1.5,-132,10.0,-105,-115,-138,-1.5,112,4.48,Guaranteed Rate Field,15,1
2017-06-30,2017,BOS,TOR,7,4,109,1.5,-190,9.0,-120,100,-119,-1.5,163,4.31,Rogers Centre,11,3
2017-06-30,2017,STL,WSH,8,1,-121,-1.5,170,9.0,-115,-105,111,1.5,-200,4.93,Busch Stadium,9,7
2017-07-01,2017,COL,ARI,2,6,156,1.5,-135,8.5,-120,100,-176,-1.5,115,3.32,Chase Field,8,-4
2017-07-01,2017,OAK,ATL,3,4,-140,-1.5,148,9.0,-105,-115,125,1.5,-170,5.25,Oakland Coliseum,7,-1
2017-07-01,2017,TB,BAL,10,3,108,1.5,-180,11.0,100,-120,-118,-1.5,155,5.29,Camden Yards,13,7
2017-07-01,2017,TOR,BOS,1,7,143,1.5,-131,8.0,-115,-105,-158,-1.5,111,3.29,Rogers Centre,8,-6
2017-07-01,2017,CIN,CHC,5,3,111,1.5,-148,11.0,-105,-115,-121,-1.5,128,5.21,Great American Ballpark,8,2
2017-07-01,2017,CHC,CIN,3,5,-121,-1.5,128,11.0,-105,-115,111,1.5,-148,6.02,Great American Ballpark,8,-2
2017-07-01,2017,DET,CLE,7,4,112,1.5,127,11.0,-101,-119,-122,-1.5,163,5.19,Comerica Park,11,3
2017-07-01,2017,DET,CLE,1,4,161,1.5,-101,9.5,-114,-106,-181,-1.5,-119,3.64,Comerica Park,5,-3
2017-07-01,2017,ARI,COL,6,2,-176,-1.5,115,8.5,-120,100,156,1.5,-135,5.42,Chase Field,8,4
2017-07-01,2017,TEX,CWS,10,4,-122,-1.5,130,10.5,-110,-110,112,1.5,-150,5.77,Guaranteed Rate Field,14,6
2017-07-01,2017,CLE,DET,4,7,-122,-1.5,163,11.0,-101,-119,112,1.5,127,6.05,Comerica Park,11,-3
2017-07-01,2017,CLE,DET,4,1,-181,-1.5,-119,9.5,-114,-106,161,1.5,-101,6.12,Comerica Park,5,3
2017-07-01,2017,NYY,HOU,6,7,114,1.5,-180,9.5,-113,-107,-124,-1.5,155,4.44,Minute Maid Park,13,-1
2017-07-01,2017,MIN,KC,6,11,-116,-1.5,135,9.0,-125,105,106,1.5,-155,4.83,Kauffman Stadium,17,-5
2017-07-01,2017,MIN,KC,10,5,129,1.5,-155,10.0,-102,-118,-144,-1.5,135,4.37,Kauffman Stadium,15,5
2017-07-01,2017,SEA,LAA,0,4,-112,-1.5,143,8.5,-120,100,102,1.5,-163,4.49,Angel Stadium,4,-4
2017-07-01,2017,SD,LAD,0,8,175,1.5,105,8.5,-105,-115,-205,-1.5,-125,3.09,PETCO Park,8,-8
2017-07-01,2017,MIL,MIA,8,4,-126,-1.5,155,11.0,100,-120,116,1.5,-180,6.13,Miller Park,12,4
2017-07-01,2017,MIA,MIL,4,8,116,1.5,-180,11.0,100,-120,-126,-1.5,155,5.09,Miller Park,12,-4
2017-07-01,2017,KC,MIN,11,6,106,1.5,-155,9.0,-125,105,-116,-1.5,135,4.37,Kauffman Stadium,17,5
2017-07-01,2017,KC,MIN,5,10,-144,-1.5,135,10.0,-102,-118,129,1.5,-155,5.9,Kauffman Stadium,15,-5
2017-07-01,2017,PHI,NYM,6,7,162,1.5,-130,9.5,-105,-115,-182,-1.5,110,3.63,Citi Field,13,-1
2017-07-01,2017,HOU,NYY,7,6,-124,-1.5,155,9.5,-113,-107,114,1.5,-180,5.26,Minute Maid Park,13,1
2017-07-01,2017,ATL,OAK,4,3,125,1.5,-170,9.0,-105,-115,-140,-1.5,148,4.0,Oakland Coliseum,7,1
2017-07-01,2017,NYM,PHI,7,6,-182,-1.5,110,9.5,-105,-115,162,1.5,-130,6.13,Citi Field,13,1
2017-07-01,2017,SF,PIT,2,1,107,1.5,-190,9.5,-110,-110,-117,-1.5,163,4.59,PNC Park,3,1
2017-07-01,2017,LAD,SD,8,0,-205,-1.5,-125,8.5,-105,-115,175,1.5,105,5.71,PETCO Park,8,8
2017-07-01,2017,LAA,SEA,4,0,102,1.5,-163,8.5,-120,100,-112,-1.5,143,4.21,Angel Stadium,4,4
2017-07-01,2017,PIT,SF,1,2,-117,-1.5,163,9.5,-110,-110,107,1.5,-190,5.12,PNC Park,3,-1
2017-07-01,2017,WSH,STL,1,2,-108,-1.5,143,9.0,-115,-105,-102,1.5,-163,4.67,Busch Stadium,3,-1
2017-07-01,2017,BAL,TB,3,10,-118,-1.5,155,11.0,100,-120,108,1.5,-180,5.95,Camden Yards,13,-7
2017-07-01,2017,CWS,TEX,4,10,112,1.5,-150,10.5,-110,-110,-122,-1.5,130,4.95,Guaranteed Rate Field,14,-6
2017-07-01,2017,BOS,TOR,7,1,-158,-1.5,111,8.0,-115,-105,143,1.5,-131,4.9,Rogers Centre,8,6
2017-07-01,2017,STL,WSH,2,1,-102,1.5,-163,9.0,-115,-105,-108,-1.5,143,4.54,Busch Stadium,3,1
2017-07-02,2017,COL,ARI,3,4,106,1.5,-195,9.5,-105,-115,-116,-1.5,166,4.61,Chase Field,7,-1
2017-07-02,2017,OAK,ATL,3,4,-185,-1.5,103,8.5,-120,100,165,1.5,-123,5.52,Oakland Coliseum,7,-1
2017-07-02,2017,TB,BAL,1,7,117,1.5,-154,11.0,-105,-115,-132,-1.5,135,5.07,Camden Yards,8,-6
2017-07-02,2017,TOR,BOS,1,15,-122,-1.5,163,9.0,105,-125,112,1.5,-190,4.95,Rogers Centre,16,-14
2017-07-02,2017,CIN,CHC,2,6,141,1.5,-115,10.0,-122,102,-156,-1.5,-105,4.15,Great American Ballpark,8,-4
2017-07-02,2017,CHC,CIN,6,2,-156,-1.5,-105,10.0,-122,102,141,1.5,-115,6.09,Great American Ballpark,8,4
2017-07-02,2017,DET,CLE,8,11,119,1.5,-147,9.5,-102,-118,-129,-1.5,127,4.34,Comerica Park,19,-3
2017-07-02,2017,ARI,COL,4,3,-116,-1.5,166,9.5,-105,-115,106,1.5,-195,5.1,Chase Field,7,1
2017-07-02,2017,TEX,CWS,5,6,108,1.5,-200,9.5,-110,-110,-118,-1.5,170,4.57,Guaranteed Rate Field,11,-1
2017-07-02,2017,CLE,DET,11,8,-129,-1.5,127,9.5,-102,-118,119,1.5,-147,5.35,Comerica Park,19,3
2017-07-02,2017,NYY,HOU,1,8,-111,-1.5,148,8.5,-115,-105,101,1.5,-170,4.47,Minute Maid Park,9,-7
2017-07-02,2017,MIN,KC,2,6,114,1.5,-170,10.5,-110,-110,-124,-1.5,148,4.91,Kauffman Stadium,8,-4
2017-07-02,2017,SEA,LAA,5,3,-165,-1.5,-110,8.5,-110,-110,150,1.5,-110,5.29,Angel Stadium,8,2
2017-07-02,2017,SD,LAD,5,3,200,1.5,113,8.0,100,-120,-230,-1.5,-133,2.67,PETCO Park,8,2
2017-07-02,2017,MIL,MIA,3,10,128,1.5,-124,10.5,-110,-110,-143,-1.5,104,4.61,Miller Park,13,-7
2017-07-02,2017,MIA,MIL,10,3,-143,-1.5,104,10.5,-110,-110,128,1.5,-124,6.18,Miller Park,13,7
2017-07-02,2017,KC,MIN,6,2,-124,-1.5,148,10.5,-110,-110,114,1.5,-170,5.81,Kauffman Stadium,8,4
2017-07-02,2017,PHI,NYM,7,1,130,1.5,-160,9.5,-102,-118,-145,-1.5,140,4.13,Citi Field,8,6
2017-07-02,2017,HOU,NYY,8,1,101,1.5,-170,8.5,-115,-105,-111,-1.5,148,4.23,Minute Maid Park,9,7
2017-07-02,2017,ATL,OAK,4,3,165,1.5,-123,8.5,-120,100,-185,-1.5,103,3.21,Oakland Coliseum,7,1
2017-07-02,2017,NYM,PHI,1,7,-145,-1.5,140,9.5,-102,-118,130,1.5,-160,5.62,Citi Field,8,-6
2017-07-02,2017,SF,PIT,5,3,-164,-1.5,-110,8.5,-105,-115,149,1.5,-110,5.28,PNC Park,8,2
2017-07-02,2017,LAD,SD,3,5,-230,-1.5,-133,8.0,100,-120,200,1.5,113,5.58,PETCO Park,8,-2
2017-07-02,2017,LAA,SEA,3,5,150,1.5,-110,8.5,-110,-110,-165,-1.5,-110,3.4,Angel Stadium,8,-2
2017-07-02,2017,PIT,SF,3,5,149,1.5,-110,8.5,-105,-115,-164,-1.5,-110,3.41,PNC Park,8,-2
2017-07-02,2017,WSH,STL,7,2,-158,-1.5,111,7.0,-115,-105,143,1.5,-131,4.29,Busch Stadium,9,5
2017-07-02,2017,BAL,TB,7,1,-132,-1.5,135,11.0,-105,-115,117,1.5,-154,6.26,Camden Yards,8,6
2017-07-02,2017,CWS,TEX,6,5,-118,-1.5,170,9.5,-110,-110,108,1.5,-200,5.14,Guaranteed Rate Field,11,1
2017-07-02,2017,BOS,TOR,15,1,112,1.5,-190,9.0,105,-125,-122,-1.5,163,4.25,Rogers Centre,16,14
2017-07-02,2017,STL,WSH,2,7,143,1.5,-131,7.0,-115,-105,-158,-1.5,111,2.88,Busch Stadium,9,-5
2017-07-03,2017,MIL,BAL,8,1,-124,-1.5,148,10.5,-105,-115,114,1.5,-170,5.81,Miller Park,9,7
2017-07-03,2017,TEX,BOS,5,7,106,1.5,-150,11.0,100,-120,-116,-1.5,130,5.34,Rangers Ballpark,12,-2
2017-07-03,2017,COL,CIN,5,3,-157,-1.5,110,12.5,100,-120,142,1.5,-129,7.64,Coors Field,8,2
2017-07-03,2017,CIN,COL,3,5,142,1.5,-129,12.5,100,-120,-157,-1.5,110,5.17,Coors Field,8,-2
2017-07-03,2017,OAK,CWS,2,7,-145,-1.5,151,8.0,-115,-105,130,1.5,-175,4.73,Oakland Coliseum,9,-5
2017-07-03,2017,SEA,KC,1,3,-147,-1.5,140,8.5,-115,-105,132,1.5,-160,5.06,T-Mobile Park,4,-2
2017-07-03,2017,MIN,LAA,9,5,-117,-1.5,172,9.0,-110,-110,107,1.5,-205,4.85,Target Field,14,4
2017-07-03,2017,STL,MIA,14,6,-151,-1.5,130,10.0,-105,-115,136,1.5,-150,6.02,Busch Stadium,20,8
2017-07-03,2017,BAL,MIL,1,8,114,1.5,-170,10.5,-105,-115,-124,-1.5,148,4.91,Miller Park,9,-7
2017-07-03,2017,LAA,MIN,5,9,107,1.5,-205,9.0,-110,-110,-117,-1.5,172,4.35,Target Field,14,-4
2017-07-03,2017,WSH,NYM,3,2,-185,-1.5,113,8.5,-101,-119,165,1.5,-133,5.52,Nationals Park,5,1
2017-07-03,2017,TOR,NYY,3,6,127,1.5,-165,9.0,-104,-116,-142,-1.5,144,3.96,Yankee Stadium,9,-3
2017-07-03,2017,CWS,OAK,7,2,130,1.5,-175,8.0,-115,-105,-145,-1.5,151,3.48,Oakland Coliseum,9,5
2017-07-03,2017,PIT,PHI,0,4,114,1.5,-187,8.0,-115,-105,-124,-1.5,160,3.74,Citizens Bank Park,4,-4
2017-07-03,2017,PHI,PIT,4,0,-124,-1.5,160,8.0,-115,-105,114,1.5,-187,4.43,Citizens Bank Park,4,4
2017-07-03,2017,KC,SEA,3,1,132,1.5,-160,8.5,-115,-105,-147,-1.5,140,3.66,T-Mobile Park,4,2
2017-07-03,2017,MIA,STL,6,14,136,1.5,-150,10.0,-105,-115,-151,-1.5,130,4.24,Busch Stadium,20,-8
2017-07-03,2017,BOS,TEX,7,5,-116,-1.5,130,11.0,100,-120,106,1.5,-150,5.91,Rangers Ballpark,12,2
2017-07-03,2017,NYY,TOR,6,3,-142,-1.5,144,9.0,-104,-116,127,1.5,-165,5.28,Yankee Stadium,9,3
2017-07-03,2017,NYM,WSH,2,3,165,1.5,-133,8.5,-101,-119,-185,-1.5,113,3.21,Nationals Park,5,-1
2017-07-04,2017,LAD,ARI,4,3,-320,-1.5,-130,7.5,100,-120,270,1.5,114,5.71,Dodger Stadium,7,1
2017-07-04,2017,HOU,ATL,16,4,-136,-1.5,120,9.0,-120,100,121,1.5,-140,5.19,Suntrust Park,20,12
2017-07-04,2017,MIL,BAL,6,2,-178,-1.5,105,9.5,-105,-115,158,1.5,-125,6.08,Miller Park,8,4
2017-07-04,2017,TEX,BOS,4,11,-109,-1.5,176,9.0,100,-120,-101,1.5,-210,4.69,Rangers Ballpark,15,-7
2017-07-04,2017,TB,CHC,6,5,127,1.5,-180,7.0,-125,105,-142,-1.5,155,3.08,Wrigley Field,11,1
2017-07-04,2017,COL,CIN,1,8,-138,-1.5,115,12.0,-105,-115,123,1.5,-135,6.96,Coors Field,9,-7
2017-07-04,2017,SD,CLE,1,0,285,1.5,126,8.0,-119,-101,-335,-1.5,-145,2.08,Progressive Field,1,1
2017-07-04,2017,CIN,COL,8,1,123,1.5,-135,12.0,-105,-115,-138,-1.5,115,5.38,Coors Field,9,7
2017-07-04,2017,OAK,CWS,7,6,-150,-1.5,130,9.5,-105,-115,135,1.5,-150,5.7,Oakland Coliseum,13,1
2017-07-04,2017,SF,DET,3,5,180,1.5,-101,10.5,-115,-105,-210,-1.5,-119,3.75,Comerica Park,8,-2
2017-07-04,2017,ATL,HOU,4,16,121,1.5,-140,9.0,-120,100,-136,-1.5,120,4.07,Suntrust Park,20,-12
2017-07-04,2017,SEA,KC,3,7,-131,-1.5,160,9.5,100,-120,116,1.5,-185,5.39,T-Mobile Park,10,-4
2017-07-04,2017,MIN,LAA,5,4,-116,-1.5,160,9.5,-125,105,106,1.5,-185,5.1,Target Field,9,1
2017-07-04,2017,ARI,LAD,3,4,270,1.5,114,7.5,100,-120,-320,-1.5,-130,2.03,Dodger Stadium,7,-1
2017-07-04,2017,STL,MIA,2,5,-137,-1.5,151,9.5,-105,-115,122,1.5,-175,5.49,Busch Stadium,7,-3
2017-07-04,2017,BAL,MIL,2,6,158,1.5,-125,9.5,-105,-115,-178,-1.5,105,3.68,Miller Park,8,-4
2017-07-04,2017,LAA,MIN,4,5,106,1.5,-185,9.5,-125,105,-116,-1.5,160,4.61,Target Field,9,-1
2017-07-04,2017,WSH,NYM,11,4,-170,-1.5,120,10.0,-109,-111,150,1.5,-140,6.3,Nationals Park,15,7
2017-07-04,2017,TOR,NYY,4,1,-115,-1.5,140,10.5,-102,-118,105,1.5,-160,5.62,Yankee Stadium,5,3
2017-07-04,2017,CWS,OAK,6,7,135,1.5,-150,9.5,-105,-115,-150,-1.5,130,4.04,Oakland Coliseum,13,-1
2017-07-04,2017,PIT,PHI,3,0,-147,-1.5,110,8.5,-115,-105,132,1.5,-130,5.06,Citizens Bank Park,3,3
2017-07-04,2017,PHI,PIT,0,3,132,1.5,-130,8.5,-115,-105,-147,-1.5,110,3.66,Citizens Bank Park,3,-3
2017-07-04,2017,CLE,SD,0,1,-335,-1.5,-145,8.0,-119,-101,285,1.5,126,6.16,Progressive Field,1,-1
2017-07-04,2017,KC,SEA,7,3,116,1.5,-185,9.5,100,-120,-131,-1.5,160,4.4,T-Mobile Park,10,4
2017-07-04,2017,DET,SF,5,3,-210,-1.5,-119,10.5,-115,-105,180,1.5,-101,7.11,Comerica Park,8,2
2017-07-04,2017,MIA,STL,5,2,122,1.5,-175,9.5,-105,-115,-137,-1.5,151,4.28,Busch Stadium,7,3
2017-07-04,2017,CHC,TB,5,6,-142,-1.5,155,7.0,-125,105,127,1.5,-180,4.11,Wrigley Field,11,-1
2017-07-04,2017,BOS,TEX,11,4,-101,1.5,-210,9.0,100,-120,-109,-1.5,176,4.52,Rangers Ballpark,15,7
2017-07-04,2017,NYY,TOR,1,4,105,1.5,-160,10.5,-102,-118,-115,-1.5,140,5.12,Yankee Stadium,5,-3
2017-07-04,2017,NYM,WSH,4,11,150,1.5,-140,10.0,-109,-111,-170,-1.5,120,4.0,Nationals Park,15,-7
2017-07-05,2017,LAD,ARI,1,0,-257,-1.5,-115,7.5,-110,-110,217,1.5,-105,5.4,Dodger Stadium,1,1
2017-07-05,2017,HOU,ATL,10,4,-107,-1.5,147,10.0,100,-120,-103,1.5,-169,5.17,Suntrust Park,14,6
2017-07-05,2017,MIL,BAL,4,0,-136,-1.5,135,10.5,-115,-105,121,1.5,-155,6.05,Miller Park,4,4
2017-07-05,2017,TEX,BOS,8,2,105,1.5,-150,10.5,-120,100,-115,-1.5,130,5.12,Rangers Ballpark,10,6
2017-07-05,2017,TB,CHC,3,7,158,1.5,-125,9.5,-118,-102,-178,-1.5,105,3.68,Wrigley Field,10,-4
2017-07-05,2017,COL,CIN,5,3,-145,-1.5,135,11.0,-120,100,130,1.5,-155,6.51,Coors Field,8,2
2017-07-05,2017,SD,CLE,6,2,209,1.5,104,9.0,105,-125,-249,-1.5,-124,2.91,Progressive Field,8,4
2017-07-05,2017,CIN,COL,3,5,130,1.5,-155,11.0,-120,100,-145,-1.5,135,4.78,Coors Field,8,-2
2017-07-05,2017,OAK,CWS,7,4,-190,-1.5,-102,8.5,-110,-110,170,1.5,-118,5.57,Oakland Coliseum,11,3
2017-07-05,2017,SF,DET,5,4,170,1.5,-110,11.0,-110,-110,-200,-1.5,-110,4.07,Comerica Park,9,1
2017-07-05,2017,ATL,HOU,4,10,-103,1.5,-169,10.0,100,-120,-107,-1.5,147,5.07,Suntrust Park,14,-6
2017-07-05,2017,SEA,KC,6,9,-135,-1.5,148,9.0,-120,100,120,1.5,-170,5.17,T-Mobile Park,15,-3
2017-07-05,2017,MIN,LAA,1,2,-163,-1.5,118,10.0,-115,-105,148,1.5,-138,6.2,Target Field,3,-1
2017-07-05,2017,ARI,LAD,0,1,217,1.5,-105,7.5,-110,-110,-257,-1.5,-115,2.37,Dodger Stadium,1,-1
2017-07-05,2017,STL,MIA,6,9,-135,-1.5,155,9.0,-101,-119,120,1.5,-180,5.17,Busch Stadium,15,-3
2017-07-05,2017,BAL,MIL,0,4,121,1.5,-155,10.5,-115,-105,-136,-1.5,135,4.75,Miller Park,4,-4
2017-07-05,2017,LAA,MIN,2,1,148,1.5,-138,10.0,-115,-105,-163,-1.5,118,4.03,Target Field,3,1
2017-07-05,2017,TOR,NYY,7,6,163,1.5,-129,9.0,-110,-110,-183,-1.5,107,3.42,Yankee Stadium,13,1
2017-07-05,2017,CWS,OAK,4,7,170,1.5,-118,8.5,-110,-110,-190,-1.5,-102,3.15,Oakland Coliseum,11,-3
2017-07-05,2017,PIT,PHI,5,2,-162,-1.5,100,9.0,-105,-115,147,1.5,-120,5.56,Citizens Bank Park,7,3
2017-07-05,2017,PHI,PIT,2,5,147,1.5,-120,9.0,-105,-115,-162,-1.5,100,3.64,Citizens Bank Park,7,-3
2017-07-05,2017,CLE,SD,2,6,-249,-1.5,-124,9.0,105,-125,209,1.5,104,6.42,Progressive Field,8,-4
2017-07-05,2017,KC,SEA,9,6,120,1.5,-170,9.0,-120,100,-135,-1.5,148,4.09,T-Mobile Park,15,3
2017-07-05,2017,DET,SF,4,5,-200,-1.5,-110,11.0,-110,-110,170,1.5,-110,7.33,Comerica Park,9,-1
2017-07-05,2017,MIA,STL,9,6,120,1.5,-180,9.0,-101,-119,-135,-1.5,155,4.09,Busch Stadium,15,3
2017-07-05,2017,CHC,TB,7,3,-178,-1.5,105,9.5,-118,-102,158,1.5,-125,6.08,Wrigley Field,10,4
2017-07-05,2017,BOS,TEX,2,8,-115,-1.5,130,10.5,-120,100,105,1.5,-150,5.62,Rangers Ballpark,10,-6
2017-07-05,2017,NYY,TOR,6,7,-183,-1.5,107,9.0,-110,-110,163,1.5,-129,5.82,Yankee Stadium,13,-1
2017-07-06,2017,LAD,ARI,5,4,-140,-1.5,160,8.0,-112,-108,125,1.5,-185,4.67,Dodger Stadium,9,1
2017-07-06,2017,WSH,ATL,2,5,-178,-1.5,108,9.0,100,-120,158,1.5,-128,5.76,Nationals Park,7,-3
2017-07-06,2017,MIN,BAL,6,4,-147,-1.5,130,9.5,-119,-101,132,1.5,-150,5.65,Target Field,10,2
2017-07-06,2017,TB,BOS,4,1,171,1.5,107,7.0,-105,-115,-201,-1.5,-127,2.58,Tropicana Field,5,3
2017-07-06,2017,MIL,CHC,11,2,150,1.5,-130,10.0,-105,-115,-170,-1.5,110,4.0,Wrigley Field,13,9
2017-07-06,2017,COL,CIN,3,6,-158,-1.5,110,13.0,-105,-115,143,1.5,-130,7.96,Coors Field,9,-3
2017-07-06,2017,SD,CLE,2,11,179,1.5,-110,9.5,100,-120,-199,-1.5,-110,3.41,Progressive Field,13,-9
2017-07-06,2017,CIN,COL,6,3,143,1.5,-130,13.0,-105,-115,-158,-1.5,110,5.35,Coors Field,9,3
2017-07-06,2017,SF,DET,2,6,129,1.5,-145,10.5,-120,100,-144,-1.5,125,4.59,Comerica Park,8,-4
2017-07-06,2017,TOR,HOU,7,4,134,1.5,-127,9.0,-120,100,-149,-1.5,107,3.85,Rogers Centre,11,3
2017-07-06,2017,ARI,LAD,4,5,125,1.5,-185,8.0,-112,-108,-140,-1.5,160,3.56,Dodger Stadium,9,-1
2017-07-06,2017,STL,MIA,4,3,-190,-1.5,105,9.5,-104,-116,170,1.5,-125,6.22,Busch Stadium,7,1
2017-07-06,2017,CHC,MIL,2,11,-170,-1.5,110,10.0,-105,-115,150,1.5,-130,6.3,Wrigley Field,13,-9
2017-07-06,2017,BAL,MIN,4,6,132,1.5,-150,9.5,-119,-101,-147,-1.5,130,4.09,Target Field,10,-2
2017-07-06,2017,SEA,OAK,4,7,-140,-1.5,148,10.0,-112,-108,125,1.5,-170,5.83,T-Mobile Park,11,-3
2017-07-06,2017,PIT,PHI,6,3,-109,-1.5,144,9.0,-110,-110,-101,1.5,-165,4.69,Citizens Bank Park,9,3
2017-07-06,2017,PHI,PIT,3,6,-101,1.5,-165,9.0,-110,-110,-109,-1.5,144,4.52,Citizens Bank Park,9,-3
2017-07-06,2017,CLE,SD,11,2,-199,-1.5,-110,9.5,100,-120,179,1.5,-110,6.32,Progressive Field,13,9
2017-07-06,2017,OAK,SEA,7,4,125,1.5,-170,10.0,-112,-108,-140,-1.5,148,4.44,T-Mobile Park,11,3
2017-07-06,2017,DET,SF,6,2,-144,-1.5,125,10.5,-120,100,129,1.5,-145,6.2,Comerica Park,8,4
2017-07-06,2017,MIA,STL,3,4,170,1.5,-125,9.5,-104,-116,-190,-1.5,105,3.52,Busch Stadium,7,-1
2017-07-06,2017,BOS,TB,1,4,-201,-1.5,-127,7.0,-105,-115,171,1.5,107,4.67,Tropicana Field,5,-3
2017-07-06,2017,HOU,TOR,4,7,-149,-1.5,107,9.0,-120,100,134,1.5,-127,5.39,Rogers Centre,11,-3
2017-07-06,2017,ATL,WSH,5,2,158,1.5,-128,9.0,100,-120,-178,-1.5,108,3.49,Nationals Park,7,3
2017-07-07,2017,CIN,ARI,3,6,179,1.5,-108,9.0,-125,105,-209,-1.5,-112,3.23,Chase Field,9,-3
2017-07-07,2017,WSH,ATL,5,4,-249,-1.5,-135,8.0,-120,100,209,1.5,115,5.71,Nationals Park,9,1
2017-07-07,2017,MIN,BAL,9,6,111,1.5,-155,10.0,-110,-110,-121,-1.5,135,4.74,Target Field,15,3
2017-07-07,2017,TB,BOS,3,8,118,1.5,-135,8.5,100,-120,-133,-1.5,115,3.9,Tropicana Field,11,-5
2017-07-07,2017,PIT,CHC,1,6,134,1.5,-160,9.0,-105,-115,-149,-1.5,140,3.85,Wrigley Field,7,-5
2017-07-07,2017,ARI,CIN,6,3,-209,-1.5,-112,9.0,-125,105,179,1.5,-108,6.09,Chase Field,9,3
2017-07-07,2017,DET,CLE,2,11,200,1.5,-101,9.5,-105,-115,-240,-1.5,-119,3.17,Progressive Field,13,-9
2017-07-07,2017,CWS,COL,4,12,160,1.5,-115,11.0,-105,-115,-180,-1.5,-105,4.23,Coors Field,16,-8
2017-07-07,2017,COL,CWS,12,4,-180,-1.5,-105,11.0,-105,-115,160,1.5,-115,7.07,Coors Field,16,8
2017-07-07,2017,CLE,DET,11,2,-240,-1.5,-119,9.5,-105,-115,200,1.5,-101,6.71,Progressive Field,13,9
2017-07-07,2017,TOR,HOU,2,12,-111,-1.5,176,10.0,100,-120,101,1.5,-210,5.26,Rogers Centre,14,-10
2017-07-07,2017,LAD,KC,4,1,-200,-1.5,110,8.5,-105,-115,170,1.5,-130,5.67,Dodger Stadium,5,3
2017-07-07,2017,TEX,LAA,10,0,-142,-1.5,135,10.0,-101,-119,127,1.5,-155,5.87,Rangers Ballpark,10,10
2017-07-07,2017,KC,LAD,1,4,170,1.5,-130,8.5,-105,-115,-200,-1.5,110,3.15,Dodger Stadium,5,-3
2017-07-07,2017,SF,MIA,1,6,101,1.5,-165,8.5,100,-120,-111,-1.5,144,4.23,AT&T Park,7,-5
2017-07-07,2017,NYY,MIL,4,9,-230,-1.5,-129,10.5,-125,105,200,1.5,109,7.32,Yankee Stadium,13,-5
2017-07-07,2017,BAL,MIN,6,9,-121,-1.5,135,10.0,-110,-110,111,1.5,-155,5.48,Target Field,15,-3
2017-07-07,2017,STL,NYM,5,6,-109,-1.5,184,8.0,-115,-105,-101,1.5,-220,4.17,Busch Stadium,11,-1
2017-07-07,2017,MIL,NYY,9,4,200,1.5,109,10.5,-125,105,-230,-1.5,-129,3.5,Yankee Stadium,13,5
2017-07-07,2017,SEA,OAK,7,2,-171,-1.5,120,8.5,-105,-115,151,1.5,-140,5.36,T-Mobile Park,9,5
2017-07-07,2017,SD,PHI,4,3,104,1.5,-200,9.0,-110,-110,-114,-1.5,170,4.41,Citizens Bank Park,7,1
2017-07-07,2017,CHC,PIT,6,1,-149,-1.5,140,9.0,-105,-115,134,1.5,-160,5.39,Wrigley Field,7,5
2017-07-07,2017,PHI,SD,3,4,-114,-1.5,170,9.0,-110,-110,104,1.5,-200,4.79,Citizens Bank Park,7,-1
2017-07-07,2017,OAK,SEA,2,7,151,1.5,-140,8.5,-105,-115,-171,-1.5,120,3.39,T-Mobile Park,9,-5
2017-07-07,2017,MIA,SF,6,1,-111,-1.5,144,8.5,100,-120,101,1.5,-165,4.47,AT&T Park,7,5
2017-07-07,2017,NYM,STL,6,5,-101,1.5,-220,8.0,-115,-105,-109,-1.5,184,4.02,Busch Stadium,11,1
2017-07-07,2017,BOS,TB,8,3,-133,-1.5,115,8.5,100,-120,118,1.5,-135,4.85,Tropicana Field,11,5
2017-07-07,2017,LAA,TEX,0,10,127,1.5,-155,10.0,-101,-119,-142,-1.5,135,4.41,Rangers Ballpark,10,-10
2017-07-07,2017,HOU,TOR,12,2,101,1.5,-210,10.0,100,-120,-111,-1.5,176,4.98,Rogers Centre,14,10
2017-07-07,2017,ATL,WSH,4,5,209,1.5,115,8.0,-120,100,-249,-1.5,-135,2.59,Nationals Park,9,-1
2017-07-08,2017,CIN,ARI,7,0,105,1.5,-190,9.5,-109,-111,-115,-1.5,163,4.63,Chase Field,7,7
2017-07-08,2017,WSH,ATL,0,13,-242,-1.5,-130,9.0,100,-120,202,1.5,110,6.37,Nationals Park,13,-13
2017-07-08,2017,MIN,BAL,1,5,-106,-1.5,166,11.0,-109,-111,-104,1.5,-195,5.66,Target Field,6,-4
2017-07-08,2017,TB,BOS,1,0,108,1.5,-160,9.0,100,-120,-118,-1.5,140,4.33,Tropicana Field,1,1
2017-07-08,2017,PIT,CHC,4,2,178,1.5,-117,8.5,-110,-110,-198,-1.5,-103,3.06,Wrigley Field,6,2
2017-07-08,2017,ARI,CIN,0,7,-115,-1.5,163,9.5,-109,-111,105,1.5,-190,5.08,Chase Field,7,-7
2017-07-08,2017,DET,CLE,0,4,134,1.5,-155,9.5,100,-120,-149,-1.5,135,4.06,Progressive Field,4,-4
2017-07-08,2017,CWS,COL,5,4,125,1.5,-155,10.5,-105,-115,-140,-1.5,135,4.67,Coors Field,9,1
2017-07-08,2017,COL,CWS,4,5,-140,-1.5,135,10.5,-105,-115,125,1.5,-155,6.13,Coors Field,9,-1
2017-07-08,2017,CLE,DET,4,0,-149,-1.5,135,9.5,100,-120,134,1.5,-155,5.68,Progressive Field,4,4
2017-07-08,2017,TOR,HOU,7,2,-147,-1.5,131,9.0,-125,105,132,1.5,-150,5.36,Rogers Centre,9,5
2017-07-08,2017,LAD,KC,5,4,-175,-1.5,110,9.0,-105,-115,155,1.5,-130,5.73,Dodger Stadium,9,1
2017-07-08,2017,TEX,LAA,5,2,-150,-1.5,130,10.5,-102,-118,135,1.5,-150,6.3,Rangers Ballpark,7,3
2017-07-08,2017,KC,LAD,4,5,155,1.5,-130,9.0,-105,-115,-175,-1.5,110,3.53,Dodger Stadium,9,-1
2017-07-08,2017,SF,MIA,4,5,-157,-1.5,130,8.0,-115,-105,142,1.5,-150,4.89,AT&T Park,9,-1
2017-07-08,2017,NYY,MIL,5,3,-195,-1.5,-101,10.0,-105,-115,175,1.5,-119,6.61,Yankee Stadium,8,2
2017-07-08,2017,BAL,MIN,5,1,-104,1.5,-195,11.0,-109,-111,-106,-1.5,166,5.61,Target Field,6,4
2017-07-08,2017,STL,NYM,4,1,-124,-1.5,163,9.5,-115,-105,114,1.5,-190,5.26,Busch Stadium,5,3
2017-07-08,2017,MIL,NYY,3,5,175,1.5,-119,10.0,-105,-115,-195,-1.5,-101,3.64,Yankee Stadium,8,-2
2017-07-08,2017,SEA,OAK,3,4,-171,-1.5,117,9.5,-105,-115,151,1.5,-137,5.99,T-Mobile Park,7,-1
2017-07-08,2017,SD,PHI,2,1,143,1.5,-160,8.0,-120,100,-158,-1.5,140,3.29,Citizens Bank Park,3,1
2017-07-08,2017,CHC,PIT,2,4,-198,-1.5,-103,8.5,-110,-110,178,1.5,-117,5.65,Wrigley Field,6,-2
2017-07-08,2017,PHI,SD,1,2,-158,-1.5,140,8.0,-120,100,143,1.5,-160,4.9,Citizens Bank Park,3,-1
2017-07-08,2017,OAK,SEA,4,3,151,1.5,-137,9.5,-105,-115,-171,-1.5,117,3.78,T-Mobile Park,7,1
2017-07-08,2017,MIA,SF,5,4,142,1.5,-150,8.0,-115,-105,-157,-1.5,130,3.31,AT&T Park,9,1
2017-07-08,2017,NYM,STL,1,4,114,1.5,-190,9.5,-115,-105,-124,-1.5,163,4.44,Busch Stadium,5,-3
2017-07-08,2017,BOS,TB,0,1,-118,-1.5,140,9.0,100,-120,108,1.5,-160,4.87,Tropicana Field,1,-1
2017-07-08,2017,LAA,TEX,2,5,135,1.5,-150,10.5,-102,-118,-150,-1.5,130,4.47,Rangers Ballpark,7,-3
2017-07-08,2017,HOU,TOR,2,7,132,1.5,-150,9.0,-125,105,-147,-1.5,131,3.88,Rogers Centre,9,-5
2017-07-08,2017,ATL,WSH,13,0,202,1.5,110,9.0,100,-120,-242,-1.5,-130,2.98,Nationals Park,13,13
2017-07-09,2017,CIN,ARI,2,1,140,1.5,-145,10.0,105,-125,-155,-1.5,125,4.17,Chase Field,3,1
2017-07-09,2017,WSH,ATL,10,5,-137,-1.5,151,9.5,-105,-115,122,1.5,-175,5.49,Nationals Park,15,5
2017-07-09,2017,MIN,BAL,5,11,-119,-1.5,155,10.5,-125,105,109,1.5,-180,5.71,Target Field,16,-6
2017-07-09,2017,TB,BOS,5,3,-105,1.5,-160,7.5,-103,-117,-105,-1.5,140,3.84,Tropicana Field,8,2
2017-07-09,2017,PIT,CHC,14,3,183,1.5,-110,9.5,-106,-114,-213,-1.5,-110,3.36,Wrigley Field,17,11
2017-07-09,2017,ARI,CIN,1,2,-155,-1.5,125,10.0,105,-125,140,1.5,-145,6.08,Chase Field,3,-1
2017-07-09,2017,DET,CLE,5,3,193,1.5,-101,8.0,-115,-105,-223,-1.5,-119,2.73,Progressive Field,8,2
2017-07-09,2017,CWS,COL,0,10,103,1.5,-184,12.5,100,-120,-113,-1.5,159,6.16,Coors Field,10,-10
2017-07-09,2017,COL,CWS,10,0,-113,-1.5,159,12.5,100,-120,103,1.5,-184,6.63,Coors Field,10,10
2017-07-09,2017,CLE,DET,3,5,-223,-1.5,-119,8.0,-115,-105,193,1.5,-101,5.52,Progressive Field,8,-2
2017-07-09,2017,TOR,HOU,1,19,106,1.5,-155,9.5,-107,-113,-116,-1.5,135,4.61,Rogers Centre,20,-18
2017-07-09,2017,LAD,KC,5,2,-305,-1.5,-135,7.5,-115,-105,255,1.5,115,5.65,Dodger Stadium,7,3
2017-07-09,2017,TEX,LAA,0,3,-215,-1.5,-110,9.0,-125,105,185,1.5,-110,6.14,Rangers Ballpark,3,-3
2017-07-09,2017,KC,LAD,2,5,255,1.5,115,7.5,-115,-105,-305,-1.5,-135,2.11,Dodger Stadium,7,-3
2017-07-09,2017,SF,MIA,8,10,-115,-1.5,163,8.5,-110,-110,105,1.5,-194,4.55,AT&T Park,18,-2
2017-07-09,2017,NYY,MIL,3,5,-162,-1.5,130,9.0,-124,104,147,1.5,-150,5.56,Yankee Stadium,8,-2
2017-07-09,2017,BAL,MIN,11,5,109,1.5,-180,10.5,-125,105,-119,-1.5,155,5.02,Target Field,16,6
2017-07-09,2017,STL,NYM,6,0,-129,-1.5,155,9.0,-125,105,119,1.5,-180,5.07,Busch Stadium,6,6
2017-07-09,2017,MIL,NYY,5,3,147,1.5,-150,9.0,-124,104,-162,-1.5,130,3.64,Yankee Stadium,8,2
2017-07-09,2017,SEA,OAK,4,0,-168,-1.5,110,10.0,-116,-104,153,1.5,-129,6.27,T-Mobile Park,4,4
2017-07-09,2017,SD,PHI,1,7,-114,-1.5,144,8.0,-120,100,104,1.5,-165,4.26,Citizens Bank Park,8,-6
2017-07-09,2017,CHC,PIT,3,14,-213,-1.5,-110,9.5,-106,-114,183,1.5,-110,6.46,Wrigley Field,17,-11
2017-07-09,2017,PHI,SD,7,1,104,1.5,-165,8.0,-120,100,-114,-1.5,144,3.92,Citizens Bank Park,8,6
2017-07-09,2017,OAK,SEA,0,4,153,1.5,-129,10.0,-116,-104,-168,-1.5,110,3.95,T-Mobile Park,4,-4
2017-07-09,2017,MIA,SF,10,8,105,1.5,-194,8.5,-110,-110,-115,-1.5,163,4.15,AT&T Park,18,2
2017-07-09,2017,NYM,STL,0,6,119,1.5,-180,9.0,-125,105,-129,-1.5,155,4.11,Busch Stadium,6,-6
2017-07-09,2017,BOS,TB,3,5,-105,-1.5,140,7.5,-103,-117,-105,1.5,-160,3.84,Tropicana Field,8,-2
2017-07-09,2017,LAA,TEX,3,0,185,1.5,-110,9.0,-125,105,-215,-1.5,-110,3.16,Rangers Ballpark,3,3
2017-07-09,2017,HOU,TOR,19,1,-116,-1.5,135,9.5,-107,-113,106,1.5,-155,5.1,Rogers Centre,20,18
2017-07-09,2017,ATL,WSH,5,10,122,1.5,-175,9.5,-105,-115,-137,-1.5,151,4.28,Nationals Park,15,-5
2017-07-14,2017,ATL,ARI,4,3,-108,-1.5,172,9.5,-110,-110,-102,1.5,-205,4.93,Suntrust Park,7,1
2017-07-14,2017,ARI,ATL,3,4,-102,1.5,-205,9.5,-110,-110,-108,-1.5,172,4.8,Suntrust Park,7,-1
2017-07-14,2017,CHC,BAL,9,8,101,1.5,-190,10.0,100,-120,-111,-1.5,163,4.98,Camden Yards,17,1
2017-07-14,2017,NYY,BOS,4,5,123,1.5,-170,8.5,-110,-110,-138,-1.5,148,3.81,Fenway Park,9,-1
2017-07-14,2017,BAL,CHC,8,9,-111,-1.5,163,10.0,100,-120,101,1.5,-190,5.26,Camden Yards,17,-1
2017-07-14,2017,WSH,CIN,5,0,-117,-1.5,120,10.0,-110,-110,107,1.5,-140,5.39,Great American Ballpark,5,5
2017-07-14,2017,OAK,CLE,5,0,126,1.5,-130,7.5,-105,-115,-141,-1.5,110,3.32,Oakland Coliseum,5,5
2017-07-14,2017,NYM,COL,14,2,-175,-1.5,130,7.5,100,-120,155,1.5,-150,4.77,Citi Field,16,12
2017-07-14,2017,SEA,CWS,4,2,-200,-1.5,-135,9.5,-105,-115,170,1.5,115,6.33,Guaranteed Rate Field,6,2
2017-07-14,2017,TOR,DET,7,2,109,1.5,-190,9.5,-110,-110,-119,-1.5,163,4.55,Comerica Park,9,5
2017-07-14,2017,MIN,HOU,5,10,151,1.5,-140,9.0,-105,-115,-166,-1.5,120,3.59,Minute Maid Park,15,-5
2017-07-14,2017,TEX,KC,5,3,113,1.5,-185,9.5,-115,-105,-123,-1.5,160,4.46,Kauffman Stadium,8,2
2017-07-14,2017,TB,LAA,2,1,116,1.5,-180,9.0,-105,-115,-126,-1.5,155,4.17,Angel Stadium,3,1
2017-07-14,2017,MIA,LAD,4,6,105,1.5,-165,8.5,-113,-107,-115,-1.5,144,4.15,Marlins Park,10,-2
2017-07-14,2017,LAD,MIA,6,4,-115,-1.5,144,8.5,-113,-107,105,1.5,-165,4.55,Marlins Park,10,2
2017-07-14,2017,PHI,MIL,6,9,153,1.5,-150,9.5,100,-120,-168,-1.5,130,3.75,Miller Park,15,-3
2017-07-14,2017,HOU,MIN,10,5,-166,-1.5,120,9.0,-105,-115,151,1.5,-140,5.62,Minute Maid Park,15,5
2017-07-14,2017,COL,NYM,2,14,155,1.5,-150,7.5,100,-120,-175,-1.5,130,2.94,Citi Field,16,-12
2017-07-14,2017,BOS,NYY,5,4,-138,-1.5,148,8.5,-110,-110,123,1.5,-170,4.93,Fenway Park,9,1
2017-07-14,2017,CLE,OAK,0,5,-141,-1.5,110,7.5,-105,-115,126,1.5,-130,4.39,Oakland Coliseum,5,-5
2017-07-14,2017,MIL,PHI,9,6,-168,-1.5,130,9.5,100,-120,153,1.5,-150,5.96,Miller Park,15,3
2017-07-14,2017,STL,PIT,2,5,118,1.5,-190,8.5,-105,-115,-133,-1.5,163,3.9,PNC Park,7,-3
2017-07-14,2017,SF,SD,5,4,-115,-1.5,144,8.0,-105,-115,105,1.5,-165,4.28,PETCO Park,9,1
2017-07-14,2017,CWS,SEA,2,4,170,1.5,115,9.5,-105,-115,-200,-1.5,-135,3.52,Guaranteed Rate Field,6,-2
2017-07-14,2017,SD,SF,4,5,105,1.5,-165,8.0,-105,-115,-115,-1.5,144,3.9,PETCO Park,9,-1
2017-07-14,2017,PIT,STL,5,2,-133,-1.5,163,8.5,-105,-115,118,1.5,-190,4.85,PNC Park,7,3
2017-07-14,2017,LAA,TB,1,2,-126,-1.5,155,9.0,-105,-115,116,1.5,-180,5.02,Angel Stadium,3,-1
2017-07-14,2017,KC,TEX,3,5,-123,-1.5,160,9.5,-115,-105,113,1.5,-185,5.24,Kauffman Stadium,8,-2
2017-07-14,2017,DET,TOR,2,7,-119,-1.5,163,9.5,-110,-110,109,1.5,-190,5.16,Comerica Park,9,-5
2017-07-14,2017,CIN,WSH,0,5,107,1.5,-140,10.0,-110,-110,-117,-1.5,120,4.83,Great American Ballpark,5,-5
2017-07-15,2017,ATL,ARI,8,5,123,1.5,-135,9.0,-120,100,-138,-1.5,115,4.04,Suntrust Park,13,3
2017-07-15,2017,ARI,ATL,5,8,-138,-1.5,115,9.0,-120,100,123,1.5,-135,5.22,Suntrust Park,13,-3
2017-07-15,2017,CHC,BAL,10,3,-128,-1.5,115,10.0,-105,-115,118,1.5,-135,5.61,Camden Yards,13,7
2017-07-15,2017,NYY,BOS,4,1,154,1.5,-145,7.5,-110,-110,-174,-1.5,125,2.95,Fenway Park,5,3
2017-07-15,2017,BAL,CHC,3,10,118,1.5,-135,10.0,-105,-115,-128,-1.5,115,4.59,Camden Yards,13,-7
2017-07-15,2017,WSH,CIN,10,7,-144,-1.5,105,8.5,-120,100,129,1.5,-125,5.02,Great American Ballpark,17,3
2017-07-15,2017,OAK,CLE,5,3,205,1.5,115,7.5,-118,-102,-245,-1.5,-135,2.46,Oakland Coliseum,8,2
2017-07-15,2017,NYM,COL,9,3,-116,-1.5,166,9.5,-115,-105,106,1.5,-195,5.1,Citi Field,12,6
2017-07-15,2017,SEA,CWS,4,3,-131,-1.5,110,10.0,-115,-105,116,1.5,-130,5.67,Guaranteed Rate Field,7,1
2017-07-15,2017,TOR,DET,1,11,131,1.5,-150,9.5,-115,-105,-146,-1.5,130,4.11,Comerica Park,12,-10
2017-07-15,2017,MIN,HOU,4,2,153,1.5,-130,9.5,-110,-110,-168,-1.5,110,3.75,Minute Maid Park,6,2
2017-07-15,2017,TEX,KC,1,0,117,1.5,-185,9.0,-105,-115,-127,-1.5,160,4.15,Kauffman Stadium,1,1
2017-07-15,2017,TB,LAA,6,3,115,1.5,-160,9.0,-115,-105,-130,-1.5,140,4.19,Angel Stadium,9,3
2017-07-15,2017,MIA,LAD,1,7,175,1.5,105,8.5,105,-125,-205,-1.5,-125,3.09,Marlins Park,8,-6
2017-07-15,2017,LAD,MIA,7,1,-205,-1.5,-125,8.5,105,-125,175,1.5,105,5.71,Marlins Park,8,6
2017-07-15,2017,PHI,MIL,2,3,142,1.5,-150,8.5,105,-125,-157,-1.5,130,3.51,Miller Park,5,-1
2017-07-15,2017,HOU,MIN,2,4,-168,-1.5,110,9.5,-110,-110,153,1.5,-130,5.96,Minute Maid Park,6,-2
2017-07-15,2017,COL,NYM,3,9,106,1.5,-195,9.5,-115,-105,-116,-1.5,166,4.61,Citi Field,12,-6
2017-07-15,2017,BOS,NYY,1,4,-174,-1.5,125,7.5,-110,-110,154,1.5,-145,4.76,Fenway Park,5,-3
2017-07-15,2017,CLE,OAK,3,5,-245,-1.5,-135,7.5,-118,-102,205,1.5,115,5.33,Oakland Coliseum,8,-2
2017-07-15,2017,MIL,PHI,3,2,-157,-1.5,130,8.5,105,-125,142,1.5,-150,5.19,Miller Park,5,1
2017-07-15,2017,STL,PIT,4,0,114,1.5,-189,8.0,-120,100,-124,-1.5,170,3.74,PNC Park,4,4
2017-07-15,2017,SF,SD,3,5,-138,-1.5,120,7.5,-105,-115,123,1.5,-140,4.35,PETCO Park,8,-2
2017-07-15,2017,CWS,SEA,3,4,116,1.5,-130,10.0,-115,-105,-131,-1.5,110,4.63,Guaranteed Rate Field,7,-1
2017-07-15,2017,SD,SF,5,3,123,1.5,-140,7.5,-105,-115,-138,-1.5,120,3.36,PETCO Park,8,2
2017-07-15,2017,PIT,STL,0,4,-124,-1.5,170,8.0,-120,100,114,1.5,-189,4.43,PNC Park,4,-4
2017-07-15,2017,LAA,TB,3,6,-130,-1.5,140,9.0,-115,-105,115,1.5,-160,5.09,Angel Stadium,9,-3
2017-07-15,2017,KC,TEX,0,1,-127,-1.5,160,9.0,-105,-115,117,1.5,-185,5.04,Kauffman Stadium,1,-1
2017-07-15,2017,DET,TOR,11,1,-146,-1.5,130,9.5,-115,-105,131,1.5,-150,5.64,Comerica Park,12,10
2017-07-15,2017,CIN,WSH,7,10,129,1.5,-125,8.5,-120,100,-144,-1.5,105,3.71,Great American Ballpark,17,-3
2017-07-16,2017,ATL,ARI,7,1,105,-1.5,172,9.0,-115,-105,-115,1.5,-205,4.39,Suntrust Park,8,6
2017-07-16,2017,ARI,ATL,1,7,-115,1.5,-205,9.0,-115,-105,105,-1.5,172,4.81,Suntrust Park,8,-6
2017-07-16,2017,CHC,BAL,8,0,-163,-1.5,100,10.5,-110,-110,148,1.5,-120,6.51,Camden Yards,8,8
2017-07-16,2017,NYY,BOS,3,0,125,1.5,-165,9.5,-115,-105,-140,-1.5,144,4.22,Fenway Park,3,3
2017-07-16,2017,NYY,BOS,0,3,121,1.5,-185,9.0,-110,-110,-136,-1.5,160,4.07,Fenway Park,3,-3
2017-07-16,2017,BAL,CHC,0,8,148,1.5,-120,10.5,-110,-110,-163,-1.5,100,4.23,Camden Yards,8,-8
2017-07-16,2017,WSH,CIN,14,4,103,1.5,-190,10.5,-115,-105,-113,-1.5,163,5.17,Great American Ballpark,18,10
2017-07-16,2017,OAK,CLE,7,3,-107,-1.5,176,9.0,-110,-110,-103,1.5,-210,4.65,Oakland Coliseum,10,4
2017-07-16,2017,NYM,COL,4,13,-121,-1.5,173,9.0,-115,-105,111,1.5,-206,4.93,Citi Field,17,-9
2017-07-16,2017,SEA,CWS,7,6,-136,-1.5,120,10.0,-115,-105,121,1.5,-140,5.76,Guaranteed Rate Field,13,1
2017-07-16,2017,TOR,DET,5,6,100,1.5,-190,10.0,-110,-110,-110,-1.5,163,5.0,Comerica Park,11,-1
2017-07-16,2017,MIN,HOU,3,5,170,1.5,100,10.0,-110,-110,-200,-1.5,-120,3.7,Minute Maid Park,8,-2
2017-07-16,2017,TEX,KC,3,4,-135,-1.5,125,9.0,-115,-105,120,1.5,-145,5.17,Kauffman Stadium,7,-1
2017-07-16,2017,TB,LAA,3,4,-133,-1.5,129,9.0,100,-120,118,1.5,-148,5.14,Angel Stadium,7,-1
2017-07-16,2017,MIA,LAD,2,3,151,1.5,-115,8.5,-115,-105,-171,-1.5,-105,3.39,Marlins Park,5,-1
2017-07-16,2017,LAD,MIA,3,2,-171,-1.5,-105,8.5,-115,-105,151,1.5,-115,5.36,Marlins Park,5,1
2017-07-16,2017,PHI,MIL,5,2,139,1.5,-160,9.5,-102,-118,-154,-1.5,140,3.97,Miller Park,7,3
2017-07-16,2017,HOU,MIN,5,3,-200,-1.5,-120,10.0,-110,-110,170,1.5,100,6.67,Minute Maid Park,8,2
2017-07-16,2017,COL,NYM,13,4,111,1.5,-206,9.0,-115,-105,-121,-1.5,173,4.27,Citi Field,17,9
2017-07-16,2017,BOS,NYY,0,3,-140,-1.5,144,9.5,-115,-105,125,1.5,-165,5.54,Fenway Park,3,-3
2017-07-16,2017,BOS,NYY,3,0,-136,-1.5,160,9.0,-110,-110,121,1.5,-185,5.19,Fenway Park,3,3
2017-07-16,2017,CLE,OAK,3,7,-103,1.5,-210,9.0,-110,-110,-107,-1.5,176,4.57,Oakland Coliseum,10,-4
2017-07-16,2017,MIL,PHI,2,5,-154,-1.5,140,9.5,-102,-118,139,1.5,-160,5.76,Miller Park,7,-3
2017-07-16,2017,STL,PIT,3,4,-116,-1.5,144,8.5,-120,100,106,1.5,-165,4.56,PNC Park,7,-1
2017-07-16,2017,SF,SD,1,7,-133,-1.5,120,7.5,-110,-110,118,1.5,-140,4.28,PETCO Park,8,-6
2017-07-16,2017,CWS,SEA,6,7,121,1.5,-140,10.0,-115,-105,-136,-1.5,120,4.52,Guaranteed Rate Field,13,-1
2017-07-16,2017,SD,SF,7,1,118,1.5,-140,7.5,-110,-110,-133,-1.5,120,3.44,PETCO Park,8,6
2017-07-16,2017,PIT,STL,4,3,106,1.5,-165,8.5,-120,100,-116,-1.5,144,4.13,PNC Park,7,1
2017-07-16,2017,LAA,TB,4,3,118,1.5,-148,9.0,100,-120,-133,-1.5,129,4.13,Angel Stadium,7,1
2017-07-16,2017,KC,TEX,4,3,120,1.5,-145,9.0,-115,-105,-135,-1.5,125,4.09,Kauffman Stadium,7,1
2017-07-16,2017,DET,TOR,6,5,-110,-1.5,163,10.0,-110,-110,100,1.5,-190,5.24,Comerica Park,11,1
2017-07-16,2017,CIN,WSH,4,14,-113,-1.5,163,10.5,-115,-105,103,1.5,-190,5.57,Great American Ballpark,18,-10
2017-07-17,2017,CHC,ATL,4,3,-176,-1.5,-115,9.5,-115,-105,156,1.5,-105,6.06,Suntrust Park,7,1
2017-07-17,2017,TEX,BAL,1,3,102,1.5,-200,11.0,-105,-115,-112,-1.5,170,5.45,Camden Yards,4,-2
2017-07-17,2017,TOR,BOS,4,3,-105,-1.5,144,9.0,-125,105,-105,1.5,-165,4.61,Fenway Park,7,1
2017-07-17,2017,ATL,CHC,3,4,156,1.5,-105,9.5,-115,-105,-176,-1.5,-115,3.71,Suntrust Park,7,-1
2017-07-17,2017,WSH,CIN,6,1,-146,-1.5,105,9.5,-110,-110,131,1.5,-125,5.64,Great American Ballpark,7,5
2017-07-17,2017,SF,CLE,3,5,116,1.5,-150,8.0,-105,-115,-131,-1.5,130,3.7,AT&T Park,8,-2
2017-07-17,2017,SD,COL,6,9,146,1.5,-125,11.0,-120,100,-161,-1.5,105,4.47,Coors Field,15,-3
2017-07-17,2017,KC,DET,2,10,-122,-1.5,151,11.0,-110,-110,112,1.5,-175,6.05,Kauffman Stadium,12,-8
2017-07-17,2017,SEA,HOU,9,7,195,1.5,-105,9.0,-115,-105,-225,-1.5,-115,3.05,Minute Maid Park,16,2
2017-07-17,2017,DET,KC,10,2,112,1.5,-175,11.0,-110,-110,-122,-1.5,151,5.19,Kauffman Stadium,12,8
2017-07-17,2017,PHI,MIA,5,6,135,1.5,-155,8.5,-105,-115,-150,-1.5,135,3.62,Marlins Park,11,-1
2017-07-17,2017,PIT,MIL,4,2,-123,-1.5,172,9.5,100,-120,113,1.5,-205,5.24,PNC Park,6,2
2017-07-17,2017,NYY,MIN,2,4,104,1.5,-205,10.5,-115,-105,-114,-1.5,172,5.15,Target Field,6,-2
2017-07-17,2017,STL,NYM,6,3,102,1.5,-205,9.0,-115,-105,-112,-1.5,172,4.46,Citi Field,9,3
2017-07-17,2017,MIN,NYY,4,2,-114,-1.5,172,10.5,-115,-105,104,1.5,-205,5.59,Target Field,6,2
2017-07-17,2017,TB,OAK,3,2,-109,-1.5,140,9.5,105,-125,-101,1.5,-160,4.95,Oakland Coliseum,5,1
2017-07-17,2017,MIA,PHI,6,5,-150,-1.5,135,8.5,-105,-115,135,1.5,-155,5.1,Marlins Park,11,1
2017-07-17,2017,MIL,PIT,2,4,113,1.5,-205,9.5,100,-120,-123,-1.5,172,4.46,PNC Park,6,-2
2017-07-17,2017,COL,SD,9,6,-161,-1.5,105,11.0,-120,100,146,1.5,-125,6.79,Coors Field,15,3
2017-07-17,2017,HOU,SEA,7,9,-225,-1.5,-115,9.0,-115,-105,195,1.5,-105,6.23,Minute Maid Park,16,-2
2017-07-17,2017,CLE,SF,5,3,-131,-1.5,130,8.0,-105,-115,116,1.5,-150,4.54,AT&T Park,8,2
2017-07-17,2017,NYM,STL,3,6,-112,-1.5,172,9.0,-115,-105,102,1.5,-205,4.75,Citi Field,9,-3
2017-07-17,2017,OAK,TB,2,3,-101,1.5,-160,9.5,105,-125,-109,-1.5,140,4.77,Oakland Coliseum,5,-1
2017-07-17,2017,BAL,TEX,3,1,-112,-1.5,170,11.0,-105,-115,102,1.5,-200,5.81,Camden Yards,4,2
2017-07-17,2017,BOS,TOR,3,4,-105,1.5,-165,9.0,-125,105,-105,-1.5,144,4.61,Fenway Park,7,-1
2017-07-17,2017,CIN,WSH,1,6,131,1.5,-125,9.5,-110,-110,-146,-1.5,105,4.11,Great American Ballpark,7,-5
2017-07-18,2017,CIN,ARI,2,11,149,1.5,-115,9.5,100,-120,-164,-1.5,-105,3.82,Great American Ballpark,13,-9
2017-07-18,2017,CHC,ATL,5,1,-135,-1.5,115,9.5,-120,100,120,1.5,-135,5.46,Suntrust Park,6,4
2017-07-18,2017,TEX,BAL,1,12,114,1.5,-165,10.5,100,-120,-124,-1.5,144,4.91,Camden Yards,13,-11
2017-07-18,2017,TOR,BOS,4,5,-136,-1.5,110,10.0,-115,-105,121,1.5,-130,5.76,Fenway Park,9,-1
2017-07-18,2017,ATL,CHC,1,5,120,1.5,-135,9.5,-120,100,-135,-1.5,115,4.32,Suntrust Park,6,-4
2017-07-18,2017,ARI,CIN,11,2,-164,-1.5,-105,9.5,100,-120,149,1.5,-115,5.9,Great American Ballpark,13,9
2017-07-18,2017,SF,CLE,2,1,126,1.5,-140,7.5,-105,-115,-141,-1.5,120,3.32,AT&T Park,3,1
2017-07-18,2017,SD,COL,7,9,118,1.5,-150,11.0,-105,-115,-133,-1.5,130,5.05,Coors Field,16,-2
2017-07-18,2017,LAD,CWS,1,0,-335,-1.5,-190,9.0,-110,-110,285,1.5,163,6.93,Guaranteed Rate Field,1,1
2017-07-18,2017,KC,DET,3,9,-103,1.5,-160,10.5,-105,-115,-107,-1.5,140,5.33,Kauffman Stadium,12,-6
2017-07-18,2017,SEA,HOU,2,6,158,1.5,-130,10.0,-105,-115,-178,-1.5,110,3.88,Minute Maid Park,8,-4
2017-07-18,2017,DET,KC,9,3,-107,-1.5,140,10.5,-105,-115,-103,1.5,-160,5.43,Kauffman Stadium,12,6
2017-07-18,2017,WSH,LAA,4,3,127,1.5,-155,10.0,-109,-111,-142,-1.5,135,4.41,Angel Stadium,7,1
2017-07-18,2017,CWS,LAD,0,1,285,1.5,163,9.0,-110,-110,-335,-1.5,-190,2.34,Guaranteed Rate Field,1,-1
2017-07-18,2017,PHI,MIA,5,2,117,1.5,-180,9.0,101,-121,-132,-1.5,155,4.15,Marlins Park,7,3
2017-07-18,2017,PIT,MIL,4,3,-167,-1.5,130,9.5,-110,-110,152,1.5,-150,5.94,PNC Park,7,1
2017-07-18,2017,NYY,MIN,6,3,-121,-1.5,115,10.5,100,-120,111,1.5,-135,5.75,Target Field,9,3
2017-07-18,2017,STL,NYM,5,0,-112,-1.5,140,9.0,-119,-101,102,1.5,-160,4.75,Citi Field,5,5
2017-07-18,2017,MIN,NYY,3,6,111,1.5,-135,10.5,100,-120,-121,-1.5,115,4.98,Target Field,9,-3
2017-07-18,2017,TB,OAK,4,3,-105,-1.5,144,9.0,-115,-105,-105,1.5,-165,4.61,Oakland Coliseum,7,1
2017-07-18,2017,MIA,PHI,2,5,-132,-1.5,155,9.0,101,-121,117,1.5,-180,5.12,Marlins Park,7,-3
2017-07-18,2017,MIL,PIT,3,4,152,1.5,-150,9.5,-110,-110,-167,-1.5,130,3.77,PNC Park,7,-1
2017-07-18,2017,COL,SD,9,7,-133,-1.5,130,11.0,-105,-115,118,1.5,-150,6.28,Coors Field,16,2
2017-07-18,2017,HOU,SEA,6,2,-178,-1.5,110,10.0,-105,-115,158,1.5,-130,6.4,Minute Maid Park,8,4
2017-07-18,2017,CLE,SF,1,2,-141,-1.5,120,7.5,-105,-115,126,1.5,-140,4.39,AT&T Park,3,-1
2017-07-18,2017,NYM,STL,0,5,102,1.5,-160,9.0,-119,-101,-112,-1.5,140,4.46,Citi Field,5,-5
2017-07-18,2017,OAK,TB,3,4,-105,1.5,-165,9.0,-115,-105,-105,-1.5,144,4.61,Oakland Coliseum,7,-1
2017-07-18,2017,BAL,TEX,12,1,-124,-1.5,144,10.5,100,-120,114,1.5,-165,5.81,Camden Yards,13,11
2017-07-18,2017,BOS,TOR,5,4,121,1.5,-130,10.0,-115,-105,-136,-1.5,110,4.52,Fenway Park,9,1
2017-07-18,2017,LAA,WSH,3,4,-142,-1.5,135,10.0,-109,-111,127,1.5,-155,5.87,Angel Stadium,7,-1
2017-07-19,2017,CIN,ARI,4,3,147,1.5,-115,9.5,-115,-105,-162,-1.5,-105,3.85,Great American Ballpark,7,1
2017-07-19,2017,CHC,ATL,8,2,-129,-1.5,115,10.0,-115,-105,119,1.5,-135,5.63,Suntrust Park,10,6
2017-07-19,2017,TEX,BAL,2,10,130,1.5,-155,10.5,-110,-110,-145,-1.5,135,4.57,Camden Yards,12,-8
2017-07-19,2017,TOR,BOS,1,5,119,1.5,-170,9.5,-110,-110,-134,-1.5,148,4.34,Fenway Park,6,-4
2017-07-19,2017,ATL,CHC,2,8,119,1.5,-135,10.0,-115,-105,-129,-1.5,115,4.57,Suntrust Park,10,-6
2017-07-19,2017,ARI,CIN,3,4,-162,-1.5,-105,9.5,-115,-105,147,1.5,-115,5.87,Great American Ballpark,7,-1
2017-07-19,2017,SF,CLE,5,4,200,1.5,120,7.5,-110,-110,-230,-1.5,-140,2.5,AT&T Park,9,1
2017-07-19,2017,SD,COL,4,18,170,1.5,-110,11.5,-120,100,-200,-1.5,-110,4.26,Coors Field,22,-14
2017-07-19,2017,LAD,CWS,9,1,-190,-1.5,-125,9.5,113,-133,170,1.5,105,6.22,Guaranteed Rate Field,10,8
2017-07-19,2017,KC,DET,4,3,-106,1.5,-165,9.5,-110,-110,-104,-1.5,144,4.89,Kauffman Stadium,7,1
2017-07-19,2017,SEA,HOU,4,1,-109,-1.5,140,8.5,-120,100,-101,1.5,-160,4.43,Minute Maid Park,5,3
2017-07-19,2017,DET,KC,3,4,-104,-1.5,144,9.5,-110,-110,-106,1.5,-165,4.84,Kauffman Stadium,7,-1
2017-07-19,2017,WSH,LAA,0,7,109,1.5,-200,8.5,-110,-110,-119,-1.5,170,4.07,Angel Stadium,7,-7
2017-07-19,2017,CWS,LAD,1,9,170,1.5,105,9.5,113,-133,-190,-1.5,-125,3.52,Guaranteed Rate Field,10,-8
2017-07-19,2017,PHI,MIA,10,3,170,1.5,-120,8.0,-120,100,-190,-1.5,100,2.96,Marlins Park,13,7
2017-07-19,2017,PIT,MIL,3,2,-161,-1.5,125,9.0,-105,-115,146,1.5,-145,5.55,PNC Park,5,1
2017-07-19,2017,NYY,MIN,1,6,-105,-1.5,151,9.0,-111,-109,-105,1.5,-175,4.61,Target Field,7,-5
2017-07-19,2017,STL,NYM,3,7,150,1.5,-145,8.0,-115,-105,-170,-1.5,125,3.2,Citi Field,10,-4
2017-07-19,2017,MIN,NYY,6,1,-105,1.5,-175,9.0,-111,-109,-105,-1.5,151,4.61,Target Field,7,5
2017-07-19,2017,TB,OAK,2,7,103,1.5,-205,8.5,-115,-105,-113,-1.5,172,4.19,Oakland Coliseum,9,-5
2017-07-19,2017,MIA,PHI,3,10,-190,-1.5,100,8.0,-120,100,170,1.5,-120,5.24,Marlins Park,13,-7
2017-07-19,2017,MIL,PIT,2,3,146,1.5,-145,9.0,-105,-115,-161,-1.5,125,3.66,PNC Park,5,-1
2017-07-19,2017,COL,SD,18,4,-200,-1.5,-110,11.5,-120,100,170,1.5,-110,7.67,Coors Field,22,14
2017-07-19,2017,HOU,SEA,1,4,-101,1.5,-160,8.5,-120,100,-109,-1.5,140,4.27,Minute Maid Park,5,-3
2017-07-19,2017,CLE,SF,4,5,-230,-1.5,-140,7.5,-110,-110,200,1.5,120,5.23,AT&T Park,9,-1
2017-07-19,2017,NYM,STL,7,3,-170,-1.5,125,8.0,-115,-105,150,1.5,-145,5.04,Citi Field,10,4
2017-07-19,2017,OAK,TB,7,2,-113,-1.5,172,8.5,-115,-105,103,1.5,-205,4.51,Oakland Coliseum,9,5
2017-07-19,2017,BAL,TEX,10,2,-145,-1.5,135,10.5,-110,-110,130,1.5,-155,6.21,Camden Yards,12,8
2017-07-19,2017,BOS,TOR,5,1,-134,-1.5,148,9.5,-110,-110,119,1.5,-170,5.44,Fenway Park,6,4
2017-07-19,2017,LAA,WSH,7,0,-119,-1.5,170,8.5,-110,-110,109,1.5,-200,4.62,Angel Stadium,7,7
2017-07-20,2017,CIN,ARI,2,12,-135,-1.5,148,9.5,-110,-110,120,1.5,-170,5.46,Great American Ballpark,14,-10
2017-07-20,2017,LAD,ATL,3,6,-220,-1.5,-107,8.5,-125,105,190,1.5,-113,5.84,Dodger Stadium,9,-3
2017-07-20,2017,TEX,BAL,7,9,102,1.5,-190,10.5,-115,-105,-112,-1.5,163,5.2,Camden Yards,16,-2
2017-07-20,2017,TOR,BOS,8,6,-102,1.5,-200,11.0,-110,-110,-108,-1.5,170,5.55,Fenway Park,14,2
2017-07-20,2017,ARI,CIN,12,2,120,1.5,-170,9.5,-110,-110,-135,-1.5,148,4.32,Great American Ballpark,14,10
2017-07-20,2017,KC,DET,16,4,-104,1.5,-170,9.5,100,-120,-106,-1.5,148,4.84,Kauffman Stadium,20,12
2017-07-20,2017,DET,KC,4,16,-106,-1.5,148,9.5,100,-120,-104,1.5,-170,4.89,Kauffman Stadium,20,-12
2017-07-20,2017,ATL,LAD,6,3,190,1.5,-113,8.5,-125,105,-220,-1.5,-107,2.93,Dodger Stadium,9,3
2017-07-20,2017,PIT,MIL,4,2,-123,-1.5,170,8.0,100,-120,113,1.5,-200,4.41,PNC Park,6,2
2017-07-20,2017,STL,NYM,2,3,111,1.5,-175,10.0,-105,-115,-121,-1.5,151,4.74,Citi Field,5,-1
2017-07-20,2017,SEA,NYY,1,4,131,1.5,-130,8.0,100,-120,-146,-1.5,110,3.46,T-Mobile Park,5,-3
2017-07-20,2017,MIL,PIT,2,4,113,1.5,-200,8.0,100,-120,-123,-1.5,170,3.76,PNC Park,6,-2
2017-07-20,2017,SF,SD,2,5,-213,-1.5,100,7.0,-125,105,183,1.5,-120,4.76,AT&T Park,7,-3
2017-07-20,2017,NYY,SEA,4,1,-146,-1.5,110,8.0,100,-120,131,1.5,-130,4.75,T-Mobile Park,5,3
2017-07-20,2017,SD,SF,5,2,183,1.5,-120,7.0,-125,105,-213,-1.5,100,2.47,AT&T Park,7,3
2017-07-20,2017,NYM,STL,3,2,-121,-1.5,151,10.0,-105,-115,111,1.5,-175,5.48,Citi Field,5,1
2017-07-20,2017,BAL,TEX,9,7,-112,-1.5,163,10.5,-115,-105,102,1.5,-190,5.55,Camden Yards,16,2
2017-07-20,2017,BOS,TOR,6,8,-108,-1.5,170,11.0,-110,-110,-102,1.5,-200,5.71,Fenway Park,14,-2
2017-07-21,2017,WSH,ARI,5,6,-149,-1.5,110,8.5,-115,-105,134,1.5,-130,5.09,Chase Field,11,-1
2017-07-21,2017,LAD,ATL,3,12,-280,-1.5,-130,8.0,-115,-105,240,1.5,110,5.89,Dodger Stadium,15,-9
2017-07-21,2017,HOU,BAL,8,7,-132,-1.5,105,11.0,-105,-115,117,1.5,-125,6.26,Camden Yards,15,1
2017-07-21,2017,LAA,BOS,2,6,182,1.5,105,7.5,-115,-105,-212,-1.5,-125,2.66,Angel Stadium,8,-4
2017-07-21,2017,STL,CHC,11,4,135,1.5,-181,8.0,-113,-107,-150,-1.5,156,3.4,Wrigley Field,15,7
2017-07-21,2017,MIA,CIN,3,1,116,1.5,-163,10.5,-125,105,-131,-1.5,142,4.86,Great American Ballpark,4,2
2017-07-21,2017,TOR,CLE,3,13,126,1.5,-150,9.5,107,-127,-141,-1.5,130,4.2,Progressive Field,16,-10
2017-07-21,2017,PIT,COL,13,5,116,1.5,-155,11.5,-115,-105,-126,-1.5,135,5.32,Coors Field,18,8
2017-07-21,2017,KC,CWS,7,6,-177,-1.5,105,10.5,100,-120,157,1.5,-125,6.71,Kauffman Stadium,13,1
2017-07-21,2017,MIN,DET,3,6,-128,-1.5,148,9.5,-120,100,118,1.5,-170,5.33,Target Field,9,-3
2017-07-21,2017,BAL,HOU,7,8,117,1.5,-125,11.0,-105,-115,-132,-1.5,105,5.07,Camden Yards,15,-1
2017-07-21,2017,CWS,KC,6,7,157,1.5,-125,10.5,100,-120,-177,-1.5,105,4.09,Kauffman Stadium,13,-1
2017-07-21,2017,BOS,LAA,6,2,-212,-1.5,-125,7.5,-115,-105,182,1.5,105,5.1,Angel Stadium,8,4
2017-07-21,2017,ATL,LAD,12,3,240,1.5,110,8.0,-115,-105,-280,-1.5,-130,2.35,Dodger Stadium,15,9
2017-07-21,2017,CIN,MIA,1,3,-131,-1.5,142,10.5,-125,105,116,1.5,-163,5.95,Great American Ballpark,4,-2
2017-07-21,2017,PHI,MIL,6,1,-144,-1.5,144,9.0,-112,-108,129,1.5,-165,5.31,Citizens Bank Park,7,5
2017-07-21,2017,DET,MIN,6,3,118,1.5,-170,9.5,-120,100,-128,-1.5,148,4.36,Target Field,9,3
2017-07-21,2017,OAK,NYM,5,7,143,1.5,-150,9.5,-120,100,-158,-1.5,130,3.91,Citi Field,12,-2
2017-07-21,2017,SEA,NYY,1,5,105,1.5,-164,9.0,-120,100,-115,-1.5,142,4.39,T-Mobile Park,6,-4
2017-07-21,2017,NYM,OAK,7,5,-158,-1.5,130,9.5,-120,100,143,1.5,-150,5.82,Citi Field,12,2
2017-07-21,2017,MIL,PHI,1,6,129,1.5,-165,9.0,-112,-108,-144,-1.5,144,3.93,Citizens Bank Park,7,-5
2017-07-21,2017,COL,PIT,5,13,-126,-1.5,135,11.5,-115,-105,116,1.5,-155,6.41,Coors Field,18,-8
2017-07-21,2017,SF,SD,9,12,-167,-1.5,134,7.0,-115,-105,152,1.5,-154,4.38,AT&T Park,21,-3
2017-07-21,2017,NYY,SEA,5,1,-115,-1.5,142,9.0,-120,100,105,1.5,-164,4.81,T-Mobile Park,6,4
2017-07-21,2017,SD,SF,12,9,152,1.5,-154,7.0,-115,-105,-167,-1.5,134,2.78,AT&T Park,21,3
2017-07-21,2017,CHC,STL,4,11,-150,-1.5,156,8.0,-113,-107,135,1.5,-181,4.8,Wrigley Field,15,-7
2017-07-21,2017,TEX,TB,4,3,-128,-1.5,120,8.5,100,-120,118,1.5,-140,4.77,Tropicana Field,7,1
2017-07-21,2017,TB,TEX,3,4,118,1.5,-140,8.5,100,-120,-128,-1.5,120,3.9,Tropicana Field,7,-1
2017-07-21,2017,CLE,TOR,13,3,-141,-1.5,130,9.5,107,-127,126,1.5,-150,5.56,Progressive Field,16,10
2017-07-21,2017,ARI,WSH,6,5,134,1.5,-130,8.5,-115,-105,-149,-1.5,110,3.63,Chase Field,11,1
2017-07-22,2017,WSH,ARI,4,3,-118,-1.5,140,10.0,-115,-105,108,1.5,-160,5.41,Chase Field,7,1
2017-07-22,2017,LAD,ATL,6,2,-260,-1.5,-130,8.5,-102,-118,220,1.5,110,6.14,Dodger Stadium,8,4
2017-07-22,2017,HOU,BAL,8,4,-119,-1.5,125,11.5,-105,-115,109,1.5,-145,6.25,Camden Yards,12,4
2017-07-22,2017,LAA,BOS,7,3,116,1.5,-155,8.0,-125,105,-126,-1.5,135,3.7,Angel Stadium,10,4
2017-07-22,2017,STL,CHC,2,3,140,1.5,-150,8.5,-115,-105,-155,-1.5,130,3.54,Wrigley Field,5,-1
2017-07-22,2017,MIA,CIN,5,4,104,1.5,-190,11.5,-115,-105,-114,-1.5,163,5.64,Great American Ballpark,9,1
2017-07-22,2017,TOR,CLE,1,2,107,1.5,-195,9.0,-105,-115,-117,-1.5,166,4.35,Progressive Field,3,-1
2017-07-22,2017,PIT,COL,3,7,100,1.5,-170,11.5,-110,-110,-110,-1.5,148,5.75,Coors Field,10,-4
2017-07-22,2017,KC,CWS,7,2,-170,-1.5,105,11.0,-110,-110,150,1.5,-125,6.93,Kauffman Stadium,9,5
2017-07-22,2017,MIN,DET,6,5,-122,-1.5,151,10.5,-120,100,112,1.5,-175,5.77,Target Field,11,1
2017-07-22,2017,BAL,HOU,4,8,109,1.5,-145,11.5,-105,-115,-119,-1.5,125,5.5,Camden Yards,12,-4
2017-07-22,2017,CWS,KC,2,7,150,1.5,-125,11.0,-110,-110,-170,-1.5,105,4.4,Kauffman Stadium,9,-5
2017-07-22,2017,BOS,LAA,3,7,-126,-1.5,135,8.0,-125,105,116,1.5,-155,4.46,Angel Stadium,10,-4
2017-07-22,2017,ATL,LAD,2,6,220,1.5,110,8.5,-102,-118,-260,-1.5,-130,2.66,Dodger Stadium,8,-4
2017-07-22,2017,CIN,MIA,4,5,-114,-1.5,163,11.5,-115,-105,104,1.5,-190,6.13,Great American Ballpark,9,-1
2017-07-22,2017,PHI,MIL,8,9,116,1.5,-140,9.5,-105,-115,-126,-1.5,120,4.4,Citizens Bank Park,17,-1
2017-07-22,2017,DET,MIN,5,6,112,1.5,-175,10.5,-120,100,-122,-1.5,151,4.95,Target Field,11,-1
2017-07-22,2017,OAK,NYM,5,6,106,1.5,-205,9.0,-110,-110,-116,-1.5,172,4.37,Citi Field,11,-1
2017-07-22,2017,SEA,NYY,6,5,119,1.5,-135,8.5,-125,105,-134,-1.5,115,3.88,T-Mobile Park,11,1
2017-07-22,2017,NYM,OAK,6,5,-116,-1.5,172,9.0,-110,-110,106,1.5,-205,4.83,Citi Field,11,1
2017-07-22,2017,MIL,PHI,9,8,-126,-1.5,120,9.5,-105,-115,116,1.5,-140,5.3,Citizens Bank Park,17,1
2017-07-22,2017,COL,PIT,7,3,-110,-1.5,148,11.5,-110,-110,100,1.5,-170,6.02,Coors Field,10,4
2017-07-22,2017,SF,SD,5,4,-113,-1.5,172,9.0,-105,-115,103,1.5,-205,4.77,AT&T Park,9,1
2017-07-22,2017,NYY,SEA,5,6,-134,-1.5,115,8.5,-125,105,119,1.5,-135,4.87,T-Mobile Park,11,-1
2017-07-22,2017,SD,SF,4,5,103,1.5,-205,9.0,-105,-115,-113,-1.5,172,4.43,AT&T Park,9,-1
2017-07-22,2017,CHC,STL,3,2,-155,-1.5,130,8.5,-115,-105,140,1.5,-150,5.17,Wrigley Field,5,1
2017-07-22,2017,TEX,TB,4,3,165,1.5,-135,8.5,-110,-110,-185,-1.5,115,3.21,Tropicana Field,7,1
2017-07-22,2017,TB,TEX,3,4,-185,-1.5,115,8.5,-110,-110,165,1.5,-135,5.52,Tropicana Field,7,-1
2017-07-22,2017,CLE,TOR,2,1,-117,-1.5,166,9.0,-105,-115,107,1.5,-195,4.85,Progressive Field,3,1
2017-07-22,2017,ARI,WSH,3,4,108,1.5,-160,10.0,-115,-105,-118,-1.5,140,4.81,Chase Field,7,-1
2017-07-23,2017,WSH,ARI,6,2,-116,-1.5,144,8.5,100,-120,106,1.5,-165,4.56,Chase Field,8,4
2017-07-23,2017,LAD,ATL,5,4,-388,-1.5,-180,7.5,-115,-105,328,1.5,155,5.96,Dodger Stadium,9,1
2017-07-23,2017,HOU,BAL,7,9,-129,-1.5,125,10.0,-105,-115,119,1.5,-145,5.63,Camden Yards,16,-2
2017-07-23,2017,LAA,BOS,3,2,106,1.5,-150,9.0,100,-120,-116,-1.5,130,4.37,Angel Stadium,5,1
2017-07-23,2017,STL,CHC,3,5,154,1.5,-150,8.0,106,-126,-169,-1.5,130,3.15,Wrigley Field,8,-2
2017-07-23,2017,MIA,CIN,3,6,122,1.5,-155,11.0,-110,-110,-137,-1.5,135,4.95,Great American Ballpark,9,-3
2017-07-23,2017,TOR,CLE,1,8,171,1.5,-120,8.0,-110,-110,-191,-1.5,100,2.95,Progressive Field,9,-7
2017-07-23,2017,PIT,COL,3,13,102,1.5,-180,13.0,-105,-115,-112,-1.5,155,6.44,Coors Field,16,-10
2017-07-23,2017,KC,CWS,5,4,-135,-1.5,144,10.5,-110,-110,120,1.5,-165,6.03,Kauffman Stadium,9,1
2017-07-23,2017,MIN,DET,6,9,-109,-1.5,166,10.5,-115,-105,-101,1.5,-195,5.48,Target Field,15,-3
2017-07-23,2017,BAL,HOU,9,7,119,1.5,-145,10.0,-105,-115,-129,-1.5,125,4.57,Camden Yards,16,2
2017-07-23,2017,CWS,KC,4,5,120,1.5,-165,10.5,-110,-110,-135,-1.5,144,4.77,Kauffman Stadium,9,-1
2017-07-23,2017,BOS,LAA,2,3,-116,-1.5,130,9.0,100,-120,106,1.5,-150,4.83,Angel Stadium,5,-1
2017-07-23,2017,ATL,LAD,4,5,328,1.5,155,7.5,-115,-105,-388,-1.5,-180,1.75,Dodger Stadium,9,-1
2017-07-23,2017,CIN,MIA,6,3,-137,-1.5,135,11.0,-110,-110,122,1.5,-155,6.36,Great American Ballpark,9,3
2017-07-23,2017,PHI,MIL,6,3,-109,-1.5,172,10.0,-105,-115,-101,1.5,-205,5.22,Citizens Bank Park,9,3
2017-07-23,2017,DET,MIN,9,6,-101,1.5,-195,10.5,-115,-105,-109,-1.5,166,5.28,Target Field,15,3
2017-07-23,2017,OAK,NYM,3,2,125,1.5,-155,9.5,-110,-110,-140,-1.5,135,4.22,Citi Field,5,1
2017-07-23,2017,SEA,NYY,4,6,103,1.5,-157,9.5,-110,-110,-113,-1.5,137,4.68,T-Mobile Park,10,-2
2017-07-23,2017,NYM,OAK,2,3,-140,-1.5,135,9.5,-110,-110,125,1.5,-155,5.54,Citi Field,5,-1
2017-07-23,2017,MIL,PHI,3,6,-101,1.5,-205,10.0,-105,-115,-109,-1.5,172,5.02,Citizens Bank Park,9,-3
2017-07-23,2017,COL,PIT,13,3,-112,-1.5,155,13.0,-105,-115,102,1.5,-180,6.87,Coors Field,16,10
2017-07-23,2017,SF,SD,2,5,-105,-1.5,184,8.5,-115,-105,-105,1.5,-220,4.35,AT&T Park,7,-3
2017-07-23,2017,NYY,SEA,6,4,-113,-1.5,137,9.5,-110,-110,103,1.5,-157,5.04,T-Mobile Park,10,2
2017-07-23,2017,SD,SF,5,2,-105,1.5,-220,8.5,-115,-105,-105,-1.5,184,4.35,AT&T Park,7,3
2017-07-23,2017,CHC,STL,5,3,-169,-1.5,130,8.0,106,-126,154,1.5,-150,5.03,Wrigley Field,8,2
2017-07-23,2017,TEX,TB,6,5,113,1.5,-190,9.5,-105,-115,-123,-1.5,163,4.46,Tropicana Field,11,1
2017-07-23,2017,TB,TEX,5,6,-123,-1.5,163,9.5,-105,-115,113,1.5,-190,5.24,Tropicana Field,11,-1
2017-07-23,2017,CLE,TOR,8,1,-191,-1.5,100,8.0,-110,-110,171,1.5,-120,5.25,Progressive Field,9,7
2017-07-23,2017,ARI,WSH,2,6,106,1.5,-165,8.5,100,-120,-116,-1.5,144,4.13,Chase Field,8,-4
2017-07-24,2017,ATL,ARI,2,10,185,1.5,-120,9.5,100,-120,-215,-1.5,100,3.33,Chase Field,12,-8
2017-07-24,2017,ARI,ATL,10,2,-215,-1.5,100,9.5,100,-120,185,1.5,-120,6.48,Chase Field,12,8
2017-07-24,2017,TB,BAL,0,5,-107,-1.5,184,9.0,-104,-116,-103,1.5,-220,4.65,Tropicana Field,5,-5
2017-07-24,2017,SEA,BOS,4,0,-150,-1.5,140,8.0,-109,-111,135,1.5,-160,4.8,T-Mobile Park,4,4
2017-07-24,2017,CWS,CHC,3,1,230,1.5,110,7.5,-115,-105,-270,-1.5,-130,2.27,Wrigley Field,4,2
2017-07-24,2017,CLE,CIN,6,2,-185,-1.5,100,9.5,100,-120,165,1.5,-120,6.17,Progressive Field,8,4
2017-07-24,2017,CIN,CLE,2,6,165,1.5,-120,9.5,100,-120,-185,-1.5,100,3.58,Progressive Field,8,-4
2017-07-24,2017,STL,COL,8,2,-137,-1.5,155,9.0,-115,-105,122,1.5,-180,5.2,Busch Stadium,10,6
2017-07-24,2017,CHC,CWS,1,3,-270,-1.5,-130,7.5,-115,-105,230,1.5,110,5.47,Wrigley Field,4,-2
2017-07-24,2017,KC,DET,5,3,120,1.5,-165,9.0,-110,-110,-135,-1.5,144,4.09,Comerica Park,8,2
2017-07-24,2017,PHI,HOU,4,13,139,1.5,-125,9.0,100,-120,-154,-1.5,105,3.77,Citizens Bank Park,17,-9
2017-07-24,2017,DET,KC,3,5,-135,-1.5,144,9.0,-110,-110,120,1.5,-165,5.17,Comerica Park,8,-2
2017-07-24,2017,MIN,LAD,4,6,230,1.5,105,9.0,-105,-115,-270,-1.5,-125,2.73,Dodger Stadium,10,-2
2017-07-24,2017,TEX,MIA,0,4,-140,-1.5,135,11.5,-105,-115,125,1.5,-155,6.71,Rangers Ballpark,4,-4
2017-07-24,2017,LAD,MIN,6,4,-270,-1.5,-125,9.0,-105,-115,230,1.5,105,6.57,Dodger Stadium,10,2
2017-07-24,2017,SD,NYM,3,5,146,1.5,-120,7.5,-110,-110,-161,-1.5,100,3.05,PETCO Park,8,-2
2017-07-24,2017,TOR,OAK,4,2,-162,-1.5,120,9.5,-110,-110,147,1.5,-140,5.87,Rogers Centre,6,2
2017-07-24,2017,HOU,PHI,13,4,-154,-1.5,105,9.0,100,-120,139,1.5,-125,5.46,Citizens Bank Park,17,9
2017-07-24,2017,SF,PIT,3,10,135,1.5,-125,8.0,-110,-110,-150,-1.5,105,3.4,AT&T Park,13,-7
2017-07-24,2017,NYM,SD,5,3,-161,-1.5,100,7.5,-110,-110,146,1.5,-120,4.63,PETCO Park,8,2
2017-07-24,2017,BOS,SEA,0,4,135,1.5,-160,8.0,-109,-111,-150,-1.5,140,3.4,T-Mobile Park,4,-4
2017-07-24,2017,PIT,SF,10,3,-150,-1.5,105,8.0,-110,-110,135,1.5,-125,4.8,AT&T Park,13,7
2017-07-24,2017,COL,STL,2,8,122,1.5,-180,9.0,-115,-105,-137,-1.5,155,4.05,Busch Stadium,10,-6
2017-07-24,2017,BAL,TB,5,0,-103,1.5,-220,9.0,-104,-116,-107,-1.5,184,4.57,Tropicana Field,5,5
2017-07-24,2017,MIA,TEX,4,0,125,1.5,-155,11.5,-105,-115,-140,-1.5,135,5.11,Rangers Ballpark,4,4
2017-07-24,2017,OAK,TOR,2,4,147,1.5,-140,9.5,-110,-110,-162,-1.5,120,3.85,Rogers Centre,6,-2
2017-07-25,2017,ATL,ARI,8,3,136,1.5,-150,10.5,100,-120,-151,-1.5,130,4.45,Chase Field,11,5
2017-07-25,2017,ARI,ATL,3,8,-151,-1.5,130,10.5,100,-120,136,1.5,-150,6.32,Chase Field,11,-5
2017-07-25,2017,TB,BAL,5,4,-121,-1.5,163,8.5,-110,-110,111,1.5,-190,4.65,Tropicana Field,9,1
2017-07-25,2017,SEA,BOS,6,5,-109,-1.5,172,8.0,-120,100,-101,1.5,-205,4.17,T-Mobile Park,11,1
2017-07-25,2017,CWS,CHC,2,7,176,1.5,-114,9.0,-125,105,-206,-1.5,-106,3.26,Wrigley Field,9,-5
2017-07-25,2017,NYY,CIN,4,2,-168,-1.5,115,9.0,100,-120,153,1.5,-135,5.64,Yankee Stadium,6,2
2017-07-25,2017,LAA,CLE,7,11,150,1.5,-135,9.0,-105,-115,-170,-1.5,115,3.6,Progressive Field,18,-4
2017-07-25,2017,STL,COL,3,2,-118,-1.5,172,8.5,100,-120,108,1.5,-205,4.6,Busch Stadium,5,1
2017-07-25,2017,CHC,CWS,7,2,-206,-1.5,-106,9.0,-125,105,176,1.5,-114,6.06,Wrigley Field,9,5
2017-07-25,2017,KC,DET,3,1,108,1.5,-185,9.0,-121,101,-118,-1.5,160,4.33,Comerica Park,4,2
2017-07-25,2017,PHI,HOU,0,5,132,1.5,-129,8.5,-119,-101,-147,-1.5,107,3.66,Citizens Bank Park,5,-5
2017-07-25,2017,DET,KC,1,3,-118,-1.5,160,9.0,-121,101,108,1.5,-185,4.87,Comerica Park,4,-2
2017-07-25,2017,CLE,LAA,11,7,-170,-1.5,115,9.0,-105,-115,150,1.5,-135,5.67,Progressive Field,18,4
2017-07-25,2017,MIN,LAD,2,6,173,1.5,-130,8.0,-110,-110,-193,-1.5,110,2.93,Dodger Stadium,8,-4
2017-07-25,2017,TEX,MIA,10,4,-152,-1.5,130,10.5,-120,100,137,1.5,-150,6.33,Rangers Ballpark,14,6
2017-07-25,2017,WSH,MIL,0,8,-131,-1.5,151,10.0,-115,-105,116,1.5,-175,5.67,Nationals Park,8,-8
2017-07-25,2017,LAD,MIN,6,2,-193,-1.5,110,8.0,-110,-110,173,1.5,-130,5.27,Dodger Stadium,8,4
2017-07-25,2017,SD,NYM,5,6,126,1.5,-150,9.5,100,-120,-141,-1.5,130,4.2,PETCO Park,11,-1
2017-07-25,2017,CIN,NYY,2,4,153,1.5,-135,9.0,100,-120,-168,-1.5,115,3.56,Yankee Stadium,6,-2
2017-07-25,2017,TOR,OAK,4,1,-111,-1.5,166,9.5,-105,-115,101,1.5,-195,5.0,Rogers Centre,5,3
2017-07-25,2017,HOU,PHI,5,0,-147,-1.5,107,8.5,-119,-101,132,1.5,-129,5.06,Citizens Bank Park,5,5
2017-07-25,2017,SF,PIT,11,3,-108,1.5,-175,7.5,-105,-115,-102,-1.5,151,3.89,AT&T Park,14,8
2017-07-25,2017,NYM,SD,6,5,-141,-1.5,130,9.5,100,-120,126,1.5,-150,5.56,PETCO Park,11,1
2017-07-25,2017,BOS,SEA,5,6,-101,1.5,-205,8.0,-120,100,-109,-1.5,172,4.02,T-Mobile Park,11,-1
2017-07-25,2017,PIT,SF,3,11,-102,-1.5,151,7.5,-105,-115,-108,1.5,-175,3.79,AT&T Park,14,-8
2017-07-25,2017,COL,STL,2,3,108,1.5,-205,8.5,100,-120,-118,-1.5,172,4.09,Busch Stadium,5,-1
2017-07-25,2017,BAL,TB,4,5,111,1.5,-190,8.5,-110,-110,-121,-1.5,163,4.03,Tropicana Field,9,-1
2017-07-25,2017,MIA,TEX,4,10,137,1.5,-150,10.5,-120,100,-152,-1.5,130,4.43,Rangers Ballpark,14,-6
2017-07-25,2017,OAK,TOR,1,4,101,1.5,-195,9.5,-105,-115,-111,-1.5,166,4.73,Rogers Centre,5,-3
2017-07-25,2017,MIL,WSH,8,0,116,1.5,-175,10.0,-115,-105,-131,-1.5,151,4.63,Nationals Park,8,8
2017-07-26,2017,ATL,ARI,3,10,180,1.5,-101,10.5,-105,-115,-210,-1.5,-119,3.75,Chase Field,13,-7
2017-07-26,2017,ARI,ATL,10,3,-210,-1.5,-119,10.5,-105,-115,180,1.5,-101,7.11,Chase Field,13,7
2017-07-26,2017,TB,BAL,5,1,-151,-1.5,135,9.0,-125,105,136,1.5,-155,5.41,Tropicana Field,6,4
2017-07-26,2017,SEA,BOS,0,4,177,1.5,117,8.0,100,-120,-207,-1.5,-137,2.89,T-Mobile Park,4,-4
2017-07-26,2017,CWS,CHC,3,8,227,1.5,143,10.0,100,-120,-267,-1.5,-164,3.06,Guaranteed Rate Field,11,-5
2017-07-26,2017,NYY,CIN,9,5,-240,-1.5,-121,9.0,-110,-110,200,1.5,101,6.35,Yankee Stadium,14,4
2017-07-26,2017,LAA,CLE,4,10,190,1.5,-107,9.0,-103,-117,-220,-1.5,-113,3.1,Progressive Field,14,-6
2017-07-26,2017,STL,COL,10,5,-185,-1.5,120,8.5,-115,-105,165,1.5,-140,5.52,Busch Stadium,15,5
2017-07-26,2017,CHC,CWS,8,3,-267,-1.5,-164,10.0,100,-120,227,1.5,143,7.28,Guaranteed Rate Field,11,5
2017-07-26,2017,KC,DET,16,2,101,1.5,-200,9.5,-115,-105,-111,-1.5,170,4.73,Comerica Park,18,14
2017-07-26,2017,PHI,HOU,9,0,-111,-1.5,180,8.0,-112,-108,101,1.5,-215,4.21,Citizens Bank Park,9,9
2017-07-26,2017,DET,KC,2,16,-111,-1.5,170,9.5,-115,-105,101,1.5,-200,5.0,Comerica Park,18,-14
2017-07-26,2017,CLE,LAA,10,4,-220,-1.5,-113,9.0,-103,-117,190,1.5,-107,6.19,Progressive Field,14,6
2017-07-26,2017,MIN,LAD,5,6,200,1.5,-110,8.5,-116,-104,-230,-1.5,-110,2.83,Dodger Stadium,11,-1
2017-07-26,2017,TEX,MIA,10,22,-235,-1.5,-113,10.5,-110,-110,205,1.5,-107,7.37,Rangers Ballpark,32,-12
2017-07-26,2017,WSH,MIL,8,5,-121,-1.5,160,8.5,-120,100,111,1.5,-185,4.65,Nationals Park,13,3
2017-07-26,2017,LAD,MIN,6,5,-230,-1.5,-110,8.5,-116,-104,200,1.5,-110,5.92,Dodger Stadium,11,1
2017-07-26,2017,SD,NYM,6,3,-118,-1.5,172,8.5,100,-120,108,1.5,-205,4.6,PETCO Park,9,3
2017-07-26,2017,CIN,NYY,5,9,200,1.5,101,9.0,-110,-110,-240,-1.5,-121,3.0,Yankee Stadium,14,-4
2017-07-26,2017,TOR,OAK,3,2,-155,-1.5,129,10.0,-110,-110,140,1.5,-149,6.08,Rogers Centre,5,1
2017-07-26,2017,HOU,PHI,0,9,101,1.5,-215,8.0,-112,-108,-111,-1.5,180,3.98,Citizens Bank Park,9,-9
2017-07-26,2017,SF,PIT,2,1,-148,-1.5,144,8.0,-105,-115,133,1.5,-165,4.77,AT&T Park,3,1
2017-07-26,2017,NYM,SD,3,6,108,1.5,-205,8.5,100,-120,-118,-1.5,172,4.09,PETCO Park,9,-3
2017-07-26,2017,BOS,SEA,4,0,-207,-1.5,-137,8.0,100,-120,177,1.5,117,5.39,T-Mobile Park,4,4
2017-07-26,2017,PIT,SF,1,2,133,1.5,-165,8.0,-105,-115,-148,-1.5,144,3.43,AT&T Park,3,-1
2017-07-26,2017,COL,STL,5,10,165,1.5,-140,8.5,-115,-105,-185,-1.5,120,3.21,Busch Stadium,15,-5
2017-07-26,2017,BAL,TB,1,5,136,1.5,-155,9.0,-125,105,-151,-1.5,135,3.81,Tropicana Field,6,-4
2017-07-26,2017,MIA,TEX,22,10,205,1.5,-107,10.5,-110,-110,-235,-1.5,-113,3.44,Rangers Ballpark,32,12
2017-07-26,2017,OAK,TOR,2,3,140,1.5,-149,10.0,-110,-110,-155,-1.5,129,4.17,Rogers Centre,5,-1
2017-07-26,2017,MIL,WSH,5,8,111,1.5,-185,8.5,-120,100,-121,-1.5,160,4.03,Nationals Park,13,-3
2017-07-27,2017,STL,ARI,0,4,-124,-1.5,166,9.0,100,-120,114,1.5,-195,4.98,Busch Stadium,4,-4
2017-07-27,2017,CWS,CHC,3,6,201,1.5,125,10.0,-115,-105,-241,-1.5,-145,3.32,Guaranteed Rate Field,9,-3
2017-07-27,2017,MIA,CIN,4,1,-137,-1.5,148,10.0,100,-120,122,1.5,-170,5.78,Marlins Park,5,3
2017-07-27,2017,LAA,CLE,1,2,145,1.5,-150,9.5,-105,-115,-160,-1.5,130,3.88,Progressive Field,3,-1
2017-07-27,2017,CHC,CWS,6,3,-241,-1.5,-145,10.0,-115,-105,201,1.5,125,7.07,Guaranteed Rate Field,9,3
2017-07-27,2017,CLE,LAA,2,1,-160,-1.5,130,9.5,-105,-115,145,1.5,-150,5.85,Progressive Field,3,1
2017-07-27,2017,CIN,MIA,1,4,122,1.5,-170,10.0,100,-120,-137,-1.5,148,4.5,Marlins Park,5,-3
2017-07-27,2017,WSH,MIL,15,2,-295,-1.5,-139,9.0,105,-125,255,1.5,119,6.72,Nationals Park,17,13
2017-07-27,2017,SD,NYM,7,5,-113,-1.5,172,9.0,-120,100,103,1.5,-205,4.77,PETCO Park,12,2
2017-07-27,2017,TB,NYY,5,6,109,1.5,-200,9.0,100,-120,-119,-1.5,170,4.31,Yankee Stadium,11,-1
2017-07-27,2017,TOR,OAK,8,4,-192,-1.5,102,8.5,-125,105,172,1.5,-122,5.59,Rogers Centre,12,4
2017-07-27,2017,NYM,SD,5,7,103,1.5,-205,9.0,-120,100,-113,-1.5,172,4.43,PETCO Park,12,-2
2017-07-27,2017,ARI,STL,4,0,114,1.5,-195,9.0,100,-120,-124,-1.5,166,4.21,Busch Stadium,4,4
2017-07-27,2017,NYY,TB,6,5,-119,-1.5,170,9.0,100,-120,109,1.5,-200,4.89,Yankee Stadium,11,1
2017-07-27,2017,OAK,TOR,4,8,172,1.5,-122,8.5,-125,105,-192,-1.5,102,3.13,Rogers Centre,12,-4
2017-07-27,2017,MIL,WSH,2,15,255,1.5,119,9.0,105,-125,-295,-1.5,-139,2.54,Nationals Park,17,-13
2017-07-28,2017,STL,ARI,1,0,-128,-1.5,163,8.0,-120,100,118,1.5,-190,4.49,Busch Stadium,1,1
2017-07-28,2017,PHI,ATL,10,3,133,1.5,-128,9.5,-105,-115,-148,-1.5,108,4.08,Citizens Bank Park,13,7
2017-07-28,2017,TEX,BAL,8,2,-143,-1.5,128,11.5,-121,101,128,1.5,-147,6.77,Rangers Ballpark,10,6
2017-07-28,2017,KC,BOS,4,2,145,1.5,-145,9.5,100,-120,-160,-1.5,125,3.88,Fenway Park,6,2
2017-07-28,2017,MIL,CHC,2,1,120,1.5,-145,9.0,105,-125,-135,-1.5,125,4.09,Miller Park,3,1
2017-07-28,2017,MIA,CIN,7,4,-119,-1.5,163,9.5,-105,-115,109,1.5,-190,5.16,Marlins Park,11,3
2017-07-28,2017,CWS,CLE,3,9,223,1.5,135,9.5,-105,-115,-263,-1.5,-155,2.94,Guaranteed Rate Field,12,-6
2017-07-28,2017,CLE,CWS,9,3,-263,-1.5,-155,9.5,-105,-115,223,1.5,135,6.88,Guaranteed Rate Field,12,6
2017-07-28,2017,HOU,DET,6,5,-157,-1.5,-113,9.5,-118,-102,142,1.5,-107,5.8,Comerica Park,11,1
2017-07-28,2017,DET,HOU,5,6,142,1.5,-107,9.5,-118,-102,-157,-1.5,-113,3.93,Comerica Park,11,-1
2017-07-28,2017,BOS,KC,2,4,-160,-1.5,125,9.5,100,-120,145,1.5,-145,5.85,Fenway Park,6,-2
2017-07-28,2017,TOR,LAA,2,7,-152,-1.5,144,9.5,-103,-117,137,1.5,-165,5.73,Rogers Centre,9,-5
2017-07-28,2017,SF,LAD,4,6,260,1.5,120,8.5,100,-120,-310,-1.5,-140,2.36,Dodger Stadium,10,-2
2017-07-28,2017,CIN,MIA,4,7,109,1.5,-190,9.5,-105,-115,-119,-1.5,163,4.55,Marlins Park,11,-3
2017-07-28,2017,CHC,MIL,1,2,-135,-1.5,125,9.0,105,-125,120,1.5,-145,5.17,Miller Park,3,-1
2017-07-28,2017,OAK,MIN,3,6,-105,1.5,-170,9.0,-105,-115,-105,-1.5,148,4.61,Oakland Coliseum,9,-3
2017-07-28,2017,SEA,NYM,5,7,-161,-1.5,119,9.5,-119,-101,146,1.5,-139,5.86,T-Mobile Park,12,-2
2017-07-28,2017,TB,NYY,1,6,170,1.5,-120,9.0,-120,100,-200,-1.5,100,3.33,Yankee Stadium,7,-5
2017-07-28,2017,MIN,OAK,6,3,-105,-1.5,148,9.0,-105,-115,-105,1.5,-170,4.61,Oakland Coliseum,9,3
2017-07-28,2017,ATL,PHI,3,10,-148,-1.5,108,9.5,-105,-115,133,1.5,-128,5.67,Citizens Bank Park,13,-7
2017-07-28,2017,SD,PIT,3,2,153,1.5,-115,9.0,-105,-115,-168,-1.5,-105,3.56,PETCO Park,5,1
2017-07-28,2017,PIT,SD,2,3,-168,-1.5,-105,9.0,-105,-115,153,1.5,-115,5.64,PETCO Park,5,-1
2017-07-28,2017,NYM,SEA,7,5,146,1.5,-139,9.5,-119,-101,-161,-1.5,119,3.86,T-Mobile Park,12,2
2017-07-28,2017,LAD,SF,6,4,-310,-1.5,-140,8.5,100,-120,260,1.5,120,6.43,Dodger Stadium,10,2
2017-07-28,2017,ARI,STL,0,1,118,1.5,-190,8.0,-120,100,-128,-1.5,163,3.67,Busch Stadium,1,-1
2017-07-28,2017,NYY,TB,6,1,-200,-1.5,100,9.0,-120,100,170,1.5,-120,6.0,Yankee Stadium,7,5
2017-07-28,2017,BAL,TEX,2,8,128,1.5,-147,11.5,-121,101,-143,-1.5,128,5.04,Rangers Ballpark,10,-6
2017-07-28,2017,LAA,TOR,7,2,137,1.5,-165,9.5,-103,-117,-152,-1.5,144,4.01,Rogers Centre,9,5
2017-07-29,2017,STL,ARI,1,7,103,1.5,-170,7.5,-119,-101,-113,-1.5,148,3.69,Busch Stadium,8,-6
2017-07-29,2017,PHI,ATL,4,3,-111,-1.5,176,9.0,-120,100,101,1.5,-210,4.73,Citizens Bank Park,7,1
2017-07-29,2017,TEX,BAL,0,4,104,1.5,-149,11.0,100,-120,-114,-1.5,129,5.39,Rangers Ballpark,4,-4
2017-07-29,2017,KC,BOS,8,9,135,1.5,-155,8.5,100,-120,-150,-1.5,135,3.62,Fenway Park,17,-1
2017-07-29,2017,MIL,CHC,1,2,158,1.5,-101,10.0,-115,-105,-178,-1.5,-119,3.88,Miller Park,3,-1
2017-07-29,2017,MIA,CIN,7,3,-140,-1.5,140,9.0,-120,100,125,1.5,-160,5.25,Marlins Park,10,4
2017-07-29,2017,CWS,CLE,4,5,270,1.5,158,8.5,-101,-119,-320,-1.5,-183,2.3,Guaranteed Rate Field,9,-1
2017-07-29,2017,WSH,COL,2,4,-143,-1.5,143,8.5,-115,-105,128,1.5,-163,5.0,Nationals Park,6,-2
2017-07-29,2017,CLE,CWS,5,4,-320,-1.5,-183,8.5,-101,-119,270,1.5,158,6.48,Guaranteed Rate Field,9,1
2017-07-29,2017,HOU,DET,3,5,-113,-1.5,140,10.5,-115,-105,103,1.5,-160,5.57,Comerica Park,8,-2
2017-07-29,2017,DET,HOU,5,3,103,1.5,-160,10.5,-115,-105,-113,-1.5,140,5.17,Comerica Park,8,2
2017-07-29,2017,BOS,KC,9,8,-150,-1.5,135,8.5,100,-120,135,1.5,-155,5.1,Fenway Park,17,1
2017-07-29,2017,TOR,LAA,5,6,-121,-1.5,166,9.5,-115,-105,111,1.5,-195,5.2,Rogers Centre,11,-1
2017-07-29,2017,SF,LAD,1,2,260,1.5,120,9.0,105,-125,-310,-1.5,-140,2.5,Dodger Stadium,3,-1
2017-07-29,2017,CIN,MIA,3,7,125,1.5,-160,9.0,-120,100,-140,-1.5,140,4.0,Marlins Park,10,-4
2017-07-29,2017,CHC,MIL,2,1,-178,-1.5,-119,10.0,-115,-105,158,1.5,-101,6.4,Miller Park,3,1
2017-07-29,2017,OAK,MIN,5,4,-101,1.5,-163,9.5,100,-120,-109,-1.5,143,4.77,Oakland Coliseum,9,1
2017-07-29,2017,SEA,NYM,3,2,118,1.5,-140,9.0,-115,-105,-128,-1.5,120,4.13,T-Mobile Park,5,1
2017-07-29,2017,TB,NYY,4,5,150,1.5,-140,9.0,-125,105,-165,-1.5,120,3.6,Yankee Stadium,9,-1
2017-07-29,2017,MIN,OAK,4,5,-109,-1.5,143,9.5,100,-120,-101,1.5,-163,4.95,Oakland Coliseum,9,-1
2017-07-29,2017,ATL,PHI,3,4,101,1.5,-210,9.0,-120,100,-111,-1.5,176,4.48,Citizens Bank Park,7,-1
2017-07-29,2017,SD,PIT,4,2,104,1.5,-162,8.0,-101,-119,-114,-1.5,142,3.92,PETCO Park,6,2
2017-07-29,2017,PIT,SD,2,4,-114,-1.5,142,8.0,-101,-119,104,1.5,-162,4.26,PETCO Park,6,-2
2017-07-29,2017,NYM,SEA,2,3,-128,-1.5,120,9.0,-115,-105,118,1.5,-140,5.05,T-Mobile Park,5,-1
2017-07-29,2017,LAD,SF,2,1,-310,-1.5,-140,9.0,105,-125,260,1.5,120,6.8,Dodger Stadium,3,1
2017-07-29,2017,ARI,STL,7,1,-113,-1.5,148,7.5,-119,-101,103,1.5,-170,3.98,Busch Stadium,8,6
2017-07-29,2017,NYY,TB,5,4,-165,-1.5,120,9.0,-125,105,150,1.5,-140,5.6,Yankee Stadium,9,1
2017-07-29,2017,BAL,TEX,4,0,-114,-1.5,129,11.0,100,-120,104,1.5,-149,5.86,Rangers Ballpark,4,4
2017-07-29,2017,LAA,TOR,6,5,111,1.5,-195,9.5,-115,-105,-121,-1.5,166,4.5,Rogers Centre,11,1
2017-07-29,2017,COL,WSH,4,2,128,1.5,-163,8.5,-115,-105,-143,-1.5,143,3.73,Nationals Park,6,2
2017-07-30,2017,STL,ARI,3,2,-121,-1.5,166,8.5,-120,100,111,1.5,-195,4.65,Busch Stadium,5,1
2017-07-30,2017,PHI,ATL,2,1,-132,-1.5,160,9.0,-120,100,117,1.5,-185,5.12,Citizens Bank Park,3,1
2017-07-30,2017,TEX,BAL,6,10,-112,-1.5,160,11.5,-110,-110,102,1.5,-185,6.08,Rangers Ballpark,16,-4
2017-07-30,2017,KC,BOS,5,3,157,1.5,-135,9.0,-101,-119,-177,-1.5,115,3.5,Fenway Park,8,2
2017-07-30,2017,MIL,CHC,2,4,-111,-1.5,172,9.5,-115,-105,101,1.5,-205,5.0,Miller Park,6,-2
2017-07-30,2017,MIA,CIN,4,6,106,1.5,-160,8.0,-120,100,-116,-1.5,140,3.88,Marlins Park,10,-2
2017-07-30,2017,CWS,CLE,3,1,137,1.5,-125,9.0,-110,-110,-152,-1.5,105,3.8,Guaranteed Rate Field,4,2
2017-07-30,2017,WSH,COL,6,10,-126,-1.5,160,9.0,-101,-119,116,1.5,-185,5.02,Nationals Park,16,-4
2017-07-30,2017,WSH,COL,3,1,-106,1.5,-170,9.0,100,-120,-104,-1.5,148,4.63,Nationals Park,4,2
2017-07-30,2017,CLE,CWS,1,3,-152,-1.5,105,9.0,-110,-110,137,1.5,-125,5.43,Guaranteed Rate Field,4,-2
2017-07-30,2017,HOU,DET,1,13,-112,-1.5,140,9.0,-120,100,102,1.5,-160,4.75,Comerica Park,14,-12
2017-07-30,2017,DET,HOU,13,1,102,1.5,-160,9.0,-120,100,-112,-1.5,140,4.46,Comerica Park,14,12
2017-07-30,2017,BOS,KC,3,5,-177,-1.5,115,9.0,-101,-119,157,1.5,-135,5.75,Fenway Park,8,-2
2017-07-30,2017,TOR,LAA,11,10,-111,-1.5,172,10.0,-115,-105,101,1.5,-205,5.26,Rogers Centre,21,1
2017-07-30,2017,SF,LAD,2,3,139,1.5,-160,8.0,-110,-110,-154,-1.5,140,3.35,Dodger Stadium,5,-1
2017-07-30,2017,CIN,MIA,6,4,-116,-1.5,140,8.0,-120,100,106,1.5,-160,4.3,Marlins Park,10,2
2017-07-30,2017,CHC,MIL,4,2,101,1.5,-205,9.5,-115,-105,-111,-1.5,172,4.73,Miller Park,6,2
2017-07-30,2017,OAK,MIN,6,5,-135,-1.5,144,10.0,100,-120,120,1.5,-165,5.74,Oakland Coliseum,11,1
2017-07-30,2017,SEA,NYM,9,1,-234,-1.5,-123,8.5,-115,-105,204,1.5,103,5.96,T-Mobile Park,10,8
2017-07-30,2017,TB,NYY,5,3,145,1.5,-145,9.0,-115,-105,-160,-1.5,125,3.67,Yankee Stadium,8,2
2017-07-30,2017,MIN,OAK,5,6,120,1.5,-165,10.0,100,-120,-135,-1.5,144,4.55,Oakland Coliseum,11,-1
2017-07-30,2017,ATL,PHI,1,2,117,1.5,-185,9.0,-120,100,-132,-1.5,160,4.15,Citizens Bank Park,3,-1
2017-07-30,2017,SD,PIT,1,7,144,1.5,-115,8.5,100,-120,-159,-1.5,-105,3.48,PETCO Park,8,-6
2017-07-30,2017,PIT,SD,7,1,-159,-1.5,-105,8.5,100,-120,144,1.5,-115,5.22,PETCO Park,8,6
2017-07-30,2017,NYM,SEA,1,9,204,1.5,103,8.5,-115,-105,-234,-1.5,-123,2.8,T-Mobile Park,10,-8
2017-07-30,2017,LAD,SF,3,2,-154,-1.5,140,8.0,-110,-110,139,1.5,-160,4.85,Dodger Stadium,5,1
2017-07-30,2017,ARI,STL,2,3,111,1.5,-195,8.5,-120,100,-121,-1.5,166,4.03,Busch Stadium,5,-1
2017-07-30,2017,NYY,TB,3,5,-160,-1.5,125,9.0,-115,-105,145,1.5,-145,5.54,Yankee Stadium,8,-2
2017-07-30,2017,BAL,TEX,10,6,102,1.5,-185,11.5,-110,-110,-112,-1.5,160,5.69,Rangers Ballpark,16,4
2017-07-30,2017,LAA,TOR,10,11,101,1.5,-205,10.0,-115,-105,-111,-1.5,172,4.98,Rogers Centre,21,-1
2017-07-30,2017,COL,WSH,10,6,116,1.5,-185,9.0,-101,-119,-126,-1.5,160,4.17,Nationals Park,16,4
2017-07-30,2017,COL,WSH,1,3,-104,-1.5,148,9.0,100,-120,-106,1.5,-170,4.59,Nationals Park,4,-2
2017-07-31,2017,PHI,ATL,7,6,-106,-1.5,184,8.5,-115,-105,-104,1.5,-220,4.37,Citizens Bank Park,13,1
2017-07-31,2017,KC,BAL,1,2,-109,-1.5,148,9.5,-105,-115,-101,1.5,-170,4.95,Camden Yards,3,-1
2017-07-31,2017,CLE,BOS,2,6,-127,-1.5,129,10.0,-120,100,117,1.5,-149,5.59,Fenway Park,8,-4
2017-07-31,2017,BOS,CLE,6,2,117,1.5,-149,10.0,-120,100,-127,-1.5,129,4.61,Fenway Park,8,4
2017-07-31,2017,TOR,CWS,6,7,-184,-1.5,-122,10.5,-101,-119,164,1.5,102,6.8,Guaranteed Rate Field,13,-1
2017-07-31,2017,NYY,DET,7,3,-225,-1.5,-112,8.0,-110,-110,195,1.5,-108,5.54,Yankee Stadium,10,4
2017-07-31,2017,TB,HOU,7,14,128,1.5,-160,9.0,100,-120,-143,-1.5,140,3.95,Minute Maid Park,21,-7
2017-07-31,2017,BAL,KC,2,1,-101,1.5,-170,9.5,-105,-115,-109,-1.5,148,4.77,Camden Yards,3,1
2017-07-31,2017,WSH,MIA,1,0,-127,-1.5,120,9.0,100,-120,117,1.5,-140,5.04,Marlins Park,1,1
2017-07-31,2017,DET,NYY,3,7,195,1.5,-108,8.0,-110,-110,-225,-1.5,-112,2.71,Yankee Stadium,10,-4
2017-07-31,2017,SF,OAK,5,8,135,1.5,-155,9.5,-110,-110,-150,-1.5,135,4.04,Oakland Coliseum,13,-3
2017-07-31,2017,ATL,PHI,6,7,-104,1.5,-220,8.5,-115,-105,-106,-1.5,184,4.33,Citizens Bank Park,13,-1
2017-07-31,2017,TEX,SEA,4,6,-105,-1.5,170,10.5,100,-120,-105,1.5,-200,5.38,Rangers Ballpark,10,-2
2017-07-31,2017,OAK,SF,8,5,-150,-1.5,135,9.5,-110,-110,135,1.5,-155,5.7,Oakland Coliseum,13,3
2017-07-31,2017,HOU,TB,14,7,-143,-1.5,140,9.0,100,-120,128,1.5,-160,5.3,Minute Maid Park,21,7
2017-07-31,2017,SEA,TEX,6,4,-105,1.5,-200,10.5,100,-120,-105,-1.5,170,5.38,Rangers Ballpark,10,2
2017-07-31,2017,CWS,TOR,7,6,164,1.5,102,10.5,-101,-119,-184,-1.5,-122,3.98,Guaranteed Rate Field,13,1
2017-07-31,2017,MIA,WSH,0,1,117,1.5,-140,9.0,100,-120,-127,-1.5,120,4.15,Marlins Park,1,-1
2017-08-01,2017,CHC,ARI,16,4,-185,-1.5,105,9.0,-105,-115,165,1.5,-125,5.84,Wrigley Field,20,12
2017-08-01,2017,LAD,ATL,3,2,-172,-1.5,-109,10.0,-115,-105,152,1.5,-111,6.32,Suntrust Park,5,1
2017-08-01,2017,KC,BAL,2,7,112,1.5,-180,9.5,-110,-110,-122,-1.5,155,4.48,Camden Yards,9,-5
2017-08-01,2017,CLE,BOS,10,12,152,1.5,-155,7.0,-125,105,-167,-1.5,135,2.78,Fenway Park,22,-2
2017-08-01,2017,ARI,CHC,4,16,165,1.5,-125,9.0,-105,-115,-185,-1.5,105,3.4,Wrigley Field,20,-12
2017-08-01,2017,PIT,CIN,1,9,-170,-1.5,115,9.0,105,-125,150,1.5,-135,5.67,PNC Park,10,-8
2017-08-01,2017,BOS,CLE,12,10,-167,-1.5,135,7.0,-125,105,152,1.5,-155,4.38,Fenway Park,22,2
2017-08-01,2017,NYM,COL,4,5,103,1.5,-170,12.5,-125,105,-113,-1.5,148,6.16,Coors Field,9,-1
2017-08-01,2017,TOR,CWS,8,4,-223,-1.5,-135,9.5,-105,-115,193,1.5,115,6.56,Guaranteed Rate Field,12,4
2017-08-01,2017,NYY,DET,3,4,-177,-1.5,113,10.0,-120,100,157,1.5,-132,6.39,Yankee Stadium,7,-1
2017-08-01,2017,TB,HOU,6,4,-115,-1.5,130,8.5,-115,-105,105,1.5,-150,4.55,Minute Maid Park,10,2
2017-08-01,2017,BAL,KC,7,2,-122,-1.5,155,9.5,-110,-110,112,1.5,-180,5.22,Camden Yards,9,5
2017-08-01,2017,PHI,LAA,1,7,117,1.5,-205,8.0,-115,-105,-127,-1.5,172,3.69,Angel Stadium,8,-6
2017-08-01,2017,ATL,LAD,2,3,152,1.5,-111,10.0,-115,-105,-172,-1.5,-109,3.97,Suntrust Park,5,-1
2017-08-01,2017,WSH,MIA,6,7,-215,-1.5,-127,8.0,100,-120,185,1.5,107,5.46,Marlins Park,13,-1
2017-08-01,2017,STL,MIL,2,3,106,1.5,-230,8.5,-103,-117,-116,-1.5,192,4.13,Miller Park,5,-1
2017-08-01,2017,SD,MIN,3,0,-105,-1.5,192,8.0,-105,-115,-105,1.5,-230,4.1,PETCO Park,3,3
2017-08-01,2017,COL,NYM,5,4,-113,-1.5,148,12.5,-125,105,103,1.5,-170,6.63,Coors Field,9,1
2017-08-01,2017,DET,NYY,4,3,157,1.5,-132,10.0,-120,100,-177,-1.5,113,3.89,Yankee Stadium,7,1
2017-08-01,2017,SF,OAK,10,4,114,1.5,-205,8.0,-110,-110,-124,-1.5,172,3.74,Oakland Coliseum,14,6
2017-08-01,2017,LAA,PHI,7,1,-127,-1.5,172,8.0,-115,-105,117,1.5,-205,4.48,Angel Stadium,8,6
2017-08-01,2017,CIN,PIT,9,1,150,1.5,-135,9.0,105,-125,-170,-1.5,115,3.6,PNC Park,10,8
2017-08-01,2017,MIN,SD,0,3,-105,1.5,-230,8.0,-105,-115,-105,-1.5,192,4.1,PETCO Park,3,-3
2017-08-01,2017,TEX,SEA,7,8,-105,-1.5,166,11.0,-105,-115,-105,1.5,-195,5.63,Rangers Ballpark,15,-1
2017-08-01,2017,OAK,SF,4,10,-124,-1.5,172,8.0,-110,-110,114,1.5,-205,4.43,Oakland Coliseum,14,-6
2017-08-01,2017,MIL,STL,3,2,-116,-1.5,192,8.5,-103,-117,106,1.5,-230,4.56,Miller Park,5,1
2017-08-01,2017,HOU,TB,4,6,105,1.5,-150,8.5,-115,-105,-115,-1.5,130,4.15,Minute Maid Park,10,-2
2017-08-01,2017,SEA,TEX,8,7,-105,1.5,-195,11.0,-105,-115,-105,-1.5,166,5.63,Rangers Ballpark,15,1
2017-08-01,2017,CWS,TOR,4,8,193,1.5,115,9.5,-105,-115,-223,-1.5,-135,3.24,Guaranteed Rate Field,12,-4
2017-08-01,2017,MIA,WSH,7,6,185,1.5,107,8.0,100,-120,-215,-1.5,-127,2.81,Marlins Park,13,1
2017-08-02,2017,CHC,ARI,0,3,-147,-1.5,148,8.0,-110,-110,132,1.5,-170,4.76,Wrigley Field,3,-3
2017-08-02,2017,LAD,ATL,3,5,-169,-1.5,-110,9.5,-115,-105,154,1.5,-110,5.97,Suntrust Park,8,-2
2017-08-02,2017,KC,BAL,0,6,127,1.5,-155,10.0,-110,-110,-142,-1.5,135,4.41,Camden Yards,6,-6
2017-08-02,2017,ARI,CHC,3,0,132,1.5,-170,8.0,-110,-110,-147,-1.5,148,3.45,Wrigley Field,3,3
2017-08-02,2017,PIT,CIN,2,5,-173,-1.5,115,9.0,-115,-105,153,1.5,-135,5.7,PNC Park,7,-3
2017-08-02,2017,NYM,COL,10,5,117,1.5,-160,13.0,100,-120,-132,-1.5,140,5.99,Coors Field,15,5
2017-08-02,2017,TOR,CWS,5,1,-215,-1.5,-138,10.5,-120,100,185,1.5,118,7.17,Guaranteed Rate Field,6,4
2017-08-02,2017,NYY,DET,0,2,-270,-1.5,-130,9.5,-105,-115,230,1.5,110,6.93,Yankee Stadium,2,-2
2017-08-02,2017,TB,HOU,3,0,187,1.5,-119,8.0,-110,-110,-217,-1.5,-101,2.79,Minute Maid Park,3,3
2017-08-02,2017,BAL,KC,6,0,-142,-1.5,135,10.0,-110,-110,127,1.5,-155,5.87,Camden Yards,6,6
2017-08-02,2017,PHI,LAA,0,7,193,1.5,100,9.0,-115,-105,-223,-1.5,-120,3.07,Angel Stadium,7,-7
2017-08-02,2017,ATL,LAD,5,3,154,1.5,-110,9.5,-115,-105,-169,-1.5,-110,3.74,Suntrust Park,8,2
2017-08-02,2017,WSH,MIA,0,7,-102,1.5,-215,9.5,100,-120,-108,-1.5,180,4.8,Marlins Park,7,-7
2017-08-02,2017,STL,MIL,5,4,105,1.5,-211,8.5,-110,-110,-115,-1.5,177,4.15,Miller Park,9,1
2017-08-02,2017,SD,MIN,2,5,-113,-1.5,180,8.5,-115,-105,103,1.5,-215,4.51,PETCO Park,7,-3
2017-08-02,2017,COL,NYM,5,10,-132,-1.5,140,13.0,100,-120,117,1.5,-160,7.4,Coors Field,15,-5
2017-08-02,2017,DET,NYY,2,0,230,1.5,110,9.5,-105,-115,-270,-1.5,-130,2.88,Yankee Stadium,2,2
2017-08-02,2017,SF,OAK,1,6,-156,-1.5,130,8.5,-117,-103,141,1.5,-150,5.18,AT&T Park,7,-5
2017-08-02,2017,LAA,PHI,7,0,-223,-1.5,-120,9.0,-115,-105,193,1.5,100,6.21,Angel Stadium,7,7
2017-08-02,2017,CIN,PIT,5,2,153,1.5,-135,9.0,-115,-105,-173,-1.5,115,3.56,PNC Park,7,3
2017-08-02,2017,MIN,SD,5,2,103,1.5,-215,8.5,-115,-105,-113,-1.5,180,4.19,PETCO Park,7,3
2017-08-02,2017,TEX,SEA,5,1,-109,-1.5,166,10.0,-119,-101,-101,1.5,-195,5.22,Rangers Ballpark,6,4
2017-08-02,2017,OAK,SF,6,1,141,1.5,-150,8.5,-117,-103,-156,-1.5,130,3.53,AT&T Park,7,5
2017-08-02,2017,MIL,STL,4,5,-115,-1.5,177,8.5,-110,-110,105,1.5,-211,4.55,Miller Park,9,-1
2017-08-02,2017,HOU,TB,0,3,-217,-1.5,-101,8.0,-110,-110,187,1.5,-119,5.48,Minute Maid Park,3,-3
2017-08-02,2017,SEA,TEX,1,5,-101,1.5,-195,10.0,-119,-101,-109,-1.5,166,5.02,Rangers Ballpark,6,-4
2017-08-02,2017,CWS,TOR,1,5,185,1.5,118,10.5,-120,100,-215,-1.5,-138,3.68,Guaranteed Rate Field,6,-4
2017-08-02,2017,MIA,WSH,7,0,-108,-1.5,180,9.5,100,-120,-102,1.5,-215,4.93,Marlins Park,7,7
2017-08-03,2017,CHC,ARI,8,10,-144,-1.5,140,9.0,-110,-110,129,1.5,-160,5.31,Wrigley Field,18,-2
2017-08-03,2017,LAD,ATL,7,4,-232,-1.5,-133,8.5,-104,-116,202,1.5,114,5.94,Suntrust Park,11,3
2017-08-03,2017,DET,BAL,7,5,130,1.5,-160,10.0,-110,-110,-145,-1.5,140,4.35,Camden Yards,12,2
2017-08-03,2017,CWS,BOS,5,9,254,1.5,130,10.0,100,-120,-294,-1.5,-150,2.82,Fenway Park,14,-4
2017-08-03,2017,ARI,CHC,10,8,129,1.5,-160,9.0,-110,-110,-144,-1.5,140,3.93,Wrigley Field,18,2
2017-08-03,2017,PIT,CIN,6,0,-144,-1.5,146,9.0,-101,-119,129,1.5,-167,5.31,PNC Park,6,6
2017-08-03,2017,NYY,CLE,1,5,172,1.5,-128,7.5,-120,100,-192,-1.5,108,2.76,Progressive Field,6,-4
2017-08-03,2017,NYM,COL,4,5,163,1.5,-110,11.0,-120,100,-183,-1.5,-110,4.18,Coors Field,9,-1
2017-08-03,2017,BOS,CWS,9,5,-294,-1.5,-150,10.0,100,-120,254,1.5,130,7.46,Fenway Park,14,4
2017-08-03,2017,BAL,DET,5,7,-145,-1.5,140,10.0,-110,-110,130,1.5,-160,5.92,Camden Yards,12,-2
2017-08-03,2017,TB,HOU,5,3,120,1.5,-173,9.5,-101,-119,-135,-1.5,150,4.32,Minute Maid Park,8,2
2017-08-03,2017,SEA,KC,4,6,123,1.5,-165,9.5,-110,-110,-138,-1.5,144,4.26,Kauffman Stadium,10,-2
2017-08-03,2017,PHI,LAA,4,5,163,1.5,-137,9.0,-115,-105,-183,-1.5,117,3.42,Angel Stadium,9,-1
2017-08-03,2017,ATL,LAD,4,7,202,1.5,114,8.5,-104,-116,-232,-1.5,-133,2.81,Suntrust Park,11,-3
2017-08-03,2017,STL,MIL,1,2,-129,-1.5,125,9.0,100,-120,119,1.5,-145,5.07,Miller Park,3,-1
2017-08-03,2017,TEX,MIN,4,1,113,1.5,-185,9.5,-108,-112,-123,-1.5,160,4.46,Target Field,5,3
2017-08-03,2017,COL,NYM,5,4,-183,-1.5,-110,11.0,-120,100,163,1.5,-110,7.11,Coors Field,9,1
2017-08-03,2017,CLE,NYY,5,1,-192,-1.5,108,7.5,-120,100,172,1.5,-128,4.93,Progressive Field,6,4
2017-08-03,2017,SF,OAK,11,2,-145,-1.5,148,8.5,-120,100,130,1.5,-170,5.03,AT&T Park,13,9
2017-08-03,2017,LAA,PHI,5,4,-183,-1.5,117,9.0,-115,-105,163,1.5,-137,5.82,Angel Stadium,9,1
2017-08-03,2017,CIN,PIT,0,6,129,1.5,-167,9.0,-101,-119,-144,-1.5,146,3.93,PNC Park,6,-6
2017-08-03,2017,KC,SEA,6,4,-138,-1.5,144,9.5,-110,-110,123,1.5,-165,5.51,Kauffman Stadium,10,2
2017-08-03,2017,OAK,SF,2,11,130,1.5,-170,8.5,-120,100,-145,-1.5,148,3.7,AT&T Park,13,-9
2017-08-03,2017,MIL,STL,2,1,119,1.5,-145,9.0,100,-120,-129,-1.5,125,4.11,Miller Park,3,1
2017-08-03,2017,HOU,TB,3,5,-135,-1.5,150,9.5,-101,-119,120,1.5,-173,5.46,Minute Maid Park,8,-2
2017-08-03,2017,MIN,TEX,1,4,-123,-1.5,160,9.5,-108,-112,113,1.5,-185,5.24,Target Field,5,-3
2017-08-04,2017,SF,ARI,1,2,-148,-1.5,144,8.0,-117,-103,133,1.5,-165,4.77,AT&T Park,3,-1
2017-08-04,2017,MIA,ATL,3,5,119,1.5,-180,9.5,-115,-105,-129,-1.5,155,4.34,Suntrust Park,8,-2
2017-08-04,2017,DET,BAL,5,2,140,1.5,-150,8.5,-101,-119,-155,-1.5,130,3.54,Camden Yards,7,3
2017-08-04,2017,CWS,BOS,2,3,184,1.5,-107,9.5,100,-120,-214,-1.5,-113,3.35,Fenway Park,5,-1
2017-08-04,2017,WSH,CHC,4,2,154,1.5,-140,9.0,-110,-110,-174,-1.5,120,3.54,Wrigley Field,6,2
2017-08-04,2017,STL,CIN,2,3,109,1.5,-202,9.5,-105,-115,-119,-1.5,170,4.55,Great American Ballpark,5,-1
2017-08-04,2017,NYY,CLE,2,7,105,1.5,-190,9.0,-110,-110,-115,-1.5,163,4.39,Progressive Field,9,-5
2017-08-04,2017,PHI,COL,3,4,145,1.5,-135,11.5,-105,-115,-160,-1.5,115,4.69,Coors Field,7,-1
2017-08-04,2017,BOS,CWS,3,2,-214,-1.5,-113,9.5,100,-120,184,1.5,-107,6.47,Fenway Park,5,1
2017-08-04,2017,BAL,DET,2,5,-155,-1.5,130,8.5,-101,-119,140,1.5,-150,5.17,Camden Yards,7,-3
2017-08-04,2017,TOR,HOU,7,16,144,1.5,-145,9.0,-108,-112,-159,-1.5,125,3.69,Minute Maid Park,23,-9
2017-08-04,2017,SEA,KC,5,2,-161,-1.5,110,8.0,-111,-109,146,1.5,-130,4.93,Kauffman Stadium,7,3
2017-08-04,2017,OAK,LAA,6,8,122,1.5,-171,9.5,-105,-115,-137,-1.5,148,4.28,Angel Stadium,14,-2
2017-08-04,2017,NYM,LAD,0,6,102,1.5,-170,7.5,100,-120,-112,-1.5,148,3.71,Citi Field,6,-6
2017-08-04,2017,ATL,MIA,5,3,-129,-1.5,155,9.5,-115,-105,119,1.5,-180,5.35,Suntrust Park,8,2
2017-08-04,2017,TB,MIL,0,2,-156,-1.5,135,9.0,-120,100,141,1.5,-155,5.48,Tropicana Field,2,-2
2017-08-04,2017,TEX,MIN,4,8,-106,-1.5,144,10.5,-108,-112,-104,1.5,-165,5.4,Target Field,12,-4
2017-08-04,2017,LAD,NYM,6,0,-112,-1.5,148,7.5,100,-120,102,1.5,-170,3.96,Citi Field,6,6
2017-08-04,2017,CLE,NYY,7,2,-115,-1.5,163,9.0,-110,-110,105,1.5,-190,4.81,Progressive Field,9,5
2017-08-04,2017,LAA,OAK,8,6,-137,-1.5,148,9.5,-105,-115,122,1.5,-171,5.49,Angel Stadium,14,2
2017-08-04,2017,COL,PHI,4,3,-160,-1.5,115,11.5,-105,-115,145,1.5,-135,7.08,Coors Field,7,1
2017-08-04,2017,SD,PIT,6,10,172,1.5,-125,9.0,-110,-110,-192,-1.5,105,3.31,PNC Park,16,-4
2017-08-04,2017,PIT,SD,10,6,-192,-1.5,105,9.0,-110,-110,172,1.5,-125,5.92,PNC Park,16,4
2017-08-04,2017,KC,SEA,2,5,146,1.5,-130,8.0,-111,-109,-161,-1.5,110,3.25,Kauffman Stadium,7,-3
2017-08-04,2017,ARI,SF,2,1,133,1.5,-165,8.0,-117,-103,-148,-1.5,144,3.43,AT&T Park,3,1
2017-08-04,2017,CIN,STL,3,2,-119,-1.5,170,9.5,-105,-115,109,1.5,-202,5.16,Great American Ballpark,5,1
2017-08-04,2017,MIL,TB,2,0,141,1.5,-155,9.0,-120,100,-156,-1.5,135,3.73,Tropicana Field,2,2
2017-08-04,2017,MIN,TEX,8,4,-104,1.5,-165,10.5,-108,-112,-106,-1.5,144,5.35,Target Field,12,4
2017-08-04,2017,HOU,TOR,16,7,-159,-1.5,125,9.0,-108,-112,144,1.5,-145,5.53,Minute Maid Park,23,9
2017-08-04,2017,CHC,WSH,2,4,-174,-1.5,120,9.0,-110,-110,154,1.5,-140,5.72,Wrigley Field,6,-2
2017-08-05,2017,SF,ARI,5,4,138,1.5,-120,8.5,-110,-110,-153,-1.5,100,3.57,AT&T Park,9,1
2017-08-05,2017,MIA,ATL,2,7,119,1.5,-180,9.0,-125,105,-129,-1.5,155,4.11,Suntrust Park,9,-5
2017-08-05,2017,DET,BAL,2,5,151,1.5,-135,11.0,-102,-118,-166,-1.5,115,4.38,Camden Yards,7,-3
2017-08-05,2017,CWS,BOS,1,4,290,1.5,146,9.5,106,-126,-340,-1.5,-168,2.44,Fenway Park,5,-3
2017-08-05,2017,WSH,CHC,4,7,147,1.5,-135,11.0,-110,-110,-162,-1.5,115,4.45,Wrigley Field,11,-3
2017-08-05,2017,STL,CIN,4,1,140,1.5,-170,8.5,-119,-101,-155,-1.5,148,3.54,Great American Ballpark,5,3
2017-08-05,2017,NYY,CLE,2,1,117,1.5,-172,8.5,-110,-110,-127,-1.5,149,3.92,Progressive Field,3,1
2017-08-05,2017,PHI,COL,5,8,175,1.5,-108,11.0,100,-120,-205,-1.5,-112,4.0,Coors Field,13,-3
2017-08-05,2017,BOS,CWS,4,1,-340,-1.5,-168,9.5,106,-126,290,1.5,146,7.34,Fenway Park,5,3
2017-08-05,2017,BAL,DET,5,2,-166,-1.5,115,11.0,-102,-118,151,1.5,-135,6.86,Camden Yards,7,3
2017-08-05,2017,TOR,HOU,4,3,154,1.5,-133,9.0,-119,-101,-174,-1.5,113,3.54,Minute Maid Park,7,1
2017-08-05,2017,OAK,LAA,5,0,157,1.5,-135,9.0,-119,-101,-177,-1.5,115,3.5,Angel Stadium,5,5
2017-08-05,2017,NYM,LAD,4,7,185,1.5,115,9.5,105,-125,-215,-1.5,-135,3.33,Citi Field,11,-3
2017-08-05,2017,ATL,MIA,7,2,-129,-1.5,155,9.0,-125,105,119,1.5,-180,5.07,Suntrust Park,9,5
2017-08-05,2017,TB,MIL,0,3,-155,-1.5,130,9.0,100,-120,140,1.5,-150,5.47,Tropicana Field,3,-3
2017-08-05,2017,TEX,MIN,4,1,-129,-1.5,125,9.5,-115,-105,119,1.5,-145,5.35,Target Field,5,3
2017-08-05,2017,LAD,NYM,7,4,-215,-1.5,-135,9.5,105,-125,185,1.5,115,6.48,Citi Field,11,3
2017-08-05,2017,CLE,NYY,1,2,-127,-1.5,149,8.5,-110,-110,117,1.5,-172,4.76,Progressive Field,3,-1
2017-08-05,2017,LAA,OAK,0,5,-177,-1.5,115,9.0,-119,-101,157,1.5,-135,5.75,Angel Stadium,5,-5
2017-08-05,2017,COL,PHI,8,5,-205,-1.5,-112,11.0,100,-120,175,1.5,-108,7.39,Coors Field,13,3
2017-08-05,2017,SD,PIT,5,2,145,1.5,-165,7.5,-105,-115,-160,-1.5,144,3.06,PNC Park,7,3
2017-08-05,2017,PIT,SD,2,5,-160,-1.5,144,7.5,-105,-115,145,1.5,-165,4.62,PNC Park,7,-3
2017-08-05,2017,ARI,SF,4,5,-153,-1.5,100,8.5,-110,-110,138,1.5,-120,5.14,AT&T Park,9,-1
2017-08-05,2017,CIN,STL,1,4,-155,-1.5,148,8.5,-119,-101,140,1.5,-170,5.17,Great American Ballpark,5,-3
2017-08-05,2017,MIL,TB,3,0,140,1.5,-150,9.0,100,-120,-155,-1.5,130,3.75,Tropicana Field,3,3
2017-08-05,2017,MIN,TEX,1,4,119,1.5,-145,9.5,-115,-105,-129,-1.5,125,4.34,Target Field,5,-3
2017-08-05,2017,HOU,TOR,3,4,-174,-1.5,113,9.0,-119,-101,154,1.5,-133,5.72,Minute Maid Park,7,-1
2017-08-05,2017,CHC,WSH,7,4,-162,-1.5,115,11.0,-110,-110,147,1.5,-135,6.8,Wrigley Field,11,3
2017-08-06,2017,SF,ARI,6,3,101,1.5,-168,8.0,102,-122,-111,-1.5,146,3.98,AT&T Park,9,3
2017-08-06,2017,MIA,ATL,4,1,122,1.5,-165,9.5,-115,-105,-137,-1.5,144,4.28,Suntrust Park,5,3
2017-08-06,2017,DET,BAL,3,12,142,1.5,-140,10.0,-110,-110,-157,-1.5,120,4.13,Camden Yards,15,-9
2017-08-06,2017,CWS,BOS,3,6,193,1.5,-110,10.5,-110,-110,-223,-1.5,-110,3.58,Fenway Park,9,-3
2017-08-06,2017,WSH,CHC,9,4,170,1.5,-105,9.0,-125,105,-200,-1.5,-115,3.33,Wrigley Field,13,5
2017-08-06,2017,STL,CIN,13,4,104,1.5,-200,9.5,100,-120,-114,-1.5,170,4.66,Great American Ballpark,17,9
2017-08-06,2017,NYY,CLE,8,1,107,1.5,-205,7.5,-104,-116,-117,-1.5,172,3.62,Progressive Field,9,7
2017-08-06,2017,PHI,COL,3,2,101,1.5,-190,11.0,100,-120,-111,-1.5,163,5.47,Coors Field,5,1
2017-08-06,2017,BOS,CWS,6,3,-223,-1.5,-110,10.5,-110,-110,193,1.5,-110,7.25,Fenway Park,9,3
2017-08-06,2017,BAL,DET,12,3,-157,-1.5,120,10.0,-110,-110,142,1.5,-140,6.11,Camden Yards,15,9
2017-08-06,2017,TOR,HOU,6,7,-105,1.5,-210,9.0,101,-121,-105,-1.5,176,4.61,Minute Maid Park,13,-1
2017-08-06,2017,SEA,KC,8,7,120,1.5,-170,8.5,-105,-115,-135,-1.5,148,3.86,Kauffman Stadium,15,1
2017-08-06,2017,SEA,KC,1,9,108,1.5,-210,9.0,-115,-105,-118,-1.5,176,4.33,Kauffman Stadium,10,-8
2017-08-06,2017,OAK,LAA,11,10,121,1.5,-180,9.0,-105,-115,-136,-1.5,155,4.07,Angel Stadium,21,1
2017-08-06,2017,NYM,LAD,0,8,150,1.5,-112,8.5,-119,-101,-170,-1.5,-108,3.4,Citi Field,8,-8
2017-08-06,2017,ATL,MIA,1,4,-137,-1.5,144,9.5,-115,-105,122,1.5,-165,5.49,Suntrust Park,5,-3
2017-08-06,2017,TB,MIL,2,1,-172,-1.5,120,7.5,-101,-119,152,1.5,-140,4.74,Tropicana Field,3,1
2017-08-06,2017,TEX,MIN,5,6,125,1.5,-160,10.5,-105,-115,-140,-1.5,140,4.67,Target Field,11,-1
2017-08-06,2017,LAD,NYM,8,0,-170,-1.5,-108,8.5,-119,-101,150,1.5,-112,5.35,Citi Field,8,8
2017-08-06,2017,CLE,NYY,1,8,-117,-1.5,172,7.5,-104,-116,107,1.5,-205,4.04,Progressive Field,9,-7
2017-08-06,2017,LAA,OAK,10,11,-136,-1.5,155,9.0,-105,-115,121,1.5,-180,5.19,Angel Stadium,21,-1
2017-08-06,2017,COL,PHI,2,3,-111,-1.5,163,11.0,100,-120,101,1.5,-190,5.79,Coors Field,5,-1
2017-08-06,2017,SD,PIT,4,5,170,1.5,-130,8.5,-105,-115,-190,-1.5,110,3.15,PNC Park,9,-1
2017-08-06,2017,PIT,SD,5,4,-190,-1.5,110,8.5,-105,-115,170,1.5,-130,5.57,PNC Park,9,1
2017-08-06,2017,KC,SEA,7,8,-135,-1.5,148,8.5,-105,-115,120,1.5,-170,4.88,Kauffman Stadium,15,-1
2017-08-06,2017,KC,SEA,9,1,-118,-1.5,176,9.0,-115,-105,108,1.5,-210,4.87,Kauffman Stadium,10,8
2017-08-06,2017,ARI,SF,3,6,-111,-1.5,146,8.0,102,-122,101,1.5,-168,4.21,AT&T Park,9,-3
2017-08-06,2017,CIN,STL,4,13,-114,-1.5,170,9.5,100,-120,104,1.5,-200,5.06,Great American Ballpark,17,-9
2017-08-06,2017,MIL,TB,1,2,152,1.5,-140,7.5,-101,-119,-172,-1.5,120,2.98,Tropicana Field,3,-1
2017-08-06,2017,MIN,TEX,6,5,-140,-1.5,140,10.5,-105,-115,125,1.5,-160,6.13,Target Field,11,1
2017-08-06,2017,HOU,TOR,7,6,-105,-1.5,176,9.0,101,-121,-105,1.5,-210,4.61,Minute Maid Park,13,1
2017-08-06,2017,CHC,WSH,4,9,-200,-1.5,-115,9.0,-125,105,170,1.5,-105,6.0,Wrigley Field,13,-5
2017-08-07,2017,LAA,BAL,2,6,-153,-1.5,140,9.0,-114,-106,138,1.5,-160,5.44,Angel Stadium,8,-4
2017-08-07,2017,SF,CHC,3,5,160,1.5,100,8.0,-101,-119,-180,-1.5,-120,3.08,AT&T Park,8,-2
2017-08-07,2017,SD,CIN,3,11,120,1.5,-175,9.5,-105,-115,-135,-1.5,151,4.32,Great American Ballpark,14,-8
2017-08-07,2017,PIT,DET,3,0,-173,-1.5,120,8.5,-116,-104,153,1.5,-140,5.39,PNC Park,3,3
2017-08-07,2017,STL,KC,11,3,-124,-1.5,140,8.5,-110,-110,114,1.5,-160,4.71,Kauffman Stadium,14,8
2017-08-07,2017,BAL,LAA,6,2,138,1.5,-160,9.0,-114,-106,-153,-1.5,140,3.78,Angel Stadium,8,4
2017-08-07,2017,WSH,MIA,3,2,-289,-1.5,-160,8.5,-116,-104,249,1.5,140,6.31,Nationals Park,5,1
2017-08-07,2017,MIN,MIL,5,4,-101,1.5,-162,9.0,-120,100,-109,-1.5,142,4.52,Target Field,9,1
2017-08-07,2017,MIL,MIN,4,5,-109,-1.5,142,9.0,-120,100,-101,1.5,-162,4.69,Target Field,9,-1
2017-08-07,2017,DET,PIT,0,3,153,1.5,-140,8.5,-116,-104,-173,-1.5,120,3.36,PNC Park,3,-3
2017-08-07,2017,CIN,SD,11,3,-135,-1.5,151,9.5,-105,-115,120,1.5,-175,5.46,Great American Ballpark,14,8
2017-08-07,2017,CHC,SF,5,3,-180,-1.5,-120,8.0,-101,-119,160,1.5,100,5.14,AT&T Park,8,2
2017-08-07,2017,KC,STL,3,11,114,1.5,-160,8.5,-110,-110,-124,-1.5,140,3.97,Kauffman Stadium,14,-8
2017-08-07,2017,MIA,WSH,2,3,249,1.5,140,8.5,-116,-104,-289,-1.5,-160,2.44,Nationals Park,5,-1
2017-08-08,2017,LAD,ARI,3,6,-121,-1.5,130,9.5,-110,-110,111,1.5,-150,5.2,Chase Field,9,-3
2017-08-08,2017,PHI,ATL,5,2,155,1.5,-130,9.5,-115,-105,-175,-1.5,110,3.73,Suntrust Park,7,3
2017-08-08,2017,LAA,BAL,3,2,-123,-1.5,163,9.0,-125,105,113,1.5,-190,4.96,Angel Stadium,5,1
2017-08-08,2017,TB,BOS,0,2,181,1.5,105,7.0,-115,-105,-211,-1.5,-125,2.49,Tropicana Field,2,-2
2017-08-08,2017,SF,CHC,6,3,173,1.5,105,7.5,-110,-110,-203,-1.5,-125,2.75,AT&T Park,9,3
2017-08-08,2017,SD,CIN,7,3,116,1.5,-175,9.0,100,-120,-131,-1.5,151,4.17,Great American Ballpark,10,4
2017-08-08,2017,COL,CLE,1,4,220,1.5,100,8.0,-110,-110,-260,-1.5,-120,2.5,Progressive Field,5,-3
2017-08-08,2017,CLE,COL,4,1,-260,-1.5,-120,8.0,-110,-110,220,1.5,100,5.78,Progressive Field,5,3
2017-08-08,2017,HOU,CWS,5,8,-255,-1.5,-155,9.5,-120,100,215,1.5,135,6.82,Guaranteed Rate Field,13,-3
2017-08-08,2017,PIT,DET,6,3,-174,-1.5,120,8.5,-115,-105,154,1.5,-140,5.4,PNC Park,9,3
2017-08-08,2017,CWS,HOU,8,5,215,1.5,135,9.5,-120,100,-255,-1.5,-155,3.02,Guaranteed Rate Field,13,3
2017-08-08,2017,STL,KC,10,3,-131,-1.5,125,8.5,-120,100,116,1.5,-145,4.82,Kauffman Stadium,13,7
2017-08-08,2017,BAL,LAA,2,3,113,1.5,-190,9.0,-125,105,-123,-1.5,163,4.23,Angel Stadium,5,-1
2017-08-08,2017,ARI,LAD,6,3,111,1.5,-150,9.5,-110,-110,-121,-1.5,130,4.5,Chase Field,9,3
2017-08-08,2017,WSH,MIA,3,7,-140,-1.5,135,9.5,100,-120,125,1.5,-155,5.54,Nationals Park,10,-4
2017-08-08,2017,MIN,MIL,11,4,-143,-1.5,140,10.0,-125,105,128,1.5,-160,5.88,Target Field,15,7
2017-08-08,2017,MIL,MIN,4,11,128,1.5,-160,10.0,-125,105,-143,-1.5,140,4.39,Target Field,15,-7
2017-08-08,2017,TEX,NYM,4,5,-109,-1.5,151,9.5,-110,-110,-101,1.5,-175,4.95,Citi Field,9,-1
2017-08-08,2017,TOR,NYY,4,2,-143,-1.5,135,9.0,-125,105,128,1.5,-155,5.3,Rogers Centre,6,2
2017-08-08,2017,SEA,OAK,7,6,-119,-1.5,135,9.0,-115,-105,109,1.5,-155,4.89,Oakland Coliseum,13,1
2017-08-08,2017,ATL,PHI,2,5,-175,-1.5,110,9.5,-115,-105,155,1.5,-130,6.05,Suntrust Park,7,-3
2017-08-08,2017,DET,PIT,3,6,154,1.5,-140,8.5,-115,-105,-174,-1.5,120,3.35,PNC Park,9,-3
2017-08-08,2017,CIN,SD,3,7,-131,-1.5,151,9.0,100,-120,116,1.5,-175,5.1,Great American Ballpark,10,-4
2017-08-08,2017,OAK,SEA,6,7,109,1.5,-155,9.0,-115,-105,-119,-1.5,135,4.31,Oakland Coliseum,13,-1
2017-08-08,2017,CHC,SF,3,6,-203,-1.5,-125,7.5,-110,-110,173,1.5,105,5.02,AT&T Park,9,-3
2017-08-08,2017,KC,STL,3,10,116,1.5,-145,8.5,-120,100,-131,-1.5,125,3.94,Kauffman Stadium,13,-7
2017-08-08,2017,BOS,TB,2,0,-211,-1.5,-125,7.0,-115,-105,181,1.5,105,4.75,Tropicana Field,2,2
2017-08-08,2017,NYM,TEX,5,4,-101,1.5,-175,9.5,-110,-110,-109,-1.5,151,4.77,Citi Field,9,1
2017-08-08,2017,NYY,TOR,2,4,128,1.5,-155,9.0,-125,105,-143,-1.5,135,3.95,Rogers Centre,6,-2
2017-08-08,2017,MIA,WSH,7,3,125,1.5,-155,9.5,100,-120,-140,-1.5,135,4.22,Nationals Park,10,4
2017-08-09,2017,LAD,ARI,3,2,-104,-1.5,155,9.0,-110,-110,-106,1.5,-180,4.59,Chase Field,5,1
2017-08-09,2017,PHI,ATL,3,2,140,1.5,-150,9.0,-120,100,-155,-1.5,130,3.75,Suntrust Park,5,1
2017-08-09,2017,LAA,BAL,5,1,115,1.5,-145,9.0,-117,-103,-130,-1.5,125,4.19,Angel Stadium,6,4
2017-08-09,2017,TB,BOS,2,8,101,1.5,-157,8.5,-115,-105,-111,-1.5,137,4.23,Tropicana Field,10,-6
2017-08-09,2017,SF,CHC,3,1,-124,-1.5,170,7.0,-125,105,114,1.5,-200,3.88,AT&T Park,4,2
2017-08-09,2017,SD,CIN,3,8,113,1.5,-195,9.0,-112,-108,-123,-1.5,166,4.23,Great American Ballpark,11,-5
2017-08-09,2017,COL,CLE,3,2,167,1.5,-130,9.0,-113,-107,-187,-1.5,110,3.37,Progressive Field,5,1
2017-08-09,2017,CLE,COL,2,3,-187,-1.5,110,9.0,-113,-107,167,1.5,-130,5.86,Progressive Field,5,-1
2017-08-09,2017,HOU,CWS,1,7,-222,-1.5,-144,10.0,-110,-110,192,1.5,124,6.89,Guaranteed Rate Field,8,-6
2017-08-09,2017,PIT,DET,0,10,110,1.5,-205,9.0,-101,-119,-120,-1.5,172,4.29,Comerica Park,10,-10
2017-08-09,2017,CWS,HOU,7,1,192,1.5,124,10.0,-110,-110,-222,-1.5,-144,3.42,Guaranteed Rate Field,8,6
2017-08-09,2017,STL,KC,8,5,-141,-1.5,151,8.5,-102,-118,126,1.5,-175,4.97,Busch Stadium,13,3
2017-08-09,2017,BAL,LAA,1,5,-130,-1.5,125,9.0,-117,-103,115,1.5,-145,5.09,Angel Stadium,6,-4
2017-08-09,2017,ARI,LAD,2,3,-106,1.5,-180,9.0,-110,-110,-104,-1.5,155,4.63,Chase Field,5,-1
2017-08-09,2017,WSH,MIA,10,1,-178,-1.5,111,9.0,-105,-115,158,1.5,-131,5.76,Nationals Park,11,9
2017-08-09,2017,MIN,MIL,4,0,145,1.5,-150,9.5,-105,-115,-160,-1.5,130,3.88,Miller Park,4,4
2017-08-09,2017,MIL,MIN,0,4,-160,-1.5,130,9.5,-105,-115,145,1.5,-150,5.85,Miller Park,4,-4
2017-08-09,2017,TEX,NYM,5,1,104,1.5,-200,9.5,-108,-112,-114,-1.5,170,4.66,Citi Field,6,4
2017-08-09,2017,TOR,NYY,5,11,175,1.5,105,9.0,-105,-115,-195,-1.5,-125,3.27,Rogers Centre,16,-6
2017-08-09,2017,SEA,OAK,6,3,-101,1.5,-208,9.5,-120,100,-109,-1.5,174,4.77,Oakland Coliseum,9,3
2017-08-09,2017,ATL,PHI,2,3,-155,-1.5,130,9.0,-120,100,140,1.5,-150,5.47,Suntrust Park,5,-1
2017-08-09,2017,DET,PIT,10,0,-120,-1.5,172,9.0,-101,-119,110,1.5,-205,4.91,Comerica Park,10,10
2017-08-09,2017,CIN,SD,8,3,-123,-1.5,166,9.0,-112,-108,113,1.5,-195,4.96,Great American Ballpark,11,5
2017-08-09,2017,OAK,SEA,3,6,-109,-1.5,174,9.5,-120,100,-101,1.5,-208,4.95,Oakland Coliseum,9,-3
2017-08-09,2017,CHC,SF,1,3,114,1.5,-200,7.0,-125,105,-124,-1.5,170,3.27,AT&T Park,4,-2
2017-08-09,2017,KC,STL,5,8,126,1.5,-175,8.5,-102,-118,-141,-1.5,151,3.76,Busch Stadium,13,-3
2017-08-09,2017,BOS,TB,8,2,-111,-1.5,137,8.5,-115,-105,101,1.5,-157,4.47,Tropicana Field,10,6
2017-08-09,2017,NYM,TEX,1,5,-114,-1.5,170,9.5,-108,-112,104,1.5,-200,5.06,Citi Field,6,-4
2017-08-09,2017,NYY,TOR,11,5,-195,-1.5,-125,9.0,-105,-115,175,1.5,105,5.95,Rogers Centre,16,6
2017-08-09,2017,MIA,WSH,1,10,158,1.5,-131,9.0,-105,-115,-178,-1.5,111,3.49,Nationals Park,11,-9
2017-08-10,2017,LAD,ARI,8,6,-174,-1.5,-114,9.0,-120,100,154,1.5,-106,5.72,Chase Field,14,2
2017-08-10,2017,OAK,BAL,2,7,103,1.5,-161,9.5,-115,-105,-113,-1.5,141,4.68,Oakland Coliseum,9,-5
2017-08-10,2017,SD,CIN,3,10,138,1.5,-160,8.5,-125,105,-153,-1.5,140,3.57,Great American Ballpark,13,-7
2017-08-10,2017,TB,CLE,4,1,116,1.5,-145,8.0,-110,-110,-131,-1.5,125,3.7,Tropicana Field,5,3
2017-08-10,2017,HOU,CWS,2,3,-164,-1.5,-106,9.0,-115,-105,149,1.5,-114,5.59,Guaranteed Rate Field,5,-1
2017-08-10,2017,PIT,DET,7,5,-170,-1.5,-110,10.0,100,-120,150,1.5,-110,6.3,Comerica Park,12,2
2017-08-10,2017,CWS,HOU,3,2,149,1.5,-114,9.0,-115,-105,-164,-1.5,-106,3.61,Guaranteed Rate Field,5,1
2017-08-10,2017,STL,KC,8,6,-143,-1.5,144,9.0,105,-125,128,1.5,-165,5.3,Busch Stadium,14,2
2017-08-10,2017,SEA,LAA,3,6,-192,-1.5,-105,8.0,-105,-115,172,1.5,-115,5.26,T-Mobile Park,9,-3
2017-08-10,2017,ARI,LAD,6,8,154,1.5,-106,9.0,-120,100,-174,-1.5,-114,3.54,Chase Field,14,-2
2017-08-10,2017,WSH,MIA,3,2,-154,-1.5,135,9.0,-105,-115,139,1.5,-155,5.46,Nationals Park,5,1
2017-08-10,2017,MIN,MIL,7,2,138,1.5,-160,9.5,100,-120,-153,-1.5,140,3.99,Miller Park,9,5
2017-08-10,2017,MIL,MIN,2,7,-153,-1.5,140,9.5,100,-120,138,1.5,-160,5.75,Miller Park,9,-5
2017-08-10,2017,PHI,NYM,0,10,142,1.5,-121,8.5,-111,-109,-157,-1.5,101,3.51,Citizens Bank Park,10,-10
2017-08-10,2017,TOR,NYY,4,0,133,1.5,-125,9.0,105,-125,-148,-1.5,105,3.86,Rogers Centre,4,4
2017-08-10,2017,BAL,OAK,7,2,-113,-1.5,141,9.5,-115,-105,103,1.5,-161,5.04,Oakland Coliseum,9,5
2017-08-10,2017,NYM,PHI,10,0,-157,-1.5,101,8.5,-111,-109,142,1.5,-121,5.19,Citizens Bank Park,10,10
2017-08-10,2017,DET,PIT,5,7,150,1.5,-110,10.0,100,-120,-170,-1.5,-110,4.0,Comerica Park,12,-2
2017-08-10,2017,CIN,SD,10,3,-153,-1.5,140,8.5,-125,105,138,1.5,-160,5.14,Great American Ballpark,13,7
2017-08-10,2017,LAA,SEA,6,3,172,1.5,-115,8.0,-105,-115,-192,-1.5,-105,2.94,T-Mobile Park,9,3
2017-08-10,2017,KC,STL,6,8,128,1.5,-165,9.0,105,-125,-143,-1.5,144,3.95,Busch Stadium,14,-2
2017-08-10,2017,CLE,TB,1,4,-131,-1.5,125,8.0,-110,-110,116,1.5,-145,4.54,Tropicana Field,5,-3
2017-08-10,2017,NYY,TOR,0,4,-148,-1.5,105,9.0,105,-125,133,1.5,-125,5.37,Rogers Centre,4,-4
2017-08-10,2017,MIA,WSH,2,3,139,1.5,-155,9.0,-105,-115,-154,-1.5,135,3.77,Nationals Park,5,-1
2017-08-11,2017,CHC,ARI,8,3,106,1.5,-200,10.5,100,-120,-116,-1.5,170,5.1,Chase Field,11,5
2017-08-11,2017,STL,ATL,8,5,-160,-1.5,135,8.5,-110,-110,145,1.5,-155,5.23,Busch Stadium,13,3
2017-08-11,2017,OAK,BAL,5,4,103,1.5,-155,9.5,-105,-115,-113,-1.5,135,4.68,Oakland Coliseum,9,1
2017-08-11,2017,NYY,BOS,5,4,-121,-1.5,155,9.0,100,-120,111,1.5,-180,4.93,Yankee Stadium,9,1
2017-08-11,2017,ARI,CHC,3,8,-116,-1.5,170,10.5,100,-120,106,1.5,-200,5.64,Chase Field,11,-5
2017-08-11,2017,MIL,CIN,10,11,-187,-1.5,105,9.0,100,-120,167,1.5,-125,5.86,Miller Park,21,-1
2017-08-11,2017,TB,CLE,0,5,114,1.5,-150,8.0,100,-120,-124,-1.5,130,3.74,Tropicana Field,5,-5
2017-08-11,2017,MIA,COL,6,3,102,1.5,-160,8.5,100,-120,-112,-1.5,140,4.21,Marlins Park,9,3
2017-08-11,2017,KC,CWS,3,6,-127,-1.5,135,9.0,100,-120,117,1.5,-155,5.04,Guaranteed Rate Field,9,-3
2017-08-11,2017,MIN,DET,9,4,-107,-1.5,144,10.5,-105,-115,-103,1.5,-165,5.43,Comerica Park,13,5
2017-08-11,2017,TEX,HOU,6,4,106,1.5,-155,10.5,-115,-105,-116,-1.5,135,5.1,Rangers Ballpark,10,2
2017-08-11,2017,CWS,KC,6,3,117,1.5,-155,9.0,100,-120,-127,-1.5,135,4.15,Guaranteed Rate Field,9,3
2017-08-11,2017,SEA,LAA,5,6,-140,-1.5,155,10.0,-115,-105,125,1.5,-180,5.83,T-Mobile Park,11,-1
2017-08-11,2017,SD,LAD,4,3,240,1.5,116,8.5,-105,-115,-280,-1.5,-136,2.5,Dodger Stadium,7,1
2017-08-11,2017,COL,MIA,3,6,-112,-1.5,140,8.5,100,-120,102,1.5,-160,4.49,Marlins Park,9,-3
2017-08-11,2017,CIN,MIL,11,10,167,1.5,-125,9.0,100,-120,-187,-1.5,105,3.37,Miller Park,21,1
2017-08-11,2017,DET,MIN,4,9,-103,1.5,-165,10.5,-105,-115,-107,-1.5,144,5.33,Comerica Park,13,-5
2017-08-11,2017,PHI,NYM,6,7,-109,-1.5,172,9.5,-101,-119,-101,1.5,-205,4.95,Citizens Bank Park,13,-1
2017-08-11,2017,BOS,NYY,4,5,111,1.5,-180,9.0,100,-120,-121,-1.5,155,4.27,Yankee Stadium,9,-1
2017-08-11,2017,BAL,OAK,4,5,-113,-1.5,135,9.5,-105,-115,103,1.5,-155,5.04,Oakland Coliseum,9,-1
2017-08-11,2017,NYM,PHI,7,6,-101,1.5,-205,9.5,-101,-119,-109,-1.5,172,4.77,Citizens Bank Park,13,1
2017-08-11,2017,TOR,PIT,2,4,-135,-1.5,151,8.5,-110,-110,120,1.5,-175,4.88,Rogers Centre,6,-2
2017-08-11,2017,LAD,SD,3,4,-280,-1.5,-136,8.5,-105,-115,240,1.5,116,6.26,Dodger Stadium,7,-1
2017-08-11,2017,LAA,SEA,6,5,125,1.5,-180,10.0,-115,-105,-140,-1.5,155,4.44,T-Mobile Park,11,1
2017-08-11,2017,ATL,STL,5,8,145,1.5,-155,8.5,-110,-110,-160,-1.5,135,3.47,Busch Stadium,13,-3
2017-08-11,2017,CLE,TB,5,0,-124,-1.5,130,8.0,100,-120,114,1.5,-150,4.43,Tropicana Field,5,5
2017-08-11,2017,HOU,TEX,4,6,-116,-1.5,135,10.5,-115,-105,106,1.5,-155,5.64,Rangers Ballpark,10,-2
2017-08-11,2017,PIT,TOR,4,2,120,1.5,-175,8.5,-110,-110,-135,-1.5,151,3.86,Rogers Centre,6,2
2017-08-12,2017,CHC,ARI,2,6,104,1.5,-200,9.0,-125,105,-114,-1.5,170,4.41,Chase Field,8,-4
2017-08-12,2017,STL,ATL,6,5,-240,-1.5,-123,9.0,-105,-115,200,1.5,103,6.35,Busch Stadium,11,1
2017-08-12,2017,OAK,BAL,5,12,-103,1.5,-165,8.5,-125,105,-107,-1.5,144,4.31,Oakland Coliseum,17,-7
2017-08-12,2017,NYY,BOS,5,10,-183,-1.5,101,8.0,100,-120,163,1.5,-121,5.17,Yankee Stadium,15,-5
2017-08-12,2017,ARI,CHC,6,2,-114,-1.5,170,9.0,-125,105,104,1.5,-200,4.79,Chase Field,8,4
2017-08-12,2017,MIL,CIN,6,5,-156,-1.5,135,9.0,-120,100,141,1.5,-155,5.48,Miller Park,11,1
2017-08-12,2017,TB,CLE,0,3,-155,-1.5,130,8.0,100,-120,140,1.5,-150,4.86,Tropicana Field,3,-3
2017-08-12,2017,MIA,COL,4,3,-101,1.5,-165,9.0,-117,-103,-109,-1.5,144,4.52,Marlins Park,7,1
2017-08-12,2017,KC,CWS,5,4,-153,-1.5,106,10.0,-105,-115,138,1.5,-126,6.05,Guaranteed Rate Field,9,1
2017-08-12,2017,MIN,DET,11,12,-116,-1.5,135,9.5,-103,-117,106,1.5,-155,5.1,Comerica Park,23,-1
2017-08-12,2017,TEX,HOU,8,3,109,1.5,-148,11.0,-115,-105,-119,-1.5,128,5.26,Rangers Ballpark,11,5
2017-08-12,2017,CWS,KC,4,5,138,1.5,-126,10.0,-105,-115,-153,-1.5,106,4.2,Guaranteed Rate Field,9,-1
2017-08-12,2017,SEA,LAA,3,6,-160,-1.5,125,9.5,-105,-115,145,1.5,-145,5.85,T-Mobile Park,9,-3
2017-08-12,2017,SD,LAD,3,6,205,1.5,101,8.5,-115,-105,-245,-1.5,-121,2.79,Dodger Stadium,9,-3
2017-08-12,2017,COL,MIA,3,4,-109,-1.5,144,9.0,-117,-103,-101,1.5,-165,4.69,Marlins Park,7,-1
2017-08-12,2017,CIN,MIL,5,6,141,1.5,-155,9.0,-120,100,-156,-1.5,135,3.73,Miller Park,11,-1
2017-08-12,2017,DET,MIN,12,11,106,1.5,-155,9.5,-103,-117,-116,-1.5,135,4.61,Comerica Park,23,1
2017-08-12,2017,PHI,NYM,3,1,-150,-1.5,140,8.5,100,-120,135,1.5,-160,5.1,Citizens Bank Park,4,2
2017-08-12,2017,BOS,NYY,10,5,163,1.5,-121,8.0,100,-120,-183,-1.5,101,3.04,Yankee Stadium,15,5
2017-08-12,2017,BAL,OAK,12,5,-107,-1.5,144,8.5,-125,105,-103,1.5,-165,4.39,Oakland Coliseum,17,7
2017-08-12,2017,NYM,PHI,1,3,135,1.5,-160,8.5,100,-120,-150,-1.5,140,3.62,Citizens Bank Park,4,-2
2017-08-12,2017,TOR,PIT,7,2,111,1.5,-155,10.0,100,-120,-121,-1.5,135,4.74,Rogers Centre,9,5
2017-08-12,2017,LAD,SD,6,3,-245,-1.5,-121,8.5,-115,-105,205,1.5,101,6.04,Dodger Stadium,9,3
2017-08-12,2017,LAA,SEA,6,3,145,1.5,-145,9.5,-105,-115,-160,-1.5,125,3.88,T-Mobile Park,9,3
2017-08-12,2017,WSH,SF,3,1,-129,-1.5,163,9.5,100,-120,119,1.5,-190,5.35,Nationals Park,4,2
2017-08-12,2017,ATL,STL,5,6,200,1.5,103,9.0,-105,-115,-240,-1.5,-123,3.0,Busch Stadium,11,-1
2017-08-12,2017,CLE,TB,3,0,140,1.5,-150,8.0,100,-120,-155,-1.5,130,3.33,Tropicana Field,3,3
2017-08-12,2017,HOU,TEX,3,8,-119,-1.5,128,11.0,-115,-105,109,1.5,-148,5.98,Rangers Ballpark,11,-5
2017-08-12,2017,PIT,TOR,2,7,-121,-1.5,135,10.0,100,-120,111,1.5,-155,5.48,Rogers Centre,9,-5
2017-08-12,2017,SF,WSH,1,3,119,1.5,-190,9.5,100,-120,-129,-1.5,163,4.34,Nationals Park,4,-2
2017-08-13,2017,CHC,ARI,7,2,-105,-1.5,148,9.0,-115,-105,-105,1.5,-170,4.61,Chase Field,9,5
2017-08-13,2017,STL,ATL,3,6,-190,-1.5,101,8.5,-110,-110,170,1.5,-121,5.57,Busch Stadium,9,-3
2017-08-13,2017,OAK,BAL,9,3,-101,1.5,-164,9.5,100,-120,-109,-1.5,143,4.77,Oakland Coliseum,12,6
2017-08-13,2017,NYY,BOS,2,3,143,1.5,-120,7.5,-110,-110,-158,-1.5,100,3.09,Yankee Stadium,5,-1
2017-08-13,2017,ARI,CHC,2,7,-105,1.5,-170,9.0,-115,-105,-105,-1.5,148,4.61,Chase Field,9,-5
2017-08-13,2017,MIL,CIN,7,4,-117,-1.5,172,10.5,-110,-110,107,1.5,-205,5.66,Miller Park,11,3
2017-08-13,2017,TB,CLE,3,4,151,1.5,-110,7.0,-125,105,-166,-1.5,-110,2.79,Tropicana Field,7,-1
2017-08-13,2017,MIA,COL,5,3,102,1.5,-165,8.5,-115,-105,-112,-1.5,144,4.21,Marlins Park,8,2
2017-08-13,2017,KC,CWS,14,6,-140,-1.5,115,10.0,-115,-105,125,1.5,-135,5.83,Guaranteed Rate Field,20,8
2017-08-13,2017,MIN,DET,6,4,-131,-1.5,130,9.5,-110,-110,116,1.5,-150,5.39,Comerica Park,10,2
2017-08-13,2017,TEX,HOU,1,2,120,1.5,-130,10.5,-120,100,-135,-1.5,110,4.77,Rangers Ballpark,3,-1
2017-08-13,2017,CWS,KC,6,14,125,1.5,-135,10.0,-115,-105,-140,-1.5,115,4.44,Guaranteed Rate Field,20,-8
2017-08-13,2017,SEA,LAA,2,4,-122,-1.5,155,9.5,-103,-117,112,1.5,-180,5.22,T-Mobile Park,6,-2
2017-08-13,2017,SD,LAD,4,6,250,1.5,110,8.5,-119,-101,-290,-1.5,-130,2.43,Dodger Stadium,10,-2
2017-08-13,2017,COL,MIA,3,5,-112,-1.5,144,8.5,-115,-105,102,1.5,-165,4.49,Marlins Park,8,-2
2017-08-13,2017,CIN,MIL,4,7,107,1.5,-205,10.5,-110,-110,-117,-1.5,172,5.07,Miller Park,11,-3
2017-08-13,2017,DET,MIN,4,6,116,1.5,-150,9.5,-110,-110,-131,-1.5,130,4.4,Comerica Park,10,-2
2017-08-13,2017,PHI,NYM,2,6,101,1.5,-165,10.0,-115,-105,-111,-1.5,144,4.98,Citizens Bank Park,8,-4
2017-08-13,2017,BOS,NYY,3,2,-158,-1.5,100,7.5,-110,-110,143,1.5,-120,4.59,Yankee Stadium,5,1
2017-08-13,2017,BAL,OAK,3,9,-109,-1.5,143,9.5,100,-120,-101,1.5,-164,4.95,Oakland Coliseum,12,-6
2017-08-13,2017,NYM,PHI,6,2,-111,-1.5,144,10.0,-115,-105,101,1.5,-165,5.26,Citizens Bank Park,8,4
2017-08-13,2017,TOR,PIT,7,1,-109,-1.5,170,9.0,-117,-103,-101,1.5,-200,4.69,Rogers Centre,8,6
2017-08-13,2017,LAD,SD,6,4,-290,-1.5,-130,8.5,-119,-101,250,1.5,110,6.32,Dodger Stadium,10,2
2017-08-13,2017,LAA,SEA,4,2,112,1.5,-180,9.5,-103,-117,-122,-1.5,155,4.48,T-Mobile Park,6,2
2017-08-13,2017,WSH,SF,2,4,-150,-1.5,140,9.0,-115,-105,135,1.5,-160,5.4,Nationals Park,6,-2
2017-08-13,2017,WSH,SF,6,2,-280,-1.5,-140,7.5,-120,100,240,1.5,121,5.53,Nationals Park,8,4
2017-08-13,2017,ATL,STL,6,3,170,1.5,-121,8.5,-110,-110,-190,-1.5,101,3.15,Busch Stadium,9,3
2017-08-13,2017,CLE,TB,4,3,-166,-1.5,-110,7.0,-125,105,151,1.5,-110,4.37,Tropicana Field,7,1
2017-08-13,2017,HOU,TEX,2,1,-135,-1.5,110,10.5,-120,100,120,1.5,-130,6.03,Rangers Ballpark,3,1
2017-08-13,2017,PIT,TOR,1,7,-101,1.5,-200,9.0,-117,-103,-109,-1.5,170,4.52,Rogers Centre,8,-6
2017-08-13,2017,SF,WSH,4,2,135,1.5,-160,9.0,-115,-105,-150,-1.5,140,3.83,Nationals Park,6,2
2017-08-13,2017,SF,WSH,2,6,240,1.5,121,7.5,-120,100,-280,-1.5,-140,2.21,Nationals Park,8,-4
2017-08-14,2017,HOU,ARI,0,2,150,1.5,-140,9.5,-101,-119,-170,-1.5,120,3.8,Chase Field,2,-2
2017-08-14,2017,COL,ATL,3,0,-119,-1.5,156,11.5,-119,-101,109,1.5,-181,6.25,Coors Field,3,3
2017-08-14,2017,SEA,BAL,3,11,111,1.5,-151,9.0,-115,-105,-121,-1.5,131,4.27,T-Mobile Park,14,-8
2017-08-14,2017,CLE,BOS,7,3,-119,-1.5,135,9.5,-115,-105,109,1.5,-155,5.16,Fenway Park,10,4
2017-08-14,2017,CIN,CHC,5,15,188,1.5,-115,9.0,-110,-110,-218,-1.5,-105,3.13,Wrigley Field,20,-10
2017-08-14,2017,CHC,CIN,15,5,-218,-1.5,-105,9.0,-110,-110,188,1.5,-115,6.17,Wrigley Field,20,10
2017-08-14,2017,BOS,CLE,3,7,109,1.5,-155,9.5,-115,-105,-119,-1.5,135,4.55,Fenway Park,10,-4
2017-08-14,2017,ATL,COL,0,3,109,1.5,-181,11.5,-119,-101,-119,-1.5,156,5.5,Coors Field,3,-3
2017-08-14,2017,TEX,DET,6,2,-111,-1.5,161,11.0,100,-120,101,1.5,-187,5.79,Rangers Ballpark,8,4
2017-08-14,2017,ARI,HOU,2,0,-170,-1.5,120,9.5,-101,-119,150,1.5,-140,5.98,Chase Field,2,2
2017-08-14,2017,OAK,KC,2,6,-103,1.5,-170,8.5,-119,-101,-107,-1.5,148,4.31,Oakland Coliseum,8,-4
2017-08-14,2017,SF,MIA,3,8,145,1.5,-150,9.0,-120,100,-160,-1.5,130,3.67,Marlins Park,11,-5
2017-08-14,2017,NYY,NYM,4,2,-186,-1.5,-105,10.0,100,-120,166,1.5,-115,6.5,Yankee Stadium,6,2
2017-08-14,2017,NYM,NYY,2,4,166,1.5,-115,10.0,100,-120,-186,-1.5,-105,3.76,Yankee Stadium,6,-2
2017-08-14,2017,KC,OAK,6,2,-107,-1.5,148,8.5,-119,-101,-103,1.5,-170,4.39,Oakland Coliseum,8,4
2017-08-14,2017,SD,PHI,7,4,-119,-1.5,172,8.0,-107,-113,109,1.5,-205,4.35,PETCO Park,11,3
2017-08-14,2017,PHI,SD,4,7,109,1.5,-205,8.0,-107,-113,-119,-1.5,172,3.83,PETCO Park,11,-3
2017-08-14,2017,BAL,SEA,11,3,-121,-1.5,131,9.0,-115,-105,111,1.5,-151,4.93,T-Mobile Park,14,8
2017-08-14,2017,MIA,SF,8,3,-160,-1.5,130,9.0,-120,100,145,1.5,-150,5.54,Marlins Park,11,5
2017-08-14,2017,TOR,TB,2,1,-101,1.5,-160,10.0,-120,100,-109,-1.5,140,5.02,Rogers Centre,3,1
2017-08-14,2017,DET,TEX,2,6,101,1.5,-187,11.0,100,-120,-111,-1.5,161,5.47,Rangers Ballpark,8,-4
2017-08-14,2017,TB,TOR,1,2,-109,-1.5,140,10.0,-120,100,-101,1.5,-160,5.22,Rogers Centre,3,-1
2017-08-15,2017,HOU,ARI,9,4,-110,-1.5,144,9.5,-110,-110,100,1.5,-165,4.98,Chase Field,13,5
2017-08-15,2017,COL,ATL,3,4,-188,-1.5,-105,11.0,-115,-105,168,1.5,-115,7.18,Coors Field,7,-1
2017-08-15,2017,SEA,BAL,3,1,-111,-1.5,172,9.0,-110,-110,101,1.5,-205,4.73,T-Mobile Park,4,2
2017-08-15,2017,STL,BOS,4,10,133,1.5,-155,9.5,-121,101,-148,-1.5,135,4.08,Fenway Park,14,-6
2017-08-15,2017,CIN,CHC,2,1,148,1.5,-160,7.5,-105,-115,-163,-1.5,140,3.02,Wrigley Field,3,1
2017-08-15,2017,CHC,CIN,1,2,-163,-1.5,140,7.5,-105,-115,148,1.5,-160,4.65,Wrigley Field,3,-1
2017-08-15,2017,MIN,CLE,1,8,142,1.5,-110,9.5,-125,105,-157,-1.5,-110,3.93,Target Field,9,-7
2017-08-15,2017,ATL,COL,4,3,168,1.5,-115,11.0,-115,-105,-188,-1.5,-105,4.1,Coors Field,7,1
2017-08-15,2017,LAD,CWS,6,1,-375,-1.5,-155,8.5,100,-120,315,1.5,135,6.71,Dodger Stadium,7,5
2017-08-15,2017,TEX,DET,10,4,-105,1.5,-175,10.5,-120,100,-105,-1.5,151,5.38,Rangers Ballpark,14,6
2017-08-15,2017,ARI,HOU,4,9,100,1.5,-165,9.5,-110,-110,-110,-1.5,144,4.75,Chase Field,13,-5
2017-08-15,2017,OAK,KC,10,8,114,1.5,-145,9.0,-105,-115,-124,-1.5,125,4.21,Oakland Coliseum,18,2
2017-08-15,2017,WSH,LAA,3,1,-110,-1.5,184,8.5,-110,-110,100,1.5,-220,4.45,Nationals Park,4,2
2017-08-15,2017,CWS,LAD,1,6,315,1.5,135,8.5,100,-120,-375,-1.5,-155,2.05,Dodger Stadium,7,-5
2017-08-15,2017,SF,MIA,9,4,-101,1.5,-210,7.5,-125,105,-109,-1.5,176,3.77,Marlins Park,13,5
2017-08-15,2017,PIT,MIL,1,3,113,1.5,-180,9.0,-110,-110,-123,-1.5,155,4.23,Miller Park,4,-2
2017-08-15,2017,CLE,MIN,8,1,-157,-1.5,-110,9.5,-125,105,142,1.5,-110,5.8,Target Field,9,7
2017-08-15,2017,NYY,NYM,5,4,-143,-1.5,155,8.0,-110,-110,128,1.5,-180,4.71,Yankee Stadium,9,1
2017-08-15,2017,NYM,NYY,4,5,128,1.5,-180,8.0,-110,-110,-143,-1.5,155,3.51,Yankee Stadium,9,-1
2017-08-15,2017,KC,OAK,8,10,-124,-1.5,125,9.0,-105,-115,114,1.5,-145,4.98,Oakland Coliseum,18,-2
2017-08-15,2017,SD,PHI,8,4,-174,-1.5,125,8.0,-105,-115,154,1.5,-145,5.08,PETCO Park,12,4
2017-08-15,2017,MIL,PIT,3,1,-123,-1.5,155,9.0,-110,-110,113,1.5,-180,4.96,Miller Park,4,2
2017-08-15,2017,PHI,SD,4,8,154,1.5,-145,8.0,-105,-115,-174,-1.5,125,3.15,PETCO Park,12,-4
2017-08-15,2017,BAL,SEA,1,3,101,1.5,-205,9.0,-110,-110,-111,-1.5,172,4.48,T-Mobile Park,4,-2
2017-08-15,2017,MIA,SF,4,9,-109,-1.5,176,7.5,-125,105,-101,1.5,-210,3.91,Marlins Park,13,-5
2017-08-15,2017,BOS,STL,10,4,-148,-1.5,135,9.5,-121,101,133,1.5,-155,5.67,Fenway Park,14,6
2017-08-15,2017,TOR,TB,4,6,-108,-1.5,166,9.5,-110,-110,-102,1.5,-195,4.93,Rogers Centre,10,-2
2017-08-15,2017,DET,TEX,4,10,-105,-1.5,151,10.5,-120,100,-105,1.5,-175,5.38,Rangers Ballpark,14,-6
2017-08-15,2017,TB,TOR,6,4,-102,1.5,-195,9.5,-110,-110,-108,-1.5,166,4.8,Rogers Centre,10,2
2017-08-15,2017,LAA,WSH,1,3,100,1.5,-220,8.5,-110,-110,-110,-1.5,184,4.25,Nationals Park,4,-2
2017-08-16,2017,HOU,ARI,9,5,-165,-1.5,120,9.0,-120,100,150,1.5,-140,5.6,Minute Maid Park,14,4
2017-08-16,2017,COL,ATL,17,2,-196,-1.5,-111,10.5,-105,-115,176,1.5,-109,6.95,Coors Field,19,15
2017-08-16,2017,SEA,BAL,7,6,-113,-1.5,170,9.5,-108,-112,103,1.5,-200,5.04,T-Mobile Park,13,1
2017-08-16,2017,STL,BOS,4,5,150,1.5,-140,9.5,-119,-101,-170,-1.5,122,3.8,Fenway Park,9,-1
2017-08-16,2017,CIN,CHC,6,7,205,1.5,107,10.0,-119,-101,-235,-1.5,-126,3.28,Wrigley Field,13,-1
2017-08-16,2017,CHC,CIN,7,6,-235,-1.5,-126,10.0,-119,-101,205,1.5,107,7.01,Wrigley Field,13,1
2017-08-16,2017,ATL,COL,2,17,176,1.5,-109,10.5,-105,-115,-196,-1.5,-111,3.8,Coors Field,19,-15
2017-08-16,2017,LAD,CWS,5,4,-315,-1.5,-140,7.0,-130,110,265,1.5,120,5.31,Dodger Stadium,9,1
2017-08-16,2017,TEX,DET,12,6,-185,-1.5,-110,11.5,-105,-115,165,1.5,-109,7.46,Rangers Ballpark,18,6
2017-08-16,2017,ARI,HOU,5,9,150,1.5,-140,9.0,-120,100,-165,-1.5,120,3.6,Minute Maid Park,14,-4
2017-08-16,2017,OAK,KC,6,7,116,1.5,-149,9.5,-110,-110,-131,-1.5,129,4.4,Oakland Coliseum,13,-1
2017-08-16,2017,WSH,LAA,2,3,-131,-1.5,154,9.0,-120,100,116,1.5,-177,5.1,Nationals Park,5,-1
2017-08-16,2017,CWS,LAD,4,5,265,1.5,120,7.0,-130,110,-315,-1.5,-140,1.92,Dodger Stadium,9,-1
2017-08-16,2017,SF,MIA,1,8,172,1.5,-118,9.0,-114,-106,-202,-1.5,-102,3.31,Marlins Park,9,-7
2017-08-16,2017,PIT,MIL,6,7,119,1.5,-190,8.0,100,-120,-129,-1.5,163,3.65,Miller Park,13,-1
2017-08-16,2017,NYY,NYM,5,3,-172,-1.5,-110,8.5,-110,-110,152,1.5,-110,5.38,Citi Field,8,2
2017-08-16,2017,NYM,NYY,3,5,152,1.5,-110,8.5,-110,-110,-172,-1.5,-110,3.37,Citi Field,8,-2
2017-08-16,2017,KC,OAK,7,6,-131,-1.5,129,9.5,-110,-110,116,1.5,-149,5.39,Oakland Coliseum,13,1
2017-08-16,2017,SD,PHI,3,0,-154,-1.5,148,8.0,-120,100,139,1.5,-170,4.85,PETCO Park,3,3
2017-08-16,2017,MIL,PIT,7,6,-129,-1.5,163,8.0,100,-120,119,1.5,-190,4.51,Miller Park,13,1
2017-08-16,2017,PHI,SD,0,3,139,1.5,-170,8.0,-120,100,-154,-1.5,148,3.35,PETCO Park,3,-3
2017-08-16,2017,BAL,SEA,6,7,103,1.5,-200,9.5,-108,-112,-113,-1.5,170,4.68,T-Mobile Park,13,-1
2017-08-16,2017,MIA,SF,8,1,-202,-1.5,-102,9.0,-114,-106,172,1.5,-118,6.02,Marlins Park,9,7
2017-08-16,2017,BOS,STL,5,4,-170,-1.5,122,9.5,-119,-101,150,1.5,-140,5.98,Fenway Park,9,1
2017-08-16,2017,TOR,TB,3,2,-131,-1.5,155,8.5,-110,-110,116,1.5,-180,4.82,Rogers Centre,5,1
2017-08-16,2017,DET,TEX,6,12,165,1.5,-109,11.5,-105,-115,-185,-1.5,-110,4.34,Rangers Ballpark,18,-6
2017-08-16,2017,TB,TOR,2,3,116,1.5,-180,8.5,-110,-110,-131,-1.5,155,3.94,Rogers Centre,5,-1
2017-08-16,2017,LAA,WSH,3,2,116,1.5,-177,9.0,-120,100,-131,-1.5,154,4.17,Nationals Park,5,1
2017-08-17,2017,HOU,ARI,0,4,-121,-1.5,155,9.5,-120,100,111,1.5,-180,5.2,Minute Maid Park,4,-4
2017-08-17,2017,COL,ATL,4,10,-178,-1.5,-104,12.0,-110,-110,158,1.5,-116,7.68,Coors Field,14,-6
2017-08-17,2017,CIN,CHC,13,10,208,1.5,120,11.5,-105,-115,-248,-1.5,-140,3.73,Wrigley Field,23,3
2017-08-17,2017,CHC,CIN,10,13,-248,-1.5,-140,11.5,-105,-115,208,1.5,120,8.2,Wrigley Field,23,-3
2017-08-17,2017,MIN,CLE,3,9,162,1.5,-105,9.0,-105,-115,-182,-1.5,-115,3.44,Target Field,12,-6
2017-08-17,2017,MIN,CLE,4,2,100,1.5,-160,9.5,-119,-101,-110,-1.5,140,4.75,Target Field,6,2
2017-08-17,2017,ATL,COL,10,4,158,1.5,-116,12.0,-110,-110,-178,-1.5,-104,4.65,Coors Field,14,6
2017-08-17,2017,TEX,CWS,9,8,-185,-1.5,100,11.0,-105,-115,165,1.5,-120,7.14,Rangers Ballpark,17,1
2017-08-17,2017,ARI,HOU,4,0,111,1.5,-180,9.5,-120,100,-121,-1.5,155,4.5,Minute Maid Park,4,4
2017-08-17,2017,CLE,MIN,9,3,-182,-1.5,-115,9.0,-105,-115,162,1.5,-105,5.81,Target Field,12,6
2017-08-17,2017,CLE,MIN,2,4,-110,-1.5,140,9.5,-119,-101,100,1.5,-160,4.98,Target Field,6,-2
2017-08-17,2017,NYY,NYM,7,5,-208,-1.5,-124,7.0,-120,100,178,1.5,106,4.73,Citi Field,12,2
2017-08-17,2017,NYM,NYY,5,7,178,1.5,106,7.0,-120,100,-208,-1.5,-124,2.52,Citi Field,12,-2
2017-08-17,2017,SF,PHI,5,4,-126,-1.5,170,7.0,104,-124,116,1.5,-200,3.9,AT&T Park,9,1
2017-08-17,2017,STL,PIT,11,7,125,1.5,-182,9.0,-110,-110,-140,-1.5,158,4.0,PNC Park,18,4
2017-08-17,2017,WSH,SD,2,1,116,1.5,-204,8.0,-118,-102,-126,-1.5,171,3.7,PETCO Park,3,1
2017-08-17,2017,PHI,SF,4,5,116,1.5,-200,7.0,104,-124,-126,-1.5,170,3.24,AT&T Park,9,-1
2017-08-17,2017,PIT,STL,7,11,-140,-1.5,158,9.0,-110,-110,125,1.5,-182,5.25,PNC Park,18,-4
2017-08-17,2017,TOR,TB,5,3,151,1.5,-105,8.5,-120,100,-171,-1.5,-115,3.39,Rogers Centre,8,2
2017-08-17,2017,CWS,TEX,8,9,165,1.5,-120,11.0,-105,-115,-185,-1.5,100,4.15,Rangers Ballpark,17,-1
2017-08-17,2017,TB,TOR,3,5,-171,-1.5,-115,8.5,-120,100,151,1.5,-105,5.36,Rogers Centre,8,-2
2017-08-17,2017,SD,WSH,1,2,-126,-1.5,171,8.0,-118,-102,116,1.5,-204,4.46,PETCO Park,3,-1
2017-08-18,2017,MIN,ARI,10,3,-102,1.5,-170,9.0,-120,100,-108,-1.5,148,4.54,Target Field,13,7
2017-08-18,2017,CIN,ATL,5,3,111,1.5,-185,9.5,-120,100,-121,-1.5,160,4.5,Suntrust Park,8,2
2017-08-18,2017,LAA,BAL,7,9,116,1.5,-180,9.5,-111,-109,-126,-1.5,155,4.4,Camden Yards,16,-2
2017-08-18,2017,NYY,BOS,6,9,118,1.5,-190,9.0,-120,100,-133,-1.5,163,4.13,Fenway Park,15,-3
2017-08-18,2017,TOR,CHC,4,7,155,1.5,-140,9.0,100,-120,-175,-1.5,120,3.53,Wrigley Field,11,-3
2017-08-18,2017,ATL,CIN,3,5,-121,-1.5,160,9.5,-120,100,111,1.5,-185,5.2,Suntrust Park,8,-2
2017-08-18,2017,KC,CLE,1,10,170,1.5,112,8.0,-103,-117,-200,-1.5,-132,2.96,Kauffman Stadium,11,-9
2017-08-18,2017,MIL,COL,4,8,160,1.5,-119,13.0,-105,-115,-180,-1.5,-101,5.0,Coors Field,12,-4
2017-08-18,2017,TEX,CWS,3,4,-263,-1.5,-147,11.0,-120,100,223,1.5,127,7.97,Rangers Ballpark,7,-1
2017-08-18,2017,LAD,DET,8,5,-226,-1.5,-140,10.5,-110,-110,196,1.5,120,7.28,Comerica Park,13,3
2017-08-18,2017,OAK,HOU,1,3,186,1.5,-110,9.0,-120,100,-216,-1.5,-110,3.15,Minute Maid Park,4,-2
2017-08-18,2017,CLE,KC,10,1,-200,-1.5,-132,8.0,-103,-117,170,1.5,112,5.33,Kauffman Stadium,11,9
2017-08-18,2017,BAL,LAA,9,7,-126,-1.5,155,9.5,-111,-109,116,1.5,-180,5.3,Camden Yards,16,2
2017-08-18,2017,DET,LAD,5,8,196,1.5,120,10.5,-110,-110,-226,-1.5,-140,3.55,Comerica Park,13,-3
2017-08-18,2017,NYM,MIA,1,3,-109,-1.5,176,10.0,100,-120,-101,1.5,-210,5.22,Citi Field,4,-2
2017-08-18,2017,COL,MIL,8,4,-180,-1.5,-101,13.0,-105,-115,160,1.5,-119,8.36,Coors Field,12,4
2017-08-18,2017,ARI,MIN,3,10,-108,-1.5,148,9.0,-120,100,-102,1.5,-170,4.67,Target Field,13,-7
2017-08-18,2017,MIA,NYM,3,1,-101,1.5,-210,10.0,100,-120,-109,-1.5,176,5.02,Citi Field,4,2
2017-08-18,2017,BOS,NYY,9,6,-133,-1.5,163,9.0,-120,100,118,1.5,-190,5.14,Fenway Park,15,3
2017-08-18,2017,HOU,OAK,3,1,-216,-1.5,-110,9.0,-120,100,186,1.5,-110,6.15,Minute Maid Park,4,2
2017-08-18,2017,SF,PHI,10,2,-185,-1.5,119,8.5,100,-120,165,1.5,-139,5.52,AT&T Park,12,8
2017-08-18,2017,STL,PIT,11,10,-127,-1.5,125,8.5,100,-120,117,1.5,-145,4.76,PNC Park,21,1
2017-08-18,2017,WSH,SD,7,1,102,1.5,-215,8.0,-115,-105,-112,-1.5,180,3.96,PETCO Park,8,6
2017-08-18,2017,TB,SEA,1,7,-135,-1.5,154,9.0,-111,-109,120,1.5,-179,5.17,Tropicana Field,8,-6
2017-08-18,2017,PHI,SF,2,10,165,1.5,-139,8.5,100,-120,-185,-1.5,119,3.21,AT&T Park,12,-8
2017-08-18,2017,PIT,STL,10,11,117,1.5,-145,8.5,100,-120,-127,-1.5,125,3.92,PNC Park,21,-1
2017-08-18,2017,SEA,TB,7,1,120,1.5,-179,9.0,-111,-109,-135,-1.5,154,4.09,Tropicana Field,8,6
2017-08-18,2017,CWS,TEX,4,3,223,1.5,127,11.0,-120,100,-263,-1.5,-147,3.41,Rangers Ballpark,7,1
2017-08-18,2017,CHC,TOR,7,4,-175,-1.5,120,9.0,100,-120,155,1.5,-140,5.73,Wrigley Field,11,3
2017-08-18,2017,SD,WSH,1,7,-112,-1.5,180,8.0,-115,-105,102,1.5,-215,4.23,PETCO Park,8,-6
2017-08-19,2017,MIN,ARI,5,0,125,1.5,-140,8.5,-120,100,-140,-1.5,120,3.78,Target Field,5,5
2017-08-19,2017,CIN,ATL,11,8,150,1.5,-148,10.0,-122,102,-165,-1.5,128,4.0,Suntrust Park,19,3
2017-08-19,2017,LAA,BAL,5,1,150,1.5,-135,9.5,-120,100,-165,-1.5,115,3.8,Camden Yards,6,4
2017-08-19,2017,NYY,BOS,4,3,240,1.5,109,8.0,-120,100,-280,-1.5,-129,2.35,Fenway Park,7,1
2017-08-19,2017,TOR,CHC,3,4,210,1.5,105,9.5,-120,100,-250,-1.5,-125,3.06,Wrigley Field,7,-1
2017-08-19,2017,ATL,CIN,8,11,-165,-1.5,128,10.0,-122,102,150,1.5,-148,6.23,Suntrust Park,19,-3
2017-08-19,2017,KC,CLE,0,5,132,1.5,-130,9.5,-114,-106,-147,-1.5,110,4.09,Kauffman Stadium,5,-5
2017-08-19,2017,MIL,COL,6,3,115,1.5,-165,12.5,-119,-101,-125,-1.5,144,5.81,Coors Field,9,3
2017-08-19,2017,TEX,CWS,17,7,-230,-1.5,-125,11.0,-118,-102,200,1.5,105,7.67,Rangers Ballpark,24,10
2017-08-19,2017,LAD,DET,3,0,-143,-1.5,-101,10.5,-105,-115,128,1.5,-119,6.18,Comerica Park,3,3
2017-08-19,2017,OAK,HOU,0,3,145,1.5,-145,9.5,-118,-102,-160,-1.5,125,3.88,Minute Maid Park,3,-3
2017-08-19,2017,CLE,KC,5,0,-147,-1.5,110,9.5,-114,-106,132,1.5,-130,5.65,Kauffman Stadium,5,5
2017-08-19,2017,BAL,LAA,1,5,-165,-1.5,115,9.5,-120,100,150,1.5,-135,5.92,Camden Yards,6,-4
2017-08-19,2017,DET,LAD,0,3,128,1.5,-119,10.5,-105,-115,-143,-1.5,-101,4.61,Comerica Park,3,-3
2017-08-19,2017,NYM,MIA,8,1,-116,-1.5,176,10.0,100,-120,106,1.5,-210,5.37,Citi Field,9,7
2017-08-19,2017,COL,MIL,3,6,-125,-1.5,144,12.5,-119,-101,115,1.5,-165,6.94,Coors Field,9,-3
2017-08-19,2017,ARI,MIN,0,5,-140,-1.5,120,8.5,-120,100,125,1.5,-140,4.96,Target Field,5,-5
2017-08-19,2017,MIA,NYM,1,8,106,1.5,-210,10.0,100,-120,-116,-1.5,176,4.85,Citi Field,9,-7
2017-08-19,2017,BOS,NYY,3,4,-280,-1.5,-129,8.0,-120,100,240,1.5,109,5.89,Fenway Park,7,-1
2017-08-19,2017,HOU,OAK,3,0,-160,-1.5,125,9.5,-118,-102,145,1.5,-145,5.85,Minute Maid Park,3,3
2017-08-19,2017,SF,PHI,9,12,-138,-1.5,151,8.5,100,-120,123,1.5,-175,4.93,AT&T Park,21,-3
2017-08-19,2017,STL,PIT,4,6,-105,-1.5,148,9.0,-105,-115,-105,1.5,-170,4.61,PNC Park,10,-2
2017-08-19,2017,WSH,SD,1,3,-155,-1.5,105,7.5,-109,-111,140,1.5,-125,4.56,PETCO Park,4,-2
2017-08-19,2017,TB,SEA,6,7,-114,-1.5,172,9.5,100,-120,104,1.5,-205,5.06,Tropicana Field,13,-1
2017-08-19,2017,PHI,SF,12,9,123,1.5,-175,8.5,100,-120,-138,-1.5,151,3.81,AT&T Park,21,3
2017-08-19,2017,PIT,STL,6,4,-105,1.5,-170,9.0,-105,-115,-105,-1.5,148,4.61,PNC Park,10,2
2017-08-19,2017,SEA,TB,7,6,104,1.5,-205,9.5,100,-120,-114,-1.5,172,4.66,Tropicana Field,13,1
2017-08-19,2017,CWS,TEX,7,17,200,1.5,105,11.0,-118,-102,-230,-1.5,-125,3.67,Rangers Ballpark,24,-10
2017-08-19,2017,CHC,TOR,4,3,-250,-1.5,-125,9.5,-120,100,210,1.5,105,6.79,Wrigley Field,7,1
2017-08-19,2017,SD,WSH,3,1,140,1.5,-125,7.5,-109,-111,-155,-1.5,105,3.13,PETCO Park,4,2
2017-08-20,2017,MIN,ARI,12,5,-103,-1.5,184,10.5,-120,100,-107,1.5,-220,5.33,Target Field,17,7
2017-08-20,2017,CIN,ATL,1,8,-111,1.5,-210,9.5,-102,-118,101,-1.5,176,5.0,Suntrust Park,9,-7
2017-08-20,2017,LAA,BAL,5,4,106,1.5,-195,10.5,-115,-105,-116,-1.5,166,5.1,Camden Yards,9,1
2017-08-20,2017,NYY,BOS,1,5,-101,-1.5,144,9.5,-105,-115,-109,1.5,-165,4.77,Fenway Park,6,-4
2017-08-20,2017,TOR,CHC,5,6,164,1.5,-130,9.0,-115,-105,-184,-1.5,110,3.41,Wrigley Field,11,-1
2017-08-20,2017,ATL,CIN,8,1,101,-1.5,176,9.5,-102,-118,-111,1.5,-210,4.73,Suntrust Park,9,7
2017-08-20,2017,KC,CLE,7,4,155,1.5,-110,9.0,-115,-105,-175,-1.5,-110,3.53,Kauffman Stadium,11,3
2017-08-20,2017,MIL,COL,8,4,109,1.5,-170,13.0,105,-125,-119,-1.5,148,6.22,Coors Field,12,4
2017-08-20,2017,TEX,CWS,2,3,-195,-1.5,-107,11.5,-105,-115,175,1.5,-113,7.6,Rangers Ballpark,5,-1
2017-08-20,2017,LAD,DET,1,6,-140,-1.5,115,9.0,105,-125,125,1.5,-135,5.25,Comerica Park,7,-5
2017-08-20,2017,OAK,HOU,3,2,210,1.5,118,9.0,-125,105,-250,-1.5,-138,2.9,Minute Maid Park,5,1
2017-08-20,2017,CLE,KC,4,7,-175,-1.5,-110,9.0,-115,-105,155,1.5,-110,5.73,Kauffman Stadium,11,-3
2017-08-20,2017,BAL,LAA,4,5,-116,-1.5,166,10.5,-115,-105,106,1.5,-195,5.64,Camden Yards,9,-1
2017-08-20,2017,DET,LAD,6,1,125,1.5,-135,9.0,105,-125,-140,-1.5,115,4.0,Comerica Park,7,5
2017-08-20,2017,NYM,MIA,4,6,-188,-1.5,110,8.5,-114,-106,168,1.5,-130,5.55,Citi Field,10,-2
2017-08-20,2017,COL,MIL,4,8,-119,-1.5,148,13.0,105,-125,109,1.5,-170,7.06,Coors Field,12,-4
2017-08-20,2017,ARI,MIN,5,12,-107,1.5,-220,10.5,-120,100,-103,-1.5,184,5.43,Target Field,17,-7
2017-08-20,2017,MIA,NYM,6,4,168,1.5,-130,8.5,-114,-106,-188,-1.5,110,3.17,Citi Field,10,2
2017-08-20,2017,BOS,NYY,5,1,-109,1.5,-165,9.5,-105,-115,-101,-1.5,144,4.95,Fenway Park,6,4
2017-08-20,2017,HOU,OAK,2,3,-250,-1.5,-138,9.0,-125,105,210,1.5,118,6.43,Minute Maid Park,5,-1
2017-08-20,2017,SF,PHI,2,5,-250,-1.5,-120,8.0,-120,100,210,1.5,100,5.71,AT&T Park,7,-3
2017-08-20,2017,STL,PIT,3,6,-116,-1.5,139,9.5,100,-120,106,1.5,-159,5.1,BB&T Ballpark at Bowman Field,9,-3
2017-08-20,2017,WSH,SD,4,1,114,1.5,-215,7.5,-110,-110,-124,-1.5,180,3.5,PETCO Park,5,3
2017-08-20,2017,TB,SEA,3,0,-175,-1.5,110,9.5,-105,-115,155,1.5,-130,6.05,Tropicana Field,3,3
2017-08-20,2017,PHI,SF,5,2,210,1.5,100,8.0,-120,100,-250,-1.5,-120,2.58,AT&T Park,7,3
2017-08-20,2017,PIT,STL,6,3,106,1.5,-159,9.5,100,-120,-116,-1.5,139,4.61,BB&T Ballpark at Bowman Field,9,3
2017-08-20,2017,SEA,TB,0,3,155,1.5,-130,9.5,-105,-115,-175,-1.5,110,3.73,Tropicana Field,3,-3
2017-08-20,2017,CWS,TEX,3,2,175,1.5,-113,11.5,-105,-115,-195,-1.5,-107,4.18,Rangers Ballpark,5,1
2017-08-20,2017,CHC,TOR,6,5,-184,-1.5,110,9.0,-115,-105,164,1.5,-130,5.83,Wrigley Field,11,1
2017-08-20,2017,SD,WSH,1,4,-124,-1.5,180,7.5,-110,-110,114,1.5,-215,4.15,PETCO Park,5,-3
2017-08-21,2017,NYM,ARI,2,3,122,1.5,-140,9.0,-110,-110,-137,-1.5,120,4.05,Citi Field,5,-1
2017-08-21,2017,SEA,ATL,6,5,-107,-1.5,148,9.5,-116,-104,-103,1.5,-170,4.91,Suntrust Park,11,1
2017-08-21,2017,OAK,BAL,3,7,165,1.5,-110,11.0,-110,-110,-185,-1.5,-110,4.15,Camden Yards,10,-4
2017-08-21,2017,CLE,BOS,5,4,-114,-1.5,176,8.5,-120,100,104,1.5,-210,4.53,Progressive Field,9,1
2017-08-21,2017,BOS,CLE,4,5,104,1.5,-210,8.5,-120,100,-114,-1.5,176,4.17,Progressive Field,9,-1
2017-08-21,2017,MIN,CWS,6,7,113,1.5,-175,9.5,-101,-119,-123,-1.5,151,4.46,Guaranteed Rate Field,13,-1
2017-08-21,2017,MIN,CWS,10,2,-150,-1.5,-105,10.0,-119,-101,135,1.5,-115,6.0,Guaranteed Rate Field,12,8
2017-08-21,2017,TEX,LAA,5,3,141,1.5,-145,8.5,-125,105,-156,-1.5,125,3.53,Angel Stadium,8,2
2017-08-21,2017,PIT,LAD,5,6,123,1.5,-140,8.0,-109,-111,-138,-1.5,120,3.59,PNC Park,11,-1
2017-08-21,2017,SF,MIL,2,0,114,1.5,-150,8.5,-105,-115,-124,-1.5,130,3.97,AT&T Park,2,2
2017-08-21,2017,CWS,MIN,7,6,-123,-1.5,151,9.5,-101,-119,113,1.5,-175,5.24,Guaranteed Rate Field,13,1
2017-08-21,2017,CWS,MIN,2,10,135,1.5,-115,10.0,-119,-101,-150,-1.5,-105,4.26,Guaranteed Rate Field,12,-8
2017-08-21,2017,ARI,NYM,3,2,-137,-1.5,120,9.0,-110,-110,122,1.5,-140,5.2,Citi Field,5,1
2017-08-21,2017,BAL,OAK,7,3,-185,-1.5,-110,11.0,-110,-110,165,1.5,-110,7.14,Camden Yards,10,4
2017-08-21,2017,LAD,PIT,6,5,-138,-1.5,120,8.0,-109,-111,123,1.5,-140,4.64,PNC Park,11,1
2017-08-21,2017,ATL,SEA,5,6,-103,1.5,-170,9.5,-116,-104,-107,-1.5,148,4.82,Suntrust Park,11,-1
2017-08-21,2017,MIL,SF,0,2,-124,-1.5,130,8.5,-105,-115,114,1.5,-150,4.71,AT&T Park,2,-2
2017-08-21,2017,LAA,TEX,3,5,-156,-1.5,125,8.5,-125,105,141,1.5,-145,5.18,Angel Stadium,8,-2
2017-08-22,2017,NYM,ARI,4,7,151,1.5,-105,9.0,-115,-105,-166,-1.5,-115,3.59,Citi Field,11,-3
2017-08-22,2017,SEA,ATL,0,4,-123,-1.5,130,10.0,-120,100,113,1.5,-150,5.52,Suntrust Park,4,-4
2017-08-22,2017,OAK,BAL,6,4,152,1.5,-125,11.0,-119,-101,-167,-1.5,105,4.37,Camden Yards,10,2
2017-08-22,2017,CLE,BOS,1,9,-177,-1.5,105,8.5,-115,-105,157,1.5,-125,5.43,Progressive Field,10,-8
2017-08-22,2017,CIN,CHC,9,13,144,1.5,-110,10.5,-110,-110,-159,-1.5,-110,4.3,Great American Ballpark,22,-4
2017-08-22,2017,CHC,CIN,13,9,-159,-1.5,-110,10.5,-110,-110,144,1.5,-110,6.45,Great American Ballpark,22,4
2017-08-22,2017,BOS,CLE,9,1,157,1.5,-125,8.5,-115,-105,-177,-1.5,105,3.31,Progressive Field,10,8
2017-08-22,2017,KC,COL,3,2,-119,-1.5,166,8.5,100,-120,109,1.5,-195,4.62,Kauffman Stadium,5,1
2017-08-22,2017,MIN,CWS,4,1,-135,-1.5,110,10.5,-105,-115,120,1.5,-130,6.03,Guaranteed Rate Field,5,3
2017-08-22,2017,NYY,DET,13,4,-192,-1.5,-120,9.5,-118,-102,172,1.5,100,6.25,Comerica Park,17,9
2017-08-22,2017,WSH,HOU,4,3,150,1.5,-130,9.0,-120,100,-170,-1.5,110,3.6,Minute Maid Park,7,1
2017-08-22,2017,COL,KC,2,3,109,1.5,-195,8.5,100,-120,-119,-1.5,166,4.07,Kauffman Stadium,5,-1
2017-08-22,2017,TEX,LAA,1,10,151,1.5,-130,9.5,-125,105,-166,-1.5,110,3.78,Angel Stadium,11,-9
2017-08-22,2017,PIT,LAD,5,8,108,1.5,-145,9.0,-114,-106,-118,-1.5,125,4.33,PNC Park,13,-3
2017-08-22,2017,PHI,MIA,8,12,-121,-1.5,166,9.0,-107,-113,111,1.5,-195,4.93,Citizens Bank Park,20,-4
2017-08-22,2017,PHI,MIA,4,7,102,1.5,-155,10.0,-110,-110,-112,-1.5,135,4.95,Citizens Bank Park,11,-3
2017-08-22,2017,SF,MIL,3,4,112,1.5,-165,7.5,-107,-113,-122,-1.5,144,3.54,AT&T Park,7,-1
2017-08-22,2017,CWS,MIN,1,4,120,1.5,-130,10.5,-105,-115,-135,-1.5,110,4.77,Guaranteed Rate Field,5,-3
2017-08-22,2017,ARI,NYM,7,4,-166,-1.5,-115,9.0,-115,-105,151,1.5,-105,5.62,Citi Field,11,3
2017-08-22,2017,DET,NYY,4,13,172,1.5,100,9.5,-118,-102,-192,-1.5,-120,3.49,Comerica Park,17,-9
2017-08-22,2017,BAL,OAK,4,6,-167,-1.5,105,11.0,-119,-101,152,1.5,-125,6.88,Camden Yards,10,-2
2017-08-22,2017,MIA,PHI,12,8,111,1.5,-195,9.0,-107,-113,-121,-1.5,166,4.27,Citizens Bank Park,20,4
2017-08-22,2017,MIA,PHI,7,4,-112,-1.5,135,10.0,-110,-110,102,1.5,-155,5.28,Citizens Bank Park,11,3
2017-08-22,2017,LAD,PIT,8,5,-118,-1.5,125,9.0,-114,-106,108,1.5,-145,4.87,PNC Park,13,3
2017-08-22,2017,STL,SD,4,12,-173,-1.5,120,8.5,-115,-105,153,1.5,-140,5.39,Busch Stadium,16,-8
2017-08-22,2017,ATL,SEA,4,0,113,1.5,-150,10.0,-120,100,-123,-1.5,130,4.69,Suntrust Park,4,4
2017-08-22,2017,MIL,SF,4,3,-122,-1.5,144,7.5,-107,-113,112,1.5,-165,4.12,AT&T Park,7,1
2017-08-22,2017,SD,STL,12,4,153,1.5,-140,8.5,-115,-105,-173,-1.5,120,3.36,Busch Stadium,16,8
2017-08-22,2017,TOR,TB,5,6,183,1.5,-110,8.0,-110,-110,-213,-1.5,-110,2.83,Tropicana Field,11,-1
2017-08-22,2017,LAA,TEX,10,1,-166,-1.5,110,9.5,-125,105,151,1.5,-130,5.93,Angel Stadium,11,9
2017-08-22,2017,TB,TOR,6,5,-213,-1.5,-110,8.0,-110,-110,183,1.5,-110,5.44,Tropicana Field,11,1
2017-08-22,2017,HOU,WSH,3,4,-170,-1.5,110,9.0,-120,100,150,1.5,-130,5.67,Minute Maid Park,7,-1
2017-08-23,2017,NYM,ARI,4,2,170,1.5,102,9.0,-105,-115,-190,-1.5,-122,3.33,Citi Field,6,2
2017-08-23,2017,SEA,ATL,9,6,109,1.5,-215,9.0,-125,105,-119,-1.5,180,4.31,Suntrust Park,15,3
2017-08-23,2017,OAK,BAL,7,8,167,1.5,-118,10.0,-119,-101,-187,-1.5,-102,3.75,Camden Yards,15,-1
2017-08-23,2017,CLE,BOS,1,6,-152,-1.5,144,7.0,-125,105,137,1.5,-165,4.22,Progressive Field,7,-5
2017-08-23,2017,CIN,CHC,3,9,102,1.5,-150,10.0,-108,-112,-112,-1.5,130,4.95,Great American Ballpark,12,-6
2017-08-23,2017,CHC,CIN,9,3,-112,-1.5,130,10.0,-108,-112,102,1.5,-150,5.28,Great American Ballpark,12,6
2017-08-23,2017,BOS,CLE,6,1,137,1.5,-165,7.0,-125,105,-152,-1.5,144,2.95,Progressive Field,7,5
2017-08-23,2017,KC,COL,6,4,-135,-1.5,151,9.0,-110,-110,120,1.5,-175,5.17,Kauffman Stadium,10,2
2017-08-23,2017,MIN,CWS,3,4,-175,-1.5,-112,9.5,-101,-119,155,1.5,-108,6.05,Guaranteed Rate Field,7,-1
2017-08-23,2017,NYY,DET,10,2,-265,-1.5,-160,9.0,-101,-119,225,1.5,140,6.53,Comerica Park,12,8
2017-08-23,2017,WSH,HOU,1,6,131,1.5,-157,9.5,105,-125,-146,-1.5,137,4.11,Minute Maid Park,7,-5
2017-08-23,2017,COL,KC,4,6,120,1.5,-175,9.0,-110,-110,-135,-1.5,151,4.09,Kauffman Stadium,10,-2
2017-08-23,2017,TEX,LAA,7,5,152,1.5,-140,9.0,105,-125,-172,-1.5,120,3.57,Angel Stadium,12,2
2017-08-23,2017,PIT,LAD,1,0,132,1.5,-130,8.5,102,-122,-147,-1.5,110,3.66,PNC Park,1,1
2017-08-23,2017,PHI,MIA,8,0,109,1.5,-150,10.0,-119,-101,-119,-1.5,130,4.78,Citizens Bank Park,8,8
2017-08-23,2017,SF,MIL,4,2,-116,-1.5,176,9.0,-110,-110,106,1.5,-210,4.83,AT&T Park,6,2
2017-08-23,2017,CWS,MIN,4,3,155,1.5,-108,9.5,-101,-119,-175,-1.5,-112,3.73,Guaranteed Rate Field,7,1
2017-08-23,2017,ARI,NYM,2,4,-190,-1.5,-122,9.0,-105,-115,170,1.5,102,5.9,Citi Field,6,-2
2017-08-23,2017,DET,NYY,2,10,225,1.5,140,9.0,-101,-119,-265,-1.5,-160,2.77,Comerica Park,12,-8
2017-08-23,2017,BAL,OAK,8,7,-187,-1.5,-102,10.0,-119,-101,167,1.5,-118,6.52,Camden Yards,15,1
2017-08-23,2017,MIA,PHI,0,8,-119,-1.5,130,10.0,-119,-101,109,1.5,-150,5.43,Citizens Bank Park,8,-8
2017-08-23,2017,LAD,PIT,0,1,-147,-1.5,110,8.5,102,-122,132,1.5,-130,5.06,PNC Park,1,-1
2017-08-23,2017,STL,SD,6,2,-179,-1.5,115,8.0,-106,-114,159,1.5,-135,5.13,Busch Stadium,8,4
2017-08-23,2017,ATL,SEA,6,9,-119,-1.5,180,9.0,-125,105,109,1.5,-215,4.89,Suntrust Park,15,-3
2017-08-23,2017,MIL,SF,2,4,106,1.5,-210,9.0,-110,-110,-116,-1.5,176,4.37,AT&T Park,6,-2
2017-08-23,2017,SD,STL,2,6,159,1.5,-135,8.0,-106,-114,-179,-1.5,115,3.09,Busch Stadium,8,-4
2017-08-23,2017,TOR,TB,7,6,105,1.5,-220,8.0,-105,-115,-115,-1.5,184,3.9,Tropicana Field,13,1
2017-08-23,2017,LAA,TEX,5,7,-172,-1.5,120,9.0,105,-125,152,1.5,-140,5.69,Angel Stadium,12,-2
2017-08-23,2017,TB,TOR,6,7,-115,-1.5,184,8.0,-105,-115,105,1.5,-220,4.28,Tropicana Field,13,-1
2017-08-23,2017,HOU,WSH,6,1,-146,-1.5,137,9.5,105,-125,131,1.5,-157,5.64,Minute Maid Park,7,5
2017-08-24,2017,NYM,ARI,2,3,127,1.5,-130,8.5,-115,-105,-142,-1.5,110,3.74,Citi Field,5,-1
2017-08-24,2017,CLE,BOS,13,6,153,1.5,-118,7.0,-105,-115,-168,-1.5,-103,2.77,Progressive Field,19,7
2017-08-24,2017,CIN,CHC,4,2,153,1.5,106,9.5,-122,102,-173,-1.5,-127,3.75,Great American Ballpark,6,2
2017-08-24,2017,CHC,CIN,2,4,-173,-1.5,-127,9.5,-122,102,153,1.5,106,6.02,Great American Ballpark,6,-2
2017-08-24,2017,BOS,CLE,6,13,-168,-1.5,-103,7.0,-105,-115,153,1.5,-118,4.39,Progressive Field,19,-7
2017-08-24,2017,KC,COL,2,3,-105,-1.5,184,9.0,-110,-110,-105,1.5,-220,4.61,Kauffman Stadium,5,-1
2017-08-24,2017,MIN,CWS,1,5,-180,-1.5,-117,9.0,-125,105,160,1.5,-103,5.79,Guaranteed Rate Field,6,-4
2017-08-24,2017,NYY,DET,6,10,-102,1.5,-200,9.5,-105,-115,-108,-1.5,170,4.8,Comerica Park,16,-4
2017-08-24,2017,WSH,HOU,5,4,121,1.5,-175,8.0,-101,-119,-136,-1.5,151,3.62,Minute Maid Park,9,1
2017-08-24,2017,COL,KC,3,2,-105,1.5,-220,9.0,-110,-110,-105,-1.5,184,4.61,Kauffman Stadium,5,1
2017-08-24,2017,TEX,LAA,3,0,141,1.5,-155,10.0,100,-120,-156,-1.5,135,4.15,Angel Stadium,3,3
2017-08-24,2017,PIT,LAD,2,5,118,1.5,-140,8.5,-115,-105,-133,-1.5,120,3.9,PNC Park,7,-3
2017-08-24,2017,PHI,MIA,8,9,130,1.5,-120,10.0,-120,100,-145,-1.5,100,4.35,Citizens Bank Park,17,-1
2017-08-24,2017,CWS,MIN,5,1,160,1.5,-103,9.0,-125,105,-180,-1.5,-117,3.46,Guaranteed Rate Field,6,4
2017-08-24,2017,ARI,NYM,3,2,-142,-1.5,110,8.5,-115,-105,127,1.5,-130,4.99,Citi Field,5,1
2017-08-24,2017,DET,NYY,10,6,-108,-1.5,170,9.5,-105,-115,-102,1.5,-200,4.93,Comerica Park,16,4
2017-08-24,2017,MIA,PHI,9,8,-145,-1.5,100,10.0,-120,100,130,1.5,-120,5.92,Citizens Bank Park,17,1
2017-08-24,2017,LAD,PIT,5,2,-133,-1.5,120,8.5,-115,-105,118,1.5,-140,4.85,PNC Park,7,3
2017-08-24,2017,STL,SD,3,4,-245,-1.5,-115,8.0,-102,-118,205,1.5,-104,5.68,Busch Stadium,7,-1
2017-08-24,2017,SD,STL,4,3,205,1.5,-104,8.0,-102,-118,-245,-1.5,-115,2.62,Busch Stadium,7,1
2017-08-24,2017,TOR,TB,0,2,145,1.5,-150,9.0,-109,-111,-160,-1.5,130,3.67,Tropicana Field,2,-2
2017-08-24,2017,LAA,TEX,0,3,-156,-1.5,135,10.0,100,-120,141,1.5,-155,6.09,Angel Stadium,3,-3
2017-08-24,2017,TB,TOR,2,0,-160,-1.5,130,9.0,-109,-111,145,1.5,-150,5.54,Tropicana Field,2,2
2017-08-24,2017,HOU,WSH,4,5,-136,-1.5,151,8.0,-101,-119,121,1.5,-175,4.61,Minute Maid Park,9,-1
2017-08-25,2017,SF,ARI,3,4,218,1.5,115,9.5,-120,100,-258,-1.5,-135,2.99,Chase Field,7,-1
2017-08-25,2017,COL,ATL,2,5,113,1.5,-191,9.0,-120,100,-123,-1.5,163,4.23,Suntrust Park,7,-3
2017-08-25,2017,BOS,BAL,3,16,-163,-1.5,120,10.0,100,-120,148,1.5,-140,6.2,Fenway Park,19,-13
2017-08-25,2017,BAL,BOS,16,3,148,1.5,-140,10.0,100,-120,-163,-1.5,120,4.03,Fenway Park,19,13
2017-08-25,2017,PHI,CHC,7,1,205,1.5,120,8.5,-111,-109,-235,-1.5,-140,2.79,Citizens Bank Park,8,6
2017-08-25,2017,PIT,CIN,5,9,-109,-1.5,148,9.5,-115,-105,-101,1.5,-170,4.95,Great American Ballpark,14,-4
2017-08-25,2017,KC,CLE,0,4,130,1.5,-160,9.0,-120,100,-145,-1.5,140,3.91,Progressive Field,4,-4
2017-08-25,2017,ATL,COL,5,2,-123,-1.5,163,9.0,-120,100,113,1.5,-191,4.96,Suntrust Park,7,3
2017-08-25,2017,DET,CWS,2,3,-168,-1.5,-110,8.5,-110,-110,153,1.5,-110,5.33,Guaranteed Rate Field,5,-1
2017-08-25,2017,CWS,DET,3,2,153,1.5,-110,8.5,-110,-110,-168,-1.5,-110,3.36,Guaranteed Rate Field,5,1
2017-08-25,2017,LAA,HOU,1,2,-114,-1.5,172,8.5,-110,-110,104,1.5,-205,4.53,Angel Stadium,3,-1
2017-08-25,2017,CLE,KC,4,0,-145,-1.5,140,9.0,-120,100,130,1.5,-160,5.33,Progressive Field,4,4
2017-08-25,2017,HOU,LAA,2,1,104,1.5,-205,8.5,-110,-110,-114,-1.5,172,4.17,Angel Stadium,3,1
2017-08-25,2017,MIL,LAD,1,3,157,1.5,-145,7.5,-120,100,-177,-1.5,125,2.92,Dodger Stadium,4,-2
2017-08-25,2017,SD,MIA,6,8,140,1.5,-155,9.0,-119,-101,-155,-1.5,135,3.75,Marlins Park,14,-2
2017-08-25,2017,LAD,MIL,3,1,-177,-1.5,125,7.5,-120,100,157,1.5,-145,4.79,Dodger Stadium,4,2
2017-08-25,2017,TOR,MIN,1,6,-193,-1.5,103,9.0,-110,-110,173,1.5,-123,5.93,Rogers Centre,7,-5
2017-08-25,2017,WSH,NYM,2,4,125,1.5,-145,7.0,-110,-110,-140,-1.5,125,3.11,Nationals Park,6,-2
2017-08-25,2017,SEA,NYY,2,1,160,1.5,-130,9.5,102,-122,-180,-1.5,110,3.65,Yankee Stadium,3,1
2017-08-25,2017,TEX,OAK,1,3,134,1.5,-154,9.5,-101,-119,-149,-1.5,135,4.06,Oakland Coliseum,4,-2
2017-08-25,2017,CHC,PHI,1,7,-235,-1.5,-140,8.5,-111,-109,205,1.5,120,5.96,Citizens Bank Park,8,-6
2017-08-25,2017,CIN,PIT,9,5,-101,1.5,-170,9.5,-115,-105,-109,-1.5,148,4.77,Great American Ballpark,14,4
2017-08-25,2017,MIA,SD,8,6,-155,-1.5,135,9.0,-119,-101,140,1.5,-155,5.47,Marlins Park,14,2
2017-08-25,2017,NYY,SEA,1,2,-180,-1.5,110,9.5,102,-122,160,1.5,-130,6.11,Yankee Stadium,3,-1
2017-08-25,2017,ARI,SF,4,3,-258,-1.5,-135,9.5,-120,100,218,1.5,115,6.85,Chase Field,7,1
2017-08-25,2017,TB,STL,7,3,167,1.5,-131,8.5,-125,105,-187,-1.5,111,3.18,Busch Stadium,10,4
2017-08-25,2017,STL,TB,3,7,-187,-1.5,111,8.5,-125,105,167,1.5,-131,5.54,Busch Stadium,10,-4
2017-08-25,2017,OAK,TEX,3,1,-149,-1.5,135,9.5,-101,-119,134,1.5,-154,5.68,Oakland Coliseum,4,2
2017-08-25,2017,MIN,TOR,6,1,173,1.5,-123,9.0,-110,-110,-193,-1.5,103,3.3,Rogers Centre,7,5
2017-08-25,2017,NYM,WSH,4,2,-140,-1.5,125,7.0,-110,-110,125,1.5,-145,4.08,Nationals Park,6,2
2017-08-26,2017,SF,ARI,1,2,114,1.5,-195,9.0,-110,-110,-124,-1.5,166,4.21,Chase Field,3,-1
2017-08-26,2017,COL,ATL,7,6,102,1.5,-215,9.5,-105,-115,-112,-1.5,180,4.7,Suntrust Park,13,1
2017-08-26,2017,BOS,BAL,0,7,-140,-1.5,129,9.5,-121,101,125,1.5,-149,5.54,Fenway Park,7,-7
2017-08-26,2017,BAL,BOS,7,0,125,1.5,-149,9.5,-121,101,-140,-1.5,129,4.22,Fenway Park,7,7
2017-08-26,2017,PHI,CHC,2,17,170,1.5,105,8.5,-124,104,-200,-1.5,-125,3.15,Citizens Bank Park,19,-15
2017-08-26,2017,PIT,CIN,1,0,105,1.5,-210,8.5,-110,-110,-115,-1.5,176,4.15,Great American Ballpark,1,1
2017-08-26,2017,KC,CLE,0,4,135,1.5,-163,9.0,-105,-115,-150,-1.5,143,3.83,Progressive Field,4,-4
2017-08-26,2017,ATL,COL,6,7,-112,-1.5,180,9.5,-105,-115,102,1.5,-215,5.02,Suntrust Park,13,-1
2017-08-26,2017,DET,CWS,6,3,-105,-1.5,148,9.0,-110,-110,-105,1.5,-170,4.61,Guaranteed Rate Field,9,3
2017-08-26,2017,CWS,DET,3,6,-105,1.5,-170,9.0,-110,-110,-105,-1.5,148,4.61,Guaranteed Rate Field,9,-3
2017-08-26,2017,LAA,HOU,7,6,-101,1.5,-169,8.5,-103,-117,-109,-1.5,147,4.27,Angel Stadium,13,1
2017-08-26,2017,CLE,KC,4,0,-150,-1.5,143,9.0,-105,-115,135,1.5,-163,5.4,Progressive Field,4,4
2017-08-26,2017,HOU,LAA,6,7,-109,-1.5,147,8.5,-103,-117,-101,1.5,-169,4.43,Angel Stadium,13,-1
2017-08-26,2017,MIL,LAD,3,0,157,1.5,-151,8.5,-115,-105,-177,-1.5,130,3.31,Dodger Stadium,3,3
2017-08-26,2017,SD,MIA,1,2,-109,-1.5,155,8.5,-120,100,-101,1.5,-180,4.43,Marlins Park,3,-1
2017-08-26,2017,LAD,MIL,0,3,-177,-1.5,130,8.5,-115,-105,157,1.5,-151,5.43,Dodger Stadium,3,-3
2017-08-26,2017,TOR,MIN,10,9,-115,-1.5,163,9.0,-105,-115,105,1.5,-190,4.81,Rogers Centre,19,1
2017-08-26,2017,WSH,NYM,9,4,-195,-1.5,106,8.0,-101,-119,175,1.5,-126,5.29,Nationals Park,13,5
2017-08-26,2017,SEA,NYY,3,6,170,1.5,-112,9.0,-125,105,-200,-1.5,-108,3.33,Yankee Stadium,9,-3
2017-08-26,2017,TEX,OAK,3,8,-109,-1.5,130,9.5,-113,-107,-101,1.5,-150,4.95,Oakland Coliseum,11,-5
2017-08-26,2017,CHC,PHI,17,2,-200,-1.5,-125,8.5,-124,104,170,1.5,105,5.67,Citizens Bank Park,19,15
2017-08-26,2017,CIN,PIT,0,1,-115,-1.5,176,8.5,-110,-110,105,1.5,-210,4.55,Great American Ballpark,1,-1
2017-08-26,2017,MIA,SD,2,1,-101,1.5,-180,8.5,-120,100,-109,-1.5,155,4.27,Marlins Park,3,1
2017-08-26,2017,NYY,SEA,6,3,-200,-1.5,-108,9.0,-125,105,170,1.5,-112,6.0,Yankee Stadium,9,3
2017-08-26,2017,ARI,SF,2,1,-124,-1.5,166,9.0,-110,-110,114,1.5,-195,4.98,Chase Field,3,1
2017-08-26,2017,TB,STL,4,6,116,1.5,-190,9.0,-101,-119,-131,-1.5,163,4.17,Busch Stadium,10,-2
2017-08-26,2017,STL,TB,6,4,-131,-1.5,163,9.0,-101,-119,116,1.5,-190,5.1,Busch Stadium,10,2
2017-08-26,2017,OAK,TEX,8,3,-101,1.5,-150,9.5,-113,-107,-109,-1.5,130,4.77,Oakland Coliseum,11,5
2017-08-26,2017,MIN,TOR,9,10,105,1.5,-190,9.0,-105,-115,-115,-1.5,163,4.39,Rogers Centre,19,-1
2017-08-26,2017,NYM,WSH,4,9,175,1.5,-126,8.0,-101,-119,-195,-1.5,106,2.91,Nationals Park,13,-5
2017-08-27,2017,SF,ARI,0,11,172,1.5,-115,9.5,-110,-110,-202,-1.5,-105,3.49,Chase Field,11,-11
2017-08-27,2017,COL,ATL,3,0,-134,-1.5,115,9.0,-110,-110,119,1.5,-135,5.15,Suntrust Park,3,3
2017-08-27,2017,BOS,BAL,1,2,-155,-1.5,130,10.5,-105,-115,140,1.5,-150,6.38,Fenway Park,3,-1
2017-08-27,2017,BAL,BOS,2,1,140,1.5,-150,10.5,-105,-115,-155,-1.5,130,4.38,Fenway Park,3,1
2017-08-27,2017,PHI,CHC,6,3,155,1.5,-105,9.5,-115,-105,-175,-1.5,-115,3.73,Citizens Bank Park,9,3
2017-08-27,2017,PIT,CIN,5,2,-101,1.5,-215,9.5,-115,-105,-109,-1.5,180,4.77,Great American Ballpark,7,3
2017-08-27,2017,KC,CLE,0,12,190,1.5,-110,9.0,105,-125,-220,-1.5,-110,3.1,Progressive Field,12,-12
2017-08-27,2017,ATL,COL,0,3,119,1.5,-135,9.0,-110,-110,-134,-1.5,115,4.11,Suntrust Park,3,-3
2017-08-27,2017,DET,CWS,1,7,-106,-1.5,144,10.0,-103,-117,-104,1.5,-165,5.15,Guaranteed Rate Field,8,-6
2017-08-27,2017,CWS,DET,7,1,-104,1.5,-165,10.0,-103,-117,-106,-1.5,144,5.1,Guaranteed Rate Field,8,6
2017-08-27,2017,LAA,HOU,5,7,120,1.5,-133,9.5,100,-120,-135,-1.5,112,4.32,Angel Stadium,12,-2
2017-08-27,2017,CLE,KC,12,0,-220,-1.5,-110,9.0,105,-125,190,1.5,-110,6.19,Progressive Field,12,12
2017-08-27,2017,HOU,LAA,7,5,-135,-1.5,112,9.5,100,-120,120,1.5,-133,5.46,Angel Stadium,12,2
2017-08-27,2017,MIL,LAD,3,2,183,1.5,-125,8.0,-105,-115,-213,-1.5,105,2.83,Dodger Stadium,5,1
2017-08-27,2017,SD,MIA,2,6,144,1.5,-152,8.0,-115,-105,-159,-1.5,133,3.28,Marlins Park,8,-4
2017-08-27,2017,LAD,MIL,2,3,-213,-1.5,105,8.0,-105,-115,183,1.5,-125,5.44,Dodger Stadium,5,-1
2017-08-27,2017,TOR,MIN,2,7,-135,-1.5,138,9.5,100,-120,120,1.5,-157,5.46,Rogers Centre,9,-5
2017-08-27,2017,WSH,NYM,5,6,-165,-1.5,135,9.0,-109,-111,150,1.5,-155,5.6,Nationals Park,11,-1
2017-08-27,2017,WSH,NYM,5,4,-236,-1.5,-119,8.5,-104,-116,206,1.5,-101,5.97,Nationals Park,9,1
2017-08-27,2017,SEA,NYY,1,10,155,1.5,-130,9.0,-125,105,-175,-1.5,110,3.53,Yankee Stadium,11,-9
2017-08-27,2017,TEX,OAK,3,8,111,1.5,-197,10.5,-123,103,-121,-1.5,168,4.98,Oakland Coliseum,11,-5
2017-08-27,2017,CHC,PHI,3,6,-175,-1.5,-115,9.5,-115,-105,155,1.5,-105,6.05,Citizens Bank Park,9,-3
2017-08-27,2017,CIN,PIT,2,5,-109,-1.5,180,9.5,-115,-105,-101,1.5,-215,4.95,Great American Ballpark,7,-3
2017-08-27,2017,MIA,SD,6,2,-159,-1.5,133,8.0,-115,-105,144,1.5,-152,4.91,Marlins Park,8,4
2017-08-27,2017,NYY,SEA,10,1,-175,-1.5,110,9.0,-125,105,155,1.5,-130,5.73,Yankee Stadium,11,9
2017-08-27,2017,ARI,SF,11,0,-202,-1.5,-105,9.5,-110,-110,172,1.5,-115,6.35,Chase Field,11,11
2017-08-27,2017,TB,STL,3,2,-128,-1.5,135,8.0,-120,100,118,1.5,-155,4.49,Busch Stadium,5,1
2017-08-27,2017,STL,TB,2,3,118,1.5,-155,8.0,-120,100,-128,-1.5,135,3.67,Busch Stadium,5,-1
2017-08-27,2017,OAK,TEX,8,3,-121,-1.5,168,10.5,-123,103,111,1.5,-197,5.75,Oakland Coliseum,11,5
2017-08-27,2017,MIN,TOR,7,2,120,1.5,-157,9.5,100,-120,-135,-1.5,138,4.32,Rogers Centre,9,5
2017-08-27,2017,NYM,WSH,6,5,150,1.5,-155,9.0,-109,-111,-165,-1.5,135,3.6,Nationals Park,11,1
2017-08-27,2017,NYM,WSH,4,5,206,1.5,-101,8.5,-104,-116,-236,-1.5,-119,2.78,Nationals Park,9,-1
2017-08-28,2017,PHI,ATL,6,1,-150,-1.5,135,8.0,-119,-101,135,1.5,-155,4.8,Citizens Bank Park,7,5
2017-08-28,2017,SEA,BAL,6,7,100,1.5,-190,10.5,-119,-101,-110,-1.5,163,5.25,Camden Yards,13,-1
2017-08-28,2017,TOR,BOS,5,6,-109,-1.5,184,8.0,-116,-104,-101,1.5,-220,4.17,Rogers Centre,11,-1
2017-08-28,2017,PIT,CHC,1,6,166,1.5,-130,9.0,-102,-118,-186,-1.5,110,3.38,Wrigley Field,7,-5
2017-08-28,2017,NYY,CLE,2,6,103,1.5,-185,6.5,-110,-110,-113,-1.5,160,3.2,Yankee Stadium,8,-4
2017-08-28,2017,DET,COL,4,3,192,1.5,108,13.0,-117,-103,-222,-1.5,-128,4.45,Coors Field,7,1
2017-08-28,2017,COL,DET,3,4,-222,-1.5,-128,13.0,-117,-103,192,1.5,108,8.96,Coors Field,7,-1
2017-08-28,2017,TB,KC,12,0,-114,-1.5,143,10.0,-101,-119,104,1.5,-164,5.33,Kauffman Stadium,12,12
2017-08-28,2017,OAK,LAA,1,3,120,1.5,-175,9.0,-106,-114,-135,-1.5,151,4.09,Angel Stadium,4,-2
2017-08-28,2017,WSH,MIA,11,2,-220,-1.5,-105,8.0,-105,-115,190,1.5,-115,5.5,Nationals Park,13,9
2017-08-28,2017,CLE,NYY,6,2,-113,-1.5,160,6.5,-110,-110,103,1.5,-185,3.45,Yankee Stadium,8,4
2017-08-28,2017,LAA,OAK,3,1,-135,-1.5,151,9.0,-106,-114,120,1.5,-175,5.17,Angel Stadium,4,2
2017-08-28,2017,ATL,PHI,1,6,135,1.5,-155,8.0,-119,-101,-150,-1.5,135,3.4,Citizens Bank Park,7,-5
2017-08-28,2017,CHC,PIT,6,1,-186,-1.5,110,9.0,-102,-118,166,1.5,-130,5.85,Wrigley Field,7,5
2017-08-28,2017,SF,SD,3,0,-105,1.5,-225,7.5,-110,-110,-105,-1.5,188,3.84,PETCO Park,3,3
2017-08-28,2017,BAL,SEA,7,6,-110,-1.5,163,10.5,-119,-101,100,1.5,-190,5.5,Camden Yards,13,1
2017-08-28,2017,SD,SF,0,3,-105,-1.5,188,7.5,-110,-110,-105,1.5,-225,3.84,PETCO Park,3,-3
2017-08-28,2017,KC,TB,0,12,104,1.5,-164,10.0,-101,-119,-114,-1.5,143,4.9,Kauffman Stadium,12,-12
2017-08-28,2017,BOS,TOR,6,5,-101,1.5,-220,8.0,-116,-104,-109,-1.5,184,4.02,Rogers Centre,11,1
2017-08-28,2017,MIA,WSH,2,11,190,1.5,-115,8.0,-105,-115,-220,-1.5,-105,2.76,Nationals Park,13,-9
2017-08-29,2017,LAD,ARI,6,7,-111,-1.5,151,9.0,105,-125,101,1.5,-175,4.73,Chase Field,13,-1
2017-08-29,2017,SEA,BAL,0,4,129,1.5,-155,9.5,105,-125,-144,-1.5,135,4.15,Camden Yards,4,-4
2017-08-29,2017,TOR,BOS,0,3,201,1.5,134,8.5,102,-122,-241,-1.5,-155,2.82,Rogers Centre,3,-3
2017-08-29,2017,PIT,CHC,1,4,200,1.5,-105,8.0,-110,-110,-240,-1.5,-115,2.67,Wrigley Field,5,-3
2017-08-29,2017,NYM,CIN,4,14,145,1.5,-140,9.5,-110,-110,-160,-1.5,120,3.88,Great American Ballpark,18,-10
2017-08-29,2017,DET,COL,3,7,175,1.5,-110,11.0,-125,105,-205,-1.5,-110,4.0,Coors Field,10,-4
2017-08-29,2017,MIN,CWS,6,4,-230,-1.5,-130,9.0,-110,-110,200,1.5,110,6.27,Target Field,10,2
2017-08-29,2017,COL,DET,7,3,-205,-1.5,-110,11.0,-125,105,175,1.5,-110,7.39,Coors Field,10,4
2017-08-29,2017,TEX,HOU,12,2,135,1.5,-145,9.5,-115,-105,-150,-1.5,125,4.04,Tropicana Field,14,10
2017-08-29,2017,TB,KC,2,6,-113,-1.5,148,9.0,-105,-115,103,1.5,-170,4.77,Kauffman Stadium,8,-4
2017-08-29,2017,OAK,LAA,2,8,137,1.5,-160,9.5,104,-124,-152,-1.5,140,4.01,Angel Stadium,10,-6
2017-08-29,2017,ARI,LAD,7,6,101,1.5,-175,9.0,105,-125,-111,-1.5,151,4.48,Chase Field,13,1
2017-08-29,2017,WSH,MIA,8,3,-140,-1.5,130,9.5,100,-120,125,1.5,-150,5.54,Nationals Park,11,5
2017-08-29,2017,STL,MIL,10,2,-140,-1.5,115,9.0,-120,100,125,1.5,-135,5.25,Miller Park,12,8
2017-08-29,2017,CWS,MIN,4,6,200,1.5,110,9.0,-110,-110,-230,-1.5,-130,3.0,Target Field,10,-2
2017-08-29,2017,CIN,NYM,14,4,-160,-1.5,120,9.5,-110,-110,145,1.5,-140,5.85,Great American Ballpark,18,10
2017-08-29,2017,LAA,OAK,8,2,-152,-1.5,140,9.5,104,-124,137,1.5,-160,5.73,Angel Stadium,10,6
2017-08-29,2017,CHC,PIT,4,1,-240,-1.5,-115,8.0,-110,-110,200,1.5,-105,5.65,Wrigley Field,5,3
2017-08-29,2017,SF,SD,3,6,143,1.5,-170,8.5,100,-120,-158,-1.5,148,3.5,PETCO Park,9,-3
2017-08-29,2017,BAL,SEA,4,0,-144,-1.5,135,9.5,105,-125,129,1.5,-155,5.61,Camden Yards,4,4
2017-08-29,2017,SD,SF,6,3,-158,-1.5,148,8.5,100,-120,143,1.5,-170,5.21,PETCO Park,9,3
2017-08-29,2017,MIL,STL,2,10,125,1.5,-135,9.0,-120,100,-140,-1.5,115,4.0,Miller Park,12,-8
2017-08-29,2017,KC,TB,6,2,103,1.5,-170,9.0,-105,-115,-113,-1.5,148,4.43,Kauffman Stadium,8,4
2017-08-29,2017,HOU,TEX,2,12,-150,-1.5,125,9.5,-115,-105,135,1.5,-145,5.7,Tropicana Field,14,-10
2017-08-29,2017,BOS,TOR,3,0,-241,-1.5,-155,8.5,102,-122,201,1.5,134,6.01,Rogers Centre,3,3
2017-08-29,2017,MIA,WSH,3,8,125,1.5,-150,9.5,100,-120,-140,-1.5,130,4.22,Nationals Park,11,-5
2017-08-30,2017,LAD,ARI,4,6,-126,-1.5,130,9.0,-110,-110,116,1.5,-150,5.02,Chase Field,10,-2
2017-08-30,2017,PHI,ATL,1,9,-101,1.5,-175,8.5,-115,-105,-109,-1.5,152,4.27,Citizens Bank Park,10,-8
2017-08-30,2017,PHI,ATL,2,5,100,1.5,-160,9.0,100,-120,-110,-1.5,140,4.5,Citizens Bank Park,7,-3
2017-08-30,2017,SEA,BAL,7,8,117,1.5,-170,10.5,-115,-105,-132,-1.5,148,4.84,Camden Yards,15,-1
2017-08-30,2017,TOR,BOS,1,7,123,1.5,-145,8.5,-105,-115,-138,-1.5,125,3.81,Rogers Centre,8,-6
2017-08-30,2017,PIT,CHC,3,17,175,1.5,-140,9.0,100,-120,-205,-1.5,120,3.27,Wrigley Field,20,-14
2017-08-30,2017,NYM,CIN,2,0,152,1.5,-140,10.0,100,-120,-167,-1.5,120,3.97,Great American Ballpark,2,2
2017-08-30,2017,NYY,CLE,1,2,-134,-1.5,160,8.5,-120,100,119,1.5,-185,4.87,Yankee Stadium,3,-1
2017-08-30,2017,NYY,CLE,4,9,-182,-1.5,116,9.0,-120,100,162,1.5,-136,5.81,Yankee Stadium,13,-5
2017-08-30,2017,DET,COL,6,2,137,1.5,-150,11.5,-110,-110,-152,-1.5,130,4.85,Coors Field,8,4
2017-08-30,2017,MIN,CWS,11,1,-270,-1.5,-140,9.5,-103,-117,230,1.5,120,6.93,Target Field,12,10
2017-08-30,2017,COL,DET,2,6,-152,-1.5,130,11.5,-110,-110,137,1.5,-150,6.94,Coors Field,8,-4
2017-08-30,2017,TEX,HOU,8,1,195,1.5,-105,9.0,-105,-115,-225,-1.5,-115,3.05,Tropicana Field,9,7
2017-08-30,2017,TB,KC,5,3,118,1.5,-185,9.5,-105,-115,-128,-1.5,160,4.36,Kauffman Stadium,8,2
2017-08-30,2017,OAK,LAA,8,10,134,1.5,-160,9.0,100,-120,-149,-1.5,140,3.85,Angel Stadium,18,-2
2017-08-30,2017,ARI,LAD,6,4,116,1.5,-150,9.0,-110,-110,-126,-1.5,130,4.17,Chase Field,10,2
2017-08-30,2017,WSH,MIA,4,0,-219,-1.5,-110,8.5,-105,-115,189,1.5,-110,5.84,Nationals Park,4,4
2017-08-30,2017,STL,MIL,5,6,-118,-1.5,140,9.0,-113,-107,108,1.5,-160,4.87,Miller Park,11,-1
2017-08-30,2017,CWS,MIN,1,11,230,1.5,120,9.5,-103,-117,-270,-1.5,-140,2.88,Target Field,12,-10
2017-08-30,2017,CIN,NYM,0,2,-167,-1.5,120,10.0,100,-120,152,1.5,-140,6.25,Great American Ballpark,2,-2
2017-08-30,2017,CLE,NYY,2,1,119,1.5,-185,8.5,-120,100,-134,-1.5,160,3.88,Yankee Stadium,3,1
2017-08-30,2017,CLE,NYY,9,4,162,1.5,-136,9.0,-120,100,-182,-1.5,116,3.44,Yankee Stadium,13,5
2017-08-30,2017,LAA,OAK,10,8,-149,-1.5,140,9.0,100,-120,134,1.5,-160,5.39,Angel Stadium,18,2
2017-08-30,2017,ATL,PHI,9,1,-109,-1.5,152,8.5,-115,-105,-101,1.5,-175,4.43,Citizens Bank Park,10,8
2017-08-30,2017,ATL,PHI,5,2,-110,-1.5,140,9.0,100,-120,100,1.5,-160,4.71,Citizens Bank Park,7,3
2017-08-30,2017,CHC,PIT,17,3,-205,-1.5,120,9.0,100,-120,175,1.5,-140,6.05,Wrigley Field,20,14
2017-08-30,2017,SF,SD,0,5,137,1.5,-161,8.5,-120,100,-152,-1.5,141,3.59,PETCO Park,5,-5
2017-08-30,2017,BAL,SEA,8,7,-132,-1.5,148,10.5,-115,-105,117,1.5,-170,5.97,Camden Yards,15,1
2017-08-30,2017,SD,SF,5,0,-152,-1.5,141,8.5,-120,100,137,1.5,-161,5.13,PETCO Park,5,5
2017-08-30,2017,MIL,STL,6,5,108,1.5,-160,9.0,-113,-107,-118,-1.5,140,4.33,Miller Park,11,1
2017-08-30,2017,KC,TB,3,5,-128,-1.5,160,9.5,-105,-115,118,1.5,-185,5.33,Kauffman Stadium,8,-2
2017-08-30,2017,HOU,TEX,1,8,-225,-1.5,-115,9.0,-105,-115,195,1.5,-105,6.23,Tropicana Field,9,-7
2017-08-30,2017,BOS,TOR,7,1,-138,-1.5,125,8.5,-105,-115,123,1.5,-145,4.93,Rogers Centre,8,6
2017-08-30,2017,MIA,WSH,0,4,189,1.5,-110,8.5,-105,-115,-219,-1.5,-110,2.94,Nationals Park,4,-4
2017-08-31,2017,LAD,ARI,1,8,-109,-1.5,144,8.5,-105,-115,-101,1.5,-165,4.43,Chase Field,9,-7
2017-08-31,2017,CHC,ATL,6,2,-245,-1.5,-119,7.0,-125,105,205,1.5,-101,4.97,Wrigley Field,8,4
2017-08-31,2017,TOR,BAL,11,8,153,1.5,-130,10.0,-110,-110,-173,-1.5,110,3.95,Camden Yards,19,3
2017-08-31,2017,NYY,BOS,6,2,-149,-1.5,140,9.0,-110,-110,134,1.5,-160,5.39,Yankee Stadium,8,4
2017-08-31,2017,ATL,CHC,2,6,205,1.5,-101,7.0,-125,105,-245,-1.5,-119,2.3,Wrigley Field,8,-4
2017-08-31,2017,NYM,CIN,2,7,-149,-1.5,110,8.5,-110,-110,134,1.5,-130,5.09,Great American Ballpark,9,-5
2017-08-31,2017,MIN,CWS,5,4,-161,-1.5,130,9.5,-105,-115,146,1.5,-150,5.86,Target Field,9,1
2017-08-31,2017,TEX,HOU,1,5,155,1.5,-131,9.5,100,-120,-175,-1.5,111,3.73,Tropicana Field,6,-4
2017-08-31,2017,ARI,LAD,8,1,-101,1.5,-165,8.5,-105,-115,-109,-1.5,144,4.27,Chase Field,9,7
2017-08-31,2017,PHI,MIA,3,2,177,1.5,-114,9.0,-110,-110,-197,-1.5,-106,3.25,Marlins Park,5,1
2017-08-31,2017,WSH,MIL,3,6,120,1.5,-185,9.0,-110,-110,-135,-1.5,160,4.09,Miller Park,9,-3
2017-08-31,2017,CWS,MIN,4,5,146,1.5,-150,9.5,-105,-115,-161,-1.5,130,3.86,Target Field,9,-1
2017-08-31,2017,CIN,NYM,7,2,134,1.5,-130,8.5,-110,-110,-149,-1.5,110,3.63,Great American Ballpark,9,5
2017-08-31,2017,BOS,NYY,2,6,134,1.5,-160,9.0,-110,-110,-149,-1.5,140,3.85,Yankee Stadium,8,-4
2017-08-31,2017,MIA,PHI,2,3,-197,-1.5,-106,9.0,-110,-110,177,1.5,-114,5.97,Marlins Park,5,-1
2017-08-31,2017,STL,SF,5,2,-170,-1.5,-115,8.5,-120,100,150,1.5,-105,5.35,AT&T Park,7,3
2017-08-31,2017,SF,STL,2,5,150,1.5,-105,8.5,-120,100,-170,-1.5,-115,3.4,AT&T Park,7,-3
2017-08-31,2017,HOU,TEX,5,1,-175,-1.5,111,9.5,100,-120,155,1.5,-131,6.05,Tropicana Field,6,4
2017-08-31,2017,BAL,TOR,8,11,-173,-1.5,110,10.0,-110,-110,153,1.5,-130,6.34,Camden Yards,19,-3
2017-08-31,2017,MIL,WSH,6,3,-135,-1.5,160,9.0,-110,-110,120,1.5,-185,5.17,Miller Park,9,3
2017-09-01,2017,COL,ARI,5,9,-112,-1.5,163,12.5,-105,-115,102,1.5,-190,6.6,Coors Field,14,-4
2017-09-01,2017,CHC,ATL,2,0,-220,-1.5,-105,8.5,-105,-115,190,1.5,-115,5.84,Wrigley Field,2,2
2017-09-01,2017,TOR,BAL,0,1,170,1.5,-120,9.0,-110,-110,-200,-1.5,100,3.33,Camden Yards,1,-1
2017-09-01,2017,NYY,BOS,1,4,-185,-1.5,110,8.5,-113,-107,165,1.5,-130,5.52,Yankee Stadium,5,-3
2017-09-01,2017,ATL,CHC,0,2,190,1.5,-115,8.5,-105,-115,-220,-1.5,-105,2.93,Wrigley Field,2,-2
2017-09-01,2017,PIT,CIN,3,7,-119,-1.5,176,7.5,105,-125,109,1.5,-210,4.08,PNC Park,10,-4
2017-09-01,2017,DET,CLE,2,3,206,1.5,125,8.5,-104,-116,-246,-1.5,-145,2.78,Comerica Park,5,-1
2017-09-01,2017,DET,CLE,0,10,144,1.5,-116,8.5,-115,-105,-159,-1.5,-104,3.48,Comerica Park,10,-10
2017-09-01,2017,ARI,COL,9,5,102,1.5,-190,12.5,-105,-115,-112,-1.5,163,6.19,Coors Field,14,4
2017-09-01,2017,TB,CWS,3,1,-204,-1.5,-135,9.0,105,-125,174,1.5,115,6.04,Guaranteed Rate Field,4,2
2017-09-01,2017,CLE,DET,3,2,-246,-1.5,-145,8.5,-104,-116,206,1.5,125,6.04,Comerica Park,5,1
2017-09-01,2017,CLE,DET,10,0,-159,-1.5,-104,8.5,-115,-105,144,1.5,-116,5.22,Comerica Park,10,10
2017-09-01,2017,MIN,KC,6,7,-108,-1.5,176,9.5,-105,-115,-102,1.5,-210,4.93,Target Field,13,-1
2017-09-01,2017,TEX,LAA,10,9,133,1.5,-125,10.5,-115,-105,-148,-1.5,105,4.51,Rangers Ballpark,19,1
2017-09-01,2017,SD,LAD,0,1,235,1.5,120,7.0,-108,-112,-275,-1.5,-140,2.09,PETCO Park,1,-1
2017-09-01,2017,PHI,MIA,2,1,158,1.5,-139,9.0,105,-125,-178,-1.5,119,3.49,Marlins Park,3,1
2017-09-01,2017,WSH,MIL,0,1,136,1.5,-150,8.5,-115,-105,-151,-1.5,130,3.6,Miller Park,1,-1
2017-09-01,2017,KC,MIN,7,6,-102,1.5,-210,9.5,-105,-115,-108,-1.5,176,4.8,Target Field,13,1
2017-09-01,2017,BOS,NYY,4,1,165,1.5,-130,8.5,-113,-107,-185,-1.5,110,3.21,Yankee Stadium,5,3
2017-09-01,2017,SEA,OAK,3,2,-150,-1.5,135,9.5,100,-120,135,1.5,-155,5.7,T-Mobile Park,5,1
2017-09-01,2017,MIA,PHI,1,2,-178,-1.5,119,9.0,105,-125,158,1.5,-139,5.76,Marlins Park,3,-1
2017-09-01,2017,CIN,PIT,7,3,109,1.5,-210,7.5,105,-125,-119,-1.5,176,3.59,PNC Park,10,4
2017-09-01,2017,LAD,SD,1,0,-275,-1.5,-140,7.0,-108,-112,235,1.5,120,5.13,PETCO Park,1,1
2017-09-01,2017,OAK,SEA,2,3,135,1.5,-155,9.5,100,-120,-150,-1.5,135,4.04,T-Mobile Park,5,-1
2017-09-01,2017,STL,SF,11,6,-116,-1.5,141,9.0,-115,-105,106,1.5,-161,4.83,AT&T Park,17,5
2017-09-01,2017,SF,STL,6,11,106,1.5,-161,9.0,-115,-105,-116,-1.5,141,4.37,AT&T Park,17,-5
2017-09-01,2017,CWS,TB,1,3,174,1.5,115,9.0,105,-125,-204,-1.5,-135,3.28,Guaranteed Rate Field,4,-2
2017-09-01,2017,LAA,TEX,9,10,-148,-1.5,105,10.5,-115,-105,133,1.5,-125,6.27,Rangers Ballpark,19,-1
2017-09-01,2017,BAL,TOR,1,0,-200,-1.5,100,9.0,-110,-110,170,1.5,-120,6.0,Camden Yards,1,1
2017-09-01,2017,MIL,WSH,1,0,-151,-1.5,130,8.5,-115,-105,136,1.5,-150,5.11,Miller Park,1,1
2017-09-02,2017,COL,ARI,2,6,-128,-1.5,144,11.5,100,-120,118,1.5,-165,6.46,Coors Field,8,-4
2017-09-02,2017,CHC,ATL,14,12,-255,-1.5,-125,8.5,-107,-113,215,1.5,106,6.11,Wrigley Field,26,2
2017-09-02,2017,TOR,BAL,7,2,101,1.5,-215,8.5,-120,100,-111,-1.5,180,4.23,Camden Yards,9,5
2017-09-02,2017,NYY,BOS,5,1,-165,-1.5,125,8.0,103,-123,150,1.5,-145,4.98,Yankee Stadium,6,4
2017-09-02,2017,ATL,CHC,12,14,215,1.5,106,8.5,-107,-113,-255,-1.5,-125,2.7,Wrigley Field,26,-2
2017-09-02,2017,PIT,CIN,5,0,-135,-1.5,150,8.0,-115,-105,120,1.5,-173,4.6,PNC Park,5,5
2017-09-02,2017,DET,CLE,2,5,280,1.5,-140,8.0,103,-123,-330,-1.5,-168,2.11,Comerica Park,7,-3
2017-09-02,2017,ARI,COL,6,2,118,1.5,-165,11.5,100,-120,-128,-1.5,144,5.28,Coors Field,8,4
2017-09-02,2017,TB,CWS,4,5,-207,-1.5,-134,8.0,100,-120,177,1.5,114,5.39,Guaranteed Rate Field,9,-1
2017-09-02,2017,CLE,DET,5,2,-330,-1.5,-168,8.0,103,-123,280,1.5,-140,6.14,Comerica Park,7,3
2017-09-02,2017,NYM,HOU,8,12,238,1.5,108,9.0,-110,-110,-278,-1.5,-126,2.66,Minute Maid Park,20,-4
2017-09-02,2017,NYM,HOU,1,4,238,1.5,125,8.5,100,-120,-278,-1.5,-145,2.51,Minute Maid Park,5,-3
2017-09-02,2017,MIN,KC,17,0,-129,-1.5,151,10.0,-105,-115,119,1.5,-175,5.63,Target Field,17,17
2017-09-02,2017,TEX,LAA,4,7,118,1.5,-140,11.0,-123,103,-133,-1.5,120,5.05,Rangers Ballpark,11,-3
2017-09-02,2017,SD,LAD,6,5,109,1.5,-158,9.0,-110,-110,-119,-1.5,138,4.31,PETCO Park,11,1
2017-09-02,2017,SD,LAD,7,2,290,1.5,160,8.5,-118,-102,-350,-1.5,-185,2.18,PETCO Park,9,5
2017-09-02,2017,PHI,MIA,9,10,152,1.5,-165,7.5,-105,-115,-167,-1.5,144,2.98,Marlins Park,19,-1
2017-09-02,2017,WSH,MIL,3,2,-213,-1.5,-124,8.0,-107,-113,183,1.5,104,5.44,Miller Park,5,1
2017-09-02,2017,KC,MIN,0,17,119,1.5,-175,10.0,-105,-115,-129,-1.5,151,4.57,Target Field,17,-17
2017-09-02,2017,HOU,NYM,12,8,-278,-1.5,-126,9.0,-110,-110,238,1.5,108,6.62,Minute Maid Park,20,4
2017-09-02,2017,HOU,NYM,4,1,-278,-1.5,-145,8.5,100,-120,238,1.5,125,6.25,Minute Maid Park,5,3
2017-09-02,2017,BOS,NYY,1,5,150,1.5,-145,8.0,103,-123,-165,-1.5,125,3.2,Yankee Stadium,6,-4
2017-09-02,2017,SEA,OAK,7,6,-122,-1.5,160,9.5,-123,103,112,1.5,-185,5.22,T-Mobile Park,13,1
2017-09-02,2017,MIA,PHI,10,9,-167,-1.5,144,7.5,-105,-115,152,1.5,-165,4.69,Marlins Park,19,1
2017-09-02,2017,CIN,PIT,0,5,120,1.5,-173,8.0,-115,-105,-135,-1.5,150,3.64,PNC Park,5,-5
2017-09-02,2017,LAD,SD,5,6,-119,-1.5,138,9.0,-110,-110,109,1.5,-158,4.89,PETCO Park,11,-1
2017-09-02,2017,LAD,SD,2,7,-350,-1.5,-185,8.5,-118,-102,290,1.5,160,6.61,PETCO Park,9,-5
2017-09-02,2017,OAK,SEA,6,7,112,1.5,-185,9.5,-123,103,-122,-1.5,160,4.48,T-Mobile Park,13,-1
2017-09-02,2017,STL,SF,1,2,-102,-1.5,155,9.5,-101,-119,-108,1.5,-180,4.8,AT&T Park,3,-1
2017-09-02,2017,SF,STL,2,1,-108,1.5,-180,9.5,-101,-119,-102,-1.5,155,4.93,AT&T Park,3,1
2017-09-02,2017,CWS,TB,5,4,177,1.5,114,8.0,100,-120,-207,-1.5,-134,2.89,Guaranteed Rate Field,9,1
2017-09-02,2017,LAA,TEX,7,4,-133,-1.5,120,11.0,-123,103,118,1.5,-140,6.28,Rangers Ballpark,11,3
2017-09-02,2017,BAL,TOR,2,7,-111,-1.5,180,8.5,-120,100,101,1.5,-215,4.47,Camden Yards,9,-5
2017-09-02,2017,MIL,WSH,2,3,183,1.5,104,8.0,-107,-113,-213,-1.5,-124,2.83,Miller Park,5,-1
2017-09-03,2017,COL,ARI,1,5,-144,-1.5,135,11.0,-110,-110,129,1.5,-155,6.49,Coors Field,6,-4
2017-09-03,2017,CHC,ATL,1,5,-250,-1.5,-128,9.5,-119,-101,210,1.5,109,6.79,Wrigley Field,6,-4
2017-09-03,2017,TOR,BAL,4,5,135,1.5,-140,11.0,-101,-119,-150,-1.5,120,4.68,Camden Yards,9,-1
2017-09-03,2017,NYY,BOS,9,2,-102,1.5,-180,6.5,-131,111,-108,-1.5,155,3.28,Yankee Stadium,11,7
2017-09-03,2017,ATL,CHC,5,1,210,1.5,109,9.5,-119,-101,-250,-1.5,-128,3.06,Wrigley Field,6,4
2017-09-03,2017,PIT,CIN,3,1,-111,-1.5,163,9.0,100,-120,101,1.5,-190,4.73,PNC Park,4,2
2017-09-03,2017,DET,CLE,1,11,172,1.5,115,10.0,100,-120,-202,-1.5,-135,3.68,Comerica Park,12,-10
2017-09-03,2017,ARI,COL,5,1,129,1.5,-155,11.0,-110,-110,-144,-1.5,135,4.8,Coors Field,6,4
2017-09-03,2017,TB,CWS,2,6,-155,-1.5,102,9.5,-114,-106,140,1.5,-122,5.77,Guaranteed Rate Field,8,-4
2017-09-03,2017,CLE,DET,11,1,-202,-1.5,-135,10.0,100,-120,172,1.5,115,6.69,Comerica Park,12,10
2017-09-03,2017,NYM,HOU,6,8,230,1.5,113,9.5,-110,-110,-270,-1.5,-133,2.88,Minute Maid Park,14,-2
2017-09-03,2017,MIN,KC,4,5,-185,-1.5,113,10.0,-101,-119,165,1.5,-133,6.49,Target Field,9,-1
2017-09-03,2017,TEX,LAA,7,6,116,1.5,-140,11.0,-115,-105,-131,-1.5,120,5.09,Rangers Ballpark,13,1
2017-09-03,2017,SD,LAD,6,4,180,1.5,105,8.0,-119,-101,-210,-1.5,-125,2.86,PETCO Park,10,2
2017-09-03,2017,PHI,MIA,3,1,175,1.5,-120,9.5,-105,-115,-205,-1.5,100,3.45,Marlins Park,4,2
2017-09-03,2017,WSH,MIL,2,7,119,1.5,-170,9.5,-110,-110,-134,-1.5,148,4.34,Miller Park,9,-5
2017-09-03,2017,KC,MIN,5,4,165,1.5,-133,10.0,-101,-119,-185,-1.5,113,3.77,Target Field,9,1
2017-09-03,2017,HOU,NYM,8,6,-270,-1.5,-133,9.5,-110,-110,230,1.5,113,6.93,Minute Maid Park,14,2
2017-09-03,2017,BOS,NYY,2,9,-108,-1.5,155,6.5,-131,111,-102,1.5,-180,3.38,Yankee Stadium,11,-7
2017-09-03,2017,SEA,OAK,10,2,-152,-1.5,130,10.0,-110,-110,137,1.5,-150,6.03,T-Mobile Park,12,8
2017-09-03,2017,MIA,PHI,1,3,-205,-1.5,100,9.5,-105,-115,175,1.5,-120,6.39,Marlins Park,4,-2
2017-09-03,2017,CIN,PIT,1,3,101,1.5,-190,9.0,100,-120,-111,-1.5,163,4.48,PNC Park,4,-2
2017-09-03,2017,LAD,SD,4,6,-210,-1.5,-125,8.0,-119,-101,180,1.5,105,5.42,PETCO Park,10,-2
2017-09-03,2017,OAK,SEA,2,10,137,1.5,-150,10.0,-110,-110,-152,-1.5,130,4.22,T-Mobile Park,12,-8
2017-09-03,2017,STL,SF,7,3,-124,-1.5,140,7.5,-101,-119,114,1.5,-160,4.15,AT&T Park,10,4
2017-09-03,2017,SF,STL,3,7,114,1.5,-160,7.5,-101,-119,-124,-1.5,140,3.5,AT&T Park,10,-4
2017-09-03,2017,CWS,TB,6,2,140,1.5,-122,9.5,-114,-106,-155,-1.5,102,3.96,Guaranteed Rate Field,8,4
2017-09-03,2017,LAA,TEX,6,7,-131,-1.5,120,11.0,-115,-105,116,1.5,-140,6.24,Rangers Ballpark,13,-1
2017-09-03,2017,BAL,TOR,5,4,-150,-1.5,120,11.0,-101,-119,135,1.5,-140,6.6,Camden Yards,9,1
2017-09-03,2017,MIL,WSH,7,2,-134,-1.5,148,9.5,-110,-110,119,1.5,-170,5.44,Miller Park,9,5
2017-09-04,2017,LAD,ARI,0,13,-175,-1.5,135,8.0,-115,-105,155,1.5,-155,5.09,Dodger Stadium,13,-13
2017-09-04,2017,TEX,ATL,8,2,109,1.5,-179,9.0,-115,-105,-119,-1.5,153,4.31,Suntrust Park,10,6
2017-09-04,2017,NYY,BAL,7,4,125,1.5,-160,9.5,-110,-110,-140,-1.5,140,4.22,Camden Yards,11,3
2017-09-04,2017,TOR,BOS,10,4,157,1.5,-132,9.5,-120,100,-177,-1.5,112,3.7,Fenway Park,14,6
2017-09-04,2017,PIT,CHC,12,0,158,1.5,100,8.5,-105,-115,-178,-1.5,-120,3.29,PNC Park,12,12
2017-09-04,2017,MIL,CIN,4,5,-140,-1.5,105,10.0,-120,100,125,1.5,-125,5.83,Great American Ballpark,9,-1
2017-09-04,2017,CWS,CLE,3,5,200,1.5,125,10.0,-101,-119,-240,-1.5,-145,3.33,Guaranteed Rate Field,8,-2
2017-09-04,2017,SF,COL,3,4,160,1.5,-114,13.0,-116,-104,-180,-1.5,-106,5.0,Coors Field,7,-1
2017-09-04,2017,CLE,CWS,5,3,-240,-1.5,-145,10.0,-101,-119,200,1.5,125,7.06,Guaranteed Rate Field,8,2
2017-09-04,2017,KC,DET,7,6,-160,-1.5,-105,9.5,-101,-119,145,1.5,-115,5.85,Comerica Park,13,1
2017-09-04,2017,SEA,HOU,2,6,119,1.5,-145,9.0,-120,100,-134,-1.5,125,4.11,T-Mobile Park,8,-4
2017-09-04,2017,DET,KC,6,7,145,1.5,-115,9.5,-101,-119,-160,-1.5,-105,3.88,Comerica Park,13,-1
2017-09-04,2017,OAK,LAA,9,11,139,1.5,-125,10.0,-121,101,-154,-1.5,105,4.18,Oakland Coliseum,20,-2
2017-09-04,2017,ARI,LAD,13,0,155,1.5,-155,8.0,-115,-105,-175,-1.5,135,3.14,Dodger Stadium,13,13
2017-09-04,2017,WSH,MIA,7,2,114,1.5,-200,9.0,-125,105,-124,-1.5,170,4.21,Marlins Park,9,5
2017-09-04,2017,CIN,MIL,5,4,125,1.5,-125,10.0,-120,100,-140,-1.5,105,4.44,Great American Ballpark,9,1
2017-09-04,2017,TB,MIN,11,4,-129,-1.5,163,8.0,-119,-101,119,1.5,-190,4.51,Tropicana Field,15,7
2017-09-04,2017,PHI,NYM,7,11,-102,1.5,-215,8.5,-120,100,-108,-1.5,180,4.29,Citi Field,18,-4
2017-09-04,2017,BAL,NYY,4,7,-140,-1.5,140,9.5,-110,-110,125,1.5,-160,5.54,Camden Yards,11,-3
2017-09-04,2017,LAA,OAK,11,9,-154,-1.5,105,10.0,-121,101,139,1.5,-125,6.06,Oakland Coliseum,20,2
2017-09-04,2017,NYM,PHI,11,7,-108,-1.5,180,8.5,-120,100,-102,1.5,-215,4.41,Citi Field,18,4
2017-09-04,2017,CHC,PIT,0,12,-178,-1.5,-120,8.5,-105,-115,158,1.5,100,5.44,PNC Park,12,-12
2017-09-04,2017,STL,SD,2,0,-143,-1.5,115,8.0,-114,-106,128,1.5,-135,4.71,PETCO Park,2,2
2017-09-04,2017,HOU,SEA,6,2,-134,-1.5,125,9.0,-120,100,119,1.5,-145,5.15,T-Mobile Park,8,4
2017-09-04,2017,COL,SF,4,3,-180,-1.5,-106,13.0,-116,-104,160,1.5,-114,8.36,Coors Field,7,1
2017-09-04,2017,SD,STL,0,2,128,1.5,-135,8.0,-114,-106,-143,-1.5,115,3.51,PETCO Park,2,-2
2017-09-04,2017,MIN,TB,4,11,119,1.5,-190,8.0,-119,-101,-129,-1.5,163,3.65,Tropicana Field,15,-7
2017-09-04,2017,ATL,TEX,2,8,-119,-1.5,153,9.0,-115,-105,109,1.5,-179,4.89,Suntrust Park,10,-6
2017-09-04,2017,BOS,TOR,4,10,-177,-1.5,112,9.5,-120,100,157,1.5,-132,6.07,Fenway Park,14,-6
2017-09-04,2017,MIA,WSH,2,7,-124,-1.5,170,9.0,-125,105,114,1.5,-200,4.98,Marlins Park,9,-5
2017-09-05,2017,LAD,ARI,1,3,-150,-1.5,148,7.5,-115,-105,135,1.5,-170,4.5,Dodger Stadium,4,-2
2017-09-05,2017,NYY,BAL,6,7,-110,1.5,-205,9.5,-120,100,100,-1.5,172,4.98,Camden Yards,13,-1
2017-09-05,2017,TOR,BOS,2,3,175,1.5,-115,10.0,-105,-115,-195,-1.5,-105,3.64,Fenway Park,5,-1
2017-09-05,2017,PIT,CHC,4,3,153,1.5,-116,8.5,-105,-115,-168,-1.5,-104,3.36,PNC Park,7,1
2017-09-05,2017,MIL,CIN,3,9,-128,-1.5,121,9.5,-110,-110,118,1.5,-141,5.33,Great American Ballpark,12,-6
2017-09-05,2017,CWS,CLE,4,9,230,1.5,140,9.0,-125,105,-270,-1.5,-160,2.73,Guaranteed Rate Field,13,-5
2017-09-05,2017,SF,COL,6,9,175,1.5,-105,12.0,-105,-115,-195,-1.5,-115,4.36,Coors Field,15,-3
2017-09-05,2017,CLE,CWS,9,4,-270,-1.5,-160,9.0,-125,105,230,1.5,140,6.57,Guaranteed Rate Field,13,5
2017-09-05,2017,KC,DET,2,13,-117,-1.5,135,9.5,100,-120,107,1.5,-155,5.12,Comerica Park,15,-11
2017-09-05,2017,SEA,HOU,1,3,138,1.5,-120,9.5,-116,-104,-153,-1.5,-101,3.99,T-Mobile Park,4,-2
2017-09-05,2017,DET,KC,13,2,107,1.5,-155,9.5,100,-120,-117,-1.5,135,4.59,Comerica Park,15,11
2017-09-05,2017,OAK,LAA,7,8,133,1.5,-110,9.5,100,-120,-148,-1.5,-110,4.08,Oakland Coliseum,15,-1
2017-09-05,2017,ARI,LAD,3,1,135,1.5,-170,7.5,-115,-105,-150,-1.5,148,3.19,Dodger Stadium,4,2
2017-09-05,2017,WSH,MIA,2,1,-175,-1.5,-110,8.5,-105,-115,155,1.5,-110,5.41,Marlins Park,3,1
2017-09-05,2017,CIN,MIL,9,3,118,1.5,-141,9.5,-110,-110,-128,-1.5,121,4.36,Great American Ballpark,12,6
2017-09-05,2017,TB,MIN,2,1,-145,-1.5,135,9.0,100,-120,130,1.5,-155,5.33,Tropicana Field,3,1
2017-09-05,2017,PHI,NYM,9,1,176,1.5,-130,8.0,-110,-110,-196,-1.5,110,2.9,Citi Field,10,8
2017-09-05,2017,BAL,NYY,7,6,100,-1.5,172,9.5,-120,100,-110,1.5,-205,4.75,Camden Yards,13,1
2017-09-05,2017,LAA,OAK,8,7,-148,-1.5,-110,9.5,100,-120,133,1.5,-110,5.67,Oakland Coliseum,15,1
2017-09-05,2017,NYM,PHI,1,9,-196,-1.5,110,8.0,-110,-110,176,1.5,-130,5.3,Citi Field,10,-8
2017-09-05,2017,CHC,PIT,3,4,-168,-1.5,-104,8.5,-105,-115,153,1.5,-116,5.33,PNC Park,7,-1
2017-09-05,2017,STL,SD,8,4,-155,-1.5,105,8.0,100,-120,140,1.5,-125,4.86,PETCO Park,12,4
2017-09-05,2017,HOU,SEA,3,1,-153,-1.5,-101,9.5,-116,-104,138,1.5,-120,5.75,T-Mobile Park,4,2
2017-09-05,2017,COL,SF,9,6,-195,-1.5,-115,12.0,-105,-115,175,1.5,-105,7.93,Coors Field,15,3
2017-09-05,2017,SD,STL,4,8,140,1.5,-125,8.0,100,-120,-155,-1.5,105,3.33,PETCO Park,12,-4
2017-09-05,2017,MIN,TB,1,2,130,1.5,-155,9.0,100,-120,-145,-1.5,135,3.91,Tropicana Field,3,-1
2017-09-05,2017,BOS,TOR,3,2,-195,-1.5,-105,10.0,-105,-115,175,1.5,-115,6.61,Fenway Park,5,1
2017-09-05,2017,MIA,WSH,1,2,155,1.5,-110,8.5,-105,-115,-175,-1.5,-110,3.33,Marlins Park,3,-1
2017-09-06,2017,LAD,ARI,1,3,-190,-1.5,105,8.5,-105,-115,170,1.5,-125,5.57,Dodger Stadium,4,-2
2017-09-06,2017,TEX,ATL,12,8,-111,-1.5,140,9.0,-115,-105,101,1.5,-160,4.73,Suntrust Park,20,4
2017-09-06,2017,TEX,ATL,4,5,-113,-1.5,140,9.0,-101,-119,103,1.5,-160,4.77,Suntrust Park,9,-1
2017-09-06,2017,TOR,BOS,1,6,165,1.5,-125,9.5,105,-125,-185,-1.5,105,3.58,Fenway Park,7,-5
2017-09-06,2017,PIT,CHC,0,1,113,1.5,-160,7.5,-115,-105,-123,-1.5,140,3.52,PNC Park,1,-1
2017-09-06,2017,MIL,CIN,1,7,125,1.5,-165,9.5,-101,-119,-140,-1.5,144,4.22,Great American Ballpark,8,-6
2017-09-06,2017,CWS,CLE,1,5,225,1.5,121,8.5,-101,-119,-265,-1.5,-141,2.62,Guaranteed Rate Field,6,-4
2017-09-06,2017,SF,COL,11,3,170,1.5,-108,11.0,-119,-101,-200,-1.5,-112,4.07,Coors Field,14,8
2017-09-06,2017,CLE,CWS,5,1,-265,-1.5,-141,8.5,-101,-119,225,1.5,121,6.17,Guaranteed Rate Field,6,4
2017-09-06,2017,KC,DET,13,2,-140,-1.5,118,9.0,-115,-105,125,1.5,-138,5.25,Comerica Park,15,11
2017-09-06,2017,SEA,HOU,3,5,140,1.5,-118,9.0,-120,100,-155,-1.5,-102,3.75,T-Mobile Park,8,-2
2017-09-06,2017,DET,KC,2,13,125,1.5,-138,9.0,-115,-105,-140,-1.5,118,4.0,Comerica Park,15,-11
2017-09-06,2017,OAK,LAA,3,1,118,1.5,-150,10.0,-110,-110,-128,-1.5,130,4.59,Oakland Coliseum,4,2
2017-09-06,2017,ARI,LAD,3,1,170,1.5,-125,8.5,-105,-115,-190,-1.5,105,3.15,Dodger Stadium,4,2
2017-09-06,2017,WSH,MIA,8,1,-117,-1.5,135,8.5,-115,-105,107,1.5,-155,4.58,Marlins Park,9,7
2017-09-06,2017,CIN,MIL,7,1,-140,-1.5,144,9.5,-101,-119,125,1.5,-165,5.54,Great American Ballpark,8,6
2017-09-06,2017,TB,MIN,6,10,-190,-1.5,105,8.5,-105,-115,170,1.5,-125,5.57,Tropicana Field,16,-4
2017-09-06,2017,PHI,NYM,3,6,-105,1.5,-210,8.0,-109,-111,-105,-1.5,176,4.1,Citi Field,9,-3
2017-09-06,2017,LAA,OAK,1,3,-128,-1.5,130,10.0,-110,-110,118,1.5,-150,5.61,Oakland Coliseum,4,-2
2017-09-06,2017,NYM,PHI,6,3,-105,-1.5,176,8.0,-109,-111,-105,1.5,-210,4.1,Citi Field,9,3
2017-09-06,2017,CHC,PIT,1,0,-123,-1.5,140,7.5,-115,-105,113,1.5,-160,4.14,PNC Park,1,1
2017-09-06,2017,STL,SD,3,1,125,1.5,-175,8.0,100,-120,-140,-1.5,151,3.56,PETCO Park,4,2
2017-09-06,2017,HOU,SEA,5,3,-155,-1.5,-102,9.0,-120,100,140,1.5,-118,5.47,T-Mobile Park,8,2
2017-09-06,2017,COL,SF,3,11,-200,-1.5,-112,11.0,-119,-101,170,1.5,-108,7.33,Coors Field,14,-8
2017-09-06,2017,SD,STL,1,3,-140,-1.5,151,8.0,100,-120,125,1.5,-175,4.67,PETCO Park,4,-2
2017-09-06,2017,MIN,TB,10,6,170,1.5,-125,8.5,-105,-115,-190,-1.5,105,3.15,Tropicana Field,16,4
2017-09-06,2017,ATL,TEX,8,12,101,1.5,-160,9.0,-115,-105,-111,-1.5,140,4.48,Suntrust Park,20,-4
2017-09-06,2017,ATL,TEX,5,4,103,1.5,-160,9.0,-101,-119,-113,-1.5,140,4.43,Suntrust Park,9,1
2017-09-06,2017,BOS,TOR,6,1,-185,-1.5,105,9.5,105,-125,165,1.5,-125,6.17,Fenway Park,7,5
2017-09-06,2017,MIA,WSH,1,8,107,1.5,-155,8.5,-115,-105,-117,-1.5,135,4.11,Marlins Park,9,-7
2017-09-07,2017,MIA,ATL,5,6,-126,-1.5,130,9.5,-101,-119,116,1.5,-150,5.3,Suntrust Park,11,-1
2017-09-07,2017,NYY,BAL,9,1,101,1.5,-205,9.0,-110,-110,-111,-1.5,172,4.48,Camden Yards,10,8
2017-09-07,2017,PIT,CHC,2,8,122,1.5,-145,7.5,-105,-115,-137,-1.5,125,3.38,PNC Park,10,-6
2017-09-07,2017,NYM,CIN,7,2,122,1.5,-140,8.5,-120,100,-137,-1.5,120,3.83,Citi Field,9,5
2017-09-07,2017,CWS,CLE,2,11,315,1.5,166,8.0,-110,-110,-375,-1.5,-195,1.93,Guaranteed Rate Field,13,-9
2017-09-07,2017,LAD,COL,1,9,-305,-1.5,-133,6.5,-105,-115,255,1.5,113,4.9,Dodger Stadium,10,-8
2017-09-07,2017,CLE,CWS,11,2,-375,-1.5,-195,8.0,-110,-110,315,1.5,166,6.32,Guaranteed Rate Field,13,9
2017-09-07,2017,MIN,KC,4,2,-109,-1.5,146,9.5,100,-120,-101,1.5,-167,4.95,Kauffman Stadium,6,2
2017-09-07,2017,COL,LAD,9,1,255,1.5,113,6.5,-105,-115,-305,-1.5,-133,1.83,Dodger Stadium,10,8
2017-09-07,2017,ATL,MIA,6,5,116,1.5,-150,9.5,-101,-119,-126,-1.5,130,4.4,Suntrust Park,11,1
2017-09-07,2017,KC,MIN,2,4,-101,1.5,-167,9.5,100,-120,-109,-1.5,146,4.77,Kauffman Stadium,6,-2
2017-09-07,2017,CIN,NYM,2,7,-137,-1.5,120,8.5,-120,100,122,1.5,-140,4.91,Citi Field,9,-5
2017-09-07,2017,BAL,NYY,1,9,-111,-1.5,172,9.0,-110,-110,101,1.5,-205,4.73,Camden Yards,10,-8
2017-09-07,2017,WSH,PHI,4,3,-143,-1.5,151,8.0,-115,-105,128,1.5,-175,4.71,Nationals Park,7,1
2017-09-07,2017,CHC,PIT,8,2,-137,-1.5,125,7.5,-105,-115,122,1.5,-145,4.34,PNC Park,10,6
2017-09-07,2017,STL,SD,0,3,-112,-1.5,140,8.5,-110,-110,102,1.5,-160,4.49,PETCO Park,3,-3
2017-09-07,2017,SD,STL,3,0,102,1.5,-160,8.5,-110,-110,-112,-1.5,140,4.21,PETCO Park,3,3
2017-09-07,2017,PHI,WSH,3,4,128,1.5,-175,8.0,-115,-105,-143,-1.5,151,3.51,Nationals Park,7,-1
2017-09-08,2017,SD,ARI,10,6,200,1.5,105,9.5,-110,-110,-230,-1.5,-125,3.17,Chase Field,16,4
2017-09-08,2017,MIA,ATL,7,1,114,1.5,-195,9.0,-115,-105,-124,-1.5,166,4.21,Suntrust Park,8,6
2017-09-08,2017,CLE,BAL,5,0,-170,-1.5,121,9.0,105,-125,150,1.5,-141,5.67,Progressive Field,5,5
2017-09-08,2017,TB,BOS,3,9,107,1.5,-205,8.5,-103,-117,-117,-1.5,172,4.11,Fenway Park,12,-6
2017-09-08,2017,MIL,CHC,2,0,111,1.5,-205,7.5,-115,-105,-121,-1.5,172,3.55,Wrigley Field,2,2
2017-09-08,2017,NYM,CIN,5,1,101,1.5,-180,8.5,-110,-110,-111,-1.5,155,4.23,Citi Field,6,4
2017-09-08,2017,BAL,CLE,0,5,150,1.5,-141,9.0,105,-125,-170,-1.5,121,3.6,Progressive Field,5,-5
2017-09-08,2017,LAD,COL,4,5,-215,-1.5,102,7.5,105,-125,185,1.5,-122,5.12,Dodger Stadium,9,-1
2017-09-08,2017,SF,CWS,9,2,114,1.5,-190,9.0,-110,-110,-124,-1.5,163,4.21,Guaranteed Rate Field,11,7
2017-09-08,2017,TOR,DET,4,5,-220,-1.5,-111,8.5,-109,-111,190,1.5,-109,5.84,Rogers Centre,9,-1
2017-09-08,2017,OAK,HOU,9,8,157,1.5,-105,9.5,-101,-119,-177,-1.5,-115,3.7,Oakland Coliseum,17,1
2017-09-08,2017,MIN,KC,8,5,-136,-1.5,120,9.0,-119,-101,121,1.5,-140,5.19,Kauffman Stadium,13,3
2017-09-08,2017,SEA,LAA,4,3,-126,-1.5,155,9.0,-101,-119,116,1.5,-180,5.02,T-Mobile Park,7,1
2017-09-08,2017,COL,LAD,5,4,185,1.5,-122,7.5,105,-125,-215,-1.5,102,2.63,Dodger Stadium,9,1
2017-09-08,2017,ATL,MIA,1,7,-124,-1.5,166,9.0,-115,-105,114,1.5,-195,4.98,Suntrust Park,8,-6
2017-09-08,2017,CHC,MIL,0,2,-121,-1.5,172,7.5,-115,-105,111,1.5,-205,4.11,Wrigley Field,2,-2
2017-09-08,2017,KC,MIN,5,8,121,1.5,-140,9.0,-119,-101,-136,-1.5,120,4.07,Kauffman Stadium,13,-3
2017-09-08,2017,CIN,NYM,1,5,-111,-1.5,155,8.5,-110,-110,101,1.5,-180,4.47,Citi Field,6,-4
2017-09-08,2017,TEX,NYY,11,5,140,1.5,-119,9.5,-110,-110,-155,-1.5,-101,3.96,Rangers Ballpark,16,6
2017-09-08,2017,HOU,OAK,8,9,-177,-1.5,-115,9.5,-101,-119,157,1.5,-105,6.07,Oakland Coliseum,17,-1
2017-09-08,2017,WSH,PHI,11,10,-395,-1.5,-177,8.0,100,-120,335,1.5,152,6.38,Nationals Park,21,1
2017-09-08,2017,STL,PIT,4,1,-200,-1.5,110,7.5,-120,100,170,1.5,-130,5.0,Busch Stadium,5,3
2017-09-08,2017,ARI,SD,6,10,-230,-1.5,-125,9.5,-110,-110,200,1.5,105,6.62,Chase Field,16,-4
2017-09-08,2017,LAA,SEA,3,4,116,1.5,-180,9.0,-101,-119,-126,-1.5,155,4.17,T-Mobile Park,7,-1
2017-09-08,2017,CWS,SF,2,9,-124,-1.5,163,9.0,-110,-110,114,1.5,-190,4.98,Guaranteed Rate Field,11,-7
2017-09-08,2017,PIT,STL,1,4,170,1.5,-130,7.5,-120,100,-200,-1.5,110,2.78,Busch Stadium,5,-3
2017-09-08,2017,BOS,TB,9,3,-117,-1.5,172,8.5,-103,-117,107,1.5,-205,4.58,Fenway Park,12,6
2017-09-08,2017,NYY,TEX,5,11,-155,-1.5,-101,9.5,-110,-110,140,1.5,-119,5.77,Rangers Ballpark,16,-6
2017-09-08,2017,DET,TOR,5,4,190,1.5,-109,8.5,-109,-111,-220,-1.5,-111,2.93,Rogers Centre,9,1
2017-09-08,2017,PHI,WSH,10,11,335,1.5,152,8.0,100,-120,-395,-1.5,-177,1.84,Nationals Park,21,-1
2017-09-09,2017,SD,ARI,8,7,175,1.5,-118,9.5,-110,-110,-195,-1.5,-102,3.45,Chase Field,15,1
2017-09-09,2017,MIA,ATL,5,6,-113,-1.5,135,9.5,-115,-105,103,1.5,-155,5.04,Suntrust Park,11,-1
2017-09-09,2017,CLE,BAL,4,2,-184,-1.5,100,9.5,103,-123,164,1.5,-120,6.15,Progressive Field,6,2
2017-09-09,2017,TB,BOS,0,9,256,1.5,114,8.0,-105,-115,-296,-1.5,-132,2.25,Fenway Park,9,-9
2017-09-09,2017,MIL,CHC,15,2,145,1.5,-158,8.0,100,-120,-160,-1.5,138,3.27,Wrigley Field,17,13
2017-09-09,2017,NYM,CIN,6,1,-105,-1.5,188,8.5,-110,-110,-105,1.5,-225,4.35,Citi Field,7,5
2017-09-09,2017,BAL,CLE,2,4,164,1.5,-120,9.5,103,-123,-184,-1.5,100,3.6,Progressive Field,6,-2
2017-09-09,2017,LAD,COL,5,6,-240,-1.5,-115,8.5,-101,-119,200,1.5,-104,6.0,Dodger Stadium,11,-1
2017-09-09,2017,SF,CWS,1,13,-145,-1.5,115,9.0,-110,-110,130,1.5,-135,5.33,Guaranteed Rate Field,14,-12
2017-09-09,2017,TOR,DET,5,4,-132,-1.5,151,9.5,-101,-119,117,1.5,-175,5.41,Rogers Centre,9,1
2017-09-09,2017,OAK,HOU,11,1,135,1.5,-125,9.5,-107,-113,-150,-1.5,105,4.04,Oakland Coliseum,12,10
2017-09-09,2017,OAK,HOU,11,4,190,1.5,120,9.5,-105,-115,-220,-1.5,-140,3.28,Oakland Coliseum,15,7
2017-09-09,2017,MIN,KC,2,5,-108,-1.5,148,9.0,-108,-112,-102,1.5,-170,4.67,Kauffman Stadium,7,-3
2017-09-09,2017,SEA,LAA,8,1,101,1.5,-165,9.0,-104,-116,-111,-1.5,144,4.48,T-Mobile Park,9,7
2017-09-09,2017,COL,LAD,6,5,200,1.5,-104,8.5,-101,-119,-240,-1.5,-115,2.83,Dodger Stadium,11,1
2017-09-09,2017,ATL,MIA,6,5,103,1.5,-155,9.5,-115,-105,-113,-1.5,135,4.68,Suntrust Park,11,1
2017-09-09,2017,CHC,MIL,2,15,-160,-1.5,138,8.0,100,-120,145,1.5,-158,4.92,Wrigley Field,17,-13
2017-09-09,2017,KC,MIN,5,2,-102,1.5,-170,9.0,-108,-112,-108,-1.5,148,4.54,Kauffman Stadium,7,3
2017-09-09,2017,CIN,NYM,1,6,-105,1.5,-225,8.5,-110,-110,-105,-1.5,188,4.35,Citi Field,7,-5
2017-09-09,2017,TEX,NYY,1,3,190,1.5,115,9.0,-105,-115,-220,-1.5,-135,3.1,Rangers Ballpark,4,-2
2017-09-09,2017,HOU,OAK,1,11,-150,-1.5,105,9.5,-107,-113,135,1.5,-125,5.7,Oakland Coliseum,12,-10
2017-09-09,2017,HOU,OAK,4,11,-220,-1.5,-140,9.5,-105,-115,190,1.5,120,6.53,Oakland Coliseum,15,-7
2017-09-09,2017,WSH,PHI,4,5,-175,-1.5,125,9.0,-125,105,155,1.5,-145,5.73,Nationals Park,9,-1
2017-09-09,2017,STL,PIT,4,3,-198,-1.5,104,8.0,103,-123,178,1.5,-125,5.32,Busch Stadium,7,1
2017-09-09,2017,ARI,SD,7,8,-195,-1.5,-102,9.5,-110,-110,175,1.5,-118,6.28,Chase Field,15,-1
2017-09-09,2017,LAA,SEA,1,8,-111,-1.5,144,9.0,-104,-116,101,1.5,-165,4.73,T-Mobile Park,9,-7
2017-09-09,2017,CWS,SF,13,1,130,1.5,-135,9.0,-110,-110,-145,-1.5,115,3.91,Guaranteed Rate Field,14,12
2017-09-09,2017,PIT,STL,3,4,178,1.5,-125,8.0,103,-123,-198,-1.5,104,2.88,Busch Stadium,7,-1
2017-09-09,2017,BOS,TB,9,0,-296,-1.5,-132,8.0,-105,-115,256,1.5,114,5.98,Fenway Park,9,9
2017-09-09,2017,NYY,TEX,3,1,-220,-1.5,-135,9.0,-105,-115,190,1.5,115,6.19,Rangers Ballpark,4,2
2017-09-09,2017,DET,TOR,4,5,117,1.5,-175,9.5,-101,-119,-132,-1.5,151,4.38,Rogers Centre,9,-1
2017-09-09,2017,PHI,WSH,5,4,155,1.5,-145,9.0,-125,105,-175,-1.5,125,3.53,Nationals Park,9,1
2017-09-10,2017,SD,ARI,2,3,210,1.5,110,9.5,-107,-113,-250,-1.5,-130,3.06,Chase Field,5,-1
2017-09-10,2017,MIA,ATL,8,10,135,1.5,-160,9.0,-120,100,-150,-1.5,140,3.83,Suntrust Park,18,-2
2017-09-10,2017,CLE,BAL,3,2,-210,-1.5,-105,9.5,101,-121,180,1.5,-115,6.44,Progressive Field,5,1
2017-09-10,2017,TB,BOS,4,1,126,1.5,-165,9.0,-101,-119,-141,-1.5,144,3.98,Fenway Park,5,3
2017-09-10,2017,MIL,CHC,3,1,135,1.5,-170,7.5,-119,-101,-150,-1.5,148,3.19,Wrigley Field,4,2
2017-09-10,2017,NYM,CIN,5,10,-141,-1.5,151,7.5,-118,-102,126,1.5,-175,4.39,Citi Field,15,-5
2017-09-10,2017,BAL,CLE,2,3,180,1.5,-115,9.5,101,-121,-210,-1.5,-105,3.39,Progressive Field,5,-1
2017-09-10,2017,LAD,COL,1,8,-238,-1.5,-125,8.5,-125,105,208,1.5,105,5.99,Dodger Stadium,9,-7
2017-09-10,2017,SF,CWS,1,8,-155,-1.5,-105,9.0,-105,-115,140,1.5,-115,5.47,Guaranteed Rate Field,9,-7
2017-09-10,2017,TOR,DET,8,2,-157,-1.5,130,9.0,100,-120,142,1.5,-150,5.5,Rogers Centre,10,6
2017-09-10,2017,OAK,HOU,10,2,169,1.5,-102,9.5,-105,-115,-189,-1.5,-118,3.53,Oakland Coliseum,12,8
2017-09-10,2017,MIN,KC,3,11,120,1.5,-170,10.0,-119,-101,-135,-1.5,148,4.55,Kauffman Stadium,14,-8
2017-09-10,2017,SEA,LAA,3,5,-133,-1.5,148,9.0,-115,-105,118,1.5,-170,5.14,T-Mobile Park,8,-2
2017-09-10,2017,COL,LAD,8,1,208,1.5,105,8.5,-125,105,-238,-1.5,-125,2.76,Dodger Stadium,9,7
2017-09-10,2017,ATL,MIA,10,8,-150,-1.5,140,9.0,-120,100,135,1.5,-160,5.4,Suntrust Park,18,2
2017-09-10,2017,CHC,MIL,1,3,-150,-1.5,148,7.5,-119,-101,135,1.5,-170,4.5,Wrigley Field,4,-2
2017-09-10,2017,KC,MIN,11,3,-135,-1.5,148,10.0,-119,-101,120,1.5,-170,5.74,Kauffman Stadium,14,8
2017-09-10,2017,CIN,NYM,10,5,126,1.5,-175,7.5,-118,-102,-141,-1.5,151,3.32,Citi Field,15,5
2017-09-10,2017,TEX,NYY,7,16,117,1.5,-148,10.5,-105,-115,-127,-1.5,128,4.84,Rangers Ballpark,23,-9
2017-09-10,2017,HOU,OAK,2,10,-189,-1.5,-118,9.5,-105,-115,169,1.5,-102,6.21,Oakland Coliseum,12,-8
2017-09-10,2017,WSH,PHI,3,2,-215,-1.5,-105,8.0,100,-120,185,1.5,-115,5.46,Nationals Park,5,1
2017-09-10,2017,STL,PIT,7,0,-164,-1.5,135,8.0,-116,-104,149,1.5,-155,4.97,Busch Stadium,7,7
2017-09-10,2017,ARI,SD,3,2,-250,-1.5,-130,9.5,-107,-113,210,1.5,110,6.79,Chase Field,5,1
2017-09-10,2017,LAA,SEA,5,3,118,1.5,-170,9.0,-115,-105,-133,-1.5,148,4.13,T-Mobile Park,8,2
2017-09-10,2017,CWS,SF,8,1,140,1.5,-115,9.0,-105,-115,-155,-1.5,-105,3.75,Guaranteed Rate Field,9,7
2017-09-10,2017,PIT,STL,0,7,149,1.5,-155,8.0,-116,-104,-164,-1.5,135,3.21,Busch Stadium,7,-7
2017-09-10,2017,BOS,TB,1,4,-141,-1.5,144,9.0,-101,-119,126,1.5,-165,5.27,Fenway Park,5,-3
2017-09-10,2017,NYY,TEX,16,7,-127,-1.5,128,10.5,-105,-115,117,1.5,-148,5.87,Rangers Ballpark,23,9
2017-09-10,2017,DET,TOR,2,8,142,1.5,-150,9.0,100,-120,-157,-1.5,130,3.72,Rogers Centre,10,-6
2017-09-10,2017,PHI,WSH,2,3,185,1.5,-115,8.0,100,-120,-215,-1.5,-105,2.81,Nationals Park,5,-1
2017-09-11,2017,COL,ARI,5,4,175,1.5,-114,9.0,-121,101,-195,-1.5,-106,3.27,Chase Field,9,1
2017-09-11,2017,TOR,BAL,4,3,111,1.5,-155,9.5,-111,-109,-121,-1.5,135,4.5,Rogers Centre,7,1
2017-09-11,2017,DET,CLE,0,11,335,1.5,152,8.5,-118,-102,-415,-1.5,-177,1.95,Progressive Field,11,-11
2017-09-11,2017,ARI,COL,4,5,-195,-1.5,-106,9.0,-121,101,175,1.5,-114,5.95,Chase Field,9,-1
2017-09-11,2017,KC,CWS,3,11,-170,-1.5,125,9.0,-119,-101,150,1.5,-145,5.67,Kauffman Stadium,14,-8
2017-09-11,2017,CLE,DET,11,0,-415,-1.5,-177,8.5,-118,-102,335,1.5,152,6.85,Progressive Field,11,11
2017-09-11,2017,CWS,KC,11,3,150,1.5,-145,9.0,-119,-101,-170,-1.5,125,3.6,Kauffman Stadium,14,8
2017-09-11,2017,SF,LAD,8,6,180,1.5,103,8.5,-110,-110,-210,-1.5,-123,3.04,AT&T Park,14,2
2017-09-11,2017,PIT,MIL,7,0,128,1.5,-160,9.0,-120,100,-143,-1.5,140,3.95,Miller Park,7,7
2017-09-11,2017,TB,NYY,1,5,127,1.5,-130,8.5,-123,103,-142,-1.5,110,3.74,Citi Field,6,-4
2017-09-11,2017,MIL,PIT,0,7,-143,-1.5,140,9.0,-120,100,128,1.5,-160,5.3,Miller Park,7,-7
2017-09-11,2017,TEX,SEA,5,3,-121,-1.5,146,10.5,-121,101,111,1.5,-169,5.75,Rangers Ballpark,8,2
2017-09-11,2017,LAD,SF,6,8,-210,-1.5,-123,8.5,-110,-110,180,1.5,103,5.76,AT&T Park,14,-2
2017-09-11,2017,NYY,TB,5,1,-142,-1.5,110,8.5,-123,103,127,1.5,-130,4.99,Citi Field,6,4
2017-09-11,2017,SEA,TEX,3,5,111,1.5,-169,10.5,-121,101,-121,-1.5,146,4.98,Rangers Ballpark,8,-2
2017-09-11,2017,BAL,TOR,3,4,-121,-1.5,135,9.5,-111,-109,111,1.5,-155,5.2,Rogers Centre,7,-1
2017-09-12,2017,COL,ARI,4,2,113,1.5,-185,9.5,-115,-105,-123,-1.5,160,4.46,Chase Field,6,2
2017-09-12,2017,WSH,ATL,0,8,-177,-1.5,126,8.5,-115,-105,157,1.5,-147,5.43,Nationals Park,8,-8
2017-09-12,2017,TOR,BAL,3,2,114,1.5,-155,8.5,-110,-110,-124,-1.5,135,3.97,Rogers Centre,5,1
2017-09-12,2017,OAK,BOS,1,11,162,1.5,-110,10.0,-120,100,-182,-1.5,-110,3.82,Fenway Park,12,-10
2017-09-12,2017,NYM,CHC,3,8,295,1.5,115,8.0,-110,-110,-345,-1.5,-135,2.03,Wrigley Field,11,-5
2017-09-12,2017,STL,CIN,13,4,-158,-1.5,135,8.5,-110,-110,143,1.5,-155,5.21,Busch Stadium,17,9
2017-09-12,2017,DET,CLE,0,2,373,1.5,163,8.0,-120,100,-473,-1.5,-190,1.69,Progressive Field,2,-2
2017-09-12,2017,ARI,COL,2,4,-123,-1.5,160,9.5,-115,-105,113,1.5,-185,5.24,Chase Field,6,-2
2017-09-12,2017,KC,CWS,4,3,-197,-1.5,-110,10.5,-115,-105,177,1.5,-110,6.96,Kauffman Stadium,7,1
2017-09-12,2017,CLE,DET,2,0,-473,-1.5,-190,8.0,-120,100,373,1.5,163,6.6,Progressive Field,2,2
2017-09-12,2017,LAA,HOU,0,1,-105,1.5,-170,8.0,-115,-105,-105,-1.5,148,4.1,Angel Stadium,1,-1
2017-09-12,2017,CWS,KC,3,4,177,1.5,-110,10.5,-115,-105,-197,-1.5,-110,3.79,Kauffman Stadium,7,-1
2017-09-12,2017,HOU,LAA,1,0,-105,-1.5,148,8.0,-115,-105,-105,1.5,-170,4.1,Angel Stadium,1,1
2017-09-12,2017,SF,LAD,3,5,250,1.5,135,7.0,-110,-110,-300,-1.5,-155,2.0,AT&T Park,8,-2
2017-09-12,2017,PHI,MIA,9,8,114,1.5,-150,9.5,-105,-115,-124,-1.5,130,4.44,Citizens Bank Park,17,1
2017-09-12,2017,PIT,MIL,2,5,-101,1.5,-220,8.5,-110,-110,-109,-1.5,184,4.27,Miller Park,7,-3
2017-09-12,2017,SD,MIN,0,16,154,1.5,-130,10.0,-110,-110,-174,-1.5,110,3.94,Target Field,16,-16
2017-09-12,2017,CHC,NYM,8,3,-345,-1.5,-135,8.0,-110,-110,295,1.5,115,6.2,Wrigley Field,11,5
2017-09-12,2017,TB,NYY,2,1,123,1.5,-140,8.0,-105,-115,-138,-1.5,120,3.59,Citi Field,3,1
2017-09-12,2017,BOS,OAK,11,1,-182,-1.5,-110,10.0,-120,100,162,1.5,-110,6.45,Fenway Park,12,10
2017-09-12,2017,MIA,PHI,8,9,-124,-1.5,130,9.5,-105,-115,114,1.5,-150,5.26,Citizens Bank Park,17,-1
2017-09-12,2017,MIL,PIT,5,2,-109,-1.5,184,8.5,-110,-110,-101,1.5,-220,4.43,Miller Park,7,3
2017-09-12,2017,MIN,SD,16,0,-174,-1.5,110,10.0,-110,-110,154,1.5,-130,6.35,Target Field,16,16
2017-09-12,2017,TEX,SEA,3,10,-106,-1.5,170,11.0,-110,-110,-104,1.5,-200,5.66,Rangers Ballpark,13,-7
2017-09-12,2017,LAD,SF,5,3,-300,-1.5,-155,7.0,-110,-110,250,1.5,135,5.25,AT&T Park,8,2
2017-09-12,2017,CIN,STL,4,13,143,1.5,-155,8.5,-110,-110,-158,-1.5,135,3.5,Busch Stadium,17,-9
2017-09-12,2017,NYY,TB,1,2,-138,-1.5,120,8.0,-105,-115,123,1.5,-140,4.64,Citi Field,3,-1
2017-09-12,2017,SEA,TEX,10,3,-104,1.5,-200,11.0,-110,-110,-106,-1.5,170,5.61,Rangers Ballpark,13,7
2017-09-12,2017,BAL,TOR,2,3,-124,-1.5,135,8.5,-110,-110,114,1.5,-155,4.71,Rogers Centre,5,-1
2017-09-12,2017,ATL,WSH,8,0,157,1.5,-147,8.5,-115,-105,-177,-1.5,126,3.31,Nationals Park,8,8
2017-09-13,2017,COL,ARI,2,8,124,1.5,-165,9.5,-101,-119,-139,-1.5,144,4.24,Chase Field,10,-6
2017-09-13,2017,WSH,ATL,2,8,-325,-1.5,-150,8.5,-110,-110,275,1.5,130,6.5,Nationals Park,10,-6
2017-09-13,2017,TOR,BAL,1,2,-131,-1.5,153,8.5,-117,-103,116,1.5,-177,4.82,Rogers Centre,3,-1
2017-09-13,2017,OAK,BOS,7,3,171,1.5,-111,11.0,-120,100,-191,-1.5,-109,4.06,Fenway Park,10,4
2017-09-13,2017,NYM,CHC,5,17,250,1.5,125,9.0,-120,100,-300,-1.5,-145,2.57,Wrigley Field,22,-12
2017-09-13,2017,STL,CIN,0,6,-148,-1.5,141,9.5,-104,-116,133,1.5,-162,5.67,Busch Stadium,6,-6
2017-09-13,2017,DET,CLE,3,5,285,1.5,146,10.0,100,-120,-335,-1.5,-168,2.6,Progressive Field,8,-2
2017-09-13,2017,ARI,COL,8,2,-139,-1.5,144,9.5,-101,-119,124,1.5,-165,5.53,Chase Field,10,6
2017-09-13,2017,KC,CWS,3,5,-146,-1.5,120,10.0,-119,-101,131,1.5,-140,5.93,Kauffman Stadium,8,-2
2017-09-13,2017,CLE,DET,5,3,-335,-1.5,-168,10.0,100,-120,285,1.5,146,7.7,Progressive Field,8,2
2017-09-13,2017,LAA,HOU,9,1,-131,-1.5,151,9.0,-102,-118,116,1.5,-175,5.1,Angel Stadium,10,8
2017-09-13,2017,CWS,KC,5,3,131,1.5,-140,10.0,-119,-101,-146,-1.5,120,4.33,Kauffman Stadium,8,2
2017-09-13,2017,HOU,LAA,1,9,116,1.5,-175,9.0,-102,-118,-131,-1.5,151,4.17,Angel Stadium,10,-8
2017-09-13,2017,SF,LAD,1,4,200,1.5,115,8.5,-118,-102,-240,-1.5,-135,2.83,AT&T Park,5,-3
2017-09-13,2017,PHI,MIA,8,1,-148,-1.5,135,9.0,101,-121,133,1.5,-155,5.37,Citizens Bank Park,9,7
2017-09-13,2017,PIT,MIL,2,8,136,1.5,-155,9.0,-110,-110,-151,-1.5,135,3.81,Miller Park,10,-6
2017-09-13,2017,SD,MIN,1,3,132,1.5,-160,9.0,-120,100,-147,-1.5,140,3.88,Target Field,4,-2
2017-09-13,2017,CHC,NYM,17,5,-300,-1.5,-145,9.0,-120,100,250,1.5,125,6.75,Wrigley Field,22,12
2017-09-13,2017,TB,NYY,2,3,-132,-1.5,160,7.5,-114,-106,117,1.5,-185,4.27,Citi Field,5,-1
2017-09-13,2017,BOS,OAK,3,7,-191,-1.5,-109,11.0,-120,100,171,1.5,-111,7.22,Fenway Park,10,-4
2017-09-13,2017,MIA,PHI,1,8,133,1.5,-155,9.0,101,-121,-148,-1.5,135,3.86,Citizens Bank Park,9,-7
2017-09-13,2017,MIL,PIT,8,2,-151,-1.5,135,9.0,-110,-110,136,1.5,-155,5.41,Miller Park,10,6
2017-09-13,2017,MIN,SD,3,1,-147,-1.5,140,9.0,-120,100,132,1.5,-160,5.36,Target Field,4,2
2017-09-13,2017,TEX,SEA,1,8,-111,-1.5,172,11.0,-110,-110,101,1.5,-205,5.79,Rangers Ballpark,9,-7
2017-09-13,2017,LAD,SF,4,1,-240,-1.5,-135,8.5,-118,-102,200,1.5,115,6.0,AT&T Park,5,3
2017-09-13,2017,CIN,STL,6,0,133,1.5,-162,9.5,-104,-116,-148,-1.5,141,4.08,Busch Stadium,6,6
2017-09-13,2017,NYY,TB,3,2,117,1.5,-185,7.5,-114,-106,-132,-1.5,160,3.46,Citi Field,5,1
2017-09-13,2017,SEA,TEX,8,1,101,1.5,-205,11.0,-110,-110,-111,-1.5,172,5.47,Rangers Ballpark,9,7
2017-09-13,2017,BAL,TOR,2,1,116,1.5,-177,8.5,-117,-103,-131,-1.5,153,3.94,Rogers Centre,3,1
2017-09-13,2017,ATL,WSH,8,2,275,1.5,130,8.5,-110,-110,-325,-1.5,-150,2.27,Nationals Park,10,6
2017-09-14,2017,COL,ARI,0,7,160,1.5,-134,9.5,-118,-102,-180,-1.5,112,3.65,Chase Field,7,-7
2017-09-14,2017,WSH,ATL,5,2,-133,-1.5,155,8.5,-102,-118,118,1.5,-180,4.85,Nationals Park,7,3
2017-09-14,2017,NYY,BAL,13,5,-210,-1.5,-111,10.0,-110,-110,180,1.5,-109,6.77,Yankee Stadium,18,8
2017-09-14,2017,OAK,BOS,2,6,195,1.5,105,10.5,101,-121,-225,-1.5,-125,3.56,Fenway Park,8,-4
2017-09-14,2017,NYM,CHC,6,14,182,1.5,-105,9.0,-109,-111,-212,-1.5,-115,3.19,Wrigley Field,20,-8
2017-09-14,2017,STL,CIN,5,2,-205,-1.5,-119,9.0,-115,-105,175,1.5,-101,6.05,Busch Stadium,7,3
2017-09-14,2017,KC,CLE,2,3,156,1.5,-140,9.0,-115,-105,-176,-1.5,120,3.52,Progressive Field,5,-1
2017-09-14,2017,ARI,COL,7,0,-180,-1.5,112,9.5,-118,-102,160,1.5,-134,6.11,Chase Field,7,7
2017-09-14,2017,DET,CWS,7,17,-108,-1.5,160,10.0,-119,-101,-102,1.5,-185,5.19,Comerica Park,24,-10
2017-09-14,2017,CWS,DET,17,7,-102,1.5,-185,10.0,-119,-101,-108,-1.5,160,5.05,Comerica Park,24,10
2017-09-14,2017,LAA,HOU,2,5,122,1.5,-150,8.5,100,-120,-137,-1.5,130,3.83,Angel Stadium,7,-3
2017-09-14,2017,CLE,KC,3,2,-176,-1.5,120,9.0,-115,-105,156,1.5,-140,5.74,Progressive Field,5,1
2017-09-14,2017,HOU,LAA,5,2,-137,-1.5,130,8.5,100,-120,122,1.5,-150,4.91,Angel Stadium,7,3
2017-09-14,2017,PHI,MIA,10,0,-131,-1.5,151,10.5,100,-120,116,1.5,-175,5.95,Citizens Bank Park,10,10
2017-09-14,2017,TOR,MIN,2,3,130,1.5,-155,9.0,-120,100,-145,-1.5,135,3.91,Target Field,5,-1
2017-09-14,2017,CHC,NYM,14,6,-212,-1.5,-115,9.0,-109,-111,182,1.5,-105,6.12,Wrigley Field,20,8
2017-09-14,2017,BAL,NYY,5,13,180,1.5,-109,10.0,-110,-110,-210,-1.5,-111,3.57,Yankee Stadium,18,-8
2017-09-14,2017,BOS,OAK,6,2,-225,-1.5,-125,10.5,101,-121,195,1.5,105,7.27,Fenway Park,8,4
2017-09-14,2017,MIA,PHI,0,10,116,1.5,-175,10.5,100,-120,-131,-1.5,151,4.86,Citizens Bank Park,10,-10
2017-09-14,2017,TEX,SEA,4,10,104,1.5,-153,12.0,-110,-110,-114,-1.5,133,5.88,Rangers Ballpark,14,-6
2017-09-14,2017,CIN,STL,2,5,175,1.5,-101,9.0,-115,-105,-205,-1.5,-119,3.27,Busch Stadium,7,-3
2017-09-14,2017,SEA,TEX,10,4,-114,-1.5,133,12.0,-110,-110,104,1.5,-153,6.39,Rangers Ballpark,14,6
2017-09-14,2017,MIN,TOR,3,2,-145,-1.5,135,9.0,-120,100,130,1.5,-155,5.33,Target Field,5,1
2017-09-14,2017,ATL,WSH,2,5,118,1.5,-180,8.5,-102,-118,-133,-1.5,155,3.9,Nationals Park,7,-3
2017-09-15,2017,SF,ARI,2,3,140,1.5,-125,7.0,-120,100,-155,-1.5,105,2.92,AT&T Park,5,-1
2017-09-15,2017,NYM,ATL,2,3,116,1.5,-190,9.0,-125,105,-126,-1.5,163,4.17,Suntrust Park,5,-1
2017-09-15,2017,NYY,BAL,8,2,-379,-1.5,-168,9.0,-119,-101,319,1.5,146,7.12,Yankee Stadium,10,6
2017-09-15,2017,TB,BOS,6,13,198,1.5,112,7.0,103,-123,-228,-1.5,-132,2.35,Tropicana Field,19,-7
2017-09-15,2017,STL,CHC,2,8,114,1.5,-200,9.0,-120,100,-124,-1.5,170,4.21,Wrigley Field,10,-6
2017-09-15,2017,PIT,CIN,2,4,119,1.5,-183,9.5,-120,100,-134,-1.5,158,4.34,Great American Ballpark,6,-2
2017-09-15,2017,KC,CLE,4,3,195,1.5,101,8.5,-117,-103,-225,-1.5,-121,2.88,Progressive Field,7,1
2017-09-15,2017,SD,COL,1,6,143,1.5,-135,11.5,-115,-105,-158,-1.5,115,4.73,Coors Field,7,-5
2017-09-15,2017,DET,CWS,3,2,-126,-1.5,163,10.5,-120,100,116,1.5,-190,5.85,Comerica Park,5,1
2017-09-15,2017,CWS,DET,2,3,116,1.5,-190,10.5,-120,100,-126,-1.5,163,4.86,Comerica Park,5,-1
2017-09-15,2017,SEA,HOU,2,5,116,1.5,-186,9.0,105,-125,-126,-1.5,160,4.17,Minute Maid Park,7,-3
2017-09-15,2017,CLE,KC,3,4,-225,-1.5,-121,8.5,-117,-103,195,1.5,101,5.88,Progressive Field,7,-1
2017-09-15,2017,TEX,LAA,6,7,175,1.5,-120,9.0,-117,-103,-205,-1.5,100,3.27,Angel Stadium,13,-1
2017-09-15,2017,WSH,LAD,0,7,136,1.5,-125,9.5,-101,-119,-151,-1.5,105,4.03,Nationals Park,7,-7
2017-09-15,2017,MIL,MIA,10,2,-131,-1.5,125,10.0,-115,-105,116,1.5,-145,5.67,Miller Park,12,8
2017-09-15,2017,MIA,MIL,2,10,116,1.5,-145,10.0,-115,-105,-131,-1.5,125,4.63,Miller Park,12,-8
2017-09-15,2017,TOR,MIN,4,3,-116,-1.5,137,9.5,-110,-110,106,1.5,-157,5.1,Target Field,7,1
2017-09-15,2017,ATL,NYM,3,2,-126,-1.5,163,9.0,-125,105,116,1.5,-190,5.02,Suntrust Park,5,1
2017-09-15,2017,BAL,NYY,2,8,319,1.5,146,9.0,-119,-101,-379,-1.5,-168,2.15,Yankee Stadium,10,-6
2017-09-15,2017,PHI,OAK,0,4,-126,-1.5,163,10.0,100,-120,116,1.5,-190,5.58,Citizens Bank Park,4,-4
2017-09-15,2017,OAK,PHI,4,0,116,1.5,-190,10.0,100,-120,-126,-1.5,163,4.63,Citizens Bank Park,4,4
2017-09-15,2017,CIN,PIT,4,2,-134,-1.5,158,9.5,-120,100,119,1.5,-183,5.44,Great American Ballpark,6,2
2017-09-15,2017,COL,SD,6,1,-158,-1.5,115,11.5,-115,-105,143,1.5,-135,7.04,Coors Field,7,5
2017-09-15,2017,HOU,SEA,5,2,-126,-1.5,160,9.0,105,-125,116,1.5,-186,5.02,Minute Maid Park,7,3
2017-09-15,2017,ARI,SF,3,2,-155,-1.5,105,7.0,-120,100,140,1.5,-125,4.25,AT&T Park,5,1
2017-09-15,2017,CHC,STL,8,2,-124,-1.5,170,9.0,-120,100,114,1.5,-200,4.98,Wrigley Field,10,6
2017-09-15,2017,BOS,TB,13,6,-228,-1.5,-132,7.0,103,-123,198,1.5,112,4.87,Tropicana Field,19,7
2017-09-15,2017,LAA,TEX,7,6,-205,-1.5,100,9.0,-117,-103,175,1.5,-120,6.05,Angel Stadium,13,1
2017-09-15,2017,MIN,TOR,3,4,106,1.5,-157,9.5,-110,-110,-116,-1.5,137,4.61,Target Field,7,-1
2017-09-15,2017,LAD,WSH,7,0,-151,-1.5,105,9.5,-101,-119,136,1.5,-125,5.72,Nationals Park,7,7
2017-09-16,2017,SF,ARI,0,2,135,1.5,-132,7.5,102,-122,-150,-1.5,112,3.19,AT&T Park,2,-2
2017-09-16,2017,NYM,ATL,7,3,-114,-1.5,140,8.5,-101,-119,104,1.5,-160,4.53,Suntrust Park,10,4
2017-09-16,2017,NYY,BAL,9,3,-185,-1.5,105,10.0,-102,-118,165,1.5,-125,6.49,Yankee Stadium,12,6
2017-09-16,2017,TB,BOS,1,3,-132,-1.5,155,8.0,-115,-105,117,1.5,-180,4.55,Tropicana Field,4,-2
2017-09-16,2017,STL,CHC,1,4,134,1.5,-160,10.0,-116,-104,-149,-1.5,140,4.27,Wrigley Field,5,-3
2017-09-16,2017,PIT,CIN,1,2,142,1.5,-150,10.0,-106,-114,-157,-1.5,130,4.13,Great American Ballpark,3,-1
2017-09-16,2017,KC,CLE,4,8,179,1.5,-119,8.0,-127,107,-209,-1.5,-101,2.87,Progressive Field,12,-4
2017-09-16,2017,SD,COL,0,16,185,1.5,102,11.5,-109,-111,-215,-1.5,-122,4.04,Coors Field,16,-16
2017-09-16,2017,DET,CWS,4,10,-109,-1.5,170,10.5,-122,102,-101,1.5,-200,5.48,Comerica Park,14,-6
2017-09-16,2017,CWS,DET,10,4,-101,1.5,-200,10.5,-122,102,-109,-1.5,170,5.28,Comerica Park,14,6
2017-09-16,2017,SEA,HOU,6,8,175,1.5,-110,9.0,-114,-106,-205,-1.5,-110,3.27,Minute Maid Park,14,-2
2017-09-16,2017,CLE,KC,8,4,-209,-1.5,-101,8.0,-127,107,179,1.5,-119,5.41,Progressive Field,12,4
2017-09-16,2017,TEX,LAA,0,2,118,1.5,-181,9.0,-132,112,-128,-1.5,156,4.13,Angel Stadium,2,-2
2017-09-16,2017,WSH,LAD,2,3,141,1.5,-120,9.5,100,-120,-156,-1.5,100,3.94,Nationals Park,5,-1
2017-09-16,2017,MIL,MIA,4,7,-138,-1.5,108,10.0,-111,-109,123,1.5,-128,5.8,Miller Park,11,-3
2017-09-16,2017,MIA,MIL,7,4,123,1.5,-128,10.0,-111,-109,-138,-1.5,108,4.48,Miller Park,11,3
2017-09-16,2017,TOR,MIN,7,2,116,1.5,-180,9.5,-107,-113,-126,-1.5,155,4.4,Target Field,9,5
2017-09-16,2017,ATL,NYM,3,7,104,1.5,-160,8.5,-101,-119,-114,-1.5,140,4.17,Suntrust Park,10,-4
2017-09-16,2017,BAL,NYY,3,9,165,1.5,-125,10.0,-102,-118,-185,-1.5,105,3.77,Yankee Stadium,12,-6
2017-09-16,2017,PHI,OAK,5,3,-106,1.5,-175,9.5,-101,-119,-104,-1.5,151,4.89,Citizens Bank Park,8,2
2017-09-16,2017,OAK,PHI,3,5,-104,-1.5,151,9.5,-101,-119,-106,1.5,-175,4.84,Citizens Bank Park,8,-2
2017-09-16,2017,CIN,PIT,2,1,-157,-1.5,130,10.0,-106,-114,142,1.5,-150,6.11,Great American Ballpark,3,1
2017-09-16,2017,COL,SD,16,0,-215,-1.5,-122,11.5,-109,-111,185,1.5,102,7.85,Coors Field,16,16
2017-09-16,2017,HOU,SEA,8,6,-205,-1.5,-110,9.0,-114,-106,175,1.5,-110,6.05,Minute Maid Park,14,2
2017-09-16,2017,ARI,SF,2,0,-150,-1.5,112,7.5,102,-122,135,1.5,-132,4.5,AT&T Park,2,2
2017-09-16,2017,CHC,STL,4,1,-149,-1.5,140,10.0,-116,-104,134,1.5,-160,5.98,Wrigley Field,5,3
2017-09-16,2017,BOS,TB,3,1,117,1.5,-180,8.0,-115,-105,-132,-1.5,155,3.69,Tropicana Field,4,2
2017-09-16,2017,LAA,TEX,2,0,-128,-1.5,156,9.0,-132,112,118,1.5,-181,5.05,Angel Stadium,2,2
2017-09-16,2017,MIN,TOR,2,7,-126,-1.5,155,9.5,-107,-113,116,1.5,-180,5.3,Target Field,9,-5
2017-09-16,2017,LAD,WSH,3,2,-156,-1.5,100,9.5,100,-120,141,1.5,-120,5.79,Nationals Park,5,1
2017-09-17,2017,SF,ARI,7,2,135,1.5,-125,8.5,-114,-106,-150,-1.5,105,3.62,AT&T Park,9,5
2017-09-17,2017,NYM,ATL,5,1,150,1.5,-135,9.0,-101,-119,-170,-1.5,115,3.6,Suntrust Park,6,4
2017-09-17,2017,NYY,BAL,4,6,-230,-1.5,-113,9.5,-107,-113,200,1.5,-107,6.62,Yankee Stadium,10,-2
2017-09-17,2017,TB,BOS,3,2,119,1.5,-150,8.0,-110,-110,-129,-1.5,130,3.65,Tropicana Field,5,1
2017-09-17,2017,STL,CHC,3,4,160,1.5,-131,9.0,-119,-101,-180,-1.5,111,3.46,Wrigley Field,7,-1
2017-09-17,2017,PIT,CIN,2,5,-117,-1.5,138,9.5,100,-120,107,1.5,-158,5.12,Great American Ballpark,7,-3
2017-09-17,2017,KC,CLE,2,3,220,1.5,-101,7.5,100,-120,-260,-1.5,-119,2.34,Progressive Field,5,-1
2017-09-17,2017,SD,COL,4,3,190,1.5,100,11.0,-102,-118,-220,-1.5,-120,3.79,Coors Field,7,1
2017-09-17,2017,DET,CWS,12,0,-127,-1.5,148,10.0,-119,-101,117,1.5,-170,5.59,Comerica Park,12,12
2017-09-17,2017,CWS,DET,0,12,117,1.5,-170,10.0,-119,-101,-127,-1.5,148,4.61,Comerica Park,12,-12
2017-09-17,2017,SEA,HOU,1,7,195,1.5,-105,9.0,-101,-119,-225,-1.5,-115,3.05,Minute Maid Park,8,-6
2017-09-17,2017,CLE,KC,3,2,-260,-1.5,-119,7.5,100,-120,220,1.5,-101,5.42,Progressive Field,5,1
2017-09-17,2017,TEX,LAA,4,2,174,1.5,-120,9.0,-110,-110,-194,-1.5,100,3.28,Angel Stadium,6,2
2017-09-17,2017,WSH,LAD,7,1,-172,-1.5,115,7.5,-119,-101,152,1.5,-135,4.74,Nationals Park,8,6
2017-09-17,2017,MIL,MIA,10,3,-144,-1.5,112,9.0,-120,100,129,1.5,-132,5.31,Miller Park,13,7
2017-09-17,2017,MIA,MIL,3,10,129,1.5,-132,9.0,-120,100,-144,-1.5,112,3.93,Miller Park,13,-7
2017-09-17,2017,TOR,MIN,7,13,125,1.5,-165,9.0,-115,-105,-140,-1.5,144,4.0,Target Field,20,-6
2017-09-17,2017,ATL,NYM,1,5,-170,-1.5,115,9.0,-101,-119,150,1.5,-135,5.67,Suntrust Park,6,-4
2017-09-17,2017,BAL,NYY,6,4,200,1.5,-107,9.5,-107,-113,-230,-1.5,-113,3.17,Yankee Stadium,10,2
2017-09-17,2017,PHI,OAK,3,6,114,1.5,-150,9.5,-110,-110,-124,-1.5,130,4.44,Citizens Bank Park,9,-3
2017-09-17,2017,OAK,PHI,6,3,-124,-1.5,130,9.5,-110,-110,114,1.5,-150,5.26,Citizens Bank Park,9,3
2017-09-17,2017,CIN,PIT,5,2,107,1.5,-158,9.5,100,-120,-117,-1.5,138,4.59,Great American Ballpark,7,3
2017-09-17,2017,COL,SD,3,4,-220,-1.5,-120,11.0,-102,-118,190,1.5,100,7.56,Coors Field,7,-1
2017-09-17,2017,HOU,SEA,7,1,-225,-1.5,-115,9.0,-101,-119,195,1.5,-105,6.23,Minute Maid Park,8,6
2017-09-17,2017,ARI,SF,2,7,-150,-1.5,105,8.5,-114,-106,135,1.5,-125,5.1,AT&T Park,9,-5
2017-09-17,2017,CHC,STL,4,3,-180,-1.5,111,9.0,-119,-101,160,1.5,-131,5.79,Wrigley Field,7,1
2017-09-17,2017,BOS,TB,2,3,-129,-1.5,130,8.0,-110,-110,119,1.5,-150,4.51,Tropicana Field,5,-1
2017-09-17,2017,LAA,TEX,2,4,-194,-1.5,100,9.0,-110,-110,174,1.5,-120,5.94,Angel Stadium,6,-2
2017-09-17,2017,MIN,TOR,13,7,-140,-1.5,144,9.0,-115,-105,125,1.5,-165,5.25,Target Field,20,6
2017-09-17,2017,LAD,WSH,1,7,152,1.5,-135,7.5,-119,-101,-172,-1.5,115,2.98,Nationals Park,8,-6
2017-09-18,2017,SD,ARI,4,2,130,1.5,-135,8.5,-123,103,-145,-1.5,115,3.7,PETCO Park,6,2
2017-09-18,2017,BOS,BAL,10,8,119,1.5,-176,9.0,104,-124,-129,-1.5,151,4.11,Camden Yards,18,2
2017-09-18,2017,BAL,BOS,8,10,-129,-1.5,151,9.0,104,-124,119,1.5,-176,5.07,Camden Yards,18,-2
2017-09-18,2017,OAK,DET,8,3,111,1.5,-185,10.0,-125,105,-121,-1.5,156,4.74,Comerica Park,11,5
2017-09-18,2017,PHI,LAD,4,3,276,1.5,155,8.0,-101,-119,-326,-1.5,-180,2.13,Citizens Bank Park,7,1
2017-09-18,2017,NYM,MIA,1,13,150,1.5,-145,9.0,-116,-104,-165,-1.5,125,3.6,Marlins Park,14,-12
2017-09-18,2017,PIT,MIL,0,3,-107,-1.5,184,8.5,110,-130,-103,1.5,-220,4.39,PNC Park,3,-3
2017-09-18,2017,NYY,MIN,2,1,-175,-1.5,125,8.5,-110,-110,155,1.5,-145,5.41,Yankee Stadium,3,1
2017-09-18,2017,MIA,NYM,13,1,-165,-1.5,125,9.0,-116,-104,150,1.5,-145,5.6,Marlins Park,14,12
2017-09-18,2017,MIN,NYY,1,2,155,1.5,-145,8.5,-110,-110,-175,-1.5,125,3.33,Yankee Stadium,3,-1
2017-09-18,2017,DET,OAK,3,8,-121,-1.5,156,10.0,-125,105,111,1.5,-185,5.48,Comerica Park,11,-5
2017-09-18,2017,LAD,PHI,3,4,-326,-1.5,-180,8.0,-101,-119,276,1.5,155,6.12,Citizens Bank Park,7,-1
2017-09-18,2017,MIL,PIT,3,0,-103,1.5,-220,8.5,110,-130,-107,-1.5,184,4.31,PNC Park,3,3
2017-09-18,2017,ARI,SD,2,4,-145,-1.5,115,8.5,-123,103,130,1.5,-135,5.03,PETCO Park,6,-2
2017-09-19,2017,SD,ARI,6,2,165,1.5,100,8.5,-105,-115,-185,-1.5,-120,3.21,PETCO Park,8,4
2017-09-19,2017,WSH,ATL,4,2,-205,-1.5,-140,8.0,-105,-115,175,1.5,120,5.38,Suntrust Park,6,2
2017-09-19,2017,BOS,BAL,1,0,-104,1.5,-230,9.0,-114,-106,-106,-1.5,192,4.59,Camden Yards,1,1
2017-09-19,2017,BAL,BOS,0,1,-106,-1.5,192,9.0,-114,-106,-104,1.5,-230,4.63,Camden Yards,1,-1
2017-09-19,2017,TB,CHC,1,2,-160,-1.5,135,8.0,-114,-106,145,1.5,-155,4.92,Tropicana Field,3,-1
2017-09-19,2017,STL,CIN,8,7,-110,-1.5,140,10.0,-118,-102,100,1.5,-160,5.24,Great American Ballpark,15,1
2017-09-19,2017,LAA,CLE,3,6,101,1.5,-170,7.5,-110,-110,-111,-1.5,148,3.73,Angel Stadium,9,-3
2017-09-19,2017,SF,COL,4,3,105,1.5,-170,7.5,-115,-105,-115,-1.5,148,3.66,AT&T Park,7,1
2017-09-19,2017,HOU,CWS,3,1,-270,-1.5,-130,9.0,-120,100,230,1.5,110,6.57,Minute Maid Park,4,2
2017-09-19,2017,OAK,DET,9,8,-129,-1.5,125,10.5,105,-125,119,1.5,-145,5.91,Comerica Park,17,1
2017-09-19,2017,CWS,HOU,1,3,230,1.5,110,9.0,-120,100,-270,-1.5,-130,2.73,Minute Maid Park,4,-2
2017-09-19,2017,TOR,KC,5,2,-177,-1.5,119,9.0,-105,-115,157,1.5,-139,5.75,Rogers Centre,7,3
2017-09-19,2017,CLE,LAA,6,3,-111,-1.5,148,7.5,-110,-110,101,1.5,-170,3.95,Angel Stadium,9,3
2017-09-19,2017,PHI,LAD,6,2,146,1.5,-120,7.5,-110,-110,-161,-1.5,100,3.05,Citizens Bank Park,8,4
2017-09-19,2017,NYM,MIA,4,5,119,1.5,-175,9.5,100,-120,-129,-1.5,151,4.34,Marlins Park,9,-1
2017-09-19,2017,PIT,MIL,0,1,-109,-1.5,172,8.5,-125,105,-101,1.5,-205,4.43,PNC Park,1,-1
2017-09-19,2017,NYY,MIN,5,2,-158,-1.5,120,8.5,-120,100,143,1.5,-140,5.21,Yankee Stadium,7,3
2017-09-19,2017,MIA,NYM,5,4,-129,-1.5,151,9.5,100,-120,119,1.5,-175,5.35,Marlins Park,9,1
2017-09-19,2017,MIN,NYY,2,5,143,1.5,-140,8.5,-120,100,-158,-1.5,120,3.5,Yankee Stadium,7,-3
2017-09-19,2017,DET,OAK,8,9,119,1.5,-145,10.5,105,-125,-129,-1.5,125,4.79,Comerica Park,17,-1
2017-09-19,2017,LAD,PHI,2,6,-161,-1.5,100,7.5,-110,-110,146,1.5,-120,4.63,Citizens Bank Park,8,-4
2017-09-19,2017,MIL,PIT,1,0,-101,1.5,-205,8.5,-125,105,-109,-1.5,172,4.27,PNC Park,1,1
2017-09-19,2017,ARI,SD,2,6,-185,-1.5,-120,8.5,-105,-115,165,1.5,100,5.52,PETCO Park,8,-4
2017-09-19,2017,TEX,SEA,3,1,140,1.5,-150,9.5,100,-120,-155,-1.5,130,3.96,T-Mobile Park,4,2
2017-09-19,2017,COL,SF,3,4,-115,-1.5,148,7.5,-115,-105,105,1.5,-170,4.01,AT&T Park,7,-1
2017-09-19,2017,CIN,STL,7,8,100,1.5,-160,10.0,-118,-102,-110,-1.5,140,5.0,Great American Ballpark,15,-1
2017-09-19,2017,CHC,TB,2,1,145,1.5,-155,8.0,-114,-106,-160,-1.5,135,3.27,Tropicana Field,3,1
2017-09-19,2017,SEA,TEX,1,3,-155,-1.5,130,9.5,100,-120,140,1.5,-150,5.77,T-Mobile Park,4,-2
2017-09-19,2017,KC,TOR,2,5,157,1.5,-139,9.0,-105,-115,-177,-1.5,119,3.5,Rogers Centre,7,-3
2017-09-19,2017,ATL,WSH,2,4,175,1.5,120,8.0,-105,-115,-205,-1.5,-140,2.91,Suntrust Park,6,-2
2017-09-20,2017,SD,ARI,7,13,155,1.5,-110,7.0,-128,108,-175,-1.5,-110,2.75,PETCO Park,20,-6
2017-09-20,2017,WSH,ATL,7,3,-161,-1.5,-107,9.5,-115,-105,146,1.5,-113,5.86,Suntrust Park,10,4
2017-09-20,2017,BOS,BAL,9,0,-258,-1.5,-150,8.5,-110,-110,218,1.5,130,6.13,Camden Yards,9,9
2017-09-20,2017,BAL,BOS,0,9,218,1.5,130,8.5,-110,-110,-258,-1.5,-150,2.67,Camden Yards,9,-9
2017-09-20,2017,TB,CHC,8,1,103,1.5,-160,8.0,-116,-104,-113,-1.5,140,3.94,Tropicana Field,9,7
2017-09-20,2017,STL,CIN,9,2,-195,-1.5,-140,9.5,-116,-104,175,1.5,120,6.28,Great American Ballpark,11,7
2017-09-20,2017,LAA,CLE,5,6,106,1.5,-165,8.5,-119,-101,-116,-1.5,144,4.13,Angel Stadium,11,-1
2017-09-20,2017,SF,COL,4,0,119,1.5,-150,8.5,-103,-117,-129,-1.5,130,3.88,AT&T Park,4,4
2017-09-20,2017,HOU,CWS,4,3,-370,-1.5,-190,9.0,-118,-102,310,1.5,163,7.09,Minute Maid Park,7,1
2017-09-20,2017,OAK,DET,3,2,-123,1.5,-240,10.5,106,-126,113,-1.5,199,5.79,Comerica Park,5,1
2017-09-20,2017,CWS,HOU,3,4,310,1.5,163,9.0,-118,-102,-370,-1.5,-190,2.2,Minute Maid Park,7,-1
2017-09-20,2017,TOR,KC,5,15,-121,-1.5,155,9.0,100,-120,111,1.5,-180,4.93,Rogers Centre,20,-10
2017-09-20,2017,CLE,LAA,6,5,-116,-1.5,144,8.5,-119,-101,106,1.5,-165,4.56,Angel Stadium,11,1
2017-09-20,2017,PHI,LAD,7,5,245,1.5,152,9.5,-117,-103,-285,-1.5,-175,2.75,Citizens Bank Park,12,2
2017-09-20,2017,NYM,MIA,2,9,157,1.5,-131,9.0,-110,-110,-177,-1.5,111,3.5,Marlins Park,11,-7
2017-09-20,2017,PIT,MIL,6,4,110,1.5,-155,9.0,-113,-107,-120,-1.5,135,4.29,PNC Park,10,2
2017-09-20,2017,NYY,MIN,11,3,-315,-1.5,-157,8.5,-119,-101,265,1.5,136,6.45,Yankee Stadium,14,8
2017-09-20,2017,MIA,NYM,9,2,-177,-1.5,111,9.0,-110,-110,157,1.5,-131,5.75,Marlins Park,11,7
2017-09-20,2017,MIN,NYY,3,11,265,1.5,136,8.5,-119,-101,-315,-1.5,-157,2.33,Yankee Stadium,14,-8
2017-09-20,2017,DET,OAK,2,3,113,-1.5,199,10.5,106,-126,-123,1.5,-240,4.93,Comerica Park,5,-1
2017-09-20,2017,LAD,PHI,5,7,-285,-1.5,-175,9.5,-117,-103,245,1.5,152,7.03,Citizens Bank Park,12,-2
2017-09-20,2017,MIL,PIT,4,6,-120,-1.5,135,9.0,-113,-107,110,1.5,-155,4.91,PNC Park,10,-2
2017-09-20,2017,ARI,SD,13,7,-175,-1.5,-110,7.0,-128,108,155,1.5,-110,4.45,PETCO Park,20,6
2017-09-20,2017,TEX,SEA,8,6,135,1.5,-165,9.0,-105,-115,-150,-1.5,144,3.83,T-Mobile Park,14,2
2017-09-20,2017,COL,SF,0,4,-129,-1.5,130,8.5,-103,-117,119,1.5,-150,4.79,AT&T Park,4,-4
2017-09-20,2017,CIN,STL,2,9,175,1.5,120,9.5,-116,-104,-195,-1.5,-140,3.45,Great American Ballpark,11,-7
2017-09-20,2017,CHC,TB,1,8,-113,-1.5,140,8.0,-116,-104,103,1.5,-160,4.24,Tropicana Field,9,-7
2017-09-20,2017,SEA,TEX,6,8,-150,-1.5,144,9.0,-105,-115,135,1.5,-165,5.4,T-Mobile Park,14,-2
2017-09-20,2017,KC,TOR,15,5,111,1.5,-180,9.0,100,-120,-121,-1.5,155,4.27,Rogers Centre,20,10
2017-09-20,2017,ATL,WSH,3,7,146,1.5,-113,9.5,-115,-105,-161,-1.5,-107,3.86,Suntrust Park,10,-4
2017-09-21,2017,WSH,ATL,2,3,-155,-1.5,-105,9.0,-125,105,140,1.5,-115,5.47,Suntrust Park,5,-1
2017-09-21,2017,TB,BAL,1,3,-130,-1.5,120,10.5,-119,-101,115,1.5,-140,5.93,Camden Yards,4,-2
2017-09-21,2017,MIL,CHC,3,5,125,1.5,-140,9.0,-110,-110,-140,-1.5,120,4.0,Miller Park,8,-2
2017-09-21,2017,STL,CIN,8,5,-187,-1.5,-103,9.5,-104,-116,167,1.5,-116,6.19,Great American Ballpark,13,3
2017-09-21,2017,LAA,CLE,1,4,-105,1.5,-165,8.5,-117,-103,-105,-1.5,144,4.35,Angel Stadium,5,-3
2017-09-21,2017,SD,COL,3,0,105,1.5,-160,8.0,-120,100,-115,-1.5,140,3.9,PETCO Park,3,3
2017-09-21,2017,HOU,CWS,1,3,-312,-1.5,-150,9.0,-120,100,262,1.5,130,6.82,Minute Maid Park,4,-2
2017-09-21,2017,MIN,DET,12,1,-135,-1.5,120,10.5,-110,-110,120,1.5,-140,6.03,Comerica Park,13,11
2017-09-21,2017,CWS,HOU,3,1,262,1.5,130,9.0,-120,100,-312,-1.5,-150,2.49,Minute Maid Park,4,2
2017-09-21,2017,TOR,KC,0,1,-150,-1.5,144,9.0,106,-126,135,1.5,-165,5.4,Rogers Centre,1,-1
2017-09-21,2017,CLE,LAA,4,1,-105,-1.5,144,8.5,-117,-103,-105,1.5,-165,4.35,Angel Stadium,5,3
2017-09-21,2017,PHI,LAD,4,5,183,1.5,110,9.0,105,-125,-213,-1.5,-130,3.18,Citizens Bank Park,9,-1
2017-09-21,2017,CHC,MIL,5,3,-140,-1.5,120,9.0,-110,-110,125,1.5,-140,5.25,Miller Park,8,2
2017-09-21,2017,DET,MIN,1,12,120,1.5,-140,10.5,-110,-110,-135,-1.5,120,4.77,Comerica Park,13,-11
2017-09-21,2017,LAD,PHI,5,4,-213,-1.5,-130,9.0,105,-125,183,1.5,110,6.12,Citizens Bank Park,9,1
2017-09-21,2017,COL,SD,0,3,-115,-1.5,140,8.0,-120,100,105,1.5,-160,4.28,PETCO Park,3,-3
2017-09-21,2017,TEX,SEA,4,2,150,1.5,-135,8.0,-120,100,-170,-1.5,115,3.2,T-Mobile Park,6,2
2017-09-21,2017,CIN,STL,5,8,167,1.5,-116,9.5,-104,-116,-187,-1.5,-103,3.56,Great American Ballpark,13,-3
2017-09-21,2017,BAL,TB,3,1,115,1.5,-140,10.5,-119,-101,-130,-1.5,120,4.88,Camden Yards,4,2
2017-09-21,2017,SEA,TEX,2,4,-170,-1.5,115,8.0,-120,100,150,1.5,-135,5.04,T-Mobile Park,6,-2
2017-09-21,2017,KC,TOR,1,0,135,1.5,-165,9.0,106,-126,-150,-1.5,144,3.83,Rogers Centre,1,1
2017-09-21,2017,ATL,WSH,3,2,140,1.5,-115,9.0,-125,105,-155,-1.5,-105,3.75,Suntrust Park,5,1
2017-09-22,2017,MIA,ARI,11,13,200,1.5,102,9.5,-119,-101,-230,-1.5,-122,3.17,Chase Field,24,-2
2017-09-22,2017,PHI,ATL,2,7,119,1.5,-170,9.5,-105,-115,-129,-1.5,148,4.34,Suntrust Park,9,-5
2017-09-22,2017,TB,BAL,8,3,-140,-1.5,112,9.0,-120,100,125,1.5,-132,5.25,Camden Yards,11,5
2017-09-22,2017,CIN,BOS,4,5,116,1.5,-140,9.5,-101,-119,-131,-1.5,120,4.4,Great American Ballpark,9,-1
2017-09-22,2017,MIL,CHC,4,5,105,1.5,-160,10.0,-104,-116,-115,-1.5,140,4.88,Miller Park,9,-1
2017-09-22,2017,BOS,CIN,5,4,-131,-1.5,120,9.5,-101,-119,116,1.5,-140,5.39,Great American Ballpark,9,1
2017-09-22,2017,SEA,CLE,3,1,128,1.5,-135,8.5,-105,-115,-143,-1.5,115,3.73,T-Mobile Park,4,2
2017-09-22,2017,SD,COL,1,4,126,1.5,-140,8.0,-105,-115,-141,-1.5,120,3.54,PETCO Park,5,-3
2017-09-22,2017,KC,CWS,6,7,-152,-1.5,-102,10.0,-106,-114,137,1.5,-118,6.03,Guaranteed Rate Field,13,-1
2017-09-22,2017,MIN,DET,7,3,-135,-1.5,117,10.0,-105,-115,120,1.5,-137,5.74,Comerica Park,10,4
2017-09-22,2017,LAA,HOU,0,3,117,1.5,-175,8.0,-114,-106,-132,-1.5,151,3.69,Minute Maid Park,3,-3
2017-09-22,2017,CWS,KC,7,6,137,1.5,-118,10.0,-106,-114,-152,-1.5,-102,4.22,Guaranteed Rate Field,13,1
2017-09-22,2017,HOU,LAA,3,0,-132,-1.5,151,8.0,-114,-106,117,1.5,-175,4.55,Minute Maid Park,3,3
2017-09-22,2017,SF,LAD,2,4,193,1.5,-109,7.5,-101,-119,-223,-1.5,-111,2.56,Dodger Stadium,6,-2
2017-09-22,2017,ARI,MIA,13,11,-230,-1.5,-122,9.5,-119,-101,200,1.5,102,6.62,Chase Field,24,2
2017-09-22,2017,CHC,MIL,5,4,-115,-1.5,140,10.0,-104,-116,105,1.5,-160,5.35,Miller Park,9,1
2017-09-22,2017,DET,MIN,3,7,120,1.5,-137,10.0,-105,-115,-135,-1.5,117,4.55,Comerica Park,10,-4
2017-09-22,2017,WSH,NYM,6,7,114,1.5,-210,8.0,-115,-105,-124,-1.5,176,3.74,Citi Field,13,-1
2017-09-22,2017,TOR,NYY,8,1,160,1.5,-104,9.0,100,-120,-180,-1.5,-116,3.46,Rogers Centre,9,7
2017-09-22,2017,TEX,OAK,1,4,117,1.5,-170,9.5,-119,-101,-132,-1.5,148,4.38,Oakland Coliseum,5,-3
2017-09-22,2017,ATL,PHI,7,2,-129,-1.5,148,9.5,-105,-115,119,1.5,-170,5.35,Suntrust Park,9,5
2017-09-22,2017,STL,PIT,4,3,-153,-1.5,101,8.5,-111,-109,138,1.5,-121,5.14,PNC Park,7,1
2017-09-22,2017,COL,SD,4,1,-141,-1.5,120,8.0,-105,-115,126,1.5,-140,4.68,PETCO Park,5,3
2017-09-22,2017,CLE,SEA,1,3,-143,-1.5,115,8.5,-105,-115,128,1.5,-135,5.0,T-Mobile Park,4,-2
2017-09-22,2017,LAD,SF,4,2,-223,-1.5,-111,7.5,-101,-119,193,1.5,-109,5.18,Dodger Stadium,6,2
2017-09-22,2017,PIT,STL,3,4,138,1.5,-121,8.5,-111,-109,-153,-1.5,101,3.57,PNC Park,7,-1
2017-09-22,2017,BAL,TB,3,8,125,1.5,-132,9.0,-120,100,-140,-1.5,112,4.0,Camden Yards,11,-5
2017-09-22,2017,OAK,TEX,4,1,-132,-1.5,148,9.5,-119,-101,117,1.5,-170,5.41,Oakland Coliseum,5,3
2017-09-22,2017,NYY,TOR,1,8,-180,-1.5,-116,9.0,100,-120,160,1.5,-104,5.79,Rogers Centre,9,-7
2017-09-22,2017,NYM,WSH,7,6,-124,-1.5,176,8.0,-115,-105,114,1.5,-210,4.43,Citi Field,13,1
2017-09-23,2017,MIA,ARI,12,6,140,1.5,-145,11.0,-114,-106,-155,-1.5,125,4.58,Chase Field,18,6
2017-09-23,2017,PHI,ATL,2,4,130,1.5,-166,9.0,-120,100,-145,-1.5,145,3.91,Suntrust Park,6,-2
2017-09-23,2017,TB,BAL,9,6,-115,-1.5,139,10.5,-110,-110,105,1.5,-159,5.62,Camden Yards,15,3
2017-09-23,2017,CIN,BOS,0,5,120,1.5,-140,9.5,-110,-110,-135,-1.5,120,4.32,Great American Ballpark,5,-5
2017-09-23,2017,MIL,CHC,4,3,129,1.5,-135,9.0,-115,-105,-144,-1.5,115,3.93,Miller Park,7,1
2017-09-23,2017,BOS,CIN,5,0,-135,-1.5,120,9.5,-110,-110,120,1.5,-140,5.46,Great American Ballpark,5,5
2017-09-23,2017,SEA,CLE,4,11,143,1.5,-127,8.0,-110,-110,-158,-1.5,107,3.29,T-Mobile Park,15,-7
2017-09-23,2017,SD,COL,5,0,-105,-1.5,180,8.5,-105,-115,-105,1.5,-215,4.35,PETCO Park,5,5
2017-09-23,2017,KC,CWS,8,2,-155,-1.5,106,9.5,-115,-105,140,1.5,-128,5.77,Guaranteed Rate Field,10,6
2017-09-23,2017,MIN,DET,10,4,-155,-1.5,-101,9.5,-110,-110,140,1.5,-119,5.77,Comerica Park,14,6
2017-09-23,2017,LAA,HOU,2,6,111,1.5,-180,8.5,-120,100,-121,-1.5,155,4.03,Minute Maid Park,8,-4
2017-09-23,2017,CWS,KC,2,8,140,1.5,-128,9.5,-115,-105,-155,-1.5,106,3.96,Guaranteed Rate Field,10,-6
2017-09-23,2017,HOU,LAA,6,2,-121,-1.5,155,8.5,-120,100,111,1.5,-180,4.65,Minute Maid Park,8,4
2017-09-23,2017,SF,LAD,2,1,127,1.5,-180,7.5,-105,-115,-142,-1.5,155,3.3,Dodger Stadium,3,1
2017-09-23,2017,ARI,MIA,6,12,-155,-1.5,125,11.0,-114,-106,140,1.5,-145,6.69,Chase Field,18,-6
2017-09-23,2017,CHC,MIL,3,4,-144,-1.5,115,9.0,-115,-105,129,1.5,-135,5.31,Miller Park,7,-1
2017-09-23,2017,DET,MIN,4,10,140,1.5,-119,9.5,-110,-110,-155,-1.5,-101,3.96,Comerica Park,14,-6
2017-09-23,2017,WSH,NYM,4,3,-200,-1.5,-125,8.0,-105,-115,170,1.5,105,5.33,Citi Field,7,1
2017-09-23,2017,TOR,NYY,1,5,172,1.5,105,9.0,-105,-115,-192,-1.5,-125,3.31,Rogers Centre,6,-4
2017-09-23,2017,TEX,OAK,0,1,-131,-1.5,137,10.0,-115,-105,116,1.5,-158,5.67,Oakland Coliseum,1,-1
2017-09-23,2017,ATL,PHI,4,2,-145,-1.5,145,9.0,-120,100,130,1.5,-166,5.33,Suntrust Park,6,2
2017-09-23,2017,STL,PIT,6,11,119,1.5,-190,8.0,-108,-112,-129,-1.5,163,3.65,PNC Park,17,-5
2017-09-23,2017,COL,SD,0,5,-105,1.5,-215,8.5,-105,-115,-105,-1.5,180,4.35,PETCO Park,5,-5
2017-09-23,2017,CLE,SEA,11,4,-158,-1.5,107,8.0,-110,-110,143,1.5,-127,4.9,T-Mobile Park,15,7
2017-09-23,2017,LAD,SF,1,2,-142,-1.5,155,7.5,-105,-115,127,1.5,-180,4.4,Dodger Stadium,3,-1
2017-09-23,2017,PIT,STL,11,6,-129,-1.5,163,8.0,-108,-112,119,1.5,-190,4.51,PNC Park,17,5
2017-09-23,2017,BAL,TB,6,9,105,1.5,-159,10.5,-110,-110,-115,-1.5,139,5.12,Camden Yards,15,-3
2017-09-23,2017,OAK,TEX,1,0,116,1.5,-158,10.0,-115,-105,-131,-1.5,137,4.63,Oakland Coliseum,1,1
2017-09-23,2017,NYY,TOR,5,1,-192,-1.5,-125,9.0,-105,-115,172,1.5,105,5.92,Rogers Centre,6,4
2017-09-23,2017,NYM,WSH,3,4,170,1.5,105,8.0,-105,-115,-200,-1.5,-125,2.96,Citi Field,7,-1
2017-09-24,2017,MIA,ARI,2,3,165,1.5,-125,10.5,-120,100,-185,-1.5,105,3.96,Chase Field,5,-1
2017-09-24,2017,PHI,ATL,2,0,117,1.5,-185,10.0,100,-120,-127,-1.5,160,4.61,Suntrust Park,2,2
2017-09-24,2017,TB,BAL,4,9,-140,-1.5,106,9.5,105,-125,125,1.5,-126,5.54,Camden Yards,13,-5
2017-09-24,2017,CIN,BOS,4,5,114,1.5,-150,10.0,-115,-105,-124,-1.5,130,4.67,Great American Ballpark,9,-1
2017-09-24,2017,MIL,CHC,0,5,119,1.5,-155,9.0,-105,-115,-129,-1.5,135,4.11,Miller Park,5,-5
2017-09-24,2017,BOS,CIN,5,4,-124,-1.5,130,10.0,-115,-105,114,1.5,-150,5.54,Great American Ballpark,9,1
2017-09-24,2017,SEA,CLE,2,4,180,1.5,110,7.0,100,-120,-210,-1.5,-130,2.5,T-Mobile Park,6,-2
2017-09-24,2017,SD,COL,4,8,126,1.5,-129,8.5,-101,-119,-141,-1.5,110,3.76,PETCO Park,12,-4
2017-09-24,2017,KC,CWS,1,8,-128,-1.5,110,9.5,-113,-107,118,1.5,-130,5.33,Guaranteed Rate Field,9,-7
2017-09-24,2017,MIN,DET,10,4,-195,-1.5,-135,10.0,-123,103,175,1.5,115,6.61,Comerica Park,14,6
2017-09-24,2017,LAA,HOU,7,5,170,1.5,-120,9.0,-106,-114,-190,-1.5,100,3.33,Minute Maid Park,12,2
2017-09-24,2017,CWS,KC,8,1,118,1.5,-130,9.5,-113,-107,-128,-1.5,110,4.36,Guaranteed Rate Field,9,7
2017-09-24,2017,HOU,LAA,5,7,-190,-1.5,100,9.0,-106,-114,170,1.5,-120,5.9,Minute Maid Park,12,-2
2017-09-24,2017,SF,LAD,1,3,300,1.5,136,7.5,-102,-118,-360,-1.5,-156,1.88,Dodger Stadium,4,-2
2017-09-24,2017,ARI,MIA,3,2,-185,-1.5,105,10.5,-120,100,165,1.5,-125,6.82,Chase Field,5,1
2017-09-24,2017,CHC,MIL,5,0,-129,-1.5,135,9.0,-105,-115,119,1.5,-155,5.07,Miller Park,5,5
2017-09-24,2017,DET,MIN,4,10,175,1.5,115,10.0,-123,103,-195,-1.5,-135,3.64,Comerica Park,14,-6
2017-09-24,2017,WSH,NYM,3,2,-144,-1.5,116,7.0,112,-132,129,1.5,-136,4.13,Citi Field,5,1
2017-09-24,2017,TOR,NYY,9,5,-115,-1.5,170,8.5,-110,-110,105,1.5,-200,4.55,Rogers Centre,14,4
2017-09-24,2017,TEX,OAK,1,8,103,1.5,-205,10.0,-119,-101,-113,-1.5,172,4.93,Oakland Coliseum,9,-7
2017-09-24,2017,ATL,PHI,0,2,-127,-1.5,160,10.0,100,-120,117,1.5,-185,5.59,Suntrust Park,2,-2
2017-09-24,2017,STL,PIT,1,4,-122,-1.5,140,9.0,-110,-110,112,1.5,-160,4.95,PNC Park,5,-3
2017-09-24,2017,COL,SD,8,4,-141,-1.5,110,8.5,-101,-119,126,1.5,-129,4.97,PETCO Park,12,4
2017-09-24,2017,CLE,SEA,4,2,-210,-1.5,-130,7.0,100,-120,180,1.5,110,4.74,T-Mobile Park,6,2
2017-09-24,2017,LAD,SF,3,1,-360,-1.5,-156,7.5,-102,-118,300,1.5,136,5.87,Dodger Stadium,4,2
2017-09-24,2017,PIT,STL,4,1,112,1.5,-160,9.0,-110,-110,-122,-1.5,140,4.25,PNC Park,5,3
2017-09-24,2017,BAL,TB,9,4,125,1.5,-126,9.5,105,-125,-140,-1.5,106,4.22,Camden Yards,13,5
2017-09-24,2017,OAK,TEX,8,1,-113,-1.5,172,10.0,-119,-101,103,1.5,-205,5.31,Oakland Coliseum,9,7
2017-09-24,2017,NYY,TOR,5,9,105,1.5,-200,8.5,-110,-110,-115,-1.5,170,4.15,Rogers Centre,14,-4
2017-09-24,2017,NYM,WSH,2,3,129,1.5,-136,7.0,112,-132,-144,-1.5,116,3.06,Citi Field,5,-1
2017-09-25,2017,SF,ARI,9,2,104,1.5,-200,9.0,-103,-117,-114,-1.5,170,4.41,Chase Field,11,7
2017-09-25,2017,NYM,ATL,2,9,125,1.5,-132,9.0,-105,-115,-140,-1.5,112,4.0,Citi Field,11,-7
2017-09-25,2017,NYM,ATL,3,2,-132,-1.5,160,8.5,-125,105,117,1.5,-185,4.84,Citi Field,5,1
2017-09-25,2017,TOR,BOS,6,4,160,1.5,-135,9.0,-114,-106,-180,-1.5,115,3.46,Fenway Park,10,2
2017-09-25,2017,STL,CHC,2,10,-145,-1.5,144,8.0,-105,-115,130,1.5,-166,4.73,Busch Stadium,12,-8
2017-09-25,2017,MIA,COL,5,4,152,1.5,-125,12.0,-101,-119,-172,-1.5,105,4.76,Coors Field,9,1
2017-09-25,2017,LAA,CWS,2,4,-230,-1.5,-150,10.0,-113,-107,200,1.5,130,6.97,Guaranteed Rate Field,6,-2
2017-09-25,2017,TEX,HOU,2,11,127,1.5,-125,11.5,-101,-119,-142,-1.5,105,5.07,Rangers Ballpark,13,-9
2017-09-25,2017,NYY,KC,11,3,-200,-1.5,-105,9.0,-119,-101,170,1.5,-115,6.0,Yankee Stadium,14,8
2017-09-25,2017,CWS,LAA,4,2,200,1.5,130,10.0,-113,-107,-230,-1.5,-150,3.33,Guaranteed Rate Field,6,2
2017-09-25,2017,SD,LAD,3,9,231,1.5,114,8.5,100,-120,-271,-1.5,-134,2.57,Dodger Stadium,12,-6
2017-09-25,2017,COL,MIA,4,5,-172,-1.5,105,12.0,-101,-119,152,1.5,-125,7.59,Coors Field,9,-1
2017-09-25,2017,ATL,NYM,9,2,-140,-1.5,112,9.0,-105,-115,125,1.5,-132,5.25,Citi Field,11,7
2017-09-25,2017,ATL,NYM,2,3,117,1.5,-185,8.5,-125,105,-132,-1.5,160,3.92,Citi Field,5,-1
2017-09-25,2017,KC,NYY,3,11,170,1.5,-115,9.0,-119,-101,-200,-1.5,-105,3.33,Yankee Stadium,14,-8
2017-09-25,2017,SEA,OAK,7,1,-105,-1.5,148,9.5,-115,-105,-105,1.5,-170,4.87,Oakland Coliseum,8,6
2017-09-25,2017,WSH,PHI,3,1,177,1.5,-115,8.5,-101,-119,-197,-1.5,-105,3.07,Citizens Bank Park,4,2
2017-09-25,2017,LAD,SD,9,3,-271,-1.5,-134,8.5,100,-120,231,1.5,114,6.21,Dodger Stadium,12,6
2017-09-25,2017,OAK,SEA,1,7,-105,1.5,-170,9.5,-115,-105,-105,-1.5,148,4.87,Oakland Coliseum,8,-6
2017-09-25,2017,ARI,SF,2,9,-114,-1.5,170,9.0,-103,-117,104,1.5,-200,4.79,Chase Field,11,-7
2017-09-25,2017,CHC,STL,10,2,130,1.5,-166,8.0,-105,-115,-145,-1.5,144,3.48,Busch Stadium,12,8
2017-09-25,2017,HOU,TEX,11,2,-142,-1.5,105,11.5,-101,-119,127,1.5,-125,6.75,Rangers Ballpark,13,9
2017-09-25,2017,BOS,TOR,4,6,-180,-1.5,115,9.0,-114,-106,160,1.5,-135,5.79,Fenway Park,10,-2
2017-09-25,2017,PHI,WSH,1,3,-197,-1.5,-105,8.5,-101,-119,177,1.5,-115,5.64,Citizens Bank Park,4,-2
2017-09-26,2017,SF,ARI,4,11,208,1.5,106,9.5,-115,-105,-248,-1.5,-125,3.08,Chase Field,15,-7
2017-09-26,2017,NYM,ATL,4,3,111,1.5,-150,8.5,-105,-115,-121,-1.5,130,4.03,Citi Field,7,1
2017-09-26,2017,PIT,BAL,10,1,104,1.5,-165,8.0,-120,100,-114,-1.5,144,3.92,PNC Park,11,9
2017-09-26,2017,TOR,BOS,9,4,196,1.5,-115,7.5,-116,-104,-226,-1.5,-105,2.53,Fenway Park,13,5
2017-09-26,2017,STL,CHC,8,7,106,1.5,-170,8.5,100,-120,-116,-1.5,148,4.13,Busch Stadium,15,1
2017-09-26,2017,MIL,CIN,7,6,-162,-1.5,125,9.5,-120,100,147,1.5,-145,5.87,Miller Park,13,1
2017-09-26,2017,MIN,CLE,8,6,165,1.5,-120,10.0,-120,100,-185,-1.5,100,3.77,Progressive Field,14,2
2017-09-26,2017,MIA,COL,0,6,151,1.5,-125,11.0,-101,-119,-166,-1.5,105,4.38,Coors Field,6,-6
2017-09-26,2017,LAA,CWS,9,3,-174,-1.5,-120,10.5,-110,-110,154,1.5,100,6.67,Guaranteed Rate Field,12,6
2017-09-26,2017,KC,DET,2,1,-170,-1.5,115,9.0,-115,-105,150,1.5,-135,5.67,Kauffman Stadium,3,1
2017-09-26,2017,TEX,HOU,3,14,132,1.5,-120,9.5,-105,-115,-147,-1.5,100,4.09,Rangers Ballpark,17,-11
2017-09-26,2017,DET,KC,1,2,150,1.5,-135,9.0,-115,-105,-170,-1.5,115,3.6,Kauffman Stadium,3,-1
2017-09-26,2017,CWS,LAA,3,9,154,1.5,100,10.5,-110,-110,-174,-1.5,-120,4.13,Guaranteed Rate Field,12,-6
2017-09-26,2017,SD,LAD,2,9,198,1.5,-115,8.0,110,-130,-228,-1.5,-105,2.68,Dodger Stadium,11,-7
2017-09-26,2017,COL,MIA,6,0,-166,-1.5,105,11.0,-101,-119,151,1.5,-125,6.86,Coors Field,6,6
2017-09-26,2017,CIN,MIL,6,7,147,1.5,-145,9.5,-120,100,-162,-1.5,125,3.85,Miller Park,13,-1
2017-09-26,2017,CLE,MIN,6,8,-185,-1.5,100,10.0,-120,100,165,1.5,-120,6.49,Progressive Field,14,-2
2017-09-26,2017,ATL,NYM,3,4,-121,-1.5,130,8.5,-105,-115,111,1.5,-150,4.65,Citi Field,7,-1
2017-09-26,2017,TB,NYY,1,6,153,1.5,-140,8.5,-120,100,-173,-1.5,120,3.36,Yankee Stadium,7,-5
2017-09-26,2017,SEA,OAK,6,3,-112,-1.5,125,9.0,-115,-105,102,1.5,-145,4.75,Oakland Coliseum,9,3
2017-09-26,2017,WSH,PHI,1,4,-190,-1.5,-115,9.0,-125,105,170,1.5,-105,5.9,Citizens Bank Park,5,-3
2017-09-26,2017,BAL,PIT,1,10,-114,-1.5,144,8.0,-120,100,104,1.5,-165,4.26,PNC Park,11,-9
2017-09-26,2017,LAD,SD,9,2,-228,-1.5,-105,8.0,110,-130,198,1.5,-115,5.56,Dodger Stadium,11,7
2017-09-26,2017,OAK,SEA,3,6,102,1.5,-145,9.0,-115,-105,-112,-1.5,125,4.46,Oakland Coliseum,9,-3
2017-09-26,2017,ARI,SF,11,4,-248,-1.5,-125,9.5,-115,-105,208,1.5,106,6.77,Chase Field,15,7
2017-09-26,2017,CHC,STL,7,8,-116,-1.5,148,8.5,100,-120,106,1.5,-170,4.56,Busch Stadium,15,-1
2017-09-26,2017,NYY,TB,6,1,-173,-1.5,120,8.5,-120,100,153,1.5,-140,5.39,Yankee Stadium,7,5
2017-09-26,2017,HOU,TEX,14,3,-147,-1.5,100,9.5,-105,-115,132,1.5,-120,5.65,Rangers Ballpark,17,11
2017-09-26,2017,BOS,TOR,4,9,-226,-1.5,-105,7.5,-116,-104,196,1.5,-115,5.2,Fenway Park,13,-5
2017-09-26,2017,PHI,WSH,4,1,170,1.5,-105,9.0,-125,105,-190,-1.5,-115,3.33,Citizens Bank Park,5,3
2017-09-27,2017,SF,ARI,3,4,120,1.5,-175,10.0,-120,100,-135,-1.5,151,4.55,Chase Field,7,-1
2017-09-27,2017,NYM,ATL,7,1,113,1.5,-150,8.5,-110,-110,-123,-1.5,130,3.99,Citi Field,8,6
2017-09-27,2017,PIT,BAL,5,3,-144,-1.5,143,9.0,-105,-115,129,1.5,-163,5.31,PNC Park,8,2
2017-09-27,2017,TOR,BOS,7,10,118,1.5,-170,10.0,-106,-114,-133,-1.5,148,4.59,Fenway Park,17,-3
2017-09-27,2017,STL,CHC,1,5,-113,-1.5,176,8.0,-113,-107,103,1.5,-210,4.24,Busch Stadium,6,-4
2017-09-27,2017,MIL,CIN,0,6,-140,-1.5,155,9.5,-110,-110,125,1.5,-180,5.54,Miller Park,6,-6
2017-09-27,2017,MIN,CLE,2,4,175,1.5,-120,9.0,100,-120,-205,-1.5,100,3.27,Progressive Field,6,-2
2017-09-27,2017,MIA,COL,9,15,180,1.5,-105,11.0,-120,100,-210,-1.5,-115,3.93,Coors Field,24,-6
2017-09-27,2017,LAA,CWS,4,6,-233,-1.5,-150,9.0,-119,-101,203,1.5,130,6.3,Guaranteed Rate Field,10,-2
2017-09-27,2017,KC,DET,7,4,-168,-1.5,126,9.0,100,-120,153,1.5,-146,5.64,Kauffman Stadium,11,3
2017-09-27,2017,TEX,HOU,2,12,190,1.5,139,10.0,-105,-115,-220,-1.5,-160,3.45,Rangers Ballpark,14,-10
2017-09-27,2017,DET,KC,4,7,153,1.5,-146,9.0,100,-120,-168,-1.5,126,3.56,Kauffman Stadium,11,-3
2017-09-27,2017,CWS,LAA,6,4,203,1.5,130,9.0,-119,-101,-233,-1.5,-150,2.97,Guaranteed Rate Field,10,2
2017-09-27,2017,SD,LAD,0,10,215,1.5,105,7.5,-105,-115,-255,-1.5,-125,2.38,Dodger Stadium,10,-10
2017-09-27,2017,COL,MIA,15,9,-210,-1.5,-115,11.0,-120,100,180,1.5,-105,7.45,Coors Field,24,6
2017-09-27,2017,CIN,MIL,6,0,125,1.5,-180,9.5,-110,-110,-140,-1.5,155,4.22,Miller Park,6,6
2017-09-27,2017,CLE,MIN,4,2,-205,-1.5,100,9.0,100,-120,175,1.5,-120,6.05,Progressive Field,6,2
2017-09-27,2017,ATL,NYM,1,7,-123,-1.5,130,8.5,-110,-110,113,1.5,-150,4.69,Citi Field,8,-6
2017-09-27,2017,TB,NYY,1,6,190,1.5,100,8.5,-109,-111,-220,-1.5,-120,2.93,Yankee Stadium,7,-5
2017-09-27,2017,SEA,OAK,5,6,-107,-1.5,148,10.0,-110,-110,-103,1.5,-170,5.17,Oakland Coliseum,11,-1
2017-09-27,2017,WSH,PHI,5,7,-150,-1.5,110,9.5,100,-120,135,1.5,-130,5.7,Citizens Bank Park,12,-2
2017-09-27,2017,BAL,PIT,3,5,129,1.5,-163,9.0,-105,-115,-144,-1.5,143,3.93,PNC Park,8,-2
2017-09-27,2017,LAD,SD,10,0,-255,-1.5,-125,7.5,-105,-115,215,1.5,105,5.39,Dodger Stadium,10,10
2017-09-27,2017,OAK,SEA,6,5,-103,1.5,-170,10.0,-110,-110,-107,-1.5,148,5.07,Oakland Coliseum,11,1
2017-09-27,2017,ARI,SF,4,3,-135,-1.5,151,10.0,-120,100,120,1.5,-175,5.74,Chase Field,7,1
2017-09-27,2017,CHC,STL,5,1,103,1.5,-210,8.0,-113,-107,-113,-1.5,176,3.94,Busch Stadium,6,4
2017-09-27,2017,NYY,TB,6,1,-220,-1.5,-120,8.5,-109,-111,190,1.5,100,5.84,Yankee Stadium,7,5
2017-09-27,2017,HOU,TEX,12,2,-220,-1.5,-160,10.0,-105,-115,190,1.5,139,6.88,Rangers Ballpark,14,10
2017-09-27,2017,BOS,TOR,10,7,-133,-1.5,148,10.0,-106,-114,118,1.5,-170,5.71,Fenway Park,17,3
2017-09-27,2017,PHI,WSH,7,5,135,1.5,-130,9.5,100,-120,-150,-1.5,110,4.04,Citizens Bank Park,12,2
2017-09-28,2017,MIA,ATL,7,1,-131,-1.5,155,8.5,-121,101,116,1.5,-180,4.82,Marlins Park,8,6
2017-09-28,2017,HOU,BOS,12,2,-105,-1.5,146,9.0,100,-120,-105,1.5,-168,4.61,Fenway Park,14,10
2017-09-28,2017,STL,CHC,1,2,-140,-1.5,148,8.0,-115,-105,125,1.5,-170,4.67,Busch Stadium,3,-1
2017-09-28,2017,MIL,CIN,4,3,-165,-1.5,115,9.5,105,-125,150,1.5,-134,5.92,Miller Park,7,1
2017-09-28,2017,MIN,CLE,2,5,232,1.5,115,7.5,115,-135,-272,-1.5,-135,2.26,Progressive Field,7,-3
2017-09-28,2017,LAA,CWS,4,5,-115,-1.5,134,9.5,100,-120,105,1.5,-154,5.08,Guaranteed Rate Field,9,-1
2017-09-28,2017,KC,DET,1,4,-205,-1.5,-101,8.5,-110,-110,175,1.5,-119,5.71,Kauffman Stadium,5,-3
2017-09-28,2017,BOS,HOU,2,12,-105,1.5,-168,9.0,100,-120,-105,-1.5,146,4.61,Fenway Park,14,-10
2017-09-28,2017,DET,KC,4,1,175,1.5,-119,8.5,-110,-110,-205,-1.5,-101,3.09,Kauffman Stadium,5,3
2017-09-28,2017,CWS,LAA,5,4,105,1.5,-154,9.5,100,-120,-115,-1.5,134,4.63,Guaranteed Rate Field,9,1
2017-09-28,2017,ATL,MIA,1,7,116,1.5,-180,8.5,-121,101,-131,-1.5,155,3.94,Marlins Park,8,-6
2017-09-28,2017,CIN,MIL,3,4,150,1.5,-134,9.5,105,-125,-165,-1.5,115,3.8,Miller Park,7,-1
2017-09-28,2017,CLE,MIN,5,2,-272,-1.5,-135,7.5,115,-135,232,1.5,115,5.48,Progressive Field,7,3
2017-09-28,2017,TB,NYY,9,6,182,1.5,-110,8.5,-104,-116,-212,-1.5,-110,3.01,Yankee Stadium,15,3
2017-09-28,2017,TEX,OAK,1,4,114,1.5,-145,10.5,-101,-119,-124,-1.5,125,4.91,Rangers Ballpark,5,-3
2017-09-28,2017,WSH,PIT,5,4,-119,-1.5,170,9.0,100,-120,109,1.5,-200,4.89,Nationals Park,9,1
2017-09-28,2017,CHC,STL,2,1,125,1.5,-170,8.0,-115,-105,-140,-1.5,148,3.56,Busch Stadium,3,1
2017-09-28,2017,NYY,TB,6,9,-212,-1.5,-110,8.5,-104,-116,182,1.5,-110,5.78,Yankee Stadium,15,-3
2017-09-28,2017,OAK,TEX,4,1,-124,-1.5,125,10.5,-101,-119,114,1.5,-145,5.81,Rangers Ballpark,5,3
2017-09-28,2017,PIT,WSH,4,5,109,1.5,-200,9.0,100,-120,-119,-1.5,170,4.31,Nationals Park,9,-1
2017-09-29,2017,KC,ARI,2,1,140,1.5,-119,9.0,-110,-110,-155,-1.5,-101,3.75,Kauffman Stadium,3,1
2017-09-29,2017,MIA,ATL,6,5,-129,-1.5,155,9.0,-105,-115,119,1.5,-180,5.07,Marlins Park,11,1
2017-09-29,2017,TB,BAL,7,0,-116,-1.5,160,9.0,-105,-115,106,1.5,-185,4.83,Tropicana Field,7,7
2017-09-29,2017,HOU,BOS,3,2,-113,-1.5,142,9.5,-115,-105,103,1.5,-162,5.04,Fenway Park,5,1
2017-09-29,2017,CIN,CHC,4,5,156,1.5,-135,7.0,-125,105,-176,-1.5,115,2.73,Wrigley Field,9,-1
2017-09-29,2017,CHC,CIN,5,4,-176,-1.5,115,7.0,-125,105,156,1.5,-135,4.46,Wrigley Field,9,1
2017-09-29,2017,CWS,CLE,1,10,250,1.5,137,9.0,100,-120,-300,-1.5,-157,2.57,Progressive Field,11,-9
2017-09-29,2017,LAD,COL,1,9,-150,-1.5,-105,11.0,-119,-101,135,1.5,-115,6.6,Coors Field,10,-8
2017-09-29,2017,CLE,CWS,10,1,-300,-1.5,-157,9.0,100,-120,250,1.5,137,6.75,Progressive Field,11,9
2017-09-29,2017,MIN,DET,6,3,-178,-1.5,110,8.0,-120,100,158,1.5,-130,5.12,Target Field,9,3
2017-09-29,2017,BOS,HOU,2,3,103,1.5,-162,9.5,-115,-105,-113,-1.5,142,4.68,Fenway Park,5,-1
2017-09-29,2017,ARI,KC,1,2,-155,-1.5,-101,9.0,-110,-110,140,1.5,-119,5.47,Kauffman Stadium,3,-1
2017-09-29,2017,SEA,LAA,5,6,119,1.5,-180,9.0,-110,-110,-134,-1.5,155,4.11,Angel Stadium,11,-1
2017-09-29,2017,COL,LAD,9,1,135,1.5,-115,11.0,-119,-101,-150,-1.5,-105,4.68,Coors Field,10,8
2017-09-29,2017,ATL,MIA,5,6,119,1.5,-180,9.0,-105,-115,-129,-1.5,155,4.11,Marlins Park,11,-1
2017-09-29,2017,STL,MIL,3,5,101,1.5,-165,9.0,-101,-119,-111,-1.5,144,4.48,Busch Stadium,8,-2
2017-09-29,2017,DET,MIN,3,6,158,1.5,-130,8.0,-120,100,-178,-1.5,110,3.1,Target Field,9,-3
2017-09-29,2017,PHI,NYM,6,2,-145,-1.5,148,9.0,-127,107,130,1.5,-170,5.33,Citizens Bank Park,8,4
2017-09-29,2017,TOR,NYY,0,4,207,1.5,120,9.0,-110,-110,-247,-1.5,-140,2.93,Yankee Stadium,4,-4
2017-09-29,2017,TEX,OAK,5,3,-129,-1.5,152,10.5,-120,100,119,1.5,-176,5.91,Rangers Ballpark,8,2
2017-09-29,2017,NYM,PHI,2,6,130,1.5,-170,9.0,-127,107,-145,-1.5,148,3.91,Citizens Bank Park,8,-4
2017-09-29,2017,WSH,PIT,6,1,-210,-1.5,-104,7.5,-110,-110,180,1.5,-116,5.08,Nationals Park,7,5
2017-09-29,2017,SF,SD,8,0,-124,-1.5,163,8.5,-105,-115,114,1.5,-190,4.71,AT&T Park,8,8
2017-09-29,2017,LAA,SEA,6,5,-134,-1.5,155,9.0,-110,-110,119,1.5,-180,5.15,Angel Stadium,11,1
2017-09-29,2017,SD,SF,0,8,114,1.5,-190,8.5,-105,-115,-124,-1.5,163,3.97,AT&T Park,8,-8
2017-09-29,2017,MIL,STL,5,3,-111,-1.5,144,9.0,-101,-119,101,1.5,-165,4.73,Busch Stadium,8,2
2017-09-29,2017,BAL,TB,0,7,106,1.5,-185,9.0,-105,-115,-116,-1.5,160,4.37,Tropicana Field,7,-7
2017-09-29,2017,OAK,TEX,3,5,119,1.5,-176,10.5,-120,100,-129,-1.5,152,4.79,Rangers Ballpark,8,-2
2017-09-29,2017,NYY,TOR,4,0,-247,-1.5,-140,9.0,-110,-110,207,1.5,120,6.41,Yankee Stadium,4,4
2017-09-29,2017,PIT,WSH,1,6,180,1.5,-116,7.5,-110,-110,-210,-1.5,-104,2.68,Nationals Park,7,-5
2017-09-30,2017,KC,ARI,4,3,-118,-1.5,163,9.0,-114,-106,108,1.5,-190,4.87,Kauffman Stadium,7,1
2017-09-30,2017,MIA,ATL,10,2,-132,-1.5,172,9.5,105,-125,117,1.5,-205,5.41,Marlins Park,12,8
2017-09-30,2017,TB,BAL,4,3,-205,-1.5,-104,8.5,100,-120,175,1.5,-115,5.71,Tropicana Field,7,1
2017-09-30,2017,HOU,BOS,3,6,-114,-1.5,148,8.5,-120,100,104,1.5,-170,4.53,Fenway Park,9,-3
2017-09-30,2017,CIN,CHC,0,9,173,1.5,-117,8.5,100,-120,-203,-1.5,-102,3.11,Wrigley Field,9,-9
2017-09-30,2017,CHC,CIN,9,0,-203,-1.5,-102,8.5,100,-120,173,1.5,-117,5.69,Wrigley Field,9,9
2017-09-30,2017,CWS,CLE,2,1,330,1.5,151,7.0,-116,-104,-390,-1.5,-175,1.63,Progressive Field,3,1
2017-09-30,2017,LAD,COL,5,3,-220,-1.5,-135,9.0,-125,105,190,1.5,115,6.19,Coors Field,8,2
2017-09-30,2017,CLE,CWS,1,2,-390,-1.5,-175,7.0,-116,-104,330,1.5,151,5.57,Progressive Field,3,-1
2017-09-30,2017,MIN,DET,2,3,-208,-1.5,-115,9.5,-119,-101,178,1.5,-105,6.42,Target Field,5,-1
2017-09-30,2017,BOS,HOU,6,3,104,1.5,-170,8.5,-120,100,-114,-1.5,148,4.17,Fenway Park,9,3
2017-09-30,2017,ARI,KC,3,4,108,1.5,-190,9.0,-114,-106,-118,-1.5,163,4.33,Kauffman Stadium,7,-1
2017-09-30,2017,SEA,LAA,6,4,105,1.5,-200,9.0,100,-120,-115,-1.5,170,4.39,Angel Stadium,10,2
2017-09-30,2017,COL,LAD,3,5,190,1.5,115,9.0,-125,105,-220,-1.5,-135,3.1,Coors Field,8,-2
2017-09-30,2017,ATL,MIA,2,10,117,1.5,-205,9.5,105,-125,-132,-1.5,172,4.38,Marlins Park,12,-8
2017-09-30,2017,STL,MIL,7,6,-136,-1.5,151,8.5,-105,-115,121,1.5,-175,4.9,Busch Stadium,13,1
2017-09-30,2017,DET,MIN,3,2,178,1.5,-105,9.5,-119,-101,-208,-1.5,-115,3.42,Target Field,5,1
2017-09-30,2017,PHI,NYM,4,7,-124,-1.5,160,8.5,-119,-101,114,1.5,-185,4.71,Citizens Bank Park,11,-3
2017-09-30,2017,TOR,NYY,1,2,145,1.5,-150,8.5,-115,-105,-160,-1.5,130,3.47,Yankee Stadium,3,-1
2017-09-30,2017,TEX,OAK,8,4,-132,-1.5,148,11.0,-101,-119,117,1.5,-170,6.26,Rangers Ballpark,12,4
2017-09-30,2017,NYM,PHI,7,4,114,1.5,-185,8.5,-119,-101,-124,-1.5,160,3.97,Citizens Bank Park,11,3
2017-09-30,2017,WSH,PIT,1,4,-279,-1.5,-132,7.0,-121,101,239,1.5,112,5.15,Nationals Park,5,-3
2017-09-30,2017,SF,SD,2,3,100,1.5,-160,8.5,-103,-117,-110,-1.5,140,4.25,AT&T Park,5,-1
2017-09-30,2017,LAA,SEA,4,6,-115,-1.5,170,9.0,100,-120,105,1.5,-200,4.81,Angel Stadium,10,-2
2017-09-30,2017,SD,SF,3,2,-110,-1.5,140,8.5,-103,-117,100,1.5,-160,4.45,AT&T Park,5,1
2017-09-30,2017,MIL,STL,6,7,121,1.5,-175,8.5,-105,-115,-136,-1.5,151,3.85,Busch Stadium,13,-1
2017-09-30,2017,BAL,TB,3,4,175,1.5,-115,8.5,100,-120,-205,-1.5,-104,3.09,Tropicana Field,7,-1
2017-09-30,2017,OAK,TEX,4,8,117,1.5,-170,11.0,-101,-119,-132,-1.5,148,5.07,Rangers Ballpark,12,-4
2017-09-30,2017,NYY,TOR,2,1,-160,-1.5,130,8.5,-115,-105,145,1.5,-150,5.23,Yankee Stadium,3,1
2017-09-30,2017,PIT,WSH,4,1,239,1.5,112,7.0,-121,101,-279,-1.5,-132,2.06,Nationals Park,5,3
2017-10-01,2017,KC,ARI,2,14,119,1.5,-145,9.0,-114,-106,-129,-1.5,125,4.11,Kauffman Stadium,16,-12
2017-10-01,2017,MIA,ATL,5,8,-169,-1.5,120,9.0,-112,-108,154,1.5,-140,5.65,Marlins Park,13,-3
2017-10-01,2017,TB,BAL,6,0,-131,-1.5,163,8.0,-115,-105,116,1.5,-190,4.54,Tropicana Field,6,6
2017-10-01,2017,HOU,BOS,4,3,-135,-1.5,125,9.0,-111,-109,120,1.5,-145,5.17,Fenway Park,7,1
2017-10-01,2017,CIN,CHC,3,1,160,1.5,-130,9.0,-101,-119,-180,-1.5,110,3.46,Wrigley Field,4,2
2017-10-01,2017,CHC,CIN,1,3,-180,-1.5,110,9.0,-101,-119,160,1.5,-130,5.79,Wrigley Field,4,-2
2017-10-01,2017,CWS,CLE,1,3,220,1.5,110,9.0,100,-120,-260,-1.5,-130,2.81,Progressive Field,4,-2
2017-10-01,2017,LAD,COL,6,3,-152,-1.5,-105,11.0,-127,107,137,1.5,-115,6.63,Coors Field,9,3
2017-10-01,2017,CLE,CWS,3,1,-260,-1.5,-130,9.0,100,-120,220,1.5,110,6.5,Progressive Field,4,2
2017-10-01,2017,MIN,DET,5,1,-174,-1.5,114,9.0,-120,100,154,1.5,-134,5.72,Target Field,6,4
2017-10-01,2017,BOS,HOU,3,4,120,1.5,-145,9.0,-111,-109,-135,-1.5,125,4.09,Fenway Park,7,-1
2017-10-01,2017,ARI,KC,14,2,-129,-1.5,125,9.0,-114,-106,119,1.5,-145,5.07,Kauffman Stadium,16,12
2017-10-01,2017,SEA,LAA,2,6,-131,-1.5,130,8.5,100,-120,116,1.5,-150,4.82,Angel Stadium,8,-4
2017-10-01,2017,COL,LAD,3,6,137,1.5,-115,11.0,-127,107,-152,-1.5,-105,4.64,Coors Field,9,-3
2017-10-01,2017,ATL,MIA,8,5,154,1.5,-140,9.0,-112,-108,-169,-1.5,120,3.54,Marlins Park,13,3
2017-10-01,2017,STL,MIL,1,6,-119,-1.5,163,8.5,-105,-115,109,1.5,-190,4.62,Busch Stadium,7,-5
2017-10-01,2017,DET,MIN,1,5,154,1.5,-134,9.0,-120,100,-174,-1.5,114,3.54,Target Field,6,-4
2017-10-01,2017,PHI,NYM,11,0,-140,-1.5,148,8.5,-105,-115,125,1.5,-170,4.96,Citizens Bank Park,11,11
2017-10-01,2017,TOR,NYY,2,1,165,1.5,-120,8.5,-110,-110,-185,-1.5,100,3.21,Yankee Stadium,3,1
2017-10-01,2017,TEX,OAK,2,5,-145,-1.5,135,10.0,-105,-115,130,1.5,-155,5.92,Rangers Ballpark,7,-3
2017-10-01,2017,NYM,PHI,0,11,125,1.5,-170,8.5,-105,-115,-140,-1.5,148,3.78,Citizens Bank Park,11,-11
2017-10-01,2017,WSH,PIT,8,11,-195,-1.5,100,8.5,-115,-105,175,1.5,-120,5.62,Nationals Park,19,-3
2017-10-01,2017,SF,SD,5,4,-150,-1.5,140,8.0,-115,-105,135,1.5,-160,4.8,AT&T Park,9,1
2017-10-01,2017,LAA,SEA,6,2,116,1.5,-150,8.5,100,-120,-131,-1.5,130,3.94,Angel Stadium,8,4
2017-10-01,2017,SD,SF,4,5,135,1.5,-160,8.0,-115,-105,-150,-1.5,140,3.4,AT&T Park,9,-1
2017-10-01,2017,MIL,STL,6,1,109,1.5,-190,8.5,-105,-115,-119,-1.5,163,4.07,Busch Stadium,7,5
2017-10-01,2017,BAL,TB,0,6,116,1.5,-190,8.0,-115,-105,-131,-1.5,163,3.7,Tropicana Field,6,-6
2017-10-01,2017,OAK,TEX,5,2,130,1.5,-155,10.0,-105,-115,-145,-1.5,135,4.35,Rangers Ballpark,7,3
2017-10-01,2017,NYY,TOR,1,2,-185,-1.5,100,8.5,-110,-110,165,1.5,-120,5.52,Yankee Stadium,3,-1
2017-10-01,2017,PIT,WSH,11,8,175,1.5,-120,8.5,-115,-105,-195,-1.5,100,3.09,Nationals Park,19,3
2018-03-29,2018,COL,ARI,2,8,-101,1.5,-211,8.0,-118,-102,-109,-1.5,177,4.02,Chase Field,10,-6
2018-03-29,2018,PHI,ATL,5,8,-131,-1.5,125,8.0,-119,-101,116,1.5,-145,4.54,Suntrust Park,13,-3
2018-03-29,2018,MIN,BAL,2,3,117,1.5,-185,9.5,-105,-115,-127,-1.5,160,4.38,Camden Yards,5,-1
2018-03-29,2018,TB,BOS,6,4,153,1.5,-106,6.5,-119,-101,-173,-1.5,-114,2.57,Tropicana Field,10,2
2018-03-29,2018,MIA,CHC,4,8,170,1.5,105,8.0,-120,100,-200,-1.5,-125,2.96,Marlins Park,12,-4
2018-03-29,2018,SEA,CLE,2,1,160,1.5,-102,7.0,-105,-115,-180,-1.5,-118,2.69,T-Mobile Park,3,1
2018-03-29,2018,ARI,COL,8,2,-109,-1.5,177,8.0,-118,-102,-101,1.5,-211,4.17,Chase Field,10,6
2018-03-29,2018,KC,CWS,7,14,-140,-1.5,148,8.5,-106,-114,125,1.5,-170,4.96,Kauffman Stadium,21,-7
2018-03-29,2018,TEX,HOU,1,4,145,1.5,-110,9.0,-119,-101,-160,-1.5,-110,3.67,Rangers Ballpark,5,-3
2018-03-29,2018,CWS,KC,14,7,125,1.5,-170,8.5,-106,-114,-140,-1.5,148,3.78,Kauffman Stadium,21,7
2018-03-29,2018,OAK,LAA,6,5,108,1.5,-160,9.0,-109,-111,-118,-1.5,140,4.33,Oakland Coliseum,11,1
2018-03-29,2018,SF,LAD,1,0,256,1.5,125,7.5,-116,-104,-306,-1.5,-145,2.11,Dodger Stadium,1,1
2018-03-29,2018,CHC,MIA,8,4,-200,-1.5,-125,8.0,-120,100,170,1.5,105,5.33,Marlins Park,12,4
2018-03-29,2018,SD,MIL,1,2,116,1.5,-150,8.0,-115,-105,-131,-1.5,130,3.7,PETCO Park,3,-1
2018-03-29,2018,BAL,MIN,3,2,-127,-1.5,160,9.5,-105,-115,117,1.5,-185,5.31,Camden Yards,5,1
2018-03-29,2018,STL,NYM,4,9,123,1.5,-185,6.5,-125,105,-138,-1.5,160,2.91,Citi Field,13,-5
2018-03-29,2018,TOR,NYY,1,6,151,1.5,-111,8.5,-101,-119,-171,-1.5,-109,3.39,Rogers Centre,7,-5
2018-03-29,2018,LAA,OAK,5,6,-118,-1.5,140,9.0,-109,-111,108,1.5,-160,4.87,Oakland Coliseum,11,-1
2018-03-29,2018,ATL,PHI,8,5,116,1.5,-145,8.0,-119,-101,-131,-1.5,125,3.7,Suntrust Park,13,3
2018-03-29,2018,MIL,SD,2,1,-131,-1.5,130,8.0,-115,-105,116,1.5,-150,4.54,PETCO Park,3,1
2018-03-29,2018,CLE,SEA,1,2,-180,-1.5,-118,7.0,-105,-115,160,1.5,-102,4.5,T-Mobile Park,3,-1
2018-03-29,2018,LAD,SF,0,1,-306,-1.5,-145,7.5,-116,-104,256,1.5,125,5.65,Dodger Stadium,1,-1
2018-03-29,2018,NYM,STL,9,4,-138,-1.5,160,6.5,-125,105,123,1.5,-185,3.77,Citi Field,13,5
2018-03-29,2018,BOS,TB,4,6,-173,-1.5,-114,6.5,-119,-101,153,1.5,-106,4.12,Tropicana Field,10,-2
2018-03-29,2018,HOU,TEX,4,1,-160,-1.5,-110,9.0,-119,-101,145,1.5,-110,5.54,Rangers Ballpark,5,3
2018-03-29,2018,NYY,TOR,6,1,-171,-1.5,-109,8.5,-101,-119,151,1.5,-111,5.36,Rogers Centre,7,5
2018-03-30,2018,COL,ARI,8,9,128,1.5,-170,8.0,-103,-117,-143,-1.5,148,3.51,Chase Field,17,-1
2018-03-30,2018,PHI,ATL,5,4,-109,1.5,-225,9.0,-106,-114,-101,-1.5,188,4.69,Suntrust Park,9,1
2018-03-30,2018,TB,BOS,0,1,126,1.5,-137,7.0,-118,-102,-141,-1.5,116,3.1,Tropicana Field,1,-1
2018-03-30,2018,MIA,CHC,2,1,170,1.5,108,8.0,-119,-101,-200,-1.5,-128,2.96,Marlins Park,3,1
2018-03-30,2018,WSH,CIN,2,0,-215,-1.5,-130,9.0,108,-128,185,1.5,111,6.14,Great American Ballpark,2,2
2018-03-30,2018,ARI,COL,9,8,-143,-1.5,148,8.0,-103,-117,128,1.5,-170,4.71,Chase Field,17,1
2018-03-30,2018,PIT,DET,13,10,-129,-1.5,120,9.0,105,-125,119,1.5,-140,5.07,Comerica Park,23,3
2018-03-30,2018,TEX,HOU,5,1,150,1.5,-103,9.0,-102,-118,-170,-1.5,-117,3.6,Rangers Ballpark,6,4
2018-03-30,2018,OAK,LAA,1,2,104,-1.5,192,9.0,-112,-108,-114,1.5,-230,4.41,Oakland Coliseum,3,-1
2018-03-30,2018,SF,LAD,1,0,148,1.5,-157,7.5,100,-120,-163,-1.5,137,3.02,Dodger Stadium,1,1
2018-03-30,2018,CHC,MIA,1,2,-200,-1.5,-128,8.0,-119,-101,170,1.5,108,5.33,Marlins Park,3,-1
2018-03-30,2018,SD,MIL,6,8,103,1.5,-166,8.0,-101,-119,-113,-1.5,146,3.94,PETCO Park,14,-2
2018-03-30,2018,TOR,NYY,2,4,122,1.5,-123,8.5,-110,-110,-137,-1.5,104,3.83,Rogers Centre,6,-2
2018-03-30,2018,LAA,OAK,2,1,-114,1.5,-230,9.0,-112,-108,104,-1.5,192,4.79,Oakland Coliseum,3,1
2018-03-30,2018,ATL,PHI,4,5,-101,-1.5,188,9.0,-106,-114,-109,1.5,-225,4.52,Suntrust Park,9,-1
2018-03-30,2018,DET,PIT,10,13,119,1.5,-140,9.0,105,-125,-129,-1.5,120,4.11,Comerica Park,23,-3
2018-03-30,2018,MIL,SD,8,6,-113,-1.5,146,8.0,-101,-119,103,1.5,-166,4.24,PETCO Park,14,2
2018-03-30,2018,LAD,SF,0,1,-163,-1.5,137,7.5,100,-120,148,1.5,-157,4.65,Dodger Stadium,1,-1
2018-03-30,2018,BOS,TB,1,0,-141,-1.5,116,7.0,-118,-102,126,1.5,-137,4.1,Tropicana Field,1,1
2018-03-30,2018,HOU,TEX,1,5,-170,-1.5,-117,9.0,-102,-118,150,1.5,-103,5.67,Rangers Ballpark,6,-4
2018-03-30,2018,NYY,TOR,4,2,-137,-1.5,104,8.5,-110,-110,122,1.5,-123,4.91,Rogers Centre,6,2
2018-03-30,2018,CIN,WSH,0,2,185,1.5,111,9.0,108,-128,-215,-1.5,-130,3.16,Great American Ballpark,2,-2
2018-03-31,2018,COL,ARI,2,1,136,1.5,-161,8.5,-103,-117,-151,-1.5,141,3.6,Chase Field,3,1
2018-03-31,2018,PHI,ATL,2,15,105,1.5,-205,8.0,-119,-101,-115,-1.5,172,3.9,Suntrust Park,17,-13
2018-03-31,2018,MIN,BAL,6,2,-119,-1.5,135,9.0,102,-122,109,1.5,-155,4.89,Camden Yards,8,4
2018-03-31,2018,TB,BOS,2,3,101,1.5,-159,8.0,-101,-119,-111,-1.5,139,3.98,Tropicana Field,5,-1
2018-03-31,2018,MIA,CHC,6,10,180,1.5,111,8.0,-110,-110,-210,-1.5,-131,2.86,Marlins Park,16,-4
2018-03-31,2018,WSH,CIN,13,7,-145,-1.5,115,8.0,-101,-119,130,1.5,-135,4.73,Great American Ballpark,20,6
2018-03-31,2018,SEA,CLE,5,6,-103,1.5,-175,6.5,-121,101,-107,-1.5,151,3.3,T-Mobile Park,11,-1
2018-03-31,2018,ARI,COL,1,2,-151,-1.5,141,8.5,-103,-117,136,1.5,-161,5.11,Chase Field,3,-1
2018-03-31,2018,KC,CWS,3,4,-102,-1.5,184,8.5,-105,-115,-108,1.5,-220,4.29,Kauffman Stadium,7,-1
2018-03-31,2018,TEX,HOU,3,9,171,1.5,110,9.5,-114,-106,-201,-1.5,-130,3.51,Rangers Ballpark,12,-6
2018-03-31,2018,CWS,KC,4,3,-108,1.5,-220,8.5,-105,-115,-102,-1.5,184,4.41,Kauffman Stadium,7,1
2018-03-31,2018,OAK,LAA,3,8,-103,1.5,-170,9.0,101,-121,-107,-1.5,148,4.57,Oakland Coliseum,11,-5
2018-03-31,2018,SF,LAD,0,5,175,1.5,-110,8.0,-120,100,-205,-1.5,-110,2.91,Dodger Stadium,5,-5
2018-03-31,2018,CHC,MIA,10,6,-210,-1.5,-131,8.0,-110,-110,180,1.5,111,5.42,Marlins Park,16,4
2018-03-31,2018,SD,MIL,3,7,110,1.5,-155,7.5,-109,-111,-120,-1.5,135,3.57,PETCO Park,10,-4
2018-03-31,2018,BAL,MIN,2,6,109,1.5,-155,9.0,102,-122,-119,-1.5,135,4.31,Camden Yards,8,-4
2018-03-31,2018,STL,NYM,2,6,107,1.5,-222,7.0,100,-120,-117,-1.5,185,3.38,Citi Field,8,-4
2018-03-31,2018,TOR,NYY,5,3,-106,1.5,-170,9.5,100,-120,-104,-1.5,148,4.89,Rogers Centre,8,2
2018-03-31,2018,LAA,OAK,8,3,-107,-1.5,148,9.0,101,-121,-103,1.5,-170,4.65,Oakland Coliseum,11,5
2018-03-31,2018,ATL,PHI,15,2,-115,-1.5,172,8.0,-119,-101,105,1.5,-205,4.28,Suntrust Park,17,13
2018-03-31,2018,MIL,SD,7,3,-120,-1.5,135,7.5,-109,-111,110,1.5,-155,4.09,PETCO Park,10,4
2018-03-31,2018,CLE,SEA,6,5,-107,-1.5,151,6.5,-121,101,-103,1.5,-175,3.36,T-Mobile Park,11,1
2018-03-31,2018,LAD,SF,5,0,-205,-1.5,-110,8.0,-120,100,175,1.5,-110,5.38,Dodger Stadium,5,5
2018-03-31,2018,NYM,STL,6,2,-117,-1.5,185,7.0,100,-120,107,1.5,-222,3.77,Citi Field,8,4
2018-03-31,2018,BOS,TB,3,2,-111,-1.5,139,8.0,-101,-119,101,1.5,-159,4.21,Tropicana Field,5,1
2018-03-31,2018,HOU,TEX,9,3,-201,-1.5,-130,9.5,-114,-106,171,1.5,110,6.34,Rangers Ballpark,12,6
2018-03-31,2018,NYY,TOR,3,5,-104,-1.5,148,9.5,100,-120,-106,1.5,-170,4.84,Rogers Centre,8,-2
2018-03-31,2018,CIN,WSH,7,13,130,1.5,-135,8.0,-101,-119,-145,-1.5,115,3.48,Great American Ballpark,20,-6
2018-04-01,2018,MIN,BAL,7,0,103,1.5,-205,9.0,102,-122,-113,-1.5,172,4.43,Camden Yards,7,7
2018-04-01,2018,TB,BOS,1,2,-114,1.5,-184,8.5,-101,-119,104,-1.5,159,4.53,Tropicana Field,3,-1
2018-04-01,2018,MIA,CHC,6,0,178,1.5,109,8.0,-101,-119,-208,-1.5,-128,2.88,Marlins Park,6,6
2018-04-01,2018,WSH,CIN,6,5,-131,-1.5,120,8.5,-107,-113,116,1.5,-141,4.82,Great American Ballpark,11,1
2018-04-01,2018,SEA,CLE,5,4,130,1.5,-135,7.5,-125,105,-145,-1.5,115,3.26,T-Mobile Park,9,1
2018-04-01,2018,PIT,DET,1,0,101,1.5,-210,8.5,-105,-115,-111,-1.5,176,4.23,Comerica Park,1,1
2018-04-01,2018,PIT,DET,8,6,-121,-1.5,129,8.5,-115,-105,111,1.5,-149,4.65,Comerica Park,14,2
2018-04-01,2018,TEX,HOU,2,8,140,1.5,-115,9.5,102,-122,-155,-1.5,-105,3.96,Rangers Ballpark,10,-6
2018-04-01,2018,OAK,LAA,4,7,116,1.5,-148,9.0,-111,-109,-126,-1.5,128,4.17,Oakland Coliseum,11,-3
2018-04-01,2018,SF,LAD,0,9,175,1.5,-129,7.5,-115,-105,-195,-1.5,109,2.73,Dodger Stadium,9,-9
2018-04-01,2018,CHC,MIA,0,6,-208,-1.5,-128,8.0,-101,-119,178,1.5,109,5.4,Marlins Park,6,-6
2018-04-01,2018,BAL,MIN,0,7,-113,-1.5,172,9.0,102,-122,103,1.5,-205,4.77,Camden Yards,7,-7
2018-04-01,2018,STL,NYM,5,1,-152,-1.5,-101,8.0,-111,-109,137,1.5,-119,4.83,Citi Field,6,4
2018-04-01,2018,TOR,NYY,7,4,-114,-1.5,171,8.5,-110,-110,104,1.5,-204,4.53,Rogers Centre,11,3
2018-04-01,2018,LAA,OAK,7,4,-126,-1.5,128,9.0,-111,-109,116,1.5,-148,5.02,Oakland Coliseum,11,3
2018-04-01,2018,DET,PIT,0,1,-111,-1.5,176,8.5,-105,-115,101,1.5,-210,4.47,Comerica Park,1,-1
2018-04-01,2018,DET,PIT,6,8,111,1.5,-149,8.5,-115,-105,-121,-1.5,129,4.03,Comerica Park,14,-2
2018-04-01,2018,CLE,SEA,4,5,-145,-1.5,115,7.5,-125,105,130,1.5,-135,4.44,T-Mobile Park,9,-1
2018-04-01,2018,LAD,SF,9,0,-195,-1.5,109,7.5,-115,-105,175,1.5,-129,4.96,Dodger Stadium,9,9
2018-04-01,2018,NYM,STL,1,5,137,1.5,-119,8.0,-111,-109,-152,-1.5,-101,3.38,Citi Field,6,-4
2018-04-01,2018,BOS,TB,2,1,104,-1.5,159,8.5,-101,-119,-114,1.5,-184,4.17,Tropicana Field,3,1
2018-04-01,2018,HOU,TEX,8,2,-155,-1.5,-105,9.5,102,-122,140,1.5,-115,5.77,Rangers Ballpark,10,6
2018-04-01,2018,NYY,TOR,4,7,104,1.5,-204,8.5,-110,-110,-114,-1.5,171,4.17,Rogers Centre,11,-3
2018-04-01,2018,CIN,WSH,5,6,116,1.5,-141,8.5,-107,-113,-131,-1.5,120,3.94,Great American Ballpark,11,-1
2018-04-02,2018,LAD,ARI,7,8,-109,-1.5,146,9.0,100,-120,-101,1.5,-167,4.69,Chase Field,15,-1
2018-04-02,2018,WSH,ATL,8,1,-121,-1.5,135,9.0,-117,-103,111,1.5,-155,4.93,Suntrust Park,9,7
2018-04-02,2018,HOU,BAL,6,1,-228,-1.5,-109,9.5,-115,-105,198,1.5,-110,6.6,Minute Maid Park,7,5
2018-04-02,2018,MIA,BOS,3,7,118,1.5,-146,8.5,-119,-101,-133,-1.5,126,3.9,Marlins Park,10,-4
2018-04-02,2018,CIN,CHC,1,0,125,1.5,-135,8.5,-110,-110,-140,-1.5,115,3.78,Great American Ballpark,1,1
2018-04-02,2018,CHC,CIN,0,1,-140,-1.5,115,8.5,-110,-110,125,1.5,-135,4.96,Great American Ballpark,1,-1
2018-04-02,2018,LAA,CLE,0,6,101,1.5,-165,8.0,-119,-101,-111,-1.5,144,3.98,Angel Stadium,6,-6
2018-04-02,2018,SD,COL,4,7,-111,-1.5,184,8.0,-105,-115,101,1.5,-220,4.21,PETCO Park,11,-3
2018-04-02,2018,TOR,CWS,4,2,-175,-1.5,110,9.0,-117,-103,155,1.5,-130,5.73,Rogers Centre,6,2
2018-04-02,2018,KC,DET,1,6,101,1.5,-210,8.5,-115,-105,-111,-1.5,176,4.23,Comerica Park,7,-5
2018-04-02,2018,BAL,HOU,1,6,198,1.5,-110,9.5,-115,-105,-228,-1.5,-109,3.19,Minute Maid Park,7,-5
2018-04-02,2018,DET,KC,6,1,-111,-1.5,176,8.5,-115,-105,101,1.5,-210,4.47,Comerica Park,7,5
2018-04-02,2018,CLE,LAA,6,0,-111,-1.5,144,8.0,-119,-101,101,1.5,-165,4.21,Angel Stadium,6,6
2018-04-02,2018,ARI,LAD,8,7,-101,1.5,-167,9.0,100,-120,-109,-1.5,146,4.52,Chase Field,15,1
2018-04-02,2018,BOS,MIA,7,3,-133,-1.5,126,8.5,-119,-101,118,1.5,-146,4.85,Marlins Park,10,4
2018-04-02,2018,STL,MIL,8,4,101,1.5,-205,9.5,-101,-119,-111,-1.5,172,4.73,Miller Park,12,4
2018-04-02,2018,PIT,MIN,5,4,-146,-1.5,151,7.5,-110,-110,131,1.5,-175,4.45,PNC Park,9,1
2018-04-02,2018,TEX,OAK,1,3,152,1.5,-138,9.0,-125,105,-167,-1.5,118,3.57,Oakland Coliseum,4,-2
2018-04-02,2018,MIN,PIT,4,5,131,1.5,-175,7.5,-110,-110,-146,-1.5,151,3.25,PNC Park,9,-1
2018-04-02,2018,COL,SD,7,4,101,1.5,-220,8.0,-105,-115,-111,-1.5,184,3.98,PETCO Park,11,3
2018-04-02,2018,MIL,STL,4,8,-111,-1.5,172,9.5,-101,-119,101,1.5,-205,5.0,Miller Park,12,-4
2018-04-02,2018,OAK,TEX,3,1,-167,-1.5,118,9.0,-125,105,152,1.5,-138,5.63,Oakland Coliseum,4,2
2018-04-02,2018,CWS,TOR,2,4,155,1.5,-130,9.0,-117,-103,-175,-1.5,110,3.53,Rogers Centre,6,-2
2018-04-02,2018,ATL,WSH,1,8,111,1.5,-155,9.0,-117,-103,-121,-1.5,135,4.27,Suntrust Park,9,-7
2018-04-03,2018,LAD,ARI,1,6,-173,-1.5,100,7.5,100,-120,153,1.5,-120,4.75,Chase Field,7,-5
2018-04-03,2018,WSH,ATL,6,13,-129,-1.5,120,9.5,-120,100,119,1.5,-140,5.35,Suntrust Park,19,-7
2018-04-03,2018,HOU,BAL,10,6,-250,-1.5,-130,9.0,100,-120,210,1.5,110,6.43,Minute Maid Park,16,4
2018-04-03,2018,MIA,BOS,2,4,230,1.5,130,7.5,113,-133,-270,-1.5,-150,2.27,Marlins Park,6,-2
2018-04-03,2018,LAA,CLE,13,2,-133,-1.5,148,8.0,-110,-110,118,1.5,-170,4.57,Angel Stadium,15,11
2018-04-03,2018,SD,COL,8,4,102,1.5,-180,8.0,-110,-110,-112,-1.5,155,3.96,PETCO Park,12,4
2018-04-03,2018,TOR,CWS,14,5,-185,-1.5,110,9.0,-115,-105,165,1.5,-130,5.84,Rogers Centre,19,9
2018-04-03,2018,KC,DET,1,0,102,1.5,-195,8.5,-105,-115,-112,-1.5,167,4.21,Comerica Park,1,1
2018-04-03,2018,BAL,HOU,6,10,210,1.5,110,9.0,100,-120,-250,-1.5,-130,2.9,Minute Maid Park,16,-4
2018-04-03,2018,DET,KC,0,1,-112,-1.5,167,8.5,-105,-115,102,1.5,-195,4.49,Comerica Park,1,-1
2018-04-03,2018,CLE,LAA,2,13,118,1.5,-170,8.0,-110,-110,-133,-1.5,148,3.67,Angel Stadium,15,-11
2018-04-03,2018,ARI,LAD,6,1,153,1.5,-120,7.5,100,-120,-173,-1.5,100,2.96,Chase Field,7,5
2018-04-03,2018,BOS,MIA,4,2,-270,-1.5,-150,7.5,113,-133,230,1.5,130,5.47,Marlins Park,6,2
2018-04-03,2018,STL,MIL,4,5,-102,1.5,-210,9.5,104,-124,-108,-1.5,176,4.8,Miller Park,9,-1
2018-04-03,2018,PHI,NYM,0,2,116,1.5,-191,7.5,-110,-110,-126,-1.5,163,3.47,Citi Field,2,-2
2018-04-03,2018,TB,NYY,4,11,165,1.5,-145,7.0,-120,100,-185,-1.5,125,2.64,Yankee Stadium,15,-7
2018-04-03,2018,TEX,OAK,4,1,117,1.5,-180,9.0,-110,-110,-132,-1.5,155,4.15,Oakland Coliseum,5,3
2018-04-03,2018,NYM,PHI,2,0,-126,-1.5,163,7.5,-110,-110,116,1.5,-191,4.18,Citi Field,2,2
2018-04-03,2018,COL,SD,4,8,-112,-1.5,155,8.0,-110,-110,102,1.5,-180,4.23,PETCO Park,12,-4
2018-04-03,2018,SF,SEA,4,6,-115,-1.5,176,8.0,-125,105,105,1.5,-210,4.28,AT&T Park,10,-2
2018-04-03,2018,SEA,SF,6,4,105,1.5,-210,8.0,-125,105,-115,-1.5,176,3.9,AT&T Park,10,2
2018-04-03,2018,MIL,STL,5,4,-108,-1.5,176,9.5,104,-124,-102,1.5,-210,4.93,Miller Park,9,1
2018-04-03,2018,NYY,TB,11,4,-185,-1.5,125,7.0,-120,100,165,1.5,-145,4.54,Yankee Stadium,15,7
2018-04-03,2018,OAK,TEX,1,4,-132,-1.5,155,9.0,-110,-110,117,1.5,-180,5.12,Oakland Coliseum,5,-3
2018-04-03,2018,CWS,TOR,5,14,165,1.5,-130,9.0,-115,-105,-185,-1.5,110,3.4,Rogers Centre,19,-9
2018-04-03,2018,ATL,WSH,13,6,119,1.5,-140,9.5,-120,100,-129,-1.5,120,4.34,Suntrust Park,19,7
2018-04-04,2018,LAD,ARI,0,3,-131,-1.5,120,8.0,-101,-119,116,1.5,-140,4.54,Chase Field,3,-3
2018-04-04,2018,WSH,ATL,1,7,-209,-1.5,-134,8.0,-110,-110,179,1.5,114,5.41,Suntrust Park,8,-6
2018-04-04,2018,HOU,BAL,3,2,-166,-1.5,120,8.0,-102,-118,151,1.5,-140,4.99,Minute Maid Park,5,1
2018-04-04,2018,LAA,CLE,3,2,135,1.5,-125,7.0,-119,-101,-150,-1.5,105,2.98,Angel Stadium,5,1
2018-04-04,2018,SD,COL,2,5,116,1.5,-155,7.0,-110,-110,-131,-1.5,135,3.24,PETCO Park,7,-3
2018-04-04,2018,TOR,CWS,3,4,-223,-1.5,-116,9.5,-115,-105,193,1.5,-104,6.56,Rogers Centre,7,-1
2018-04-04,2018,BAL,HOU,2,3,151,1.5,-140,8.0,-102,-118,-166,-1.5,120,3.19,Minute Maid Park,5,-1
2018-04-04,2018,CLE,LAA,2,3,-150,-1.5,105,7.0,-119,-101,135,1.5,-125,4.2,Angel Stadium,5,-1
2018-04-04,2018,ARI,LAD,3,0,116,1.5,-140,8.0,-101,-119,-131,-1.5,120,3.7,Chase Field,3,3
2018-04-04,2018,STL,MIL,6,0,-105,-1.5,144,9.5,100,-120,-105,1.5,-165,4.87,Miller Park,6,6
2018-04-04,2018,PIT,MIN,3,7,-121,-1.5,176,8.0,101,-121,111,1.5,-210,4.38,PNC Park,10,-4
2018-04-04,2018,PHI,NYM,2,4,131,1.5,-165,7.0,104,-124,-146,-1.5,144,3.03,Citi Field,6,-2
2018-04-04,2018,TB,NYY,2,7,227,1.5,115,8.5,-104,-116,-267,-1.5,-135,2.6,Yankee Stadium,9,-5
2018-04-04,2018,TEX,OAK,2,6,145,1.5,-150,8.5,-117,-103,-160,-1.5,130,3.47,Oakland Coliseum,8,-4
2018-04-04,2018,NYM,PHI,4,2,-146,-1.5,144,7.0,104,-124,131,1.5,-165,4.15,Citi Field,6,2
2018-04-04,2018,MIN,PIT,7,3,111,1.5,-210,8.0,101,-121,-121,-1.5,176,3.79,PNC Park,10,4
2018-04-04,2018,COL,SD,5,2,-131,-1.5,135,7.0,-110,-110,116,1.5,-155,3.97,PETCO Park,7,3
2018-04-04,2018,SF,SEA,10,1,-140,-1.5,155,7.5,-104,-116,125,1.5,-180,4.38,AT&T Park,11,9
2018-04-04,2018,SEA,SF,1,10,125,1.5,-180,7.5,-104,-116,-140,-1.5,155,3.33,AT&T Park,11,-9
2018-04-04,2018,MIL,STL,0,6,-105,1.5,-165,9.5,100,-120,-105,-1.5,144,4.87,Miller Park,6,-6
2018-04-04,2018,NYY,TB,7,2,-267,-1.5,-135,8.5,-104,-116,227,1.5,115,6.18,Yankee Stadium,9,5
2018-04-04,2018,OAK,TEX,6,2,-160,-1.5,130,8.5,-117,-103,145,1.5,-150,5.23,Oakland Coliseum,8,4
2018-04-04,2018,CWS,TOR,4,3,193,1.5,-104,9.5,-115,-105,-223,-1.5,-116,3.24,Rogers Centre,7,1
2018-04-04,2018,ATL,WSH,7,1,179,1.5,114,8.0,-110,-110,-209,-1.5,-134,2.87,Suntrust Park,8,6
2018-04-05,2018,STL,ARI,1,3,-111,-1.5,176,8.0,-119,-101,101,1.5,-210,4.21,Busch Stadium,4,-2
2018-04-05,2018,NYY,BAL,2,5,-265,-1.5,-150,8.5,-119,-101,225,1.5,130,6.17,Yankee Stadium,7,-3
2018-04-05,2018,TB,BOS,2,3,200,1.5,-101,9.0,105,-125,-230,-1.5,-119,3.0,Fenway Park,5,-1
2018-04-05,2018,MIL,CHC,0,8,-101,1.5,-170,9.0,-101,-119,-109,-1.5,148,4.52,Miller Park,8,-8
2018-04-05,2018,PIT,CIN,5,2,-162,-1.5,129,8.0,-119,-101,147,1.5,-149,4.95,PNC Park,7,3
2018-04-05,2018,SD,COL,1,3,-109,1.5,-176,7.5,-110,-110,-101,-1.5,152,3.91,PETCO Park,4,-2
2018-04-05,2018,DET,CWS,9,7,109,1.5,-180,8.5,-115,-105,-119,-1.5,155,4.07,Guaranteed Rate Field,16,2
2018-04-05,2018,CWS,DET,7,9,-119,-1.5,155,8.5,-115,-105,109,1.5,-180,4.62,Guaranteed Rate Field,16,-2
2018-04-05,2018,PHI,MIA,5,0,-145,-1.5,140,8.0,-117,-103,130,1.5,-160,4.73,Citizens Bank Park,5,5
2018-04-05,2018,CHC,MIL,8,0,-109,-1.5,148,9.0,-101,-119,-101,1.5,-170,4.69,Miller Park,8,8
2018-04-05,2018,SEA,MIN,2,4,-105,-1.5,151,7.5,-110,-110,-105,1.5,-175,3.84,Target Field,6,-2
2018-04-05,2018,WSH,NYM,2,8,-155,-1.5,144,7.0,105,-125,140,1.5,-165,4.25,Nationals Park,10,-6
2018-04-05,2018,BAL,NYY,5,2,225,1.5,130,8.5,-119,-101,-265,-1.5,-150,2.62,Yankee Stadium,7,3
2018-04-05,2018,TEX,OAK,6,3,140,1.5,-146,9.0,-116,-104,-155,-1.5,126,3.75,Oakland Coliseum,9,3
2018-04-05,2018,MIA,PHI,0,5,130,1.5,-160,8.0,-117,-103,-145,-1.5,140,3.48,Citizens Bank Park,5,-5
2018-04-05,2018,CIN,PIT,2,5,147,1.5,-149,8.0,-119,-101,-162,-1.5,129,3.24,PNC Park,7,-3
2018-04-05,2018,COL,SD,3,1,-101,-1.5,152,7.5,-110,-110,-109,1.5,-176,3.77,PETCO Park,4,2
2018-04-05,2018,MIN,SEA,4,2,-105,1.5,-175,7.5,-110,-110,-105,-1.5,151,3.84,Target Field,6,2
2018-04-05,2018,ARI,STL,3,1,101,1.5,-210,8.0,-119,-101,-111,-1.5,176,3.98,Busch Stadium,4,2
2018-04-05,2018,BOS,TB,3,2,-230,-1.5,-119,9.0,105,-125,200,1.5,-101,6.27,Fenway Park,5,1
2018-04-05,2018,OAK,TEX,3,6,-155,-1.5,126,9.0,-116,-104,140,1.5,-146,5.47,Oakland Coliseum,9,-3
2018-04-05,2018,NYM,WSH,8,2,140,1.5,-165,7.0,105,-125,-155,-1.5,144,2.92,Nationals Park,10,6
2018-04-06,2018,COL,ATL,3,8,-152,-1.5,135,9.0,-118,-102,137,1.5,-155,5.43,Coors Field,11,-5
2018-04-06,2018,NYY,BAL,3,7,-181,-1.5,-102,9.5,-101,-119,161,1.5,-118,6.12,Yankee Stadium,10,-4
2018-04-06,2018,MIL,CHC,5,4,116,1.5,-142,8.5,-110,-110,-131,-1.5,122,3.94,Miller Park,9,1
2018-04-06,2018,PIT,CIN,14,3,111,1.5,-156,8.0,-115,-105,-121,-1.5,136,3.79,PNC Park,17,11
2018-04-06,2018,KC,CLE,2,3,203,1.5,-105,7.0,-120,100,-233,-1.5,-115,2.31,Progressive Field,5,-1
2018-04-06,2018,ATL,COL,8,3,137,1.5,-155,9.0,-118,-102,-152,-1.5,135,3.8,Coors Field,11,5
2018-04-06,2018,SD,HOU,4,1,248,1.5,126,8.5,-114,-106,-288,-1.5,-146,2.44,Minute Maid Park,5,3
2018-04-06,2018,CLE,KC,3,2,-233,-1.5,-115,7.0,-120,100,203,1.5,-105,4.9,Progressive Field,5,1
2018-04-06,2018,OAK,LAA,9,13,116,1.5,-175,9.0,-104,-116,-131,-1.5,151,4.17,Angel Stadium,22,-4
2018-04-06,2018,CHC,MIL,4,5,-131,-1.5,122,8.5,-110,-110,116,1.5,-142,4.82,Miller Park,9,-1
2018-04-06,2018,BAL,NYY,7,3,161,1.5,-118,9.5,-101,-119,-181,-1.5,-102,3.64,Yankee Stadium,10,4
2018-04-06,2018,LAA,OAK,13,9,-131,-1.5,151,9.0,-104,-116,116,1.5,-175,5.1,Angel Stadium,22,4
2018-04-06,2018,CIN,PIT,3,14,-121,-1.5,136,8.0,-115,-105,111,1.5,-156,4.38,PNC Park,17,-11
2018-04-06,2018,HOU,SD,1,4,-288,-1.5,-146,8.5,-114,-106,248,1.5,126,6.31,Minute Maid Park,5,-3
2018-04-06,2018,TOR,TEX,8,5,-116,-1.5,134,10.0,-110,-110,106,1.5,-154,5.37,Rangers Ballpark,13,3
2018-04-06,2018,TEX,TOR,5,8,106,1.5,-154,10.0,-110,-110,-116,-1.5,134,4.85,Rangers Ballpark,13,-3
2018-04-07,2018,STL,ARI,5,3,-109,1.5,-187,7.5,106,-126,-101,-1.5,161,3.91,Busch Stadium,8,2
2018-04-07,2018,COL,ATL,3,2,-146,-1.5,130,11.0,-110,-110,131,1.5,-150,6.53,Coors Field,5,1
2018-04-07,2018,NYY,BAL,8,3,-235,-1.5,-129,9.5,-107,-113,205,1.5,109,6.66,Yankee Stadium,11,5
2018-04-07,2018,TB,BOS,3,10,150,1.5,-135,9.0,104,-124,-170,-1.5,115,3.6,Fenway Park,13,-7
2018-04-07,2018,MIL,CHC,2,5,118,1.5,-140,9.0,101,-121,-133,-1.5,120,4.13,Miller Park,7,-3
2018-04-07,2018,PIT,CIN,4,7,-131,-1.5,160,8.0,103,-123,116,1.5,-185,4.54,PNC Park,11,-3
2018-04-07,2018,KC,CLE,1,0,205,1.5,-109,7.5,-110,-110,-245,-1.5,-111,2.46,Progressive Field,1,1
2018-04-07,2018,ATL,COL,2,3,131,1.5,-150,11.0,-110,-110,-146,-1.5,130,4.76,Coors Field,5,-1
2018-04-07,2018,DET,CWS,6,1,109,1.5,-200,8.0,-116,-104,-119,-1.5,170,3.83,Guaranteed Rate Field,7,5
2018-04-07,2018,CWS,DET,1,6,-119,-1.5,170,8.0,-116,-104,109,1.5,-200,4.35,Guaranteed Rate Field,7,-5
2018-04-07,2018,SD,HOU,0,1,275,1.5,144,9.0,-101,-119,-325,-1.5,-165,2.4,Minute Maid Park,1,-1
2018-04-07,2018,CLE,KC,0,1,-245,-1.5,-111,7.5,-110,-110,205,1.5,-109,5.33,Progressive Field,1,-1
2018-04-07,2018,OAK,LAA,7,3,104,1.5,-205,9.0,100,-120,-114,-1.5,172,4.41,Angel Stadium,10,4
2018-04-07,2018,SF,LAD,7,5,116,1.5,-149,8.0,-115,-105,-126,-1.5,129,3.7,AT&T Park,12,2
2018-04-07,2018,PHI,MIA,20,1,-175,-1.5,125,8.5,-105,-115,155,1.5,-145,5.41,Citizens Bank Park,21,19
2018-04-07,2018,CHC,MIL,5,2,-133,-1.5,120,9.0,101,-121,118,1.5,-140,5.14,Miller Park,7,3
2018-04-07,2018,SEA,MIN,11,4,149,1.5,-145,8.0,-107,-113,-164,-1.5,125,3.21,Target Field,15,7
2018-04-07,2018,WSH,NYM,2,3,-155,-1.5,135,8.0,-110,-110,140,1.5,-155,4.86,Nationals Park,5,-1
2018-04-07,2018,BAL,NYY,3,8,205,1.5,109,9.5,-107,-113,-235,-1.5,-129,3.11,Yankee Stadium,11,-5
2018-04-07,2018,LAA,OAK,3,7,-114,-1.5,172,9.0,100,-120,104,1.5,-205,4.79,Angel Stadium,10,-4
2018-04-07,2018,MIA,PHI,1,20,155,1.5,-145,8.5,-105,-115,-175,-1.5,125,3.33,Citizens Bank Park,21,-19
2018-04-07,2018,CIN,PIT,7,4,116,1.5,-185,8.0,103,-123,-131,-1.5,160,3.7,PNC Park,11,3
2018-04-07,2018,HOU,SD,1,0,-325,-1.5,-165,9.0,-101,-119,275,1.5,144,6.88,Minute Maid Park,1,1
2018-04-07,2018,MIN,SEA,4,11,-164,-1.5,125,8.0,-107,-113,149,1.5,-145,4.97,Target Field,15,-7
2018-04-07,2018,LAD,SF,5,7,-126,-1.5,129,8.0,-115,-105,116,1.5,-149,4.46,AT&T Park,12,-2
2018-04-07,2018,ARI,STL,3,5,-101,-1.5,161,7.5,106,-126,-109,1.5,-187,3.77,Busch Stadium,8,-2
2018-04-07,2018,BOS,TB,10,3,-170,-1.5,115,9.0,104,-124,150,1.5,-135,5.67,Fenway Park,13,7
2018-04-07,2018,TOR,TEX,1,5,-126,-1.5,125,8.5,-101,-119,116,1.5,-145,4.74,Rangers Ballpark,6,-4
2018-04-07,2018,TEX,TOR,5,1,116,1.5,-145,8.5,-101,-119,-126,-1.5,125,3.94,Rangers Ballpark,6,4
2018-04-07,2018,NYM,WSH,3,2,140,1.5,-155,8.0,-110,-110,-155,-1.5,135,3.33,Nationals Park,5,1
2018-04-08,2018,STL,ARI,1,4,-165,-1.5,135,7.5,-108,-112,150,1.5,-155,4.67,Busch Stadium,5,-3
2018-04-08,2018,COL,ATL,0,4,-155,-1.5,120,11.0,-105,-115,140,1.5,-140,6.69,Coors Field,4,-4
2018-04-08,2018,NYY,BAL,7,8,-185,-1.5,101,8.5,-114,-106,165,1.5,-121,5.52,Yankee Stadium,15,-1
2018-04-08,2018,TB,BOS,7,8,170,1.5,-119,8.0,-113,-107,-200,-1.5,-101,2.96,Fenway Park,15,-1
2018-04-08,2018,MIL,CHC,0,3,104,1.5,-160,8.5,-111,-109,-114,-1.5,140,4.17,Miller Park,3,-3
2018-04-08,2018,PIT,CIN,5,0,-155,-1.5,144,7.5,-112,-108,140,1.5,-165,4.56,PNC Park,5,5
2018-04-08,2018,KC,CLE,1,3,184,1.5,-110,7.5,-114,-106,-214,-1.5,-110,2.64,Progressive Field,4,-2
2018-04-08,2018,ATL,COL,4,0,140,1.5,-140,11.0,-105,-115,-155,-1.5,120,4.58,Coors Field,4,4
2018-04-08,2018,DET,CWS,1,0,155,1.5,-130,8.0,-110,-110,-175,-1.5,110,3.14,Guaranteed Rate Field,1,1
2018-04-08,2018,CWS,DET,0,1,-175,-1.5,110,8.0,-110,-110,155,1.5,-130,5.09,Guaranteed Rate Field,1,-1
2018-04-08,2018,SD,HOU,1,4,237,1.5,121,8.5,-102,-118,-277,-1.5,-140,2.52,Minute Maid Park,5,-3
2018-04-08,2018,CLE,KC,3,1,-214,-1.5,-110,7.5,-114,-106,184,1.5,-110,5.11,Progressive Field,4,2
2018-04-08,2018,OAK,LAA,1,6,170,1.5,-119,9.0,-110,-110,-190,-1.5,-101,3.33,Angel Stadium,7,-5
2018-04-08,2018,SF,LAD,1,2,205,1.5,125,8.0,-106,-114,-245,-1.5,-145,2.62,AT&T Park,3,-1
2018-04-08,2018,PHI,MIA,3,6,-200,-1.5,102,8.0,-106,-114,170,1.5,-122,5.33,Citizens Bank Park,9,-3
2018-04-08,2018,CHC,MIL,3,0,-114,-1.5,140,8.5,-111,-109,104,1.5,-160,4.53,Miller Park,3,3
2018-04-08,2018,WSH,NYM,5,6,-187,-1.5,110,8.0,-110,-110,167,1.5,-130,5.21,Nationals Park,11,-1
2018-04-08,2018,BAL,NYY,8,7,165,1.5,-121,8.5,-114,-106,-185,-1.5,101,3.21,Yankee Stadium,15,1
2018-04-08,2018,LAA,OAK,6,1,-190,-1.5,-101,9.0,-110,-110,170,1.5,-119,5.9,Angel Stadium,7,5
2018-04-08,2018,MIA,PHI,6,3,170,1.5,-122,8.0,-106,-114,-200,-1.5,102,2.96,Citizens Bank Park,9,3
2018-04-08,2018,CIN,PIT,0,5,140,1.5,-165,7.5,-112,-108,-155,-1.5,144,3.13,PNC Park,5,-5
2018-04-08,2018,HOU,SD,4,1,-277,-1.5,-140,8.5,-102,-118,237,1.5,121,6.25,Minute Maid Park,5,3
2018-04-08,2018,LAD,SF,2,1,-245,-1.5,-145,8.0,-106,-114,205,1.5,125,5.68,AT&T Park,3,1
2018-04-08,2018,ARI,STL,4,1,150,1.5,-155,7.5,-108,-112,-165,-1.5,135,3.0,Busch Stadium,5,3
2018-04-08,2018,BOS,TB,8,7,-200,-1.5,-101,8.0,-113,-107,170,1.5,-119,5.33,Fenway Park,15,1
2018-04-08,2018,TOR,TEX,7,4,-112,-1.5,140,9.0,-105,-115,102,1.5,-160,4.75,Rangers Ballpark,11,3
2018-04-08,2018,TEX,TOR,4,7,102,1.5,-160,9.0,-105,-115,-112,-1.5,140,4.46,Rangers Ballpark,11,-3
2018-04-08,2018,NYM,WSH,6,5,167,1.5,-130,8.0,-110,-110,-187,-1.5,110,3.0,Nationals Park,11,1
2018-04-09,2018,SF,ARI,1,2,-105,-1.5,192,8.0,106,-126,-105,1.5,-230,4.1,AT&T Park,3,-1
2018-04-09,2018,WSH,ATL,2,0,-254,-1.5,-127,7.5,-110,-110,214,1.5,107,5.38,Nationals Park,2,2
2018-04-09,2018,TOR,BAL,7,1,107,1.5,-220,7.5,-119,-101,-117,-1.5,184,3.62,Camden Yards,8,6
2018-04-09,2018,PHI,CIN,6,5,-131,-1.5,151,9.0,-103,-117,116,1.5,-175,5.1,Citizens Bank Park,11,1
2018-04-09,2018,DET,CLE,0,2,255,1.5,110,6.5,-114,-106,-305,-1.5,-130,1.83,Progressive Field,2,-2
2018-04-09,2018,SD,COL,7,6,170,1.5,-115,9.5,-111,-109,-190,-1.5,-105,3.52,Coors Field,13,1
2018-04-09,2018,TB,CWS,5,4,-140,-1.5,115,7.0,-119,-101,125,1.5,-135,4.08,Guaranteed Rate Field,9,1
2018-04-09,2018,CLE,DET,2,0,-305,-1.5,-130,6.5,-114,-106,255,1.5,110,4.9,Progressive Field,2,2
2018-04-09,2018,MIN,HOU,0,2,130,1.5,-130,8.0,-101,-119,-145,-1.5,110,3.48,Target Field,2,-2
2018-04-09,2018,SEA,KC,0,10,-105,-1.5,151,7.5,-105,-115,-105,1.5,-175,3.84,Kauffman Stadium,10,-10
2018-04-09,2018,TEX,LAA,3,8,121,1.5,-137,9.0,-120,100,-136,-1.5,117,4.07,Rangers Ballpark,11,-5
2018-04-09,2018,NYM,MIA,4,2,-235,-1.5,-147,7.5,-101,-119,205,1.5,127,5.26,Marlins Park,6,2
2018-04-09,2018,STL,MIL,4,5,-148,-1.5,152,8.0,-103,-117,133,1.5,-174,4.77,Busch Stadium,9,-1
2018-04-09,2018,HOU,MIN,2,0,-145,-1.5,110,8.0,-101,-119,130,1.5,-130,4.73,Target Field,2,2
2018-04-09,2018,MIA,NYM,2,4,205,1.5,127,7.5,-101,-119,-235,-1.5,-147,2.46,Marlins Park,6,-2
2018-04-09,2018,CIN,PHI,5,6,116,1.5,-175,9.0,-103,-117,-131,-1.5,151,4.17,Citizens Bank Park,11,-1
2018-04-09,2018,COL,SD,6,7,-190,-1.5,-105,9.5,-111,-109,170,1.5,-115,6.22,Coors Field,13,-1
2018-04-09,2018,KC,SEA,10,0,-105,1.5,-175,7.5,-105,-115,-105,-1.5,151,3.84,Kauffman Stadium,10,10
2018-04-09,2018,ARI,SF,2,1,-105,1.5,-230,8.0,106,-126,-105,-1.5,192,4.1,AT&T Park,3,1
2018-04-09,2018,MIL,STL,5,4,133,1.5,-174,8.0,-103,-117,-148,-1.5,152,3.43,Busch Stadium,9,1
2018-04-09,2018,CWS,TB,4,5,125,1.5,-135,7.0,-119,-101,-140,-1.5,115,3.11,Guaranteed Rate Field,9,-1
2018-04-09,2018,LAA,TEX,8,3,-136,-1.5,117,9.0,-120,100,121,1.5,-137,5.19,Rangers Ballpark,11,5
2018-04-09,2018,BAL,TOR,1,7,-117,-1.5,184,7.5,-119,-101,107,1.5,-220,4.04,Camden Yards,8,-6
2018-04-09,2018,ATL,WSH,0,2,214,1.5,107,7.5,-110,-110,-254,-1.5,-127,2.39,Nationals Park,2,-2
2018-04-10,2018,SF,ARI,5,4,-102,1.5,-170,7.5,-105,-115,-108,-1.5,148,3.79,AT&T Park,9,1
2018-04-10,2018,WSH,ATL,4,1,-240,-1.5,-110,7.0,-120,100,200,1.5,-110,4.94,Nationals Park,5,3
2018-04-10,2018,TOR,BAL,2,1,-135,-1.5,120,9.0,-105,-115,120,1.5,-140,5.17,Camden Yards,3,1
2018-04-10,2018,NYY,BOS,1,14,117,1.5,-185,7.0,115,-135,-132,-1.5,160,3.23,Fenway Park,15,-13
2018-04-10,2018,PIT,CHC,8,5,132,1.5,-168,9.0,-110,-110,-147,-1.5,145,3.88,Wrigley Field,13,3
2018-04-10,2018,PHI,CIN,6,1,-195,-1.5,105,7.5,-115,-105,175,1.5,-125,4.96,Citizens Bank Park,7,5
2018-04-10,2018,DET,CLE,1,2,182,1.5,-115,8.5,100,-120,-212,-1.5,-105,3.01,Progressive Field,3,-1
2018-04-10,2018,SD,COL,5,2,135,1.5,-140,10.5,-110,-110,-150,-1.5,120,4.47,Coors Field,7,3
2018-04-10,2018,TB,CWS,6,5,-110,-1.5,144,8.5,-105,-115,100,1.5,-165,4.45,Guaranteed Rate Field,11,1
2018-04-10,2018,CLE,DET,2,1,-212,-1.5,-105,8.5,100,-120,182,1.5,-115,5.78,Progressive Field,3,1
2018-04-10,2018,MIN,HOU,4,1,143,1.5,-115,8.0,-122,102,-158,-1.5,-105,3.29,Target Field,5,3
2018-04-10,2018,SEA,KC,8,3,-105,-1.5,151,8.5,-110,-110,-105,1.5,-175,4.35,Kauffman Stadium,11,5
2018-04-10,2018,TEX,LAA,1,11,128,1.5,-125,10.0,-110,-110,-143,-1.5,105,4.39,Rangers Ballpark,12,-10
2018-04-10,2018,OAK,LAD,0,4,113,1.5,-195,8.5,-105,-115,-123,-1.5,166,3.99,Dodger Stadium,4,-4
2018-04-10,2018,NYM,MIA,8,6,-194,-1.5,-115,8.0,107,-127,174,1.5,-105,5.28,Marlins Park,14,2
2018-04-10,2018,STL,MIL,5,3,-163,-1.5,130,7.5,-121,101,148,1.5,-150,4.65,Busch Stadium,8,2
2018-04-10,2018,HOU,MIN,1,4,-158,-1.5,-105,8.0,-122,102,143,1.5,-115,4.9,Target Field,5,-3
2018-04-10,2018,MIA,NYM,6,8,174,1.5,-105,8.0,107,-127,-194,-1.5,-115,2.92,Marlins Park,14,-2
2018-04-10,2018,BOS,NYY,14,1,-132,-1.5,160,7.0,115,-135,117,1.5,-185,3.98,Fenway Park,15,13
2018-04-10,2018,LAD,OAK,4,0,-123,-1.5,166,8.5,-105,-115,113,1.5,-195,4.69,Dodger Stadium,4,4
2018-04-10,2018,CIN,PHI,1,6,175,1.5,-125,7.5,-115,-105,-195,-1.5,105,2.73,Citizens Bank Park,7,-5
2018-04-10,2018,CHC,PIT,5,8,-147,-1.5,145,9.0,-110,-110,132,1.5,-168,5.36,Wrigley Field,13,-3
2018-04-10,2018,COL,SD,2,5,-150,-1.5,120,10.5,-110,-110,135,1.5,-140,6.3,Coors Field,7,-3
2018-04-10,2018,KC,SEA,3,8,-105,1.5,-175,8.5,-110,-110,-105,-1.5,151,4.35,Kauffman Stadium,11,-5
2018-04-10,2018,ARI,SF,4,5,-108,-1.5,148,7.5,-105,-115,-102,1.5,-170,3.89,AT&T Park,9,-1
2018-04-10,2018,MIL,STL,3,5,148,1.5,-150,7.5,-121,101,-163,-1.5,130,3.02,Busch Stadium,8,-2
2018-04-10,2018,CWS,TB,5,6,100,1.5,-165,8.5,-105,-115,-110,-1.5,144,4.25,Guaranteed Rate Field,11,-1
2018-04-10,2018,LAA,TEX,11,1,-143,-1.5,105,10.0,-110,-110,128,1.5,-125,5.88,Rangers Ballpark,12,10
2018-04-10,2018,BAL,TOR,1,2,120,1.5,-140,9.0,-105,-115,-135,-1.5,120,4.09,Camden Yards,3,-1
2018-04-10,2018,ATL,WSH,1,4,200,1.5,-110,7.0,-120,100,-240,-1.5,-110,2.33,Nationals Park,5,-3
2018-04-11,2018,SF,ARI,3,7,100,1.5,-164,7.5,-103,-117,-110,-1.5,143,3.75,AT&T Park,10,-4
2018-04-11,2018,WSH,ATL,3,5,-123,-1.5,169,9.0,-105,-115,113,1.5,-201,4.96,Nationals Park,8,-2
2018-04-11,2018,TOR,BAL,3,5,122,1.5,-175,8.5,-102,-118,-137,-1.5,151,3.83,Camden Yards,8,-2
2018-04-11,2018,NYY,BOS,10,7,-106,-1.5,149,8.0,-111,-109,-104,1.5,-171,4.12,Fenway Park,17,3
2018-04-11,2018,PIT,CHC,5,13,145,1.5,-155,8.0,-110,-110,-160,-1.5,135,3.27,Wrigley Field,18,-8
2018-04-11,2018,PHI,CIN,4,3,-107,-1.5,180,8.0,-101,-119,-103,1.5,-215,4.14,Citizens Bank Park,7,1
2018-04-11,2018,DET,CLE,1,5,250,1.5,114,8.0,-120,100,-300,-1.5,-134,2.29,Progressive Field,6,-4
2018-04-11,2018,SD,COL,4,6,135,1.5,-145,11.5,-115,-105,-150,-1.5,125,4.89,Coors Field,10,-2
2018-04-11,2018,TB,CWS,1,2,-125,-1.5,130,9.0,106,-126,115,1.5,-150,5.0,Guaranteed Rate Field,3,-1
2018-04-11,2018,CLE,DET,5,1,-300,-1.5,-134,8.0,-120,100,250,1.5,114,6.0,Progressive Field,6,4
2018-04-11,2018,MIN,HOU,9,8,145,1.5,-115,8.0,-101,-119,-160,-1.5,-105,3.27,Target Field,17,1
2018-04-11,2018,SEA,KC,4,2,-140,-1.5,115,8.5,-117,-103,125,1.5,-135,4.96,Kauffman Stadium,6,2
2018-04-11,2018,TEX,LAA,2,7,105,1.5,-156,11.0,-125,105,-115,-1.5,136,5.37,Rangers Ballpark,9,-5
2018-04-11,2018,OAK,LAD,16,6,158,1.5,-138,7.5,-107,-113,-178,-1.5,118,2.91,Dodger Stadium,22,10
2018-04-11,2018,NYM,MIA,4,1,-129,-1.5,125,8.5,-115,-105,119,1.5,-145,4.79,Marlins Park,5,3
2018-04-11,2018,STL,MIL,2,3,-141,-1.5,144,9.5,-108,-112,126,1.5,-165,5.56,Busch Stadium,5,-1
2018-04-11,2018,HOU,MIN,8,9,-160,-1.5,-105,8.0,-101,-119,145,1.5,-115,4.92,Target Field,17,-1
2018-04-11,2018,MIA,NYM,1,4,119,1.5,-145,8.5,-115,-105,-129,-1.5,125,3.88,Marlins Park,5,-3
2018-04-11,2018,BOS,NYY,7,10,-104,1.5,-171,8.0,-111,-109,-106,-1.5,149,4.08,Fenway Park,17,-3
2018-04-11,2018,LAD,OAK,6,16,-178,-1.5,118,7.5,-107,-113,158,1.5,-138,4.8,Dodger Stadium,22,-10
2018-04-11,2018,CIN,PHI,3,4,-103,1.5,-215,8.0,-101,-119,-107,-1.5,180,4.06,Citizens Bank Park,7,-1
2018-04-11,2018,CHC,PIT,13,5,-160,-1.5,135,8.0,-110,-110,145,1.5,-155,4.92,Wrigley Field,18,8
2018-04-11,2018,COL,SD,6,4,-150,-1.5,125,11.5,-115,-105,135,1.5,-145,6.9,Coors Field,10,2
2018-04-11,2018,KC,SEA,2,4,125,1.5,-135,8.5,-117,-103,-140,-1.5,115,3.78,Kauffman Stadium,6,-2
2018-04-11,2018,ARI,SF,7,3,-110,-1.5,143,7.5,-103,-117,100,1.5,-164,3.93,AT&T Park,10,4
2018-04-11,2018,MIL,STL,3,2,126,1.5,-165,9.5,-108,-112,-141,-1.5,144,4.2,Busch Stadium,5,1
2018-04-11,2018,CWS,TB,2,1,115,1.5,-150,9.0,106,-126,-125,-1.5,130,4.19,Guaranteed Rate Field,3,1
2018-04-11,2018,LAA,TEX,7,2,-115,-1.5,136,11.0,-125,105,105,1.5,-156,5.88,Rangers Ballpark,9,5
2018-04-11,2018,BAL,TOR,5,3,-137,-1.5,151,8.5,-102,-118,122,1.5,-175,4.91,Camden Yards,8,2
2018-04-11,2018,ATL,WSH,5,3,113,1.5,-201,9.0,-105,-115,-123,-1.5,169,4.23,Nationals Park,8,2
2018-04-12,2018,NYY,BOS,3,6,-114,-1.5,141,9.0,-125,105,104,1.5,-161,4.79,Fenway Park,9,-3
2018-04-12,2018,PIT,CHC,6,1,155,1.5,-140,8.5,-110,-110,-175,-1.5,120,3.33,Wrigley Field,7,5
2018-04-12,2018,STL,CIN,13,4,-146,-1.5,105,9.5,-105,-115,131,1.5,-125,5.64,Great American Ballpark,17,9
2018-04-12,2018,DET,CLE,3,9,195,1.5,-110,8.5,-108,-112,-225,-1.5,-110,2.88,Progressive Field,12,-6
2018-04-12,2018,WSH,COL,1,5,-185,-1.5,110,9.0,-119,-101,165,1.5,-130,5.84,Nationals Park,6,-4
2018-04-12,2018,MIN,CWS,4,0,-245,-1.5,-115,8.5,-120,100,205,1.5,-105,6.04,Target Field,4,4
2018-04-12,2018,CLE,DET,9,3,-225,-1.5,-110,8.5,-108,-112,195,1.5,-110,5.88,Progressive Field,12,6
2018-04-12,2018,LAA,KC,7,1,-152,-1.5,100,10.0,-109,-111,137,1.5,-120,6.03,Kauffman Stadium,8,6
2018-04-12,2018,KC,LAA,1,7,137,1.5,-120,10.0,-109,-111,-152,-1.5,100,4.22,Kauffman Stadium,8,-6
2018-04-12,2018,CWS,MIN,0,4,205,1.5,-105,8.5,-120,100,-245,-1.5,-115,2.79,Target Field,4,-4
2018-04-12,2018,BOS,NYY,6,3,104,1.5,-161,9.0,-125,105,-114,-1.5,141,4.41,Fenway Park,9,3
2018-04-12,2018,CHC,PIT,1,6,-175,-1.5,120,8.5,-110,-110,155,1.5,-140,5.41,Wrigley Field,7,-5
2018-04-12,2018,SF,SD,7,0,-139,-1.5,112,8.5,102,-122,124,1.5,-131,4.94,PETCO Park,7,7
2018-04-12,2018,SD,SF,0,7,124,1.5,-131,8.5,102,-122,-139,-1.5,112,3.79,PETCO Park,7,-7
2018-04-12,2018,CIN,STL,4,13,131,1.5,-125,9.5,-105,-115,-146,-1.5,105,4.11,Great American Ballpark,17,-9
2018-04-12,2018,COL,WSH,5,1,165,1.5,-130,9.0,-119,-101,-185,-1.5,110,3.4,Nationals Park,6,4
2018-04-13,2018,LAD,ARI,7,8,-142,-1.5,148,6.5,-120,100,127,1.5,-170,3.81,Dodger Stadium,15,-1
2018-04-13,2018,CHC,ATL,0,4,-196,-1.5,102,7.5,-112,-108,176,1.5,-122,4.97,Wrigley Field,4,-4
2018-04-13,2018,BOS,BAL,7,3,-251,-1.5,-134,9.5,-118,-102,211,1.5,114,6.79,Fenway Park,10,4
2018-04-13,2018,BAL,BOS,3,7,211,1.5,114,9.5,-118,-102,-251,-1.5,-134,3.05,Fenway Park,10,-4
2018-04-13,2018,ATL,CHC,4,0,176,1.5,-122,7.5,-112,-108,-196,-1.5,102,2.72,Wrigley Field,4,4
2018-04-13,2018,STL,CIN,5,3,-170,-1.5,-110,9.5,-110,-110,150,1.5,-110,5.98,Great American Ballpark,8,2
2018-04-13,2018,TOR,CLE,8,4,131,1.5,-155,8.5,-107,-113,-146,-1.5,135,3.68,Progressive Field,12,4
2018-04-13,2018,WSH,COL,1,2,-177,-1.5,110,8.5,-115,-105,157,1.5,-130,5.43,Nationals Park,3,-1
2018-04-13,2018,NYY,DET,8,6,-182,-1.5,-125,9.0,100,-120,162,1.5,105,5.81,Comerica Park,14,2
2018-04-13,2018,TEX,HOU,2,3,220,1.5,115,8.5,-106,-114,-260,-1.5,-135,2.66,Minute Maid Park,5,-1
2018-04-13,2018,LAA,KC,5,4,-170,-1.5,-117,10.0,-101,-119,150,1.5,-103,6.3,Kauffman Stadium,9,1
2018-04-13,2018,KC,LAA,4,5,150,1.5,-103,10.0,-101,-119,-170,-1.5,-117,4.0,Kauffman Stadium,9,-1
2018-04-13,2018,ARI,LAD,8,7,127,1.5,-170,6.5,-120,100,-142,-1.5,148,2.86,Dodger Stadium,15,1
2018-04-13,2018,PIT,MIA,2,7,-129,-1.5,125,8.0,-109,-111,119,1.5,-145,4.51,Marlins Park,9,-5
2018-04-13,2018,NYM,MIL,6,5,-106,-1.5,180,8.5,-108,-112,-104,1.5,-215,4.37,Citi Field,11,1
2018-04-13,2018,MIL,NYM,5,6,-104,1.5,-215,8.5,-108,-112,-106,-1.5,180,4.33,Citi Field,11,-1
2018-04-13,2018,DET,NYY,6,8,162,1.5,105,9.0,100,-120,-182,-1.5,-125,3.44,Comerica Park,14,-2
2018-04-13,2018,SEA,OAK,7,4,119,1.5,-145,8.0,-101,-119,-129,-1.5,125,3.65,T-Mobile Park,11,3
2018-04-13,2018,TB,PHI,1,2,-114,-1.5,179,8.0,-112,-108,104,1.5,-214,4.26,Tropicana Field,3,-1
2018-04-13,2018,MIA,PIT,7,2,119,1.5,-145,8.0,-109,-111,-129,-1.5,125,3.65,Marlins Park,9,5
2018-04-13,2018,SF,SD,1,5,-131,-1.5,124,8.5,-105,-115,116,1.5,-144,4.82,PETCO Park,6,-4
2018-04-13,2018,OAK,SEA,4,7,-129,-1.5,125,8.0,-101,-119,119,1.5,-145,4.51,T-Mobile Park,11,-3
2018-04-13,2018,SD,SF,5,1,116,1.5,-144,8.5,-105,-115,-131,-1.5,124,3.94,PETCO Park,6,4
2018-04-13,2018,CIN,STL,3,5,150,1.5,-110,9.5,-110,-110,-170,-1.5,-110,3.8,Great American Ballpark,8,-2
2018-04-13,2018,PHI,TB,2,1,104,1.5,-214,8.0,-112,-108,-114,-1.5,179,3.92,Tropicana Field,3,1
2018-04-13,2018,HOU,TEX,3,2,-260,-1.5,-135,8.5,-106,-114,220,1.5,115,6.14,Minute Maid Park,5,1
2018-04-13,2018,CLE,TOR,4,8,-146,-1.5,135,8.5,-107,-113,131,1.5,-155,5.04,Progressive Field,12,-4
2018-04-13,2018,COL,WSH,2,1,157,1.5,-130,8.5,-115,-105,-177,-1.5,110,3.31,Nationals Park,3,1
2018-04-14,2018,LAD,ARI,1,9,-180,-1.5,115,7.5,-108,-112,160,1.5,-135,4.82,Dodger Stadium,10,-8
2018-04-14,2018,CHC,ATL,14,10,-178,-1.5,130,6.5,-102,-118,158,1.5,-150,4.16,Wrigley Field,24,4
2018-04-14,2018,BOS,BAL,10,3,-155,-1.5,125,9.0,100,-120,140,1.5,-145,5.47,Fenway Park,13,7
2018-04-14,2018,BAL,BOS,3,10,140,1.5,-145,9.0,100,-120,-155,-1.5,125,3.75,Fenway Park,13,-7
2018-04-14,2018,ATL,CHC,10,14,158,1.5,-150,6.5,-102,-118,-178,-1.5,130,2.52,Wrigley Field,24,-4
2018-04-14,2018,STL,CIN,6,1,-121,-1.5,130,9.5,106,-126,111,1.5,-150,5.2,Great American Ballpark,7,5
2018-04-14,2018,WSH,COL,6,2,-184,-1.5,112,7.5,-101,-119,164,1.5,-132,4.86,Nationals Park,8,4
2018-04-14,2018,TEX,HOU,6,5,200,1.5,102,8.5,-115,-105,-240,-1.5,-122,2.83,Minute Maid Park,11,1
2018-04-14,2018,LAA,KC,5,3,-163,-1.5,-105,7.5,-110,-110,148,1.5,-115,4.65,Kauffman Stadium,8,2
2018-04-14,2018,KC,LAA,3,5,148,1.5,-115,7.5,-110,-110,-163,-1.5,-105,3.02,Kauffman Stadium,8,-2
2018-04-14,2018,ARI,LAD,9,1,160,1.5,-135,7.5,-108,-112,-180,-1.5,115,2.88,Dodger Stadium,10,8
2018-04-14,2018,PIT,MIA,1,0,-195,-1.5,-122,7.5,-117,-103,175,1.5,102,4.96,Marlins Park,1,1
2018-04-14,2018,NYM,MIL,1,5,-105,-1.5,180,8.0,-119,-101,-105,1.5,-215,4.1,Citi Field,6,-4
2018-04-14,2018,MIL,NYM,5,1,-105,1.5,-215,8.0,-119,-101,-105,-1.5,180,4.1,Citi Field,6,4
2018-04-14,2018,SEA,OAK,10,8,-109,-1.5,176,9.0,104,-124,-101,1.5,-210,4.69,T-Mobile Park,18,2
2018-04-14,2018,TB,PHI,4,9,-142,-1.5,166,7.0,-120,100,127,1.5,-195,4.11,Tropicana Field,13,-5
2018-04-14,2018,MIA,PIT,0,1,175,1.5,102,7.5,-117,-103,-195,-1.5,-122,2.73,Marlins Park,1,-1
2018-04-14,2018,SF,SD,4,5,-102,1.5,-220,8.5,-105,-115,-108,-1.5,184,4.29,PETCO Park,9,-1
2018-04-14,2018,OAK,SEA,8,10,-101,1.5,-210,9.0,104,-124,-109,-1.5,176,4.52,T-Mobile Park,18,-2
2018-04-14,2018,SD,SF,5,4,-108,-1.5,184,8.5,-105,-115,-102,1.5,-220,4.41,PETCO Park,9,1
2018-04-14,2018,CIN,STL,1,6,111,1.5,-150,9.5,106,-126,-121,-1.5,130,4.5,Great American Ballpark,7,-5
2018-04-14,2018,PHI,TB,9,4,127,1.5,-195,7.0,-120,100,-142,-1.5,166,3.08,Tropicana Field,13,5
2018-04-14,2018,HOU,TEX,5,6,-240,-1.5,-122,8.5,-115,-105,200,1.5,102,6.0,Minute Maid Park,11,-1
2018-04-14,2018,COL,WSH,2,6,164,1.5,-132,7.5,-101,-119,-184,-1.5,112,2.84,Nationals Park,8,-4
2018-04-15,2018,LAD,ARI,7,2,-210,-1.5,110,6.5,-108,-112,180,1.5,-130,4.4,Dodger Stadium,9,5
2018-04-15,2018,BOS,BAL,3,1,-225,-1.5,-105,6.5,-107,-113,195,1.5,-115,4.5,Fenway Park,4,2
2018-04-15,2018,BAL,BOS,1,3,195,1.5,-115,6.5,-107,-113,-225,-1.5,-105,2.2,Fenway Park,4,-2
2018-04-15,2018,STL,CIN,3,2,-185,-1.5,-120,8.5,-110,-110,165,1.5,100,5.52,Great American Ballpark,5,1
2018-04-15,2018,WSH,COL,5,6,-205,-1.5,105,7.0,-119,-101,175,1.5,-125,4.7,Nationals Park,11,-1
2018-04-15,2018,TEX,HOU,3,1,288,1.5,135,8.0,-115,-105,-338,-1.5,-155,2.06,Minute Maid Park,4,2
2018-04-15,2018,ARI,LAD,2,7,180,1.5,-130,6.5,-108,-112,-210,-1.5,110,2.32,Dodger Stadium,9,-5
2018-04-15,2018,PIT,MIA,7,3,-139,-1.5,116,8.5,-105,-115,124,1.5,-136,4.94,Marlins Park,10,4
2018-04-15,2018,NYM,MIL,3,2,-207,-1.5,-102,7.0,110,-130,177,1.5,-118,4.72,Citi Field,5,1
2018-04-15,2018,MIL,NYM,2,3,177,1.5,-118,7.0,110,-130,-207,-1.5,-102,2.53,Citi Field,5,-1
2018-04-15,2018,SEA,OAK,1,2,104,1.5,-164,8.5,100,-120,-114,-1.5,143,4.17,T-Mobile Park,3,-1
2018-04-15,2018,TB,PHI,4,10,-138,-1.5,151,8.0,-115,-105,123,1.5,-175,4.64,Tropicana Field,14,-6
2018-04-15,2018,MIA,PIT,3,7,124,1.5,-136,8.5,-105,-115,-139,-1.5,116,3.79,Marlins Park,10,-4
2018-04-15,2018,SF,SD,1,10,120,1.5,-190,8.0,-120,100,-135,-1.5,163,3.64,PETCO Park,11,-9
2018-04-15,2018,OAK,SEA,2,1,-114,-1.5,143,8.5,100,-120,104,1.5,-164,4.53,T-Mobile Park,3,1
2018-04-15,2018,SD,SF,10,1,-135,-1.5,163,8.0,-120,100,120,1.5,-190,4.6,PETCO Park,11,9
2018-04-15,2018,CIN,STL,2,3,165,1.5,100,8.5,-110,-110,-185,-1.5,-120,3.21,Great American Ballpark,5,-1
2018-04-15,2018,PHI,TB,10,4,123,1.5,-175,8.0,-115,-105,-138,-1.5,151,3.59,Tropicana Field,14,6
2018-04-15,2018,HOU,TEX,1,3,-338,-1.5,-155,8.0,-115,-105,288,1.5,135,6.17,Minute Maid Park,4,-2
2018-04-15,2018,COL,WSH,6,5,175,1.5,-125,7.0,-119,-101,-205,-1.5,105,2.55,Nationals Park,11,1
2018-04-16,2018,PHI,ATL,1,2,-117,-1.5,135,8.5,-111,-109,107,1.5,-155,4.58,Suntrust Park,3,-1
2018-04-16,2018,MIL,CIN,4,10,-117,-1.5,170,8.0,-112,-108,107,1.5,-200,4.31,Miller Park,14,-6
2018-04-16,2018,PIT,COL,2,6,-127,-1.5,167,8.0,-114,-106,117,1.5,-194,4.48,PNC Park,8,-4
2018-04-16,2018,OAK,CWS,8,1,-155,-1.5,135,8.5,-101,-119,140,1.5,-155,5.17,Oakland Coliseum,9,7
2018-04-16,2018,SEA,HOU,2,1,-102,1.5,-170,7.0,-120,100,-108,-1.5,148,3.53,T-Mobile Park,3,1
2018-04-16,2018,SD,LAD,3,10,128,1.5,-132,7.5,100,-120,-143,-1.5,112,3.29,PETCO Park,13,-7
2018-04-16,2018,NYY,MIA,12,1,-342,-1.5,-165,8.5,-106,-114,292,1.5,144,6.58,Yankee Stadium,13,11
2018-04-16,2018,CIN,MIL,10,4,107,1.5,-200,8.0,-112,-108,-117,-1.5,170,3.86,Miller Park,14,6
2018-04-16,2018,WSH,NYM,8,6,151,1.5,-141,7.5,-111,-109,-171,-1.5,121,2.99,Citi Field,14,2
2018-04-16,2018,MIA,NYY,1,12,292,1.5,144,8.5,-106,-114,-342,-1.5,-165,2.17,Yankee Stadium,13,-11
2018-04-16,2018,CWS,OAK,1,8,140,1.5,-155,8.5,-101,-119,-155,-1.5,135,3.54,Oakland Coliseum,9,-7
2018-04-16,2018,ATL,PHI,2,1,107,1.5,-155,8.5,-111,-109,-117,-1.5,135,4.11,Suntrust Park,3,1
2018-04-16,2018,COL,PIT,6,2,117,1.5,-194,8.0,-114,-106,-127,-1.5,167,3.69,PNC Park,8,4
2018-04-16,2018,LAD,SD,10,3,-143,-1.5,112,7.5,100,-120,128,1.5,-132,4.41,PETCO Park,13,7
2018-04-16,2018,HOU,SEA,1,2,-108,-1.5,148,7.0,-120,100,-102,1.5,-170,3.63,T-Mobile Park,3,-1
2018-04-16,2018,TEX,TB,4,8,153,1.5,-135,7.5,-111,-109,-168,-1.5,114,2.96,Tropicana Field,12,-4
2018-04-16,2018,TB,TEX,8,4,-168,-1.5,114,7.5,-111,-109,153,1.5,-135,4.7,Tropicana Field,12,4
2018-04-16,2018,NYM,WSH,6,8,-171,-1.5,121,7.5,-111,-109,151,1.5,-141,4.73,Citi Field,14,-2
2018-04-17,2018,SF,ARI,0,1,135,1.5,-170,8.0,-103,-117,-150,-1.5,148,3.4,Chase Field,1,-1
2018-04-17,2018,PHI,ATL,5,1,-101,1.5,-215,8.5,-110,-110,-109,-1.5,180,4.27,Suntrust Park,6,4
2018-04-17,2018,DET,BAL,4,2,100,1.5,-160,9.0,-105,-115,-110,-1.5,140,4.5,Comerica Park,6,2
2018-04-17,2018,LAA,BOS,1,10,-166,-1.5,130,8.0,105,-125,151,1.5,-150,4.99,Angel Stadium,11,-9
2018-04-17,2018,STL,CHC,5,3,118,1.5,-175,8.0,-125,105,-128,-1.5,151,3.67,Wrigley Field,8,2
2018-04-17,2018,MIL,CIN,2,0,-149,-1.5,135,9.0,-110,-110,134,1.5,-155,5.39,Miller Park,2,2
2018-04-17,2018,MIN,CLE,1,6,170,1.5,100,8.0,-110,-110,-200,-1.5,-120,2.96,Estadio Hiram Bithorn,7,-5
2018-04-17,2018,PIT,COL,0,2,-131,-1.5,148,8.0,100,-120,116,1.5,-170,4.54,PNC Park,2,-2
2018-04-17,2018,OAK,CWS,10,2,-187,-1.5,110,8.5,-115,-105,167,1.5,-130,5.54,Oakland Coliseum,12,8
2018-04-17,2018,BAL,DET,2,4,-110,-1.5,140,9.0,-105,-115,100,1.5,-160,4.71,Comerica Park,6,-2
2018-04-17,2018,SEA,HOU,1,4,172,1.5,105,8.0,-115,-105,-202,-1.5,-125,2.94,T-Mobile Park,5,-3
2018-04-17,2018,TOR,KC,11,3,-215,-1.5,-119,9.0,-115,-105,185,1.5,-101,6.14,Rogers Centre,14,8
2018-04-17,2018,TOR,KC,5,4,-153,-1.5,125,9.0,105,-125,138,1.5,-145,5.44,Rogers Centre,9,1
2018-04-17,2018,BOS,LAA,10,1,151,1.5,-150,8.0,105,-125,-166,-1.5,130,3.19,Angel Stadium,11,9
2018-04-17,2018,SD,LAD,3,7,196,1.5,115,7.5,-110,-110,-226,-1.5,-135,2.53,PETCO Park,10,-4
2018-04-17,2018,NYY,MIA,1,9,-345,-1.5,-170,9.0,-120,100,295,1.5,148,6.98,Yankee Stadium,10,-8
2018-04-17,2018,CIN,MIL,0,2,134,1.5,-155,9.0,-110,-110,-149,-1.5,135,3.85,Miller Park,2,-2
2018-04-17,2018,CLE,MIN,6,1,-200,-1.5,-120,8.0,-110,-110,170,1.5,100,5.33,Estadio Hiram Bithorn,7,5
2018-04-17,2018,WSH,NYM,5,2,-113,-1.5,144,7.5,110,-130,103,1.5,-165,3.98,Citi Field,7,3
2018-04-17,2018,MIA,NYY,9,1,295,1.5,148,9.0,-120,100,-345,-1.5,-170,2.28,Yankee Stadium,10,8
2018-04-17,2018,CWS,OAK,2,10,167,1.5,-130,8.5,-115,-105,-187,-1.5,110,3.18,Oakland Coliseum,12,-8
2018-04-17,2018,ATL,PHI,1,5,-109,-1.5,180,8.5,-110,-110,-101,1.5,-215,4.43,Suntrust Park,6,-4
2018-04-17,2018,COL,PIT,2,0,116,1.5,-170,8.0,100,-120,-131,-1.5,148,3.7,PNC Park,2,2
2018-04-17,2018,LAD,SD,7,3,-226,-1.5,-135,7.5,-110,-110,196,1.5,115,5.2,PETCO Park,10,4
2018-04-17,2018,HOU,SEA,4,1,-202,-1.5,-125,8.0,-115,-105,172,1.5,105,5.35,T-Mobile Park,5,3
2018-04-17,2018,ARI,SF,1,0,-150,-1.5,148,8.0,-103,-117,135,1.5,-170,4.8,Chase Field,1,1
2018-04-17,2018,CHC,STL,3,5,-128,-1.5,151,8.0,-125,105,118,1.5,-175,4.49,Wrigley Field,8,-2
2018-04-17,2018,TEX,TB,7,2,131,1.5,-155,8.5,100,-120,-146,-1.5,135,3.68,Tropicana Field,9,5
2018-04-17,2018,TB,TEX,2,7,-146,-1.5,135,8.5,100,-120,131,1.5,-155,5.04,Tropicana Field,9,-5
2018-04-17,2018,KC,TOR,3,11,185,1.5,-101,9.0,-115,-105,-215,-1.5,-119,3.16,Rogers Centre,14,-8
2018-04-17,2018,KC,TOR,4,5,138,1.5,-145,9.0,105,-125,-153,-1.5,125,3.78,Rogers Centre,9,-1
2018-04-17,2018,NYM,WSH,2,5,103,1.5,-165,7.5,110,-130,-113,-1.5,144,3.69,Citi Field,7,-3
2018-04-18,2018,SF,ARI,4,3,152,1.5,-145,8.0,-120,100,-167,-1.5,126,3.17,Chase Field,7,1
2018-04-18,2018,PHI,ATL,3,7,113,1.5,-200,9.0,-110,-110,-123,-1.5,170,4.23,Suntrust Park,10,-4
2018-04-18,2018,DET,BAL,6,5,111,1.5,-149,8.5,102,-122,-121,-1.5,129,4.03,Comerica Park,11,1
2018-04-18,2018,LAA,BOS,0,9,-101,1.5,-166,8.0,-104,-116,-109,-1.5,145,4.02,Angel Stadium,9,-9
2018-04-18,2018,MIL,CIN,2,0,-139,-1.5,158,9.0,-118,-102,124,1.5,-183,5.23,Miller Park,2,2
2018-04-18,2018,MIN,CLE,2,1,106,1.5,-156,8.0,-109,-111,-116,-1.5,137,3.88,Estadio Hiram Bithorn,3,1
2018-04-18,2018,PIT,COL,10,2,-123,-1.5,170,7.5,-109,-111,113,1.5,-200,4.14,PNC Park,12,8
2018-04-18,2018,OAK,CWS,12,11,-205,-1.5,-119,9.0,-112,-108,175,1.5,-101,6.05,Oakland Coliseum,23,1
2018-04-18,2018,BAL,DET,5,6,-121,-1.5,129,8.5,102,-122,111,1.5,-149,4.65,Comerica Park,11,-1
2018-04-18,2018,SEA,HOU,1,7,160,1.5,-103,7.5,105,-125,-180,-1.5,-116,2.88,T-Mobile Park,8,-6
2018-04-18,2018,TOR,KC,15,5,-197,-1.5,-105,8.0,-115,-105,177,1.5,-114,5.31,Rogers Centre,20,10
2018-04-18,2018,BOS,LAA,9,0,-109,-1.5,145,8.0,-104,-116,-101,1.5,-166,4.17,Angel Stadium,9,9
2018-04-18,2018,SD,LAD,4,13,150,1.5,-114,7.0,-119,-101,-165,-1.5,-106,2.8,PETCO Park,17,-9
2018-04-18,2018,CIN,MIL,0,2,124,1.5,-183,9.0,-118,-102,-139,-1.5,158,4.02,Miller Park,2,-2
2018-04-18,2018,CLE,MIN,1,2,-116,-1.5,137,8.0,-109,-111,106,1.5,-156,4.3,Estadio Hiram Bithorn,3,-1
2018-04-18,2018,WSH,NYM,5,11,-101,1.5,-220,8.0,100,-120,-109,-1.5,184,4.02,Citi Field,16,-6
2018-04-18,2018,CWS,OAK,11,12,175,1.5,-101,9.0,-112,-108,-205,-1.5,-119,3.27,Oakland Coliseum,23,-1
2018-04-18,2018,ATL,PHI,7,3,-123,-1.5,170,9.0,-110,-110,113,1.5,-200,4.96,Suntrust Park,10,4
2018-04-18,2018,COL,PIT,2,10,113,1.5,-200,7.5,-109,-111,-123,-1.5,170,3.52,PNC Park,12,-8
2018-04-18,2018,LAD,SD,13,4,-165,-1.5,-106,7.0,-119,-101,150,1.5,-114,4.36,PETCO Park,17,9
2018-04-18,2018,HOU,SEA,7,1,-180,-1.5,-116,7.5,105,-125,160,1.5,-103,4.82,T-Mobile Park,8,6
2018-04-18,2018,ARI,SF,3,4,-167,-1.5,126,8.0,-120,100,152,1.5,-145,5.0,Chase Field,7,-1
2018-04-18,2018,TEX,TB,2,4,-132,-1.5,130,8.0,-101,-119,117,1.5,-150,4.55,Tropicana Field,6,-2
2018-04-18,2018,TB,TEX,4,2,117,1.5,-150,8.0,-101,-119,-132,-1.5,130,3.69,Tropicana Field,6,2
2018-04-18,2018,KC,TOR,5,15,177,1.5,-114,8.0,-115,-105,-197,-1.5,-105,2.89,Rogers Centre,20,-10
2018-04-18,2018,NYM,WSH,11,5,-109,-1.5,184,8.0,100,-120,-101,1.5,-220,4.17,Citi Field,16,6
2018-04-19,2018,SF,ARI,1,3,153,1.5,-140,8.5,-110,-110,-173,-1.5,120,3.36,Chase Field,4,-2
2018-04-19,2018,NYM,ATL,4,12,-105,-1.5,147,9.5,-108,-112,-105,1.5,-169,4.87,Suntrust Park,16,-8
2018-04-19,2018,DET,BAL,13,8,101,1.5,-160,9.0,-110,-110,-111,-1.5,140,4.48,Comerica Park,21,5
2018-04-19,2018,LAA,BOS,2,8,101,1.5,-165,8.5,-101,-119,-111,-1.5,144,4.23,Angel Stadium,10,-6
2018-04-19,2018,STL,CHC,5,8,113,1.5,-225,7.0,-115,-105,-123,-1.5,188,3.29,Wrigley Field,13,-3
2018-04-19,2018,BAL,DET,8,13,-111,-1.5,140,9.0,-110,-110,101,1.5,-160,4.73,Comerica Park,21,-5
2018-04-19,2018,SEA,HOU,2,9,165,1.5,105,8.5,106,-126,-185,-1.5,-125,3.21,T-Mobile Park,11,-7
2018-04-19,2018,BOS,LAA,8,2,-111,-1.5,144,8.5,-101,-119,101,1.5,-165,4.47,Angel Stadium,10,6
2018-04-19,2018,MIL,MIA,12,3,-187,-1.5,-103,9.0,-115,-105,167,1.5,-117,5.86,Miller Park,15,9
2018-04-19,2018,MIA,MIL,3,12,167,1.5,-117,9.0,-115,-105,-187,-1.5,-103,3.37,Miller Park,15,-9
2018-04-19,2018,ATL,NYM,12,4,-105,1.5,-169,9.5,-108,-112,-105,-1.5,147,4.87,Suntrust Park,16,8
2018-04-19,2018,TOR,NYY,3,4,145,1.5,-145,9.0,-110,-110,-160,-1.5,125,3.67,Yankee Stadium,7,-1
2018-04-19,2018,PIT,PHI,0,7,-117,-1.5,143,7.0,-102,-118,107,1.5,-163,3.77,Citizens Bank Park,7,-7
2018-04-19,2018,PHI,PIT,7,0,107,1.5,-163,7.0,-102,-118,-117,-1.5,143,3.38,Citizens Bank Park,7,7
2018-04-19,2018,HOU,SEA,9,2,-185,-1.5,-125,8.5,106,-126,165,1.5,105,5.52,T-Mobile Park,11,7
2018-04-19,2018,ARI,SF,3,1,-173,-1.5,120,8.5,-110,-110,153,1.5,-140,5.39,Chase Field,4,2
2018-04-19,2018,CHC,STL,8,5,-123,-1.5,188,7.0,-115,-105,113,1.5,-225,3.86,Wrigley Field,13,3
2018-04-19,2018,NYY,TOR,4,3,-160,-1.5,125,9.0,-110,-110,145,1.5,-145,5.54,Yankee Stadium,7,1
2018-04-20,2018,SD,ARI,4,1,101,1.5,-200,8.5,-105,-115,-111,-1.5,170,4.23,Chase Field,5,3
2018-04-20,2018,NYM,ATL,5,3,-140,-1.5,110,7.5,-114,-106,125,1.5,-129,4.38,Suntrust Park,8,2
2018-04-20,2018,CLE,BAL,1,3,-123,-1.5,130,7.5,-115,-105,113,1.5,-149,4.14,Camden Yards,4,-2
2018-04-20,2018,OAK,BOS,3,7,119,1.5,-148,8.5,-124,104,-134,-1.5,125,3.88,Oakland Coliseum,10,-4
2018-04-20,2018,COL,CHC,5,16,-102,-1.5,172,9.5,-105,-115,-108,1.5,-205,4.8,Coors Field,21,-11
2018-04-20,2018,STL,CIN,4,2,-215,-1.5,-106,8.5,-110,-110,185,1.5,-114,5.8,Busch Stadium,6,2
2018-04-20,2018,BAL,CLE,3,1,113,1.5,-149,7.5,-115,-105,-123,-1.5,130,3.52,Camden Yards,4,2
2018-04-20,2018,CHC,COL,16,5,-108,1.5,-205,9.5,-105,-115,-102,-1.5,172,4.93,Coors Field,21,11
2018-04-20,2018,HOU,CWS,10,0,-266,-1.5,-160,8.5,-123,103,226,1.5,140,6.18,Guaranteed Rate Field,10,10
2018-04-20,2018,KC,DET,2,3,119,1.5,-170,9.0,105,-125,-129,-1.5,148,4.11,Comerica Park,5,-1
2018-04-20,2018,KC,DET,3,2,-104,-1.5,152,8.0,-110,-110,-106,1.5,-176,4.08,Comerica Park,5,1
2018-04-20,2018,CWS,HOU,0,10,226,1.5,140,8.5,-123,103,-266,-1.5,-160,2.61,Guaranteed Rate Field,10,-10
2018-04-20,2018,DET,KC,3,2,-129,-1.5,148,9.0,105,-125,119,1.5,-170,5.07,Comerica Park,5,1
2018-04-20,2018,DET,KC,2,3,-106,1.5,-176,8.0,-110,-110,-104,-1.5,152,4.12,Comerica Park,5,-1
2018-04-20,2018,SF,LAA,8,1,140,1.5,-145,8.5,-110,-110,-155,-1.5,126,3.54,Angel Stadium,9,7
2018-04-20,2018,WSH,LAD,5,2,136,1.5,-190,5.5,-115,-105,-151,-1.5,163,2.33,Dodger Stadium,7,3
2018-04-20,2018,MIL,MIA,8,0,-163,-1.5,126,9.0,-101,-119,148,1.5,-146,5.58,Miller Park,8,8
2018-04-20,2018,MIA,MIL,0,8,148,1.5,-146,9.0,-101,-119,-163,-1.5,126,3.63,Miller Park,8,-8
2018-04-20,2018,TB,MIN,8,7,-135,-1.5,158,8.0,-101,-119,120,1.5,-184,4.6,Tropicana Field,15,1
2018-04-20,2018,ATL,NYM,3,5,125,1.5,-129,7.5,-114,-106,-140,-1.5,110,3.33,Suntrust Park,8,-2
2018-04-20,2018,TOR,NYY,8,5,173,1.5,-123,8.5,-110,-110,-193,-1.5,103,3.11,Yankee Stadium,13,3
2018-04-20,2018,BOS,OAK,7,3,-134,-1.5,125,8.5,-124,104,119,1.5,-148,4.87,Oakland Coliseum,10,4
2018-04-20,2018,PIT,PHI,1,2,-104,1.5,-214,8.0,-120,100,-106,-1.5,179,4.08,Citizens Bank Park,3,-1
2018-04-20,2018,PHI,PIT,2,1,-106,-1.5,179,8.0,-120,100,-104,1.5,-214,4.12,Citizens Bank Park,3,1
2018-04-20,2018,ARI,SD,1,4,-111,-1.5,170,8.5,-105,-115,101,1.5,-200,4.47,Chase Field,5,-3
2018-04-20,2018,TEX,SEA,2,6,-130,-1.5,160,9.5,-116,-104,115,1.5,-185,5.37,Rangers Ballpark,8,-4
2018-04-20,2018,LAA,SF,1,8,-155,-1.5,126,8.5,-110,-110,140,1.5,-145,5.17,Angel Stadium,9,-7
2018-04-20,2018,CIN,STL,2,4,185,1.5,-114,8.5,-110,-110,-215,-1.5,-106,2.98,Busch Stadium,6,-2
2018-04-20,2018,MIN,TB,7,8,120,1.5,-184,8.0,-101,-119,-135,-1.5,158,3.64,Tropicana Field,15,-1
2018-04-20,2018,SEA,TEX,6,2,115,1.5,-185,9.5,-116,-104,-130,-1.5,160,4.42,Rangers Ballpark,8,4
2018-04-20,2018,NYY,TOR,5,8,-193,-1.5,103,8.5,-110,-110,173,1.5,-123,5.6,Yankee Stadium,13,-3
2018-04-20,2018,LAD,WSH,2,5,-151,-1.5,163,5.5,-115,-105,136,1.5,-190,3.31,Dodger Stadium,7,-3
2018-04-21,2018,SD,ARI,2,6,150,1.5,-139,8.0,-101,-119,-170,-1.5,119,3.2,Chase Field,8,-4
2018-04-21,2018,NYM,ATL,3,4,-163,-1.5,101,8.5,-105,-115,148,1.5,-121,5.27,Suntrust Park,7,-1
2018-04-21,2018,CLE,BAL,4,0,-205,-1.5,-140,9.5,-110,-110,175,1.5,120,6.39,Camden Yards,4,4
2018-04-21,2018,OAK,BOS,3,0,155,1.5,-103,7.5,105,-125,-175,-1.5,-117,2.94,Oakland Coliseum,3,3
2018-04-21,2018,COL,CHC,5,2,119,1.5,-140,9.5,105,-125,-129,-1.5,120,4.34,Coors Field,7,3
2018-04-21,2018,STL,CIN,4,3,-223,-1.5,100,8.5,-110,-110,193,1.5,-121,5.87,Busch Stadium,7,1
2018-04-21,2018,BAL,CLE,0,4,175,1.5,120,9.5,-110,-110,-205,-1.5,-140,3.45,Camden Yards,4,-4
2018-04-21,2018,CHC,COL,2,5,-129,-1.5,120,9.5,105,-125,119,1.5,-140,5.35,Coors Field,7,-3
2018-04-21,2018,HOU,CWS,10,1,-219,-1.5,-139,9.0,-116,-104,189,1.5,119,6.18,Guaranteed Rate Field,11,9
2018-04-21,2018,KC,DET,4,12,-101,1.5,-210,8.5,-107,-113,-109,-1.5,176,4.27,Comerica Park,16,-8
2018-04-21,2018,CWS,HOU,1,10,189,1.5,119,9.0,-116,-104,-219,-1.5,-139,3.11,Guaranteed Rate Field,11,-9
2018-04-21,2018,DET,KC,12,4,-109,-1.5,176,8.5,-107,-113,-101,1.5,-210,4.43,Comerica Park,16,8
2018-04-21,2018,SF,LAA,3,4,202,1.5,-101,9.5,100,-120,-232,-1.5,-119,3.15,Angel Stadium,7,-1
2018-04-21,2018,WSH,LAD,0,4,-109,-1.5,145,7.5,-105,-115,-101,1.5,-166,3.91,Dodger Stadium,4,-4
2018-04-21,2018,MIL,MIA,6,5,-195,-1.5,101,9.0,-110,-110,175,1.5,-121,5.95,Miller Park,11,1
2018-04-21,2018,MIA,MIL,5,6,175,1.5,-121,9.0,-110,-110,-195,-1.5,101,3.27,Miller Park,11,-1
2018-04-21,2018,TB,MIN,10,1,-121,-1.5,172,7.5,-115,-105,111,1.5,-205,4.11,Tropicana Field,11,9
2018-04-21,2018,ATL,NYM,4,3,148,1.5,-121,8.5,-105,-115,-163,-1.5,101,3.43,Suntrust Park,7,1
2018-04-21,2018,TOR,NYY,1,9,146,1.5,-140,8.5,-115,-105,-161,-1.5,120,3.46,Yankee Stadium,10,-8
2018-04-21,2018,BOS,OAK,0,3,-175,-1.5,-117,7.5,105,-125,155,1.5,-103,4.77,Oakland Coliseum,3,-3
2018-04-21,2018,PIT,PHI,2,6,156,1.5,-138,8.0,-110,-110,-176,-1.5,117,3.13,Citizens Bank Park,8,-4
2018-04-21,2018,PHI,PIT,6,2,-176,-1.5,117,8.0,-110,-110,156,1.5,-138,5.1,Citizens Bank Park,8,4
2018-04-21,2018,ARI,SD,6,2,-170,-1.5,119,8.0,-101,-119,150,1.5,-139,5.04,Chase Field,8,4
2018-04-21,2018,TEX,SEA,7,9,156,1.5,-101,8.5,-116,-104,-176,-1.5,-119,3.32,Rangers Ballpark,16,-2
2018-04-21,2018,LAA,SF,4,3,-232,-1.5,-119,9.5,100,-120,202,1.5,-101,6.64,Angel Stadium,7,1
2018-04-21,2018,CIN,STL,3,4,193,1.5,-121,8.5,-110,-110,-223,-1.5,100,2.9,Busch Stadium,7,-1
2018-04-21,2018,MIN,TB,1,10,111,1.5,-205,7.5,-115,-105,-121,-1.5,172,3.55,Tropicana Field,11,-9
2018-04-21,2018,SEA,TEX,9,7,-176,-1.5,-119,8.5,-116,-104,156,1.5,-101,5.42,Rangers Ballpark,16,2
2018-04-21,2018,NYY,TOR,9,1,-161,-1.5,120,8.5,-115,-105,146,1.5,-140,5.24,Yankee Stadium,10,8
2018-04-21,2018,LAD,WSH,4,0,-101,1.5,-166,7.5,-105,-115,-109,-1.5,145,3.77,Dodger Stadium,4,4
2018-04-22,2018,SD,ARI,2,4,134,1.5,-185,7.0,-110,-110,-149,-1.5,159,2.99,Chase Field,6,-2
2018-04-22,2018,CLE,BAL,7,3,-270,-1.5,-156,7.5,-120,100,230,1.5,136,5.47,Camden Yards,10,4
2018-04-22,2018,OAK,BOS,4,1,119,1.5,-135,8.5,-108,-112,-129,-1.5,115,3.88,Oakland Coliseum,5,3
2018-04-22,2018,COL,CHC,7,9,104,1.5,-154,10.5,-115,-105,-114,-1.5,134,5.15,Coors Field,16,-2
2018-04-22,2018,STL,CIN,9,2,-150,-1.5,140,7.5,-105,-115,135,1.5,-160,4.5,Busch Stadium,11,7
2018-04-22,2018,BAL,CLE,3,7,230,1.5,136,7.5,-120,100,-270,-1.5,-156,2.27,Camden Yards,10,-4
2018-04-22,2018,CHC,COL,9,7,-114,-1.5,134,10.5,-115,-105,104,1.5,-154,5.59,Coors Field,16,2
2018-04-22,2018,HOU,CWS,7,1,-190,-1.5,-125,8.0,-110,-110,170,1.5,105,5.24,Guaranteed Rate Field,8,6
2018-04-22,2018,KC,DET,8,5,163,1.5,-121,9.0,-115,-105,-183,-1.5,101,3.42,Comerica Park,13,3
2018-04-22,2018,CWS,HOU,1,7,170,1.5,105,8.0,-110,-110,-190,-1.5,-125,2.96,Guaranteed Rate Field,8,-6
2018-04-22,2018,DET,KC,5,8,-183,-1.5,101,9.0,-115,-105,163,1.5,-121,5.82,Comerica Park,13,-3
2018-04-22,2018,SF,LAA,4,2,103,1.5,-215,9.0,-105,-115,-113,-1.5,180,4.43,Angel Stadium,6,2
2018-04-22,2018,WSH,LAD,3,4,180,1.5,-108,8.0,-115,-105,-210,-1.5,-112,2.86,Dodger Stadium,7,-1
2018-04-22,2018,MIL,MIA,4,2,-190,-1.5,-101,9.0,-105,-115,170,1.5,-119,5.9,Miller Park,6,2
2018-04-22,2018,MIA,MIL,2,4,170,1.5,-119,9.0,-105,-115,-190,-1.5,-101,3.33,Miller Park,6,-2
2018-04-22,2018,TB,MIN,8,6,-119,-1.5,163,9.0,104,-124,109,1.5,-190,4.89,Tropicana Field,14,2
2018-04-22,2018,TOR,NYY,1,5,216,1.5,110,8.5,-101,-119,-256,-1.5,-130,2.69,Yankee Stadium,6,-4
2018-04-22,2018,BOS,OAK,1,4,-129,-1.5,115,8.5,-108,-112,119,1.5,-135,4.79,Oakland Coliseum,5,-3
2018-04-22,2018,PIT,PHI,2,3,151,1.5,-150,8.5,-105,-115,-166,-1.5,130,3.39,Citizens Bank Park,5,-1
2018-04-22,2018,PHI,PIT,3,2,-166,-1.5,130,8.5,-105,-115,151,1.5,-150,5.3,Citizens Bank Park,5,1
2018-04-22,2018,ARI,SD,4,2,-149,-1.5,159,7.0,-110,-110,134,1.5,-185,4.19,Chase Field,6,2
2018-04-22,2018,TEX,SEA,7,4,105,1.5,-147,10.0,-105,-115,-115,-1.5,127,4.88,Rangers Ballpark,11,3
2018-04-22,2018,LAA,SF,2,4,-113,-1.5,180,9.0,-105,-115,103,1.5,-215,4.77,Angel Stadium,6,-2
2018-04-22,2018,CIN,STL,2,9,135,1.5,-160,7.5,-105,-115,-150,-1.5,140,3.19,Busch Stadium,11,-7
2018-04-22,2018,MIN,TB,6,8,109,1.5,-190,9.0,104,-124,-119,-1.5,163,4.31,Tropicana Field,14,-2
2018-04-22,2018,SEA,TEX,4,7,-115,-1.5,127,10.0,-105,-115,105,1.5,-147,5.35,Rangers Ballpark,11,-3
2018-04-22,2018,NYY,TOR,5,1,-256,-1.5,-130,8.5,-101,-119,216,1.5,110,6.11,Yankee Stadium,6,4
2018-04-22,2018,LAD,WSH,4,3,-210,-1.5,-112,8.0,-115,-105,180,1.5,-108,5.42,Dodger Stadium,7,1
2018-04-23,2018,CIN,ATL,10,4,108,1.5,-155,8.5,-113,-107,-118,-1.5,135,4.09,Great American Ballpark,14,6
2018-04-23,2018,CLE,BAL,2,1,-185,-1.5,-123,8.0,-108,-112,165,1.5,103,5.19,Camden Yards,3,1
2018-04-23,2018,ATL,CIN,4,10,-118,-1.5,135,8.5,-113,-107,108,1.5,-155,4.6,Great American Ballpark,14,-6
2018-04-23,2018,BAL,CLE,1,2,165,1.5,103,8.0,-108,-112,-185,-1.5,-123,3.02,Camden Yards,3,-1
2018-04-23,2018,SD,COL,13,5,179,1.5,101,12.0,-101,-119,-199,-1.5,-121,4.3,Coors Field,18,8
2018-04-23,2018,SEA,CWS,4,10,-150,-1.5,103,9.5,-110,-110,135,1.5,-123,5.7,Guaranteed Rate Field,14,-6
2018-04-23,2018,LAA,HOU,2,0,173,1.5,-110,8.5,-122,102,-203,-1.5,-110,3.11,Minute Maid Park,2,2
2018-04-23,2018,HOU,LAA,0,2,-203,-1.5,-110,8.5,-122,102,173,1.5,-110,5.69,Minute Maid Park,2,-2
2018-04-23,2018,MIA,LAD,1,2,205,1.5,-103,8.0,-101,-119,-245,-1.5,-117,2.62,Dodger Stadium,3,-1
2018-04-23,2018,LAD,MIA,2,1,-245,-1.5,-117,8.0,-101,-119,205,1.5,-103,5.68,Dodger Stadium,3,1
2018-04-23,2018,NYY,MIN,14,1,-200,-1.5,-110,8.5,-120,100,170,1.5,-110,5.67,Yankee Stadium,15,13
2018-04-23,2018,MIN,NYY,1,14,170,1.5,-110,8.5,-120,100,-200,-1.5,-110,3.15,Yankee Stadium,15,-13
2018-04-23,2018,TEX,OAK,4,9,109,1.5,-145,10.0,-119,-101,-119,-1.5,125,4.78,Rangers Ballpark,13,-5
2018-04-23,2018,COL,SD,5,13,-199,-1.5,-121,12.0,-101,-119,179,1.5,101,7.99,Coors Field,18,-8
2018-04-23,2018,CWS,SEA,10,4,135,1.5,-123,9.5,-110,-110,-150,-1.5,103,4.04,Guaranteed Rate Field,14,6
2018-04-23,2018,WSH,SF,2,4,-111,-1.5,144,8.0,-110,-110,101,1.5,-165,4.21,AT&T Park,6,-2
2018-04-23,2018,OAK,TEX,9,4,-119,-1.5,125,10.0,-119,-101,109,1.5,-145,5.43,Rangers Ballpark,13,5
2018-04-23,2018,SF,WSH,4,2,101,1.5,-165,8.0,-110,-110,-111,-1.5,144,3.98,AT&T Park,6,2
2018-04-24,2018,PHI,ARI,4,8,-107,-1.5,188,7.5,105,-125,-103,1.5,-225,3.88,Citizens Bank Park,12,-4
2018-04-24,2018,CIN,ATL,9,7,-101,1.5,-170,8.5,-105,-115,-109,-1.5,148,4.27,Great American Ballpark,16,2
2018-04-24,2018,TOR,BOS,4,3,-115,-1.5,170,8.5,-110,-110,105,1.5,-200,4.55,Rogers Centre,7,1
2018-04-24,2018,CLE,CHC,3,10,-137,-1.5,148,9.0,-105,-115,122,1.5,-170,5.2,Progressive Field,13,-7
2018-04-24,2018,ATL,CIN,7,9,-109,-1.5,148,8.5,-105,-115,-101,1.5,-170,4.43,Great American Ballpark,16,-2
2018-04-24,2018,CHC,CLE,10,3,122,1.5,-170,9.0,-105,-115,-137,-1.5,148,4.05,Progressive Field,13,7
2018-04-24,2018,SD,COL,0,8,140,1.5,-130,10.0,100,-120,-155,-1.5,110,4.17,Coors Field,8,-8
2018-04-24,2018,SEA,CWS,1,0,-124,-1.5,120,9.5,-101,-119,114,1.5,-140,5.26,Guaranteed Rate Field,1,1
2018-04-24,2018,LAA,HOU,8,7,125,1.5,-165,8.0,102,-122,-140,-1.5,144,3.56,Minute Maid Park,15,1
2018-04-24,2018,MIL,KC,5,2,-131,-1.5,120,9.5,-102,-118,116,1.5,-140,5.39,Kauffman Stadium,7,3
2018-04-24,2018,HOU,LAA,7,8,-140,-1.5,144,8.0,102,-122,125,1.5,-165,4.67,Minute Maid Park,15,-1
2018-04-24,2018,MIA,LAD,3,2,220,1.5,110,7.5,-110,-110,-260,-1.5,-130,2.34,Dodger Stadium,5,1
2018-04-24,2018,LAD,MIA,2,3,-260,-1.5,-130,7.5,-110,-110,220,1.5,110,5.42,Dodger Stadium,5,-1
2018-04-24,2018,KC,MIL,2,5,116,1.5,-140,9.5,-102,-118,-131,-1.5,120,4.4,Kauffman Stadium,7,-3
2018-04-24,2018,NYY,MIN,8,3,-154,-1.5,125,8.5,-110,-110,139,1.5,-145,5.15,Yankee Stadium,11,5
2018-04-24,2018,STL,NYM,5,6,-195,-1.5,110,8.0,-108,-112,175,1.5,-130,5.29,Busch Stadium,11,-1
2018-04-24,2018,MIN,NYY,3,8,139,1.5,-145,8.5,-110,-110,-154,-1.5,125,3.56,Yankee Stadium,11,-5
2018-04-24,2018,TEX,OAK,2,3,-114,-1.5,155,10.0,-110,-110,104,1.5,-180,5.33,Rangers Ballpark,5,-1
2018-04-24,2018,ARI,PHI,8,4,-103,1.5,-225,7.5,105,-125,-107,-1.5,188,3.81,Citizens Bank Park,12,4
2018-04-24,2018,COL,SD,8,0,-155,-1.5,110,10.0,100,-120,140,1.5,-130,6.08,Coors Field,8,8
2018-04-24,2018,CWS,SEA,0,1,114,1.5,-140,9.5,-101,-119,-124,-1.5,120,4.44,Guaranteed Rate Field,1,-1
2018-04-24,2018,WSH,SF,3,4,-109,-1.5,144,8.0,-110,-110,-101,1.5,-165,4.17,AT&T Park,7,-1
2018-04-24,2018,NYM,STL,6,5,175,1.5,-130,8.0,-108,-112,-195,-1.5,110,2.91,Busch Stadium,11,1
2018-04-24,2018,OAK,TEX,3,2,104,1.5,-180,10.0,-110,-110,-114,-1.5,155,4.9,Rangers Ballpark,5,1
2018-04-24,2018,BOS,TOR,3,4,105,1.5,-200,8.5,-110,-110,-115,-1.5,170,4.15,Rogers Centre,7,-1
2018-04-24,2018,SF,WSH,4,3,-101,1.5,-165,8.0,-110,-110,-109,-1.5,144,4.02,AT&T Park,7,1
2018-04-25,2018,PHI,ARI,5,3,-105,-1.5,184,7.0,-120,100,-105,1.5,-220,3.59,Citizens Bank Park,8,2
2018-04-25,2018,CIN,ATL,4,5,-103,1.5,-166,9.5,-110,-110,-107,-1.5,145,4.82,Great American Ballpark,9,-1
2018-04-25,2018,TB,BAL,8,4,103,1.5,-210,9.0,-106,-114,-113,-1.5,176,4.43,Camden Yards,12,4
2018-04-25,2018,TOR,BOS,3,4,133,1.5,-121,9.0,-114,-106,-148,-1.5,101,3.86,Rogers Centre,7,-1
2018-04-25,2018,CLE,CHC,4,1,-138,-1.5,155,7.5,-101,-119,123,1.5,-180,4.35,Progressive Field,5,3
2018-04-25,2018,ATL,CIN,5,4,-107,-1.5,145,9.5,-110,-110,-103,1.5,-166,4.91,Great American Ballpark,9,1
2018-04-25,2018,CHC,CLE,1,4,123,1.5,-180,7.5,-101,-119,-138,-1.5,155,3.36,Progressive Field,5,-3
2018-04-25,2018,SD,COL,2,5,150,1.5,-135,9.5,-110,-110,-170,-1.5,115,3.8,Coors Field,7,-3
2018-04-25,2018,SEA,CWS,4,3,-138,-1.5,112,9.5,-105,-115,123,1.5,-132,5.51,Guaranteed Rate Field,7,1
2018-04-25,2018,PIT,DET,10,13,-207,-1.5,-105,7.5,-110,-110,177,1.5,-115,5.06,PNC Park,23,-3
2018-04-25,2018,PIT,DET,8,3,-160,-1.5,135,8.0,-104,-116,145,1.5,-155,4.92,PNC Park,11,5
2018-04-25,2018,LAA,HOU,2,5,186,1.5,-108,8.5,-110,-110,-216,-1.5,-112,2.97,Minute Maid Park,7,-3
2018-04-25,2018,MIL,KC,6,2,-105,-1.5,148,8.5,-112,-108,-105,1.5,-170,4.35,Kauffman Stadium,8,4
2018-04-25,2018,HOU,LAA,5,2,-216,-1.5,-112,8.5,-110,-110,186,1.5,-108,5.81,Minute Maid Park,7,3
2018-04-25,2018,MIA,LAD,8,6,330,1.5,146,7.0,-125,105,-390,-1.5,-168,1.63,Dodger Stadium,14,2
2018-04-25,2018,LAD,MIA,6,8,-390,-1.5,-168,7.0,-125,105,330,1.5,146,5.57,Dodger Stadium,14,-2
2018-04-25,2018,KC,MIL,2,6,-105,1.5,-170,8.5,-112,-108,-105,-1.5,148,4.35,Kauffman Stadium,8,-4
2018-04-25,2018,NYY,MIN,7,4,-175,-1.5,105,9.0,-115,-105,155,1.5,-125,5.73,Yankee Stadium,11,3
2018-04-25,2018,STL,NYM,9,1,-138,-1.5,155,8.5,100,-120,123,1.5,-180,4.93,Busch Stadium,10,8
2018-04-25,2018,MIN,NYY,4,7,155,1.5,-125,9.0,-115,-105,-175,-1.5,105,3.53,Yankee Stadium,11,-3
2018-04-25,2018,TEX,OAK,4,2,-107,-1.5,176,9.5,-105,-115,-103,1.5,-210,4.91,Rangers Ballpark,6,2
2018-04-25,2018,ARI,PHI,3,5,-105,1.5,-220,7.0,-120,100,-105,-1.5,184,3.59,Citizens Bank Park,8,-2
2018-04-25,2018,DET,PIT,13,10,177,1.5,-115,7.5,-110,-110,-207,-1.5,-105,2.71,PNC Park,23,3
2018-04-25,2018,DET,PIT,3,8,145,1.5,-155,8.0,-104,-116,-160,-1.5,135,3.27,PNC Park,11,-5
2018-04-25,2018,COL,SD,5,2,-170,-1.5,115,9.5,-110,-110,150,1.5,-135,5.98,Coors Field,7,3
2018-04-25,2018,CWS,SEA,3,4,123,1.5,-132,9.5,-105,-115,-138,-1.5,112,4.26,Guaranteed Rate Field,7,-1
2018-04-25,2018,WSH,SF,15,2,-165,-1.5,-105,7.0,-101,-119,150,1.5,-115,4.36,AT&T Park,17,13
2018-04-25,2018,NYM,STL,1,9,123,1.5,-180,8.5,100,-120,-138,-1.5,155,3.81,Busch Stadium,10,-8
2018-04-25,2018,BAL,TB,4,8,-113,-1.5,176,9.0,-106,-114,103,1.5,-210,4.77,Camden Yards,12,-4
2018-04-25,2018,OAK,TEX,2,4,-103,1.5,-210,9.5,-105,-115,-107,-1.5,176,4.82,Rangers Ballpark,6,-2
2018-04-25,2018,BOS,TOR,4,3,-148,-1.5,101,9.0,-114,-106,133,1.5,-121,5.37,Rogers Centre,7,1
2018-04-25,2018,SF,WSH,2,15,150,1.5,-115,7.0,-101,-119,-165,-1.5,-105,2.8,AT&T Park,17,-13
2018-04-26,2018,PHI,ARI,2,8,-128,-1.5,163,9.0,-119,-101,118,1.5,-190,5.05,Citizens Bank Park,10,-6
2018-04-26,2018,CIN,ATL,4,7,119,1.5,-144,9.0,-119,-101,-134,-1.5,124,4.11,Great American Ballpark,11,-3
2018-04-26,2018,TB,BAL,9,5,123,1.5,-179,7.5,-117,-103,-138,-1.5,154,3.36,Camden Yards,14,4
2018-04-26,2018,TOR,BOS,4,5,192,1.5,125,8.0,101,-121,-222,-1.5,-145,2.74,Rogers Centre,9,-1
2018-04-26,2018,MIL,CHC,0,1,150,1.5,-145,8.5,-115,-105,-165,-1.5,125,3.4,Wrigley Field,1,-1
2018-04-26,2018,ATL,CIN,7,4,-134,-1.5,124,9.0,-119,-101,119,1.5,-144,5.15,Great American Ballpark,11,3
2018-04-26,2018,SEA,CLE,5,4,101,1.5,-215,7.5,-117,-103,-111,-1.5,180,3.73,Progressive Field,9,1
2018-04-26,2018,KC,CWS,3,6,-173,-1.5,110,9.0,-120,100,153,1.5,-130,5.7,Kauffman Stadium,9,-3
2018-04-26,2018,PIT,DET,1,0,-158,-1.5,140,7.5,-110,-110,143,1.5,-160,4.59,PNC Park,1,1
2018-04-26,2018,CWS,KC,6,3,153,1.5,-130,9.0,-120,100,-173,-1.5,110,3.56,Kauffman Stadium,9,3
2018-04-26,2018,CHC,MIL,1,0,-165,-1.5,125,8.5,-115,-105,150,1.5,-145,5.29,Wrigley Field,1,1
2018-04-26,2018,NYY,MIN,4,3,-215,-1.5,-119,10.0,-111,-109,185,1.5,-101,6.83,Yankee Stadium,7,1
2018-04-26,2018,STL,NYM,4,3,-105,1.5,-175,7.5,106,-126,-105,-1.5,151,3.84,Busch Stadium,7,1
2018-04-26,2018,MIN,NYY,3,4,185,1.5,-101,10.0,-111,-109,-215,-1.5,-119,3.51,Yankee Stadium,7,-1
2018-04-26,2018,ARI,PHI,8,2,118,1.5,-190,9.0,-119,-101,-128,-1.5,163,4.13,Citizens Bank Park,10,6
2018-04-26,2018,DET,PIT,0,1,143,1.5,-160,7.5,-110,-110,-158,-1.5,140,3.09,PNC Park,1,-1
2018-04-26,2018,CLE,SEA,4,5,-111,-1.5,180,7.5,-117,-103,101,1.5,-215,3.95,Progressive Field,9,-1
2018-04-26,2018,NYM,STL,3,4,-105,-1.5,151,7.5,106,-126,-105,1.5,-175,3.84,Busch Stadium,7,-1
2018-04-26,2018,BAL,TB,5,9,-138,-1.5,154,7.5,-117,-103,123,1.5,-179,4.35,Camden Yards,14,-4
2018-04-26,2018,BOS,TOR,5,4,-222,-1.5,-145,8.0,101,-121,192,1.5,125,5.52,Rogers Centre,9,1
2018-04-27,2018,WSH,ARI,4,5,-144,-1.5,160,7.0,-105,-115,129,1.5,-185,4.13,Nationals Park,9,-1
2018-04-27,2018,PHI,ATL,7,3,-166,-1.5,125,8.0,-105,-115,151,1.5,-145,4.99,Citizens Bank Park,10,4
2018-04-27,2018,DET,BAL,0,6,116,1.5,-173,9.5,-118,-102,-126,-1.5,149,4.4,Camden Yards,6,-6
2018-04-27,2018,TB,BOS,4,3,140,1.5,-150,8.5,-109,-111,-155,-1.5,130,3.54,Fenway Park,7,1
2018-04-27,2018,MIL,CHC,2,3,150,1.5,-143,7.5,105,-125,-165,-1.5,123,3.0,Wrigley Field,5,-1
2018-04-27,2018,MIN,CIN,9,15,-111,-1.5,172,9.5,-104,-116,101,1.5,-205,5.0,Target Field,24,-6
2018-04-27,2018,SEA,CLE,5,6,220,1.5,104,8.0,-108,-112,-260,-1.5,-124,2.5,Progressive Field,11,-1
2018-04-27,2018,MIA,COL,0,1,117,1.5,-147,8.0,-109,-111,-127,-1.5,127,3.69,Marlins Park,1,-1
2018-04-27,2018,KC,CWS,4,7,-109,-1.5,170,9.0,-118,-102,-101,1.5,-200,4.69,Kauffman Stadium,11,-3
2018-04-27,2018,BAL,DET,6,0,-126,-1.5,149,9.5,-118,-102,116,1.5,-173,5.3,Camden Yards,6,6
2018-04-27,2018,OAK,HOU,8,1,161,1.5,-130,8.5,-119,-101,-181,-1.5,110,3.26,Minute Maid Park,9,7
2018-04-27,2018,CWS,KC,7,4,-101,1.5,-200,9.0,-118,-102,-109,-1.5,170,4.52,Kauffman Stadium,11,3
2018-04-27,2018,NYY,LAA,4,3,-138,-1.5,118,8.0,-105,-115,123,1.5,-138,4.64,Angel Stadium,7,1
2018-04-27,2018,SF,LAD,6,4,111,1.5,-160,8.0,100,-120,-121,-1.5,140,3.79,AT&T Park,10,2
2018-04-27,2018,COL,MIA,1,0,-127,-1.5,127,8.0,-109,-111,117,1.5,-147,4.48,Marlins Park,1,1
2018-04-27,2018,CHC,MIL,3,2,-165,-1.5,123,7.5,105,-125,150,1.5,-143,4.67,Wrigley Field,5,1
2018-04-27,2018,CIN,MIN,15,9,101,1.5,-205,9.5,-104,-116,-111,-1.5,172,4.73,Target Field,24,6
2018-04-27,2018,SD,NYM,1,5,152,1.5,-108,7.0,103,-123,-167,-1.5,-112,2.78,PETCO Park,6,-4
2018-04-27,2018,LAA,NYY,3,4,123,1.5,-138,8.0,-105,-115,-138,-1.5,118,3.59,Angel Stadium,7,-1
2018-04-27,2018,HOU,OAK,1,8,-181,-1.5,110,8.5,-119,-101,161,1.5,-130,5.48,Minute Maid Park,9,-7
2018-04-27,2018,ATL,PHI,3,7,151,1.5,-145,8.0,-105,-115,-166,-1.5,125,3.19,Citizens Bank Park,10,-4
2018-04-27,2018,STL,PIT,5,6,-124,-1.5,132,8.5,-120,100,114,1.5,-152,4.71,PNC Park,11,-1
2018-04-27,2018,NYM,SD,5,1,-167,-1.5,-112,7.0,103,-123,152,1.5,-108,4.38,PETCO Park,6,4
2018-04-27,2018,CLE,SEA,6,5,-260,-1.5,-124,8.0,-108,-112,220,1.5,104,5.78,Progressive Field,11,1
2018-04-27,2018,LAD,SF,4,6,-121,-1.5,140,8.0,100,-120,111,1.5,-160,4.38,AT&T Park,10,-2
2018-04-27,2018,PIT,STL,6,5,114,1.5,-152,8.5,-120,100,-124,-1.5,132,3.97,PNC Park,11,1
2018-04-27,2018,BOS,TB,3,4,-155,-1.5,130,8.5,-109,-111,140,1.5,-150,5.17,Fenway Park,7,-1
2018-04-27,2018,TOR,TEX,4,6,-147,-1.5,130,9.0,100,-120,132,1.5,-148,5.36,Rogers Centre,10,-2
2018-04-27,2018,TEX,TOR,6,4,132,1.5,-148,9.0,100,-120,-147,-1.5,130,3.88,Rogers Centre,10,2
2018-04-27,2018,ARI,WSH,5,4,129,1.5,-185,7.0,-105,-115,-144,-1.5,160,3.06,Nationals Park,9,1
2018-04-28,2018,WSH,ARI,3,4,116,1.5,-140,8.0,-101,-119,-131,-1.5,120,3.7,Nationals Park,7,-1
2018-04-28,2018,PHI,ATL,1,4,-119,-1.5,170,8.5,-109,-111,109,1.5,-200,4.62,Citizens Bank Park,5,-3
2018-04-28,2018,DET,BAL,9,5,125,1.5,-165,9.0,108,-128,-140,-1.5,144,4.0,Camden Yards,14,4
2018-04-28,2018,TB,BOS,12,6,185,1.5,-110,9.0,-120,100,-215,-1.5,-110,3.16,Fenway Park,18,6
2018-04-28,2018,MIL,CHC,0,3,153,1.5,-155,7.0,-110,-110,-168,-1.5,135,2.77,Wrigley Field,3,-3
2018-04-28,2018,MIN,CIN,3,1,-148,-1.5,125,10.5,-105,-115,133,1.5,-145,6.27,Target Field,4,2
2018-04-28,2018,SEA,CLE,12,4,200,1.5,100,7.5,-115,-105,-230,-1.5,-120,2.5,Progressive Field,16,8
2018-04-28,2018,MIA,COL,4,1,105,1.5,-160,8.0,-105,-115,-115,-1.5,140,3.9,Marlins Park,5,3
2018-04-28,2018,KC,CWS,0,8,-132,-1.5,155,9.5,-114,-106,117,1.5,-180,5.41,Kauffman Stadium,8,-8
2018-04-28,2018,KC,CWS,5,2,-148,-1.5,135,10.0,-110,-110,133,1.5,-155,5.97,Kauffman Stadium,7,3
2018-04-28,2018,BAL,DET,5,9,-140,-1.5,144,9.0,108,-128,125,1.5,-165,5.25,Camden Yards,14,-4
2018-04-28,2018,OAK,HOU,0,11,193,1.5,-110,9.0,-116,-104,-223,-1.5,-110,3.07,Minute Maid Park,11,-11
2018-04-28,2018,CWS,KC,8,0,117,1.5,-180,9.5,-114,-106,-132,-1.5,155,4.38,Kauffman Stadium,8,8
2018-04-28,2018,CWS,KC,2,5,133,1.5,-155,10.0,-110,-110,-148,-1.5,135,4.29,Kauffman Stadium,7,-3
2018-04-28,2018,NYY,LAA,11,1,-108,-1.5,148,7.5,-118,-102,-102,1.5,-170,3.89,Angel Stadium,12,10
2018-04-28,2018,SF,LAD,6,15,150,1.5,-114,8.0,-101,-119,-165,-1.5,-106,3.2,AT&T Park,21,-9
2018-04-28,2018,SF,LAD,8,3,100,1.5,-170,6.5,-125,105,-110,-1.5,148,3.25,AT&T Park,11,5
2018-04-28,2018,COL,MIA,1,4,-115,-1.5,140,8.0,-105,-115,105,1.5,-160,4.28,Marlins Park,5,-3
2018-04-28,2018,CHC,MIL,3,0,-168,-1.5,135,7.0,-110,-110,153,1.5,-155,4.39,Wrigley Field,3,3
2018-04-28,2018,CIN,MIN,1,3,133,1.5,-145,10.5,-105,-115,-148,-1.5,125,4.51,Target Field,4,-2
2018-04-28,2018,SD,NYM,12,2,-143,-1.5,160,7.0,-121,101,128,1.5,-185,4.12,PETCO Park,14,10
2018-04-28,2018,LAA,NYY,1,11,-102,1.5,-170,7.5,-118,-102,-108,-1.5,148,3.79,Angel Stadium,12,-10
2018-04-28,2018,HOU,OAK,11,0,-223,-1.5,-110,9.0,-116,-104,193,1.5,-110,6.21,Minute Maid Park,11,11
2018-04-28,2018,ATL,PHI,4,1,109,1.5,-200,8.5,-109,-111,-119,-1.5,170,4.07,Citizens Bank Park,5,3
2018-04-28,2018,STL,PIT,2,6,-128,-1.5,134,8.5,-101,-119,118,1.5,-154,4.77,PNC Park,8,-4
2018-04-28,2018,NYM,SD,2,12,128,1.5,-185,7.0,-121,101,-143,-1.5,160,3.07,PETCO Park,14,-10
2018-04-28,2018,CLE,SEA,4,12,-230,-1.5,-120,7.5,-115,-105,200,1.5,100,5.23,Progressive Field,16,-8
2018-04-28,2018,LAD,SF,15,6,-165,-1.5,-106,8.0,-101,-119,150,1.5,-114,4.98,AT&T Park,21,9
2018-04-28,2018,LAD,SF,3,8,-110,-1.5,148,6.5,-125,105,100,1.5,-170,3.4,AT&T Park,11,-5
2018-04-28,2018,PIT,STL,6,2,118,1.5,-154,8.5,-101,-119,-128,-1.5,134,3.9,PNC Park,8,4
2018-04-28,2018,BOS,TB,6,12,-215,-1.5,-110,9.0,-120,100,185,1.5,-110,6.14,Fenway Park,18,-6
2018-04-28,2018,TOR,TEX,4,7,-153,-1.5,128,9.0,103,-123,138,1.5,-146,5.44,Rogers Centre,11,-3
2018-04-28,2018,TEX,TOR,7,4,138,1.5,-146,9.0,103,-123,-153,-1.5,128,3.78,Rogers Centre,11,3
2018-04-28,2018,ARI,WSH,4,3,-131,-1.5,120,8.0,-101,-119,116,1.5,-140,4.54,Nationals Park,7,1
2018-04-29,2018,WSH,ARI,3,1,-118,-1.5,188,7.0,-118,-102,108,1.5,-225,3.79,Nationals Park,4,2
2018-04-29,2018,PHI,ATL,1,10,-111,-1.5,176,8.5,-109,-111,101,1.5,-210,4.47,Citizens Bank Park,11,-9
2018-04-29,2018,DET,BAL,3,5,145,1.5,-150,8.5,102,-122,-160,-1.5,130,3.47,Camden Yards,8,-2
2018-04-29,2018,TB,BOS,3,4,185,1.5,-110,8.5,-114,-106,-215,-1.5,-110,2.98,Fenway Park,7,-1
2018-04-29,2018,MIL,CHC,0,2,137,1.5,-165,8.5,-120,100,-152,-1.5,144,3.59,Wrigley Field,2,-2
2018-04-29,2018,MIN,CIN,2,8,-190,-1.5,-104,9.0,-113,-107,170,1.5,-116,5.9,Target Field,10,-6
2018-04-29,2018,SEA,CLE,10,4,-101,1.5,-205,8.5,-114,-106,-109,-1.5,172,4.27,Progressive Field,14,6
2018-04-29,2018,MIA,COL,3,0,101,1.5,-160,7.5,-105,-115,-111,-1.5,140,3.73,Marlins Park,3,3
2018-04-29,2018,KC,CWS,5,4,-115,-1.5,170,9.5,-103,-117,105,1.5,-200,5.08,Kauffman Stadium,9,1
2018-04-29,2018,BAL,DET,5,3,-160,-1.5,130,8.5,102,-122,145,1.5,-150,5.23,Camden Yards,8,2
2018-04-29,2018,OAK,HOU,4,8,175,1.5,-115,8.0,-110,-110,-205,-1.5,-105,2.91,Minute Maid Park,12,-4
2018-04-29,2018,CWS,KC,4,5,105,1.5,-200,9.5,-103,-117,-115,-1.5,170,4.63,Kauffman Stadium,9,-1
2018-04-29,2018,NYY,LAA,2,1,114,1.5,-200,9.0,-115,-105,-124,-1.5,170,4.21,Angel Stadium,3,1
2018-04-29,2018,SF,LAD,4,2,127,1.5,-130,8.0,-101,-119,-142,-1.5,110,3.52,AT&T Park,6,2
2018-04-29,2018,COL,MIA,0,3,-111,-1.5,140,7.5,-105,-115,101,1.5,-160,3.95,Marlins Park,3,-3
2018-04-29,2018,CHC,MIL,2,0,-152,-1.5,144,8.5,-120,100,137,1.5,-165,5.13,Wrigley Field,2,2
2018-04-29,2018,CIN,MIN,8,2,170,1.5,-116,9.0,-113,-107,-190,-1.5,-104,3.33,Target Field,10,6
2018-04-29,2018,SD,NYM,2,14,125,1.5,-130,8.5,-118,-102,-140,-1.5,110,3.78,PETCO Park,16,-12
2018-04-29,2018,LAA,NYY,1,2,-124,-1.5,170,9.0,-115,-105,114,1.5,-200,4.98,Angel Stadium,3,-1
2018-04-29,2018,HOU,OAK,8,4,-205,-1.5,-105,8.0,-110,-110,175,1.5,-115,5.38,Minute Maid Park,12,4
2018-04-29,2018,ATL,PHI,10,1,101,1.5,-210,8.5,-109,-111,-111,-1.5,176,4.23,Citizens Bank Park,11,9
2018-04-29,2018,STL,PIT,0,5,-121,-1.5,138,8.0,-105,-115,111,1.5,-158,4.38,PNC Park,5,-5
2018-04-29,2018,NYM,SD,14,2,-140,-1.5,110,8.5,-118,-102,125,1.5,-130,4.96,PETCO Park,16,12
2018-04-29,2018,CLE,SEA,4,10,-109,-1.5,172,8.5,-114,-106,-101,1.5,-205,4.43,Progressive Field,14,-6
2018-04-29,2018,LAD,SF,2,4,-142,-1.5,110,8.0,-101,-119,127,1.5,-130,4.69,AT&T Park,6,-2
2018-04-29,2018,PIT,STL,5,0,111,1.5,-158,8.0,-105,-115,-121,-1.5,138,3.79,PNC Park,5,5
2018-04-29,2018,BOS,TB,4,3,-215,-1.5,-110,8.5,-114,-106,185,1.5,-110,5.8,Fenway Park,7,1
2018-04-29,2018,TOR,TEX,7,2,-245,-1.5,-132,9.0,-110,-110,205,1.5,112,6.39,Rogers Centre,9,5
2018-04-29,2018,TEX,TOR,2,7,205,1.5,112,9.0,-110,-110,-245,-1.5,-132,2.95,Rogers Centre,9,-5
2018-04-29,2018,ARI,WSH,1,3,108,1.5,-225,7.0,-118,-102,-118,-1.5,188,3.37,Nationals Park,4,-2
2018-04-30,2018,LAD,ARI,5,8,131,1.5,-170,8.0,-101,-119,-146,-1.5,148,3.46,Chase Field,13,-3
2018-04-30,2018,KC,BOS,6,10,200,1.5,110,8.5,-109,-111,-240,-1.5,-130,2.83,Fenway Park,16,-4
2018-04-30,2018,COL,CHC,2,3,170,1.5,-110,10.0,-120,100,-200,-1.5,-110,3.7,Wrigley Field,5,-1
2018-04-30,2018,MIL,CIN,6,5,-119,-1.5,135,9.5,-107,-113,109,1.5,-155,5.16,Great American Ballpark,11,1
2018-04-30,2018,TEX,CLE,5,7,166,1.5,-128,8.0,-119,-101,-186,-1.5,108,3.01,Progressive Field,12,-2
2018-04-30,2018,CHC,COL,3,2,-200,-1.5,-110,10.0,-120,100,170,1.5,-110,6.67,Wrigley Field,5,1
2018-04-30,2018,TB,DET,3,2,-134,-1.5,123,8.5,-105,-115,119,1.5,-143,4.87,Comerica Park,5,1
2018-04-30,2018,NYY,HOU,1,2,157,1.5,-131,8.5,-102,-118,-177,-1.5,111,3.31,Minute Maid Park,3,-1
2018-04-30,2018,BOS,KC,10,6,-240,-1.5,-130,8.5,-109,-111,200,1.5,110,6.0,Fenway Park,16,4
2018-04-30,2018,ARI,LAD,8,5,-146,-1.5,148,8.0,-101,-119,131,1.5,-170,4.75,Chase Field,13,3
2018-04-30,2018,PHI,MIA,4,8,-153,-1.5,-105,7.5,-110,-110,138,1.5,-115,4.54,Marlins Park,12,-4
2018-04-30,2018,CIN,MIL,5,6,109,1.5,-155,9.5,-107,-113,-119,-1.5,135,4.55,Great American Ballpark,11,-1
2018-04-30,2018,TOR,MIN,7,5,108,1.5,-195,10.0,-101,-119,-118,-1.5,166,4.81,Target Field,12,2
2018-04-30,2018,HOU,NYY,2,1,-177,-1.5,111,8.5,-102,-118,157,1.5,-131,5.43,Minute Maid Park,3,1
2018-04-30,2018,MIA,PHI,8,4,138,1.5,-115,7.5,-110,-110,-153,-1.5,-105,3.15,Marlins Park,12,4
2018-04-30,2018,WSH,PIT,3,2,-116,-1.5,179,8.0,-117,-103,106,1.5,-214,4.3,Nationals Park,5,1
2018-04-30,2018,SF,SD,6,5,-170,-1.5,120,7.5,-120,100,150,1.5,-140,4.72,AT&T Park,11,1
2018-04-30,2018,SD,SF,5,6,150,1.5,-140,7.5,-120,100,-170,-1.5,120,3.0,AT&T Park,11,-1
2018-04-30,2018,DET,TB,2,3,119,1.5,-143,8.5,-105,-115,-134,-1.5,123,3.88,Comerica Park,5,-1
2018-04-30,2018,CLE,TEX,7,5,-186,-1.5,108,8.0,-119,-101,166,1.5,-128,5.2,Progressive Field,12,2
2018-04-30,2018,MIN,TOR,5,7,-118,-1.5,166,10.0,-101,-119,108,1.5,-195,5.41,Target Field,12,-2
2018-04-30,2018,PIT,WSH,2,3,106,1.5,-214,8.0,-117,-103,-116,-1.5,179,3.88,Nationals Park,5,-1
2018-05-01,2018,LAD,ARI,3,4,-205,-1.5,-120,7.5,-115,-105,175,1.5,100,5.04,Chase Field,7,-1
2018-05-01,2018,NYM,ATL,2,3,-183,-1.5,120,7.0,-123,103,163,1.5,-140,4.53,Citi Field,5,-1
2018-05-01,2018,LAA,BAL,3,2,-190,-1.5,100,8.5,-119,-101,170,1.5,-120,5.57,Angel Stadium,5,1
2018-05-01,2018,KC,BOS,7,6,275,1.5,141,8.5,-110,-110,-325,-1.5,-161,2.27,Fenway Park,13,1
2018-05-01,2018,COL,CHC,3,1,138,1.5,-149,10.5,-101,-119,-153,-1.5,129,4.41,Wrigley Field,4,2
2018-05-01,2018,MIL,CIN,7,6,-119,-1.5,135,9.5,-105,-115,109,1.5,-155,5.16,Great American Ballpark,13,1
2018-05-01,2018,TEX,CLE,8,6,175,1.5,-112,9.5,-106,-114,-195,-1.5,-108,3.45,Progressive Field,14,2
2018-05-01,2018,CHC,COL,1,3,-153,-1.5,129,10.5,-101,-119,138,1.5,-149,6.35,Wrigley Field,4,-2
2018-05-01,2018,STL,CWS,3,2,-240,-1.5,-125,9.5,-105,-115,200,1.5,105,6.71,Busch Stadium,5,1
2018-05-01,2018,TB,DET,1,2,-163,-1.5,-101,8.5,-110,-110,148,1.5,-119,5.27,Comerica Park,3,-1
2018-05-01,2018,NYY,HOU,4,0,150,1.5,-140,8.5,-105,-115,-170,-1.5,120,3.4,Minute Maid Park,4,4
2018-05-01,2018,BOS,KC,6,7,-325,-1.5,-161,8.5,-110,-110,275,1.5,141,6.5,Fenway Park,13,-1
2018-05-01,2018,BAL,LAA,2,3,170,1.5,-120,8.5,-119,-101,-190,-1.5,100,3.15,Angel Stadium,5,-1
2018-05-01,2018,ARI,LAD,4,3,175,1.5,100,7.5,-115,-105,-205,-1.5,-120,2.73,Chase Field,7,1
2018-05-01,2018,PHI,MIA,1,2,-108,1.5,-230,9.0,-105,-115,-102,-1.5,192,4.67,Marlins Park,3,-1
2018-05-01,2018,CIN,MIL,6,7,109,1.5,-155,9.5,-105,-115,-119,-1.5,135,4.55,Great American Ballpark,13,-1
2018-05-01,2018,TOR,MIN,7,4,117,1.5,-180,9.0,105,-125,-127,-1.5,155,4.15,Target Field,11,3
2018-05-01,2018,ATL,NYM,3,2,163,1.5,-140,7.0,-123,103,-183,-1.5,120,2.66,Citi Field,5,1
2018-05-01,2018,HOU,NYY,0,4,-170,-1.5,120,8.5,-105,-115,150,1.5,-140,5.35,Minute Maid Park,4,-4
2018-05-01,2018,SEA,OAK,6,3,-115,-1.5,170,9.0,-105,-115,105,1.5,-200,4.81,T-Mobile Park,9,3
2018-05-01,2018,MIA,PHI,2,1,-102,-1.5,192,9.0,-105,-115,-108,1.5,-230,4.54,Marlins Park,3,1
2018-05-01,2018,WSH,PIT,12,4,-235,-1.5,-110,7.5,-105,-115,205,1.5,-110,5.26,Nationals Park,16,8
2018-05-01,2018,SF,SD,2,3,-144,-1.5,151,7.5,105,-125,129,1.5,-175,4.43,AT&T Park,5,-1
2018-05-01,2018,OAK,SEA,3,6,105,1.5,-200,9.0,-105,-115,-115,-1.5,170,4.39,T-Mobile Park,9,-3
2018-05-01,2018,SD,SF,3,2,129,1.5,-175,7.5,105,-125,-144,-1.5,151,3.28,AT&T Park,5,1
2018-05-01,2018,CWS,STL,2,3,200,1.5,105,9.5,-105,-115,-240,-1.5,-125,3.17,Busch Stadium,5,-1
2018-05-01,2018,DET,TB,2,1,148,1.5,-119,8.5,-110,-110,-163,-1.5,-101,3.43,Comerica Park,3,1
2018-05-01,2018,CLE,TEX,6,8,-195,-1.5,-108,9.5,-106,-114,175,1.5,-112,6.28,Progressive Field,14,-2
2018-05-01,2018,MIN,TOR,4,7,-127,-1.5,155,9.0,105,-125,117,1.5,-180,5.04,Target Field,11,-3
2018-05-01,2018,PIT,WSH,4,12,205,1.5,-110,7.5,-105,-115,-235,-1.5,-110,2.46,Nationals Park,16,-8
2018-05-02,2018,LAD,ARI,2,1,-102,1.5,-215,7.5,-101,-119,-108,-1.5,180,3.79,Chase Field,3,1
2018-05-02,2018,NYM,ATL,0,7,-151,-1.5,140,7.5,-101,-119,136,1.5,-160,4.51,Citi Field,7,-7
2018-05-02,2018,LAA,BAL,10,7,-152,-1.5,140,7.5,100,-120,137,1.5,-160,4.52,Angel Stadium,17,3
2018-05-02,2018,KC,BOS,4,5,160,1.5,-119,11.0,105,-125,-180,-1.5,-101,4.23,Fenway Park,9,-1
2018-05-02,2018,COL,CHC,11,2,195,1.5,105,10.5,-105,-115,-225,-1.5,-125,3.56,Wrigley Field,13,9
2018-05-02,2018,MIL,CIN,3,1,-111,-1.5,139,9.5,-110,-110,101,1.5,-159,5.0,Great American Ballpark,4,2
2018-05-02,2018,TEX,CLE,4,12,252,1.5,126,9.0,-110,-110,-302,-1.5,-145,2.56,Progressive Field,16,-8
2018-05-02,2018,CHC,COL,2,11,-225,-1.5,-125,10.5,-105,-115,195,1.5,105,7.27,Wrigley Field,13,-9
2018-05-02,2018,STL,CWS,3,2,-260,-1.5,-139,9.5,-105,-115,220,1.5,119,6.86,Busch Stadium,5,1
2018-05-02,2018,TB,DET,2,3,-128,-1.5,126,8.0,-121,101,118,1.5,-146,4.49,Comerica Park,5,-1
2018-05-02,2018,NYY,HOU,4,0,-129,-1.5,125,8.5,-103,-117,119,1.5,-145,4.79,Minute Maid Park,4,4
2018-05-02,2018,BOS,KC,5,4,-180,-1.5,-101,11.0,105,-125,160,1.5,-119,7.07,Fenway Park,9,1
2018-05-02,2018,BAL,LAA,7,10,137,1.5,-160,7.5,100,-120,-152,-1.5,140,3.16,Angel Stadium,17,-3
2018-05-02,2018,ARI,LAD,1,2,-108,-1.5,180,7.5,-101,-119,-102,1.5,-215,3.89,Chase Field,3,-1
2018-05-02,2018,PHI,MIA,6,0,-177,-1.5,-110,7.0,-125,105,157,1.5,-110,4.47,Marlins Park,6,6
2018-05-02,2018,CIN,MIL,1,3,101,1.5,-159,9.5,-110,-110,-111,-1.5,139,4.73,Great American Ballpark,4,-2
2018-05-02,2018,TOR,MIN,0,4,-108,-1.5,144,9.0,-115,-105,-102,1.5,-165,4.67,Target Field,4,-4
2018-05-02,2018,ATL,NYM,7,0,136,1.5,-160,7.5,-101,-119,-151,-1.5,140,3.18,Citi Field,7,7
2018-05-02,2018,HOU,NYY,0,4,119,1.5,-145,8.5,-103,-117,-129,-1.5,125,3.88,Minute Maid Park,4,-4
2018-05-02,2018,SEA,OAK,2,3,-172,-1.5,115,8.0,-105,-115,152,1.5,-135,5.06,T-Mobile Park,5,-1
2018-05-02,2018,MIA,PHI,0,6,157,1.5,-110,7.0,-125,105,-177,-1.5,-110,2.72,Marlins Park,6,-6
2018-05-02,2018,WSH,PIT,9,3,-190,-1.5,110,7.5,-119,-101,170,1.5,-130,4.91,Nationals Park,12,6
2018-05-02,2018,SF,SD,9,4,-118,-1.5,166,8.0,-115,-105,108,1.5,-195,4.33,AT&T Park,13,5
2018-05-02,2018,OAK,SEA,3,2,152,1.5,-135,8.0,-105,-115,-172,-1.5,115,3.17,T-Mobile Park,5,1
2018-05-02,2018,SD,SF,4,9,108,1.5,-195,8.0,-115,-105,-118,-1.5,166,3.85,AT&T Park,13,-5
2018-05-02,2018,CWS,STL,2,3,220,1.5,119,9.5,-105,-115,-260,-1.5,-139,2.97,Busch Stadium,5,-1
2018-05-02,2018,DET,TB,3,2,118,1.5,-146,8.0,-121,101,-128,-1.5,126,3.67,Comerica Park,5,1
2018-05-02,2018,CLE,TEX,12,4,-302,-1.5,-145,9.0,-110,-110,252,1.5,126,6.76,Progressive Field,16,8
2018-05-02,2018,MIN,TOR,4,0,-102,1.5,-165,9.0,-115,-105,-108,-1.5,144,4.54,Target Field,4,4
2018-05-02,2018,PIT,WSH,3,9,170,1.5,-130,7.5,-119,-101,-190,-1.5,110,2.78,Nationals Park,12,-6
2018-05-03,2018,LAD,ARI,5,2,143,1.5,-175,7.0,-105,-115,-158,-1.5,151,2.88,Chase Field,7,3
2018-05-03,2018,NYM,ATL,0,11,-115,-1.5,176,9.5,100,-120,105,1.5,-210,5.08,Citi Field,11,-11
2018-05-03,2018,LAA,BAL,12,3,-175,-1.5,110,10.0,-115,-105,155,1.5,-130,6.36,Angel Stadium,15,9
2018-05-03,2018,TEX,BOS,11,5,137,1.5,-115,9.0,-120,100,-152,-1.5,-105,3.8,Rangers Ballpark,16,6
2018-05-03,2018,TOR,CLE,13,11,160,1.5,-125,9.0,105,-125,-180,-1.5,105,3.46,Progressive Field,24,2
2018-05-03,2018,TOR,CLE,4,13,135,1.5,-150,10.0,-103,-117,-150,-1.5,130,4.26,Progressive Field,17,-9
2018-05-03,2018,MIN,CWS,5,6,-126,-1.5,135,9.0,-105,-115,116,1.5,-155,5.02,Guaranteed Rate Field,11,-1
2018-05-03,2018,KC,DET,10,6,-138,-1.5,144,9.5,-119,-101,123,1.5,-164,5.51,Kauffman Stadium,16,4
2018-05-03,2018,NYY,HOU,6,5,105,1.5,-205,8.0,100,-120,-115,-1.5,172,3.9,Minute Maid Park,11,1
2018-05-03,2018,DET,KC,6,10,123,1.5,-164,9.5,-119,-101,-138,-1.5,144,4.26,Kauffman Stadium,16,-4
2018-05-03,2018,BAL,LAA,3,12,155,1.5,-130,10.0,-115,-105,-175,-1.5,110,3.92,Angel Stadium,15,-9
2018-05-03,2018,ARI,LAD,2,5,-158,-1.5,151,7.0,-105,-115,143,1.5,-175,4.29,Chase Field,7,-3
2018-05-03,2018,CWS,MIN,6,5,116,1.5,-155,9.0,-105,-115,-126,-1.5,135,4.17,Guaranteed Rate Field,11,1
2018-05-03,2018,ATL,NYM,11,0,105,1.5,-210,9.5,100,-120,-115,-1.5,176,4.63,Citi Field,11,11
2018-05-03,2018,HOU,NYY,5,6,-115,-1.5,172,8.0,100,-120,105,1.5,-205,4.28,Minute Maid Park,11,-1
2018-05-03,2018,SEA,OAK,4,1,105,1.5,-160,8.5,-115,-105,-115,-1.5,140,4.15,T-Mobile Park,5,3
2018-05-03,2018,WSH,PIT,3,1,-136,-1.5,149,9.5,-120,100,121,1.5,-173,5.47,Nationals Park,4,2
2018-05-03,2018,OAK,SEA,1,4,-115,-1.5,140,8.5,-115,-105,105,1.5,-160,4.55,T-Mobile Park,5,-3
2018-05-03,2018,BOS,TEX,5,11,-152,-1.5,-105,9.0,-120,100,137,1.5,-115,5.43,Rangers Ballpark,16,-6
2018-05-03,2018,CLE,TOR,11,13,-180,-1.5,105,9.0,105,-125,160,1.5,-125,5.79,Progressive Field,24,-2
2018-05-03,2018,CLE,TOR,13,4,-150,-1.5,130,10.0,-103,-117,135,1.5,-150,6.0,Progressive Field,17,9
2018-05-03,2018,PIT,WSH,1,3,121,1.5,-173,9.5,-120,100,-136,-1.5,149,4.3,Nationals Park,4,-2
2018-05-04,2018,HOU,ARI,8,0,-190,-1.5,-119,8.5,-110,-110,170,1.5,-101,5.57,Chase Field,8,8
2018-05-04,2018,SF,ATL,9,4,135,1.5,-165,9.0,-115,-105,-150,-1.5,144,3.83,Suntrust Park,13,5
2018-05-04,2018,OAK,BAL,6,4,-188,-1.5,106,9.5,-105,-115,168,1.5,-126,6.2,Oakland Coliseum,10,2
2018-05-04,2018,TEX,BOS,1,5,152,1.5,-101,9.0,-105,-115,-172,-1.5,-119,3.57,Rangers Ballpark,6,-4
2018-05-04,2018,STL,CHC,3,2,-111,-1.5,176,8.0,-120,100,101,1.5,-210,4.21,Busch Stadium,5,1
2018-05-04,2018,MIA,CIN,1,4,-103,1.5,-210,9.0,-105,-115,-107,-1.5,176,4.57,Great American Ballpark,5,-3
2018-05-04,2018,NYY,CLE,7,6,-210,-1.5,-120,11.0,107,-127,180,1.5,100,7.45,Yankee Stadium,13,1
2018-05-04,2018,NYM,COL,7,8,-121,-1.5,160,8.5,100,-120,111,1.5,-185,4.65,Citi Field,15,-1
2018-05-04,2018,MIN,CWS,6,4,-162,-1.5,-110,9.0,-110,-110,147,1.5,-110,5.56,Guaranteed Rate Field,10,2
2018-05-04,2018,KC,DET,4,2,-145,-1.5,136,9.0,-119,-101,130,1.5,-156,5.33,Kauffman Stadium,6,2
2018-05-04,2018,ARI,HOU,0,8,170,1.5,-101,8.5,-110,-110,-190,-1.5,-119,3.15,Chase Field,8,-8
2018-05-04,2018,DET,KC,2,4,130,1.5,-156,9.0,-119,-101,-145,-1.5,136,3.91,Kauffman Stadium,6,-2
2018-05-04,2018,SEA,LAA,0,5,107,1.5,-155,8.5,-105,-115,-117,-1.5,135,4.11,T-Mobile Park,5,-5
2018-05-04,2018,SD,LAD,0,4,116,1.5,-153,8.0,100,-120,-126,-1.5,133,3.7,Estadio Monterrey,4,-4
2018-05-04,2018,CIN,MIA,4,1,-107,-1.5,176,9.0,-105,-115,-103,1.5,-210,4.65,Great American Ballpark,5,3
2018-05-04,2018,PIT,MIL,6,4,104,1.5,-224,8.5,-101,-119,-114,-1.5,187,4.17,Miller Park,10,2
2018-05-04,2018,CWS,MIN,4,6,147,1.5,-110,9.0,-110,-110,-162,-1.5,-110,3.64,Guaranteed Rate Field,10,-2
2018-05-04,2018,COL,NYM,8,7,111,1.5,-185,8.5,100,-120,-121,-1.5,160,4.03,Citi Field,15,1
2018-05-04,2018,CLE,NYY,6,7,180,1.5,100,11.0,107,-127,-210,-1.5,-120,3.93,Yankee Stadium,13,-1
2018-05-04,2018,BAL,OAK,4,6,168,1.5,-126,9.5,-105,-115,-188,-1.5,106,3.54,Oakland Coliseum,10,-2
2018-05-04,2018,WSH,PHI,7,3,-128,-1.5,156,9.0,-110,-110,118,1.5,-180,5.05,Nationals Park,10,4
2018-05-04,2018,MIL,PIT,4,6,-114,-1.5,187,8.5,-101,-119,104,1.5,-224,4.53,Miller Park,10,-2
2018-05-04,2018,LAD,SD,4,0,-126,-1.5,133,8.0,100,-120,116,1.5,-153,4.46,Estadio Monterrey,4,4
2018-05-04,2018,LAA,SEA,5,0,-117,-1.5,135,8.5,-105,-115,107,1.5,-155,4.58,T-Mobile Park,5,5
2018-05-04,2018,ATL,SF,4,9,-150,-1.5,144,9.0,-115,-105,135,1.5,-165,5.4,Suntrust Park,13,-5
2018-05-04,2018,CHC,STL,2,3,101,1.5,-210,8.0,-120,100,-111,-1.5,176,3.98,Busch Stadium,5,-1
2018-05-04,2018,TOR,TB,2,6,-157,-1.5,-102,8.0,-101,-119,142,1.5,-118,4.89,Tropicana Field,8,-4
2018-05-04,2018,BOS,TEX,5,1,-172,-1.5,-119,9.0,-105,-115,152,1.5,-101,5.69,Rangers Ballpark,6,4
2018-05-04,2018,TB,TOR,6,2,142,1.5,-118,8.0,-101,-119,-157,-1.5,-102,3.31,Tropicana Field,8,4
2018-05-04,2018,PHI,WSH,3,7,118,1.5,-180,9.0,-110,-110,-128,-1.5,156,4.13,Nationals Park,10,-4
2018-05-05,2018,HOU,ARI,3,4,-127,-1.5,134,7.5,-110,-110,117,1.5,-154,4.2,Chase Field,7,-1
2018-05-05,2018,SF,ATL,11,2,117,1.5,-185,9.0,-122,102,-127,-1.5,160,4.15,Suntrust Park,13,9
2018-05-05,2018,OAK,BAL,2,0,-145,-1.5,144,9.0,-102,-118,130,1.5,-165,5.33,Oakland Coliseum,2,2
2018-05-05,2018,TEX,BOS,5,6,138,1.5,-122,9.0,-115,-105,-153,-1.5,102,3.78,Rangers Ballpark,11,-1
2018-05-05,2018,STL,CHC,8,6,-127,-1.5,166,8.5,-120,100,117,1.5,-195,4.76,Busch Stadium,14,2
2018-05-05,2018,MIA,CIN,6,0,114,1.5,-200,8.5,-112,-108,-124,-1.5,170,3.97,Great American Ballpark,6,6
2018-05-05,2018,NYY,CLE,5,2,-105,1.5,-173,9.0,-125,105,-105,-1.5,150,4.61,Yankee Stadium,7,3
2018-05-05,2018,NYM,COL,0,2,-122,-1.5,170,8.5,103,-123,112,1.5,-200,4.67,Citi Field,2,-2
2018-05-05,2018,MIN,CWS,8,4,-123,-1.5,130,9.5,-105,-115,113,1.5,-150,5.24,Guaranteed Rate Field,12,4
2018-05-05,2018,KC,DET,2,3,-165,-1.5,120,9.5,-110,-110,150,1.5,-140,5.92,Kauffman Stadium,5,-1
2018-05-05,2018,ARI,HOU,4,3,117,1.5,-154,7.5,-110,-110,-127,-1.5,134,3.46,Chase Field,7,1
2018-05-05,2018,DET,KC,3,2,150,1.5,-140,9.5,-110,-110,-165,-1.5,120,3.8,Kauffman Stadium,5,1
2018-05-05,2018,SEA,LAA,9,8,-101,1.5,-160,8.5,-102,-118,-109,-1.5,140,4.27,T-Mobile Park,17,1
2018-05-05,2018,SD,LAD,7,4,195,1.5,117,9.0,-115,-105,-225,-1.5,-137,3.05,Estadio Monterrey,11,3
2018-05-05,2018,CIN,MIA,0,6,-124,-1.5,170,8.5,-112,-108,114,1.5,-200,4.71,Great American Ballpark,6,-6
2018-05-05,2018,PIT,MIL,3,5,-109,-1.5,149,8.5,-110,-110,-101,1.5,-172,4.43,Miller Park,8,-2
2018-05-05,2018,CWS,MIN,4,8,113,1.5,-150,9.5,-105,-115,-123,-1.5,130,4.46,Guaranteed Rate Field,12,-4
2018-05-05,2018,COL,NYM,2,0,112,1.5,-200,8.5,103,-123,-122,-1.5,170,4.01,Citi Field,2,2
2018-05-05,2018,CLE,NYY,2,5,-105,-1.5,150,9.0,-125,105,-105,1.5,-173,4.61,Yankee Stadium,7,-3
2018-05-05,2018,BAL,OAK,0,2,130,1.5,-165,9.0,-102,-118,-145,-1.5,144,3.91,Oakland Coliseum,2,-2
2018-05-05,2018,WSH,PHI,1,3,-140,-1.5,139,8.5,-119,-101,125,1.5,-159,4.96,Nationals Park,4,-2
2018-05-05,2018,MIL,PIT,5,3,-101,1.5,-172,8.5,-110,-110,-109,-1.5,149,4.27,Miller Park,8,2
2018-05-05,2018,LAD,SD,4,7,-225,-1.5,-137,9.0,-115,-105,195,1.5,117,6.23,Estadio Monterrey,11,-3
2018-05-05,2018,LAA,SEA,8,9,-109,-1.5,140,8.5,-102,-118,-101,1.5,-160,4.43,T-Mobile Park,17,-1
2018-05-05,2018,ATL,SF,2,11,-127,-1.5,160,9.0,-122,102,117,1.5,-185,5.04,Suntrust Park,13,-9
2018-05-05,2018,CHC,STL,6,8,117,1.5,-195,8.5,-120,100,-127,-1.5,166,3.92,Busch Stadium,14,-2
2018-05-05,2018,TOR,TB,3,5,-101,-1.5,160,8.0,-105,-115,-109,1.5,-185,4.02,Tropicana Field,8,-2
2018-05-05,2018,BOS,TEX,6,5,-153,-1.5,102,9.0,-115,-105,138,1.5,-122,5.44,Rangers Ballpark,11,1
2018-05-05,2018,TB,TOR,5,3,-109,1.5,-185,8.0,-105,-115,-101,-1.5,160,4.17,Tropicana Field,8,2
2018-05-05,2018,PHI,WSH,3,1,125,1.5,-159,8.5,-119,-101,-140,-1.5,139,3.78,Nationals Park,4,2
2018-05-06,2018,HOU,ARI,1,3,-219,-1.5,-140,8.0,-115,-105,189,1.5,120,5.49,Chase Field,4,-2
2018-05-06,2018,SF,ATL,4,3,130,1.5,-157,9.0,-101,-119,-145,-1.5,137,3.91,Suntrust Park,7,1
2018-05-06,2018,OAK,BAL,2,1,-170,-1.5,120,8.5,-104,-116,150,1.5,-140,5.35,Oakland Coliseum,3,1
2018-05-06,2018,TEX,BOS,1,6,200,1.5,125,8.5,-111,-109,-240,-1.5,-145,2.83,Rangers Ballpark,7,-5
2018-05-06,2018,STL,CHC,4,3,100,1.5,-170,8.5,-117,-103,-110,-1.5,148,4.25,Busch Stadium,7,1
2018-05-06,2018,MIA,CIN,8,5,119,1.5,-175,10.0,-101,-119,-134,-1.5,151,4.57,Great American Ballpark,13,3
2018-05-06,2018,NYY,CLE,7,4,-127,-1.5,154,8.5,-120,100,117,1.5,-179,4.76,Yankee Stadium,11,3
2018-05-06,2018,NYM,COL,2,3,-215,-1.5,115,6.5,-115,-105,185,1.5,-135,4.44,Citi Field,5,-1
2018-05-06,2018,MIN,CWS,5,3,-157,-1.5,-101,9.0,-115,-105,142,1.5,-119,5.5,Guaranteed Rate Field,8,2
2018-05-06,2018,KC,DET,4,2,-142,-1.5,144,8.5,-126,106,127,1.5,-165,4.99,Kauffman Stadium,6,2
2018-05-06,2018,ARI,HOU,3,1,189,1.5,120,8.0,-115,-105,-219,-1.5,-140,2.77,Chase Field,4,2
2018-05-06,2018,DET,KC,2,4,127,1.5,-165,8.5,-126,106,-142,-1.5,144,3.74,Kauffman Stadium,6,-2
2018-05-06,2018,SEA,LAA,2,8,117,1.5,-140,8.5,-113,-107,-132,-1.5,120,3.92,T-Mobile Park,10,-6
2018-05-06,2018,SD,LAD,3,0,130,1.5,-125,9.5,100,-120,-145,-1.5,105,4.13,Estadio Monterrey,3,3
2018-05-06,2018,CIN,MIA,5,8,-134,-1.5,151,10.0,-101,-119,119,1.5,-175,5.73,Great American Ballpark,13,-3
2018-05-06,2018,PIT,MIL,9,0,116,1.5,-185,9.0,108,-128,-126,-1.5,160,4.17,Miller Park,9,9
2018-05-06,2018,CWS,MIN,3,5,142,1.5,-119,9.0,-115,-105,-157,-1.5,-101,3.72,Guaranteed Rate Field,8,-2
2018-05-06,2018,COL,NYM,3,2,185,1.5,-135,6.5,-115,-105,-215,-1.5,115,2.28,Citi Field,5,1
2018-05-06,2018,CLE,NYY,4,7,117,1.5,-179,8.5,-120,100,-127,-1.5,154,3.92,Yankee Stadium,11,-3
2018-05-06,2018,BAL,OAK,1,2,150,1.5,-140,8.5,-104,-116,-170,-1.5,120,3.4,Oakland Coliseum,3,-1
2018-05-06,2018,WSH,PHI,5,4,-222,-1.5,-105,7.0,-115,-105,192,1.5,-115,4.83,Nationals Park,9,1
2018-05-06,2018,MIL,PIT,0,9,-126,-1.5,160,9.0,108,-128,116,1.5,-185,5.02,Miller Park,9,-9
2018-05-06,2018,LAD,SD,0,3,-145,-1.5,105,9.5,100,-120,130,1.5,-125,5.62,Estadio Monterrey,3,-3
2018-05-06,2018,LAA,SEA,8,2,-132,-1.5,120,8.5,-113,-107,117,1.5,-140,4.84,T-Mobile Park,10,6
2018-05-06,2018,ATL,SF,3,4,-145,-1.5,137,9.0,-101,-119,130,1.5,-157,5.33,Suntrust Park,7,-1
2018-05-06,2018,CHC,STL,3,4,-110,-1.5,148,8.5,-117,-103,100,1.5,-170,4.45,Busch Stadium,7,-1
2018-05-06,2018,TOR,TB,2,1,120,1.5,-175,8.0,-110,-110,-135,-1.5,151,3.64,Tropicana Field,3,1
2018-05-06,2018,BOS,TEX,6,1,-240,-1.5,-145,8.5,-111,-109,200,1.5,125,6.0,Rangers Ballpark,7,5
2018-05-06,2018,TB,TOR,1,2,-135,-1.5,151,8.0,-110,-110,120,1.5,-175,4.6,Tropicana Field,3,-1
2018-05-06,2018,PHI,WSH,4,5,192,1.5,-115,7.0,-115,-105,-222,-1.5,-105,2.4,Nationals Park,9,-1
2018-05-07,2018,MIA,CHC,2,14,185,1.5,-120,8.0,-115,-105,-215,-1.5,100,2.81,Wrigley Field,16,-12
2018-05-07,2018,NYM,CIN,7,6,-105,-1.5,144,9.5,-119,-101,-105,1.5,-165,4.87,Great American Ballpark,13,1
2018-05-07,2018,TEX,DET,7,6,189,-1.5,176,9.5,-110,-110,-219,1.5,-210,3.29,Rangers Ballpark,13,1
2018-05-07,2018,OAK,HOU,2,16,120,1.5,-140,8.5,100,-120,-135,-1.5,120,3.86,Oakland Coliseum,18,-14
2018-05-07,2018,CHC,MIA,14,2,-215,-1.5,100,8.0,-115,-105,185,1.5,-120,5.46,Wrigley Field,16,12
2018-05-07,2018,STL,MIN,0,6,-114,-1.5,163,8.5,-101,-119,104,1.5,-190,4.53,Busch Stadium,6,-6
2018-05-07,2018,CIN,NYM,6,7,-105,1.5,-165,9.5,-119,-101,-105,-1.5,144,4.87,Great American Ballpark,13,-1
2018-05-07,2018,HOU,OAK,16,2,-135,-1.5,120,8.5,100,-120,120,1.5,-140,4.88,Oakland Coliseum,18,14
2018-05-07,2018,SF,PHI,0,11,-122,-1.5,135,9.0,-110,-110,112,1.5,-155,4.95,Citizens Bank Park,11,-11
2018-05-07,2018,WSH,SD,8,5,-177,-1.5,-115,7.0,-105,-115,157,1.5,-105,4.47,PETCO Park,13,3
2018-05-07,2018,PHI,SF,11,0,112,1.5,-155,9.0,-110,-110,-122,-1.5,135,4.25,Citizens Bank Park,11,11
2018-05-07,2018,MIN,STL,6,0,104,1.5,-190,8.5,-101,-119,-114,-1.5,163,4.17,Busch Stadium,6,6
2018-05-07,2018,DET,TEX,6,7,-219,1.5,-210,9.5,-110,-110,189,-1.5,176,6.52,Rangers Ballpark,13,-1
2018-05-07,2018,SD,WSH,5,8,157,1.5,-105,7.0,-105,-115,-177,-1.5,-115,2.72,PETCO Park,13,-3
2018-05-08,2018,LAD,ARI,5,8,-118,-1.5,172,7.0,-115,-105,108,1.5,-205,3.79,Dodger Stadium,13,-3
2018-05-08,2018,TB,ATL,0,1,-129,-1.5,155,7.5,110,-130,119,1.5,-180,4.22,Tropicana Field,1,-1
2018-05-08,2018,KC,BAL,15,7,143,1.5,-150,8.5,-119,-101,-158,-1.5,130,3.5,Camden Yards,22,8
2018-05-08,2018,NYY,BOS,3,2,-240,-1.5,-120,8.5,-112,-108,200,1.5,100,6.0,Yankee Stadium,5,1
2018-05-08,2018,MIA,CHC,3,4,147,1.5,-145,9.5,-115,-105,-162,-1.5,125,3.85,Wrigley Field,7,-1
2018-05-08,2018,NYM,CIN,2,7,137,1.5,-160,9.5,100,-120,-152,-1.5,140,4.01,Great American Ballpark,9,-5
2018-05-08,2018,MIL,CLE,3,2,137,1.5,-120,8.0,-110,-110,-152,-1.5,100,3.38,Miller Park,5,1
2018-05-08,2018,LAA,COL,2,4,111,1.5,-175,10.5,-115,-105,-121,-1.5,151,4.98,Coors Field,6,-2
2018-05-08,2018,PIT,CWS,10,6,-146,-1.5,105,9.5,-105,-115,131,1.5,-125,5.64,Guaranteed Rate Field,16,4
2018-05-08,2018,TEX,DET,4,7,-174,-1.5,105,9.5,-101,-119,154,1.5,-125,6.03,Rangers Ballpark,11,-3
2018-05-08,2018,OAK,HOU,2,4,140,1.5,-131,8.0,-105,-115,-155,-1.5,111,3.33,Oakland Coliseum,6,-2
2018-05-08,2018,BAL,KC,7,15,-158,-1.5,130,8.5,-119,-101,143,1.5,-150,5.21,Camden Yards,22,-8
2018-05-08,2018,COL,LAA,4,2,-121,-1.5,151,10.5,-115,-105,111,1.5,-175,5.75,Coors Field,6,2
2018-05-08,2018,ARI,LAD,8,5,108,1.5,-205,7.0,-115,-105,-118,-1.5,172,3.37,Dodger Stadium,13,3
2018-05-08,2018,CHC,MIA,4,3,-162,-1.5,125,9.5,-115,-105,147,1.5,-145,5.87,Wrigley Field,7,1
2018-05-08,2018,CLE,MIL,2,3,-152,-1.5,100,8.0,-110,-110,137,1.5,-120,4.83,Miller Park,5,-1
2018-05-08,2018,STL,MIN,1,7,-175,-1.5,105,8.0,-125,105,155,1.5,-125,5.09,Busch Stadium,8,-6
2018-05-08,2018,CIN,NYM,7,2,-152,-1.5,140,9.5,100,-120,137,1.5,-160,5.73,Great American Ballpark,9,5
2018-05-08,2018,BOS,NYY,2,3,200,1.5,100,8.5,-112,-108,-240,-1.5,-120,2.83,Yankee Stadium,5,-1
2018-05-08,2018,HOU,OAK,4,2,-155,-1.5,111,8.0,-105,-115,140,1.5,-131,4.86,Oakland Coliseum,6,2
2018-05-08,2018,SF,PHI,2,4,155,1.5,-135,8.5,-119,-101,-175,-1.5,115,3.33,Citizens Bank Park,6,-2
2018-05-08,2018,CWS,PIT,6,10,131,1.5,-125,9.5,-105,-115,-146,-1.5,105,4.11,Guaranteed Rate Field,16,-4
2018-05-08,2018,WSH,SD,4,0,-116,-1.5,130,8.5,-105,-115,106,1.5,-150,4.56,PETCO Park,4,4
2018-05-08,2018,TOR,SEA,0,5,110,1.5,-155,8.0,-122,102,-120,-1.5,135,3.81,Rogers Centre,5,-5
2018-05-08,2018,PHI,SF,4,2,-175,-1.5,115,8.5,-119,-101,155,1.5,-135,5.41,Citizens Bank Park,6,2
2018-05-08,2018,MIN,STL,7,1,155,1.5,-125,8.0,-125,105,-175,-1.5,105,3.14,Busch Stadium,8,6
2018-05-08,2018,ATL,TB,1,0,119,1.5,-180,7.5,110,-130,-129,-1.5,155,3.42,Tropicana Field,1,1
2018-05-08,2018,DET,TEX,7,4,154,1.5,-125,9.5,-101,-119,-174,-1.5,105,3.74,Rangers Ballpark,11,3
2018-05-08,2018,SEA,TOR,5,0,-120,-1.5,135,8.0,-122,102,110,1.5,-155,4.36,Rogers Centre,5,5
2018-05-08,2018,SD,WSH,0,4,106,1.5,-150,8.5,-105,-115,-116,-1.5,130,4.13,PETCO Park,4,-4
2018-05-09,2018,LAD,ARI,6,3,-121,-1.5,180,7.0,110,-130,111,1.5,-215,3.83,Dodger Stadium,9,3
2018-05-09,2018,TB,ATL,2,5,-106,-1.5,180,8.5,100,-120,-104,1.5,-215,4.37,Tropicana Field,7,-3
2018-05-09,2018,KC,BAL,3,5,104,1.5,-205,10.0,-105,-115,-114,-1.5,172,4.9,Camden Yards,8,-2
2018-05-09,2018,NYY,BOS,9,6,-141,-1.5,144,8.5,100,-120,126,1.5,-165,4.97,Yankee Stadium,15,3
2018-05-09,2018,MIA,CHC,4,13,204,1.5,110,11.5,-101,-119,-244,-1.5,-130,3.78,Wrigley Field,17,-9
2018-05-09,2018,NYM,CIN,1,2,-105,-1.5,148,10.0,-104,-116,-105,1.5,-170,5.12,Great American Ballpark,3,-1
2018-05-09,2018,MIL,CLE,2,6,145,1.5,-117,8.0,-109,-111,-160,-1.5,-103,3.27,Miller Park,8,-4
2018-05-09,2018,LAA,COL,8,0,123,1.5,-155,12.0,-121,101,-138,-1.5,135,5.38,Coors Field,8,8
2018-05-09,2018,PIT,CWS,6,5,-109,-1.5,144,10.0,-110,-110,-101,1.5,-165,5.22,Guaranteed Rate Field,11,1
2018-05-09,2018,TEX,DET,5,4,-175,-1.5,115,9.0,-115,-105,155,1.5,-135,5.73,Rangers Ballpark,9,1
2018-05-09,2018,OAK,HOU,1,4,156,1.5,100,7.5,100,-120,-176,-1.5,-120,2.93,Oakland Coliseum,5,-3
2018-05-09,2018,BAL,KC,5,3,-114,-1.5,172,10.0,-105,-115,104,1.5,-205,5.33,Camden Yards,8,2
2018-05-09,2018,COL,LAA,0,8,-138,-1.5,135,12.0,-121,101,123,1.5,-155,6.96,Coors Field,8,-8
2018-05-09,2018,ARI,LAD,3,6,111,1.5,-215,7.0,110,-130,-121,-1.5,180,3.32,Dodger Stadium,9,-3
2018-05-09,2018,CHC,MIA,13,4,-244,-1.5,-130,11.5,-101,-119,204,1.5,110,8.16,Wrigley Field,17,9
2018-05-09,2018,CLE,MIL,6,2,-160,-1.5,-103,8.0,-109,-111,145,1.5,-117,4.92,Miller Park,8,4
2018-05-09,2018,CIN,NYM,2,1,-105,1.5,-170,10.0,-104,-116,-105,-1.5,148,5.12,Great American Ballpark,3,1
2018-05-09,2018,BOS,NYY,6,9,126,1.5,-165,8.5,100,-120,-141,-1.5,144,3.76,Yankee Stadium,15,-3
2018-05-09,2018,HOU,OAK,4,1,-176,-1.5,-120,7.5,100,-120,156,1.5,100,4.78,Oakland Coliseum,5,3
2018-05-09,2018,SF,PHI,3,11,101,1.5,-210,8.5,-110,-110,-111,-1.5,176,4.23,Citizens Bank Park,14,-8
2018-05-09,2018,CWS,PIT,5,6,-101,1.5,-165,10.0,-110,-110,-109,-1.5,144,5.02,Guaranteed Rate Field,11,-1
2018-05-09,2018,WSH,SD,1,2,-131,-1.5,130,7.0,-115,-105,116,1.5,-150,3.97,PETCO Park,3,-1
2018-05-09,2018,TOR,SEA,5,2,-111,-1.5,172,9.5,-105,-115,101,1.5,-205,5.0,Rogers Centre,7,3
2018-05-09,2018,PHI,SF,11,3,-111,-1.5,176,8.5,-110,-110,101,1.5,-210,4.47,Citizens Bank Park,14,8
2018-05-09,2018,ATL,TB,5,2,-104,1.5,-215,8.5,100,-120,-106,-1.5,180,4.33,Tropicana Field,7,3
2018-05-09,2018,DET,TEX,4,5,155,1.5,-135,9.0,-115,-105,-175,-1.5,115,3.53,Rangers Ballpark,9,-1
2018-05-09,2018,SEA,TOR,2,5,101,1.5,-205,9.5,-105,-115,-111,-1.5,172,4.73,Rogers Centre,7,-3
2018-05-09,2018,SD,WSH,2,1,116,1.5,-150,7.0,-115,-105,-131,-1.5,130,3.24,PETCO Park,3,1
2018-05-10,2018,WSH,ARI,2,1,132,1.5,-170,8.0,-105,-115,-147,-1.5,148,3.45,Chase Field,3,1
2018-05-10,2018,MIA,ATL,2,9,-105,1.5,-170,7.5,-105,-115,-105,-1.5,148,3.84,Marlins Park,11,-7
2018-05-10,2018,KC,BAL,6,11,-105,-1.5,148,10.5,-112,-108,-105,1.5,-170,5.38,Camden Yards,17,-5
2018-05-10,2018,NYY,BOS,4,5,-122,-1.5,150,9.0,-121,101,112,1.5,-173,4.95,Yankee Stadium,9,-1
2018-05-10,2018,LAD,CIN,1,4,-192,-1.5,115,7.0,-115,-105,172,1.5,-135,4.6,Dodger Stadium,5,-3
2018-05-10,2018,MIL,COL,5,2,131,1.5,-143,11.5,-110,-110,-146,-1.5,123,4.98,Coors Field,7,3
2018-05-10,2018,BAL,KC,11,6,-105,1.5,-170,10.5,-112,-108,-105,-1.5,148,5.38,Camden Yards,17,5
2018-05-10,2018,MIN,LAA,4,7,146,1.5,-150,7.5,-104,-116,-161,-1.5,130,3.05,Angel Stadium,11,-3
2018-05-10,2018,CIN,LAD,4,1,172,1.5,-135,7.0,-115,-105,-192,-1.5,115,2.57,Dodger Stadium,5,3
2018-05-10,2018,ATL,MIA,9,2,-105,-1.5,148,7.5,-105,-115,-105,1.5,-170,3.84,Marlins Park,11,7
2018-05-10,2018,COL,MIL,2,5,-146,-1.5,123,11.5,-110,-110,131,1.5,-143,6.83,Coors Field,7,-3
2018-05-10,2018,LAA,MIN,7,4,-161,-1.5,130,7.5,-104,-116,146,1.5,-150,4.63,Angel Stadium,11,3
2018-05-10,2018,BOS,NYY,5,4,112,1.5,-173,9.0,-121,101,-122,-1.5,150,4.25,Yankee Stadium,9,1
2018-05-10,2018,SF,PHI,3,6,155,1.5,-145,9.5,-101,-119,-175,-1.5,125,3.73,Citizens Bank Park,9,-3
2018-05-10,2018,STL,SD,2,1,-155,-1.5,100,7.5,-117,-103,140,1.5,-120,4.56,PETCO Park,3,1
2018-05-10,2018,TOR,SEA,3,9,-158,-1.5,120,9.0,-118,-102,143,1.5,-140,5.51,Rogers Centre,12,-6
2018-05-10,2018,PHI,SF,6,3,-175,-1.5,125,9.5,-101,-119,155,1.5,-145,6.05,Citizens Bank Park,9,3
2018-05-10,2018,SD,STL,1,2,140,1.5,-120,7.5,-117,-103,-155,-1.5,100,3.13,PETCO Park,3,-1
2018-05-10,2018,SEA,TOR,9,3,143,1.5,-140,9.0,-118,-102,-158,-1.5,120,3.7,Rogers Centre,12,6
2018-05-10,2018,ARI,WSH,1,2,-147,-1.5,148,8.0,-105,-115,132,1.5,-170,4.76,Chase Field,3,-1
2018-05-11,2018,WSH,ARI,3,1,-195,-1.5,-115,8.0,-102,-118,175,1.5,-105,5.29,Chase Field,4,2
2018-05-11,2018,MIA,ATL,6,3,123,1.5,-135,9.0,100,-120,-138,-1.5,115,4.04,Marlins Park,9,3
2018-05-11,2018,TB,BAL,4,9,118,1.5,-174,9.0,-110,-110,-133,-1.5,150,4.13,Camden Yards,13,-5
2018-05-11,2018,TOR,BOS,5,3,170,1.5,100,8.0,-116,-104,-190,-1.5,-120,2.96,Rogers Centre,8,2
2018-05-11,2018,CWS,CHC,2,11,204,1.5,-105,8.0,-119,-101,-244,-1.5,-115,2.63,Wrigley Field,13,-9
2018-05-11,2018,LAD,CIN,2,6,-200,-1.5,-101,8.5,-109,-111,170,1.5,-119,5.67,Dodger Stadium,8,-4
2018-05-11,2018,KC,CLE,10,9,200,1.5,-101,8.5,-120,100,-240,-1.5,-119,2.83,Progressive Field,19,1
2018-05-11,2018,MIL,COL,11,10,101,1.5,-185,11.0,-121,101,-111,-1.5,160,5.47,Coors Field,21,1
2018-05-11,2018,CHC,CWS,11,2,-244,-1.5,-115,8.0,-119,-101,204,1.5,-105,5.67,Wrigley Field,13,9
2018-05-11,2018,TEX,HOU,1,0,232,1.5,115,8.5,-105,-115,-272,-1.5,-135,2.56,Minute Maid Park,1,1
2018-05-11,2018,CLE,KC,9,10,-240,-1.5,-119,8.5,-120,100,200,1.5,-101,6.0,Progressive Field,19,-1
2018-05-11,2018,MIN,LAA,5,4,176,1.5,-130,8.0,-107,-113,-206,-1.5,110,2.9,Angel Stadium,9,1
2018-05-11,2018,CIN,LAD,6,2,170,1.5,-119,8.5,-109,-111,-200,-1.5,-101,3.15,Dodger Stadium,8,4
2018-05-11,2018,ATL,MIA,3,6,-138,-1.5,115,9.0,100,-120,123,1.5,-135,5.22,Marlins Park,9,-3
2018-05-11,2018,COL,MIL,10,11,-111,-1.5,160,11.0,-121,101,101,1.5,-185,5.79,Coors Field,21,-1
2018-05-11,2018,LAA,MIN,4,5,-206,-1.5,110,8.0,-107,-113,176,1.5,-130,5.39,Angel Stadium,9,-1
2018-05-11,2018,PHI,NYM,1,3,-163,-1.5,130,8.5,-115,-105,148,1.5,-150,5.27,Citizens Bank Park,4,-2
2018-05-11,2018,OAK,NYY,10,5,167,1.5,-120,9.5,-107,-113,-187,-1.5,100,3.56,Yankee Stadium,15,5
2018-05-11,2018,NYY,OAK,5,10,-187,-1.5,100,9.5,-107,-113,167,1.5,-120,6.19,Yankee Stadium,15,-5
2018-05-11,2018,NYM,PHI,3,1,148,1.5,-150,8.5,-115,-105,-163,-1.5,130,3.43,Citizens Bank Park,4,2
2018-05-11,2018,SF,PIT,2,11,109,1.5,-205,7.5,-119,-101,-119,-1.5,172,3.59,PNC Park,13,-9
2018-05-11,2018,STL,SD,9,5,-145,-1.5,110,7.5,-107,-113,130,1.5,-130,4.44,PETCO Park,14,4
2018-05-11,2018,PIT,SF,11,2,-119,-1.5,172,7.5,-119,-101,109,1.5,-205,4.08,PNC Park,13,9
2018-05-11,2018,SD,STL,5,9,130,1.5,-130,7.5,-107,-113,-145,-1.5,110,3.26,PETCO Park,14,-4
2018-05-11,2018,BAL,TB,9,4,-133,-1.5,150,9.0,-110,-110,118,1.5,-174,5.14,Camden Yards,13,5
2018-05-11,2018,HOU,TEX,0,1,-272,-1.5,-135,8.5,-105,-115,232,1.5,115,6.22,Minute Maid Park,1,-1
2018-05-11,2018,BOS,TOR,3,5,-190,-1.5,-120,8.0,-116,-104,170,1.5,100,5.24,Rogers Centre,8,-2
2018-05-11,2018,ARI,WSH,1,3,175,1.5,-105,8.0,-102,-118,-195,-1.5,-115,2.91,Chase Field,4,-2
2018-05-12,2018,WSH,ARI,2,1,-180,-1.5,-118,8.0,-106,-114,160,1.5,-102,5.14,Chase Field,3,1
2018-05-12,2018,MIA,ATL,5,10,122,1.5,-140,8.0,-115,-105,-137,-1.5,120,3.6,Marlins Park,15,-5
2018-05-12,2018,TB,BAL,3,6,-128,-1.5,125,9.5,-110,-110,118,1.5,-145,5.33,Camden Yards,9,-3
2018-05-12,2018,TB,BAL,10,3,111,1.5,-190,9.5,-105,-115,-121,-1.5,163,4.5,Camden Yards,13,7
2018-05-12,2018,TOR,BOS,2,5,129,1.5,-125,9.5,-103,-117,-144,-1.5,105,4.15,Rogers Centre,7,-3
2018-05-12,2018,CWS,CHC,4,8,218,1.5,105,7.5,-116,-104,-258,-1.5,-125,2.36,Wrigley Field,12,-4
2018-05-12,2018,LAD,CIN,3,5,-177,-1.5,115,8.5,-101,-119,157,1.5,-135,5.43,Dodger Stadium,8,-2
2018-05-12,2018,KC,CLE,2,6,170,1.5,-119,8.5,-115,-105,-200,-1.5,-101,3.15,Progressive Field,8,-4
2018-05-12,2018,MIL,COL,0,4,111,1.5,-170,11.0,-110,-110,-121,-1.5,148,5.21,Coors Field,4,-4
2018-05-12,2018,CHC,CWS,8,4,-258,-1.5,-125,7.5,-116,-104,218,1.5,105,5.41,Wrigley Field,12,4
2018-05-12,2018,SEA,DET,3,4,-155,-1.5,105,9.0,-105,-115,140,1.5,-125,5.47,Comerica Park,7,-1
2018-05-12,2018,SEA,DET,9,5,-115,-1.5,140,8.5,-101,-119,105,1.5,-160,4.55,Comerica Park,14,4
2018-05-12,2018,TEX,HOU,1,6,195,1.5,-115,8.5,-115,-105,-225,-1.5,-105,2.88,Minute Maid Park,7,-5
2018-05-12,2018,CLE,KC,6,2,-200,-1.5,-101,8.5,-115,-105,170,1.5,-119,5.67,Progressive Field,8,4
2018-05-12,2018,MIN,LAA,5,3,106,1.5,-200,8.5,-104,-116,-116,-1.5,170,4.13,Angel Stadium,8,2
2018-05-12,2018,CIN,LAD,5,3,157,1.5,-135,8.5,-101,-119,-177,-1.5,115,3.31,Dodger Stadium,8,2
2018-05-12,2018,ATL,MIA,10,5,-137,-1.5,120,8.0,-115,-105,122,1.5,-140,4.62,Marlins Park,15,5
2018-05-12,2018,COL,MIL,4,0,-121,-1.5,148,11.0,-110,-110,111,1.5,-170,6.02,Coors Field,4,4
2018-05-12,2018,LAA,MIN,3,5,-116,-1.5,170,8.5,-104,-116,106,1.5,-200,4.56,Angel Stadium,8,-2
2018-05-12,2018,OAK,NYY,6,7,170,1.5,-112,9.0,-110,-110,-190,-1.5,-108,3.33,Yankee Stadium,13,-1
2018-05-12,2018,NYY,OAK,7,6,-190,-1.5,-108,9.0,-110,-110,170,1.5,-112,5.9,Yankee Stadium,13,1
2018-05-12,2018,SF,PIT,5,6,110,1.5,-200,8.5,-110,-110,-120,-1.5,170,4.05,PNC Park,11,-1
2018-05-12,2018,STL,SD,1,2,-117,-1.5,136,7.5,-101,-119,107,1.5,-156,4.04,PETCO Park,3,-1
2018-05-12,2018,DET,SEA,4,3,140,1.5,-125,9.0,-105,-115,-155,-1.5,105,3.75,Comerica Park,7,1
2018-05-12,2018,DET,SEA,5,9,105,1.5,-160,8.5,-101,-119,-115,-1.5,140,4.15,Comerica Park,14,-4
2018-05-12,2018,PIT,SF,6,5,-120,-1.5,170,8.5,-110,-110,110,1.5,-200,4.64,PNC Park,11,1
2018-05-12,2018,SD,STL,2,1,107,1.5,-156,7.5,-101,-119,-117,-1.5,136,3.62,PETCO Park,3,1
2018-05-12,2018,BAL,TB,6,3,118,1.5,-145,9.5,-110,-110,-128,-1.5,125,4.36,Camden Yards,9,3
2018-05-12,2018,BAL,TB,3,10,-121,-1.5,163,9.5,-105,-115,111,1.5,-190,5.2,Camden Yards,13,-7
2018-05-12,2018,HOU,TEX,6,1,-225,-1.5,-105,8.5,-115,-105,195,1.5,-115,5.88,Minute Maid Park,7,5
2018-05-12,2018,BOS,TOR,5,2,-144,-1.5,105,9.5,-103,-117,129,1.5,-125,5.61,Rogers Centre,7,3
2018-05-12,2018,ARI,WSH,1,2,160,1.5,-102,8.0,-106,-114,-180,-1.5,-118,3.08,Chase Field,3,-1
2018-05-13,2018,WSH,ARI,6,4,111,1.5,-195,8.5,-119,-101,-121,-1.5,166,4.03,Chase Field,10,2
2018-05-13,2018,MIA,ATL,3,4,130,1.5,-130,8.0,-101,-119,-145,-1.5,110,3.48,Marlins Park,7,-1
2018-05-13,2018,TB,BAL,1,17,109,1.5,-205,8.0,-119,-101,-119,-1.5,172,3.83,Camden Yards,18,-16
2018-05-13,2018,TOR,BOS,3,5,118,1.5,-145,9.5,-105,-115,-128,-1.5,125,4.36,Rogers Centre,8,-2
2018-05-13,2018,CWS,CHC,5,3,235,1.5,115,8.5,-105,-115,-275,-1.5,-135,2.54,Wrigley Field,8,2
2018-05-13,2018,LAD,CIN,3,5,-153,-1.5,148,7.5,-115,-105,138,1.5,-170,4.54,Dodger Stadium,8,-2
2018-05-13,2018,KC,CLE,2,11,221,1.5,110,7.5,-111,-109,-261,-1.5,-130,2.34,Progressive Field,13,-9
2018-05-13,2018,MIL,COL,7,3,145,1.5,-138,10.5,-115,-105,-160,-1.5,118,4.29,Coors Field,10,4
2018-05-13,2018,CHC,CWS,3,5,-275,-1.5,-135,8.5,-105,-115,235,1.5,115,6.23,Wrigley Field,8,-2
2018-05-13,2018,SEA,DET,4,5,-226,-1.5,-145,8.0,-115,-105,196,1.5,125,5.55,Comerica Park,9,-1
2018-05-13,2018,TEX,HOU,1,6,250,1.5,133,8.5,-120,100,-290,-1.5,-153,2.43,Minute Maid Park,7,-5
2018-05-13,2018,CLE,KC,11,2,-261,-1.5,-130,7.5,-111,-109,221,1.5,110,5.42,Progressive Field,13,9
2018-05-13,2018,MIN,LAA,1,2,153,1.5,-145,7.5,-104,-116,-173,-1.5,125,2.96,Angel Stadium,3,-1
2018-05-13,2018,CIN,LAD,5,3,138,1.5,-170,7.5,-115,-105,-153,-1.5,148,3.15,Dodger Stadium,8,2
2018-05-13,2018,ATL,MIA,4,3,-145,-1.5,110,8.0,-101,-119,130,1.5,-130,4.73,Marlins Park,7,1
2018-05-13,2018,COL,MIL,3,7,-160,-1.5,118,10.5,-115,-105,145,1.5,-138,6.46,Coors Field,10,-4
2018-05-13,2018,LAA,MIN,2,1,-173,-1.5,125,7.5,-104,-116,153,1.5,-145,4.75,Angel Stadium,3,1
2018-05-13,2018,PHI,NYM,4,2,-123,-1.5,176,6.5,-125,105,113,1.5,-210,3.59,Citizens Bank Park,6,2
2018-05-13,2018,OAK,NYY,2,6,265,1.5,130,8.5,104,-124,-315,-1.5,-150,2.33,Yankee Stadium,8,-4
2018-05-13,2018,NYY,OAK,6,2,-315,-1.5,-150,8.5,104,-124,265,1.5,130,6.45,Yankee Stadium,8,4
2018-05-13,2018,NYM,PHI,2,4,113,1.5,-210,6.5,-125,105,-123,-1.5,176,3.05,Citizens Bank Park,6,-2
2018-05-13,2018,SF,PIT,5,0,130,1.5,-160,9.0,-105,-115,-145,-1.5,140,3.91,PNC Park,5,5
2018-05-13,2018,STL,SD,3,5,-129,-1.5,130,8.5,-105,-115,119,1.5,-150,4.79,PETCO Park,8,-2
2018-05-13,2018,DET,SEA,5,4,196,1.5,125,8.0,-115,-105,-226,-1.5,-145,2.7,Comerica Park,9,1
2018-05-13,2018,PIT,SF,0,5,-145,-1.5,140,9.0,-105,-115,130,1.5,-160,5.33,PNC Park,5,-5
2018-05-13,2018,SD,STL,5,3,119,1.5,-150,8.5,-105,-115,-129,-1.5,130,3.88,PETCO Park,8,2
2018-05-13,2018,BAL,TB,17,1,-119,-1.5,172,8.0,-119,-101,109,1.5,-205,4.35,Camden Yards,18,16
2018-05-13,2018,HOU,TEX,6,1,-290,-1.5,-153,8.5,-120,100,250,1.5,133,6.32,Minute Maid Park,7,5
2018-05-13,2018,BOS,TOR,5,3,-128,-1.5,125,9.5,-105,-115,118,1.5,-145,5.33,Rogers Centre,8,2
2018-05-13,2018,ARI,WSH,4,6,-121,-1.5,166,8.5,-119,-101,111,1.5,-195,4.65,Chase Field,10,-2
2018-05-14,2018,MIL,ARI,7,2,130,1.5,-165,8.0,-105,-115,-145,-1.5,144,3.48,Chase Field,9,5
2018-05-14,2018,CHC,ATL,5,6,-150,-1.5,144,8.5,-120,100,135,1.5,-165,5.1,Wrigley Field,11,-1
2018-05-14,2018,OAK,BOS,6,5,141,1.5,-150,10.0,100,-120,-156,-1.5,130,4.15,Fenway Park,11,1
2018-05-14,2018,ATL,CHC,6,5,135,1.5,-165,8.5,-120,100,-150,-1.5,144,3.62,Wrigley Field,11,1
2018-05-14,2018,SF,CIN,10,7,-142,-1.5,150,8.5,-110,-110,127,1.5,-173,4.99,AT&T Park,17,3
2018-05-14,2018,DET,CLE,6,3,235,1.5,133,8.0,-120,100,-275,-1.5,-153,2.39,Comerica Park,9,3
2018-05-14,2018,SD,COL,4,6,-110,-1.5,184,7.0,110,-130,100,1.5,-220,3.67,PETCO Park,10,-2
2018-05-14,2018,CLE,DET,3,6,-275,-1.5,-153,8.0,-120,100,235,1.5,133,5.87,Comerica Park,9,-3
2018-05-14,2018,LAA,HOU,2,1,118,1.5,-140,8.5,-101,-119,-128,-1.5,120,3.9,Angel Stadium,3,1
2018-05-14,2018,TB,KC,2,1,-105,1.5,-190,9.5,-108,-112,-105,-1.5,163,4.87,Kauffman Stadium,3,1
2018-05-14,2018,HOU,LAA,1,2,-128,-1.5,120,8.5,-101,-119,118,1.5,-140,4.77,Angel Stadium,3,-1
2018-05-14,2018,ARI,MIL,2,7,-145,-1.5,144,8.0,-105,-115,130,1.5,-165,4.73,Chase Field,9,-5
2018-05-14,2018,SEA,MIN,1,0,-104,1.5,-210,10.0,-103,-117,-106,-1.5,176,5.1,Target Field,1,1
2018-05-14,2018,BOS,OAK,5,6,-156,-1.5,130,10.0,100,-120,141,1.5,-150,6.09,Fenway Park,11,-1
2018-05-14,2018,COL,SD,6,4,100,1.5,-220,7.0,110,-130,-110,-1.5,184,3.5,PETCO Park,10,2
2018-05-14,2018,MIN,SEA,0,1,-106,-1.5,176,10.0,-103,-117,-104,1.5,-210,5.15,Target Field,1,-1
2018-05-14,2018,CIN,SF,7,10,127,1.5,-173,8.5,-110,-110,-142,-1.5,150,3.74,AT&T Park,17,-3
2018-05-14,2018,KC,TB,1,2,-105,-1.5,163,9.5,-108,-112,-105,1.5,-190,4.87,Kauffman Stadium,3,-1
2018-05-15,2018,MIL,ARI,1,2,147,1.5,-150,8.0,-105,-115,-162,-1.5,130,3.24,Chase Field,3,-1
2018-05-15,2018,CHC,ATL,3,2,-119,-1.5,139,9.0,-115,-105,109,1.5,-159,4.89,Suntrust Park,5,1
2018-05-15,2018,OAK,BOS,5,3,165,1.5,-125,10.0,-105,-115,-185,-1.5,105,3.77,Fenway Park,8,2
2018-05-15,2018,ATL,CHC,2,3,109,1.5,-159,9.0,-115,-105,-119,-1.5,139,4.31,Suntrust Park,5,-1
2018-05-15,2018,SF,CIN,5,3,-144,-1.5,148,8.0,100,-120,129,1.5,-170,4.72,AT&T Park,8,2
2018-05-15,2018,DET,CLE,9,8,138,1.5,-124,9.0,-101,-119,-153,-1.5,104,3.78,Comerica Park,17,1
2018-05-15,2018,SD,COL,4,0,-105,-1.5,184,7.5,110,-130,-105,1.5,-220,3.84,PETCO Park,4,4
2018-05-15,2018,PIT,CWS,7,0,-133,-1.5,155,9.0,104,-124,118,1.5,-180,5.14,PNC Park,7,7
2018-05-15,2018,CLE,DET,8,9,-153,-1.5,104,9.0,-101,-119,138,1.5,-124,5.44,Comerica Park,17,-1
2018-05-15,2018,LAA,HOU,3,5,150,1.5,-117,8.0,-115,-105,-165,-1.5,-103,3.2,Angel Stadium,8,-2
2018-05-15,2018,TB,KC,6,5,-114,-1.5,146,8.5,-115,-105,104,1.5,-168,4.53,Kauffman Stadium,11,1
2018-05-15,2018,HOU,LAA,5,3,-165,-1.5,-103,8.0,-115,-105,150,1.5,-117,4.98,Angel Stadium,8,2
2018-05-15,2018,MIA,LAD,4,2,161,1.5,101,8.0,-119,-101,-181,-1.5,-121,3.07,Marlins Park,6,2
2018-05-15,2018,LAD,MIA,2,4,-181,-1.5,-121,8.0,-119,-101,161,1.5,101,5.15,Marlins Park,6,-2
2018-05-15,2018,ARI,MIL,2,1,-162,-1.5,130,8.0,-105,-115,147,1.5,-150,4.95,Chase Field,3,1
2018-05-15,2018,STL,MIN,1,4,109,1.5,-205,9.0,-120,100,-119,-1.5,172,4.31,Target Field,5,-3
2018-05-15,2018,TOR,NYM,2,12,130,1.5,-180,7.5,-105,-115,-145,-1.5,155,3.26,Citi Field,14,-10
2018-05-15,2018,WSH,NYY,5,3,118,1.5,-142,8.5,-120,100,-128,-1.5,122,3.9,Nationals Park,8,2
2018-05-15,2018,BOS,OAK,3,5,-185,-1.5,105,10.0,-105,-115,165,1.5,-125,6.49,Fenway Park,8,-2
2018-05-15,2018,CWS,PIT,0,7,118,1.5,-180,9.0,104,-124,-133,-1.5,155,4.13,PNC Park,7,-7
2018-05-15,2018,COL,SD,0,4,-105,1.5,-220,7.5,110,-130,-105,-1.5,184,3.84,PETCO Park,4,-4
2018-05-15,2018,TEX,SEA,8,9,119,1.5,-175,9.0,100,-120,-134,-1.5,151,4.11,T-Mobile Park,17,-1
2018-05-15,2018,CIN,SF,3,5,129,1.5,-170,8.0,100,-120,-144,-1.5,148,3.49,AT&T Park,8,-2
2018-05-15,2018,MIN,STL,4,1,-119,-1.5,172,9.0,-120,100,109,1.5,-205,4.89,Target Field,5,3
2018-05-15,2018,KC,TB,5,6,104,1.5,-168,8.5,-115,-105,-114,-1.5,146,4.17,Kauffman Stadium,11,-1
2018-05-15,2018,SEA,TEX,9,8,-134,-1.5,151,9.0,100,-120,119,1.5,-175,5.15,T-Mobile Park,17,1
2018-05-15,2018,NYM,TOR,12,2,-145,-1.5,155,7.5,-105,-115,130,1.5,-180,4.44,Citi Field,14,10
2018-05-15,2018,NYY,WSH,3,5,-128,-1.5,122,8.5,-120,100,118,1.5,-142,4.77,Nationals Park,8,-2
2018-05-16,2018,MIL,ARI,8,2,-101,1.5,-200,8.5,-115,-105,-109,-1.5,170,4.27,Chase Field,10,6
2018-05-16,2018,CHC,ATL,1,4,101,1.5,-210,10.0,-101,-119,-111,-1.5,176,4.98,Suntrust Park,5,-3
2018-05-16,2018,PHI,BAL,4,1,-109,-1.5,135,10.0,100,-120,-101,1.5,-155,5.22,Camden Yards,5,3
2018-05-16,2018,OAK,BOS,4,6,220,1.5,110,8.0,-101,-119,-260,-1.5,-130,2.5,Fenway Park,10,-2
2018-05-16,2018,ATL,CHC,4,1,-111,-1.5,176,10.0,-101,-119,101,1.5,-210,5.26,Suntrust Park,5,3
2018-05-16,2018,SF,CIN,3,6,-158,-1.5,142,8.0,-110,-110,143,1.5,-162,4.9,AT&T Park,9,-3
2018-05-16,2018,DET,CLE,0,6,202,1.5,120,9.0,105,-125,-232,-1.5,-140,2.98,Comerica Park,6,-6
2018-05-16,2018,PIT,CWS,3,2,-175,-1.5,115,8.0,-110,-110,155,1.5,-135,5.09,PNC Park,5,1
2018-05-16,2018,CLE,DET,6,0,-232,-1.5,-140,9.0,105,-125,202,1.5,120,6.29,Comerica Park,6,6
2018-05-16,2018,LAA,HOU,0,2,105,1.5,-154,7.5,105,-125,-115,-1.5,134,3.66,Angel Stadium,2,-2
2018-05-16,2018,TB,KC,5,3,-115,-1.5,144,9.0,-119,-101,105,1.5,-165,4.81,Kauffman Stadium,8,2
2018-05-16,2018,HOU,LAA,2,0,-115,-1.5,134,7.5,105,-125,105,1.5,-154,4.01,Angel Stadium,2,2
2018-05-16,2018,MIA,LAD,6,5,170,1.5,110,8.0,-109,-111,-200,-1.5,-130,2.96,Marlins Park,11,1
2018-05-16,2018,LAD,MIA,5,6,-200,-1.5,-130,8.0,-109,-111,170,1.5,110,5.33,Marlins Park,11,-1
2018-05-16,2018,ARI,MIL,2,8,-109,-1.5,170,8.5,-115,-105,-101,1.5,-200,4.43,Chase Field,10,-6
2018-05-16,2018,STL,MIN,7,5,-102,-1.5,141,9.5,-110,-110,-108,1.5,-162,4.8,Target Field,12,2
2018-05-16,2018,TOR,NYM,12,1,-149,-1.5,110,7.0,-105,-115,134,1.5,-130,4.19,Citi Field,13,11
2018-05-16,2018,BOS,OAK,6,4,-260,-1.5,-130,8.0,-101,-119,220,1.5,110,5.78,Fenway Park,10,2
2018-05-16,2018,BAL,PHI,1,4,-101,1.5,-155,10.0,100,-120,-109,-1.5,135,5.02,Camden Yards,5,-3
2018-05-16,2018,CWS,PIT,2,3,155,1.5,-135,8.0,-110,-110,-175,-1.5,115,3.14,PNC Park,5,-1
2018-05-16,2018,TEX,SEA,5,1,-107,-1.5,151,8.5,-119,-101,-103,1.5,-175,4.39,T-Mobile Park,6,4
2018-05-16,2018,CIN,SF,6,3,143,1.5,-162,8.0,-110,-110,-158,-1.5,142,3.29,AT&T Park,9,3
2018-05-16,2018,MIN,STL,5,7,-108,1.5,-162,9.5,-110,-110,-102,-1.5,141,4.93,Target Field,12,-2
2018-05-16,2018,KC,TB,3,5,105,1.5,-165,9.0,-119,-101,-115,-1.5,144,4.39,Kauffman Stadium,8,-2
2018-05-16,2018,SEA,TEX,1,5,-103,1.5,-175,8.5,-119,-101,-107,-1.5,151,4.31,T-Mobile Park,6,-4
2018-05-16,2018,NYM,TOR,1,12,134,1.5,-130,7.0,-105,-115,-149,-1.5,110,2.99,Citi Field,13,-11
2018-05-17,2018,BOS,BAL,6,2,-160,-1.5,121,9.5,-110,-110,145,1.5,-140,5.85,Fenway Park,8,4
2018-05-17,2018,BAL,BOS,2,6,145,1.5,-140,9.5,-110,-110,-160,-1.5,121,3.88,Fenway Park,8,-4
2018-05-17,2018,SF,COL,3,5,-143,-1.5,150,8.0,-110,-110,128,1.5,-174,4.71,AT&T Park,8,-2
2018-05-17,2018,TEX,CWS,2,4,-114,-1.5,137,9.5,-104,-116,104,1.5,-157,5.06,Guaranteed Rate Field,6,-2
2018-05-17,2018,SEA,DET,2,3,-180,-1.5,115,8.0,-109,-111,160,1.5,-135,5.14,T-Mobile Park,5,-1
2018-05-17,2018,TB,LAA,7,1,150,1.5,-135,7.5,-108,-112,-170,-1.5,115,3.0,Angel Stadium,8,6
2018-05-17,2018,MIA,LAD,0,7,150,1.5,-121,7.5,100,-120,-165,-1.5,101,3.0,Marlins Park,7,-7
2018-05-17,2018,LAD,MIA,7,0,-165,-1.5,101,7.5,100,-120,150,1.5,-121,4.67,Marlins Park,7,7
2018-05-17,2018,TOR,OAK,5,10,-116,-1.5,163,9.5,-107,-113,106,1.5,-190,5.1,Rogers Centre,15,-5
2018-05-17,2018,STL,PHI,2,6,-135,-1.5,155,8.5,-110,-110,120,1.5,-180,4.88,Busch Stadium,8,-4
2018-05-17,2018,SD,PIT,4,5,118,1.5,-195,8.0,-118,-102,-128,-1.5,166,3.67,PNC Park,9,-1
2018-05-17,2018,PIT,SD,5,4,-128,-1.5,166,8.0,-118,-102,118,1.5,-195,4.49,PNC Park,9,1
2018-05-17,2018,DET,SEA,3,2,160,1.5,-135,8.0,-109,-111,-180,-1.5,115,3.08,T-Mobile Park,5,1
2018-05-17,2018,COL,SF,5,3,128,1.5,-174,8.0,-110,-110,-143,-1.5,150,3.51,AT&T Park,8,2
2018-05-17,2018,PHI,STL,6,2,120,1.5,-180,8.5,-110,-110,-135,-1.5,155,3.86,Busch Stadium,8,4
2018-05-17,2018,LAA,TB,1,7,-170,-1.5,115,7.5,-108,-112,150,1.5,-135,4.72,Angel Stadium,8,-6
2018-05-17,2018,CWS,TEX,4,2,104,1.5,-157,9.5,-104,-116,-114,-1.5,137,4.66,Guaranteed Rate Field,6,2
2018-05-17,2018,OAK,TOR,10,5,106,1.5,-190,9.5,-107,-113,-116,-1.5,163,4.61,Rogers Centre,15,5
2018-05-18,2018,NYM,ARI,3,1,-144,-1.5,163,6.5,-119,-101,129,1.5,-190,3.84,Citi Field,4,2
2018-05-18,2018,MIA,ATL,2,0,150,1.5,-121,9.0,-125,105,-170,-1.5,101,3.6,Suntrust Park,2,2
2018-05-18,2018,BOS,BAL,4,7,-185,-1.5,-101,9.5,-113,-107,165,1.5,-119,6.17,Fenway Park,11,-3
2018-05-18,2018,BAL,BOS,7,4,165,1.5,-119,9.5,-113,-107,-185,-1.5,-101,3.58,Fenway Park,11,3
2018-05-18,2018,CIN,CHC,1,8,157,1.5,-116,9.5,-105,-115,-177,-1.5,-104,3.7,Great American Ballpark,9,-7
2018-05-18,2018,CHC,CIN,8,1,-177,-1.5,-104,9.5,-105,-115,157,1.5,-116,6.07,Great American Ballpark,9,7
2018-05-18,2018,HOU,CLE,4,1,-170,-1.5,120,7.5,-103,-117,150,1.5,-140,4.72,Minute Maid Park,5,3
2018-05-18,2018,SF,COL,1,6,-113,-1.5,173,8.5,-105,-115,103,1.5,-206,4.51,AT&T Park,7,-5
2018-05-18,2018,TEX,CWS,12,5,-115,-1.5,125,9.5,-107,-113,105,1.5,-145,5.08,Guaranteed Rate Field,17,7
2018-05-18,2018,SEA,DET,5,4,-175,-1.5,123,7.5,-120,100,155,1.5,-143,4.77,T-Mobile Park,9,1
2018-05-18,2018,CLE,HOU,1,4,150,1.5,-140,7.5,-103,-117,-170,-1.5,120,3.0,Minute Maid Park,5,-3
2018-05-18,2018,NYY,KC,2,5,-185,-1.5,-124,9.0,-120,100,165,1.5,104,5.84,Kauffman Stadium,7,-3
2018-05-18,2018,TB,LAA,8,3,130,1.5,-170,8.0,-120,100,-145,-1.5,148,3.48,Angel Stadium,11,5
2018-05-18,2018,ATL,MIA,0,2,-170,-1.5,101,9.0,-125,105,150,1.5,-121,5.67,Suntrust Park,2,-2
2018-05-18,2018,MIN,MIL,3,8,-147,-1.5,140,9.0,100,-120,132,1.5,-160,5.36,Target Field,11,-5
2018-05-18,2018,MIL,MIN,8,3,132,1.5,-160,9.0,100,-120,-147,-1.5,140,3.88,Target Field,11,5
2018-05-18,2018,ARI,NYM,1,3,129,1.5,-190,6.5,-119,-101,-144,-1.5,163,2.84,Citi Field,4,-2
2018-05-18,2018,KC,NYY,5,2,165,1.5,104,9.0,-120,100,-185,-1.5,-124,3.4,Kauffman Stadium,7,3
2018-05-18,2018,TOR,OAK,1,3,-126,-1.5,148,9.5,-109,-111,116,1.5,-170,5.3,Rogers Centre,4,-2
2018-05-18,2018,STL,PHI,12,4,-141,-1.5,151,8.0,-110,-110,126,1.5,-175,4.68,Busch Stadium,16,8
2018-05-18,2018,SD,PIT,3,2,109,1.5,-203,7.5,-112,-108,-119,-1.5,171,3.59,PNC Park,5,1
2018-05-18,2018,PIT,SD,2,3,-119,-1.5,171,7.5,-112,-108,109,1.5,-203,4.08,PNC Park,5,-1
2018-05-18,2018,DET,SEA,4,5,155,1.5,-143,7.5,-120,100,-175,-1.5,123,2.94,T-Mobile Park,9,-1
2018-05-18,2018,COL,SF,6,1,103,1.5,-206,8.5,-105,-115,-113,-1.5,173,4.19,AT&T Park,7,5
2018-05-18,2018,PHI,STL,4,12,126,1.5,-175,8.0,-110,-110,-141,-1.5,151,3.54,Busch Stadium,16,-8
2018-05-18,2018,LAA,TB,3,8,-145,-1.5,148,8.0,-120,100,130,1.5,-170,4.73,Angel Stadium,11,-5
2018-05-18,2018,CWS,TEX,5,12,105,1.5,-145,9.5,-107,-113,-115,-1.5,125,4.63,Guaranteed Rate Field,17,-7
2018-05-18,2018,OAK,TOR,3,1,116,1.5,-170,9.5,-109,-111,-126,-1.5,148,4.4,Rogers Centre,4,2
2018-05-19,2018,NYM,ARI,5,4,116,1.5,-151,7.0,105,-125,-131,-1.5,131,3.24,Citi Field,9,1
2018-05-19,2018,MIA,ATL,1,8,175,1.5,-110,8.5,-110,-110,-205,-1.5,-110,3.09,Suntrust Park,9,-7
2018-05-19,2018,BOS,BAL,6,3,-190,-1.5,-101,9.0,-120,100,170,1.5,-119,5.9,Fenway Park,9,3
2018-05-19,2018,BAL,BOS,3,6,170,1.5,-119,9.0,-120,100,-190,-1.5,-101,3.33,Fenway Park,9,-3
2018-05-19,2018,CIN,CHC,5,4,111,1.5,-150,9.0,-103,-117,-121,-1.5,130,4.27,Great American Ballpark,9,1
2018-05-19,2018,CIN,CHC,0,10,163,1.5,-101,9.0,-120,100,-183,-1.5,-119,3.42,Great American Ballpark,10,-10
2018-05-19,2018,CHC,CIN,4,5,-121,-1.5,130,9.0,-103,-117,111,1.5,-150,4.93,Great American Ballpark,9,-1
2018-05-19,2018,CHC,CIN,10,0,-183,-1.5,-119,9.0,-120,100,163,1.5,-101,5.82,Great American Ballpark,10,10
2018-05-19,2018,HOU,CLE,4,5,-111,-1.5,176,7.0,-130,110,101,1.5,-210,3.68,Minute Maid Park,9,-1
2018-05-19,2018,SF,COL,9,4,103,1.5,-165,7.5,-105,-115,-113,-1.5,144,3.69,AT&T Park,13,5
2018-05-19,2018,TEX,CWS,3,5,-121,-1.5,127,10.0,-110,-110,111,1.5,-147,5.48,Guaranteed Rate Field,8,-2
2018-05-19,2018,SEA,DET,7,2,-270,-1.5,-125,7.5,-118,-102,230,1.5,105,5.47,T-Mobile Park,9,5
2018-05-19,2018,CLE,HOU,5,4,101,1.5,-210,7.0,-130,110,-111,-1.5,176,3.48,Minute Maid Park,9,1
2018-05-19,2018,NYY,KC,8,3,-282,-1.5,-171,8.0,-119,-101,242,1.5,148,5.91,Kauffman Stadium,11,5
2018-05-19,2018,TB,LAA,5,3,160,1.5,-135,8.0,-105,-115,-180,-1.5,115,3.08,Angel Stadium,8,2
2018-05-19,2018,WSH,LAD,1,4,-126,-1.5,160,8.5,-120,100,116,1.5,-185,4.74,Nationals Park,5,-3
2018-05-19,2018,WSH,LAD,4,5,-220,-1.5,-104,7.0,-110,-110,190,1.5,-116,4.81,Nationals Park,9,-1
2018-05-19,2018,ATL,MIA,8,1,-205,-1.5,-110,8.5,-110,-110,175,1.5,-110,5.71,Suntrust Park,9,7
2018-05-19,2018,MIN,MIL,4,5,-106,-1.5,184,8.0,-120,100,-104,1.5,-220,4.12,Target Field,9,-1
2018-05-19,2018,MIL,MIN,5,4,-104,1.5,-220,8.0,-120,100,-106,-1.5,184,4.08,Target Field,9,1
2018-05-19,2018,ARI,NYM,4,5,-131,-1.5,131,7.0,105,-125,116,1.5,-151,3.97,Citi Field,9,-1
2018-05-19,2018,KC,NYY,3,8,242,1.5,148,8.0,-119,-101,-282,-1.5,-171,2.34,Kauffman Stadium,11,-5
2018-05-19,2018,TOR,OAK,4,5,-101,1.5,-165,9.0,-119,-101,-109,-1.5,145,4.52,Rogers Centre,9,-1
2018-05-19,2018,STL,PHI,6,7,-109,-1.5,172,9.5,-103,-117,-101,1.5,-205,4.95,Busch Stadium,13,-1
2018-05-19,2018,SD,PIT,6,2,130,1.5,-165,7.5,-101,-119,-145,-1.5,144,3.26,PNC Park,8,4
2018-05-19,2018,PIT,SD,2,6,-145,-1.5,144,7.5,-101,-119,130,1.5,-165,4.44,PNC Park,8,-4
2018-05-19,2018,DET,SEA,2,7,230,1.5,105,7.5,-118,-102,-270,-1.5,-125,2.27,T-Mobile Park,9,-5
2018-05-19,2018,COL,SF,4,9,-113,-1.5,144,7.5,-105,-115,103,1.5,-165,3.98,AT&T Park,13,-5
2018-05-19,2018,PHI,STL,7,6,-101,1.5,-205,9.5,-103,-117,-109,-1.5,172,4.77,Busch Stadium,13,1
2018-05-19,2018,LAA,TB,3,5,-180,-1.5,115,8.0,-105,-115,160,1.5,-135,5.14,Angel Stadium,8,-2
2018-05-19,2018,CWS,TEX,5,3,111,1.5,-147,10.0,-110,-110,-121,-1.5,127,4.74,Guaranteed Rate Field,8,2
2018-05-19,2018,OAK,TOR,5,4,-109,-1.5,145,9.0,-119,-101,-101,1.5,-165,4.69,Rogers Centre,9,1
2018-05-19,2018,LAD,WSH,4,1,116,1.5,-185,8.5,-120,100,-126,-1.5,160,3.94,Nationals Park,5,3
2018-05-19,2018,LAD,WSH,5,4,190,1.5,-116,7.0,-110,-110,-220,-1.5,-104,2.41,Nationals Park,9,1
2018-05-20,2018,NYM,ARI,4,1,-185,-1.5,115,7.5,-115,-105,165,1.5,-135,4.87,Citi Field,5,3
2018-05-20,2018,MIA,ATL,9,10,170,1.5,-120,9.0,-105,-115,-190,-1.5,100,3.33,Suntrust Park,19,-1
2018-05-20,2018,BOS,BAL,5,0,-235,-1.5,-130,10.5,-101,-119,205,1.5,110,7.37,Fenway Park,5,5
2018-05-20,2018,BAL,BOS,0,5,205,1.5,110,10.5,-101,-119,-235,-1.5,-130,3.44,Fenway Park,5,-5
2018-05-20,2018,CIN,CHC,1,6,125,1.5,-134,9.5,-101,-119,-140,-1.5,114,4.22,Great American Ballpark,7,-5
2018-05-20,2018,CHC,CIN,6,1,-140,-1.5,114,9.5,-101,-119,125,1.5,-134,5.54,Great American Ballpark,7,5
2018-05-20,2018,HOU,CLE,3,1,-145,-1.5,144,7.5,-119,-101,130,1.5,-165,4.44,Minute Maid Park,4,2
2018-05-20,2018,SF,COL,9,5,266,1.5,-170,8.0,-105,-115,-316,-1.5,148,2.19,AT&T Park,14,4
2018-05-20,2018,TEX,CWS,0,3,-102,1.5,-210,8.5,-111,-109,-108,-1.5,176,4.29,Guaranteed Rate Field,3,-3
2018-05-20,2018,SEA,DET,3,2,-162,-1.5,130,8.5,-101,-119,147,1.5,-150,5.26,T-Mobile Park,5,1
2018-05-20,2018,CLE,HOU,1,3,130,1.5,-165,7.5,-119,-101,-145,-1.5,144,3.26,Minute Maid Park,4,-2
2018-05-20,2018,NYY,KC,10,1,-171,-1.5,-115,9.0,-115,-105,151,1.5,-105,5.68,Kauffman Stadium,11,9
2018-05-20,2018,TB,LAA,2,5,177,1.5,-125,7.5,-119,-101,-197,-1.5,105,2.71,Angel Stadium,7,-3
2018-05-20,2018,WSH,LAD,2,7,-133,-1.5,163,7.5,-108,-112,118,1.5,-190,4.28,Nationals Park,9,-5
2018-05-20,2018,ATL,MIA,10,9,-190,-1.5,100,9.0,-105,-115,170,1.5,-120,5.9,Suntrust Park,19,1
2018-05-20,2018,MIN,MIL,3,1,-119,-1.5,176,9.0,-110,-110,109,1.5,-210,4.89,Target Field,4,2
2018-05-20,2018,MIL,MIN,1,3,109,1.5,-210,9.0,-110,-110,-119,-1.5,176,4.31,Target Field,4,-2
2018-05-20,2018,ARI,NYM,1,4,165,1.5,-135,7.5,-115,-105,-185,-1.5,115,2.83,Citi Field,5,-3
2018-05-20,2018,KC,NYY,1,10,151,1.5,-105,9.0,-115,-105,-171,-1.5,-115,3.59,Kauffman Stadium,11,-9
2018-05-20,2018,TOR,OAK,2,9,-105,1.5,-176,9.5,-114,-106,-105,-1.5,153,4.87,Rogers Centre,11,-7
2018-05-20,2018,STL,PHI,5,1,101,1.5,-160,8.0,-101,-119,-111,-1.5,140,3.98,Busch Stadium,6,4
2018-05-20,2018,SD,PIT,8,5,129,1.5,-165,8.0,-120,100,-144,-1.5,144,3.49,PNC Park,13,3
2018-05-20,2018,PIT,SD,5,8,-144,-1.5,144,8.0,-120,100,129,1.5,-165,4.72,PNC Park,13,-3
2018-05-20,2018,DET,SEA,2,3,147,1.5,-150,8.5,-101,-119,-162,-1.5,130,3.44,T-Mobile Park,5,-1
2018-05-20,2018,COL,SF,5,9,-316,-1.5,148,8.0,-105,-115,266,1.5,-170,6.08,AT&T Park,14,-4
2018-05-20,2018,PHI,STL,1,5,-111,-1.5,140,8.0,-101,-119,101,1.5,-160,4.21,Busch Stadium,6,-4
2018-05-20,2018,LAA,TB,5,2,-197,-1.5,105,7.5,-119,-101,177,1.5,-125,4.97,Angel Stadium,7,3
2018-05-20,2018,CWS,TEX,3,0,-108,-1.5,176,8.5,-111,-109,-102,1.5,-210,4.41,Guaranteed Rate Field,3,3
2018-05-20,2018,OAK,TOR,9,2,-105,-1.5,153,9.5,-114,-106,-105,1.5,-176,4.87,Rogers Centre,11,7
2018-05-20,2018,LAD,WSH,7,2,118,1.5,-190,7.5,-108,-112,-133,-1.5,163,3.44,Nationals Park,9,5
2018-05-21,2018,MIL,ARI,4,2,120,1.5,-140,7.5,-116,-104,-135,-1.5,120,3.41,Miller Park,6,2
2018-05-21,2018,PHI,ATL,3,0,-101,-1.5,184,8.5,-114,-106,-109,1.5,-220,4.27,Citizens Bank Park,3,3
2018-05-21,2018,CWS,BAL,2,3,-311,-1.5,176,9.5,-101,-119,261,1.5,-210,7.19,Guaranteed Rate Field,5,-1
2018-05-21,2018,LAD,COL,1,2,-186,-1.5,113,7.0,-111,-109,166,1.5,-133,4.55,Dodger Stadium,3,-1
2018-05-21,2018,BAL,CWS,3,2,261,1.5,-210,9.5,-101,-119,-311,-1.5,176,2.63,Guaranteed Rate Field,5,1
2018-05-21,2018,MIN,DET,4,2,-215,-1.5,-105,8.5,-103,-117,185,1.5,-115,5.8,Target Field,6,2
2018-05-21,2018,STL,KC,6,0,-215,-1.5,-105,8.5,-105,-115,185,1.5,-115,5.8,Busch Stadium,6,6
2018-05-21,2018,COL,LAD,2,1,166,1.5,-133,7.0,-111,-109,-186,-1.5,113,2.63,Dodger Stadium,3,1
2018-05-21,2018,NYM,MIA,2,0,-126,-1.5,160,8.5,-115,-105,116,1.5,-185,4.74,Citi Field,2,2
2018-05-21,2018,ARI,MIL,2,4,-135,-1.5,120,7.5,-116,-104,120,1.5,-140,4.31,Miller Park,6,-2
2018-05-21,2018,DET,MIN,2,4,185,1.5,-115,8.5,-103,-117,-215,-1.5,-105,2.98,Target Field,6,-2
2018-05-21,2018,MIA,NYM,0,2,116,1.5,-185,8.5,-115,-105,-126,-1.5,160,3.94,Citi Field,2,-2
2018-05-21,2018,TEX,NYY,5,10,185,1.5,120,9.5,-104,-116,-215,-1.5,-140,3.33,Rangers Ballpark,15,-5
2018-05-21,2018,ATL,PHI,0,3,-109,1.5,-220,8.5,-114,-106,-101,-1.5,184,4.43,Citizens Bank Park,3,-3
2018-05-21,2018,WSH,SD,10,2,-180,-1.5,120,8.0,-105,-115,160,1.5,-140,5.14,Nationals Park,12,8
2018-05-21,2018,KC,STL,0,6,185,1.5,-115,8.5,-105,-115,-215,-1.5,-105,2.98,Busch Stadium,6,-6
2018-05-21,2018,NYY,TEX,10,5,-215,-1.5,-140,9.5,-104,-116,185,1.5,120,6.48,Rangers Ballpark,15,5
2018-05-21,2018,SD,WSH,2,10,160,1.5,-140,8.0,-105,-115,-180,-1.5,120,3.08,Nationals Park,12,-8
2018-05-22,2018,MIL,ARI,1,0,-142,-1.5,135,9.0,-122,102,127,1.5,-155,5.28,Miller Park,1,1
2018-05-22,2018,PHI,ATL,1,3,-117,-1.5,176,8.5,-101,-119,107,1.5,-210,4.58,Citizens Bank Park,4,-2
2018-05-22,2018,CWS,BAL,3,2,117,1.5,-145,8.5,-110,-110,-132,-1.5,125,3.92,Guaranteed Rate Field,5,1
2018-05-22,2018,TB,BOS,2,4,205,1.5,125,7.5,-108,-112,-235,-1.5,-145,2.46,Tropicana Field,6,-2
2018-05-22,2018,CLE,CHC,10,1,-118,-1.5,130,8.0,-112,-108,108,1.5,-150,4.33,Wrigley Field,11,9
2018-05-22,2018,PIT,CIN,2,7,-114,-1.5,135,9.0,-119,-101,104,1.5,-155,4.79,Great American Ballpark,9,-5
2018-05-22,2018,CHC,CLE,1,10,108,1.5,-150,8.0,-112,-108,-118,-1.5,130,3.85,Wrigley Field,11,-9
2018-05-22,2018,LAD,COL,5,3,-145,-1.5,151,8.5,-110,-110,130,1.5,-175,5.03,Dodger Stadium,8,2
2018-05-22,2018,BAL,CWS,2,3,-132,-1.5,125,8.5,-110,-110,117,1.5,-145,4.84,Guaranteed Rate Field,5,-1
2018-05-22,2018,MIN,DET,6,0,-172,-1.5,120,9.0,100,-120,152,1.5,-140,5.69,Target Field,6,6
2018-05-22,2018,SF,HOU,2,11,204,1.5,105,8.0,-105,-115,-244,-1.5,-125,2.63,Minute Maid Park,13,-9
2018-05-22,2018,STL,KC,1,5,-194,-1.5,105,8.5,-115,-105,174,1.5,-125,5.61,Busch Stadium,6,-4
2018-05-22,2018,TOR,LAA,5,3,106,1.5,-175,8.5,-108,-112,-116,-1.5,151,4.13,Rogers Centre,8,2
2018-05-22,2018,COL,LAD,3,5,130,1.5,-175,8.5,-110,-110,-145,-1.5,151,3.7,Dodger Stadium,8,-2
2018-05-22,2018,NYM,MIA,1,5,-112,-1.5,180,7.0,-117,-103,102,1.5,-215,3.7,Citi Field,6,-4
2018-05-22,2018,ARI,MIL,0,1,127,1.5,-155,9.0,-122,102,-142,-1.5,135,3.96,Miller Park,1,-1
2018-05-22,2018,DET,MIN,0,6,152,1.5,-140,9.0,100,-120,-172,-1.5,120,3.57,Target Field,6,-6
2018-05-22,2018,MIA,NYM,5,1,102,1.5,-215,7.0,-117,-103,-112,-1.5,180,3.47,Citi Field,6,4
2018-05-22,2018,TEX,NYY,6,4,152,1.5,-110,9.5,-125,105,-167,-1.5,-110,3.77,Rangers Ballpark,10,2
2018-05-22,2018,SEA,OAK,3,2,125,1.5,-170,8.0,-119,-101,-140,-1.5,148,3.56,Oakland Coliseum,5,1
2018-05-22,2018,ATL,PHI,3,1,107,1.5,-210,8.5,-101,-119,-117,-1.5,176,4.11,Citizens Bank Park,4,2
2018-05-22,2018,CIN,PIT,7,2,104,1.5,-155,9.0,-119,-101,-114,-1.5,135,4.41,Great American Ballpark,9,5
2018-05-22,2018,WSH,SD,2,1,-197,-1.5,-101,8.5,-120,100,177,1.5,-119,5.64,Nationals Park,3,1
2018-05-22,2018,OAK,SEA,2,3,-140,-1.5,148,8.0,-119,-101,125,1.5,-170,4.67,Oakland Coliseum,5,-1
2018-05-22,2018,HOU,SF,11,2,-244,-1.5,-125,8.0,-105,-115,204,1.5,105,5.67,Minute Maid Park,13,9
2018-05-22,2018,KC,STL,5,1,174,1.5,-125,8.5,-115,-105,-194,-1.5,105,3.1,Busch Stadium,6,4
2018-05-22,2018,BOS,TB,4,2,-235,-1.5,-145,7.5,-108,-112,205,1.5,125,5.26,Tropicana Field,6,2
2018-05-22,2018,NYY,TEX,4,6,-167,-1.5,-110,9.5,-125,105,152,1.5,-110,5.94,Rangers Ballpark,10,-2
2018-05-22,2018,LAA,TOR,3,5,-116,-1.5,151,8.5,-108,-112,106,1.5,-175,4.56,Rogers Centre,8,-2
2018-05-22,2018,SD,WSH,1,2,177,1.5,-119,8.5,-120,100,-197,-1.5,-101,3.07,Nationals Park,3,-1
2018-05-23,2018,MIL,ARI,9,2,-111,-1.5,177,8.0,-110,-110,101,1.5,-212,4.21,Miller Park,11,7
2018-05-23,2018,PHI,ATL,4,0,-118,-1.5,172,9.0,-101,-119,108,1.5,-205,4.87,Citizens Bank Park,4,4
2018-05-23,2018,CWS,BAL,11,1,109,1.5,-151,9.0,-125,105,-119,-1.5,131,4.31,Guaranteed Rate Field,12,10
2018-05-23,2018,TB,BOS,1,4,126,1.5,-135,7.5,-116,-104,-141,-1.5,115,3.32,Tropicana Field,5,-3
2018-05-23,2018,CLE,CHC,1,0,153,1.5,-140,8.5,-113,-107,-173,-1.5,120,3.36,Wrigley Field,1,1
2018-05-23,2018,PIT,CIN,5,4,-115,-1.5,135,9.5,-116,-104,105,1.5,-155,5.08,Great American Ballpark,9,1
2018-05-23,2018,CHC,CLE,0,1,-173,-1.5,120,8.5,-113,-107,153,1.5,-140,5.39,Wrigley Field,1,-1
2018-05-23,2018,LAD,COL,3,0,-185,-1.5,120,7.5,-110,-110,165,1.5,-140,4.87,Dodger Stadium,3,3
2018-05-23,2018,BAL,CWS,1,11,-119,-1.5,131,9.0,-125,105,109,1.5,-151,4.89,Guaranteed Rate Field,12,-10
2018-05-23,2018,MIN,DET,1,4,-154,-1.5,140,8.5,-104,-116,139,1.5,-160,5.15,Target Field,5,-3
2018-05-23,2018,SF,HOU,1,4,266,1.5,130,8.0,-116,-104,-316,-1.5,-150,2.19,Minute Maid Park,5,-3
2018-05-23,2018,STL,KC,2,5,-158,-1.5,140,8.0,-118,-102,143,1.5,-160,4.9,Busch Stadium,7,-3
2018-05-23,2018,TOR,LAA,4,5,116,1.5,-131,9.5,-101,-119,-126,-1.5,112,4.4,Rogers Centre,9,-1
2018-05-23,2018,COL,LAD,0,3,165,1.5,-140,7.5,-110,-110,-185,-1.5,120,2.83,Dodger Stadium,3,-3
2018-05-23,2018,NYM,MIA,1,2,-240,-1.5,-115,7.5,100,-120,200,1.5,-105,5.29,Citi Field,3,-1
2018-05-23,2018,ARI,MIL,2,9,101,1.5,-212,8.0,-110,-110,-111,-1.5,177,3.98,Miller Park,11,-7
2018-05-23,2018,DET,MIN,4,1,139,1.5,-160,8.5,-104,-116,-154,-1.5,140,3.56,Target Field,5,3
2018-05-23,2018,MIA,NYM,2,1,200,1.5,-105,7.5,100,-120,-240,-1.5,-115,2.5,Citi Field,3,1
2018-05-23,2018,TEX,NYY,12,10,176,1.5,113,9.5,101,-121,-206,-1.5,-133,3.44,Rangers Ballpark,22,2
2018-05-23,2018,SEA,OAK,1,0,102,1.5,-210,8.5,-110,-110,-112,-1.5,176,4.21,Oakland Coliseum,1,1
2018-05-23,2018,ATL,PHI,0,4,108,1.5,-205,9.0,-101,-119,-118,-1.5,172,4.33,Citizens Bank Park,4,-4
2018-05-23,2018,CIN,PIT,4,5,105,1.5,-155,9.5,-116,-104,-115,-1.5,135,4.63,Great American Ballpark,9,-1
2018-05-23,2018,WSH,SD,1,3,-149,-1.5,144,8.5,-119,-101,134,1.5,-165,5.09,Nationals Park,4,-2
2018-05-23,2018,OAK,SEA,0,1,-112,-1.5,176,8.5,-110,-110,102,1.5,-210,4.49,Oakland Coliseum,1,-1
2018-05-23,2018,HOU,SF,4,1,-316,-1.5,-150,8.0,-116,-104,266,1.5,130,6.08,Minute Maid Park,5,3
2018-05-23,2018,KC,STL,5,2,143,1.5,-160,8.0,-118,-102,-158,-1.5,140,3.29,Busch Stadium,7,3
2018-05-23,2018,BOS,TB,4,1,-141,-1.5,115,7.5,-116,-104,126,1.5,-135,4.39,Tropicana Field,5,3
2018-05-23,2018,NYY,TEX,10,12,-206,-1.5,-133,9.5,101,-121,176,1.5,113,6.4,Rangers Ballpark,22,-2
2018-05-23,2018,LAA,TOR,5,4,-126,-1.5,112,9.5,-101,-119,116,1.5,-131,5.3,Rogers Centre,9,1
2018-05-23,2018,SD,WSH,3,1,134,1.5,-165,8.5,-119,-101,-149,-1.5,144,3.63,Nationals Park,4,2
2018-05-24,2018,CWS,BAL,3,9,136,1.5,-120,9.5,-115,-105,-151,-1.5,100,4.03,Guaranteed Rate Field,12,-6
2018-05-24,2018,TB,BOS,6,3,106,1.5,-160,7.0,-120,100,-116,-1.5,140,3.4,Tropicana Field,9,3
2018-05-24,2018,PIT,CIN,4,5,103,1.5,-215,8.5,-101,-119,-113,-1.5,180,4.19,Great American Ballpark,9,-1
2018-05-24,2018,HOU,CLE,8,2,-119,-1.5,135,7.5,-120,100,109,1.5,-155,4.08,Progressive Field,10,6
2018-05-24,2018,BAL,CWS,9,3,-151,-1.5,100,9.5,-115,-105,136,1.5,-120,5.72,Guaranteed Rate Field,12,6
2018-05-24,2018,CLE,HOU,2,8,109,1.5,-155,7.5,-120,100,-119,-1.5,135,3.59,Progressive Field,10,-6
2018-05-24,2018,TEX,KC,2,8,104,1.5,-152,10.0,-109,-111,-114,-1.5,132,4.9,Rangers Ballpark,10,-6
2018-05-24,2018,TOR,LAA,1,8,117,1.5,-135,9.5,100,-120,-132,-1.5,115,4.38,Rogers Centre,9,-7
2018-05-24,2018,NYM,MIL,5,0,145,1.5,-150,9.0,-107,-113,-160,-1.5,130,3.67,Miller Park,5,5
2018-05-24,2018,MIL,NYM,0,5,-160,-1.5,130,9.0,-107,-113,145,1.5,-150,5.54,Miller Park,5,-5
2018-05-24,2018,SEA,OAK,3,4,120,1.5,-180,9.0,-109,-111,-135,-1.5,155,4.09,Oakland Coliseum,7,-1
2018-05-24,2018,CIN,PIT,5,4,-113,-1.5,180,8.5,-101,-119,103,1.5,-215,4.51,Great American Ballpark,9,1
2018-05-24,2018,OAK,SEA,4,3,-135,-1.5,155,9.0,-109,-111,120,1.5,-180,5.17,Oakland Coliseum,7,1
2018-05-24,2018,BOS,TB,3,6,-116,-1.5,140,7.0,-120,100,106,1.5,-160,3.76,Tropicana Field,9,-3
2018-05-24,2018,KC,TEX,8,2,-114,-1.5,132,10.0,-109,-111,104,1.5,-152,5.33,Rangers Ballpark,10,6
2018-05-24,2018,LAA,TOR,8,1,-132,-1.5,115,9.5,100,-120,117,1.5,-135,5.41,Rogers Centre,9,7
2018-05-25,2018,OAK,ARI,1,7,-140,-1.5,155,7.0,-120,100,125,1.5,-180,4.08,Oakland Coliseum,8,-6
2018-05-25,2018,BOS,ATL,6,2,-186,-1.5,105,10.5,-118,-102,166,1.5,-125,6.83,Fenway Park,8,4
2018-05-25,2018,TB,BAL,0,2,-160,-1.5,130,8.0,-110,-110,145,1.5,-150,4.92,Tropicana Field,2,-2
2018-05-25,2018,ATL,BOS,2,6,166,1.5,-125,10.5,-118,-102,-186,-1.5,105,3.95,Fenway Park,8,-4
2018-05-25,2018,SF,CHC,2,6,205,1.5,101,11.0,105,-125,-235,-1.5,-121,3.61,Wrigley Field,8,-4
2018-05-25,2018,COL,CIN,5,4,-195,-1.5,-110,11.5,-119,-101,175,1.5,-110,7.6,Coors Field,9,1
2018-05-25,2018,HOU,CLE,11,2,140,1.5,-165,7.5,-119,-101,-155,-1.5,144,3.13,Progressive Field,13,9
2018-05-25,2018,CIN,COL,4,5,175,1.5,-110,11.5,-119,-101,-195,-1.5,-110,4.18,Coors Field,9,-1
2018-05-25,2018,DET,CWS,5,4,-109,-1.5,180,9.0,-112,-108,-101,1.5,-215,4.69,Comerica Park,9,1
2018-05-25,2018,CWS,DET,4,5,-101,1.5,-215,9.0,-112,-108,-109,-1.5,180,4.52,Comerica Park,9,-1
2018-05-25,2018,CLE,HOU,2,11,-155,-1.5,144,7.5,-119,-101,140,1.5,-165,4.56,Progressive Field,13,-9
2018-05-25,2018,TEX,KC,8,4,-142,-1.5,144,9.5,-110,-110,127,1.5,-165,5.57,Rangers Ballpark,12,4
2018-05-25,2018,NYY,LAA,2,1,-235,-1.5,-117,9.0,-119,-101,205,1.5,-103,6.31,Yankee Stadium,3,1
2018-05-25,2018,SD,LAD,1,4,167,1.5,-135,7.5,101,-121,-187,-1.5,115,2.81,Dodger Stadium,5,-3
2018-05-25,2018,WSH,MIA,9,5,-240,-1.5,-145,7.0,-102,-118,200,1.5,125,4.94,Marlins Park,14,4
2018-05-25,2018,NYM,MIL,3,4,-119,-1.5,140,8.0,-120,100,109,1.5,-160,4.35,Miller Park,7,-1
2018-05-25,2018,SEA,MIN,2,1,-160,-1.5,135,7.0,-119,-101,145,1.5,-155,4.31,T-Mobile Park,3,1
2018-05-25,2018,MIL,NYM,4,3,109,1.5,-160,8.0,-120,100,-119,-1.5,140,3.83,Miller Park,7,1
2018-05-25,2018,LAA,NYY,1,2,205,1.5,-103,9.0,-119,-101,-235,-1.5,-117,2.95,Yankee Stadium,3,-1
2018-05-25,2018,ARI,OAK,7,1,125,1.5,-180,7.0,-120,100,-140,-1.5,155,3.11,Oakland Coliseum,8,6
2018-05-25,2018,TOR,PHI,6,5,-119,-1.5,146,9.0,-119,-101,109,1.5,-168,4.89,Citizens Bank Park,11,1
2018-05-25,2018,STL,PIT,1,8,119,1.5,-175,9.0,-105,-115,-129,-1.5,151,4.11,PNC Park,9,-7
2018-05-25,2018,LAD,SD,4,1,-187,-1.5,115,7.5,101,-121,167,1.5,-135,4.89,Dodger Stadium,5,3
2018-05-25,2018,MIN,SEA,1,2,145,1.5,-155,7.0,-119,-101,-160,-1.5,135,2.86,T-Mobile Park,3,-1
2018-05-25,2018,CHC,SF,6,2,-235,-1.5,-121,11.0,105,-125,205,1.5,101,7.72,Wrigley Field,8,4
2018-05-25,2018,PIT,STL,8,1,-129,-1.5,151,9.0,-105,-115,119,1.5,-175,5.07,PNC Park,9,7
2018-05-25,2018,BAL,TB,2,0,145,1.5,-150,8.0,-110,-110,-160,-1.5,130,3.27,Tropicana Field,2,2
2018-05-25,2018,KC,TEX,4,8,127,1.5,-165,9.5,-110,-110,-142,-1.5,144,4.19,Rangers Ballpark,12,-4
2018-05-25,2018,PHI,TOR,5,6,109,1.5,-168,9.0,-119,-101,-119,-1.5,146,4.31,Citizens Bank Park,11,-1
2018-05-25,2018,MIA,WSH,5,9,200,1.5,125,7.0,-102,-118,-240,-1.5,-145,2.33,Marlins Park,14,-4
2018-05-26,2018,OAK,ARI,3,0,-166,-1.5,127,9.0,105,-125,151,1.5,-147,5.62,Oakland Coliseum,3,3
2018-05-26,2018,BOS,ATL,8,6,-125,-1.5,150,10.5,-125,105,115,1.5,-173,5.83,Fenway Park,14,2
2018-05-26,2018,TB,BAL,5,1,-143,-1.5,146,8.0,-118,-102,128,1.5,-167,4.71,Tropicana Field,6,4
2018-05-26,2018,ATL,BOS,6,8,115,1.5,-173,10.5,-125,105,-125,-1.5,150,4.88,Fenway Park,14,-2
2018-05-26,2018,SF,CHC,5,4,200,1.5,112,10.0,-102,-118,-240,-1.5,-132,3.33,Wrigley Field,9,1
2018-05-26,2018,COL,CIN,5,6,-176,-1.5,105,11.5,-112,-108,156,1.5,-125,7.33,Coors Field,11,-1
2018-05-26,2018,HOU,CLE,6,8,-101,1.5,-220,8.0,-110,-110,-109,-1.5,184,4.02,Progressive Field,14,-2
2018-05-26,2018,CIN,COL,6,5,156,1.5,-125,11.5,-112,-108,-176,-1.5,105,4.49,Coors Field,11,1
2018-05-26,2018,DET,CWS,4,8,-104,-1.5,170,9.5,-105,-115,-106,1.5,-200,4.84,Comerica Park,12,-4
2018-05-26,2018,CWS,DET,8,4,-106,1.5,-200,9.5,-105,-115,-104,-1.5,170,4.89,Comerica Park,12,4
2018-05-26,2018,CLE,HOU,8,6,-109,-1.5,184,8.0,-110,-110,-101,1.5,-220,4.17,Progressive Field,14,2
2018-05-26,2018,TEX,KC,4,3,-138,-1.5,144,10.5,-110,-110,123,1.5,-165,6.09,Rangers Ballpark,7,1
2018-05-26,2018,NYY,LAA,4,11,-155,-1.5,128,10.0,-110,-110,140,1.5,-148,6.08,Yankee Stadium,15,-7
2018-05-26,2018,SD,LAD,7,5,195,1.5,-115,7.0,-125,105,-225,-1.5,-105,2.37,Dodger Stadium,12,2
2018-05-26,2018,WSH,MIA,4,1,-150,-1.5,104,8.0,100,-120,135,1.5,-124,4.8,Marlins Park,5,3
2018-05-26,2018,NYM,MIL,6,17,128,1.5,-165,9.5,-110,-110,-143,-1.5,144,4.17,Miller Park,23,-11
2018-05-26,2018,SEA,MIN,4,3,-127,-1.5,160,8.5,-115,-105,117,1.5,-185,4.76,T-Mobile Park,7,1
2018-05-26,2018,MIL,NYM,17,6,-143,-1.5,144,9.5,-110,-110,128,1.5,-165,5.59,Miller Park,23,11
2018-05-26,2018,LAA,NYY,11,4,140,1.5,-148,10.0,-110,-110,-155,-1.5,128,4.17,Yankee Stadium,15,7
2018-05-26,2018,ARI,OAK,0,3,151,1.5,-147,9.0,105,-125,-166,-1.5,127,3.59,Oakland Coliseum,3,-3
2018-05-26,2018,TOR,PHI,1,2,161,1.5,-132,8.5,-119,-101,-181,-1.5,112,3.26,Citizens Bank Park,3,-1
2018-05-26,2018,STL,PIT,4,1,-104,-1.5,149,8.5,-110,-110,-106,1.5,-172,4.33,PNC Park,5,3
2018-05-26,2018,LAD,SD,5,7,-225,-1.5,-105,7.0,-125,105,195,1.5,-115,4.85,Dodger Stadium,12,-2
2018-05-26,2018,MIN,SEA,3,4,117,1.5,-185,8.5,-115,-105,-127,-1.5,160,3.92,T-Mobile Park,7,-1
2018-05-26,2018,CHC,SF,4,5,-240,-1.5,-132,10.0,-102,-118,200,1.5,112,7.06,Wrigley Field,9,-1
2018-05-26,2018,PIT,STL,1,4,-106,1.5,-172,8.5,-110,-110,-104,-1.5,149,4.37,PNC Park,5,-3
2018-05-26,2018,BAL,TB,1,5,128,1.5,-167,8.0,-118,-102,-143,-1.5,146,3.51,Tropicana Field,6,-4
2018-05-26,2018,KC,TEX,3,4,123,1.5,-165,10.5,-110,-110,-138,-1.5,144,4.71,Rangers Ballpark,7,-1
2018-05-26,2018,PHI,TOR,2,1,-181,-1.5,112,8.5,-119,-101,161,1.5,-132,5.48,Citizens Bank Park,3,1
2018-05-26,2018,MIA,WSH,1,4,135,1.5,-124,8.0,100,-120,-150,-1.5,104,3.4,Marlins Park,5,-3
2018-05-27,2018,OAK,ARI,2,1,111,1.5,-154,8.0,-110,-110,-121,-1.5,134,3.79,Oakland Coliseum,3,1
2018-05-27,2018,BOS,ATL,1,7,-215,-1.5,-110,7.5,100,-120,185,1.5,-110,5.12,Fenway Park,8,-6
2018-05-27,2018,TB,BAL,8,3,-109,-1.5,172,8.0,100,-120,-101,1.5,-205,4.17,Tropicana Field,11,5
2018-05-27,2018,ATL,BOS,7,1,185,1.5,-110,7.5,100,-120,-215,-1.5,-110,2.63,Fenway Park,8,6
2018-05-27,2018,SF,CHC,3,8,158,1.5,-130,10.0,-115,-105,-178,-1.5,110,3.88,Wrigley Field,11,-5
2018-05-27,2018,COL,CIN,8,2,-170,-1.5,105,12.5,-115,-105,150,1.5,-125,7.87,Coors Field,10,6
2018-05-27,2018,HOU,CLE,9,10,-124,-1.5,129,8.0,-114,-106,114,1.5,-149,4.43,Progressive Field,19,-1
2018-05-27,2018,CIN,COL,2,8,150,1.5,-125,12.5,-115,-105,-170,-1.5,105,5.0,Coors Field,10,-6
2018-05-27,2018,DET,CWS,3,2,-134,-1.5,151,9.5,-110,-110,119,1.5,-175,5.44,Comerica Park,5,1
2018-05-27,2018,CWS,DET,2,3,119,1.5,-175,9.5,-110,-110,-134,-1.5,151,4.34,Comerica Park,5,-1
2018-05-27,2018,CLE,HOU,10,9,114,1.5,-149,8.0,-114,-106,-124,-1.5,129,3.74,Progressive Field,19,1
2018-05-27,2018,TEX,KC,3,5,-200,-1.5,-101,10.0,-115,-105,170,1.5,-119,6.67,Rangers Ballpark,8,-2
2018-05-27,2018,NYY,LAA,3,1,-161,-1.5,129,8.0,-108,-112,146,1.5,-149,4.93,Yankee Stadium,4,2
2018-05-27,2018,SD,LAD,1,6,215,1.5,106,7.5,-117,-103,-255,-1.5,-125,2.38,Dodger Stadium,7,-5
2018-05-27,2018,WSH,MIA,5,2,-215,-1.5,-140,7.5,-119,-101,185,1.5,120,5.12,Marlins Park,7,3
2018-05-27,2018,NYM,MIL,7,8,125,1.5,-160,9.0,-111,-109,-140,-1.5,140,4.0,Miller Park,15,-1
2018-05-27,2018,SEA,MIN,3,1,117,1.5,-148,8.0,-113,-107,-127,-1.5,128,3.69,T-Mobile Park,4,2
2018-05-27,2018,MIL,NYM,8,7,-140,-1.5,140,9.0,-111,-109,125,1.5,-160,5.25,Miller Park,15,1
2018-05-27,2018,LAA,NYY,1,3,146,1.5,-149,8.0,-108,-112,-161,-1.5,129,3.25,Yankee Stadium,4,-2
2018-05-27,2018,ARI,OAK,1,2,-121,-1.5,134,8.0,-110,-110,111,1.5,-154,4.38,Oakland Coliseum,3,-1
2018-05-27,2018,TOR,PHI,5,3,-111,-1.5,155,8.0,-115,-105,101,1.5,-180,4.21,Citizens Bank Park,8,2
2018-05-27,2018,STL,PIT,6,4,106,1.5,-205,8.0,-107,-113,-116,-1.5,172,3.88,PNC Park,10,2
2018-05-27,2018,LAD,SD,6,1,-255,-1.5,-125,7.5,-117,-103,215,1.5,106,5.39,Dodger Stadium,7,5
2018-05-27,2018,MIN,SEA,1,3,-127,-1.5,128,8.0,-113,-107,117,1.5,-148,4.48,T-Mobile Park,4,-2
2018-05-27,2018,CHC,SF,8,3,-178,-1.5,110,10.0,-115,-105,158,1.5,-130,6.4,Wrigley Field,11,5
2018-05-27,2018,PIT,STL,4,6,-116,-1.5,172,8.0,-107,-113,106,1.5,-205,4.3,PNC Park,10,-2
2018-05-27,2018,BAL,TB,3,8,-101,1.5,-205,8.0,100,-120,-109,-1.5,172,4.02,Tropicana Field,11,-5
2018-05-27,2018,KC,TEX,5,3,170,1.5,-119,10.0,-115,-105,-200,-1.5,-101,3.7,Rangers Ballpark,8,2
2018-05-27,2018,PHI,TOR,3,5,101,1.5,-180,8.0,-115,-105,-111,-1.5,155,3.98,Citizens Bank Park,8,-2
2018-05-27,2018,MIA,WSH,2,5,185,1.5,120,7.5,-119,-101,-215,-1.5,-140,2.63,Marlins Park,7,-3
2018-05-28,2018,CIN,ARI,5,12,104,1.5,-210,9.0,-117,-103,-114,-1.5,176,4.41,Chase Field,17,-7
2018-05-28,2018,NYM,ATL,3,4,261,1.5,-220,7.5,-105,-115,-311,-1.5,184,2.08,Suntrust Park,7,-1
2018-05-28,2018,NYM,ATL,8,5,150,1.5,-140,9.0,-104,-116,-170,-1.5,120,3.6,Suntrust Park,13,3
2018-05-28,2018,WSH,BAL,6,0,-129,-1.5,115,9.0,-111,-109,119,1.5,-135,5.07,Camden Yards,6,6
2018-05-28,2018,TOR,BOS,3,8,160,1.5,-128,9.0,-110,-110,-180,-1.5,109,3.46,Fenway Park,11,-5
2018-05-28,2018,PIT,CHC,0,7,-105,-1.5,184,9.0,-121,101,-105,1.5,-220,4.61,PNC Park,7,-7
2018-05-28,2018,ARI,CIN,12,5,-114,-1.5,176,9.0,-117,-103,104,1.5,-210,4.79,Chase Field,17,7
2018-05-28,2018,CWS,CLE,6,9,160,1.5,-119,10.0,-115,-105,-180,-1.5,100,3.85,Progressive Field,15,-3
2018-05-28,2018,SF,COL,5,6,101,1.5,-187,11.0,-119,-101,-111,-1.5,160,5.47,Coors Field,11,-1
2018-05-28,2018,CLE,CWS,9,6,-180,-1.5,100,10.0,-115,-105,160,1.5,-119,6.43,Progressive Field,15,3
2018-05-28,2018,LAA,DET,3,9,-176,-1.5,-125,10.0,-117,-103,156,1.5,105,6.38,Comerica Park,12,-6
2018-05-28,2018,NYY,HOU,1,5,100,1.5,-165,8.5,101,-121,-110,-1.5,144,4.25,Yankee Stadium,6,-4
2018-05-28,2018,MIN,KC,8,5,-128,-1.5,130,9.0,-105,-115,118,1.5,-150,5.05,Kauffman Stadium,13,3
2018-05-28,2018,DET,LAA,9,3,156,1.5,105,10.0,-117,-103,-176,-1.5,-125,3.91,Comerica Park,12,6
2018-05-28,2018,PHI,LAD,4,5,123,1.5,-177,8.5,-101,-119,-138,-1.5,152,3.81,Dodger Stadium,9,-1
2018-05-28,2018,SD,MIA,2,7,-116,-1.5,180,7.5,-105,-115,106,1.5,-215,4.03,PETCO Park,9,-5
2018-05-28,2018,STL,MIL,3,8,-101,1.5,-205,9.0,-119,-101,-109,-1.5,172,4.52,Miller Park,11,-5
2018-05-28,2018,KC,MIN,5,8,118,1.5,-150,9.0,-105,-115,-128,-1.5,130,4.13,Kauffman Stadium,13,-3
2018-05-28,2018,ATL,NYM,4,3,-311,-1.5,184,7.5,-105,-115,261,1.5,-220,5.68,Suntrust Park,7,1
2018-05-28,2018,ATL,NYM,5,8,-170,-1.5,120,9.0,-104,-116,150,1.5,-140,5.67,Suntrust Park,13,-3
2018-05-28,2018,HOU,NYY,5,1,-110,-1.5,144,8.5,101,-121,100,1.5,-165,4.45,Yankee Stadium,6,4
2018-05-28,2018,TB,OAK,1,0,119,1.5,-195,8.0,-109,-111,-129,-1.5,166,3.65,Oakland Coliseum,1,1
2018-05-28,2018,LAD,PHI,5,4,-138,-1.5,152,8.5,-101,-119,123,1.5,-177,4.93,Dodger Stadium,9,1
2018-05-28,2018,CHC,PIT,7,0,-105,1.5,-220,9.0,-121,101,-105,-1.5,184,4.61,PNC Park,7,7
2018-05-28,2018,MIA,SD,7,2,106,1.5,-215,7.5,-105,-115,-116,-1.5,180,3.64,PETCO Park,9,5
2018-05-28,2018,TEX,SEA,1,2,155,1.5,-140,8.0,-105,-115,-175,-1.5,120,3.14,T-Mobile Park,3,-1
2018-05-28,2018,COL,SF,6,5,-111,-1.5,160,11.0,-119,-101,101,1.5,-187,5.79,Coors Field,11,1
2018-05-28,2018,MIL,STL,8,3,-109,-1.5,172,9.0,-119,-101,-101,1.5,-205,4.69,Miller Park,11,5
2018-05-28,2018,OAK,TB,0,1,-129,-1.5,166,8.0,-109,-111,119,1.5,-195,4.51,Oakland Coliseum,1,-1
2018-05-28,2018,SEA,TEX,2,1,-175,-1.5,120,8.0,-105,-115,155,1.5,-140,5.09,T-Mobile Park,3,1
2018-05-28,2018,BOS,TOR,8,3,-180,-1.5,109,9.0,-110,-110,160,1.5,-128,5.79,Fenway Park,11,5
2018-05-28,2018,BAL,WSH,0,6,119,1.5,-135,9.0,-111,-109,-129,-1.5,115,4.11,Camden Yards,6,-6
2018-05-29,2018,CIN,ARI,2,5,100,1.5,-225,8.0,-119,-101,-110,-1.5,188,4.0,Chase Field,7,-3
2018-05-29,2018,NYM,ATL,6,7,121,1.5,-165,8.5,-120,100,-136,-1.5,144,3.85,Suntrust Park,13,-1
2018-05-29,2018,WSH,BAL,3,2,105,1.5,-185,9.0,-125,105,-115,-1.5,160,4.39,Camden Yards,5,1
2018-05-29,2018,TOR,BOS,3,8,170,1.5,-110,9.5,-110,-110,-190,-1.5,-110,3.52,Fenway Park,11,-5
2018-05-29,2018,PIT,CHC,6,8,120,1.5,-135,8.5,-125,105,-135,-1.5,115,3.86,PNC Park,14,-2
2018-05-29,2018,ARI,CIN,5,2,-110,-1.5,188,8.0,-119,-101,100,1.5,-225,4.19,Chase Field,7,3
2018-05-29,2018,CWS,CLE,3,7,249,1.5,128,10.0,-115,-105,-289,-1.5,-148,2.87,Progressive Field,10,-4
2018-05-29,2018,SF,COL,4,11,131,1.5,-140,11.5,-110,-110,-146,-1.5,120,4.98,Coors Field,15,-7
2018-05-29,2018,CLE,CWS,7,3,-289,-1.5,-148,10.0,-115,-105,249,1.5,128,7.43,Progressive Field,10,4
2018-05-29,2018,LAA,DET,9,2,-140,-1.5,105,9.0,-112,-108,125,1.5,-125,5.25,Comerica Park,11,7
2018-05-29,2018,NYY,HOU,6,5,114,1.5,-150,9.0,-110,-110,-124,-1.5,130,4.21,Yankee Stadium,11,1
2018-05-29,2018,MIN,KC,1,2,-126,-1.5,125,9.0,105,-125,116,1.5,-145,5.02,Kauffman Stadium,3,-1
2018-05-29,2018,DET,LAA,2,9,125,1.5,-125,9.0,-112,-108,-140,-1.5,105,4.0,Comerica Park,11,-7
2018-05-29,2018,PHI,LAD,6,1,173,1.5,-134,7.0,-101,-119,-193,-1.5,114,2.56,Dodger Stadium,7,5
2018-05-29,2018,SD,MIA,9,5,-164,-1.5,148,7.0,102,-122,149,1.5,-170,4.35,PETCO Park,14,4
2018-05-29,2018,STL,MIL,6,1,105,1.5,-200,8.5,-105,-115,-115,-1.5,170,4.15,Miller Park,7,5
2018-05-29,2018,KC,MIN,2,1,116,1.5,-145,9.0,105,-125,-126,-1.5,125,4.17,Kauffman Stadium,3,1
2018-05-29,2018,ATL,NYM,7,6,-136,-1.5,144,8.5,-120,100,121,1.5,-165,4.9,Suntrust Park,13,1
2018-05-29,2018,HOU,NYY,5,6,-124,-1.5,130,9.0,-110,-110,114,1.5,-150,4.98,Yankee Stadium,11,-1
2018-05-29,2018,TB,OAK,4,3,-106,-1.5,143,7.5,100,-120,-104,1.5,-164,3.86,Oakland Coliseum,7,1
2018-05-29,2018,LAD,PHI,1,6,-193,-1.5,114,7.0,-101,-119,173,1.5,-134,4.61,Dodger Stadium,7,-5
2018-05-29,2018,CHC,PIT,8,6,-135,-1.5,115,8.5,-125,105,120,1.5,-135,4.88,PNC Park,14,2
2018-05-29,2018,MIA,SD,5,9,149,1.5,-170,7.0,102,-122,-164,-1.5,148,2.81,PETCO Park,14,-4
2018-05-29,2018,TEX,SEA,9,5,134,1.5,-155,8.5,-125,105,-149,-1.5,135,3.63,T-Mobile Park,14,4
2018-05-29,2018,COL,SF,11,4,-146,-1.5,120,11.5,-110,-110,131,1.5,-140,6.83,Coors Field,15,7
2018-05-29,2018,MIL,STL,1,6,-115,-1.5,170,8.5,-105,-115,105,1.5,-200,4.55,Miller Park,7,-5
2018-05-29,2018,OAK,TB,3,4,-104,1.5,-164,7.5,100,-120,-106,-1.5,143,3.82,Oakland Coliseum,7,-1
2018-05-29,2018,SEA,TEX,5,9,-149,-1.5,135,8.5,-125,105,134,1.5,-155,5.09,T-Mobile Park,14,-4
2018-05-29,2018,BOS,TOR,8,3,-190,-1.5,-110,9.5,-110,-110,170,1.5,-110,6.22,Fenway Park,11,5
2018-05-29,2018,BAL,WSH,2,3,-115,-1.5,160,9.0,-125,105,105,1.5,-185,4.81,Camden Yards,5,-1
2018-05-30,2018,CIN,ARI,7,4,170,1.5,-119,8.0,-105,-115,-200,-1.5,-101,2.96,Chase Field,11,3
2018-05-30,2018,NYM,ATL,4,1,135,1.5,-165,9.0,-108,-112,-150,-1.5,144,3.83,Suntrust Park,5,3
2018-05-30,2018,WSH,BAL,2,0,-260,-1.5,-165,9.0,100,-120,220,1.5,144,6.5,Camden Yards,2,2
2018-05-30,2018,TOR,BOS,4,6,165,1.5,-140,9.0,100,-120,-185,-1.5,115,3.4,Fenway Park,10,-2
2018-05-30,2018,PIT,CHC,2,1,116,1.5,-136,8.0,-102,-118,-131,-1.5,116,3.7,PNC Park,3,1
2018-05-30,2018,ARI,CIN,4,7,-200,-1.5,-101,8.0,-105,-115,170,1.5,-119,5.33,Chase Field,11,-3
2018-05-30,2018,CWS,CLE,1,9,210,1.5,115,8.5,-125,105,-250,-1.5,-135,2.74,Progressive Field,10,-8
2018-05-30,2018,SF,COL,7,4,145,1.5,-135,10.5,-119,-101,-160,-1.5,115,4.29,Coors Field,11,3
2018-05-30,2018,CLE,CWS,9,1,-250,-1.5,-135,8.5,-125,105,210,1.5,115,6.07,Progressive Field,10,8
2018-05-30,2018,LAA,DET,1,6,-242,-1.5,-133,8.5,-105,-115,202,1.5,116,6.01,Comerica Park,7,-5
2018-05-30,2018,NYY,HOU,5,3,-193,-1.5,104,8.0,100,-120,173,1.5,-124,5.27,Yankee Stadium,8,2
2018-05-30,2018,MIN,KC,8,11,-134,-1.5,125,9.0,-104,-116,119,1.5,-145,5.15,Kauffman Stadium,19,-3
2018-05-30,2018,DET,LAA,6,1,202,1.5,116,8.5,-105,-115,-242,-1.5,-133,2.81,Comerica Park,7,5
2018-05-30,2018,PHI,LAD,2,8,170,1.5,-135,7.5,-105,-115,-190,-1.5,115,2.78,Dodger Stadium,10,-6
2018-05-30,2018,SD,MIA,3,2,-126,-1.5,170,7.0,-125,105,116,1.5,-200,3.9,PETCO Park,5,1
2018-05-30,2018,STL,MIL,2,3,-101,1.5,-220,8.5,100,-120,-109,-1.5,184,4.27,Miller Park,5,-1
2018-05-30,2018,KC,MIN,11,8,119,1.5,-145,9.0,-104,-116,-134,-1.5,125,4.11,Kauffman Stadium,19,3
2018-05-30,2018,ATL,NYM,1,4,-150,-1.5,144,9.0,-108,-112,135,1.5,-165,5.4,Suntrust Park,5,-3
2018-05-30,2018,HOU,NYY,3,5,173,1.5,-124,8.0,100,-120,-193,-1.5,104,2.93,Yankee Stadium,8,-2
2018-05-30,2018,TB,OAK,6,0,116,1.5,-190,8.0,100,-120,-126,-1.5,163,3.7,Oakland Coliseum,6,6
2018-05-30,2018,LAD,PHI,8,2,-190,-1.5,115,7.5,-105,-115,170,1.5,-135,4.91,Dodger Stadium,10,6
2018-05-30,2018,CHC,PIT,1,2,-131,-1.5,116,8.0,-102,-118,116,1.5,-136,4.54,PNC Park,3,-1
2018-05-30,2018,MIA,SD,2,3,116,1.5,-200,7.0,-125,105,-126,-1.5,170,3.24,PETCO Park,5,-1
2018-05-30,2018,TEX,SEA,7,6,236,1.5,114,7.5,105,-125,-276,-1.5,-134,2.23,T-Mobile Park,13,1
2018-05-30,2018,COL,SF,4,7,-160,-1.5,115,10.5,-119,-101,145,1.5,-135,6.46,Coors Field,11,-3
2018-05-30,2018,MIL,STL,3,2,-109,-1.5,184,8.5,100,-120,-101,1.5,-220,4.43,Miller Park,5,1
2018-05-30,2018,OAK,TB,0,6,-126,-1.5,163,8.0,100,-120,116,1.5,-190,4.46,Oakland Coliseum,6,-6
2018-05-30,2018,SEA,TEX,6,7,-276,-1.5,-134,7.5,105,-125,236,1.5,114,5.51,T-Mobile Park,13,-1
2018-05-30,2018,BOS,TOR,6,4,-185,-1.5,115,9.0,100,-120,165,1.5,-140,5.84,Fenway Park,10,2
2018-05-30,2018,BAL,WSH,0,2,220,1.5,144,9.0,100,-120,-260,-1.5,-165,2.81,Camden Yards,2,-2
2018-05-31,2018,WSH,ATL,2,4,112,1.5,-195,8.5,-115,-105,-122,-1.5,166,4.01,Suntrust Park,6,-2
2018-05-31,2018,HOU,BOS,4,2,-200,-1.5,-105,8.5,-110,-110,170,1.5,-115,5.67,Minute Maid Park,6,2
2018-05-31,2018,NYM,CHC,1,5,152,1.5,-110,8.0,-110,-110,-167,-1.5,-110,3.17,Citi Field,6,-4
2018-05-31,2018,MIN,CLE,8,9,114,1.5,-140,9.5,-115,-105,-124,-1.5,120,4.44,Target Field,17,-1
2018-05-31,2018,LAA,DET,2,6,-200,-1.5,-137,10.0,105,-125,170,1.5,117,6.67,Comerica Park,8,-4
2018-05-31,2018,BOS,HOU,2,4,170,1.5,-115,8.5,-110,-110,-200,-1.5,-105,3.15,Minute Maid Park,6,-2
2018-05-31,2018,DET,LAA,6,2,170,1.5,117,10.0,105,-125,-200,-1.5,-137,3.7,Comerica Park,8,4
2018-05-31,2018,PHI,LAD,2,1,148,1.5,-157,6.5,102,-122,-163,-1.5,137,2.62,Dodger Stadium,3,1
2018-05-31,2018,SD,MIA,8,3,-133,-1.5,160,7.5,-115,-105,118,1.5,-185,4.28,PETCO Park,11,5
2018-05-31,2018,CLE,MIN,9,8,-124,-1.5,120,9.5,-115,-105,114,1.5,-140,5.26,Target Field,17,1
2018-05-31,2018,CHC,NYM,5,1,-167,-1.5,-110,8.0,-110,-110,152,1.5,-110,5.0,Citi Field,6,4
2018-05-31,2018,TB,OAK,3,7,127,1.5,-180,8.0,-105,-115,-142,-1.5,155,3.52,Oakland Coliseum,10,-4
2018-05-31,2018,LAD,PHI,1,2,-163,-1.5,137,6.5,102,-122,148,1.5,-157,4.03,Dodger Stadium,3,-1
2018-05-31,2018,STL,PIT,10,8,-133,-1.5,151,8.0,-119,-101,118,1.5,-175,4.57,Busch Stadium,18,2
2018-05-31,2018,MIA,SD,3,8,118,1.5,-185,7.5,-115,-105,-133,-1.5,160,3.44,PETCO Park,11,-5
2018-05-31,2018,TEX,SEA,1,6,125,1.5,-168,7.5,-119,-101,-140,-1.5,146,3.33,T-Mobile Park,7,-5
2018-05-31,2018,PIT,STL,8,10,118,1.5,-175,8.0,-119,-101,-133,-1.5,151,3.67,Busch Stadium,18,-2
2018-05-31,2018,OAK,TB,7,3,-142,-1.5,155,8.0,-105,-115,127,1.5,-180,4.69,Oakland Coliseum,10,4
2018-05-31,2018,SEA,TEX,6,1,-140,-1.5,146,7.5,-119,-101,125,1.5,-168,4.38,T-Mobile Park,7,5
2018-05-31,2018,ATL,WSH,4,2,-122,-1.5,166,8.5,-115,-105,112,1.5,-195,4.67,Suntrust Park,6,2
2018-06-01,2018,MIA,ARI,1,9,130,1.5,-160,9.0,-106,-114,-145,-1.5,140,3.91,Chase Field,10,-8
2018-06-01,2018,WSH,ATL,0,4,-138,-1.5,117,8.0,-105,-115,123,1.5,-137,4.64,Suntrust Park,4,-4
2018-06-01,2018,NYY,BAL,4,1,-180,-1.5,-125,10.5,-101,-119,160,1.5,105,6.75,Camden Yards,5,3
2018-06-01,2018,HOU,BOS,7,3,-121,-1.5,172,7.0,110,-130,111,1.5,-205,3.83,Minute Maid Park,10,4
2018-06-01,2018,NYM,CHC,4,7,-107,1.5,-170,8.5,-119,-101,-103,-1.5,148,4.39,Citi Field,11,-3
2018-06-01,2018,SD,CIN,2,7,107,1.5,-163,8.0,-120,100,-117,-1.5,143,3.86,PETCO Park,9,-5
2018-06-01,2018,MIN,CLE,7,4,114,1.5,-150,8.5,-111,-109,-124,-1.5,130,3.97,Target Field,11,3
2018-06-01,2018,LAD,COL,11,8,-105,-1.5,146,11.5,-118,-102,-105,1.5,-168,5.89,Coors Field,19,3
2018-06-01,2018,MIL,CWS,3,8,-145,-1.5,105,9.0,-110,-110,130,1.5,-125,5.33,Guaranteed Rate Field,11,-5
2018-06-01,2018,TOR,DET,2,5,-310,-1.5,144,9.0,-117,-103,260,1.5,-165,6.8,Comerica Park,7,-3
2018-06-01,2018,BOS,HOU,3,7,111,1.5,-205,7.0,110,-130,-121,-1.5,172,3.32,Minute Maid Park,10,-4
2018-06-01,2018,OAK,KC,16,0,-127,-1.5,123,9.5,-110,-110,117,1.5,-143,5.31,Kauffman Stadium,16,16
2018-06-01,2018,TEX,LAA,0,6,155,1.5,-135,8.5,-110,-110,-175,-1.5,115,3.33,Angel Stadium,6,-6
2018-06-01,2018,COL,LAD,8,11,-105,1.5,-168,11.5,-118,-102,-105,-1.5,146,5.89,Coors Field,19,-3
2018-06-01,2018,ARI,MIA,9,1,-145,-1.5,140,9.0,-106,-114,130,1.5,-160,5.33,Chase Field,10,8
2018-06-01,2018,CWS,MIL,8,3,130,1.5,-125,9.0,-110,-110,-145,-1.5,105,3.91,Guaranteed Rate Field,11,5
2018-06-01,2018,CLE,MIN,4,7,-124,-1.5,130,8.5,-111,-109,114,1.5,-150,4.71,Target Field,11,-3
2018-06-01,2018,CHC,NYM,7,4,-103,-1.5,148,8.5,-119,-101,-107,1.5,-170,4.31,Citi Field,11,3
2018-06-01,2018,BAL,NYY,1,4,160,1.5,105,10.5,-101,-119,-180,-1.5,-125,4.04,Camden Yards,5,-3
2018-06-01,2018,KC,OAK,0,16,117,1.5,-143,9.5,-110,-110,-127,-1.5,123,4.38,Kauffman Stadium,16,-16
2018-06-01,2018,SF,PHI,4,0,-128,-1.5,170,8.0,-110,-110,118,1.5,-200,4.49,AT&T Park,4,4
2018-06-01,2018,STL,PIT,0,4,-109,-1.5,180,8.0,-105,-115,-101,1.5,-215,4.17,Busch Stadium,4,-4
2018-06-01,2018,CIN,SD,7,2,-117,-1.5,143,8.0,-120,100,107,1.5,-163,4.31,PETCO Park,9,5
2018-06-01,2018,TB,SEA,3,4,116,1.5,-185,8.0,100,-120,-131,-1.5,160,3.7,T-Mobile Park,7,-1
2018-06-01,2018,PHI,SF,0,4,118,1.5,-200,8.0,-110,-110,-128,-1.5,170,3.67,AT&T Park,4,-4
2018-06-01,2018,PIT,STL,4,0,-101,1.5,-215,8.0,-105,-115,-109,-1.5,180,4.02,Busch Stadium,4,4
2018-06-01,2018,SEA,TB,4,3,-131,-1.5,160,8.0,100,-120,116,1.5,-185,4.54,T-Mobile Park,7,1
2018-06-01,2018,LAA,TEX,6,0,-175,-1.5,115,8.5,-110,-110,155,1.5,-135,5.41,Angel Stadium,6,6
2018-06-01,2018,DET,TOR,5,2,260,1.5,-165,9.0,-117,-103,-310,-1.5,144,2.5,Comerica Park,7,3
2018-06-01,2018,ATL,WSH,4,0,123,1.5,-137,8.0,-105,-115,-138,-1.5,117,3.59,Suntrust Park,4,4
2018-06-02,2018,MIA,ARI,2,6,157,1.5,-142,7.0,-101,-119,-177,-1.5,122,2.72,Chase Field,8,-4
2018-06-02,2018,WSH,ATL,5,3,-119,-1.5,140,9.0,100,-120,109,1.5,-160,4.89,Suntrust Park,8,2
2018-06-02,2018,NYY,BAL,8,5,-190,-1.5,-125,9.0,-115,-105,170,1.5,105,5.9,Camden Yards,13,3
2018-06-02,2018,HOU,BOS,4,5,-195,-1.5,101,7.5,-101,-119,175,1.5,-121,4.96,Minute Maid Park,9,-1
2018-06-02,2018,NYM,CHC,1,7,-114,-1.5,184,7.0,-125,105,104,1.5,-220,3.73,Citi Field,8,-6
2018-06-02,2018,SD,CIN,8,2,-109,-1.5,180,8.5,-110,-110,-101,1.5,-215,4.43,PETCO Park,10,6
2018-06-02,2018,MIN,CLE,7,1,151,1.5,-102,8.5,-110,-110,-171,-1.5,-119,3.39,Target Field,8,6
2018-06-02,2018,LAD,COL,12,4,-134,-1.5,115,11.0,100,-120,119,1.5,-135,6.3,Coors Field,16,8
2018-06-02,2018,MIL,CWS,5,0,-155,-1.5,-105,9.0,-107,-113,140,1.5,-115,5.47,Guaranteed Rate Field,5,5
2018-06-02,2018,TOR,DET,4,7,-137,-1.5,120,9.0,-105,-115,122,1.5,-140,5.2,Comerica Park,11,-3
2018-06-02,2018,BOS,HOU,5,4,175,1.5,-121,7.5,-101,-119,-195,-1.5,101,2.73,Minute Maid Park,9,1
2018-06-02,2018,OAK,KC,4,5,-150,-1.5,105,9.0,-104,-116,135,1.5,-125,5.4,Kauffman Stadium,9,-1
2018-06-02,2018,TEX,LAA,3,2,158,1.5,-140,8.5,-106,-114,-178,-1.5,120,3.29,Angel Stadium,5,1
2018-06-02,2018,COL,LAD,4,12,119,1.5,-135,11.0,100,-120,-134,-1.5,115,5.02,Coors Field,16,-8
2018-06-02,2018,ARI,MIA,6,2,-177,-1.5,122,7.0,-101,-119,157,1.5,-142,4.47,Chase Field,8,4
2018-06-02,2018,CWS,MIL,0,5,140,1.5,-115,9.0,-107,-113,-155,-1.5,-105,3.75,Guaranteed Rate Field,5,-5
2018-06-02,2018,CLE,MIN,1,7,-171,-1.5,-119,8.5,-110,-110,151,1.5,-102,5.36,Target Field,8,-6
2018-06-02,2018,CHC,NYM,7,1,104,1.5,-220,7.0,-125,105,-114,-1.5,184,3.43,Citi Field,8,6
2018-06-02,2018,BAL,NYY,5,8,170,1.5,105,9.0,-115,-105,-190,-1.5,-125,3.33,Camden Yards,13,-3
2018-06-02,2018,KC,OAK,5,4,135,1.5,-125,9.0,-104,-116,-150,-1.5,105,3.83,Kauffman Stadium,9,1
2018-06-02,2018,SF,PHI,2,0,-109,-1.5,188,7.5,-111,-109,-101,1.5,-225,3.91,AT&T Park,2,2
2018-06-02,2018,STL,PIT,3,2,-154,-1.5,144,8.5,-120,100,139,1.5,-165,5.15,Busch Stadium,5,1
2018-06-02,2018,CIN,SD,2,8,-101,1.5,-215,8.5,-110,-110,-109,-1.5,180,4.27,PETCO Park,10,-6
2018-06-02,2018,TB,SEA,1,3,111,1.5,-205,8.0,100,-120,-121,-1.5,172,3.79,T-Mobile Park,4,-2
2018-06-02,2018,PHI,SF,0,2,-101,1.5,-225,7.5,-111,-109,-109,-1.5,188,3.77,AT&T Park,2,-2
2018-06-02,2018,PIT,STL,2,3,139,1.5,-165,8.5,-120,100,-154,-1.5,144,3.56,Busch Stadium,5,-1
2018-06-02,2018,SEA,TB,3,1,-121,-1.5,172,8.0,100,-120,111,1.5,-205,4.38,T-Mobile Park,4,2
2018-06-02,2018,LAA,TEX,2,3,-178,-1.5,120,8.5,-106,-114,158,1.5,-140,5.44,Angel Stadium,5,-1
2018-06-02,2018,DET,TOR,7,4,122,1.5,-140,9.0,-105,-115,-137,-1.5,120,4.05,Comerica Park,11,3
2018-06-02,2018,ATL,WSH,3,5,109,1.5,-160,9.0,100,-120,-119,-1.5,140,4.31,Suntrust Park,8,-2
2018-06-03,2018,MIA,ARI,1,6,117,1.5,-180,9.0,-110,-110,-132,-1.5,155,4.15,Chase Field,7,-5
2018-06-03,2018,WSH,ATL,2,4,114,1.5,-185,9.5,-103,-117,-124,-1.5,160,4.44,Suntrust Park,6,-2
2018-06-03,2018,HOU,BOS,3,9,-180,-1.5,110,7.5,-110,-110,160,1.5,-130,4.82,Minute Maid Park,12,-6
2018-06-03,2018,NYM,CHC,0,2,146,1.5,-120,7.5,-103,-117,-161,-1.5,100,3.05,Citi Field,2,-2
2018-06-03,2018,SD,CIN,6,3,-101,1.5,-170,7.5,-101,-119,-109,-1.5,148,3.77,PETCO Park,9,3
2018-06-03,2018,MIN,CLE,7,5,-105,1.5,-162,8.5,-115,-105,-105,-1.5,142,4.35,Target Field,12,2
2018-06-03,2018,LAD,COL,10,7,-145,-1.5,101,12.0,-105,-115,130,1.5,-121,7.1,Coors Field,17,3
2018-06-03,2018,MIL,CWS,1,6,-155,-1.5,-105,9.5,100,-120,140,1.5,-115,5.77,Guaranteed Rate Field,7,-5
2018-06-03,2018,TOR,DET,8,4,107,1.5,-195,9.0,-104,-116,-117,-1.5,166,4.35,Comerica Park,12,4
2018-06-03,2018,BOS,HOU,9,3,160,1.5,-130,7.5,-110,-110,-180,-1.5,110,2.88,Minute Maid Park,12,6
2018-06-03,2018,OAK,KC,5,1,261,1.5,-205,9.0,-120,100,-311,-1.5,172,2.49,Kauffman Stadium,6,4
2018-06-03,2018,TEX,LAA,1,3,176,1.5,-125,8.5,-120,100,-196,-1.5,105,3.08,Angel Stadium,4,-2
2018-06-03,2018,COL,LAD,7,10,130,1.5,-121,12.0,-105,-115,-145,-1.5,101,5.22,Coors Field,17,-3
2018-06-03,2018,ARI,MIA,6,1,-132,-1.5,155,9.0,-110,-110,117,1.5,-180,5.12,Chase Field,7,5
2018-06-03,2018,CWS,MIL,6,1,140,1.5,-115,9.5,100,-120,-155,-1.5,-105,3.96,Guaranteed Rate Field,7,5
2018-06-03,2018,CLE,MIN,5,7,-105,-1.5,142,8.5,-115,-105,-105,1.5,-162,4.35,Target Field,12,-2
2018-06-03,2018,CHC,NYM,2,0,-161,-1.5,100,7.5,-103,-117,146,1.5,-120,4.63,Citi Field,2,2
2018-06-03,2018,KC,OAK,1,5,-311,-1.5,172,9.0,-120,100,261,1.5,-205,6.81,Kauffman Stadium,6,-4
2018-06-03,2018,SF,PHI,6,1,-114,-1.5,180,8.0,-105,-115,104,1.5,-215,4.26,AT&T Park,7,5
2018-06-03,2018,STL,PIT,5,0,-119,-1.5,172,8.5,-110,-110,109,1.5,-205,4.62,Busch Stadium,5,5
2018-06-03,2018,CIN,SD,3,6,-109,-1.5,148,7.5,-101,-119,-101,1.5,-170,3.91,PETCO Park,9,-3
2018-06-03,2018,TB,SEA,1,2,107,1.5,-232,7.5,-106,-114,-117,-1.5,193,3.62,T-Mobile Park,3,-1
2018-06-03,2018,PHI,SF,1,6,104,1.5,-215,8.0,-105,-115,-114,-1.5,180,3.92,AT&T Park,7,-5
2018-06-03,2018,PIT,STL,0,5,109,1.5,-205,8.5,-110,-110,-119,-1.5,172,4.07,Busch Stadium,5,-5
2018-06-03,2018,SEA,TB,2,1,-117,-1.5,193,7.5,-106,-114,107,1.5,-232,4.04,T-Mobile Park,3,1
2018-06-03,2018,LAA,TEX,3,1,-196,-1.5,105,8.5,-120,100,176,1.5,-125,5.63,Angel Stadium,4,2
2018-06-03,2018,DET,TOR,4,8,-117,-1.5,166,9.0,-104,-116,107,1.5,-195,4.85,Comerica Park,12,-4
2018-06-03,2018,ATL,WSH,4,2,-124,-1.5,160,9.5,-103,-117,114,1.5,-185,5.26,Suntrust Park,6,2
2018-06-04,2018,SF,ARI,10,3,-113,-1.5,184,7.5,-110,-110,103,1.5,-220,3.98,AT&T Park,13,7
2018-06-04,2018,SD,ATL,11,4,-105,-1.5,184,7.5,-101,-119,-105,1.5,-220,3.84,PETCO Park,15,7
2018-06-04,2018,NYY,DET,7,4,-285,-1.5,-180,9.0,-114,-106,245,1.5,155,6.66,Comerica Park,11,3
2018-06-04,2018,NYY,DET,2,4,-194,-1.5,-125,10.0,-120,100,174,1.5,106,6.6,Comerica Park,6,-2
2018-06-04,2018,LAA,KC,9,6,-205,-1.5,100,8.5,-120,100,175,1.5,-120,5.71,Angel Stadium,15,3
2018-06-04,2018,KC,LAA,6,9,175,1.5,-120,8.5,-120,100,-205,-1.5,100,3.09,Angel Stadium,15,-3
2018-06-04,2018,DET,NYY,4,7,245,1.5,155,9.0,-114,-106,-285,-1.5,-180,2.61,Comerica Park,11,-3
2018-06-04,2018,DET,NYY,4,2,174,1.5,106,10.0,-120,100,-194,-1.5,-125,3.65,Comerica Park,6,2
2018-06-04,2018,ATL,SD,4,11,-105,1.5,-220,7.5,-101,-119,-105,-1.5,184,3.84,PETCO Park,15,-7
2018-06-04,2018,ARI,SF,3,10,103,1.5,-220,7.5,-110,-110,-113,-1.5,184,3.69,AT&T Park,13,-7
2018-06-05,2018,SF,ARI,2,3,-145,-1.5,148,6.5,-114,-106,130,1.5,-170,3.85,AT&T Park,5,-1
2018-06-05,2018,SD,ATL,1,14,119,1.5,-141,7.5,-110,-110,-129,-1.5,121,3.42,PETCO Park,15,-13
2018-06-05,2018,NYM,BAL,1,2,-126,-1.5,166,9.0,-105,-115,116,1.5,-195,5.02,Citi Field,3,-1
2018-06-05,2018,DET,BOS,0,6,170,1.5,-110,10.0,-105,-115,-190,-1.5,-110,3.7,Fenway Park,6,-6
2018-06-05,2018,PHI,CHC,6,1,180,1.5,-115,7.5,100,-120,-210,-1.5,-105,2.68,Wrigley Field,7,5
2018-06-05,2018,COL,CIN,9,6,-108,-1.5,144,8.5,-110,-110,-102,1.5,-165,4.41,Great American Ballpark,15,3
2018-06-05,2018,MIL,CLE,2,3,180,1.5,-115,7.5,-120,100,-210,-1.5,-105,2.68,Progressive Field,5,-1
2018-06-05,2018,CIN,COL,6,9,-102,1.5,-165,8.5,-110,-110,-108,-1.5,144,4.29,Great American Ballpark,15,-3
2018-06-05,2018,MIN,CWS,4,2,-166,-1.5,110,8.5,-125,105,151,1.5,-130,5.3,Target Field,6,2
2018-06-05,2018,MIN,CWS,3,6,-180,-1.5,105,9.5,-105,-115,160,1.5,-125,6.11,Target Field,9,-3
2018-06-05,2018,BOS,DET,6,0,-190,-1.5,-110,10.0,-105,-115,170,1.5,-110,6.55,Fenway Park,6,6
2018-06-05,2018,SEA,HOU,7,1,117,1.5,-185,7.5,-110,-110,-127,-1.5,160,3.46,Minute Maid Park,8,6
2018-06-05,2018,LAA,KC,1,0,-200,-1.5,100,8.0,-109,-111,170,1.5,-120,5.33,Angel Stadium,1,1
2018-06-05,2018,KC,LAA,0,1,170,1.5,-120,8.0,-109,-111,-200,-1.5,100,2.96,Angel Stadium,1,-1
2018-06-05,2018,PIT,LAD,0,5,117,1.5,-136,7.5,-105,-115,-127,-1.5,116,3.46,PNC Park,5,-5
2018-06-05,2018,STL,MIA,4,7,-210,-1.5,-101,7.5,-121,101,180,1.5,-119,5.08,Busch Stadium,11,-3
2018-06-05,2018,CLE,MIL,3,2,-210,-1.5,-105,7.5,-120,100,180,1.5,-115,5.08,Progressive Field,5,1
2018-06-05,2018,CWS,MIN,2,4,151,1.5,-130,8.5,-125,105,-166,-1.5,110,3.39,Target Field,6,-2
2018-06-05,2018,CWS,MIN,6,3,160,1.5,-125,9.5,-105,-115,-180,-1.5,105,3.65,Target Field,9,3
2018-06-05,2018,BAL,NYM,2,1,116,1.5,-195,9.0,-105,-115,-126,-1.5,166,4.17,Citi Field,3,1
2018-06-05,2018,TOR,NYY,2,7,125,1.5,-125,9.5,105,-125,-140,-1.5,105,4.22,Rogers Centre,9,-5
2018-06-05,2018,TEX,OAK,7,4,127,1.5,-130,10.5,-115,-105,-142,-1.5,110,4.63,Rangers Ballpark,11,3
2018-06-05,2018,CHC,PHI,1,6,-210,-1.5,-105,7.5,100,-120,180,1.5,-115,5.08,Wrigley Field,7,-5
2018-06-05,2018,LAD,PIT,5,0,-127,-1.5,116,7.5,-105,-115,117,1.5,-136,4.2,PNC Park,5,5
2018-06-05,2018,ATL,SD,14,1,-129,-1.5,121,7.5,-110,-110,119,1.5,-141,4.22,PETCO Park,15,13
2018-06-05,2018,HOU,SEA,1,7,-127,-1.5,160,7.5,-110,-110,117,1.5,-185,4.2,Minute Maid Park,8,-6
2018-06-05,2018,ARI,SF,3,2,130,1.5,-170,6.5,-114,-106,-145,-1.5,148,2.83,AT&T Park,5,1
2018-06-05,2018,MIA,STL,7,4,180,1.5,-119,7.5,-121,101,-210,-1.5,-101,2.68,Busch Stadium,11,3
2018-06-05,2018,WSH,TB,4,2,-275,-1.5,-125,6.5,-112,-108,235,1.5,105,4.77,Nationals Park,6,2
2018-06-05,2018,OAK,TEX,4,7,-142,-1.5,110,10.5,-115,-105,127,1.5,-130,6.16,Rangers Ballpark,11,-3
2018-06-05,2018,NYY,TOR,7,2,-140,-1.5,105,9.5,105,-125,125,1.5,-125,5.54,Rogers Centre,9,5
2018-06-05,2018,TB,WSH,2,4,235,1.5,105,6.5,-112,-108,-275,-1.5,-125,1.94,Nationals Park,6,-2
2018-06-06,2018,SF,ARI,5,4,-117,-1.5,176,8.0,-116,-104,107,1.5,-210,4.31,AT&T Park,9,1
2018-06-06,2018,SD,ATL,3,1,101,1.5,-171,7.0,-101,-119,-111,-1.5,148,3.48,PETCO Park,4,2
2018-06-06,2018,NYM,BAL,0,1,-126,-1.5,172,8.0,-108,-112,116,1.5,-205,4.46,Citi Field,1,-1
2018-06-06,2018,DET,BOS,1,7,175,1.5,-115,9.0,107,-127,-205,-1.5,-105,3.27,Fenway Park,8,-6
2018-06-06,2018,PHI,CHC,5,7,117,1.5,-190,7.5,-115,-105,-132,-1.5,163,3.46,Wrigley Field,12,-2
2018-06-06,2018,COL,CIN,6,3,-126,-1.5,125,9.5,102,-122,116,1.5,-145,5.3,Great American Ballpark,9,3
2018-06-06,2018,MIL,CLE,1,3,181,1.5,-124,8.5,-105,-115,-211,-1.5,104,3.02,Progressive Field,4,-2
2018-06-06,2018,CIN,COL,3,6,116,1.5,-145,9.5,102,-122,-126,-1.5,125,4.4,Great American Ballpark,9,-3
2018-06-06,2018,MIN,CWS,2,5,-170,-1.5,115,9.5,-118,-102,150,1.5,-135,5.98,Target Field,7,-3
2018-06-06,2018,BOS,DET,7,1,-205,-1.5,-105,9.0,107,-127,175,1.5,-115,6.05,Fenway Park,8,6
2018-06-06,2018,SEA,HOU,5,7,166,1.5,-130,8.5,-120,100,-186,-1.5,110,3.2,Minute Maid Park,12,-2
2018-06-06,2018,LAA,KC,4,3,-250,-1.5,-133,7.5,-110,-110,210,1.5,113,5.36,Angel Stadium,7,1
2018-06-06,2018,KC,LAA,3,4,210,1.5,113,7.5,-110,-110,-250,-1.5,-133,2.42,Angel Stadium,7,-1
2018-06-06,2018,PIT,LAD,11,9,105,1.5,-159,8.5,-110,-110,-115,-1.5,139,4.15,PNC Park,20,2
2018-06-06,2018,STL,MIA,3,11,-209,-1.5,-112,8.5,-110,-110,179,1.5,-108,5.75,Busch Stadium,14,-8
2018-06-06,2018,CLE,MIL,3,1,-211,-1.5,104,8.5,-105,-115,181,1.5,-124,5.77,Progressive Field,4,2
2018-06-06,2018,CWS,MIN,5,2,150,1.5,-135,9.5,-118,-102,-170,-1.5,115,3.8,Target Field,7,3
2018-06-06,2018,BAL,NYM,1,0,116,1.5,-205,8.0,-108,-112,-126,-1.5,172,3.7,Citi Field,1,1
2018-06-06,2018,TOR,NYY,0,3,139,1.5,-125,9.5,-102,-118,-154,-1.5,105,3.97,Rogers Centre,3,-3
2018-06-06,2018,TEX,OAK,8,2,105,1.5,-150,10.0,-120,100,-115,-1.5,130,4.88,Rangers Ballpark,10,6
2018-06-06,2018,CHC,PHI,7,5,-132,-1.5,163,7.5,-115,-105,117,1.5,-190,4.27,Wrigley Field,12,2
2018-06-06,2018,LAD,PIT,9,11,-115,-1.5,139,8.5,-110,-110,105,1.5,-159,4.55,PNC Park,20,-2
2018-06-06,2018,ATL,SD,1,3,-111,-1.5,148,7.0,-101,-119,101,1.5,-171,3.68,PETCO Park,4,-2
2018-06-06,2018,HOU,SEA,7,5,-186,-1.5,110,8.5,-120,100,166,1.5,-130,5.53,Minute Maid Park,12,2
2018-06-06,2018,ARI,SF,4,5,107,1.5,-210,8.0,-116,-104,-117,-1.5,176,3.86,AT&T Park,9,-1
2018-06-06,2018,MIA,STL,11,3,179,1.5,-108,8.5,-110,-110,-209,-1.5,-112,3.05,Busch Stadium,14,8
2018-06-06,2018,WSH,TB,11,2,-150,-1.5,144,7.5,-110,-110,135,1.5,-165,4.5,Nationals Park,13,9
2018-06-06,2018,OAK,TEX,2,8,-115,-1.5,130,10.0,-120,100,105,1.5,-150,5.35,Rangers Ballpark,10,-6
2018-06-06,2018,NYY,TOR,3,0,-154,-1.5,105,9.5,-102,-118,139,1.5,-125,5.76,Rogers Centre,3,3
2018-06-06,2018,TB,WSH,2,11,135,1.5,-165,7.5,-110,-110,-150,-1.5,144,3.19,Nationals Park,13,-9
2018-06-07,2018,TOR,BAL,5,4,-121,-1.5,163,9.5,-110,-110,111,1.5,-190,5.2,Rogers Centre,9,1
2018-06-07,2018,DET,BOS,7,2,150,1.5,-130,10.0,-101,-119,-170,-1.5,110,4.0,Fenway Park,9,5
2018-06-07,2018,PHI,CHC,3,4,103,1.5,-210,8.0,-115,-105,-113,-1.5,176,3.94,Wrigley Field,7,-1
2018-06-07,2018,COL,CIN,5,7,-102,1.5,-210,9.0,-109,-111,-108,-1.5,176,4.54,Great American Ballpark,12,-2
2018-06-07,2018,CIN,COL,7,5,-108,-1.5,176,9.0,-109,-111,-102,1.5,-210,4.67,Great American Ballpark,12,2
2018-06-07,2018,MIN,CWS,7,2,-186,-1.5,101,8.5,-117,-103,166,1.5,-121,5.53,Target Field,9,5
2018-06-07,2018,BOS,DET,2,7,-170,-1.5,110,10.0,-101,-119,150,1.5,-130,6.3,Fenway Park,9,-5
2018-06-07,2018,TEX,HOU,2,5,172,1.5,108,9.0,-110,-110,-192,-1.5,-128,3.31,Rangers Ballpark,7,-3
2018-06-07,2018,OAK,KC,4,1,-162,-1.5,125,8.5,-101,-119,147,1.5,-145,5.26,Oakland Coliseum,5,3
2018-06-07,2018,PIT,LAD,7,8,-140,-1.5,145,8.0,-110,-110,125,1.5,-170,4.67,PNC Park,15,-1
2018-06-07,2018,STL,MIA,4,1,-236,-1.5,-125,8.5,100,-120,206,1.5,105,5.97,Busch Stadium,5,3
2018-06-07,2018,CWS,MIN,2,7,166,1.5,-121,8.5,-117,-103,-186,-1.5,101,3.2,Target Field,9,-5
2018-06-07,2018,KC,OAK,1,4,147,1.5,-145,8.5,-101,-119,-162,-1.5,125,3.44,Oakland Coliseum,5,-3
2018-06-07,2018,CHC,PHI,4,3,-113,-1.5,176,8.0,-115,-105,103,1.5,-210,4.24,Wrigley Field,7,1
2018-06-07,2018,LAD,PIT,8,7,125,1.5,-170,8.0,-110,-110,-140,-1.5,145,3.56,PNC Park,15,1
2018-06-07,2018,TB,SEA,4,5,-103,1.5,-170,8.0,-105,-115,-107,-1.5,148,4.06,Tropicana Field,9,-1
2018-06-07,2018,MIA,STL,1,4,206,1.5,105,8.5,100,-120,-236,-1.5,-125,2.78,Busch Stadium,5,-3
2018-06-07,2018,SEA,TB,5,4,-107,-1.5,148,8.0,-105,-115,-103,1.5,-170,4.14,Tropicana Field,9,1
2018-06-07,2018,HOU,TEX,5,2,-192,-1.5,-128,9.0,-110,-110,172,1.5,108,5.92,Rangers Ballpark,7,3
2018-06-07,2018,BAL,TOR,4,5,111,1.5,-190,9.5,-110,-110,-121,-1.5,163,4.5,Rogers Centre,9,-1
2018-06-08,2018,COL,ARI,4,9,-109,-1.5,170,11.0,100,-120,-101,1.5,-200,5.74,Coors Field,13,-5
2018-06-08,2018,LAD,ATL,7,3,-180,-1.5,120,7.5,100,-120,160,1.5,-140,4.82,Dodger Stadium,10,4
2018-06-08,2018,TOR,BAL,5,1,-182,-1.5,105,9.0,-117,-103,162,1.5,-125,5.81,Rogers Centre,6,4
2018-06-08,2018,CWS,BOS,1,0,270,1.5,144,8.0,-110,-110,-320,-1.5,-165,2.16,Fenway Park,1,1
2018-06-08,2018,PIT,CHC,1,3,149,1.5,-140,8.0,-110,-110,-164,-1.5,120,3.21,Wrigley Field,4,-2
2018-06-08,2018,STL,CIN,7,6,-131,-1.5,111,9.5,-116,-104,116,1.5,-130,5.39,Great American Ballpark,13,1
2018-06-08,2018,DET,CLE,1,4,150,1.5,-104,8.5,-120,100,-170,-1.5,-116,3.4,Comerica Park,5,-3
2018-06-08,2018,ARI,COL,9,4,-101,1.5,-200,11.0,100,-120,-109,-1.5,170,5.53,Coors Field,13,5
2018-06-08,2018,BOS,CWS,0,1,-320,-1.5,-165,8.0,-110,-110,270,1.5,144,6.1,Fenway Park,1,-1
2018-06-08,2018,CLE,DET,4,1,-170,-1.5,-116,8.5,-120,100,150,1.5,-104,5.35,Comerica Park,5,3
2018-06-08,2018,TEX,HOU,3,7,170,1.5,112,9.0,-126,106,-200,-1.5,-132,3.33,Rangers Ballpark,10,-4
2018-06-08,2018,OAK,KC,7,2,-164,-1.5,128,7.5,-115,-105,149,1.5,-148,4.66,Oakland Coliseum,9,5
2018-06-08,2018,MIN,LAA,2,4,107,1.5,-160,9.0,105,-125,-117,-1.5,140,4.35,Target Field,6,-2
2018-06-08,2018,ATL,LAD,3,7,160,1.5,-140,7.5,100,-120,-180,-1.5,120,2.88,Dodger Stadium,10,-4
2018-06-08,2018,SD,MIA,0,4,123,1.5,-187,7.5,-120,100,-138,-1.5,161,3.36,Marlins Park,4,-4
2018-06-08,2018,PHI,MIL,4,12,-110,-1.5,188,8.0,-105,-115,100,1.5,-225,4.19,Citizens Bank Park,16,-8
2018-06-08,2018,LAA,MIN,4,2,-117,-1.5,140,9.0,105,-125,107,1.5,-160,4.85,Target Field,6,2
2018-06-08,2018,NYY,NYM,4,1,-101,1.5,-230,7.0,-105,-115,-109,-1.5,192,3.52,Citi Field,5,3
2018-06-08,2018,NYM,NYY,1,4,-109,-1.5,192,7.0,-105,-115,-101,1.5,-230,3.65,Citi Field,5,-3
2018-06-08,2018,KC,OAK,2,7,149,1.5,-148,7.5,-115,-105,-164,-1.5,128,3.01,Oakland Coliseum,9,-5
2018-06-08,2018,MIL,PHI,12,4,100,1.5,-225,8.0,-105,-115,-110,-1.5,188,4.0,Citizens Bank Park,16,8
2018-06-08,2018,CHC,PIT,3,1,-164,-1.5,120,8.0,-110,-110,149,1.5,-140,4.97,Wrigley Field,4,2
2018-06-08,2018,MIA,SD,4,0,-138,-1.5,161,7.5,-120,100,123,1.5,-187,4.35,Marlins Park,4,4
2018-06-08,2018,TB,SEA,3,4,-321,-1.5,172,8.0,-121,101,271,1.5,-205,6.1,Tropicana Field,7,-1
2018-06-08,2018,WSH,SF,5,9,-190,-1.5,105,7.5,-105,-115,170,1.5,-125,4.91,Nationals Park,14,-4
2018-06-08,2018,CIN,STL,6,7,116,1.5,-130,9.5,-116,-104,-131,-1.5,111,4.4,Great American Ballpark,13,-1
2018-06-08,2018,SEA,TB,4,3,271,1.5,-205,8.0,-121,101,-321,-1.5,172,2.16,Tropicana Field,7,1
2018-06-08,2018,HOU,TEX,7,3,-200,-1.5,-132,9.0,-126,106,170,1.5,112,6.0,Rangers Ballpark,10,4
2018-06-08,2018,BAL,TOR,1,5,162,1.5,-125,9.0,-117,-103,-182,-1.5,105,3.44,Rogers Centre,6,-4
2018-06-08,2018,SF,WSH,9,5,170,1.5,-125,7.5,-105,-115,-190,-1.5,105,2.78,Nationals Park,14,4
2018-06-09,2018,COL,ARI,7,12,-138,-1.5,125,13.0,-121,101,123,1.5,-145,7.54,Coors Field,19,-5
2018-06-09,2018,LAD,ATL,3,5,-153,-1.5,125,7.5,-121,101,138,1.5,-145,4.54,Dodger Stadium,8,-2
2018-06-09,2018,TOR,BAL,4,3,-107,-1.5,172,9.0,-101,-119,-103,1.5,-205,4.65,Rogers Centre,7,1
2018-06-09,2018,CWS,BOS,2,4,187,1.5,-105,9.0,-119,-101,-217,-1.5,-115,3.14,Fenway Park,6,-2
2018-06-09,2018,PIT,CHC,0,2,151,1.5,-135,8.0,-116,-104,-171,-1.5,115,3.19,Wrigley Field,2,-2
2018-06-09,2018,STL,CIN,6,4,-219,1.5,-210,8.5,-110,-110,189,-1.5,176,5.84,Great American Ballpark,10,2
2018-06-09,2018,DET,CLE,4,2,150,1.5,-119,9.0,-120,100,-165,-1.5,-101,3.6,Comerica Park,6,2
2018-06-09,2018,ARI,COL,12,7,123,1.5,-145,13.0,-121,101,-138,-1.5,125,5.83,Coors Field,19,5
2018-06-09,2018,BOS,CWS,4,2,-217,-1.5,-115,9.0,-119,-101,187,1.5,-105,6.16,Fenway Park,6,2
2018-06-09,2018,CLE,DET,2,4,-165,-1.5,-101,9.0,-120,100,150,1.5,-119,5.6,Comerica Park,6,-2
2018-06-09,2018,TEX,HOU,3,4,162,1.5,109,9.5,-118,-102,-182,-1.5,-129,3.63,Rangers Ballpark,7,-1
2018-06-09,2018,OAK,KC,0,2,-175,-1.5,115,9.0,100,-120,155,1.5,-135,5.73,Oakland Coliseum,2,-2
2018-06-09,2018,MIN,LAA,1,2,-116,-1.5,176,8.5,-115,-105,106,1.5,-210,4.56,Target Field,3,-1
2018-06-09,2018,ATL,LAD,5,3,138,1.5,-145,7.5,-121,101,-153,-1.5,125,3.15,Dodger Stadium,8,2
2018-06-09,2018,SD,MIA,5,4,-124,-1.5,136,7.5,-119,-101,114,1.5,-156,4.15,Marlins Park,9,1
2018-06-09,2018,PHI,MIL,3,12,-116,-1.5,172,8.0,-120,100,106,1.5,-205,4.3,Citizens Bank Park,15,-9
2018-06-09,2018,LAA,MIN,2,1,106,1.5,-210,8.5,-115,-105,-116,-1.5,176,4.13,Target Field,3,1
2018-06-09,2018,NYY,NYM,4,3,-163,-1.5,101,8.5,-120,100,148,1.5,-122,5.27,Citi Field,7,1
2018-06-09,2018,NYM,NYY,3,4,148,1.5,-122,8.5,-120,100,-163,-1.5,101,3.43,Citi Field,7,-1
2018-06-09,2018,KC,OAK,2,0,155,1.5,-135,9.0,100,-120,-175,-1.5,115,3.53,Oakland Coliseum,2,2
2018-06-09,2018,MIL,PHI,12,3,106,1.5,-205,8.0,-120,100,-116,-1.5,172,3.88,Citizens Bank Park,15,9
2018-06-09,2018,CHC,PIT,2,0,-171,-1.5,115,8.0,-116,-104,151,1.5,-135,5.05,Wrigley Field,2,2
2018-06-09,2018,MIA,SD,4,5,114,1.5,-156,7.5,-119,-101,-124,-1.5,136,3.5,Marlins Park,9,-1
2018-06-09,2018,TB,SEA,7,3,-126,-1.5,170,7.0,-117,-103,116,1.5,-200,3.9,Tropicana Field,10,4
2018-06-09,2018,WSH,SF,7,5,-190,-1.5,-101,9.0,100,-120,170,1.5,-119,5.9,Nationals Park,12,2
2018-06-09,2018,CIN,STL,4,6,189,-1.5,176,8.5,-110,-110,-219,1.5,-210,2.94,Great American Ballpark,10,-2
2018-06-09,2018,SEA,TB,3,7,116,1.5,-200,7.0,-117,-103,-126,-1.5,170,3.24,Tropicana Field,10,-4
2018-06-09,2018,HOU,TEX,4,3,-182,-1.5,-129,9.5,-118,-102,162,1.5,109,6.13,Rangers Ballpark,7,1
2018-06-09,2018,BAL,TOR,3,4,-103,1.5,-205,9.0,-101,-119,-107,-1.5,172,4.57,Rogers Centre,7,-1
2018-06-09,2018,SF,WSH,5,7,170,1.5,-119,9.0,100,-120,-190,-1.5,-101,3.33,Nationals Park,12,-2
2018-06-10,2018,COL,ARI,3,8,-157,-1.5,106,12.0,-105,-115,142,1.5,-126,7.33,Coors Field,11,-5
2018-06-10,2018,LAD,ATL,7,2,-158,-1.5,140,7.0,-105,-115,143,1.5,-160,4.29,Dodger Stadium,9,5
2018-06-10,2018,TOR,BAL,13,3,-131,-1.5,144,9.0,-114,-106,116,1.5,-165,5.1,Rogers Centre,16,10
2018-06-10,2018,CWS,BOS,5,2,190,1.5,103,9.5,-105,-115,-220,-1.5,-123,3.28,Fenway Park,7,3
2018-06-10,2018,PIT,CHC,7,1,175,1.5,-118,9.0,-101,-119,-195,-1.5,-103,3.27,Wrigley Field,8,6
2018-06-10,2018,STL,CIN,3,6,-116,-1.5,130,9.5,-115,-105,106,1.5,-150,5.1,Great American Ballpark,9,-3
2018-06-10,2018,DET,CLE,2,9,195,1.5,120,8.0,-118,-102,-225,-1.5,-140,2.71,Comerica Park,11,-7
2018-06-10,2018,ARI,COL,8,3,142,1.5,-126,12.0,-105,-115,-157,-1.5,106,4.96,Coors Field,11,5
2018-06-10,2018,BOS,CWS,2,5,-220,-1.5,-123,9.5,-105,-115,190,1.5,103,6.53,Fenway Park,7,-3
2018-06-10,2018,CLE,DET,9,2,-225,-1.5,-140,8.0,-118,-102,195,1.5,120,5.54,Comerica Park,11,7
2018-06-10,2018,TEX,HOU,7,8,165,1.5,102,10.5,-111,-109,-185,-1.5,-122,3.96,Rangers Ballpark,15,-1
2018-06-10,2018,OAK,KC,3,2,-165,-1.5,130,8.0,-110,-110,150,1.5,-150,4.98,Oakland Coliseum,5,1
2018-06-10,2018,MIN,LAA,7,5,-113,-1.5,172,9.0,-120,100,103,1.5,-205,4.77,Target Field,12,2
2018-06-10,2018,ATL,LAD,2,7,143,1.5,-160,7.0,-105,-115,-158,-1.5,140,2.88,Dodger Stadium,9,-5
2018-06-10,2018,SD,MIA,3,1,-105,-1.5,160,7.0,-122,102,-105,1.5,-186,3.59,Marlins Park,4,2
2018-06-10,2018,PHI,MIL,4,3,107,1.5,-155,8.5,-115,-105,-117,-1.5,135,4.11,Citizens Bank Park,7,1
2018-06-10,2018,LAA,MIN,5,7,103,1.5,-205,9.0,-120,100,-113,-1.5,172,4.43,Target Field,12,-2
2018-06-10,2018,NYY,NYM,0,2,-280,-1.5,-155,7.0,-118,-102,240,1.5,135,5.16,Citi Field,2,-2
2018-06-10,2018,NYM,NYY,2,0,240,1.5,135,7.0,-118,-102,-280,-1.5,-155,2.06,Citi Field,2,2
2018-06-10,2018,KC,OAK,2,3,150,1.5,-150,8.0,-110,-110,-165,-1.5,130,3.2,Oakland Coliseum,5,-1
2018-06-10,2018,MIL,PHI,3,4,-117,-1.5,135,8.5,-115,-105,107,1.5,-155,4.58,Citizens Bank Park,7,-1
2018-06-10,2018,CHC,PIT,1,7,-195,-1.5,-103,9.0,-101,-119,175,1.5,-118,5.95,Wrigley Field,8,-6
2018-06-10,2018,MIA,SD,1,3,-105,1.5,-186,7.0,-122,102,-105,-1.5,160,3.59,Marlins Park,4,-2
2018-06-10,2018,TB,SEA,4,5,150,1.5,-117,7.0,-123,103,-165,-1.5,-103,2.8,Tropicana Field,9,-1
2018-06-10,2018,WSH,SF,0,2,-305,-1.5,-136,7.0,-124,104,255,1.5,117,5.27,Nationals Park,2,-2
2018-06-10,2018,CIN,STL,6,3,106,1.5,-150,9.5,-115,-105,-116,-1.5,130,4.61,Great American Ballpark,9,3
2018-06-10,2018,SEA,TB,5,4,-165,-1.5,-103,7.0,-123,103,150,1.5,-117,4.36,Tropicana Field,9,1
2018-06-10,2018,HOU,TEX,8,7,-185,-1.5,-122,10.5,-111,-109,165,1.5,102,6.82,Rangers Ballpark,15,1
2018-06-10,2018,BAL,TOR,3,13,116,1.5,-165,9.0,-114,-106,-131,-1.5,144,4.17,Rogers Centre,16,-10
2018-06-10,2018,SF,WSH,2,0,255,1.5,117,7.0,-124,104,-305,-1.5,-136,1.97,Nationals Park,2,2
2018-06-11,2018,PIT,ARI,5,9,142,1.5,-160,7.5,-110,-110,-157,-1.5,140,3.1,Chase Field,14,-4
2018-06-11,2018,BOS,BAL,2,0,-133,-1.5,117,8.5,-119,-101,118,1.5,-137,4.85,Camden Yards,2,2
2018-06-11,2018,BAL,BOS,0,2,118,1.5,-137,8.5,-119,-101,-133,-1.5,117,3.9,Camden Yards,2,-2
2018-06-11,2018,MIL,CHC,2,7,111,1.5,-160,8.0,-103,-117,-121,-1.5,140,3.79,Miller Park,9,-5
2018-06-11,2018,CWS,CLE,0,4,200,1.5,125,9.0,-113,-107,-240,-1.5,-145,3.0,Guaranteed Rate Field,4,-4
2018-06-11,2018,CLE,CWS,4,0,-240,-1.5,-145,9.0,-113,-107,200,1.5,125,6.35,Guaranteed Rate Field,4,4
2018-06-11,2018,SEA,LAA,5,3,113,1.5,-149,8.5,-103,-117,-123,-1.5,129,3.99,T-Mobile Park,8,2
2018-06-11,2018,SF,MIA,5,7,-175,-1.5,-102,7.5,-109,-111,155,1.5,-119,4.77,Marlins Park,12,-2
2018-06-11,2018,CHC,MIL,7,2,-121,-1.5,140,8.0,-103,-117,111,1.5,-160,4.38,Miller Park,9,5
2018-06-11,2018,ARI,PIT,9,5,-157,-1.5,140,7.5,-110,-110,142,1.5,-160,4.58,Chase Field,14,4
2018-06-11,2018,STL,SD,5,2,-173,-1.5,116,8.5,-119,-101,153,1.5,-136,5.39,Busch Stadium,7,3
2018-06-11,2018,LAA,SEA,3,5,-123,-1.5,129,8.5,-103,-117,113,1.5,-149,4.69,T-Mobile Park,8,-2
2018-06-11,2018,MIA,SF,7,5,155,1.5,-119,7.5,-109,-111,-175,-1.5,-102,2.94,Marlins Park,12,2
2018-06-11,2018,SD,STL,2,5,153,1.5,-136,8.5,-119,-101,-173,-1.5,116,3.36,Busch Stadium,7,-3
2018-06-11,2018,TOR,TB,4,8,-105,-1.5,145,8.0,-101,-119,-105,1.5,-166,4.1,Tropicana Field,12,-4
2018-06-11,2018,TB,TOR,8,4,-105,1.5,-166,8.0,-101,-119,-105,-1.5,145,4.1,Tropicana Field,12,4
2018-06-12,2018,PIT,ARI,8,13,142,1.5,-150,9.0,-105,-115,-157,-1.5,130,3.72,Chase Field,21,-5
2018-06-12,2018,NYM,ATL,2,8,137,1.5,-140,8.5,100,-120,-152,-1.5,120,3.59,Suntrust Park,10,-6
2018-06-12,2018,BOS,BAL,6,4,-167,-1.5,-125,9.5,-101,-119,152,1.5,105,5.94,Camden Yards,10,2
2018-06-12,2018,BAL,BOS,4,6,152,1.5,105,9.5,-101,-119,-167,-1.5,-125,3.77,Camden Yards,10,-2
2018-06-12,2018,MIL,CHC,4,0,103,1.5,-180,9.0,-115,-105,-113,-1.5,155,4.43,Miller Park,4,4
2018-06-12,2018,KC,CIN,1,5,-105,-1.5,180,9.5,-115,-105,-105,1.5,-215,4.87,Kauffman Stadium,6,-4
2018-06-12,2018,CWS,CLE,5,1,128,1.5,-130,10.5,100,-120,-143,-1.5,110,4.61,Guaranteed Rate Field,6,4
2018-06-12,2018,PHI,COL,5,4,-146,-1.5,155,7.0,100,-120,131,1.5,-180,4.15,Citizens Bank Park,9,1
2018-06-12,2018,CLE,CWS,1,5,-143,-1.5,110,10.5,100,-120,128,1.5,-130,6.18,Guaranteed Rate Field,6,-4
2018-06-12,2018,MIN,DET,6,4,-105,1.5,-210,9.0,-105,-115,-105,-1.5,176,4.61,Comerica Park,10,2
2018-06-12,2018,OAK,HOU,3,6,138,1.5,-125,8.5,100,-120,-153,-1.5,105,3.57,Oakland Coliseum,9,-3
2018-06-12,2018,CIN,KC,5,1,-105,1.5,-215,9.5,-115,-105,-105,-1.5,180,4.87,Kauffman Stadium,6,4
2018-06-12,2018,SEA,LAA,6,3,-108,-1.5,176,8.5,-104,-116,-102,1.5,-210,4.41,T-Mobile Park,9,3
2018-06-12,2018,TEX,LAD,5,12,157,1.5,-135,8.5,-125,105,-177,-1.5,115,3.31,Dodger Stadium,17,-7
2018-06-12,2018,SF,MIA,1,3,-121,-1.5,130,8.5,100,-120,111,1.5,-150,4.65,Marlins Park,4,-2
2018-06-12,2018,CHC,MIL,0,4,-113,-1.5,155,9.0,-115,-105,103,1.5,-180,4.77,Miller Park,4,-4
2018-06-12,2018,DET,MIN,4,6,-105,-1.5,176,9.0,-105,-115,-105,1.5,-210,4.61,Comerica Park,10,-2
2018-06-12,2018,ATL,NYM,8,2,-152,-1.5,120,8.5,100,-120,137,1.5,-140,5.13,Suntrust Park,10,6
2018-06-12,2018,WSH,NYY,0,3,135,1.5,-150,9.0,-115,-105,-150,-1.5,130,3.83,Yankee Stadium,3,-3
2018-06-12,2018,HOU,OAK,6,3,-153,-1.5,105,8.5,100,-120,138,1.5,-125,5.14,Oakland Coliseum,9,3
2018-06-12,2018,COL,PHI,4,5,131,1.5,-180,7.0,100,-120,-146,-1.5,155,3.03,Citizens Bank Park,9,-1
2018-06-12,2018,ARI,PIT,13,8,-157,-1.5,130,9.0,-105,-115,142,1.5,-150,5.5,Chase Field,21,5
2018-06-12,2018,STL,SD,2,4,-198,-1.5,100,8.5,-110,-110,178,1.5,-120,5.65,Busch Stadium,6,-2
2018-06-12,2018,LAA,SEA,3,6,-102,1.5,-210,8.5,-104,-116,-108,-1.5,176,4.29,T-Mobile Park,9,-3
2018-06-12,2018,MIA,SF,3,1,111,1.5,-150,8.5,100,-120,-121,-1.5,130,4.03,Marlins Park,4,2
2018-06-12,2018,SD,STL,4,2,178,1.5,-120,8.5,-110,-110,-198,-1.5,100,3.06,Busch Stadium,6,2
2018-06-12,2018,TOR,TB,1,4,105,1.5,-200,8.0,-112,-108,-115,-1.5,170,3.9,Tropicana Field,5,-3
2018-06-12,2018,LAD,TEX,12,5,-177,-1.5,115,8.5,-125,105,157,1.5,-135,5.43,Dodger Stadium,17,7
2018-06-12,2018,TB,TOR,4,1,-115,-1.5,170,8.0,-112,-108,105,1.5,-200,4.28,Tropicana Field,5,3
2018-06-12,2018,NYY,WSH,3,0,-150,-1.5,130,9.0,-115,-105,135,1.5,-150,5.4,Yankee Stadium,3,3
2018-06-13,2018,PIT,ARI,5,4,137,1.5,-149,7.5,-102,-118,-152,-1.5,129,3.16,Chase Field,9,1
2018-06-13,2018,NYM,ATL,0,2,-131,-1.5,135,7.5,-101,-119,116,1.5,-155,4.25,Suntrust Park,2,-2
2018-06-13,2018,BOS,BAL,5,1,-280,-1.5,-183,9.0,105,-125,240,1.5,158,6.63,Camden Yards,6,4
2018-06-13,2018,BAL,BOS,1,5,240,1.5,158,9.0,105,-125,-280,-1.5,-183,2.65,Camden Yards,6,-4
2018-06-13,2018,MIL,CHC,1,0,-107,-1.5,176,9.0,-103,-117,-103,1.5,-210,4.65,Miller Park,1,1
2018-06-13,2018,KC,CIN,0,7,108,1.5,-152,9.5,100,-120,-118,-1.5,132,4.57,Kauffman Stadium,7,-7
2018-06-13,2018,CWS,CLE,3,2,180,1.5,115,8.5,100,-120,-210,-1.5,-135,3.04,Guaranteed Rate Field,5,1
2018-06-13,2018,PHI,COL,2,7,-124,-1.5,163,8.5,-114,-106,114,1.5,-190,4.71,Citizens Bank Park,9,-5
2018-06-13,2018,CLE,CWS,2,3,-210,-1.5,-135,8.5,100,-120,180,1.5,115,5.76,Guaranteed Rate Field,5,-1
2018-06-13,2018,MIN,DET,2,5,-150,-1.5,114,9.0,105,-125,135,1.5,-135,5.4,Comerica Park,7,-3
2018-06-13,2018,OAK,HOU,5,13,175,1.5,110,7.5,-103,-117,-205,-1.5,-130,2.73,Oakland Coliseum,18,-8
2018-06-13,2018,CIN,KC,7,0,-118,-1.5,132,9.5,100,-120,108,1.5,-152,5.14,Kauffman Stadium,7,7
2018-06-13,2018,SEA,LAA,8,6,108,1.5,-155,7.5,-115,-105,-118,-1.5,135,3.61,T-Mobile Park,14,2
2018-06-13,2018,TEX,LAD,2,3,162,1.5,-135,8.0,-115,-105,-182,-1.5,115,3.05,Dodger Stadium,5,-1
2018-06-13,2018,SF,MIA,4,5,-109,-1.5,148,7.5,-105,-115,-101,1.5,-170,3.91,Marlins Park,9,-1
2018-06-13,2018,CHC,MIL,0,1,-103,1.5,-210,9.0,-103,-117,-107,-1.5,176,4.57,Miller Park,1,-1
2018-06-13,2018,DET,MIN,5,2,135,1.5,-135,9.0,105,-125,-150,-1.5,114,3.83,Comerica Park,7,3
2018-06-13,2018,ATL,NYM,2,0,116,1.5,-155,7.5,-101,-119,-131,-1.5,135,3.47,Suntrust Park,2,2
2018-06-13,2018,WSH,NYY,5,4,155,1.5,-131,9.5,-110,-110,-175,-1.5,111,3.73,Yankee Stadium,9,1
2018-06-13,2018,HOU,OAK,13,5,-205,-1.5,-130,7.5,-103,-117,175,1.5,110,5.04,Oakland Coliseum,18,8
2018-06-13,2018,COL,PHI,7,2,114,1.5,-190,8.5,-114,-106,-124,-1.5,163,3.97,Citizens Bank Park,9,5
2018-06-13,2018,ARI,PIT,4,5,-152,-1.5,129,7.5,-102,-118,137,1.5,-149,4.52,Chase Field,9,-1
2018-06-13,2018,STL,SD,2,4,-195,-1.5,100,8.5,-109,-111,175,1.5,-120,5.62,Busch Stadium,6,-2
2018-06-13,2018,LAA,SEA,6,8,-118,-1.5,135,7.5,-115,-105,108,1.5,-155,4.06,T-Mobile Park,14,-2
2018-06-13,2018,MIA,SF,5,4,-101,1.5,-170,7.5,-105,-115,-109,-1.5,148,3.77,Marlins Park,9,1
2018-06-13,2018,SD,STL,4,2,175,1.5,-120,8.5,-109,-111,-195,-1.5,100,3.09,Busch Stadium,6,2
2018-06-13,2018,TOR,TB,0,1,-114,-1.5,136,7.0,-109,-111,104,1.5,-156,3.73,Tropicana Field,1,-1
2018-06-13,2018,LAD,TEX,3,2,-182,-1.5,115,8.0,-115,-105,162,1.5,-135,5.16,Dodger Stadium,5,1
2018-06-13,2018,TB,TOR,1,0,104,1.5,-156,7.0,-109,-111,-114,-1.5,136,3.43,Tropicana Field,1,1
2018-06-13,2018,NYY,WSH,4,5,-175,-1.5,111,9.5,-110,-110,155,1.5,-131,6.05,Yankee Stadium,9,-1
2018-06-14,2018,NYM,ARI,3,6,130,1.5,-145,9.0,-111,-109,-145,-1.5,125,3.91,Chase Field,9,-3
2018-06-14,2018,SD,ATL,2,4,150,1.5,-135,8.5,-120,100,-170,-1.5,115,3.4,Suntrust Park,6,-2
2018-06-14,2018,SEA,BOS,1,2,117,1.5,-145,8.5,-111,-109,-127,-1.5,125,3.92,T-Mobile Park,3,-1
2018-06-14,2018,CWS,CLE,2,5,121,1.5,-130,8.5,118,-138,-136,-1.5,110,3.85,Guaranteed Rate Field,7,-3
2018-06-14,2018,PHI,COL,9,3,-117,-1.5,170,8.5,101,-121,107,1.5,-202,4.58,Citizens Bank Park,12,6
2018-06-14,2018,CLE,CWS,5,2,-136,-1.5,110,8.5,118,-138,121,1.5,-130,4.9,Guaranteed Rate Field,7,3
2018-06-14,2018,MIN,DET,1,3,-109,-1.5,143,9.0,-120,100,-101,1.5,-164,4.69,Comerica Park,4,-2
2018-06-14,2018,OAK,HOU,3,7,170,1.5,105,7.5,-104,-116,-200,-1.5,-125,2.78,Oakland Coliseum,10,-4
2018-06-14,2018,SF,MIA,6,3,-134,-1.5,125,8.0,-111,-109,119,1.5,-145,4.58,Marlins Park,9,3
2018-06-14,2018,DET,MIN,3,1,-101,1.5,-164,9.0,-120,100,-109,-1.5,143,4.52,Comerica Park,4,2
2018-06-14,2018,ARI,NYM,6,3,-145,-1.5,125,9.0,-111,-109,130,1.5,-145,5.33,Chase Field,9,3
2018-06-14,2018,TB,NYY,3,4,155,1.5,-140,8.5,-115,-105,-175,-1.5,120,3.33,Yankee Stadium,7,-1
2018-06-14,2018,HOU,OAK,7,3,-200,-1.5,-125,7.5,-104,-116,170,1.5,105,5.0,Oakland Coliseum,10,4
2018-06-14,2018,COL,PHI,3,9,107,1.5,-202,8.5,101,-121,-117,-1.5,170,4.11,Citizens Bank Park,12,-6
2018-06-14,2018,ATL,SD,4,2,-170,-1.5,115,8.5,-120,100,150,1.5,-135,5.35,Suntrust Park,6,2
2018-06-14,2018,BOS,SEA,2,1,-127,-1.5,125,8.5,-111,-109,117,1.5,-145,4.76,T-Mobile Park,3,1
2018-06-14,2018,MIA,SF,3,6,119,1.5,-145,8.0,-111,-109,-134,-1.5,125,3.65,Marlins Park,9,-3
2018-06-14,2018,NYY,TB,4,3,-175,-1.5,120,8.5,-115,-105,155,1.5,-140,5.41,Yankee Stadium,7,1
2018-06-15,2018,NYM,ARI,3,7,120,1.5,-175,8.0,-102,-118,-135,-1.5,151,3.64,Chase Field,10,-4
2018-06-15,2018,SD,ATL,9,3,127,1.5,-173,8.0,-119,-101,-142,-1.5,150,3.52,Suntrust Park,12,6
2018-06-15,2018,MIA,BAL,2,0,140,1.5,-155,8.5,-120,100,-155,-1.5,135,3.54,Camden Yards,2,2
2018-06-15,2018,SEA,BOS,7,6,-152,-1.5,143,7.0,-125,105,137,1.5,-164,4.22,T-Mobile Park,13,1
2018-06-15,2018,STL,CHC,5,13,-101,1.5,-171,8.5,-103,-117,-109,-1.5,148,4.27,Busch Stadium,18,-8
2018-06-15,2018,PIT,CIN,3,2,-137,-1.5,148,9.0,-115,-105,122,1.5,-170,5.2,PNC Park,5,1
2018-06-15,2018,MIN,CLE,6,3,190,1.5,-106,8.0,-101,-119,-220,-1.5,-114,2.76,Progressive Field,9,3
2018-06-15,2018,TEX,COL,5,9,-109,-1.5,170,10.5,-115,-105,-101,1.5,-200,5.48,Rangers Ballpark,14,-4
2018-06-15,2018,DET,CWS,4,3,125,1.5,-170,8.5,-120,100,-140,-1.5,148,3.78,Guaranteed Rate Field,7,1
2018-06-15,2018,CWS,DET,3,4,-140,-1.5,148,8.5,-120,100,125,1.5,-170,4.96,Guaranteed Rate Field,7,-1
2018-06-15,2018,KC,HOU,3,7,205,1.5,135,9.0,100,-120,-235,-1.5,-155,2.95,Kauffman Stadium,10,-4
2018-06-15,2018,HOU,KC,7,3,-235,-1.5,-155,9.0,100,-120,205,1.5,135,6.31,Kauffman Stadium,10,4
2018-06-15,2018,OAK,LAA,4,8,105,1.5,-160,8.5,-103,-117,-115,-1.5,140,4.15,Oakland Coliseum,12,-4
2018-06-15,2018,SF,LAD,2,3,220,1.5,114,8.0,-105,-115,-260,-1.5,-133,2.5,Dodger Stadium,5,-1
2018-06-15,2018,BAL,MIA,0,2,-155,-1.5,135,8.5,-120,100,140,1.5,-155,5.17,Camden Yards,2,-2
2018-06-15,2018,PHI,MIL,2,13,127,1.5,-172,8.0,-110,-110,-142,-1.5,149,3.52,Miller Park,15,-11
2018-06-15,2018,CLE,MIN,3,6,-220,-1.5,-114,8.0,-101,-119,190,1.5,-106,5.5,Progressive Field,9,-3
2018-06-15,2018,ARI,NYM,7,3,-135,-1.5,151,8.0,-102,-118,120,1.5,-175,4.6,Chase Field,10,4
2018-06-15,2018,TB,NYY,0,5,185,1.5,-110,9.0,-101,-119,-215,-1.5,-110,3.16,Yankee Stadium,5,-5
2018-06-15,2018,LAA,OAK,8,4,-115,-1.5,140,8.5,-103,-117,105,1.5,-160,4.55,Oakland Coliseum,12,4
2018-06-15,2018,MIL,PHI,13,2,-142,-1.5,149,8.0,-110,-110,127,1.5,-172,4.69,Miller Park,15,11
2018-06-15,2018,CIN,PIT,2,3,122,1.5,-170,9.0,-115,-105,-137,-1.5,148,4.05,PNC Park,5,-1
2018-06-15,2018,ATL,SD,3,9,-142,-1.5,150,8.0,-119,-101,127,1.5,-173,4.69,Suntrust Park,12,-6
2018-06-15,2018,BOS,SEA,6,7,137,1.5,-164,7.0,-125,105,-152,-1.5,143,2.95,T-Mobile Park,13,-1
2018-06-15,2018,LAD,SF,3,2,-260,-1.5,-133,8.0,-105,-115,220,1.5,114,5.78,Dodger Stadium,5,1
2018-06-15,2018,CHC,STL,13,5,-109,-1.5,148,8.5,-103,-117,-101,1.5,-171,4.43,Busch Stadium,18,8
2018-06-15,2018,NYY,TB,5,0,-215,-1.5,-110,9.0,-101,-119,185,1.5,-110,6.14,Yankee Stadium,5,5
2018-06-15,2018,COL,TEX,9,5,-101,1.5,-200,10.5,-115,-105,-109,-1.5,170,5.28,Rangers Ballpark,14,4
2018-06-15,2018,WSH,TOR,5,6,-132,-1.5,118,9.5,-119,-101,117,1.5,-138,5.41,Rogers Centre,11,-1
2018-06-15,2018,TOR,WSH,6,5,117,1.5,-138,9.5,-119,-101,-132,-1.5,118,4.38,Rogers Centre,11,1
2018-06-16,2018,NYM,ARI,5,1,157,1.5,-135,7.5,-105,-115,-177,-1.5,115,2.92,Chase Field,6,4
2018-06-16,2018,SD,ATL,0,1,175,1.5,-121,8.5,-105,-115,-195,-1.5,100,3.09,Suntrust Park,1,-1
2018-06-16,2018,MIA,BAL,5,4,143,1.5,-138,9.5,-111,-109,-158,-1.5,119,3.91,Camden Yards,9,1
2018-06-16,2018,SEA,BOS,1,0,-101,1.5,-170,8.5,-119,-101,-109,-1.5,148,4.27,T-Mobile Park,1,1
2018-06-16,2018,STL,CHC,3,6,118,1.5,-147,9.0,100,-120,-128,-1.5,127,4.13,Busch Stadium,9,-3
2018-06-16,2018,PIT,CIN,6,2,-105,-1.5,176,8.5,-118,-102,-105,1.5,-210,4.35,PNC Park,8,4
2018-06-16,2018,MIN,CLE,9,3,160,1.5,-131,9.0,-115,-105,-180,-1.5,111,3.46,Progressive Field,12,6
2018-06-16,2018,TEX,COL,5,2,105,1.5,-150,9.5,-109,-111,-115,-1.5,130,4.63,Rangers Ballpark,7,3
2018-06-16,2018,DET,CWS,7,5,-111,-1.5,144,9.5,-110,-110,101,1.5,-165,5.0,Guaranteed Rate Field,12,2
2018-06-16,2018,CWS,DET,5,7,101,1.5,-165,9.5,-110,-110,-111,-1.5,144,4.73,Guaranteed Rate Field,12,-2
2018-06-16,2018,KC,HOU,2,10,215,1.5,141,9.5,-120,100,-255,-1.5,-161,3.02,Kauffman Stadium,12,-8
2018-06-16,2018,HOU,KC,10,2,-255,-1.5,-161,9.5,-120,100,215,1.5,141,6.82,Kauffman Stadium,12,8
2018-06-16,2018,OAK,LAA,6,4,-109,-1.5,176,9.0,102,-122,-101,1.5,-210,4.69,Oakland Coliseum,10,2
2018-06-16,2018,SF,LAD,1,3,130,1.5,-175,7.5,-117,-103,-145,-1.5,151,3.26,Dodger Stadium,4,-2
2018-06-16,2018,BAL,MIA,4,5,-158,-1.5,119,9.5,-111,-109,143,1.5,-138,5.82,Camden Yards,9,-1
2018-06-16,2018,PHI,MIL,4,1,147,1.5,-135,9.0,-110,-110,-162,-1.5,115,3.64,Miller Park,5,3
2018-06-16,2018,CLE,MIN,3,9,-180,-1.5,111,9.0,-115,-105,160,1.5,-131,5.79,Progressive Field,12,-6
2018-06-16,2018,ARI,NYM,1,5,-177,-1.5,115,7.5,-105,-115,157,1.5,-135,4.79,Chase Field,6,-4
2018-06-16,2018,TB,NYY,1,4,285,1.5,137,8.0,-111,-109,-335,-1.5,-157,2.08,Yankee Stadium,5,-3
2018-06-16,2018,LAA,OAK,4,6,-101,1.5,-210,9.0,102,-122,-109,-1.5,176,4.52,Oakland Coliseum,10,-2
2018-06-16,2018,MIL,PHI,1,4,-162,-1.5,115,9.0,-110,-110,147,1.5,-135,5.56,Miller Park,5,-3
2018-06-16,2018,CIN,PIT,2,6,-105,1.5,-210,8.5,-118,-102,-105,-1.5,176,4.35,PNC Park,8,-4
2018-06-16,2018,ATL,SD,1,0,-195,-1.5,100,8.5,-105,-115,175,1.5,-121,5.62,Suntrust Park,1,1
2018-06-16,2018,BOS,SEA,0,1,-109,-1.5,148,8.5,-119,-101,-101,1.5,-170,4.43,T-Mobile Park,1,-1
2018-06-16,2018,LAD,SF,3,1,-145,-1.5,151,7.5,-117,-103,130,1.5,-175,4.44,Dodger Stadium,4,2
2018-06-16,2018,CHC,STL,6,3,-128,-1.5,127,9.0,100,-120,118,1.5,-147,5.05,Busch Stadium,9,3
2018-06-16,2018,NYY,TB,4,1,-335,-1.5,-157,8.0,-111,-109,285,1.5,137,6.16,Yankee Stadium,5,3
2018-06-16,2018,COL,TEX,2,5,-115,-1.5,130,9.5,-109,-111,105,1.5,-150,5.08,Rangers Ballpark,7,-3
2018-06-16,2018,WSH,TOR,0,2,-240,-1.5,-145,7.5,-115,-105,200,1.5,126,5.29,Rogers Centre,2,-2
2018-06-16,2018,TOR,WSH,2,0,200,1.5,126,7.5,-115,-105,-240,-1.5,-145,2.5,Rogers Centre,2,2
2018-06-17,2018,NYM,ARI,5,3,116,1.5,-190,9.0,-110,-110,-126,-1.5,163,4.17,Chase Field,8,2
2018-06-17,2018,SD,ATL,1,4,104,1.5,-200,8.5,100,-120,-114,-1.5,170,4.17,Suntrust Park,5,-3
2018-06-17,2018,MIA,BAL,4,10,160,1.5,-125,8.5,-120,100,-180,-1.5,105,3.27,Camden Yards,14,-6
2018-06-17,2018,SEA,BOS,3,9,138,1.5,-125,8.5,-110,-110,-153,-1.5,105,3.57,T-Mobile Park,12,-6
2018-06-17,2018,STL,CHC,5,0,105,1.5,-160,8.5,100,-120,-115,-1.5,140,4.15,Busch Stadium,5,5
2018-06-17,2018,PIT,CIN,6,8,-145,-1.5,135,8.5,-117,-103,130,1.5,-155,5.03,PNC Park,14,-2
2018-06-17,2018,MIN,CLE,1,4,130,1.5,-160,10.0,-110,-110,-145,-1.5,140,4.35,Progressive Field,5,-3
2018-06-17,2018,TEX,COL,13,12,114,1.5,-140,10.0,-111,-109,-124,-1.5,120,4.67,Rangers Ballpark,25,1
2018-06-17,2018,DET,CWS,3,1,-114,-1.5,137,9.5,-105,-115,104,1.5,-157,5.06,Guaranteed Rate Field,4,2
2018-06-17,2018,CWS,DET,1,3,104,1.5,-157,9.5,-105,-115,-114,-1.5,137,4.66,Guaranteed Rate Field,4,-2
2018-06-17,2018,KC,HOU,4,7,205,1.5,143,9.5,100,-120,-245,-1.5,-163,3.11,Kauffman Stadium,11,-3
2018-06-17,2018,HOU,KC,7,4,-245,-1.5,-163,9.5,100,-120,205,1.5,143,6.75,Kauffman Stadium,11,3
2018-06-17,2018,OAK,LAA,6,5,111,1.5,-147,8.5,-119,-101,-121,-1.5,127,4.03,Oakland Coliseum,11,1
2018-06-17,2018,SF,LAD,4,1,160,1.5,-130,8.5,-119,-101,-180,-1.5,110,3.27,Dodger Stadium,5,3
2018-06-17,2018,BAL,MIA,10,4,-180,-1.5,105,8.5,-120,100,160,1.5,-125,5.46,Camden Yards,14,6
2018-06-17,2018,PHI,MIL,10,9,-128,-1.5,139,8.5,-105,-115,118,1.5,-159,4.77,Miller Park,19,1
2018-06-17,2018,CLE,MIN,4,1,-145,-1.5,140,10.0,-110,-110,130,1.5,-160,5.92,Progressive Field,5,3
2018-06-17,2018,ARI,NYM,3,5,-126,-1.5,163,9.0,-110,-110,116,1.5,-190,5.02,Chase Field,8,-2
2018-06-17,2018,TB,NYY,3,1,200,1.5,113,9.5,-110,-110,-240,-1.5,-133,3.17,Yankee Stadium,4,2
2018-06-17,2018,LAA,OAK,5,6,-121,-1.5,127,8.5,-119,-101,111,1.5,-147,4.65,Oakland Coliseum,11,-1
2018-06-17,2018,MIL,PHI,9,10,118,1.5,-159,8.5,-105,-115,-128,-1.5,139,3.9,Miller Park,19,-1
2018-06-17,2018,CIN,PIT,8,6,130,1.5,-155,8.5,-117,-103,-145,-1.5,135,3.7,PNC Park,14,2
2018-06-17,2018,ATL,SD,4,1,-114,-1.5,170,8.5,100,-120,104,1.5,-200,4.53,Suntrust Park,5,3
2018-06-17,2018,BOS,SEA,9,3,-153,-1.5,105,8.5,-110,-110,138,1.5,-125,5.14,T-Mobile Park,12,6
2018-06-17,2018,LAD,SF,1,4,-180,-1.5,110,8.5,-119,-101,160,1.5,-130,5.46,Dodger Stadium,5,-3
2018-06-17,2018,CHC,STL,0,5,-115,-1.5,140,8.5,100,-120,105,1.5,-160,4.55,Busch Stadium,5,-5
2018-06-17,2018,NYY,TB,1,3,-240,-1.5,-133,9.5,-110,-110,200,1.5,113,6.71,Yankee Stadium,4,-2
2018-06-17,2018,COL,TEX,12,13,-124,-1.5,120,10.0,-111,-109,114,1.5,-140,5.54,Rangers Ballpark,25,-1
2018-06-17,2018,WSH,TOR,6,8,-126,-1.5,125,9.5,-105,-115,116,1.5,-145,5.3,Rogers Centre,14,-2
2018-06-17,2018,TOR,WSH,8,6,116,1.5,-145,9.5,-105,-115,-126,-1.5,125,4.4,Rogers Centre,14,2
2018-06-18,2018,LAA,ARI,4,7,-121,-1.5,172,7.5,105,-125,111,1.5,-205,4.11,Angel Stadium,11,-3
2018-06-18,2018,CWS,CLE,2,6,231,1.5,124,8.5,-111,-109,-271,-1.5,-144,2.57,Progressive Field,8,-4
2018-06-18,2018,NYM,COL,12,2,-119,-1.5,135,9.5,-110,-110,109,1.5,-155,5.16,Coors Field,14,10
2018-06-18,2018,CLE,CWS,6,2,-271,-1.5,-144,8.5,-111,-109,231,1.5,124,6.21,Progressive Field,8,4
2018-06-18,2018,TB,HOU,4,5,231,1.5,108,7.0,-117,-103,-271,-1.5,-128,2.11,Minute Maid Park,9,-1
2018-06-18,2018,TEX,KC,6,3,-145,-1.5,110,9.5,-120,100,130,1.5,-130,5.62,Kauffman Stadium,9,3
2018-06-18,2018,ARI,LAA,7,4,111,1.5,-205,7.5,105,-125,-121,-1.5,172,3.55,Angel Stadium,11,3
2018-06-18,2018,SF,MIA,4,5,-160,-1.5,130,7.5,100,-120,145,1.5,-150,4.62,AT&T Park,9,-1
2018-06-18,2018,PIT,MIL,1,0,-103,1.5,-165,9.0,-102,-118,-107,-1.5,144,4.57,PNC Park,1,1
2018-06-18,2018,COL,NYM,2,12,109,1.5,-155,9.5,-110,-110,-119,-1.5,135,4.55,Coors Field,14,-10
2018-06-18,2018,WSH,NYY,2,4,115,1.5,-150,9.5,-110,-110,-125,-1.5,130,4.42,Nationals Park,6,-2
2018-06-18,2018,STL,PHI,5,6,-109,-1.5,143,8.5,-115,-105,-101,1.5,-164,4.43,Citizens Bank Park,11,-1
2018-06-18,2018,MIL,PIT,0,1,-107,-1.5,144,9.0,-102,-118,-103,1.5,-165,4.65,PNC Park,1,-1
2018-06-18,2018,MIA,SF,5,4,145,1.5,-150,7.5,100,-120,-160,-1.5,130,3.06,AT&T Park,9,1
2018-06-18,2018,PHI,STL,6,5,-101,1.5,-164,8.5,-115,-105,-109,-1.5,143,4.27,Citizens Bank Park,11,1
2018-06-18,2018,HOU,TB,5,4,-271,-1.5,-128,7.0,-117,-103,231,1.5,108,5.11,Minute Maid Park,9,1
2018-06-18,2018,KC,TEX,3,6,130,1.5,-130,9.5,-120,100,-145,-1.5,110,4.13,Kauffman Stadium,9,-3
2018-06-18,2018,NYY,WSH,4,2,-125,-1.5,130,9.5,-110,-110,115,1.5,-150,5.28,Nationals Park,6,2
2018-06-19,2018,LAA,ARI,5,4,-148,-1.5,144,9.0,-101,-119,133,1.5,-165,5.37,Angel Stadium,9,1
2018-06-19,2018,TOR,ATL,4,11,-105,1.5,-170,9.0,-110,-110,-105,-1.5,148,4.61,Rogers Centre,15,-7
2018-06-19,2018,WSH,BAL,9,7,-190,-1.5,101,9.5,-107,-113,170,1.5,-121,6.22,Nationals Park,16,2
2018-06-19,2018,MIN,BOS,6,2,180,1.5,110,7.0,-130,110,-210,-1.5,-130,2.5,Target Field,8,4
2018-06-19,2018,LAD,CHC,4,3,-119,-1.5,135,8.5,-115,-105,109,1.5,-155,4.62,Wrigley Field,7,1
2018-06-19,2018,LAD,CHC,1,2,108,1.5,-200,8.0,-101,-119,-118,-1.5,170,3.85,Wrigley Field,3,-1
2018-06-19,2018,DET,CIN,5,9,117,1.5,-180,9.0,-105,-115,-132,-1.5,155,4.15,Great American Ballpark,14,-4
2018-06-19,2018,CWS,CLE,3,6,176,1.5,-113,8.5,-110,-110,-196,-1.5,-107,3.08,Progressive Field,9,-3
2018-06-19,2018,NYM,COL,8,10,149,1.5,-130,11.5,-110,-110,-164,-1.5,110,4.62,Coors Field,18,-2
2018-06-19,2018,CLE,CWS,6,3,-196,-1.5,-107,8.5,-110,-110,176,1.5,-113,5.63,Progressive Field,9,3
2018-06-19,2018,CIN,DET,9,5,-132,-1.5,155,9.0,-105,-115,117,1.5,-180,5.12,Great American Ballpark,14,4
2018-06-19,2018,TB,HOU,2,1,205,1.5,-105,7.0,101,-121,-235,-1.5,-115,2.3,Minute Maid Park,3,1
2018-06-19,2018,TEX,KC,4,1,-137,-1.5,115,9.0,-120,100,122,1.5,-135,5.2,Kauffman Stadium,5,3
2018-06-19,2018,ARI,LAA,4,5,133,1.5,-165,9.0,-101,-119,-148,-1.5,144,3.86,Angel Stadium,9,-1
2018-06-19,2018,CHC,LAD,3,4,109,1.5,-155,8.5,-115,-105,-119,-1.5,135,4.07,Wrigley Field,7,-1
2018-06-19,2018,CHC,LAD,2,1,-118,-1.5,170,8.0,-101,-119,108,1.5,-200,4.33,Wrigley Field,3,1
2018-06-19,2018,SF,MIA,6,3,-162,-1.5,125,8.0,-109,-111,147,1.5,-145,4.95,AT&T Park,9,3
2018-06-19,2018,PIT,MIL,2,3,-119,-1.5,170,8.0,-110,-110,109,1.5,-200,4.35,PNC Park,5,-1
2018-06-19,2018,BOS,MIN,2,6,-210,-1.5,-130,7.0,-130,110,180,1.5,110,4.74,Target Field,8,-4
2018-06-19,2018,COL,NYM,10,8,-164,-1.5,110,11.5,-110,-110,149,1.5,-130,7.14,Coors Field,18,2
2018-06-19,2018,SEA,NYY,2,7,155,1.5,-125,9.5,-110,-110,-175,-1.5,105,3.73,Yankee Stadium,9,-5
2018-06-19,2018,SD,OAK,2,4,-109,-1.5,180,8.5,100,-120,-101,1.5,-215,4.43,PETCO Park,6,-2
2018-06-19,2018,STL,PHI,7,6,104,1.5,-210,8.5,-115,-105,-114,-1.5,176,4.17,Citizens Bank Park,13,1
2018-06-19,2018,MIL,PIT,3,2,109,1.5,-200,8.0,-110,-110,-119,-1.5,170,3.83,PNC Park,5,1
2018-06-19,2018,OAK,SD,4,2,-101,1.5,-215,8.5,100,-120,-109,-1.5,180,4.27,PETCO Park,6,2
2018-06-19,2018,NYY,SEA,7,2,-175,-1.5,105,9.5,-110,-110,155,1.5,-125,6.05,Yankee Stadium,9,5
2018-06-19,2018,MIA,SF,3,6,147,1.5,-145,8.0,-109,-111,-162,-1.5,125,3.24,AT&T Park,9,-3
2018-06-19,2018,PHI,STL,6,7,-114,-1.5,176,8.5,-115,-105,104,1.5,-210,4.53,Citizens Bank Park,13,-1
2018-06-19,2018,HOU,TB,1,2,-235,-1.5,-115,7.0,101,-121,205,1.5,-105,4.91,Minute Maid Park,3,-1
2018-06-19,2018,KC,TEX,1,4,122,1.5,-135,9.0,-120,100,-137,-1.5,115,4.05,Kauffman Stadium,5,-3
2018-06-19,2018,ATL,TOR,11,4,-105,-1.5,148,9.0,-110,-110,-105,1.5,-170,4.61,Rogers Centre,15,7
2018-06-19,2018,BAL,WSH,7,9,170,1.5,-121,9.5,-107,-113,-190,-1.5,101,3.52,Nationals Park,16,-2
2018-06-20,2018,TOR,ATL,5,4,-165,-1.5,130,8.5,-111,-109,150,1.5,-150,5.29,Rogers Centre,9,1
2018-06-20,2018,WSH,BAL,0,3,-205,-1.5,-115,9.0,-115,-105,175,1.5,-105,6.05,Nationals Park,3,-3
2018-06-20,2018,MIN,BOS,4,1,155,1.5,-105,8.5,-114,-106,-175,-1.5,-115,3.33,Target Field,5,3
2018-06-20,2018,LAD,CHC,0,4,-117,-1.5,137,7.5,-113,-107,107,1.5,-157,4.04,Wrigley Field,4,-4
2018-06-20,2018,DET,CIN,3,5,125,1.5,-162,9.0,100,-120,-140,-1.5,141,4.0,Great American Ballpark,8,-2
2018-06-20,2018,CWS,CLE,0,12,283,1.5,141,8.0,-110,-110,-333,-1.5,-161,2.09,Progressive Field,12,-12
2018-06-20,2018,NYM,COL,8,10,-103,1.5,-190,11.0,-109,-111,-107,-1.5,163,5.58,Coors Field,18,-2
2018-06-20,2018,CLE,CWS,12,0,-333,-1.5,-161,8.0,-110,-110,283,1.5,141,6.15,Progressive Field,12,12
2018-06-20,2018,CIN,DET,5,3,-140,-1.5,141,9.0,100,-120,125,1.5,-162,5.25,Great American Ballpark,8,2
2018-06-20,2018,TB,HOU,1,5,220,1.5,110,7.5,101,-121,-260,-1.5,-130,2.34,Minute Maid Park,6,-4
2018-06-20,2018,TEX,KC,3,2,100,1.5,-210,9.5,-101,-119,-110,-1.5,176,4.75,Kauffman Stadium,5,1
2018-06-20,2018,CHC,LAD,4,0,107,1.5,-157,7.5,-113,-107,-117,-1.5,137,3.62,Wrigley Field,4,4
2018-06-20,2018,SF,MIA,6,5,-119,-1.5,176,8.0,100,-120,109,1.5,-210,4.35,AT&T Park,11,1
2018-06-20,2018,BOS,MIN,1,4,-175,-1.5,-115,8.5,-114,-106,155,1.5,-105,5.41,Target Field,5,-3
2018-06-20,2018,COL,NYM,10,8,-107,-1.5,163,11.0,-109,-111,-103,1.5,-190,5.69,Coors Field,18,2
2018-06-20,2018,SEA,NYY,5,7,180,1.5,-104,10.0,-115,-105,-210,-1.5,-116,3.57,Yankee Stadium,12,-2
2018-06-20,2018,SD,OAK,4,12,-133,-1.5,160,7.5,-111,-109,118,1.5,-185,4.28,PETCO Park,16,-8
2018-06-20,2018,STL,PHI,3,4,103,1.5,-215,9.0,-111,-109,-113,-1.5,180,4.43,Citizens Bank Park,7,-1
2018-06-20,2018,OAK,SD,12,4,118,1.5,-185,7.5,-111,-109,-133,-1.5,160,3.44,PETCO Park,16,8
2018-06-20,2018,NYY,SEA,7,5,-210,-1.5,-116,10.0,-115,-105,180,1.5,-104,6.77,Yankee Stadium,12,2
2018-06-20,2018,MIA,SF,5,6,109,1.5,-210,8.0,100,-120,-119,-1.5,176,3.83,AT&T Park,11,-1
2018-06-20,2018,PHI,STL,4,3,-113,-1.5,180,9.0,-111,-109,103,1.5,-215,4.77,Citizens Bank Park,7,1
2018-06-20,2018,HOU,TB,5,1,-260,-1.5,-130,7.5,101,-121,220,1.5,110,5.42,Minute Maid Park,6,4
2018-06-20,2018,KC,TEX,2,3,-110,-1.5,176,9.5,-101,-119,100,1.5,-210,4.98,Kauffman Stadium,5,-1
2018-06-20,2018,ATL,TOR,4,5,150,1.5,-150,8.5,-111,-109,-165,-1.5,130,3.4,Rogers Centre,9,-1
2018-06-20,2018,BAL,WSH,3,0,175,1.5,-105,9.0,-115,-105,-205,-1.5,-115,3.27,Nationals Park,3,3
2018-06-21,2018,PIT,ARI,3,9,-119,-1.5,176,8.0,-119,-101,109,1.5,-210,4.35,PNC Park,12,-6
2018-06-21,2018,WSH,BAL,4,2,-275,-1.5,-135,7.0,110,-130,235,1.5,115,5.13,Nationals Park,6,2
2018-06-21,2018,MIN,BOS,2,9,119,1.5,-145,9.0,-101,-119,-129,-1.5,125,4.11,Target Field,11,-7
2018-06-21,2018,CIN,CHC,6,2,162,1.5,107,9.5,-115,-105,-182,-1.5,-127,3.63,Great American Ballpark,8,4
2018-06-21,2018,CHC,CIN,2,6,-182,-1.5,-127,9.5,-115,-105,162,1.5,107,6.13,Great American Ballpark,8,-4
2018-06-21,2018,NYM,COL,4,6,145,1.5,-135,11.5,-110,-110,-160,-1.5,115,4.69,Coors Field,10,-2
2018-06-21,2018,TOR,LAA,5,8,123,1.5,-170,8.5,-110,-110,-138,-1.5,148,3.81,Angel Stadium,13,-3
2018-06-21,2018,STL,MIL,3,11,106,1.5,-210,8.5,-114,-106,-116,-1.5,176,4.13,Miller Park,14,-8
2018-06-21,2018,BOS,MIN,9,2,-129,-1.5,125,9.0,-101,-119,119,1.5,-145,5.07,Target Field,11,7
2018-06-21,2018,COL,NYM,6,4,-160,-1.5,115,11.5,-110,-110,145,1.5,-135,7.08,Coors Field,10,2
2018-06-21,2018,SEA,NYY,3,4,165,1.5,-133,7.5,-115,-105,-185,-1.5,113,2.83,Yankee Stadium,7,-1
2018-06-21,2018,ARI,PIT,9,3,109,1.5,-210,8.0,-119,-101,-119,-1.5,176,3.83,PNC Park,12,6
2018-06-21,2018,SF,SD,3,0,-163,-1.5,130,7.5,-118,-102,148,1.5,-150,4.65,AT&T Park,3,3
2018-06-21,2018,NYY,SEA,4,3,-185,-1.5,113,7.5,-115,-105,165,1.5,-133,4.87,Yankee Stadium,7,1
2018-06-21,2018,SD,SF,0,3,148,1.5,-150,7.5,-118,-102,-163,-1.5,130,3.02,AT&T Park,3,-3
2018-06-21,2018,MIL,STL,11,3,-116,-1.5,176,8.5,-114,-106,106,1.5,-210,4.56,Miller Park,14,8
2018-06-21,2018,LAA,TOR,8,5,-138,-1.5,148,8.5,-110,-110,123,1.5,-170,4.93,Angel Stadium,13,3
2018-06-21,2018,BAL,WSH,2,4,235,1.5,115,7.0,110,-130,-275,-1.5,-135,2.09,Nationals Park,6,-2
2018-06-22,2018,PIT,ARI,1,2,111,1.5,-155,7.5,100,-120,-121,-1.5,134,3.55,PNC Park,3,-1
2018-06-22,2018,BAL,ATL,10,7,161,1.5,-129,8.0,-120,100,-181,-1.5,109,3.07,Suntrust Park,17,3
2018-06-22,2018,ATL,BAL,7,10,-181,-1.5,109,8.0,-120,100,161,1.5,-129,5.15,Suntrust Park,17,-3
2018-06-22,2018,SEA,BOS,10,14,119,1.5,-171,9.5,-115,-105,-129,-1.5,148,4.34,Fenway Park,24,-4
2018-06-22,2018,CIN,CHC,6,3,116,1.5,-136,8.5,-106,-114,-131,-1.5,116,3.94,Great American Ballpark,9,3
2018-06-22,2018,CHC,CIN,3,6,-131,-1.5,116,8.5,-106,-114,116,1.5,-136,4.82,Great American Ballpark,9,-3
2018-06-22,2018,DET,CLE,0,10,205,1.5,108,9.0,-120,100,-235,-1.5,-128,2.95,Progressive Field,10,-10
2018-06-22,2018,MIA,COL,3,11,190,1.5,106,11.0,-115,-105,-220,-1.5,-126,3.79,Coors Field,14,-8
2018-06-22,2018,OAK,CWS,11,2,-126,-1.5,121,9.0,-110,-110,116,1.5,-141,5.02,Guaranteed Rate Field,13,9
2018-06-22,2018,OAK,CWS,4,6,-143,-1.5,105,9.5,100,-120,128,1.5,-125,5.59,Guaranteed Rate Field,10,-2
2018-06-22,2018,CLE,DET,10,0,-235,-1.5,-128,9.0,-120,100,205,1.5,108,6.31,Progressive Field,10,10
2018-06-22,2018,KC,HOU,1,0,290,1.5,151,8.5,-115,-105,-340,-1.5,-175,2.18,Minute Maid Park,1,1
2018-06-22,2018,HOU,KC,0,1,-340,-1.5,-175,8.5,-115,-105,290,1.5,151,6.57,Minute Maid Park,1,-1
2018-06-22,2018,TOR,LAA,1,2,136,1.5,-165,8.5,-103,-117,-151,-1.5,144,3.6,Angel Stadium,3,-1
2018-06-22,2018,NYM,LAD,2,5,135,1.5,-125,7.5,-120,100,-150,-1.5,105,3.19,Citi Field,7,-3
2018-06-22,2018,COL,MIA,11,3,-220,-1.5,-126,11.0,-115,-105,190,1.5,106,7.56,Coors Field,14,8
2018-06-22,2018,STL,MIL,1,2,108,1.5,-210,8.5,-115,-105,-118,-1.5,176,4.09,Miller Park,3,-1
2018-06-22,2018,TEX,MIN,8,1,-320,-1.5,132,9.0,-120,100,270,1.5,-152,6.86,Target Field,9,7
2018-06-22,2018,LAD,NYM,5,2,-150,-1.5,105,7.5,-120,100,135,1.5,-125,4.5,Citi Field,7,3
2018-06-22,2018,TB,NYY,2,1,140,1.5,-119,7.5,-120,100,-155,-1.5,-101,3.13,Tropicana Field,3,1
2018-06-22,2018,CWS,OAK,2,11,116,1.5,-141,9.0,-110,-110,-126,-1.5,121,4.17,Guaranteed Rate Field,13,-9
2018-06-22,2018,CWS,OAK,6,4,128,1.5,-125,9.5,100,-120,-143,-1.5,105,4.17,Guaranteed Rate Field,10,2
2018-06-22,2018,WSH,PHI,2,12,-161,-1.5,135,8.5,100,-120,146,1.5,-155,5.24,Nationals Park,14,-10
2018-06-22,2018,ARI,PIT,2,1,-121,-1.5,134,7.5,100,-120,111,1.5,-155,4.11,PNC Park,3,1
2018-06-22,2018,SF,SD,2,6,-117,-1.5,176,7.5,-115,-105,107,1.5,-210,4.04,AT&T Park,8,-4
2018-06-22,2018,BOS,SEA,14,10,-129,-1.5,148,9.5,-115,-105,119,1.5,-171,5.35,Fenway Park,24,4
2018-06-22,2018,SD,SF,6,2,107,1.5,-210,7.5,-115,-105,-117,-1.5,176,3.62,AT&T Park,8,4
2018-06-22,2018,MIL,STL,2,1,-118,-1.5,176,8.5,-115,-105,108,1.5,-210,4.6,Miller Park,3,1
2018-06-22,2018,NYY,TB,1,2,-155,-1.5,-101,7.5,-120,100,140,1.5,-119,4.56,Tropicana Field,3,-1
2018-06-22,2018,MIN,TEX,1,8,270,1.5,-152,9.0,-120,100,-320,-1.5,132,2.43,Target Field,9,-7
2018-06-22,2018,LAA,TOR,2,1,-151,-1.5,144,8.5,-103,-117,136,1.5,-165,5.11,Angel Stadium,3,1
2018-06-22,2018,PHI,WSH,12,2,146,1.5,-155,8.5,100,-120,-161,-1.5,135,3.46,Nationals Park,14,10
2018-06-23,2018,PIT,ARI,2,7,-101,1.5,-170,7.5,-110,-110,-109,-1.5,148,3.77,PNC Park,9,-5
2018-06-23,2018,BAL,ATL,7,5,116,1.5,-175,8.5,-105,-115,-131,-1.5,151,3.94,Suntrust Park,12,2
2018-06-23,2018,ATL,BAL,5,7,-131,-1.5,151,8.5,-105,-115,116,1.5,-175,4.82,Suntrust Park,12,-2
2018-06-23,2018,SEA,BOS,7,2,162,1.5,-125,9.0,-111,-109,-182,-1.5,105,3.44,Fenway Park,9,5
2018-06-23,2018,CIN,CHC,11,2,-110,-1.5,180,9.5,-120,100,100,1.5,-215,4.98,Great American Ballpark,13,9
2018-06-23,2018,CHC,CIN,2,11,100,1.5,-215,9.5,-120,100,-110,-1.5,180,4.75,Great American Ballpark,13,-9
2018-06-23,2018,DET,CLE,1,4,225,1.5,123,8.5,-102,-118,-265,-1.5,-144,2.62,Progressive Field,5,-3
2018-06-23,2018,MIA,COL,6,2,210,1.5,130,11.5,-117,-103,-250,-1.5,-150,3.71,Coors Field,8,4
2018-06-23,2018,OAK,CWS,7,6,-113,-1.5,135,9.0,-121,101,103,1.5,-155,4.77,Guaranteed Rate Field,13,1
2018-06-23,2018,CLE,DET,4,1,-265,-1.5,-144,8.5,-102,-118,225,1.5,123,6.17,Progressive Field,5,3
2018-06-23,2018,KC,HOU,3,4,295,1.5,140,8.0,-119,-101,-345,-1.5,-160,2.03,Minute Maid Park,7,-1
2018-06-23,2018,HOU,KC,4,3,-345,-1.5,-160,8.0,-119,-101,295,1.5,140,6.2,Minute Maid Park,7,1
2018-06-23,2018,TOR,LAA,4,1,120,1.5,-171,8.5,-115,-105,-135,-1.5,148,3.86,Angel Stadium,5,3
2018-06-23,2018,NYM,LAD,3,8,101,1.5,-170,6.5,105,-125,-111,-1.5,148,3.23,Citi Field,11,-5
2018-06-23,2018,COL,MIA,2,6,-250,-1.5,-150,11.5,-117,-103,210,1.5,130,8.21,Coors Field,8,-4
2018-06-23,2018,STL,MIL,3,2,-105,1.5,-230,9.0,-105,-115,-105,-1.5,192,4.61,Miller Park,5,1
2018-06-23,2018,TEX,MIN,9,6,114,1.5,-180,10.5,-119,-101,-124,-1.5,155,4.91,Target Field,15,3
2018-06-23,2018,LAD,NYM,8,3,-111,-1.5,148,6.5,105,-125,101,1.5,-170,3.42,Citi Field,11,5
2018-06-23,2018,TB,NYY,4,0,153,1.5,-102,8.0,-110,-110,-173,-1.5,-118,3.16,Tropicana Field,4,4
2018-06-23,2018,CWS,OAK,6,7,103,1.5,-155,9.0,-121,101,-113,-1.5,135,4.43,Guaranteed Rate Field,13,-1
2018-06-23,2018,WSH,PHI,3,5,-118,-1.5,172,8.5,100,-120,108,1.5,-205,4.6,Nationals Park,8,-2
2018-06-23,2018,ARI,PIT,7,2,-109,-1.5,148,7.5,-110,-110,-101,1.5,-170,3.91,PNC Park,9,5
2018-06-23,2018,SF,SD,5,3,-142,-1.5,144,8.5,-110,-110,127,1.5,-165,4.99,AT&T Park,8,2
2018-06-23,2018,BOS,SEA,2,7,-182,-1.5,105,9.0,-111,-109,162,1.5,-125,5.81,Fenway Park,9,-5
2018-06-23,2018,SD,SF,3,5,127,1.5,-165,8.5,-110,-110,-142,-1.5,144,3.74,AT&T Park,8,-2
2018-06-23,2018,MIL,STL,2,3,-105,-1.5,192,9.0,-105,-115,-105,1.5,-230,4.61,Miller Park,5,-1
2018-06-23,2018,NYY,TB,0,4,-173,-1.5,-118,8.0,-110,-110,153,1.5,-102,5.07,Tropicana Field,4,-4
2018-06-23,2018,MIN,TEX,6,9,-124,-1.5,155,10.5,-119,-101,114,1.5,-180,5.81,Target Field,15,-3
2018-06-23,2018,LAA,TOR,1,4,-135,-1.5,148,8.5,-115,-105,120,1.5,-171,4.88,Angel Stadium,5,-3
2018-06-23,2018,PHI,WSH,5,3,108,1.5,-205,8.5,100,-120,-118,-1.5,172,4.09,Nationals Park,8,2
2018-06-24,2018,PIT,ARI,0,3,-115,-1.5,172,8.5,-115,-105,105,1.5,-205,4.55,PNC Park,3,-3
2018-06-24,2018,BAL,ATL,3,7,165,1.5,-119,9.5,-105,-115,-185,-1.5,-101,3.58,Suntrust Park,10,-4
2018-06-24,2018,ATL,BAL,7,3,-185,-1.5,-101,9.5,-105,-115,165,1.5,-119,6.17,Suntrust Park,10,4
2018-06-24,2018,SEA,BOS,0,5,210,1.5,107,8.5,-114,-106,-250,-1.5,-127,2.74,Fenway Park,5,-5
2018-06-24,2018,CIN,CHC,8,6,116,1.5,-139,9.5,-110,-110,-131,-1.5,119,4.4,Great American Ballpark,14,2
2018-06-24,2018,CHC,CIN,6,8,-131,-1.5,119,9.5,-110,-110,116,1.5,-139,5.39,Great American Ballpark,14,-2
2018-06-24,2018,DET,CLE,2,12,147,1.5,-140,9.5,-110,-110,-162,-1.5,121,3.85,Progressive Field,14,-10
2018-06-24,2018,MIA,COL,8,5,154,1.5,-130,11.0,105,-125,-174,-1.5,110,4.33,Coors Field,13,3
2018-06-24,2018,OAK,CWS,3,10,109,1.5,-190,9.5,100,-120,-119,-1.5,163,4.55,Guaranteed Rate Field,13,-7
2018-06-24,2018,CLE,DET,12,2,-162,-1.5,121,9.5,-110,-110,147,1.5,-140,5.87,Progressive Field,14,10
2018-06-24,2018,KC,HOU,3,11,310,1.5,148,7.5,-113,-107,-370,-1.5,-170,1.83,Minute Maid Park,14,-8
2018-06-24,2018,HOU,KC,11,3,-370,-1.5,-170,7.5,-113,-107,310,1.5,148,5.9,Minute Maid Park,14,8
2018-06-24,2018,TOR,LAA,7,6,127,1.5,-170,9.0,107,-127,-142,-1.5,148,3.96,Angel Stadium,13,1
2018-06-24,2018,NYM,LAD,7,8,150,1.5,-105,8.5,-120,100,-170,-1.5,-115,3.4,Citi Field,15,-1
2018-06-24,2018,COL,MIA,5,8,-174,-1.5,110,11.0,105,-125,154,1.5,-130,6.99,Coors Field,13,-3
2018-06-24,2018,STL,MIL,8,2,111,1.5,-195,8.5,-110,-110,-121,-1.5,166,4.03,Miller Park,10,6
2018-06-24,2018,TEX,MIN,0,2,152,1.5,-135,9.0,-117,-103,-172,-1.5,115,3.57,Target Field,2,-2
2018-06-24,2018,LAD,NYM,8,7,-170,-1.5,-115,8.5,-120,100,150,1.5,-105,5.35,Citi Field,15,1
2018-06-24,2018,TB,NYY,7,6,150,1.5,-104,7.5,-105,-115,-170,-1.5,-116,3.0,Tropicana Field,13,1
2018-06-24,2018,CWS,OAK,10,3,-119,-1.5,163,9.5,100,-120,109,1.5,-190,5.16,Guaranteed Rate Field,13,7
2018-06-24,2018,WSH,PHI,8,6,-122,-1.5,172,9.0,-117,-103,112,1.5,-199,4.95,Nationals Park,14,2
2018-06-24,2018,ARI,PIT,3,0,105,1.5,-205,8.5,-115,-105,-115,-1.5,172,4.15,PNC Park,3,3
2018-06-24,2018,SF,SD,3,2,-152,-1.5,130,8.0,-113,-107,137,1.5,-150,4.83,AT&T Park,5,1
2018-06-24,2018,BOS,SEA,5,0,-250,-1.5,-127,8.5,-114,-106,210,1.5,107,6.07,Fenway Park,5,5
2018-06-24,2018,SD,SF,2,3,137,1.5,-150,8.0,-113,-107,-152,-1.5,130,3.38,AT&T Park,5,-1
2018-06-24,2018,MIL,STL,2,8,-121,-1.5,166,8.5,-110,-110,111,1.5,-195,4.65,Miller Park,10,-6
2018-06-24,2018,NYY,TB,6,7,-170,-1.5,-116,7.5,-105,-115,150,1.5,-104,4.72,Tropicana Field,13,-1
2018-06-24,2018,MIN,TEX,2,0,-172,-1.5,115,9.0,-117,-103,152,1.5,-135,5.69,Target Field,2,2
2018-06-24,2018,LAA,TOR,6,7,-142,-1.5,148,9.0,107,-127,127,1.5,-170,5.28,Angel Stadium,13,-1
2018-06-24,2018,PHI,WSH,6,8,112,1.5,-199,9.0,-117,-103,-122,-1.5,172,4.25,Nationals Park,14,-2
2018-06-25,2018,MIA,ARI,9,5,117,1.5,-155,7.5,-110,-110,-127,-1.5,135,3.46,Marlins Park,14,4
2018-06-25,2018,CIN,ATL,4,5,138,1.5,-160,9.0,-105,-115,-153,-1.5,140,3.78,Suntrust Park,9,-1
2018-06-25,2018,SEA,BAL,5,3,-111,-1.5,141,9.5,-110,-110,101,1.5,-161,5.0,Camden Yards,8,2
2018-06-25,2018,LAD,CHC,2,1,-168,-1.5,125,8.5,-110,-110,153,1.5,-145,5.33,Dodger Stadium,3,1
2018-06-25,2018,ATL,CIN,5,4,-153,-1.5,140,9.0,-105,-115,138,1.5,-160,5.44,Suntrust Park,9,1
2018-06-25,2018,STL,CLE,4,0,108,1.5,-155,8.0,-114,-106,-118,-1.5,135,3.85,Busch Stadium,4,4
2018-06-25,2018,OAK,DET,5,4,-115,-1.5,134,9.5,104,-124,105,1.5,-154,5.08,Comerica Park,9,1
2018-06-25,2018,TOR,HOU,6,3,200,1.5,100,7.0,-120,100,-240,-1.5,-120,2.33,Minute Maid Park,9,3
2018-06-25,2018,LAA,KC,0,2,-187,-1.5,-125,9.0,100,-120,167,1.5,105,5.86,Kauffman Stadium,2,-2
2018-06-25,2018,KC,LAA,2,0,167,1.5,105,9.0,100,-120,-187,-1.5,-125,3.37,Kauffman Stadium,2,2
2018-06-25,2018,CHC,LAD,1,2,153,1.5,-145,8.5,-110,-110,-168,-1.5,125,3.36,Dodger Stadium,3,-1
2018-06-25,2018,ARI,MIA,5,9,-127,-1.5,135,7.5,-110,-110,117,1.5,-155,4.2,Marlins Park,14,-4
2018-06-25,2018,PIT,NYM,6,4,-116,-1.5,144,7.5,-108,-112,106,1.5,-165,4.03,Citi Field,10,2
2018-06-25,2018,PHI,NYY,2,4,135,1.5,-120,8.0,-110,-110,-150,-1.5,100,3.4,Citizens Bank Park,6,-2
2018-06-25,2018,DET,OAK,4,5,105,1.5,-154,9.5,104,-124,-115,-1.5,134,4.63,Comerica Park,9,-1
2018-06-25,2018,NYY,PHI,4,2,-150,-1.5,100,8.0,-110,-110,135,1.5,-120,4.8,Citizens Bank Park,6,2
2018-06-25,2018,NYM,PIT,4,6,106,1.5,-165,7.5,-108,-112,-116,-1.5,144,3.64,Citi Field,10,-2
2018-06-25,2018,TEX,SD,7,4,-137,-1.5,143,9.5,-108,-112,122,1.5,-163,5.49,Rangers Ballpark,11,3
2018-06-25,2018,BAL,SEA,3,5,101,1.5,-161,9.5,-110,-110,-111,-1.5,141,4.73,Camden Yards,8,-2
2018-06-25,2018,CLE,STL,0,4,-118,-1.5,135,8.0,-114,-106,108,1.5,-155,4.33,Busch Stadium,4,-4
2018-06-25,2018,WSH,TB,0,11,102,1.5,-225,7.0,-130,110,-112,-1.5,188,3.47,Tropicana Field,11,-11
2018-06-25,2018,SD,TEX,4,7,122,1.5,-163,9.5,-108,-112,-137,-1.5,143,4.28,Rangers Ballpark,11,-3
2018-06-25,2018,HOU,TOR,3,6,-240,-1.5,-120,7.0,-120,100,200,1.5,100,4.94,Minute Maid Park,9,-3
2018-06-25,2018,TB,WSH,11,0,-112,-1.5,188,7.0,-130,110,102,1.5,-225,3.7,Tropicana Field,11,11
2018-06-26,2018,MIA,ARI,3,5,142,1.5,-115,8.0,101,-121,-157,-1.5,-105,3.31,Marlins Park,8,-2
2018-06-26,2018,CIN,ATL,5,3,125,1.5,-174,9.5,-105,-115,-140,-1.5,150,4.22,Suntrust Park,8,2
2018-06-26,2018,SEA,BAL,3,2,-140,-1.5,111,8.0,-112,-108,125,1.5,-131,4.67,Camden Yards,5,1
2018-06-26,2018,LAA,BOS,1,9,141,1.5,-130,10.0,-110,-110,-156,-1.5,110,4.15,Fenway Park,10,-8
2018-06-26,2018,LAD,CHC,4,9,-155,-1.5,138,7.5,-101,-119,140,1.5,-158,4.56,Dodger Stadium,13,-5
2018-06-26,2018,ATL,CIN,3,5,-140,-1.5,150,9.5,-105,-115,125,1.5,-174,5.54,Suntrust Park,8,-2
2018-06-26,2018,STL,CLE,11,2,149,1.5,-110,7.5,-120,100,-164,-1.5,-110,3.01,Busch Stadium,13,9
2018-06-26,2018,SF,COL,3,2,-144,-1.5,148,8.5,-108,-112,129,1.5,-170,5.02,AT&T Park,5,1
2018-06-26,2018,MIN,CWS,4,8,-127,-1.5,125,8.5,-120,100,117,1.5,-145,4.76,Guaranteed Rate Field,12,-4
2018-06-26,2018,OAK,DET,9,7,-126,-1.5,125,9.0,-115,-105,116,1.5,-145,5.02,Comerica Park,16,2
2018-06-26,2018,TOR,HOU,0,7,200,1.5,101,8.0,-120,100,-240,-1.5,-121,2.67,Minute Maid Park,7,-7
2018-06-26,2018,MIL,KC,5,1,-220,-1.5,-119,8.0,-122,102,190,1.5,-101,5.5,Miller Park,6,4
2018-06-26,2018,BOS,LAA,9,1,-156,-1.5,110,10.0,-110,-110,141,1.5,-130,6.09,Fenway Park,10,8
2018-06-26,2018,CHC,LAD,9,4,140,1.5,-158,7.5,-101,-119,-155,-1.5,138,3.13,Dodger Stadium,13,5
2018-06-26,2018,ARI,MIA,5,3,-157,-1.5,-105,8.0,101,-121,142,1.5,-115,4.89,Marlins Park,8,2
2018-06-26,2018,KC,MIL,1,5,190,1.5,-101,8.0,-122,102,-220,-1.5,-119,2.76,Miller Park,6,-4
2018-06-26,2018,CWS,MIN,8,4,117,1.5,-145,8.5,-120,100,-127,-1.5,125,3.92,Guaranteed Rate Field,12,4
2018-06-26,2018,PIT,NYM,3,4,107,1.5,-210,8.0,-110,-110,-117,-1.5,176,3.86,Citi Field,7,-1
2018-06-26,2018,PHI,NYY,0,6,166,1.5,-105,7.5,-105,-115,-186,-1.5,-115,2.82,Citizens Bank Park,6,-6
2018-06-26,2018,DET,OAK,7,9,116,1.5,-145,9.0,-115,-105,-126,-1.5,125,4.17,Comerica Park,16,-2
2018-06-26,2018,NYY,PHI,6,0,-186,-1.5,-115,7.5,-105,-115,166,1.5,-105,4.88,Citizens Bank Park,6,6
2018-06-26,2018,NYM,PIT,4,3,-117,-1.5,176,8.0,-110,-110,107,1.5,-210,4.31,Citi Field,7,1
2018-06-26,2018,TEX,SD,2,3,-127,-1.5,148,10.5,-120,100,117,1.5,-170,5.87,Rangers Ballpark,5,-1
2018-06-26,2018,BAL,SEA,2,3,125,1.5,-131,8.0,-112,-108,-140,-1.5,111,3.56,Camden Yards,5,-1
2018-06-26,2018,COL,SF,2,3,129,1.5,-170,8.5,-108,-112,-144,-1.5,148,3.71,AT&T Park,5,-1
2018-06-26,2018,CLE,STL,2,11,-164,-1.5,-110,7.5,-120,100,149,1.5,-110,4.66,Busch Stadium,13,-9
2018-06-26,2018,WSH,TB,0,1,-201,-1.5,-119,7.0,-105,-115,171,1.5,-101,4.67,Tropicana Field,1,-1
2018-06-26,2018,SD,TEX,3,2,117,1.5,-170,10.5,-120,100,-127,-1.5,148,4.84,Rangers Ballpark,5,1
2018-06-26,2018,HOU,TOR,7,0,-240,-1.5,-121,8.0,-120,100,200,1.5,101,5.65,Minute Maid Park,7,7
2018-06-26,2018,TB,WSH,1,0,171,1.5,-101,7.0,-105,-115,-201,-1.5,-119,2.58,Tropicana Field,1,1
2018-06-27,2018,MIA,ARI,1,2,143,1.5,-120,7.0,-120,100,-158,-1.5,100,2.88,Marlins Park,3,-1
2018-06-27,2018,CIN,ATL,6,5,109,1.5,-190,8.5,-114,-106,-119,-1.5,163,4.07,Suntrust Park,11,1
2018-06-27,2018,SEA,BAL,8,7,-105,1.5,-210,9.5,-110,-110,-105,-1.5,176,4.87,Camden Yards,15,1
2018-06-27,2018,LAA,BOS,6,9,135,1.5,-155,9.0,-120,100,-150,-1.5,135,3.83,Fenway Park,15,-3
2018-06-27,2018,LAD,CHC,7,5,-147,-1.5,148,7.5,-112,-108,132,1.5,-170,4.46,Dodger Stadium,12,2
2018-06-27,2018,ATL,CIN,5,6,-119,-1.5,163,8.5,-114,-106,109,1.5,-190,4.62,Suntrust Park,11,-1
2018-06-27,2018,STL,CLE,1,5,-112,-1.5,180,8.0,-119,-101,102,1.5,-215,4.23,Busch Stadium,6,-4
2018-06-27,2018,SF,COL,1,0,-164,-1.5,139,7.0,-118,-102,149,1.5,-159,4.35,AT&T Park,1,1
2018-06-27,2018,MIN,CWS,1,6,-153,-1.5,105,9.0,100,-120,138,1.5,-125,5.44,Guaranteed Rate Field,7,-5
2018-06-27,2018,OAK,DET,3,0,-122,-1.5,131,9.5,107,-127,112,1.5,-151,5.22,Comerica Park,3,3
2018-06-27,2018,TOR,HOU,6,7,170,1.5,-120,8.0,-118,-102,-190,-1.5,100,2.96,Minute Maid Park,13,-1
2018-06-27,2018,MIL,KC,4,5,-200,-1.5,-107,8.0,-101,-119,170,1.5,-113,5.33,Miller Park,9,-1
2018-06-27,2018,BOS,LAA,9,6,-150,-1.5,135,9.0,-120,100,135,1.5,-155,5.4,Fenway Park,15,3
2018-06-27,2018,CHC,LAD,5,7,132,1.5,-170,7.5,-112,-108,-147,-1.5,148,3.23,Dodger Stadium,12,-2
2018-06-27,2018,ARI,MIA,2,1,-158,-1.5,100,7.0,-120,100,143,1.5,-120,4.29,Marlins Park,3,1
2018-06-27,2018,KC,MIL,5,4,170,1.5,-113,8.0,-101,-119,-200,-1.5,-107,2.96,Miller Park,9,1
2018-06-27,2018,CWS,MIN,6,1,138,1.5,-125,9.0,100,-120,-153,-1.5,105,3.78,Guaranteed Rate Field,7,5
2018-06-27,2018,PIT,NYM,5,3,109,1.5,-202,8.0,-105,-115,-119,-1.5,170,3.83,Citi Field,8,2
2018-06-27,2018,PHI,NYY,3,0,114,1.5,-148,8.0,100,-120,-124,-1.5,128,3.74,Citizens Bank Park,3,3
2018-06-27,2018,DET,OAK,0,3,112,1.5,-151,9.5,107,-127,-122,-1.5,131,4.48,Comerica Park,3,-3
2018-06-27,2018,NYY,PHI,0,3,-124,-1.5,128,8.0,100,-120,114,1.5,-148,4.43,Citizens Bank Park,3,-3
2018-06-27,2018,NYM,PIT,3,5,-119,-1.5,170,8.0,-105,-115,109,1.5,-202,4.35,Citi Field,8,-2
2018-06-27,2018,TEX,SD,5,2,-116,-1.5,165,9.5,-105,-115,106,1.5,-193,5.1,Rangers Ballpark,7,3
2018-06-27,2018,BAL,SEA,7,8,-105,-1.5,176,9.5,-110,-110,-105,1.5,-210,4.87,Camden Yards,15,-1
2018-06-27,2018,COL,SF,0,1,149,1.5,-159,7.0,-118,-102,-164,-1.5,139,2.81,AT&T Park,1,-1
2018-06-27,2018,CLE,STL,5,1,102,1.5,-215,8.0,-119,-101,-112,-1.5,180,3.96,Busch Stadium,6,4
2018-06-27,2018,SD,TEX,2,5,106,1.5,-193,9.5,-105,-115,-116,-1.5,165,4.61,Rangers Ballpark,7,-3
2018-06-27,2018,HOU,TOR,7,6,-190,-1.5,100,8.0,-118,-102,170,1.5,-120,5.24,Minute Maid Park,13,1
2018-06-28,2018,MIA,ARI,0,4,150,1.5,-110,7.0,-103,-117,-170,-1.5,-110,2.8,Marlins Park,4,-4
2018-06-28,2018,SEA,BAL,4,2,-133,-1.5,110,10.5,-111,-109,118,1.5,-130,5.99,Camden Yards,6,2
2018-06-28,2018,LAA,BOS,2,4,150,1.5,-139,10.5,-125,105,-165,-1.5,119,4.2,Fenway Park,6,-2
2018-06-28,2018,LAD,CHC,5,11,-185,-1.5,110,7.5,-110,-110,165,1.5,-131,4.87,Dodger Stadium,16,-6
2018-06-28,2018,MIL,CIN,6,4,-111,-1.5,142,9.5,100,-120,101,1.5,-162,5.0,Great American Ballpark,10,2
2018-06-28,2018,SF,COL,8,9,114,1.5,-158,8.0,-110,-110,-124,-1.5,138,3.74,AT&T Park,17,-1
2018-06-28,2018,MIN,CWS,2,1,-112,-1.5,135,9.5,-110,-110,102,1.5,-155,5.02,Guaranteed Rate Field,3,1
2018-06-28,2018,OAK,DET,4,2,-113,-1.5,144,9.0,-120,100,103,1.5,-165,4.77,Comerica Park,6,2
2018-06-28,2018,TB,HOU,0,1,142,1.5,-121,7.5,-105,-115,-157,-1.5,101,3.1,Tropicana Field,1,-1
2018-06-28,2018,BOS,LAA,4,2,-165,-1.5,119,10.5,-125,105,150,1.5,-139,6.54,Fenway Park,6,2
2018-06-28,2018,CHC,LAD,11,5,165,1.5,-131,7.5,-110,-110,-185,-1.5,110,2.83,Dodger Stadium,16,6
2018-06-28,2018,ARI,MIA,4,0,-170,-1.5,-110,7.0,-103,-117,150,1.5,-110,4.41,Marlins Park,4,4
2018-06-28,2018,CIN,MIL,4,6,101,1.5,-162,9.5,100,-120,-111,-1.5,142,4.73,Great American Ballpark,10,-2
2018-06-28,2018,CWS,MIN,1,2,102,1.5,-155,9.5,-110,-110,-112,-1.5,135,4.7,Guaranteed Rate Field,3,-1
2018-06-28,2018,DET,OAK,2,4,103,1.5,-165,9.0,-120,100,-113,-1.5,144,4.43,Comerica Park,6,-2
2018-06-28,2018,WSH,PHI,3,4,113,1.5,-195,8.5,-104,-116,-123,-1.5,166,3.99,Citizens Bank Park,7,-1
2018-06-28,2018,BAL,SEA,2,4,118,1.5,-130,10.5,-111,-109,-133,-1.5,110,4.82,Camden Yards,6,-2
2018-06-28,2018,COL,SF,9,8,-124,-1.5,138,8.0,-110,-110,114,1.5,-158,4.43,AT&T Park,17,1
2018-06-28,2018,HOU,TB,1,0,-157,-1.5,101,7.5,-105,-115,142,1.5,-121,4.58,Tropicana Field,1,1
2018-06-28,2018,PHI,WSH,4,3,-123,-1.5,166,8.5,-104,-116,113,1.5,-195,4.69,Citizens Bank Park,7,1
2018-06-29,2018,SF,ARI,2,1,120,1.5,-170,7.0,-117,-103,-135,-1.5,148,3.18,Chase Field,3,1
2018-06-29,2018,STL,ATL,1,5,-136,-1.5,155,8.5,-105,-115,121,1.5,-180,4.9,Busch Stadium,6,-4
2018-06-29,2018,LAA,BAL,7,1,-155,-1.5,100,10.0,-115,-105,140,1.5,-120,6.08,Camden Yards,8,6
2018-06-29,2018,NYY,BOS,8,1,-121,-1.5,163,9.5,-109,-111,111,1.5,-190,5.2,Yankee Stadium,9,7
2018-06-29,2018,MIN,CHC,6,10,114,1.5,-180,9.5,-110,-110,-124,-1.5,155,4.44,Wrigley Field,16,-4
2018-06-29,2018,MIL,CIN,8,2,111,1.5,-185,9.5,-120,100,-121,-1.5,160,4.5,Great American Ballpark,10,6
2018-06-29,2018,OAK,CLE,3,1,160,1.5,104,8.5,-101,-119,-180,-1.5,-124,3.27,Oakland Coliseum,4,2
2018-06-29,2018,LAD,COL,1,3,-163,-1.5,135,8.0,100,-120,148,1.5,-155,4.96,Dodger Stadium,4,-2
2018-06-29,2018,TEX,CWS,11,3,-146,-1.5,132,10.5,-121,101,131,1.5,-152,6.23,Rangers Ballpark,14,8
2018-06-29,2018,TOR,DET,3,2,-210,-1.5,-110,9.0,-110,-110,180,1.5,-110,6.1,Rogers Centre,5,1
2018-06-29,2018,TB,HOU,3,2,165,1.5,-105,7.0,-117,-103,-185,-1.5,-115,2.64,Tropicana Field,5,1
2018-06-29,2018,SEA,KC,4,1,-215,-1.5,-116,8.0,-120,100,185,1.5,-104,5.46,T-Mobile Park,5,3
2018-06-29,2018,BAL,LAA,1,7,140,1.5,-120,10.0,-115,-105,-155,-1.5,100,4.17,Camden Yards,8,-6
2018-06-29,2018,COL,LAD,3,1,148,1.5,-155,8.0,100,-120,-163,-1.5,135,3.23,Dodger Stadium,4,2
2018-06-29,2018,NYM,MIA,2,8,-101,1.5,-215,8.5,-105,-115,-109,-1.5,180,4.27,Marlins Park,10,-6
2018-06-29,2018,CIN,MIL,2,8,-121,-1.5,160,9.5,-120,100,111,1.5,-185,5.2,Great American Ballpark,10,-6
2018-06-29,2018,CHC,MIN,10,6,-124,-1.5,155,9.5,-110,-110,114,1.5,-180,5.26,Wrigley Field,16,4
2018-06-29,2018,MIA,NYM,8,2,-109,-1.5,180,8.5,-105,-115,-101,1.5,-215,4.43,Marlins Park,10,6
2018-06-29,2018,BOS,NYY,1,8,111,1.5,-190,9.5,-109,-111,-121,-1.5,163,4.5,Yankee Stadium,9,-7
2018-06-29,2018,CLE,OAK,1,3,-180,-1.5,-124,8.5,-101,-119,160,1.5,104,5.46,Oakland Coliseum,4,-2
2018-06-29,2018,WSH,PHI,17,7,-110,1.5,-220,9.0,-114,-106,100,-1.5,184,4.71,Citizens Bank Park,24,10
2018-06-29,2018,SD,PIT,3,6,-111,-1.5,184,7.5,100,-120,101,1.5,-220,3.95,PETCO Park,9,-3
2018-06-29,2018,PIT,SD,6,3,101,1.5,-220,7.5,100,-120,-111,-1.5,184,3.73,PETCO Park,9,3
2018-06-29,2018,KC,SEA,1,4,185,1.5,-104,8.0,-120,100,-215,-1.5,-116,2.81,T-Mobile Park,5,-3
2018-06-29,2018,ARI,SF,1,2,-135,-1.5,148,7.0,-117,-103,120,1.5,-170,4.02,Chase Field,3,-1
2018-06-29,2018,ATL,STL,5,1,121,1.5,-180,8.5,-105,-115,-136,-1.5,155,3.85,Busch Stadium,6,4
2018-06-29,2018,HOU,TB,2,3,-185,-1.5,-115,7.0,-117,-103,165,1.5,-105,4.54,Tropicana Field,5,-1
2018-06-29,2018,CWS,TEX,3,11,131,1.5,-152,10.5,-121,101,-146,-1.5,132,4.55,Rangers Ballpark,14,-8
2018-06-29,2018,DET,TOR,2,3,180,1.5,-110,9.0,-110,-110,-210,-1.5,-110,3.21,Rogers Centre,5,-1
2018-06-29,2018,PHI,WSH,7,17,100,-1.5,184,9.0,-114,-106,-110,1.5,-220,4.5,Citizens Bank Park,24,-10
2018-06-30,2018,SF,ARI,7,0,111,1.5,-195,8.5,-105,-115,-121,-1.5,166,4.03,Chase Field,7,7
2018-06-30,2018,STL,ATL,4,11,-135,-1.5,160,9.0,100,-120,120,1.5,-185,5.17,Busch Stadium,15,-7
2018-06-30,2018,LAA,BAL,6,2,-163,-1.5,-105,9.5,-120,100,148,1.5,-115,5.89,Camden Yards,8,4
2018-06-30,2018,NYY,BOS,0,11,135,1.5,-121,8.5,100,-120,-150,-1.5,101,3.62,Yankee Stadium,11,-11
2018-06-30,2018,MIN,CHC,9,14,125,1.5,-150,10.5,-117,-103,-140,-1.5,130,4.67,Wrigley Field,23,-5
2018-06-30,2018,MIL,CIN,3,12,118,1.5,-170,9.5,-120,100,-133,-1.5,148,4.36,Great American Ballpark,15,-9
2018-06-30,2018,OAK,CLE,7,2,111,1.5,-150,9.5,-120,100,-121,-1.5,130,4.5,Oakland Coliseum,9,5
2018-06-30,2018,LAD,COL,1,3,-175,-1.5,132,8.0,-103,-117,155,1.5,-154,5.09,Dodger Stadium,4,-2
2018-06-30,2018,TEX,CWS,13,4,-121,-1.5,150,10.0,-120,100,111,1.5,-172,5.48,Rangers Ballpark,17,9
2018-06-30,2018,TOR,DET,4,3,-158,-1.5,120,9.0,-120,100,143,1.5,-140,5.51,Rogers Centre,7,1
2018-06-30,2018,TB,HOU,5,2,153,1.5,-124,7.0,-107,-113,-168,-1.5,103,2.77,Tropicana Field,7,3
2018-06-30,2018,SEA,KC,6,4,-210,-1.5,-114,8.5,100,-120,180,1.5,-106,5.76,T-Mobile Park,10,2
2018-06-30,2018,BAL,LAA,2,6,148,1.5,-115,9.5,-120,100,-163,-1.5,-105,3.83,Camden Yards,8,-4
2018-06-30,2018,COL,LAD,3,1,155,1.5,-154,8.0,-103,-117,-175,-1.5,132,3.14,Dodger Stadium,4,2
2018-06-30,2018,NYM,MIA,2,5,-171,-1.5,102,7.0,-102,-118,151,1.5,-122,4.42,Marlins Park,7,-3
2018-06-30,2018,CIN,MIL,12,3,-133,-1.5,148,9.5,-120,100,118,1.5,-170,5.42,Great American Ballpark,15,9
2018-06-30,2018,CHC,MIN,14,9,-140,-1.5,130,10.5,-117,-103,125,1.5,-150,6.13,Wrigley Field,23,5
2018-06-30,2018,MIA,NYM,5,2,151,1.5,-122,7.0,-102,-118,-171,-1.5,102,2.79,Marlins Park,7,3
2018-06-30,2018,BOS,NYY,11,0,-150,-1.5,101,8.5,100,-120,135,1.5,-121,5.1,Yankee Stadium,11,11
2018-06-30,2018,CLE,OAK,2,7,-121,-1.5,130,9.5,-120,100,111,1.5,-150,5.2,Oakland Coliseum,9,-5
2018-06-30,2018,WSH,PHI,2,3,-112,-1.5,140,9.5,-105,-115,102,1.5,-160,5.02,Citizens Bank Park,5,-1
2018-06-30,2018,SD,PIT,4,3,-141,-1.5,151,7.0,-125,105,126,1.5,-175,4.1,PETCO Park,7,1
2018-06-30,2018,PIT,SD,3,4,126,1.5,-175,7.0,-125,105,-141,-1.5,151,3.1,PETCO Park,7,-1
2018-06-30,2018,KC,SEA,4,6,180,1.5,-106,8.5,100,-120,-210,-1.5,-114,3.04,T-Mobile Park,10,-2
2018-06-30,2018,ARI,SF,0,7,-121,-1.5,166,8.5,-105,-115,111,1.5,-195,4.65,Chase Field,7,-7
2018-06-30,2018,ATL,STL,11,4,120,1.5,-185,9.0,100,-120,-135,-1.5,160,4.09,Busch Stadium,15,7
2018-06-30,2018,HOU,TB,2,5,-168,-1.5,103,7.0,-107,-113,153,1.5,-124,4.39,Tropicana Field,7,-3
2018-06-30,2018,CWS,TEX,4,13,111,1.5,-172,10.0,-120,100,-121,-1.5,150,4.74,Rangers Ballpark,17,-9
2018-06-30,2018,DET,TOR,3,4,143,1.5,-140,9.0,-120,100,-158,-1.5,120,3.7,Rogers Centre,7,-1
2018-06-30,2018,PHI,WSH,3,2,102,1.5,-160,9.5,-105,-115,-112,-1.5,140,4.7,Citizens Bank Park,5,1
2018-07-01,2018,SF,ARI,9,6,118,1.5,-180,8.0,-115,-105,-133,-1.5,155,3.67,Chase Field,15,3
2018-07-01,2018,STL,ATL,5,6,105,1.5,-158,8.5,-115,-105,-115,-1.5,138,4.15,Busch Stadium,11,-1
2018-07-01,2018,LAA,BAL,2,8,103,1.5,-192,10.0,-115,-105,-113,-1.5,164,4.93,Camden Yards,10,-6
2018-07-01,2018,NYY,BOS,11,1,-185,-1.5,110,8.5,-110,-110,165,1.5,-130,5.52,Yankee Stadium,12,10
2018-07-01,2018,MIN,CHC,10,11,162,1.5,-105,12.0,-115,-105,-182,-1.5,-115,4.58,Wrigley Field,21,-1
2018-07-01,2018,MIL,CIN,2,8,-127,-1.5,129,9.0,-117,-103,117,1.5,-149,5.04,Great American Ballpark,10,-6
2018-07-01,2018,OAK,CLE,3,15,136,1.5,-120,9.0,106,-126,-151,-1.5,100,3.81,Oakland Coliseum,18,-12
2018-07-01,2018,LAD,COL,6,4,-225,-1.5,-119,8.5,-101,-119,195,1.5,-101,5.88,Dodger Stadium,10,2
2018-07-01,2018,TEX,CWS,5,10,-171,-1.5,105,10.5,-110,-110,151,1.5,-125,6.63,Rangers Ballpark,15,-5
2018-07-01,2018,TOR,DET,1,9,-202,-1.5,-110,9.0,-109,-111,172,1.5,-110,6.02,Rogers Centre,10,-8
2018-07-01,2018,TB,HOU,3,2,135,1.5,-130,7.0,110,-130,-150,-1.5,110,2.98,Tropicana Field,5,1
2018-07-01,2018,SEA,KC,1,0,-285,-1.5,-140,7.0,-125,105,245,1.5,121,5.18,T-Mobile Park,1,1
2018-07-01,2018,BAL,LAA,8,2,-113,-1.5,164,10.0,-115,-105,103,1.5,-192,5.31,Camden Yards,10,6
2018-07-01,2018,COL,LAD,4,6,195,1.5,-101,8.5,-101,-119,-225,-1.5,-119,2.88,Dodger Stadium,10,-2
2018-07-01,2018,NYM,MIA,5,2,-111,-1.5,144,8.0,-105,-115,101,1.5,-165,4.21,Marlins Park,7,3
2018-07-01,2018,CIN,MIL,8,2,117,1.5,-149,9.0,-117,-103,-127,-1.5,129,4.15,Great American Ballpark,10,6
2018-07-01,2018,CHC,MIN,11,10,-182,-1.5,-115,12.0,-115,-105,162,1.5,-105,7.74,Wrigley Field,21,1
2018-07-01,2018,MIA,NYM,2,5,101,1.5,-165,8.0,-105,-115,-111,-1.5,144,3.98,Marlins Park,7,-3
2018-07-01,2018,BOS,NYY,1,11,165,1.5,-130,8.5,-110,-110,-185,-1.5,110,3.21,Yankee Stadium,12,-10
2018-07-01,2018,CLE,OAK,15,3,-151,-1.5,100,9.0,106,-126,136,1.5,-120,5.41,Oakland Coliseum,18,12
2018-07-01,2018,WSH,PHI,3,4,-135,-1.5,115,9.5,-102,-118,120,1.5,-135,5.46,Citizens Bank Park,7,-1
2018-07-01,2018,SD,PIT,5,7,103,1.5,-160,7.5,-110,-110,-113,-1.5,140,3.69,PETCO Park,12,-2
2018-07-01,2018,PIT,SD,7,5,-113,-1.5,140,7.5,-110,-110,103,1.5,-160,3.98,PETCO Park,12,2
2018-07-01,2018,KC,SEA,0,1,245,1.5,121,7.0,-125,105,-285,-1.5,-140,2.03,T-Mobile Park,1,-1
2018-07-01,2018,ARI,SF,6,9,-133,-1.5,155,8.0,-115,-105,118,1.5,-180,4.57,Chase Field,15,-3
2018-07-01,2018,ATL,STL,6,5,-115,-1.5,138,8.5,-115,-105,105,1.5,-158,4.55,Busch Stadium,11,1
2018-07-01,2018,HOU,TB,2,3,-150,-1.5,110,7.0,110,-130,135,1.5,-130,4.2,Tropicana Field,5,-1
2018-07-01,2018,CWS,TEX,10,5,151,1.5,-125,10.5,-110,-110,-171,-1.5,105,4.18,Rangers Ballpark,15,5
2018-07-01,2018,DET,TOR,9,1,172,1.5,-110,9.0,-109,-111,-202,-1.5,-110,3.31,Rogers Centre,10,8
2018-07-01,2018,PHI,WSH,4,3,120,1.5,-135,9.5,-102,-118,-135,-1.5,115,4.32,Citizens Bank Park,7,1
2018-07-02,2018,STL,ARI,6,3,130,1.5,-170,8.0,-101,-119,-145,-1.5,148,3.48,Chase Field,9,3
2018-07-02,2018,NYY,ATL,3,5,-215,-1.5,-116,9.5,-105,-115,185,1.5,-104,6.48,Yankee Stadium,8,-2
2018-07-02,2018,WSH,BOS,3,4,-180,-1.5,119,8.0,-103,-117,160,1.5,-139,5.14,Nationals Park,7,-1
2018-07-02,2018,CWS,CIN,3,5,180,1.5,-110,9.5,100,-120,-210,-1.5,-110,3.39,Great American Ballpark,8,-2
2018-07-02,2018,KC,CLE,3,9,238,1.5,144,8.5,-115,-105,-278,-1.5,-165,2.51,Kauffman Stadium,12,-6
2018-07-02,2018,SF,COL,2,5,-105,-1.5,144,11.5,-105,-115,-105,1.5,-165,5.89,Coors Field,7,-3
2018-07-02,2018,CIN,CWS,5,3,-210,-1.5,-110,9.5,100,-120,180,1.5,-110,6.44,Great American Ballpark,8,2
2018-07-02,2018,TOR,DET,2,3,-138,-1.5,140,9.5,-101,-119,123,1.5,-160,5.51,Rogers Centre,5,-1
2018-07-02,2018,CLE,KC,9,3,-278,-1.5,-165,8.5,-115,-105,238,1.5,144,6.25,Kauffman Stadium,12,6
2018-07-02,2018,PIT,LAD,1,17,200,1.5,-104,8.0,-106,-114,-230,-1.5,-116,2.67,Dodger Stadium,18,-16
2018-07-02,2018,TB,MIA,2,3,-138,-1.5,116,7.5,100,-120,123,1.5,-136,4.35,Marlins Park,5,-1
2018-07-02,2018,MIN,MIL,5,6,108,1.5,-200,8.0,-105,-115,-118,-1.5,170,3.85,Miller Park,11,-1
2018-07-02,2018,MIL,MIN,6,5,-118,-1.5,170,8.0,-105,-115,108,1.5,-200,4.33,Miller Park,11,1
2018-07-02,2018,ATL,NYY,5,3,185,1.5,-104,9.5,-105,-115,-215,-1.5,-116,3.33,Yankee Stadium,8,2
2018-07-02,2018,LAD,PIT,17,1,-230,-1.5,-116,8.0,-106,-114,200,1.5,-104,5.58,Dodger Stadium,18,16
2018-07-02,2018,COL,SF,5,2,-105,1.5,-165,11.5,-105,-115,-105,-1.5,144,5.89,Coors Field,7,3
2018-07-02,2018,ARI,STL,3,6,-145,-1.5,148,8.0,-101,-119,130,1.5,-170,4.73,Chase Field,9,-3
2018-07-02,2018,MIA,TB,3,2,123,1.5,-136,7.5,100,-120,-138,-1.5,116,3.36,Marlins Park,5,1
2018-07-02,2018,DET,TOR,3,2,123,1.5,-160,9.5,-101,-119,-138,-1.5,140,4.26,Rogers Centre,5,1
2018-07-02,2018,BOS,WSH,4,3,160,1.5,-139,8.0,-103,-117,-180,-1.5,119,3.08,Nationals Park,7,1
2018-07-03,2018,STL,ARI,2,4,125,1.5,-180,7.5,-101,-119,-140,-1.5,155,3.33,Chase Field,6,-2
2018-07-03,2018,NYY,ATL,8,5,-160,-1.5,125,9.0,-110,-110,145,1.5,-145,5.54,Yankee Stadium,13,3
2018-07-03,2018,PHI,BAL,3,2,-165,-1.5,118,8.5,-115,-105,150,1.5,-138,5.29,Citizens Bank Park,5,1
2018-07-03,2018,WSH,BOS,4,11,-114,-1.5,172,9.5,-106,-114,104,1.5,-205,5.06,Nationals Park,15,-7
2018-07-03,2018,DET,CHC,3,5,175,1.5,-113,8.0,-120,100,-205,-1.5,-107,2.91,Wrigley Field,8,-2
2018-07-03,2018,CWS,CIN,12,8,205,1.5,-105,9.5,-105,-115,-235,-1.5,-115,3.11,Great American Ballpark,20,4
2018-07-03,2018,KC,CLE,4,6,145,1.5,-110,9.5,100,-120,-160,-1.5,-110,3.88,Kauffman Stadium,10,-2
2018-07-03,2018,SF,COL,1,8,127,1.5,-150,12.0,-115,-105,-142,-1.5,130,5.29,Coors Field,9,-7
2018-07-03,2018,CIN,CWS,8,12,-235,-1.5,-115,9.5,-105,-115,205,1.5,-105,6.66,Great American Ballpark,20,-4
2018-07-03,2018,CHC,DET,5,3,-205,-1.5,-107,8.0,-120,100,175,1.5,-113,5.38,Wrigley Field,8,2
2018-07-03,2018,TEX,HOU,3,5,150,1.5,100,10.5,-115,-105,-170,-1.5,-120,4.2,Rangers Ballpark,8,-2
2018-07-03,2018,CLE,KC,6,4,-160,-1.5,-110,9.5,100,-120,145,1.5,-110,5.85,Kauffman Stadium,10,2
2018-07-03,2018,SEA,LAA,4,1,-110,-1.5,171,8.5,-120,100,100,1.5,-203,4.45,T-Mobile Park,5,3
2018-07-03,2018,PIT,LAD,3,8,215,1.5,112,7.5,-110,-110,-255,-1.5,-132,2.38,Dodger Stadium,11,-5
2018-07-03,2018,TB,MIA,9,6,101,-1.5,150,7.0,-125,105,-111,1.5,-174,3.48,Marlins Park,15,3
2018-07-03,2018,MIN,MIL,0,2,138,1.5,-155,8.5,-115,-105,-153,-1.5,135,3.57,Miller Park,2,-2
2018-07-03,2018,MIL,MIN,2,0,-153,-1.5,135,8.5,-115,-105,138,1.5,-155,5.14,Miller Park,2,2
2018-07-03,2018,TOR,NYM,8,6,-119,-1.5,163,9.0,-120,100,109,1.5,-190,4.89,Rogers Centre,14,2
2018-07-03,2018,ATL,NYY,5,8,145,1.5,-145,9.0,-110,-110,-160,-1.5,125,3.67,Yankee Stadium,13,-3
2018-07-03,2018,SD,OAK,2,6,116,1.5,-180,8.5,100,-120,-126,-1.5,155,3.94,Oakland Coliseum,8,-4
2018-07-03,2018,BAL,PHI,2,3,150,1.5,-138,8.5,-115,-105,-165,-1.5,118,3.4,Citizens Bank Park,5,-1
2018-07-03,2018,LAD,PIT,8,3,-255,-1.5,-132,7.5,-110,-110,215,1.5,112,5.39,Dodger Stadium,11,5
2018-07-03,2018,OAK,SD,6,2,-126,-1.5,155,8.5,100,-120,116,1.5,-180,4.74,Oakland Coliseum,8,4
2018-07-03,2018,LAA,SEA,1,4,100,1.5,-203,8.5,-120,100,-110,-1.5,171,4.25,T-Mobile Park,5,-3
2018-07-03,2018,COL,SF,8,1,-142,-1.5,130,12.0,-115,-105,127,1.5,-150,7.04,Coors Field,9,7
2018-07-03,2018,ARI,STL,4,2,-140,-1.5,155,7.5,-101,-119,125,1.5,-180,4.38,Chase Field,6,2
2018-07-03,2018,MIA,TB,6,9,-111,1.5,-174,7.0,-125,105,101,-1.5,150,3.68,Marlins Park,15,-3
2018-07-03,2018,HOU,TEX,5,3,-170,-1.5,-120,10.5,-115,-105,150,1.5,100,6.61,Rangers Ballpark,8,2
2018-07-03,2018,NYM,TOR,6,8,109,1.5,-190,9.0,-120,100,-119,-1.5,163,4.31,Rogers Centre,14,-2
2018-07-03,2018,BOS,WSH,11,4,104,1.5,-205,9.5,-106,-114,-114,-1.5,172,4.66,Nationals Park,15,7
2018-07-04,2018,STL,ARI,8,4,-104,1.5,-220,7.0,-120,100,-106,-1.5,184,3.57,Chase Field,12,4
2018-07-04,2018,NYY,ATL,6,2,-215,-1.5,-110,9.5,-118,-102,185,1.5,-110,6.48,Yankee Stadium,8,4
2018-07-04,2018,PHI,BAL,4,1,-211,-1.5,-111,8.5,-107,-113,181,1.5,-109,5.77,Citizens Bank Park,5,3
2018-07-04,2018,WSH,BOS,0,3,117,1.5,-135,9.0,-115,-105,-127,-1.5,116,4.15,Nationals Park,3,-3
2018-07-04,2018,DET,CHC,2,5,205,1.5,105,9.5,-115,-105,-235,-1.5,-125,3.11,Wrigley Field,7,-3
2018-07-04,2018,CWS,CIN,4,7,162,1.5,-125,10.5,105,-125,-182,-1.5,105,4.01,Great American Ballpark,11,-3
2018-07-04,2018,KC,CLE,2,3,230,1.5,143,9.0,-110,-110,-270,-1.5,-162,2.73,Kauffman Stadium,5,-1
2018-07-04,2018,SF,COL,0,1,116,1.5,-170,10.5,-123,103,-126,-1.5,148,4.86,Coors Field,1,-1
2018-07-04,2018,CIN,CWS,7,4,-182,-1.5,105,10.5,105,-125,162,1.5,-125,6.78,Great American Ballpark,11,3
2018-07-04,2018,CHC,DET,5,2,-235,-1.5,-125,9.5,-115,-105,205,1.5,105,6.66,Wrigley Field,7,3
2018-07-04,2018,TEX,HOU,4,5,160,1.5,-105,9.5,105,-125,-180,-1.5,-114,3.65,Rangers Ballpark,9,-1
2018-07-04,2018,CLE,KC,3,2,-270,-1.5,-162,9.0,-110,-110,230,1.5,143,6.57,Kauffman Stadium,5,1
2018-07-04,2018,SEA,LAA,4,7,-103,1.5,-168,9.0,100,-120,-107,-1.5,146,4.57,T-Mobile Park,11,-3
2018-07-04,2018,PIT,LAD,4,6,205,1.5,-101,8.5,-115,-105,-235,-1.5,-119,2.79,Dodger Stadium,10,-2
2018-07-04,2018,TB,MIA,0,3,-143,-1.5,120,7.0,-125,105,128,1.5,-140,4.12,Marlins Park,3,-3
2018-07-04,2018,MIN,MIL,2,3,103,1.5,-220,8.5,-116,-104,-113,-1.5,184,4.19,Miller Park,5,-1
2018-07-04,2018,MIL,MIN,3,2,-113,-1.5,184,8.5,-116,-104,103,1.5,-220,4.51,Miller Park,5,1
2018-07-04,2018,TOR,NYM,3,6,-173,-1.5,105,9.5,-118,-102,153,1.5,-125,6.02,Rogers Centre,9,-3
2018-07-04,2018,ATL,NYY,2,6,185,1.5,-110,9.5,-118,-102,-215,-1.5,-110,3.33,Yankee Stadium,8,-4
2018-07-04,2018,SD,OAK,2,4,150,1.5,-145,8.5,-117,-103,-165,-1.5,125,3.4,Oakland Coliseum,6,-2
2018-07-04,2018,BAL,PHI,1,4,181,1.5,-109,8.5,-107,-113,-211,-1.5,-111,3.02,Citizens Bank Park,5,-3
2018-07-04,2018,LAD,PIT,6,4,-235,-1.5,-119,8.5,-115,-105,205,1.5,-101,5.96,Dodger Stadium,10,2
2018-07-04,2018,OAK,SD,4,2,-165,-1.5,125,8.5,-117,-103,150,1.5,-145,5.29,Oakland Coliseum,6,2
2018-07-04,2018,LAA,SEA,7,4,-107,-1.5,146,9.0,100,-120,-103,1.5,-168,4.65,T-Mobile Park,11,3
2018-07-04,2018,COL,SF,1,0,-126,-1.5,148,10.5,-123,103,116,1.5,-170,5.85,Coors Field,1,1
2018-07-04,2018,ARI,STL,4,8,-106,-1.5,184,7.0,-120,100,-104,1.5,-220,3.6,Chase Field,12,-4
2018-07-04,2018,MIA,TB,3,0,128,1.5,-140,7.0,-125,105,-143,-1.5,120,3.07,Marlins Park,3,3
2018-07-04,2018,HOU,TEX,5,4,-180,-1.5,-114,9.5,105,-125,160,1.5,-105,6.11,Rangers Ballpark,9,1
2018-07-04,2018,NYM,TOR,6,3,153,1.5,-125,9.5,-118,-102,-173,-1.5,105,3.75,Rogers Centre,9,3
2018-07-04,2018,BOS,WSH,3,0,-127,-1.5,116,9.0,-115,-105,117,1.5,-135,5.04,Nationals Park,3,3
2018-07-05,2018,SD,ARI,6,3,148,1.5,-150,8.5,-109,-111,-163,-1.5,130,3.43,Chase Field,9,3
2018-07-05,2018,MIL,ATL,7,2,111,1.5,-155,8.5,-112,-108,-121,-1.5,135,4.03,Miller Park,9,5
2018-07-05,2018,MIN,BAL,5,2,-147,-1.5,140,9.5,-115,-105,132,1.5,-160,5.65,Target Field,7,3
2018-07-05,2018,HOU,CWS,4,3,-330,-1.5,-158,8.0,100,-120,280,1.5,138,6.14,Minute Maid Park,7,1
2018-07-05,2018,TEX,DET,7,5,-106,1.5,-215,9.5,-110,-110,-104,-1.5,180,4.89,Comerica Park,12,2
2018-07-05,2018,CWS,HOU,3,4,280,1.5,138,8.0,100,-120,-330,-1.5,-158,2.11,Minute Maid Park,7,-1
2018-07-05,2018,SEA,LAA,4,1,-133,-1.5,146,9.0,-103,-117,118,1.5,-167,5.14,T-Mobile Park,5,3
2018-07-05,2018,WSH,MIA,14,12,-205,-1.5,-105,9.0,-105,-115,175,1.5,-115,6.05,Nationals Park,26,2
2018-07-05,2018,ATL,MIL,2,7,-121,-1.5,135,8.5,-112,-108,111,1.5,-155,4.65,Miller Park,9,-5
2018-07-05,2018,BAL,MIN,2,5,132,1.5,-160,9.5,-115,-105,-147,-1.5,140,4.09,Target Field,7,-3
2018-07-05,2018,ARI,SD,3,6,-163,-1.5,130,8.5,-109,-111,148,1.5,-150,5.27,Chase Field,9,-3
2018-07-05,2018,LAA,SEA,1,4,118,1.5,-167,9.0,-103,-117,-133,-1.5,146,4.13,T-Mobile Park,5,-3
2018-07-05,2018,STL,SF,11,2,120,1.5,-175,8.0,100,-120,-135,-1.5,151,3.64,AT&T Park,13,9
2018-07-05,2018,SF,STL,2,11,-135,-1.5,151,8.0,100,-120,120,1.5,-175,4.6,AT&T Park,13,-9
2018-07-05,2018,DET,TEX,5,7,-104,-1.5,180,9.5,-110,-110,-106,1.5,-215,4.84,Comerica Park,12,-2
2018-07-05,2018,MIA,WSH,12,14,175,1.5,-115,9.0,-105,-115,-205,-1.5,-105,3.27,Nationals Park,26,-2
2018-07-06,2018,SD,ARI,1,3,132,1.5,-165,8.0,101,-121,-147,-1.5,144,3.45,Chase Field,4,-2
2018-07-06,2018,MIL,ATL,5,4,-129,-1.5,166,8.0,-120,100,119,1.5,-195,4.51,Miller Park,9,1
2018-07-06,2018,MIN,BAL,6,2,-151,-1.5,140,9.0,-101,-119,136,1.5,-160,5.41,Target Field,8,4
2018-07-06,2018,KC,BOS,5,10,325,1.5,191,8.5,-110,-110,-385,-1.5,-230,2.0,Kauffman Stadium,15,-5
2018-07-06,2018,CIN,CHC,3,2,135,1.5,-165,7.5,-105,-115,-150,-1.5,144,3.19,Wrigley Field,5,1
2018-07-06,2018,CHC,CIN,2,3,-150,-1.5,144,7.5,-105,-115,135,1.5,-165,4.5,Wrigley Field,5,-1
2018-07-06,2018,OAK,CLE,4,10,175,1.5,-115,9.0,-115,-105,-205,-1.5,-105,3.27,Progressive Field,14,-6
2018-07-06,2018,SEA,COL,1,7,-113,-1.5,181,8.0,-101,-119,103,1.5,-217,4.24,T-Mobile Park,8,-6
2018-07-06,2018,HOU,CWS,11,4,-285,-1.5,-140,8.5,-101,-119,245,1.5,120,6.29,Minute Maid Park,15,7
2018-07-06,2018,TEX,DET,1,3,-118,-1.5,137,9.0,-102,-118,108,1.5,-157,4.87,Comerica Park,4,-2
2018-07-06,2018,CWS,HOU,4,11,245,1.5,120,8.5,-101,-119,-285,-1.5,-140,2.46,Minute Maid Park,15,-7
2018-07-06,2018,BOS,KC,10,5,-385,-1.5,-230,8.5,-110,-110,325,1.5,191,6.75,Kauffman Stadium,15,5
2018-07-06,2018,LAD,LAA,2,3,-147,-1.5,105,9.5,-115,-105,132,1.5,-125,5.65,Angel Stadium,5,-1
2018-07-06,2018,LAA,LAD,3,2,132,1.5,-125,9.5,-115,-105,-147,-1.5,105,4.09,Angel Stadium,5,1
2018-07-06,2018,WSH,MIA,3,2,-235,-1.5,-123,9.0,-120,100,205,1.5,103,6.31,Nationals Park,5,1
2018-07-06,2018,ATL,MIL,4,5,119,1.5,-195,8.0,-120,100,-129,-1.5,166,3.65,Miller Park,9,-1
2018-07-06,2018,BAL,MIN,2,6,136,1.5,-160,9.0,-101,-119,-151,-1.5,140,3.81,Target Field,8,-4
2018-07-06,2018,TB,NYM,1,5,150,1.5,-160,6.5,-130,110,-165,-1.5,140,2.6,Citi Field,6,-4
2018-07-06,2018,TOR,NYY,6,2,137,1.5,-115,9.5,105,-125,-152,-1.5,-105,4.01,Rogers Centre,8,4
2018-07-06,2018,CLE,OAK,10,4,-205,-1.5,-105,9.0,-115,-105,175,1.5,-115,6.05,Progressive Field,14,6
2018-07-06,2018,PIT,PHI,5,17,-104,1.5,-169,8.5,-101,-119,-106,-1.5,147,4.33,PNC Park,22,-12
2018-07-06,2018,PHI,PIT,17,5,-106,-1.5,147,8.5,-101,-119,-104,1.5,-169,4.37,PNC Park,22,12
2018-07-06,2018,ARI,SD,3,1,-147,-1.5,144,8.0,101,-121,132,1.5,-165,4.76,Chase Field,4,2
2018-07-06,2018,COL,SEA,7,1,103,1.5,-217,8.0,-101,-119,-113,-1.5,181,3.94,T-Mobile Park,8,6
2018-07-06,2018,STL,SF,2,3,113,1.5,-204,8.5,-105,-115,-123,-1.5,171,3.99,AT&T Park,5,-1
2018-07-06,2018,SF,STL,3,2,-123,-1.5,171,8.5,-105,-115,113,1.5,-204,4.69,AT&T Park,5,1
2018-07-06,2018,NYM,TB,5,1,-165,-1.5,140,6.5,-130,110,150,1.5,-160,4.05,Citi Field,6,4
2018-07-06,2018,DET,TEX,3,1,108,1.5,-157,9.0,-102,-118,-118,-1.5,137,4.33,Comerica Park,4,2
2018-07-06,2018,NYY,TOR,2,6,-152,-1.5,-105,9.5,105,-125,137,1.5,-115,5.73,Rogers Centre,8,-4
2018-07-06,2018,MIA,WSH,2,3,205,1.5,103,9.0,-120,100,-235,-1.5,-123,2.95,Nationals Park,5,-1
2018-07-07,2018,SD,ARI,5,20,171,1.5,-132,8.0,-120,100,-191,-1.5,112,2.95,Chase Field,25,-15
2018-07-07,2018,MIL,ATL,1,5,-105,1.5,-165,9.0,-120,100,-105,-1.5,144,4.61,Miller Park,6,-4
2018-07-07,2018,MIN,BAL,5,4,-142,-1.5,144,8.5,-110,-110,127,1.5,-165,4.99,Target Field,9,1
2018-07-07,2018,KC,BOS,4,15,170,1.5,110,9.5,-114,-106,-190,-1.5,-130,3.52,Kauffman Stadium,19,-11
2018-07-07,2018,CIN,CHC,7,8,119,1.5,-175,9.5,-115,-105,-129,-1.5,151,4.34,Wrigley Field,15,-1
2018-07-07,2018,CHC,CIN,8,7,-129,-1.5,151,9.5,-115,-105,119,1.5,-175,5.35,Wrigley Field,15,1
2018-07-07,2018,OAK,CLE,6,3,210,1.5,103,9.0,-112,-108,-250,-1.5,-123,2.9,Progressive Field,9,3
2018-07-07,2018,SEA,COL,1,5,-210,-1.5,100,7.5,-110,-110,180,1.5,-120,5.08,T-Mobile Park,6,-4
2018-07-07,2018,HOU,CWS,12,6,-382,-1.5,-180,8.0,-120,100,322,1.5,155,6.34,Minute Maid Park,18,6
2018-07-07,2018,TEX,DET,2,7,-155,-1.5,-101,9.5,-101,-119,140,1.5,-119,5.77,Comerica Park,9,-5
2018-07-07,2018,CWS,HOU,6,12,322,1.5,155,8.0,-120,100,-382,-1.5,-180,1.9,Minute Maid Park,18,-6
2018-07-07,2018,BOS,KC,15,4,-190,-1.5,-130,9.5,-114,-106,170,1.5,110,6.22,Kauffman Stadium,19,11
2018-07-07,2018,LAD,LAA,3,1,-153,-1.5,-102,10.0,-110,-110,138,1.5,-118,6.05,Angel Stadium,4,2
2018-07-07,2018,LAA,LAD,1,3,138,1.5,-118,10.0,-110,-110,-153,-1.5,-102,4.2,Angel Stadium,4,-2
2018-07-07,2018,WSH,MIA,18,4,-350,-1.5,-160,7.5,100,-120,290,1.5,140,5.83,Nationals Park,22,14
2018-07-07,2018,ATL,MIL,5,1,-105,-1.5,144,9.0,-120,100,-105,1.5,-165,4.61,Miller Park,6,4
2018-07-07,2018,BAL,MIN,4,5,127,1.5,-165,8.5,-110,-110,-142,-1.5,144,3.74,Target Field,9,-1
2018-07-07,2018,TB,NYM,3,0,-129,-1.5,130,7.0,-116,-104,119,1.5,-150,3.94,Citi Field,3,3
2018-07-07,2018,TOR,NYY,5,8,178,1.5,117,7.5,-117,-103,-208,-1.5,-137,2.7,Rogers Centre,13,-3
2018-07-07,2018,CLE,OAK,3,6,-250,-1.5,-123,9.0,-112,-108,210,1.5,103,6.43,Progressive Field,9,-3
2018-07-07,2018,PIT,PHI,2,3,-138,-1.5,155,8.0,-109,-111,123,1.5,-180,4.64,PNC Park,5,-1
2018-07-07,2018,PHI,PIT,3,2,123,1.5,-180,8.0,-109,-111,-138,-1.5,155,3.59,PNC Park,5,1
2018-07-07,2018,ARI,SD,20,5,-191,-1.5,112,8.0,-120,100,171,1.5,-132,5.25,Chase Field,25,15
2018-07-07,2018,COL,SEA,5,1,180,1.5,-120,7.5,-110,-110,-210,-1.5,100,2.68,T-Mobile Park,6,4
2018-07-07,2018,STL,SF,3,2,-123,-1.5,130,8.5,-120,100,113,1.5,-150,4.69,AT&T Park,5,1
2018-07-07,2018,SF,STL,2,3,113,1.5,-150,8.5,-120,100,-123,-1.5,130,3.99,AT&T Park,5,-1
2018-07-07,2018,NYM,TB,0,3,119,1.5,-150,7.0,-116,-104,-129,-1.5,130,3.2,Citi Field,3,-3
2018-07-07,2018,DET,TEX,7,2,140,1.5,-119,9.5,-101,-119,-155,-1.5,-101,3.96,Comerica Park,9,5
2018-07-07,2018,NYY,TOR,8,5,-208,-1.5,-137,7.5,-117,-103,178,1.5,117,5.06,Rogers Centre,13,3
2018-07-07,2018,MIA,WSH,4,18,290,1.5,140,7.5,100,-120,-350,-1.5,-160,1.92,Nationals Park,22,-14
2018-07-08,2018,SD,ARI,4,3,175,1.5,-113,7.5,100,-120,-205,-1.5,-107,2.73,Chase Field,7,1
2018-07-08,2018,MIL,ATL,10,3,-121,-1.5,166,8.5,-110,-110,111,1.5,-195,4.65,Miller Park,13,7
2018-07-08,2018,MIN,BAL,10,1,-140,-1.5,135,10.0,-105,-115,125,1.5,-155,5.83,Target Field,11,9
2018-07-08,2018,KC,BOS,4,7,195,1.5,130,9.5,-119,-101,-225,-1.5,-150,3.22,Kauffman Stadium,11,-3
2018-07-08,2018,CIN,CHC,5,6,148,1.5,-145,8.5,-119,-101,-163,-1.5,126,3.43,Wrigley Field,11,-1
2018-07-08,2018,CHC,CIN,6,5,-163,-1.5,126,8.5,-119,-101,148,1.5,-145,5.27,Wrigley Field,11,1
2018-07-08,2018,OAK,CLE,6,0,150,1.5,-130,9.5,-105,-115,-170,-1.5,110,3.8,Progressive Field,6,6
2018-07-08,2018,SEA,COL,6,4,-145,-1.5,143,8.5,-113,-107,130,1.5,-163,5.03,T-Mobile Park,10,2
2018-07-08,2018,HOU,CWS,2,1,-345,-1.5,-159,9.0,-110,-110,295,1.5,139,6.98,Minute Maid Park,3,1
2018-07-08,2018,TEX,DET,3,0,104,1.5,-210,9.0,-108,-112,-114,-1.5,176,4.41,Comerica Park,3,3
2018-07-08,2018,CWS,HOU,1,2,295,1.5,139,9.0,-110,-110,-345,-1.5,-159,2.28,Minute Maid Park,3,-1
2018-07-08,2018,BOS,KC,7,4,-225,-1.5,-150,9.5,-119,-101,195,1.5,130,6.58,Kauffman Stadium,11,3
2018-07-08,2018,LAD,LAA,3,4,-111,-1.5,148,9.0,-105,-115,101,1.5,-170,4.73,Angel Stadium,7,-1
2018-07-08,2018,LAA,LAD,4,3,101,1.5,-170,9.0,-105,-115,-111,-1.5,148,4.48,Angel Stadium,7,1
2018-07-08,2018,WSH,MIA,2,10,-182,-1.5,100,9.5,-110,-110,162,1.5,-120,6.13,Nationals Park,12,-8
2018-07-08,2018,ATL,MIL,3,10,111,1.5,-195,8.5,-110,-110,-121,-1.5,166,4.03,Miller Park,13,-7
2018-07-08,2018,BAL,MIN,1,10,125,1.5,-155,10.0,-105,-115,-140,-1.5,135,4.44,Target Field,11,-9
2018-07-08,2018,TB,NYM,9,0,-108,-1.5,139,8.0,-120,100,-102,1.5,-159,4.15,Citi Field,9,9
2018-07-08,2018,TOR,NYY,1,2,145,1.5,-110,9.0,-111,-109,-160,-1.5,-110,3.67,Rogers Centre,3,-1
2018-07-08,2018,CLE,OAK,0,6,-170,-1.5,110,9.5,-105,-115,150,1.5,-130,5.98,Progressive Field,6,-6
2018-07-08,2018,PIT,PHI,4,1,-156,-1.5,135,9.0,-119,-101,141,1.5,-155,5.48,PNC Park,5,3
2018-07-08,2018,PHI,PIT,1,4,141,1.5,-155,9.0,-119,-101,-156,-1.5,135,3.73,PNC Park,5,-3
2018-07-08,2018,ARI,SD,3,4,-205,-1.5,-107,7.5,100,-120,175,1.5,-113,5.04,Chase Field,7,-1
2018-07-08,2018,COL,SEA,4,6,130,1.5,-163,8.5,-113,-107,-145,-1.5,143,3.7,T-Mobile Park,10,-2
2018-07-08,2018,STL,SF,8,13,109,1.5,-210,7.5,-110,-110,-119,-1.5,176,3.59,AT&T Park,21,-5
2018-07-08,2018,SF,STL,13,8,-119,-1.5,176,7.5,-110,-110,109,1.5,-210,4.08,AT&T Park,21,5
2018-07-08,2018,NYM,TB,0,9,-102,1.5,-159,8.0,-120,100,-108,-1.5,139,4.04,Citi Field,9,-9
2018-07-08,2018,DET,TEX,0,3,-114,-1.5,176,9.0,-108,-112,104,1.5,-210,4.79,Comerica Park,3,-3
2018-07-08,2018,NYY,TOR,2,1,-160,-1.5,-110,9.0,-111,-109,145,1.5,-110,5.54,Rogers Centre,3,1
2018-07-08,2018,MIA,WSH,10,2,162,1.5,-120,9.5,-110,-110,-182,-1.5,100,3.63,Nationals Park,12,8
2018-07-09,2018,NYY,BAL,4,5,-225,-1.5,-145,10.5,100,-120,195,1.5,125,7.27,Camden Yards,9,-1
2018-07-09,2018,NYY,BAL,10,2,-180,-1.5,-122,9.5,-115,-105,160,1.5,102,6.11,Camden Yards,12,8
2018-07-09,2018,TEX,BOS,0,5,175,1.5,-110,10.0,-114,-106,-195,-1.5,-110,3.64,Fenway Park,5,-5
2018-07-09,2018,SF,CHC,2,1,-116,-1.5,176,8.0,100,-120,106,1.5,-210,4.3,AT&T Park,3,1
2018-07-09,2018,CLE,CIN,5,7,-175,-1.5,103,9.5,-115,-105,155,1.5,-123,6.05,Progressive Field,12,-2
2018-07-09,2018,CIN,CLE,7,5,155,1.5,-123,9.5,-115,-105,-175,-1.5,103,3.73,Progressive Field,12,2
2018-07-09,2018,TB,DET,10,9,-233,-1.5,-116,7.5,106,-126,203,1.5,-104,5.25,Tropicana Field,19,1
2018-07-09,2018,OAK,HOU,2,0,175,1.5,-115,8.5,-106,-114,-205,-1.5,-105,3.09,Minute Maid Park,2,2
2018-07-09,2018,MIN,KC,3,1,-205,-1.5,-105,8.5,-110,-110,175,1.5,-115,5.71,Target Field,4,2
2018-07-09,2018,SD,LAD,2,8,210,1.5,135,8.0,-120,100,-250,-1.5,-155,2.58,PETCO Park,10,-6
2018-07-09,2018,MIL,MIA,3,4,-140,-1.5,120,8.0,-101,-119,125,1.5,-140,4.67,Marlins Park,7,-1
2018-07-09,2018,MIA,MIL,4,3,125,1.5,-140,8.0,-101,-119,-140,-1.5,120,3.56,Marlins Park,7,1
2018-07-09,2018,KC,MIN,1,3,175,1.5,-115,8.5,-110,-110,-205,-1.5,-105,3.09,Target Field,4,-2
2018-07-09,2018,PHI,NYM,3,4,-105,-1.5,148,8.5,100,-120,-105,1.5,-170,4.35,Citi Field,7,-1
2018-07-09,2018,PHI,NYM,3,1,-163,-1.5,-105,8.5,100,-120,148,1.5,-115,5.27,Citi Field,4,2
2018-07-09,2018,BAL,NYY,5,4,195,1.5,125,10.5,100,-120,-225,-1.5,-145,3.56,Camden Yards,9,1
2018-07-09,2018,BAL,NYY,2,10,160,1.5,102,9.5,-115,-105,-180,-1.5,-122,3.65,Camden Yards,12,-8
2018-07-09,2018,HOU,OAK,0,2,-205,-1.5,-105,8.5,-106,-114,175,1.5,-115,5.71,Minute Maid Park,2,-2
2018-07-09,2018,NYM,PHI,4,3,-105,1.5,-170,8.5,100,-120,-105,-1.5,148,4.35,Citi Field,7,1
2018-07-09,2018,NYM,PHI,1,3,148,1.5,-115,8.5,100,-120,-163,-1.5,-105,3.43,Citi Field,4,-2
2018-07-09,2018,WSH,PIT,3,6,-109,-1.5,145,9.5,-105,-115,-101,1.5,-166,4.95,PNC Park,9,-3
2018-07-09,2018,LAD,SD,8,2,-250,-1.5,-155,8.0,-120,100,210,1.5,135,5.71,PETCO Park,10,6
2018-07-09,2018,CHC,SF,1,2,106,1.5,-210,8.0,100,-120,-116,-1.5,176,3.88,AT&T Park,3,-1
2018-07-09,2018,DET,TB,9,10,203,1.5,-104,7.5,106,-126,-233,-1.5,-116,2.48,Tropicana Field,19,-1
2018-07-09,2018,BOS,TEX,5,0,-195,-1.5,-110,10.0,-114,-106,175,1.5,-110,6.61,Fenway Park,5,5
2018-07-09,2018,PIT,WSH,6,3,-101,1.5,-166,9.5,-105,-115,-109,-1.5,145,4.77,PNC Park,9,3
2018-07-10,2018,COL,ARI,3,5,-105,1.5,-160,11.0,-101,-119,-105,-1.5,140,5.63,Coors Field,8,-2
2018-07-10,2018,TOR,ATL,6,2,118,1.5,-180,8.5,-114,-106,-133,-1.5,155,3.9,Suntrust Park,8,4
2018-07-10,2018,NYY,BAL,5,6,-236,-1.5,-150,10.0,-110,-110,206,1.5,130,7.02,Camden Yards,11,-1
2018-07-10,2018,TEX,BOS,4,8,188,1.5,105,11.5,-105,-115,-218,-1.5,-125,3.99,Fenway Park,12,-4
2018-07-10,2018,SF,CHC,0,2,131,1.5,-135,8.0,100,-120,-146,-1.5,115,3.46,AT&T Park,2,-2
2018-07-10,2018,CLE,CIN,4,7,-233,-1.5,-125,9.0,-105,-115,203,1.5,105,6.3,Progressive Field,11,-3
2018-07-10,2018,CIN,CLE,7,4,203,1.5,105,9.0,-105,-115,-233,-1.5,-125,2.97,Progressive Field,11,3
2018-07-10,2018,ARI,COL,5,3,-105,-1.5,140,11.0,-101,-119,-105,1.5,-160,5.63,Coors Field,8,2
2018-07-10,2018,STL,CWS,14,2,-187,-1.5,-130,9.5,-115,-105,167,1.5,110,6.19,Guaranteed Rate Field,16,12
2018-07-10,2018,TB,DET,5,2,-189,-1.5,100,7.5,-101,-119,169,1.5,-120,4.9,Tropicana Field,7,3
2018-07-10,2018,OAK,HOU,5,6,196,1.5,-110,7.5,-115,-105,-226,-1.5,-110,2.53,Minute Maid Park,11,-1
2018-07-10,2018,MIN,KC,4,9,-172,-1.5,100,10.0,-110,-110,152,1.5,-120,6.32,Target Field,13,-5
2018-07-10,2018,SEA,LAA,3,9,148,1.5,-150,8.5,-112,-108,-163,-1.5,130,3.43,Angel Stadium,12,-6
2018-07-10,2018,SD,LAD,4,1,145,1.5,-120,8.0,101,-121,-160,-1.5,100,3.27,PETCO Park,5,3
2018-07-10,2018,MIL,MIA,8,4,-158,-1.5,-110,7.5,-112,-108,143,1.5,-110,4.59,Marlins Park,12,4
2018-07-10,2018,MIA,MIL,4,8,143,1.5,-110,7.5,-112,-108,-158,-1.5,-110,3.09,Marlins Park,12,-4
2018-07-10,2018,KC,MIN,9,4,152,1.5,-120,10.0,-110,-110,-172,-1.5,100,3.97,Target Field,13,5
2018-07-10,2018,PHI,NYM,7,3,-109,-1.5,135,9.0,-125,105,-101,1.5,-155,4.69,Citi Field,10,4
2018-07-10,2018,BAL,NYY,6,5,206,1.5,130,10.0,-110,-110,-236,-1.5,-150,3.27,Camden Yards,11,1
2018-07-10,2018,HOU,OAK,6,5,-226,-1.5,-110,7.5,-115,-105,196,1.5,-110,5.2,Minute Maid Park,11,1
2018-07-10,2018,NYM,PHI,3,7,-101,1.5,-155,9.0,-125,105,-109,-1.5,135,4.52,Citi Field,10,-4
2018-07-10,2018,WSH,PIT,5,1,-117,-1.5,142,9.0,100,-120,107,1.5,-162,4.85,PNC Park,6,4
2018-07-10,2018,LAD,SD,1,4,-160,-1.5,100,8.0,101,-121,145,1.5,-120,4.92,PETCO Park,5,-3
2018-07-10,2018,LAA,SEA,9,3,-163,-1.5,130,8.5,-112,-108,148,1.5,-150,5.27,Angel Stadium,12,6
2018-07-10,2018,CHC,SF,2,0,-146,-1.5,115,8.0,100,-120,131,1.5,-135,4.75,AT&T Park,2,2
2018-07-10,2018,CWS,STL,2,14,167,1.5,110,9.5,-115,-105,-187,-1.5,-130,3.56,Guaranteed Rate Field,16,-12
2018-07-10,2018,DET,TB,2,5,169,1.5,-120,7.5,-101,-119,-189,-1.5,100,2.79,Tropicana Field,7,-3
2018-07-10,2018,BOS,TEX,8,4,-218,-1.5,-125,11.5,-105,-115,188,1.5,105,7.88,Fenway Park,12,4
2018-07-10,2018,ATL,TOR,2,6,-133,-1.5,155,8.5,-114,-106,118,1.5,-180,4.85,Suntrust Park,8,-4
2018-07-10,2018,PIT,WSH,1,5,107,1.5,-162,9.0,100,-120,-117,-1.5,142,4.35,PNC Park,6,-4
2018-07-11,2018,COL,ARI,19,2,-140,-1.5,126,13.0,107,-127,125,1.5,-146,7.58,Coors Field,21,17
2018-07-11,2018,TOR,ATL,5,9,175,1.5,-116,8.5,100,-120,-205,-1.5,-104,3.09,Suntrust Park,14,-4
2018-07-11,2018,NYY,BAL,9,0,-170,-1.5,-123,9.0,100,-120,150,1.5,103,5.67,Camden Yards,9,9
2018-07-11,2018,TEX,BOS,2,4,350,1.5,164,8.5,-115,-105,-430,-1.5,-192,1.89,Fenway Park,6,-2
2018-07-11,2018,SF,CHC,5,4,-101,1.5,-175,8.0,-101,-119,-109,-1.5,151,4.02,AT&T Park,9,1
2018-07-11,2018,CLE,CIN,19,4,-185,-1.5,110,9.0,-120,100,165,1.5,-130,5.84,Progressive Field,23,15
2018-07-11,2018,CIN,CLE,4,19,165,1.5,-130,9.0,-120,100,-185,-1.5,110,3.4,Progressive Field,23,-15
2018-07-11,2018,ARI,COL,2,19,125,1.5,-146,13.0,107,-127,-140,-1.5,126,5.78,Coors Field,21,-17
2018-07-11,2018,STL,CWS,0,4,-155,-1.5,-103,9.5,-115,-105,140,1.5,-117,5.77,Guaranteed Rate Field,4,-4
2018-07-11,2018,TB,DET,4,2,-160,-1.5,144,7.0,-115,-105,145,1.5,-165,4.31,Tropicana Field,6,2
2018-07-11,2018,OAK,HOU,8,3,180,1.5,-110,8.5,-110,-110,-210,-1.5,-110,3.04,Minute Maid Park,11,5
2018-07-11,2018,MIN,KC,8,5,-205,-1.5,-115,9.5,-110,-110,175,1.5,-105,6.39,Target Field,13,3
2018-07-11,2018,SEA,LAA,3,0,103,1.5,-210,9.0,100,-120,-113,-1.5,176,4.43,Angel Stadium,3,3
2018-07-11,2018,SD,LAD,2,4,135,1.5,-125,7.5,105,-125,-150,-1.5,105,3.19,PETCO Park,6,-2
2018-07-11,2018,MIL,MIA,4,5,-175,-1.5,-120,7.5,-104,-116,155,1.5,100,4.77,Marlins Park,9,-1
2018-07-11,2018,MIA,MIL,5,4,155,1.5,100,7.5,-104,-116,-175,-1.5,-120,2.94,Marlins Park,9,1
2018-07-11,2018,KC,MIN,5,8,175,1.5,-105,9.5,-110,-110,-205,-1.5,-115,3.45,Target Field,13,-3
2018-07-11,2018,PHI,NYM,0,3,131,1.5,-180,7.0,-110,-110,-146,-1.5,155,3.03,Citi Field,3,-3
2018-07-11,2018,BAL,NYY,0,9,150,1.5,103,9.0,100,-120,-170,-1.5,-123,3.6,Camden Yards,9,-9
2018-07-11,2018,HOU,OAK,3,8,-210,-1.5,-110,8.5,-110,-110,180,1.5,-110,5.76,Minute Maid Park,11,-5
2018-07-11,2018,NYM,PHI,3,0,-146,-1.5,155,7.0,-110,-110,131,1.5,-180,4.15,Citi Field,3,3
2018-07-11,2018,WSH,PIT,0,2,-135,-1.5,115,9.0,-125,105,120,1.5,-135,5.17,PNC Park,2,-2
2018-07-11,2018,LAD,SD,4,2,-150,-1.5,105,7.5,105,-125,135,1.5,-125,4.5,PETCO Park,6,2
2018-07-11,2018,LAA,SEA,0,3,-113,-1.5,176,9.0,100,-120,103,1.5,-210,4.77,Angel Stadium,3,-3
2018-07-11,2018,CHC,SF,4,5,-109,-1.5,151,8.0,-101,-119,-101,1.5,-175,4.17,AT&T Park,9,-1
2018-07-11,2018,CWS,STL,4,0,140,1.5,-117,9.5,-115,-105,-155,-1.5,-103,3.96,Guaranteed Rate Field,4,4
2018-07-11,2018,DET,TB,2,4,145,1.5,-165,7.0,-115,-105,-160,-1.5,144,2.86,Tropicana Field,6,-2
2018-07-11,2018,BOS,TEX,4,2,-430,-1.5,-192,8.5,-115,-105,350,1.5,164,6.9,Fenway Park,6,2
2018-07-11,2018,ATL,TOR,9,5,-205,-1.5,-104,8.5,100,-120,175,1.5,-116,5.71,Suntrust Park,14,4
2018-07-11,2018,PIT,WSH,2,0,120,1.5,-135,9.0,-125,105,-135,-1.5,115,4.09,PNC Park,2,2
2018-07-12,2018,COL,ARI,5,1,-111,-1.5,155,11.5,100,-120,101,1.5,-180,6.05,Coors Field,6,4
2018-07-12,2018,PHI,BAL,5,4,101,1.5,-206,9.0,105,-125,-111,-1.5,173,4.48,Camden Yards,9,1
2018-07-12,2018,TOR,BOS,4,6,147,1.5,-130,9.0,-119,-101,-162,-1.5,110,3.64,Fenway Park,10,-2
2018-07-12,2018,NYY,CLE,7,4,-127,-1.5,130,7.5,105,-125,117,1.5,-150,4.2,Progressive Field,11,3
2018-07-12,2018,ARI,COL,1,5,101,1.5,-180,11.5,100,-120,-111,-1.5,155,5.72,Coors Field,6,-4
2018-07-12,2018,OAK,HOU,6,4,185,1.5,-110,8.0,100,-120,-215,-1.5,-110,2.81,Minute Maid Park,10,2
2018-07-12,2018,SEA,LAA,2,11,-109,-1.5,148,7.5,101,-121,-101,1.5,-171,3.91,Angel Stadium,13,-9
2018-07-12,2018,SD,LAD,2,3,173,1.5,113,7.5,-115,-105,-203,-1.5,-133,2.75,PETCO Park,5,-1
2018-07-12,2018,PIT,MIL,6,3,-127,-1.5,170,8.0,100,-120,117,1.5,-200,4.48,PNC Park,9,3
2018-07-12,2018,TB,MIN,1,5,-142,-1.5,113,7.5,-104,-116,127,1.5,-133,4.4,Target Field,6,-4
2018-07-12,2018,WSH,NYM,5,4,-205,-1.5,-130,7.0,-125,105,175,1.5,110,4.7,Citi Field,9,1
2018-07-12,2018,CLE,NYY,4,7,117,1.5,-150,7.5,105,-125,-127,-1.5,130,3.46,Progressive Field,11,-3
2018-07-12,2018,HOU,OAK,4,6,-215,-1.5,-110,8.0,100,-120,185,1.5,-110,5.46,Minute Maid Park,10,-2
2018-07-12,2018,BAL,PHI,4,5,-111,-1.5,173,9.0,105,-125,101,1.5,-206,4.73,Camden Yards,9,-1
2018-07-12,2018,MIL,PIT,3,6,117,1.5,-200,8.0,100,-120,-127,-1.5,170,3.69,PNC Park,9,-3
2018-07-12,2018,LAD,SD,3,2,-203,-1.5,-133,7.5,-115,-105,173,1.5,113,5.02,PETCO Park,5,1
2018-07-12,2018,LAA,SEA,11,2,-101,1.5,-171,7.5,101,-121,-109,-1.5,148,3.77,Angel Stadium,13,9
2018-07-12,2018,MIN,TB,5,1,127,1.5,-133,7.5,-104,-116,-142,-1.5,113,3.3,Target Field,6,4
2018-07-12,2018,BOS,TOR,6,4,-162,-1.5,110,9.0,-119,-101,147,1.5,-130,5.56,Fenway Park,10,2
2018-07-12,2018,NYM,WSH,4,5,175,1.5,110,7.0,-125,105,-205,-1.5,-130,2.55,Citi Field,9,-1
2018-07-13,2018,ATL,ARI,1,2,-156,-1.5,143,8.5,-115,-105,141,1.5,-164,5.18,Suntrust Park,3,-1
2018-07-13,2018,ARI,ATL,2,1,141,1.5,-164,8.5,-115,-105,-156,-1.5,143,3.53,Suntrust Park,3,1
2018-07-13,2018,TEX,BAL,5,4,-116,-1.5,130,9.5,-115,-105,106,1.5,-150,5.1,Camden Yards,9,1
2018-07-13,2018,TOR,BOS,13,7,185,1.5,-103,9.5,-103,-117,-215,-1.5,-117,3.33,Fenway Park,20,6
2018-07-13,2018,SD,CHC,4,5,119,1.5,-141,8.5,-105,-115,-134,-1.5,121,3.88,PETCO Park,9,-1
2018-07-13,2018,STL,CIN,1,9,-166,-1.5,125,9.0,-110,-110,151,1.5,-144,5.62,Busch Stadium,10,-8
2018-07-13,2018,NYY,CLE,5,6,-105,-1.5,144,9.5,-101,-119,-105,1.5,-165,4.87,Progressive Field,11,-1
2018-07-13,2018,SEA,COL,7,10,123,1.5,-145,13.0,-110,-110,-138,-1.5,125,5.83,Coors Field,17,-3
2018-07-13,2018,KC,CWS,6,9,107,1.5,-188,9.5,100,-120,-117,-1.5,158,4.59,Guaranteed Rate Field,15,-3
2018-07-13,2018,HOU,DET,3,0,-268,-1.5,-126,8.5,-113,-107,228,1.5,106,6.19,Minute Maid Park,3,3
2018-07-13,2018,DET,HOU,0,3,228,1.5,106,8.5,-113,-107,-268,-1.5,-126,2.59,Minute Maid Park,3,-3
2018-07-13,2018,CWS,KC,9,6,-117,-1.5,158,9.5,100,-120,107,1.5,-188,5.12,Guaranteed Rate Field,15,3
2018-07-13,2018,LAD,LAA,3,2,-165,-1.5,130,8.0,-114,-106,150,1.5,-150,4.98,Dodger Stadium,5,1
2018-07-13,2018,LAA,LAD,2,3,150,1.5,-150,8.0,-114,-106,-165,-1.5,130,3.2,Dodger Stadium,5,-1
2018-07-13,2018,PHI,MIA,2,0,-122,-1.5,144,7.5,-119,-101,112,1.5,-165,4.12,Marlins Park,2,2
2018-07-13,2018,PIT,MIL,7,3,-119,-1.5,176,8.5,-105,-115,109,1.5,-210,4.62,PNC Park,10,4
2018-07-13,2018,TB,MIN,8,11,-106,-1.5,155,8.5,-115,-105,-104,1.5,-180,4.37,Target Field,19,-3
2018-07-13,2018,WSH,NYM,2,4,116,1.5,-193,8.5,-110,-110,-131,-1.5,164,3.94,Citi Field,6,-2
2018-07-13,2018,CLE,NYY,6,5,-105,1.5,-165,9.5,-101,-119,-105,-1.5,144,4.87,Progressive Field,11,1
2018-07-13,2018,SF,OAK,7,1,-145,-1.5,151,7.5,-119,-101,130,1.5,-175,4.44,AT&T Park,8,6
2018-07-13,2018,MIA,PHI,0,2,112,1.5,-165,7.5,-119,-101,-122,-1.5,144,3.54,Marlins Park,2,-2
2018-07-13,2018,MIL,PIT,3,7,109,1.5,-210,8.5,-105,-115,-119,-1.5,176,4.07,PNC Park,10,-4
2018-07-13,2018,CHC,SD,5,4,-134,-1.5,121,8.5,-105,-115,119,1.5,-141,4.87,PETCO Park,9,1
2018-07-13,2018,COL,SEA,10,7,-138,-1.5,125,13.0,-110,-110,123,1.5,-145,7.54,Coors Field,17,3
2018-07-13,2018,OAK,SF,1,7,130,1.5,-175,7.5,-119,-101,-145,-1.5,151,3.26,AT&T Park,8,-6
2018-07-13,2018,CIN,STL,9,1,151,1.5,-144,9.0,-110,-110,-166,-1.5,125,3.59,Busch Stadium,10,8
2018-07-13,2018,MIN,TB,11,8,-104,1.5,-180,8.5,-115,-105,-106,-1.5,155,4.33,Target Field,19,3
2018-07-13,2018,BAL,TEX,4,5,106,1.5,-150,9.5,-115,-105,-116,-1.5,130,4.61,Camden Yards,9,-1
2018-07-13,2018,BOS,TOR,7,13,-215,-1.5,-117,9.5,-103,-117,185,1.5,-103,6.48,Fenway Park,20,-6
2018-07-13,2018,NYM,WSH,4,2,-131,-1.5,164,8.5,-110,-110,116,1.5,-193,4.82,Citi Field,6,2
2018-07-14,2018,ATL,ARI,0,3,-101,1.5,-171,7.5,-119,-101,-109,-1.5,148,3.77,Suntrust Park,3,-3
2018-07-14,2018,ARI,ATL,3,0,-109,-1.5,148,7.5,-119,-101,-101,1.5,-171,3.91,Suntrust Park,3,3
2018-07-14,2018,TEX,BAL,0,1,101,1.5,-193,10.5,-115,-105,-111,-1.5,165,5.22,Camden Yards,1,-1
2018-07-14,2018,TOR,BOS,2,6,176,1.5,-115,9.5,-110,-110,-206,-1.5,-105,3.44,Fenway Park,8,-4
2018-07-14,2018,SD,CHC,6,11,170,1.5,103,8.5,-115,-105,-190,-1.5,-123,3.15,PETCO Park,17,-5
2018-07-14,2018,STL,CIN,2,8,-150,-1.5,146,9.0,-101,-119,135,1.5,-167,5.4,Busch Stadium,10,-6
2018-07-14,2018,NYY,CLE,5,4,-105,1.5,-215,9.0,-119,-101,-105,-1.5,180,4.61,Progressive Field,9,1
2018-07-14,2018,SEA,COL,1,4,100,1.5,-215,8.0,-110,-110,-110,-1.5,180,4.0,Coors Field,5,-3
2018-07-14,2018,KC,CWS,5,0,106,1.5,-195,9.0,-101,-119,-116,-1.5,166,4.37,Guaranteed Rate Field,5,5
2018-07-14,2018,HOU,DET,9,1,-285,-1.5,-135,7.0,105,-125,245,1.5,115,5.18,Minute Maid Park,10,8
2018-07-14,2018,DET,HOU,1,9,245,1.5,115,7.0,105,-125,-285,-1.5,-135,2.03,Minute Maid Park,10,-8
2018-07-14,2018,CWS,KC,0,5,-116,-1.5,166,9.0,-101,-119,106,1.5,-195,4.83,Guaranteed Rate Field,5,-5
2018-07-14,2018,LAD,LAA,4,5,-182,-1.5,-110,11.5,-118,-102,162,1.5,-110,7.42,Dodger Stadium,9,-1
2018-07-14,2018,LAA,LAD,5,4,162,1.5,-110,11.5,-118,-102,-182,-1.5,-110,4.39,Dodger Stadium,9,1
2018-07-14,2018,PHI,MIA,0,2,-175,-1.5,-111,7.0,-119,-101,155,1.5,-109,4.45,Marlins Park,2,-2
2018-07-14,2018,PIT,MIL,2,1,-129,-1.5,166,8.0,-110,-110,119,1.5,-195,4.51,PNC Park,3,1
2018-07-14,2018,PIT,MIL,6,2,119,1.5,-136,9.0,-111,-109,-134,-1.5,116,4.11,PNC Park,8,4
2018-07-14,2018,TB,MIN,19,6,119,1.5,-180,8.0,-118,-102,-129,-1.5,155,3.65,Target Field,25,13
2018-07-14,2018,WSH,NYM,4,7,-111,-1.5,140,10.0,-110,-110,101,1.5,-160,5.26,Citi Field,11,-3
2018-07-14,2018,CLE,NYY,4,5,-105,-1.5,180,9.0,-119,-101,-105,1.5,-215,4.61,Progressive Field,9,-1
2018-07-14,2018,SF,OAK,3,4,-104,-1.5,188,8.5,-102,-118,-106,1.5,-226,4.33,AT&T Park,7,-1
2018-07-14,2018,MIA,PHI,2,0,155,1.5,-109,7.0,-119,-101,-175,-1.5,-111,2.75,Marlins Park,2,2
2018-07-14,2018,MIL,PIT,1,2,119,1.5,-195,8.0,-110,-110,-129,-1.5,166,3.65,PNC Park,3,-1
2018-07-14,2018,MIL,PIT,2,6,-134,-1.5,116,9.0,-111,-109,119,1.5,-136,5.15,PNC Park,8,-4
2018-07-14,2018,CHC,SD,11,6,-190,-1.5,-123,8.5,-115,-105,170,1.5,103,5.57,PETCO Park,17,5
2018-07-14,2018,COL,SEA,4,1,-110,-1.5,180,8.0,-110,-110,100,1.5,-215,4.19,Coors Field,5,3
2018-07-14,2018,OAK,SF,4,3,-106,1.5,-226,8.5,-102,-118,-104,-1.5,188,4.37,AT&T Park,7,1
2018-07-14,2018,CIN,STL,8,2,135,1.5,-167,9.0,-101,-119,-150,-1.5,146,3.83,Busch Stadium,10,6
2018-07-14,2018,MIN,TB,6,19,-129,-1.5,155,8.0,-118,-102,119,1.5,-180,4.51,Target Field,25,-13
2018-07-14,2018,BAL,TEX,1,0,-111,-1.5,165,10.5,-115,-105,101,1.5,-193,5.52,Camden Yards,1,1
2018-07-14,2018,BOS,TOR,6,2,-206,-1.5,-105,9.5,-110,-110,176,1.5,-115,6.4,Fenway Park,8,4
2018-07-14,2018,NYM,WSH,7,4,101,1.5,-160,10.0,-110,-110,-111,-1.5,140,4.98,Citi Field,11,3
2018-07-15,2018,ATL,ARI,5,1,119,1.5,-146,8.5,-106,-114,-129,-1.5,126,3.88,Suntrust Park,6,4
2018-07-15,2018,ARI,ATL,1,5,-129,-1.5,126,8.5,-106,-114,119,1.5,-146,4.79,Suntrust Park,6,-4
2018-07-15,2018,TEX,BAL,5,6,100,-1.5,148,9.5,-105,-115,-110,1.5,-170,4.75,Camden Yards,11,-1
2018-07-15,2018,TOR,BOS,2,5,131,1.5,-148,10.5,-108,-112,-146,-1.5,128,4.55,Fenway Park,7,-3
2018-07-15,2018,SD,CHC,4,7,130,1.5,-130,8.0,-111,-109,-145,-1.5,110,3.48,PETCO Park,11,-3
2018-07-15,2018,STL,CIN,6,4,-150,-1.5,130,8.5,-112,-108,135,1.5,-150,5.1,Busch Stadium,10,2
2018-07-15,2018,NYY,CLE,2,5,119,1.5,-180,8.5,-110,-110,-129,-1.5,155,3.88,Progressive Field,7,-3
2018-07-15,2018,SEA,COL,3,4,146,1.5,-132,11.0,-110,-110,-161,-1.5,112,4.47,Coors Field,7,-1
2018-07-15,2018,KC,CWS,1,10,-102,1.5,-205,9.5,-110,-110,-108,-1.5,172,4.8,Guaranteed Rate Field,11,-9
2018-07-15,2018,HOU,DET,3,6,-400,-1.5,-183,7.5,-110,-110,320,1.5,158,6.0,Minute Maid Park,9,-3
2018-07-15,2018,DET,HOU,6,3,320,1.5,158,7.5,-110,-110,-400,-1.5,-183,1.79,Minute Maid Park,9,3
2018-07-15,2018,CWS,KC,10,1,-108,-1.5,172,9.5,-110,-110,-102,1.5,-205,4.93,Guaranteed Rate Field,11,9
2018-07-15,2018,LAD,LAA,5,3,-220,-1.5,-112,8.5,-110,-110,190,1.5,-106,5.84,Dodger Stadium,8,2
2018-07-15,2018,LAA,LAD,3,5,190,1.5,-106,8.5,-110,-110,-220,-1.5,-112,2.93,Dodger Stadium,8,-2
2018-07-15,2018,PHI,MIA,5,10,-106,-1.5,148,8.5,-103,-117,-104,1.5,-170,4.37,Marlins Park,15,-5
2018-07-15,2018,PIT,MIL,7,6,-109,-1.5,180,7.5,-116,-104,-101,1.5,-215,3.91,PNC Park,13,1
2018-07-15,2018,TB,MIN,7,11,101,1.5,-217,9.0,100,-120,-111,-1.5,182,4.48,Target Field,18,-4
2018-07-15,2018,WSH,NYM,6,1,-143,-1.5,110,9.0,-120,100,128,1.5,-130,5.3,Citi Field,7,5
2018-07-15,2018,CLE,NYY,5,2,-129,-1.5,155,8.5,-110,-110,119,1.5,-180,4.79,Progressive Field,7,3
2018-07-15,2018,SF,OAK,2,6,-120,-1.5,172,7.0,-125,105,110,1.5,-205,3.82,AT&T Park,8,-4
2018-07-15,2018,MIA,PHI,10,5,-104,1.5,-170,8.5,-103,-117,-106,-1.5,148,4.33,Marlins Park,15,5
2018-07-15,2018,MIL,PIT,6,7,-101,1.5,-215,7.5,-116,-104,-109,-1.5,180,3.77,PNC Park,13,-1
2018-07-15,2018,CHC,SD,7,4,-145,-1.5,110,8.0,-111,-109,130,1.5,-130,4.73,PETCO Park,11,3
2018-07-15,2018,COL,SEA,4,3,-161,-1.5,112,11.0,-110,-110,146,1.5,-132,6.79,Coors Field,7,1
2018-07-15,2018,OAK,SF,6,2,110,1.5,-205,7.0,-125,105,-120,-1.5,172,3.33,AT&T Park,8,4
2018-07-15,2018,CIN,STL,4,6,135,1.5,-150,8.5,-112,-108,-150,-1.5,130,3.62,Busch Stadium,10,-2
2018-07-15,2018,MIN,TB,11,7,-111,-1.5,182,9.0,100,-120,101,1.5,-217,4.73,Target Field,18,4
2018-07-15,2018,BAL,TEX,6,5,-110,1.5,-170,9.5,-105,-115,100,-1.5,148,4.98,Camden Yards,11,1
2018-07-15,2018,BOS,TOR,5,2,-146,-1.5,128,10.5,-108,-112,131,1.5,-148,6.23,Fenway Park,7,3
2018-07-15,2018,NYM,WSH,1,6,128,1.5,-130,9.0,-120,100,-143,-1.5,110,3.95,Citi Field,7,-5
2018-07-19,2018,STL,CHC,6,9,137,1.5,-145,9.5,-105,-115,-152,-1.5,125,4.01,Wrigley Field,15,-3
2018-07-19,2018,CHC,STL,9,6,-152,-1.5,125,9.5,-105,-115,137,1.5,-145,5.73,Wrigley Field,15,3
2018-07-20,2018,COL,ARI,11,10,139,1.5,-160,7.5,-105,-115,-154,-1.5,140,3.14,Chase Field,21,1
2018-07-20,2018,WSH,ATL,5,8,-183,-1.5,115,8.5,-115,-105,163,1.5,-135,5.5,Nationals Park,13,-3
2018-07-20,2018,TOR,BAL,8,7,-160,-1.5,135,9.0,100,-120,145,1.5,-155,5.54,Rogers Centre,15,1
2018-07-20,2018,DET,BOS,0,1,175,1.5,120,9.0,-105,-115,-205,-1.5,-140,3.27,Comerica Park,1,-1
2018-07-20,2018,STL,CHC,18,5,125,1.5,-150,10.5,-105,-115,-140,-1.5,130,4.67,Wrigley Field,23,13
2018-07-20,2018,PIT,CIN,12,1,-110,-1.5,151,8.5,100,-120,100,1.5,-175,4.45,Great American Ballpark,13,11
2018-07-20,2018,TEX,CLE,8,9,175,1.5,115,10.0,-115,-105,-195,-1.5,-135,3.64,Rangers Ballpark,17,-1
2018-07-20,2018,ARI,COL,10,11,-154,-1.5,140,7.5,-105,-115,139,1.5,-160,4.55,Chase Field,21,-1
2018-07-20,2018,SEA,CWS,3,1,-200,-1.5,-110,8.5,-121,101,170,1.5,-110,5.67,T-Mobile Park,4,2
2018-07-20,2018,BOS,DET,1,0,-205,-1.5,-140,9.0,-105,-115,175,1.5,120,6.05,Comerica Park,1,1
2018-07-20,2018,LAA,HOU,1,3,101,1.5,-165,8.5,-115,-105,-111,-1.5,144,4.23,Angel Stadium,4,-2
2018-07-20,2018,MIN,KC,5,6,-129,-1.5,125,8.5,-110,-110,119,1.5,-145,4.79,Kauffman Stadium,11,-1
2018-07-20,2018,HOU,LAA,3,1,-111,-1.5,144,8.5,-115,-105,101,1.5,-165,4.47,Angel Stadium,4,2
2018-07-20,2018,MIL,LAD,4,6,117,1.5,-140,9.0,-101,-119,-132,-1.5,120,4.15,Miller Park,10,-2
2018-07-20,2018,TB,MIA,5,6,-170,-1.5,127,7.5,-109,-111,150,1.5,-147,4.72,Tropicana Field,11,-1
2018-07-20,2018,LAD,MIL,6,4,-132,-1.5,120,9.0,-101,-119,117,1.5,-140,5.12,Miller Park,10,2
2018-07-20,2018,KC,MIN,6,5,119,1.5,-145,8.5,-110,-110,-129,-1.5,125,3.88,Kauffman Stadium,11,1
2018-07-20,2018,NYY,NYM,5,7,-180,-1.5,110,9.0,105,-125,160,1.5,-130,5.79,Yankee Stadium,12,-2
2018-07-20,2018,NYM,NYY,7,5,160,1.5,-130,9.0,105,-125,-180,-1.5,110,3.46,Yankee Stadium,12,2
2018-07-20,2018,SF,OAK,5,1,120,1.5,-180,9.0,105,-125,-135,-1.5,155,4.09,Oakland Coliseum,6,4
2018-07-20,2018,SD,PHI,5,11,153,1.5,-136,8.0,-120,100,-168,-1.5,116,3.16,Citizens Bank Park,16,-6
2018-07-20,2018,CIN,PIT,1,12,100,1.5,-175,8.5,100,-120,-110,-1.5,151,4.25,Great American Ballpark,13,-11
2018-07-20,2018,PHI,SD,11,5,-168,-1.5,116,8.0,-120,100,153,1.5,-136,5.01,Citizens Bank Park,16,6
2018-07-20,2018,CWS,SEA,1,3,170,1.5,-110,8.5,-121,101,-200,-1.5,-110,3.15,T-Mobile Park,4,-2
2018-07-20,2018,OAK,SF,1,5,-135,-1.5,155,9.0,105,-125,120,1.5,-180,5.17,Oakland Coliseum,6,-4
2018-07-20,2018,CHC,STL,5,18,-140,-1.5,130,10.5,-105,-115,125,1.5,-150,6.13,Wrigley Field,23,-13
2018-07-20,2018,MIA,TB,6,5,150,1.5,-147,7.5,-109,-111,-170,-1.5,127,3.0,Tropicana Field,11,1
2018-07-20,2018,CLE,TEX,9,8,-195,-1.5,-135,10.0,-115,-105,175,1.5,115,6.61,Rangers Ballpark,17,1
2018-07-20,2018,BAL,TOR,7,8,145,1.5,-155,9.0,100,-120,-160,-1.5,135,3.67,Rogers Centre,15,-1
2018-07-20,2018,ATL,WSH,8,5,163,1.5,-135,8.5,-115,-105,-183,-1.5,115,3.23,Nationals Park,13,3
2018-07-21,2018,COL,ARI,6,5,130,1.5,-165,8.0,-112,-108,-145,-1.5,144,3.48,Chase Field,11,1
2018-07-21,2018,TOR,BAL,4,1,-198,-1.5,-110,9.0,100,-120,178,1.5,-110,5.98,Rogers Centre,5,3
2018-07-21,2018,DET,BOS,5,0,129,1.5,-119,9.5,-102,-118,-144,-1.5,-101,4.15,Comerica Park,5,5
2018-07-21,2018,STL,CHC,2,7,-106,-1.5,148,8.5,-125,105,-104,1.5,-170,4.37,Wrigley Field,9,-5
2018-07-21,2018,STL,CHC,6,3,134,1.5,-160,8.5,-120,100,-149,-1.5,140,3.63,Wrigley Field,9,3
2018-07-21,2018,PIT,CIN,6,2,103,1.5,-195,9.5,-105,-115,-113,-1.5,166,4.68,Great American Ballpark,8,4
2018-07-21,2018,TEX,CLE,3,16,159,1.5,101,11.0,-115,-105,-179,-1.5,-121,4.25,Rangers Ballpark,19,-13
2018-07-21,2018,ARI,COL,5,6,-145,-1.5,144,8.0,-112,-108,130,1.5,-165,4.73,Chase Field,11,-1
2018-07-21,2018,SEA,CWS,0,5,-195,-1.5,-105,8.5,-125,105,175,1.5,-115,5.62,T-Mobile Park,5,-5
2018-07-21,2018,BOS,DET,0,5,-144,-1.5,-101,9.5,-102,-118,129,1.5,-119,5.61,Comerica Park,5,-5
2018-07-21,2018,LAA,HOU,0,7,170,1.5,100,8.0,-110,-110,-190,-1.5,-120,2.96,Angel Stadium,7,-7
2018-07-21,2018,MIN,KC,2,4,-149,-1.5,110,9.5,-102,-118,134,1.5,-130,5.68,Kauffman Stadium,6,-2
2018-07-21,2018,HOU,LAA,7,0,-190,-1.5,-120,8.0,-110,-110,170,1.5,100,5.24,Angel Stadium,7,7
2018-07-21,2018,MIL,LAD,4,2,154,1.5,-104,8.5,100,-120,-169,-1.5,-116,3.35,Miller Park,6,2
2018-07-21,2018,TB,MIA,2,3,-148,-1.5,144,7.5,-107,-113,133,1.5,-165,4.48,Tropicana Field,5,-1
2018-07-21,2018,LAD,MIL,2,4,-169,-1.5,-116,8.5,100,-120,154,1.5,-104,5.34,Miller Park,6,-2
2018-07-21,2018,KC,MIN,4,2,134,1.5,-130,9.5,-102,-118,-149,-1.5,110,4.06,Kauffman Stadium,6,2
2018-07-21,2018,NYY,NYM,7,6,-250,-1.5,-130,9.5,-110,-110,210,1.5,110,6.79,Yankee Stadium,13,1
2018-07-21,2018,NYM,NYY,6,7,210,1.5,110,9.5,-110,-110,-250,-1.5,-130,3.06,Yankee Stadium,13,-1
2018-07-21,2018,SF,OAK,3,4,118,1.5,-185,7.5,-119,-101,-133,-1.5,160,3.44,Oakland Coliseum,7,-1
2018-07-21,2018,CIN,PIT,2,6,-113,-1.5,166,9.5,-105,-115,103,1.5,-195,5.04,Great American Ballpark,8,-4
2018-07-21,2018,CWS,SEA,5,0,175,1.5,-115,8.5,-125,105,-195,-1.5,-105,3.09,T-Mobile Park,5,5
2018-07-21,2018,OAK,SF,4,3,-133,-1.5,160,7.5,-119,-101,118,1.5,-185,4.28,Oakland Coliseum,7,1
2018-07-21,2018,CHC,STL,7,2,-104,1.5,-170,8.5,-125,105,-106,-1.5,148,4.33,Wrigley Field,9,5
2018-07-21,2018,CHC,STL,3,6,-149,-1.5,140,8.5,-120,100,134,1.5,-160,5.09,Wrigley Field,9,-3
2018-07-21,2018,MIA,TB,3,2,133,1.5,-165,7.5,-107,-113,-148,-1.5,144,3.22,Tropicana Field,5,1
2018-07-21,2018,CLE,TEX,16,3,-179,-1.5,-121,11.0,-115,-105,159,1.5,101,7.06,Rangers Ballpark,19,13
2018-07-21,2018,BAL,TOR,1,4,178,1.5,-110,9.0,100,-120,-198,-1.5,-110,3.24,Rogers Centre,5,-3
2018-07-22,2018,COL,ARI,1,6,155,1.5,-135,7.5,-120,100,-175,-1.5,115,2.94,Chase Field,7,-5
2018-07-22,2018,WSH,ATL,6,2,-200,-1.5,105,7.5,-110,-110,170,1.5,-125,5.0,Nationals Park,8,4
2018-07-22,2018,TOR,BAL,5,4,-200,-1.5,-105,8.5,-105,-115,170,1.5,-115,5.67,Rogers Centre,9,1
2018-07-22,2018,DET,BOS,1,9,277,1.5,155,8.0,105,-125,-327,-1.5,-180,2.12,Comerica Park,10,-8
2018-07-22,2018,STL,CHC,2,7,120,1.5,-180,8.0,-104,-116,-135,-1.5,155,3.64,Wrigley Field,9,-5
2018-07-22,2018,PIT,CIN,9,2,103,1.5,-200,9.5,-104,-116,-113,-1.5,170,4.68,Great American Ballpark,11,7
2018-07-22,2018,TEX,CLE,5,0,148,1.5,-105,11.5,-115,-105,-163,-1.5,-115,4.64,Rangers Ballpark,5,5
2018-07-22,2018,ARI,COL,6,1,-175,-1.5,115,7.5,-120,100,155,1.5,-135,4.77,Chase Field,7,5
2018-07-22,2018,SEA,CWS,8,2,-206,-1.5,-110,8.5,-120,100,176,1.5,-110,5.72,T-Mobile Park,10,6
2018-07-22,2018,BOS,DET,9,1,-327,-1.5,-180,8.0,105,-125,277,1.5,155,6.13,Comerica Park,10,8
2018-07-22,2018,LAA,HOU,14,5,111,1.5,-152,8.5,-105,-115,-121,-1.5,131,4.03,Angel Stadium,19,9
2018-07-22,2018,MIN,KC,3,5,-140,-1.5,115,9.5,-110,-110,125,1.5,-135,5.54,Kauffman Stadium,8,-2
2018-07-22,2018,HOU,LAA,5,14,-121,-1.5,131,8.5,-105,-115,111,1.5,-152,4.65,Angel Stadium,19,-9
2018-07-22,2018,MIL,LAD,2,11,116,1.5,-150,8.5,-114,-106,-126,-1.5,130,3.94,Miller Park,13,-9
2018-07-22,2018,TB,MIA,6,4,-168,-1.5,125,8.0,-110,-110,153,1.5,-145,5.01,Tropicana Field,10,2
2018-07-22,2018,LAD,MIL,11,2,-126,-1.5,130,8.5,-114,-106,116,1.5,-150,4.74,Miller Park,13,9
2018-07-22,2018,KC,MIN,5,3,125,1.5,-135,9.5,-110,-110,-140,-1.5,115,4.22,Kauffman Stadium,8,2
2018-07-22,2018,SF,OAK,5,6,116,1.5,-165,8.5,-110,-110,-131,-1.5,144,3.94,Oakland Coliseum,11,-1
2018-07-22,2018,SD,PHI,10,2,153,1.5,-134,8.5,-115,-105,-168,-1.5,114,3.36,Citizens Bank Park,12,8
2018-07-22,2018,SD,PHI,0,5,171,1.5,-105,9.0,106,-126,-191,-1.5,-115,3.32,Citizens Bank Park,5,-5
2018-07-22,2018,CIN,PIT,2,9,-113,-1.5,170,9.5,-104,-116,103,1.5,-200,5.04,Great American Ballpark,11,-7
2018-07-22,2018,PHI,SD,2,10,-168,-1.5,114,8.5,-115,-105,153,1.5,-134,5.33,Citizens Bank Park,12,-8
2018-07-22,2018,PHI,SD,5,0,-191,-1.5,-115,9.0,106,-126,171,1.5,-105,5.91,Citizens Bank Park,5,5
2018-07-22,2018,CWS,SEA,2,8,176,1.5,-110,8.5,-120,100,-206,-1.5,-110,3.08,T-Mobile Park,10,-6
2018-07-22,2018,OAK,SF,6,5,-131,-1.5,144,8.5,-110,-110,116,1.5,-165,4.82,Oakland Coliseum,11,1
2018-07-22,2018,CHC,STL,7,2,-135,-1.5,155,8.0,-104,-116,120,1.5,-180,4.6,Wrigley Field,9,5
2018-07-22,2018,MIA,TB,4,6,153,1.5,-145,8.0,-110,-110,-168,-1.5,125,3.16,Tropicana Field,10,-2
2018-07-22,2018,CLE,TEX,0,5,-163,-1.5,-115,11.5,-115,-105,148,1.5,-105,7.13,Rangers Ballpark,5,-5
2018-07-22,2018,BAL,TOR,4,5,170,1.5,-115,8.5,-105,-115,-200,-1.5,-105,3.15,Rogers Centre,9,-1
2018-07-22,2018,ATL,WSH,2,6,170,1.5,-125,7.5,-110,-110,-200,-1.5,105,2.78,Nationals Park,8,-4
2018-07-23,2018,CHC,ARI,1,7,-109,-1.5,176,8.5,-112,-108,-101,1.5,-210,4.43,Wrigley Field,8,-6
2018-07-23,2018,MIA,ATL,1,12,104,1.5,-150,8.0,100,-120,-114,-1.5,130,3.92,Marlins Park,13,-11
2018-07-23,2018,BOS,BAL,5,3,-192,-1.5,-127,9.0,105,-125,172,1.5,107,5.92,Camden Yards,8,2
2018-07-23,2018,BAL,BOS,3,5,172,1.5,107,9.0,105,-125,-192,-1.5,-127,3.31,Camden Yards,8,-2
2018-07-23,2018,ARI,CHC,7,1,-101,1.5,-210,8.5,-112,-108,-109,-1.5,176,4.27,Wrigley Field,8,6
2018-07-23,2018,STL,CIN,1,2,103,1.5,-190,9.5,-110,-110,-113,-1.5,163,4.68,Great American Ballpark,3,-1
2018-07-23,2018,PIT,CLE,7,0,245,1.5,125,8.5,-125,105,-285,-1.5,-145,2.46,Progressive Field,7,7
2018-07-23,2018,LAA,CWS,3,5,-227,-1.5,-130,9.5,-107,-113,197,1.5,110,6.59,Angel Stadium,8,-2
2018-07-23,2018,KC,DET,4,5,-104,1.5,-166,9.5,103,-123,-106,-1.5,145,4.84,Kauffman Stadium,9,-1
2018-07-23,2018,DET,KC,5,4,-106,-1.5,145,9.5,103,-123,-104,1.5,-166,4.89,Kauffman Stadium,9,1
2018-07-23,2018,CWS,LAA,5,3,197,1.5,110,9.5,-107,-113,-227,-1.5,-130,3.2,Angel Stadium,8,2
2018-07-23,2018,PHI,LAD,6,7,148,1.5,-120,8.0,-120,100,-163,-1.5,100,3.23,Citizens Bank Park,13,-1
2018-07-23,2018,ATL,MIA,12,1,-114,-1.5,130,8.0,100,-120,104,1.5,-150,4.26,Marlins Park,13,11
2018-07-23,2018,WSH,MIL,1,6,-109,-1.5,147,9.0,-105,-115,-101,1.5,-169,4.69,Miller Park,7,-5
2018-07-23,2018,TOR,MIN,3,8,-123,-1.5,151,9.5,-110,-110,113,1.5,-175,5.24,Rogers Centre,11,-5
2018-07-23,2018,SD,NYM,3,2,152,1.5,-145,6.5,-115,-105,-167,-1.5,125,2.58,Citi Field,5,1
2018-07-23,2018,TB,NYY,7,6,235,1.5,126,7.0,-110,-110,-275,-1.5,-145,2.09,Tropicana Field,13,1
2018-07-23,2018,TEX,OAK,3,15,-106,-1.5,170,10.5,-111,-109,-104,1.5,-200,5.4,Rangers Ballpark,18,-12
2018-07-23,2018,LAD,PHI,7,6,-163,-1.5,100,8.0,-120,100,148,1.5,-120,4.96,Citizens Bank Park,13,1
2018-07-23,2018,CLE,PIT,0,7,-285,-1.5,-145,8.5,-125,105,245,1.5,125,6.29,Progressive Field,7,-7
2018-07-23,2018,NYM,SD,2,3,-167,-1.5,125,6.5,-115,-105,152,1.5,-145,4.07,Citi Field,5,-1
2018-07-23,2018,CIN,STL,2,1,-113,-1.5,163,9.5,-110,-110,103,1.5,-190,5.04,Great American Ballpark,3,1
2018-07-23,2018,NYY,TB,6,7,-275,-1.5,-145,7.0,-110,-110,235,1.5,126,5.13,Tropicana Field,13,-1
2018-07-23,2018,OAK,TEX,15,3,-104,1.5,-200,10.5,-111,-109,-106,-1.5,170,5.35,Rangers Ballpark,18,12
2018-07-23,2018,MIN,TOR,8,3,113,1.5,-175,9.5,-110,-110,-123,-1.5,151,4.46,Rogers Centre,11,5
2018-07-23,2018,MIL,WSH,6,1,-101,1.5,-169,9.0,-105,-115,-109,-1.5,147,4.52,Miller Park,7,5
2018-07-24,2018,CHC,ARI,1,5,-164,-1.5,130,9.0,-105,-115,149,1.5,-150,5.59,Wrigley Field,6,-4
2018-07-24,2018,MIA,ATL,9,3,109,1.5,-165,7.5,-120,100,-119,-1.5,144,3.59,Marlins Park,12,6
2018-07-24,2018,BOS,BAL,6,7,-154,-1.5,100,9.5,-120,100,139,1.5,-120,5.76,Camden Yards,13,-1
2018-07-24,2018,BAL,BOS,7,6,139,1.5,-120,9.5,-120,100,-154,-1.5,100,3.97,Camden Yards,13,1
2018-07-24,2018,ARI,CHC,5,1,149,1.5,-150,9.0,-105,-115,-164,-1.5,130,3.61,Wrigley Field,6,4
2018-07-24,2018,STL,CIN,4,2,-127,-1.5,125,10.5,-119,-101,117,1.5,-145,5.87,Great American Ballpark,6,2
2018-07-24,2018,PIT,CLE,9,4,150,1.5,-130,9.0,-120,100,-170,-1.5,110,3.6,Progressive Field,13,5
2018-07-24,2018,HOU,COL,8,2,-141,-1.5,110,10.0,-112,-108,126,1.5,-130,5.85,Coors Field,10,6
2018-07-24,2018,LAA,CWS,2,4,-196,-1.5,-115,8.5,-110,-110,176,1.5,-105,5.63,Angel Stadium,6,-2
2018-07-24,2018,KC,DET,5,4,-105,1.5,-175,9.0,-110,-110,-105,-1.5,151,4.61,Kauffman Stadium,9,1
2018-07-24,2018,COL,HOU,2,8,126,1.5,-130,10.0,-112,-108,-141,-1.5,110,4.42,Coors Field,10,-6
2018-07-24,2018,DET,KC,4,5,-105,-1.5,151,9.0,-110,-110,-105,1.5,-175,4.61,Kauffman Stadium,9,-1
2018-07-24,2018,CWS,LAA,4,2,176,1.5,-105,8.5,-110,-110,-196,-1.5,-115,3.08,Angel Stadium,6,2
2018-07-24,2018,PHI,LAD,7,4,-111,-1.5,170,8.0,-115,-105,101,1.5,-200,4.21,Citizens Bank Park,11,3
2018-07-24,2018,ATL,MIA,3,9,-119,-1.5,144,7.5,-120,100,109,1.5,-165,4.08,Marlins Park,12,-6
2018-07-24,2018,WSH,MIL,4,5,120,1.5,-180,9.5,100,-120,-135,-1.5,155,4.32,Miller Park,9,-1
2018-07-24,2018,TOR,MIN,0,5,-101,1.5,-160,8.5,-110,-110,-109,-1.5,140,4.27,Rogers Centre,5,-5
2018-07-24,2018,SD,NYM,3,6,117,1.5,-200,7.5,-105,-115,-127,-1.5,170,3.46,Citi Field,9,-3
2018-07-24,2018,TB,NYY,0,4,163,1.5,105,7.5,-105,-115,-183,-1.5,-125,2.85,Tropicana Field,4,-4
2018-07-24,2018,TEX,OAK,10,13,100,1.5,-170,10.5,-115,-105,-110,-1.5,148,5.25,Rangers Ballpark,23,-3
2018-07-24,2018,LAD,PHI,4,7,101,1.5,-200,8.0,-115,-105,-111,-1.5,170,3.98,Citizens Bank Park,11,-3
2018-07-24,2018,CLE,PIT,4,9,-170,-1.5,110,9.0,-120,100,150,1.5,-130,5.67,Progressive Field,13,-5
2018-07-24,2018,NYM,SD,6,3,-127,-1.5,170,7.5,-105,-115,117,1.5,-200,4.2,Citi Field,9,3
2018-07-24,2018,SF,SEA,4,3,117,1.5,-175,8.5,-120,100,-127,-1.5,151,3.92,T-Mobile Park,7,1
2018-07-24,2018,SEA,SF,3,4,-127,-1.5,151,8.5,-120,100,117,1.5,-175,4.76,T-Mobile Park,7,-1
2018-07-24,2018,CIN,STL,2,4,117,1.5,-145,10.5,-119,-101,-127,-1.5,125,4.84,Great American Ballpark,6,-2
2018-07-24,2018,NYY,TB,4,0,-183,-1.5,-125,7.5,-105,-115,163,1.5,105,4.85,Tropicana Field,4,4
2018-07-24,2018,OAK,TEX,13,10,-110,-1.5,148,10.5,-115,-105,100,1.5,-170,5.5,Rangers Ballpark,23,3
2018-07-24,2018,MIN,TOR,5,0,-109,-1.5,140,8.5,-110,-110,-101,1.5,-160,4.43,Rogers Centre,5,5
2018-07-24,2018,MIL,WSH,5,4,-135,-1.5,155,9.5,100,-120,120,1.5,-180,5.46,Miller Park,9,1
2018-07-25,2018,CHC,ARI,2,1,-103,-1.5,180,8.5,-120,100,-107,1.5,-215,4.31,Wrigley Field,3,1
2018-07-25,2018,ARI,CHC,1,2,-107,1.5,-215,8.5,-120,100,-103,-1.5,180,4.39,Wrigley Field,3,-1
2018-07-25,2018,STL,CIN,3,7,-131,-1.5,125,9.0,-114,-106,116,1.5,-145,5.1,Great American Ballpark,10,-4
2018-07-25,2018,PIT,CLE,0,4,185,1.5,-110,8.0,-105,-115,-215,-1.5,-110,2.81,Progressive Field,4,-4
2018-07-25,2018,HOU,COL,2,3,-116,-1.5,125,9.5,-110,-110,106,1.5,-145,5.1,Coors Field,5,-1
2018-07-25,2018,LAA,CWS,11,3,-237,-1.5,-125,8.5,-105,-115,207,1.5,105,5.98,Angel Stadium,14,8
2018-07-25,2018,KC,DET,4,8,-122,-1.5,166,8.5,-125,105,112,1.5,-195,4.67,Kauffman Stadium,12,-4
2018-07-25,2018,COL,HOU,3,2,106,1.5,-145,9.5,-110,-110,-116,-1.5,125,4.61,Coors Field,5,1
2018-07-25,2018,DET,KC,8,4,112,1.5,-195,8.5,-125,105,-122,-1.5,166,4.01,Kauffman Stadium,12,4
2018-07-25,2018,CWS,LAA,3,11,207,1.5,105,8.5,-105,-115,-237,-1.5,-125,2.77,Angel Stadium,14,-8
2018-07-25,2018,PHI,LAD,7,3,125,1.5,-135,8.5,-110,-110,-140,-1.5,115,3.78,Citizens Bank Park,10,4
2018-07-25,2018,WSH,MIL,7,3,123,1.5,-180,9.5,-115,-105,-138,-1.5,155,4.26,Miller Park,10,4
2018-07-25,2018,TOR,MIN,6,12,104,1.5,-165,9.5,-110,-110,-114,-1.5,144,4.66,Rogers Centre,18,-6
2018-07-25,2018,SD,NYM,4,6,-102,1.5,-215,8.0,-125,105,-108,-1.5,180,4.04,Citi Field,10,-2
2018-07-25,2018,TB,NYY,3,2,129,1.5,-135,8.0,-101,-119,-144,-1.5,115,3.49,Tropicana Field,5,1
2018-07-25,2018,TEX,OAK,5,6,109,1.5,-135,12.0,-115,-105,-119,-1.5,115,5.74,Rangers Ballpark,11,-1
2018-07-25,2018,LAD,PHI,3,7,-140,-1.5,115,8.5,-110,-110,125,1.5,-135,4.96,Citizens Bank Park,10,-4
2018-07-25,2018,CLE,PIT,4,0,-215,-1.5,-110,8.0,-105,-115,185,1.5,-110,5.46,Progressive Field,4,4
2018-07-25,2018,NYM,SD,6,4,-108,-1.5,180,8.0,-125,105,-102,1.5,-215,4.15,Citi Field,10,2
2018-07-25,2018,SF,SEA,2,3,130,1.5,-160,8.5,-120,100,-145,-1.5,140,3.7,T-Mobile Park,5,-1
2018-07-25,2018,SEA,SF,3,2,-145,-1.5,140,8.5,-120,100,130,1.5,-160,5.03,T-Mobile Park,5,1
2018-07-25,2018,CIN,STL,7,3,116,1.5,-145,9.0,-114,-106,-131,-1.5,125,4.17,Great American Ballpark,10,4
2018-07-25,2018,NYY,TB,2,3,-144,-1.5,115,8.0,-101,-119,129,1.5,-135,4.72,Tropicana Field,5,-1
2018-07-25,2018,OAK,TEX,6,5,-119,-1.5,115,12.0,-115,-105,109,1.5,-135,6.52,Rangers Ballpark,11,1
2018-07-25,2018,MIN,TOR,12,6,-114,-1.5,144,9.5,-110,-110,104,1.5,-165,5.06,Rogers Centre,18,6
2018-07-25,2018,MIL,WSH,3,7,-138,-1.5,155,9.5,-115,-105,123,1.5,-180,5.51,Miller Park,10,-4
2018-07-26,2018,CHC,ARI,7,6,-101,1.5,-170,9.5,105,-125,-109,-1.5,148,4.77,Wrigley Field,13,1
2018-07-26,2018,LAD,ATL,8,2,-131,-1.5,130,9.0,-105,-115,116,1.5,-150,5.1,Suntrust Park,10,6
2018-07-26,2018,TB,BAL,4,3,-137,-1.5,125,8.5,-105,-115,122,1.5,-145,4.91,Camden Yards,7,1
2018-07-26,2018,MIN,BOS,2,1,150,1.5,-115,10.0,-110,-110,-170,-1.5,-105,4.0,Fenway Park,3,1
2018-07-26,2018,ARI,CHC,6,7,-109,-1.5,148,9.5,105,-125,-101,1.5,-170,4.95,Wrigley Field,13,-1
2018-07-26,2018,PHI,CIN,9,4,123,1.5,-180,9.5,-110,-110,-138,-1.5,155,4.26,Great American Ballpark,13,5
2018-07-26,2018,LAA,CWS,12,8,-182,-1.5,105,9.5,-101,-119,162,1.5,-125,6.13,Angel Stadium,20,4
2018-07-26,2018,NYY,KC,7,2,-285,-1.5,-155,9.5,-112,-108,245,1.5,135,7.03,Yankee Stadium,9,5
2018-07-26,2018,CWS,LAA,8,12,162,1.5,-125,9.5,-101,-119,-182,-1.5,105,3.63,Angel Stadium,20,-4
2018-07-26,2018,ATL,LAD,2,8,116,1.5,-150,9.0,-105,-115,-131,-1.5,130,4.17,Suntrust Park,10,-6
2018-07-26,2018,WSH,MIA,10,3,-141,-1.5,115,8.5,-115,-105,126,1.5,-135,4.97,Marlins Park,13,7
2018-07-26,2018,SF,MIL,5,7,-117,-1.5,176,7.5,-110,-110,107,1.5,-210,4.04,AT&T Park,12,-2
2018-07-26,2018,BOS,MIN,1,2,-170,-1.5,-105,10.0,-110,-110,150,1.5,-115,6.3,Fenway Park,3,-1
2018-07-26,2018,PIT,NYM,6,12,-143,-1.5,144,8.5,-112,-108,128,1.5,-165,5.0,PNC Park,18,-6
2018-07-26,2018,KC,NYY,2,7,245,1.5,135,9.5,-112,-108,-285,-1.5,-155,2.75,Yankee Stadium,9,-5
2018-07-26,2018,TEX,OAK,6,7,131,1.5,-115,11.0,100,-120,-146,-1.5,-105,4.76,Rangers Ballpark,13,-1
2018-07-26,2018,CIN,PHI,4,9,-138,-1.5,155,9.5,-110,-110,123,1.5,-180,5.51,Great American Ballpark,13,-5
2018-07-26,2018,NYM,PIT,12,6,128,1.5,-165,8.5,-112,-108,-143,-1.5,144,3.73,PNC Park,18,6
2018-07-26,2018,MIL,SF,7,5,107,1.5,-210,7.5,-110,-110,-117,-1.5,176,3.62,AT&T Park,12,2
2018-07-26,2018,BAL,TB,3,4,122,1.5,-145,8.5,-105,-115,-137,-1.5,125,3.83,Camden Yards,7,-1
2018-07-26,2018,OAK,TEX,7,6,-146,-1.5,-105,11.0,100,-120,131,1.5,-115,6.53,Rangers Ballpark,13,1
2018-07-26,2018,MIA,WSH,3,10,126,1.5,-135,8.5,-115,-105,-141,-1.5,115,3.76,Marlins Park,13,-7
2018-07-27,2018,SD,ARI,2,6,163,1.5,103,7.5,121,-141,-183,-1.5,-123,2.85,PETCO Park,8,-4
2018-07-27,2018,LAD,ATL,4,1,-157,-1.5,100,8.0,-122,102,142,1.5,-120,4.89,Suntrust Park,5,3
2018-07-27,2018,TB,BAL,5,15,-160,-1.5,-105,8.0,-110,-110,145,1.5,-115,4.92,Camden Yards,20,-10
2018-07-27,2018,MIN,BOS,3,4,330,1.5,155,9.0,-110,-110,-390,-1.5,-180,2.09,Fenway Park,7,-1
2018-07-27,2018,STL,CHC,5,2,-128,-1.5,163,9.0,-115,-105,118,1.5,-190,5.05,Busch Stadium,7,3
2018-07-27,2018,PHI,CIN,4,6,-112,-1.5,135,8.5,-110,-110,102,1.5,-155,4.49,Great American Ballpark,10,-2
2018-07-27,2018,DET,CLE,3,8,220,1.5,140,8.5,-115,-105,-260,-1.5,-160,2.66,Comerica Park,11,-5
2018-07-27,2018,OAK,COL,1,3,103,1.5,-190,11.5,100,-120,-113,-1.5,163,5.67,Coors Field,4,-2
2018-07-27,2018,TOR,CWS,10,5,-122,-1.5,135,9.0,-115,-105,112,1.5,-155,4.95,Guaranteed Rate Field,15,5
2018-07-27,2018,CLE,DET,8,3,-260,-1.5,-160,8.5,-115,-105,220,1.5,140,6.14,Comerica Park,11,5
2018-07-27,2018,TEX,HOU,11,2,230,1.5,115,8.5,-115,-105,-270,-1.5,-135,2.58,Minute Maid Park,13,9
2018-07-27,2018,SEA,LAA,3,4,125,1.5,-165,9.0,-105,-115,-140,-1.5,144,4.0,Angel Stadium,7,-1
2018-07-27,2018,ATL,LAD,1,4,142,1.5,-120,8.0,-122,102,-157,-1.5,100,3.31,Suntrust Park,5,-3
2018-07-27,2018,WSH,MIA,9,1,-235,-1.5,-135,7.5,-125,105,205,1.5,115,5.26,Marlins Park,10,8
2018-07-27,2018,SF,MIL,1,3,-131,-1.5,163,7.0,-115,-105,116,1.5,-190,3.97,AT&T Park,4,-2
2018-07-27,2018,BOS,MIN,4,3,-390,-1.5,-180,9.0,-110,-110,330,1.5,155,7.16,Fenway Park,7,1
2018-07-27,2018,PIT,NYM,5,4,-135,-1.5,151,9.0,100,-120,120,1.5,-175,5.17,PNC Park,9,1
2018-07-27,2018,COL,OAK,3,1,-113,-1.5,163,11.5,100,-120,103,1.5,-190,6.1,Coors Field,4,2
2018-07-27,2018,CIN,PHI,6,4,102,1.5,-155,8.5,-110,-110,-112,-1.5,135,4.21,Great American Ballpark,10,2
2018-07-27,2018,NYM,PIT,4,5,120,1.5,-175,9.0,100,-120,-135,-1.5,151,4.09,PNC Park,9,-1
2018-07-27,2018,ARI,SD,6,2,-183,-1.5,-123,7.5,121,-141,163,1.5,103,4.85,PETCO Park,8,4
2018-07-27,2018,LAA,SEA,4,3,-140,-1.5,144,9.0,-105,-115,125,1.5,-165,5.25,Angel Stadium,7,1
2018-07-27,2018,MIL,SF,3,1,116,1.5,-190,7.0,-115,-105,-131,-1.5,163,3.24,AT&T Park,4,2
2018-07-27,2018,CHC,STL,2,5,118,1.5,-190,9.0,-115,-105,-128,-1.5,163,4.13,Busch Stadium,7,-3
2018-07-27,2018,BAL,TB,15,5,145,1.5,-115,8.0,-110,-110,-160,-1.5,-105,3.27,Camden Yards,20,10
2018-07-27,2018,HOU,TEX,2,11,-270,-1.5,-135,8.5,-115,-105,230,1.5,115,6.2,Minute Maid Park,13,-9
2018-07-27,2018,CWS,TOR,5,10,112,1.5,-155,9.0,-115,-105,-122,-1.5,135,4.25,Guaranteed Rate Field,15,-5
2018-07-27,2018,MIA,WSH,1,9,205,1.5,115,7.5,-125,105,-235,-1.5,-135,2.46,Marlins Park,10,-8
2018-07-28,2018,SD,ARI,4,9,150,1.5,-115,7.5,-125,105,-165,-1.5,-105,3.0,PETCO Park,13,-5
2018-07-28,2018,LAD,ATL,5,1,-128,-1.5,125,8.5,-115,-105,118,1.5,-145,4.77,Suntrust Park,6,4
2018-07-28,2018,TB,BAL,2,11,-115,-1.5,135,8.5,-110,-110,105,1.5,-155,4.55,Camden Yards,13,-9
2018-07-28,2018,MIN,BOS,4,10,178,1.5,-109,10.0,-123,103,-198,-1.5,-111,3.6,Fenway Park,14,-6
2018-07-28,2018,STL,CHC,6,2,-127,-1.5,163,9.0,-105,-115,117,1.5,-190,5.04,Busch Stadium,8,4
2018-07-28,2018,PHI,CIN,2,6,-129,-1.5,120,9.5,-111,-109,119,1.5,-140,5.35,Great American Ballpark,8,-4
2018-07-28,2018,DET,CLE,2,1,171,1.5,-105,8.5,-114,-106,-191,-1.5,-115,3.14,Comerica Park,3,1
2018-07-28,2018,OAK,COL,1,4,107,1.5,-180,11.0,-120,100,-117,-1.5,155,5.31,Coors Field,5,-3
2018-07-28,2018,TOR,CWS,5,9,-151,-1.5,112,9.5,-115,-105,136,1.5,-134,5.72,Guaranteed Rate Field,14,-4
2018-07-28,2018,CLE,DET,1,2,-191,-1.5,-115,8.5,-114,-106,171,1.5,-105,5.58,Comerica Park,3,-1
2018-07-28,2018,TEX,HOU,7,3,250,1.5,140,8.5,-110,-110,-300,-1.5,-160,2.43,Minute Maid Park,10,4
2018-07-28,2018,NYY,KC,5,10,-415,-1.5,-185,8.5,100,-120,335,1.5,160,6.85,Yankee Stadium,15,-5
2018-07-28,2018,NYY,KC,5,4,-325,-1.5,-157,9.5,105,-125,275,1.5,137,7.26,Yankee Stadium,9,1
2018-07-28,2018,SEA,LAA,5,11,113,1.5,-180,9.0,-125,105,-123,-1.5,155,4.23,Angel Stadium,16,-6
2018-07-28,2018,ATL,LAD,1,5,118,1.5,-145,8.5,-115,-105,-128,-1.5,125,3.9,Suntrust Park,6,-4
2018-07-28,2018,WSH,MIA,1,2,-157,-1.5,102,8.5,-105,-115,142,1.5,-122,5.19,Marlins Park,3,-1
2018-07-28,2018,SF,MIL,1,7,109,1.5,-160,7.5,-124,104,-119,-1.5,140,3.59,AT&T Park,8,-6
2018-07-28,2018,BOS,MIN,10,4,-198,-1.5,-111,10.0,-123,103,178,1.5,-109,6.64,Fenway Park,14,6
2018-07-28,2018,PIT,NYM,5,0,119,1.5,-154,7.5,-105,-115,-129,-1.5,134,3.42,PNC Park,5,5
2018-07-28,2018,KC,NYY,10,5,335,1.5,160,8.5,100,-120,-415,-1.5,-185,1.95,Yankee Stadium,15,5
2018-07-28,2018,KC,NYY,4,5,275,1.5,137,9.5,105,-125,-325,-1.5,-157,2.53,Yankee Stadium,9,-1
2018-07-28,2018,COL,OAK,4,1,-117,-1.5,155,11.0,-120,100,107,1.5,-180,5.93,Coors Field,5,3
2018-07-28,2018,CIN,PHI,6,2,119,1.5,-140,9.5,-111,-109,-129,-1.5,120,4.34,Great American Ballpark,8,4
2018-07-28,2018,NYM,PIT,0,5,-129,-1.5,134,7.5,-105,-115,119,1.5,-154,4.22,PNC Park,5,-5
2018-07-28,2018,ARI,SD,9,4,-165,-1.5,-105,7.5,-125,105,150,1.5,-115,4.67,PETCO Park,13,5
2018-07-28,2018,LAA,SEA,11,5,-123,-1.5,155,9.0,-125,105,113,1.5,-180,4.96,Angel Stadium,16,6
2018-07-28,2018,MIL,SF,7,1,-119,-1.5,140,7.5,-124,104,109,1.5,-160,4.08,AT&T Park,8,6
2018-07-28,2018,CHC,STL,2,6,117,1.5,-190,9.0,-105,-115,-127,-1.5,163,4.15,Busch Stadium,8,-4
2018-07-28,2018,BAL,TB,11,2,105,1.5,-155,8.5,-110,-110,-115,-1.5,135,4.15,Camden Yards,13,9
2018-07-28,2018,HOU,TEX,3,7,-300,-1.5,-160,8.5,-110,-110,250,1.5,140,6.38,Minute Maid Park,10,-4
2018-07-28,2018,CWS,TOR,9,5,136,1.5,-134,9.5,-115,-105,-151,-1.5,112,4.03,Guaranteed Rate Field,14,4
2018-07-28,2018,MIA,WSH,2,1,142,1.5,-122,8.5,-105,-115,-157,-1.5,102,3.51,Marlins Park,3,1
2018-07-29,2018,SD,ARI,4,5,107,1.5,-160,8.0,-118,-102,-117,-1.5,140,3.86,PETCO Park,9,-1
2018-07-29,2018,LAD,ATL,1,4,-160,-1.5,115,8.5,-122,102,145,1.5,-135,5.23,Suntrust Park,5,-3
2018-07-29,2018,TB,BAL,5,11,-114,-1.5,135,8.5,-115,-105,104,1.5,-155,4.53,Camden Yards,16,-6
2018-07-29,2018,MIN,BOS,0,3,151,1.5,-135,9.5,-104,-116,-166,-1.5,115,3.78,Fenway Park,3,-3
2018-07-29,2018,STL,CHC,2,5,111,1.5,-152,8.5,-119,-101,-121,-1.5,132,4.03,Busch Stadium,7,-3
2018-07-29,2018,PHI,CIN,0,4,106,1.5,-205,9.0,-110,-110,-116,-1.5,172,4.37,Great American Ballpark,4,-4
2018-07-29,2018,DET,CLE,1,8,205,1.5,117,8.5,-117,-103,-235,-1.5,-134,2.79,Comerica Park,9,-7
2018-07-29,2018,OAK,COL,2,3,129,1.5,-150,11.5,-108,-112,-144,-1.5,130,5.02,Coors Field,5,-1
2018-07-29,2018,TOR,CWS,7,4,112,1.5,-185,9.0,-110,-110,-122,-1.5,160,4.25,Guaranteed Rate Field,11,3
2018-07-29,2018,CLE,DET,8,1,-235,-1.5,-134,8.5,-117,-103,205,1.5,117,5.96,Comerica Park,9,7
2018-07-29,2018,TEX,HOU,4,3,177,1.5,-110,8.5,105,-125,-207,-1.5,-110,3.07,Minute Maid Park,7,1
2018-07-29,2018,NYY,KC,6,3,-320,-1.5,-163,9.0,-110,-110,270,1.5,143,6.86,Yankee Stadium,9,3
2018-07-29,2018,SEA,LAA,8,5,104,1.5,-195,9.0,-110,-110,-114,-1.5,166,4.41,Angel Stadium,13,3
2018-07-29,2018,ATL,LAD,4,1,145,1.5,-135,8.5,-122,102,-160,-1.5,115,3.47,Suntrust Park,5,3
2018-07-29,2018,WSH,MIA,0,5,-144,-1.5,105,8.5,-105,-115,129,1.5,-125,5.02,Marlins Park,5,-5
2018-07-29,2018,SF,MIL,8,5,-103,1.5,-170,7.5,100,-120,-107,-1.5,148,3.81,AT&T Park,13,3
2018-07-29,2018,BOS,MIN,3,0,-166,-1.5,115,9.5,-104,-116,151,1.5,-135,5.93,Fenway Park,3,3
2018-07-29,2018,PIT,NYM,0,1,-164,-1.5,120,7.5,-126,106,149,1.5,-140,4.66,PNC Park,1,-1
2018-07-29,2018,KC,NYY,3,6,270,1.5,143,9.0,-110,-110,-320,-1.5,-163,2.43,Yankee Stadium,9,-3
2018-07-29,2018,COL,OAK,3,2,-144,-1.5,130,11.5,-108,-112,129,1.5,-150,6.79,Coors Field,5,1
2018-07-29,2018,CIN,PHI,4,0,-116,-1.5,172,9.0,-110,-110,106,1.5,-205,4.83,Great American Ballpark,4,4
2018-07-29,2018,NYM,PIT,1,0,149,1.5,-140,7.5,-126,106,-164,-1.5,120,3.01,PNC Park,1,1
2018-07-29,2018,ARI,SD,5,4,-117,-1.5,140,8.0,-118,-102,107,1.5,-160,4.31,PETCO Park,9,1
2018-07-29,2018,LAA,SEA,5,8,-114,-1.5,166,9.0,-110,-110,104,1.5,-195,4.79,Angel Stadium,13,-3
2018-07-29,2018,MIL,SF,5,8,-107,-1.5,148,7.5,100,-120,-103,1.5,-170,3.88,AT&T Park,13,-3
2018-07-29,2018,CHC,STL,5,2,-121,-1.5,132,8.5,-119,-101,111,1.5,-152,4.65,Busch Stadium,7,3
2018-07-29,2018,BAL,TB,11,5,104,1.5,-155,8.5,-115,-105,-114,-1.5,135,4.17,Camden Yards,16,6
2018-07-29,2018,HOU,TEX,3,4,-207,-1.5,-110,8.5,105,-125,177,1.5,-110,5.73,Minute Maid Park,7,-1
2018-07-29,2018,CWS,TOR,4,7,-122,-1.5,160,9.0,-110,-110,112,1.5,-185,4.95,Guaranteed Rate Field,11,-3
2018-07-29,2018,MIA,WSH,5,0,129,1.5,-125,8.5,-105,-115,-144,-1.5,105,3.71,Marlins Park,5,5
2018-07-30,2018,TEX,ARI,9,5,173,1.5,-115,8.5,-117,-103,-203,-1.5,-105,3.11,Chase Field,14,4
2018-07-30,2018,MIA,ATL,3,5,152,1.5,-134,9.0,102,-122,-172,-1.5,114,3.57,Suntrust Park,8,-2
2018-07-30,2018,PHI,BOS,1,2,136,1.5,-155,9.0,-112,-108,-151,-1.5,135,3.81,Fenway Park,3,-1
2018-07-30,2018,MIN,CLE,5,4,129,1.5,-125,10.5,-109,-111,-144,-1.5,105,4.59,Target Field,9,1
2018-07-30,2018,STL,COL,5,4,-131,-1.5,163,7.5,100,-120,116,1.5,-190,4.25,Busch Stadium,9,1
2018-07-30,2018,SEA,HOU,2,0,-101,1.5,-170,7.0,-113,-107,-109,-1.5,148,3.52,T-Mobile Park,2,2
2018-07-30,2018,MIL,LAD,5,2,135,1.5,-160,7.5,-115,-105,-150,-1.5,140,3.19,Dodger Stadium,7,3
2018-07-30,2018,ATL,MIA,5,3,-172,-1.5,114,9.0,102,-122,152,1.5,-134,5.69,Suntrust Park,8,2
2018-07-30,2018,LAD,MIL,2,5,-150,-1.5,140,7.5,-115,-105,135,1.5,-160,4.5,Dodger Stadium,7,-3
2018-07-30,2018,CLE,MIN,4,5,-144,-1.5,105,10.5,-109,-111,129,1.5,-125,6.2,Target Field,9,-1
2018-07-30,2018,TOR,OAK,1,10,121,1.5,-165,8.5,-120,100,-136,-1.5,144,3.85,Oakland Coliseum,11,-9
2018-07-30,2018,BOS,PHI,2,1,-151,-1.5,135,9.0,-112,-108,136,1.5,-155,5.41,Fenway Park,3,1
2018-07-30,2018,SF,SD,5,3,103,1.5,-200,8.0,-110,-110,-113,-1.5,170,3.94,PETCO Park,8,2
2018-07-30,2018,HOU,SEA,0,2,-109,-1.5,148,7.0,-113,-107,-101,1.5,-170,3.65,T-Mobile Park,2,-2
2018-07-30,2018,SD,SF,3,5,-113,-1.5,170,8.0,-110,-110,103,1.5,-200,4.24,PETCO Park,8,-2
2018-07-30,2018,COL,STL,4,5,116,1.5,-190,7.5,100,-120,-131,-1.5,163,3.47,Busch Stadium,9,-1
2018-07-30,2018,ARI,TEX,5,9,-203,-1.5,-105,8.5,-117,-103,173,1.5,-115,5.69,Chase Field,14,-4
2018-07-30,2018,OAK,TOR,10,1,-136,-1.5,144,8.5,-120,100,121,1.5,-165,4.9,Oakland Coliseum,11,9
2018-07-31,2018,TEX,ARI,0,6,154,1.5,-135,9.0,-105,-115,-174,-1.5,115,3.54,Chase Field,6,-6
2018-07-31,2018,MIA,ATL,6,11,152,1.5,-130,8.5,-115,-105,-172,-1.5,110,3.37,Suntrust Park,17,-5
2018-07-31,2018,NYY,BAL,6,3,-295,-1.5,-140,8.5,-115,-105,255,1.5,120,6.35,Yankee Stadium,9,3
2018-07-31,2018,PHI,BOS,3,1,130,1.5,-149,10.0,-118,-102,-145,-1.5,129,4.35,Fenway Park,4,2
2018-07-31,2018,PIT,CHC,5,4,-121,-1.5,180,7.5,-117,-103,111,1.5,-215,4.11,PNC Park,9,1
2018-07-31,2018,DET,CIN,2,1,-105,-1.5,180,9.0,-107,-113,-105,1.5,-215,4.61,Comerica Park,3,1
2018-07-31,2018,MIN,CLE,2,6,141,1.5,-119,8.5,-105,-115,-156,-1.5,-101,3.53,Target Field,8,-4
2018-07-31,2018,STL,COL,3,6,-117,-1.5,184,7.0,-115,-105,107,1.5,-220,3.77,Busch Stadium,9,-3
2018-07-31,2018,KC,CWS,4,2,108,1.5,-190,9.0,110,-130,-118,-1.5,163,4.33,Guaranteed Rate Field,6,2
2018-07-31,2018,CIN,DET,1,2,-105,1.5,-215,9.0,-107,-113,-105,-1.5,180,4.61,Comerica Park,3,-1
2018-07-31,2018,SEA,HOU,2,5,151,1.5,-115,8.0,-115,-105,-166,-1.5,-105,3.19,T-Mobile Park,7,-3
2018-07-31,2018,CWS,KC,2,4,-118,-1.5,163,9.0,110,-130,108,1.5,-190,4.87,Guaranteed Rate Field,6,-2
2018-07-31,2018,TB,LAA,10,6,100,1.5,-168,7.5,110,-130,-110,-1.5,146,3.75,Tropicana Field,16,4
2018-07-31,2018,MIL,LAD,1,0,149,1.5,-149,8.5,-108,-112,-164,-1.5,129,3.41,Dodger Stadium,1,1
2018-07-31,2018,ATL,MIA,11,6,-172,-1.5,110,8.5,-115,-105,152,1.5,-130,5.38,Suntrust Park,17,5
2018-07-31,2018,LAD,MIL,0,1,-164,-1.5,129,8.5,-108,-112,149,1.5,-149,5.28,Dodger Stadium,1,-1
2018-07-31,2018,CLE,MIN,6,2,-156,-1.5,-101,8.5,-105,-115,141,1.5,-119,5.18,Target Field,8,4
2018-07-31,2018,WSH,NYM,25,4,-181,-1.5,115,9.0,-115,-105,161,1.5,-135,5.8,Nationals Park,29,21
2018-07-31,2018,BAL,NYY,3,6,255,1.5,120,8.5,-115,-105,-295,-1.5,-140,2.39,Yankee Stadium,9,-3
2018-07-31,2018,TOR,OAK,2,6,157,1.5,-130,8.5,103,-123,-177,-1.5,110,3.31,Oakland Coliseum,8,-4
2018-07-31,2018,BOS,PHI,1,3,-145,-1.5,129,10.0,-118,-102,130,1.5,-149,5.92,Fenway Park,4,-2
2018-07-31,2018,CHC,PIT,4,5,111,1.5,-215,7.5,-117,-103,-121,-1.5,180,3.55,PNC Park,9,-1
2018-07-31,2018,SF,SD,3,2,105,-1.5,155,8.0,-119,-101,-115,1.5,-180,3.9,PETCO Park,5,1
2018-07-31,2018,HOU,SEA,5,2,-166,-1.5,-105,8.0,-115,-105,151,1.5,-115,4.99,T-Mobile Park,7,3
2018-07-31,2018,SD,SF,2,3,-115,1.5,-180,8.0,-119,-101,105,-1.5,155,4.28,PETCO Park,5,-1
2018-07-31,2018,COL,STL,6,3,107,1.5,-220,7.0,-115,-105,-117,-1.5,184,3.38,Busch Stadium,9,3
2018-07-31,2018,LAA,TB,6,10,-110,-1.5,146,7.5,110,-130,100,1.5,-168,3.93,Tropicana Field,16,-4
2018-07-31,2018,ARI,TEX,6,0,-174,-1.5,115,9.0,-105,-115,154,1.5,-135,5.72,Chase Field,6,6
2018-07-31,2018,OAK,TOR,6,2,-177,-1.5,110,8.5,103,-123,157,1.5,-130,5.43,Oakland Coliseum,8,4
2018-07-31,2018,NYM,WSH,4,25,161,1.5,-135,9.0,-115,-105,-181,-1.5,115,3.45,Nationals Park,29,-21
2018-08-01,2018,NYY,BAL,5,7,-280,-1.5,-150,9.0,-115,-105,240,1.5,130,6.63,Yankee Stadium,12,-2
2018-08-01,2018,PIT,CHC,2,9,117,1.5,-140,8.5,-104,-116,-132,-1.5,120,3.92,PNC Park,11,-7
2018-08-01,2018,DET,CIN,7,4,111,1.5,-155,9.0,-105,-115,-121,-1.5,135,4.27,Comerica Park,11,3
2018-08-01,2018,MIN,CLE,0,2,158,1.5,101,9.0,-124,104,-178,-1.5,-121,3.49,Target Field,2,-2
2018-08-01,2018,STL,COL,6,3,-145,-1.5,144,8.5,-101,-119,130,1.5,-165,5.03,Busch Stadium,9,3
2018-08-01,2018,KC,CWS,10,5,117,1.5,-170,9.0,-110,-110,-132,-1.5,148,4.15,Guaranteed Rate Field,15,5
2018-08-01,2018,CIN,DET,4,7,-121,-1.5,135,9.0,-105,-115,111,1.5,-155,4.93,Comerica Park,11,-3
2018-08-01,2018,SEA,HOU,3,8,-101,1.5,-168,7.5,-110,-110,-109,-1.5,146,3.77,T-Mobile Park,11,-5
2018-08-01,2018,CWS,KC,5,10,-132,-1.5,148,9.0,-110,-110,117,1.5,-170,5.12,Guaranteed Rate Field,15,-5
2018-08-01,2018,TB,LAA,7,2,-134,-1.5,160,7.5,-110,-110,119,1.5,-185,4.29,Tropicana Field,9,5
2018-08-01,2018,MIL,LAD,4,6,160,1.5,-137,8.0,-122,102,-180,-1.5,117,3.08,Dodger Stadium,10,-2
2018-08-01,2018,LAD,MIL,6,4,-180,-1.5,117,8.0,-122,102,160,1.5,-137,5.14,Dodger Stadium,10,2
2018-08-01,2018,CLE,MIN,2,0,-178,-1.5,-121,9.0,-124,104,158,1.5,101,5.76,Target Field,2,2
2018-08-01,2018,WSH,NYM,5,3,-119,-1.5,172,9.0,-120,100,109,1.5,-205,4.89,Nationals Park,8,2
2018-08-01,2018,BAL,NYY,7,5,240,1.5,130,9.0,-115,-105,-280,-1.5,-150,2.65,Yankee Stadium,12,2
2018-08-01,2018,TOR,OAK,3,8,116,1.5,-200,8.0,-106,-114,-131,-1.5,170,3.7,Oakland Coliseum,11,-5
2018-08-01,2018,CHC,PIT,9,2,-132,-1.5,120,8.5,-104,-116,117,1.5,-140,4.84,PNC Park,11,7
2018-08-01,2018,HOU,SEA,8,3,-109,-1.5,146,7.5,-110,-110,-101,1.5,-168,3.91,T-Mobile Park,11,5
2018-08-01,2018,COL,STL,3,6,130,1.5,-165,8.5,-101,-119,-145,-1.5,144,3.7,Busch Stadium,9,-3
2018-08-01,2018,LAA,TB,2,7,119,1.5,-185,7.5,-110,-110,-134,-1.5,160,3.42,Tropicana Field,9,-5
2018-08-01,2018,OAK,TOR,8,3,-131,-1.5,170,8.0,-106,-114,116,1.5,-200,4.54,Oakland Coliseum,11,5
2018-08-01,2018,NYM,WSH,3,5,109,1.5,-205,9.0,-120,100,-119,-1.5,172,4.31,Nationals Park,8,-2
2018-08-02,2018,SF,ARI,8,1,160,1.5,-140,7.5,105,-125,-180,-1.5,120,2.88,Chase Field,9,7
2018-08-02,2018,NYM,ATL,2,4,145,1.5,-110,8.5,100,-120,-160,-1.5,-110,3.47,Citi Field,6,-2
2018-08-02,2018,TEX,BAL,17,8,-142,-1.5,142,11.0,-115,-105,127,1.5,-164,6.45,Rangers Ballpark,25,9
2018-08-02,2018,NYY,BOS,7,15,-105,1.5,-215,10.5,100,-120,-105,-1.5,180,5.38,Fenway Park,22,-8
2018-08-02,2018,SD,CHC,6,1,143,1.5,-150,8.5,-110,-110,-158,-1.5,130,3.5,Wrigley Field,7,5
2018-08-02,2018,WSH,CIN,10,4,-290,-1.5,-148,8.5,-122,102,250,1.5,128,6.32,Nationals Park,14,6
2018-08-02,2018,STL,COL,3,2,-138,-1.5,148,8.5,-110,-110,123,1.5,-170,4.93,Busch Stadium,5,1
2018-08-02,2018,KC,CWS,4,6,133,1.5,-162,9.5,-110,-110,-148,-1.5,142,4.08,Guaranteed Rate Field,10,-2
2018-08-02,2018,CWS,KC,6,4,-148,-1.5,142,9.5,-110,-110,133,1.5,-162,5.67,Guaranteed Rate Field,10,2
2018-08-02,2018,TB,LAA,4,2,-137,-1.5,160,7.5,-115,-105,122,1.5,-185,4.34,Tropicana Field,6,2
2018-08-02,2018,MIL,LAD,5,21,181,1.5,-130,7.5,-115,-105,-211,-1.5,110,2.67,Dodger Stadium,26,-16
2018-08-02,2018,PHI,MIA,5,2,-187,-1.5,105,9.0,100,-120,167,1.5,-125,5.86,Citizens Bank Park,7,3
2018-08-02,2018,LAD,MIL,21,5,-211,-1.5,110,7.5,-115,-105,181,1.5,-130,5.09,Dodger Stadium,26,16
2018-08-02,2018,ATL,NYM,4,2,-160,-1.5,-110,8.5,100,-120,145,1.5,-110,5.23,Citi Field,6,2
2018-08-02,2018,BOS,NYY,15,7,-105,-1.5,180,10.5,100,-120,-105,1.5,-215,5.38,Fenway Park,22,8
2018-08-02,2018,MIA,PHI,2,5,167,1.5,-125,9.0,100,-120,-187,-1.5,105,3.37,Citizens Bank Park,7,-3
2018-08-02,2018,CHC,SD,1,6,-158,-1.5,130,8.5,-110,-110,143,1.5,-150,5.21,Wrigley Field,7,-5
2018-08-02,2018,TOR,SEA,7,3,135,1.5,-160,8.5,-105,-115,-150,-1.5,140,3.62,T-Mobile Park,10,4
2018-08-02,2018,ARI,SF,1,8,-180,-1.5,120,7.5,105,-125,160,1.5,-140,4.82,Chase Field,9,-7
2018-08-02,2018,COL,STL,2,3,123,1.5,-170,8.5,-110,-110,-138,-1.5,148,3.81,Busch Stadium,5,-1
2018-08-02,2018,LAA,TB,2,4,122,1.5,-185,7.5,-115,-105,-137,-1.5,160,3.38,Tropicana Field,6,-2
2018-08-02,2018,BAL,TEX,8,17,127,1.5,-164,11.0,-115,-105,-142,-1.5,142,4.85,Rangers Ballpark,25,-9
2018-08-02,2018,SEA,TOR,3,7,-150,-1.5,140,8.5,-105,-115,135,1.5,-160,5.1,T-Mobile Park,10,-4
2018-08-02,2018,CIN,WSH,4,10,250,1.5,128,8.5,-122,102,-290,-1.5,-148,2.43,Nationals Park,14,-6
2018-08-03,2018,SF,ARI,3,6,180,1.5,-109,8.0,-112,-108,-210,-1.5,-111,2.86,Chase Field,9,-3
2018-08-03,2018,NYM,ATL,1,2,-157,-1.5,148,7.0,-107,-113,142,1.5,-170,4.28,Citi Field,3,-1
2018-08-03,2018,TEX,BAL,11,3,-163,-1.5,110,11.5,-119,-101,148,1.5,-130,7.13,Rangers Ballpark,14,8
2018-08-03,2018,NYY,BOS,1,4,-127,-1.5,131,9.0,-112,-108,117,1.5,-152,5.04,Fenway Park,5,-3
2018-08-03,2018,SD,CHC,4,5,193,1.5,100,9.0,-108,-112,-223,-1.5,-120,3.07,Wrigley Field,9,-1
2018-08-03,2018,LAA,CLE,7,4,220,1.5,111,9.0,-115,-105,-260,-1.5,-131,2.81,Progressive Field,11,3
2018-08-03,2018,MIL,COL,5,3,-128,-1.5,160,9.0,101,-121,118,1.5,-185,5.05,Miller Park,8,2
2018-08-03,2018,TB,CWS,2,3,-201,-1.5,-111,8.5,-110,-110,171,1.5,-109,5.68,Tropicana Field,5,-1
2018-08-03,2018,OAK,DET,1,0,-191,-1.5,105,9.0,105,-125,171,1.5,-125,5.91,Oakland Coliseum,1,1
2018-08-03,2018,LAD,HOU,1,2,-101,-1.5,192,7.5,102,-122,-109,1.5,-230,3.77,Dodger Stadium,3,-1
2018-08-03,2018,MIN,KC,6,4,-205,-1.5,-110,9.5,-105,-115,175,1.5,-110,6.39,Target Field,10,2
2018-08-03,2018,CLE,LAA,4,7,-260,-1.5,-131,9.0,-115,-105,220,1.5,111,6.5,Progressive Field,11,-3
2018-08-03,2018,HOU,LAD,2,1,-109,1.5,-230,7.5,102,-122,-101,-1.5,192,3.91,Dodger Stadium,3,1
2018-08-03,2018,PHI,MIA,5,1,-179,-1.5,120,8.5,-110,-110,159,1.5,-140,5.45,Citizens Bank Park,6,4
2018-08-03,2018,COL,MIL,3,5,118,1.5,-185,9.0,101,-121,-128,-1.5,160,4.13,Miller Park,8,-2
2018-08-03,2018,KC,MIN,4,6,175,1.5,-110,9.5,-105,-115,-205,-1.5,-110,3.45,Target Field,10,-2
2018-08-03,2018,ATL,NYM,2,1,142,1.5,-170,7.0,-107,-113,-157,-1.5,148,2.89,Citi Field,3,1
2018-08-03,2018,BOS,NYY,4,1,117,1.5,-152,9.0,-112,-108,-127,-1.5,131,4.15,Fenway Park,5,3
2018-08-03,2018,DET,OAK,0,1,171,1.5,-125,9.0,105,-125,-191,-1.5,105,3.32,Oakland Coliseum,1,-1
2018-08-03,2018,MIA,PHI,1,5,159,1.5,-140,8.5,-110,-110,-179,-1.5,120,3.28,Citizens Bank Park,6,-4
2018-08-03,2018,STL,PIT,6,7,142,1.5,-165,8.5,101,-121,-157,-1.5,144,3.51,PNC Park,13,-1
2018-08-03,2018,CHC,SD,5,4,-223,-1.5,-120,9.0,-108,-112,193,1.5,100,6.21,Wrigley Field,9,1
2018-08-03,2018,TOR,SEA,7,2,150,1.5,-130,8.0,-110,-110,-165,-1.5,111,3.2,T-Mobile Park,9,5
2018-08-03,2018,ARI,SF,6,3,-210,-1.5,-111,8.0,-112,-108,180,1.5,-109,5.42,Chase Field,9,3
2018-08-03,2018,PIT,STL,7,6,-157,-1.5,144,8.5,101,-121,142,1.5,-165,5.19,PNC Park,13,1
2018-08-03,2018,CWS,TB,3,2,171,1.5,-109,8.5,-110,-110,-201,-1.5,-111,3.14,Tropicana Field,5,1
2018-08-03,2018,BAL,TEX,3,11,148,1.5,-130,11.5,-119,-101,-163,-1.5,110,4.64,Rangers Ballpark,14,-8
2018-08-03,2018,SEA,TOR,2,7,-165,-1.5,111,8.0,-110,-110,150,1.5,-130,4.98,T-Mobile Park,9,-5
2018-08-04,2018,SF,ARI,3,9,131,1.5,-170,8.5,-104,-116,-146,-1.5,148,3.68,Chase Field,12,-6
2018-08-04,2018,NYM,ATL,3,0,113,1.5,-153,8.0,-105,-115,-123,-1.5,133,3.76,Citi Field,3,3
2018-08-04,2018,TEX,BAL,3,1,-145,-1.5,125,9.5,-119,-101,130,1.5,-145,5.62,Rangers Ballpark,4,2
2018-08-04,2018,NYY,BOS,1,4,145,1.5,-140,9.5,100,-120,-160,-1.5,120,3.88,Fenway Park,5,-3
2018-08-04,2018,SD,CHC,4,5,215,1.5,125,11.0,100,-120,-255,-1.5,-145,3.49,Wrigley Field,9,-1
2018-08-04,2018,WSH,CIN,1,7,-185,-1.5,-105,9.5,-114,-106,165,1.5,-115,6.17,Nationals Park,8,-6
2018-08-04,2018,WSH,CIN,6,2,-173,-1.5,114,9.5,-110,-110,153,1.5,-134,6.02,Nationals Park,8,4
2018-08-04,2018,LAA,CLE,0,3,250,1.5,127,8.5,-119,-101,-300,-1.5,-147,2.43,Progressive Field,3,-3
2018-08-04,2018,MIL,COL,8,4,-147,-1.5,146,8.5,-119,-101,132,1.5,-168,5.06,Miller Park,12,4
2018-08-04,2018,TB,CWS,1,2,-140,-1.5,152,7.0,109,-129,125,1.5,-177,4.08,Tropicana Field,3,-1
2018-08-04,2018,OAK,DET,2,1,-170,-1.5,120,8.0,-118,-102,150,1.5,-140,5.04,Oakland Coliseum,3,1
2018-08-04,2018,LAD,HOU,0,14,-122,-1.5,163,8.0,100,-120,112,1.5,-190,4.4,Dodger Stadium,14,-14
2018-08-04,2018,MIN,KC,8,2,-235,-1.5,-126,9.0,-105,-115,205,1.5,106,6.31,Target Field,10,6
2018-08-04,2018,CLE,LAA,3,0,-300,-1.5,-147,8.5,-119,-101,250,1.5,127,6.38,Progressive Field,3,3
2018-08-04,2018,HOU,LAD,14,0,112,1.5,-190,8.0,100,-120,-122,-1.5,163,3.77,Dodger Stadium,14,14
2018-08-04,2018,PHI,MIA,8,3,-172,-1.5,113,9.0,105,-125,152,1.5,-133,5.69,Citizens Bank Park,11,5
2018-08-04,2018,COL,MIL,4,8,132,1.5,-168,8.5,-119,-101,-147,-1.5,146,3.66,Miller Park,12,-4
2018-08-04,2018,KC,MIN,2,8,205,1.5,106,9.0,-105,-115,-235,-1.5,-126,2.95,Target Field,10,-6
2018-08-04,2018,ATL,NYM,0,3,-123,-1.5,133,8.0,-105,-115,113,1.5,-153,4.41,Citi Field,3,-3
2018-08-04,2018,BOS,NYY,4,1,-160,-1.5,120,9.5,100,-120,145,1.5,-140,5.85,Fenway Park,5,3
2018-08-04,2018,DET,OAK,1,2,150,1.5,-140,8.0,-118,-102,-170,-1.5,120,3.2,Oakland Coliseum,3,-1
2018-08-04,2018,MIA,PHI,3,8,152,1.5,-133,9.0,105,-125,-172,-1.5,113,3.57,Citizens Bank Park,11,-5
2018-08-04,2018,STL,PIT,8,4,101,1.5,-205,8.5,-112,-108,-111,-1.5,172,4.23,PNC Park,12,4
2018-08-04,2018,CHC,SD,5,4,-255,-1.5,-145,11.0,100,-120,215,1.5,125,7.9,Wrigley Field,9,1
2018-08-04,2018,TOR,SEA,5,1,200,1.5,105,8.0,100,-120,-230,-1.5,-125,2.67,T-Mobile Park,6,4
2018-08-04,2018,ARI,SF,9,3,-146,-1.5,148,8.5,-104,-116,131,1.5,-170,5.04,Chase Field,12,6
2018-08-04,2018,PIT,STL,4,8,-111,-1.5,172,8.5,-112,-108,101,1.5,-205,4.47,PNC Park,12,-4
2018-08-04,2018,CWS,TB,2,1,125,1.5,-177,7.0,109,-129,-140,-1.5,152,3.11,Tropicana Field,3,1
2018-08-04,2018,BAL,TEX,1,3,130,1.5,-145,9.5,-119,-101,-145,-1.5,125,4.13,Rangers Ballpark,4,-2
2018-08-04,2018,SEA,TOR,1,5,-230,-1.5,-125,8.0,100,-120,200,1.5,105,5.58,T-Mobile Park,6,-4
2018-08-04,2018,CIN,WSH,7,1,165,1.5,-115,9.5,-114,-106,-185,-1.5,-105,3.58,Nationals Park,8,6
2018-08-04,2018,CIN,WSH,2,6,153,1.5,-134,9.5,-110,-110,-173,-1.5,114,3.75,Nationals Park,8,-4
2018-08-05,2018,SF,ARI,3,2,151,1.5,-141,8.5,-110,-110,-171,-1.5,121,3.39,Chase Field,5,1
2018-08-05,2018,NYM,ATL,4,5,125,1.5,-135,8.5,-120,100,-140,-1.5,115,3.78,Citi Field,9,-1
2018-08-05,2018,TEX,BAL,6,9,-167,-1.5,115,10.5,-130,110,152,1.5,-135,6.57,Rangers Ballpark,15,-3
2018-08-05,2018,NYY,BOS,4,5,-105,-1.5,148,9.5,-103,-117,-105,1.5,-170,4.87,Fenway Park,9,-1
2018-08-05,2018,SD,CHC,10,6,150,1.5,-125,10.5,-119,-101,-170,-1.5,105,4.2,Wrigley Field,16,4
2018-08-05,2018,WSH,CIN,2,1,-172,-1.5,120,9.0,-109,-111,152,1.5,-140,5.69,Nationals Park,3,1
2018-08-05,2018,LAA,CLE,3,4,230,1.5,130,9.5,105,-125,-270,-1.5,-150,2.88,Progressive Field,7,-1
2018-08-05,2018,MIL,COL,4,5,-107,-1.5,176,9.0,100,-120,-103,1.5,-210,4.65,Miller Park,9,-1
2018-08-05,2018,TB,CWS,7,8,-160,-1.5,135,8.0,-110,-110,145,1.5,-155,4.92,Tropicana Field,15,-1
2018-08-05,2018,OAK,DET,6,0,-265,-1.5,-135,8.0,-119,-101,225,1.5,115,5.81,Oakland Coliseum,6,6
2018-08-05,2018,LAD,HOU,3,2,-116,-1.5,184,8.0,100,-120,106,1.5,-220,4.3,Dodger Stadium,5,1
2018-08-05,2018,MIN,KC,6,5,-128,-1.5,153,9.0,-113,-107,118,1.5,-178,5.05,Target Field,11,1
2018-08-05,2018,CLE,LAA,4,3,-270,-1.5,-150,9.5,105,-125,230,1.5,130,6.93,Progressive Field,7,1
2018-08-05,2018,HOU,LAD,2,3,106,1.5,-220,8.0,100,-120,-116,-1.5,184,3.88,Dodger Stadium,5,-1
2018-08-05,2018,PHI,MIA,5,3,-280,-1.5,-151,8.5,-125,105,240,1.5,131,6.26,Citizens Bank Park,8,2
2018-08-05,2018,COL,MIL,5,4,-103,1.5,-210,9.0,100,-120,-107,-1.5,176,4.57,Miller Park,9,1
2018-08-05,2018,KC,MIN,5,6,118,1.5,-178,9.0,-113,-107,-128,-1.5,153,4.13,Target Field,11,-1
2018-08-05,2018,ATL,NYM,5,4,-140,-1.5,115,8.5,-120,100,125,1.5,-135,4.96,Citi Field,9,1
2018-08-05,2018,BOS,NYY,5,4,-105,1.5,-170,9.5,-103,-117,-105,-1.5,148,4.87,Fenway Park,9,1
2018-08-05,2018,DET,OAK,0,6,225,1.5,115,8.0,-119,-101,-265,-1.5,-135,2.46,Oakland Coliseum,6,-6
2018-08-05,2018,MIA,PHI,3,5,240,1.5,131,8.5,-125,105,-280,-1.5,-151,2.5,Citizens Bank Park,8,-2
2018-08-05,2018,STL,PIT,2,1,-119,-1.5,135,8.5,-114,-106,109,1.5,-155,4.62,PNC Park,3,1
2018-08-05,2018,CHC,SD,6,10,-170,-1.5,105,10.5,-119,-101,150,1.5,-125,6.61,Wrigley Field,16,-4
2018-08-05,2018,TOR,SEA,3,6,144,1.5,-155,8.5,-120,100,-159,-1.5,135,3.48,T-Mobile Park,9,-3
2018-08-05,2018,ARI,SF,2,3,-171,-1.5,121,8.5,-110,-110,151,1.5,-141,5.36,Chase Field,5,-1
2018-08-05,2018,PIT,STL,1,2,109,1.5,-155,8.5,-114,-106,-119,-1.5,135,4.07,PNC Park,3,-1
2018-08-05,2018,CWS,TB,8,7,145,1.5,-155,8.0,-110,-110,-160,-1.5,135,3.27,Tropicana Field,15,1
2018-08-05,2018,BAL,TEX,9,6,152,1.5,-135,10.5,-130,110,-167,-1.5,115,4.17,Rangers Ballpark,15,3
2018-08-05,2018,SEA,TOR,6,3,-159,-1.5,135,8.5,-120,100,144,1.5,-155,5.22,T-Mobile Park,9,3
2018-08-05,2018,CIN,WSH,1,2,152,1.5,-140,9.0,-109,-111,-172,-1.5,120,3.57,Nationals Park,3,-1
2018-08-06,2018,PHI,ARI,2,3,112,1.5,-200,8.5,-109,-111,-122,-1.5,170,4.01,Chase Field,5,-1
2018-08-06,2018,KC,CHC,1,3,175,1.5,111,9.0,-121,101,-195,-1.5,-130,3.27,Kauffman Stadium,4,-2
2018-08-06,2018,NYM,CIN,6,4,-165,-1.5,140,8.0,-112,-108,150,1.5,-160,4.98,Citi Field,10,2
2018-08-06,2018,MIN,CLE,0,10,180,1.5,-112,8.5,-123,103,-210,-1.5,-108,3.04,Progressive Field,10,-10
2018-08-06,2018,PIT,COL,0,2,113,1.5,-175,10.5,-121,101,-123,-1.5,151,4.93,Coors Field,2,-2
2018-08-06,2018,NYY,CWS,7,0,-181,-1.5,-125,9.5,-120,100,161,1.5,105,6.12,Guaranteed Rate Field,7,7
2018-08-06,2018,LAA,DET,6,2,-141,-1.5,151,8.5,100,-120,126,1.5,-175,4.97,Angel Stadium,8,4
2018-08-06,2018,SF,HOU,1,3,119,1.5,-141,7.0,101,-121,-134,-1.5,121,3.2,AT&T Park,4,-2
2018-08-06,2018,CHC,KC,3,1,-195,-1.5,-130,9.0,-121,101,175,1.5,111,5.95,Kauffman Stadium,4,2
2018-08-06,2018,DET,LAA,2,6,126,1.5,-175,8.5,100,-120,-141,-1.5,151,3.76,Angel Stadium,8,-4
2018-08-06,2018,STL,MIA,1,2,-160,-1.5,-110,8.5,-105,-115,145,1.5,-110,5.23,Marlins Park,3,-1
2018-08-06,2018,CLE,MIN,10,0,-210,-1.5,-108,8.5,-123,103,180,1.5,-112,5.76,Progressive Field,10,10
2018-08-06,2018,CIN,NYM,4,6,150,1.5,-160,8.0,-112,-108,-165,-1.5,140,3.2,Citi Field,10,-2
2018-08-06,2018,CWS,NYY,0,7,161,1.5,105,9.5,-120,100,-181,-1.5,-125,3.64,Guaranteed Rate Field,7,-7
2018-08-06,2018,ARI,PHI,3,2,-122,-1.5,170,8.5,-109,-111,112,1.5,-200,4.67,Chase Field,5,1
2018-08-06,2018,COL,PIT,2,0,-123,-1.5,151,10.5,-121,101,113,1.5,-175,5.79,Coors Field,2,2
2018-08-06,2018,TEX,SEA,3,4,116,1.5,-140,11.5,105,-125,-126,-1.5,120,5.32,Rangers Ballpark,7,-1
2018-08-06,2018,HOU,SF,3,1,-134,-1.5,121,7.0,101,-121,119,1.5,-141,4.01,AT&T Park,4,2
2018-08-06,2018,MIA,STL,2,1,145,1.5,-110,8.5,-105,-115,-160,-1.5,-110,3.47,Marlins Park,3,1
2018-08-06,2018,SEA,TEX,4,3,-126,-1.5,120,11.5,105,-125,116,1.5,-140,6.41,Rangers Ballpark,7,1
2018-08-07,2018,PHI,ARI,5,2,148,1.5,-160,7.5,-105,-115,-163,-1.5,140,3.02,Chase Field,7,3
2018-08-07,2018,WSH,ATL,8,3,107,1.5,-145,10.0,-105,-115,-117,-1.5,125,4.83,Nationals Park,11,5
2018-08-07,2018,WSH,ATL,1,3,-235,-1.5,-120,8.0,-109,-111,205,1.5,100,5.61,Nationals Park,4,-2
2018-08-07,2018,TB,BAL,4,3,-173,-1.5,130,7.5,-110,-110,153,1.5,-150,4.75,Tropicana Field,7,1
2018-08-07,2018,TOR,BOS,7,10,-107,-1.5,176,9.0,-118,-102,-103,1.5,-210,4.65,Rogers Centre,17,-3
2018-08-07,2018,KC,CHC,0,5,151,1.5,-105,8.5,-108,-112,-171,-1.5,-115,3.39,Kauffman Stadium,5,-5
2018-08-07,2018,NYM,CIN,1,6,-137,-1.5,151,8.5,-107,-113,122,1.5,-175,4.91,Citi Field,7,-5
2018-08-07,2018,MIN,CLE,3,2,205,1.5,105,8.5,-125,105,-245,-1.5,-125,2.79,Progressive Field,5,1
2018-08-07,2018,PIT,COL,10,2,-111,-1.5,135,11.0,-115,-105,101,1.5,-155,5.79,Coors Field,12,8
2018-08-07,2018,NYY,CWS,4,3,-195,-1.5,-133,9.0,110,-130,175,1.5,113,5.95,Guaranteed Rate Field,7,1
2018-08-07,2018,LAA,DET,11,5,-205,-1.5,-107,8.5,-101,-119,175,1.5,-113,5.71,Angel Stadium,16,6
2018-08-07,2018,SF,HOU,1,2,-115,-1.5,188,7.0,-115,-105,105,1.5,-225,3.74,AT&T Park,3,-1
2018-08-07,2018,CHC,KC,5,0,-171,-1.5,-115,8.5,-108,-112,151,1.5,-105,5.36,Kauffman Stadium,5,5
2018-08-07,2018,DET,LAA,5,11,175,1.5,-113,8.5,-101,-119,-205,-1.5,-107,3.09,Angel Stadium,16,-6
2018-08-07,2018,OAK,LAD,2,4,106,1.5,-155,8.0,-122,102,-116,-1.5,135,3.88,Oakland Coliseum,6,-2
2018-08-07,2018,STL,MIA,3,2,-142,-1.5,110,7.5,-107,-113,127,1.5,-130,4.4,Marlins Park,5,1
2018-08-07,2018,SD,MIL,11,5,170,1.5,-125,8.5,100,-120,-190,-1.5,105,3.15,Miller Park,16,6
2018-08-07,2018,CLE,MIN,2,3,-245,-1.5,-125,8.5,-125,105,205,1.5,105,6.04,Progressive Field,5,-1
2018-08-07,2018,CIN,NYM,6,1,122,1.5,-175,8.5,-107,-113,-137,-1.5,151,3.83,Citi Field,7,5
2018-08-07,2018,CWS,NYY,3,4,175,1.5,113,9.0,110,-130,-195,-1.5,-133,3.27,Guaranteed Rate Field,7,-1
2018-08-07,2018,LAD,OAK,4,2,-116,-1.5,135,8.0,-122,102,106,1.5,-155,4.3,Oakland Coliseum,6,2
2018-08-07,2018,ARI,PHI,2,5,-163,-1.5,140,7.5,-105,-115,148,1.5,-160,4.65,Chase Field,7,-3
2018-08-07,2018,COL,PIT,2,10,101,1.5,-155,11.0,-115,-105,-111,-1.5,135,5.47,Coors Field,12,-8
2018-08-07,2018,MIL,SD,5,11,-190,-1.5,105,8.5,100,-120,170,1.5,-125,5.57,Miller Park,16,-6
2018-08-07,2018,TEX,SEA,11,4,105,1.5,-145,11.0,-125,105,-115,-1.5,125,5.37,Rangers Ballpark,15,7
2018-08-07,2018,HOU,SF,2,1,105,1.5,-225,7.0,-115,-105,-115,-1.5,188,3.41,AT&T Park,3,1
2018-08-07,2018,MIA,STL,2,3,127,1.5,-130,7.5,-107,-113,-142,-1.5,110,3.3,Marlins Park,5,-1
2018-08-07,2018,BAL,TB,3,4,153,1.5,-150,7.5,-110,-110,-173,-1.5,130,2.96,Tropicana Field,7,-1
2018-08-07,2018,SEA,TEX,4,11,-115,-1.5,125,11.0,-125,105,105,1.5,-145,5.88,Rangers Ballpark,15,-7
2018-08-07,2018,BOS,TOR,10,7,-103,1.5,-210,9.0,-118,-102,-107,-1.5,176,4.57,Rogers Centre,17,3
2018-08-07,2018,ATL,WSH,3,8,-117,-1.5,125,10.0,-105,-115,107,1.5,-145,5.39,Nationals Park,11,-5
2018-08-07,2018,ATL,WSH,3,1,205,1.5,100,8.0,-109,-111,-235,-1.5,-120,2.62,Nationals Park,4,2
2018-08-08,2018,PHI,ARI,0,6,170,1.5,-135,7.5,-117,-103,-190,-1.5,115,2.78,Chase Field,6,-6
2018-08-08,2018,WSH,ATL,3,8,-140,-1.5,149,9.5,105,-125,125,1.5,-172,5.54,Nationals Park,11,-5
2018-08-08,2018,TB,BAL,4,5,-175,-1.5,120,8.0,-102,-118,155,1.5,-140,5.09,Tropicana Field,9,-1
2018-08-08,2018,TOR,BOS,5,10,135,1.5,-119,9.5,-110,-110,-150,-1.5,-101,4.04,Rogers Centre,15,-5
2018-08-08,2018,KC,CHC,9,0,190,1.5,125,9.5,-103,-117,-220,-1.5,-145,3.28,Kauffman Stadium,9,9
2018-08-08,2018,NYM,CIN,8,0,-205,-1.5,105,7.0,-101,-119,175,1.5,-125,4.7,Citi Field,8,8
2018-08-08,2018,MIN,CLE,2,5,180,1.5,-105,9.0,-125,105,-210,-1.5,-115,3.21,Progressive Field,7,-3
2018-08-08,2018,PIT,COL,4,3,114,1.5,-172,10.0,-105,-115,-124,-1.5,149,4.67,Coors Field,7,1
2018-08-08,2018,NYY,CWS,7,3,-260,-1.5,-160,8.5,-103,-117,220,1.5,140,6.14,Guaranteed Rate Field,10,4
2018-08-08,2018,LAA,DET,6,0,-131,-1.5,149,8.5,-115,-105,116,1.5,-172,4.82,Angel Stadium,6,6
2018-08-08,2018,CHC,KC,0,9,-220,-1.5,-145,9.5,-103,-117,190,1.5,125,6.53,Kauffman Stadium,9,-9
2018-08-08,2018,DET,LAA,0,6,116,1.5,-172,8.5,-115,-105,-131,-1.5,149,3.94,Angel Stadium,6,-6
2018-08-08,2018,OAK,LAD,3,2,157,1.5,-110,8.0,100,-120,-177,-1.5,-110,3.11,Oakland Coliseum,5,1
2018-08-08,2018,STL,MIA,7,1,-113,-1.5,146,8.0,-121,101,103,1.5,-168,4.24,Marlins Park,8,6
2018-08-08,2018,SD,MIL,4,8,174,1.5,-110,8.5,-119,-101,-204,-1.5,-110,3.1,Miller Park,12,-4
2018-08-08,2018,CLE,MIN,5,2,-210,-1.5,-115,9.0,-125,105,180,1.5,-105,6.1,Progressive Field,7,3
2018-08-08,2018,CIN,NYM,0,8,175,1.5,-125,7.0,-101,-119,-205,-1.5,105,2.55,Citi Field,8,-8
2018-08-08,2018,CWS,NYY,3,7,220,1.5,140,8.5,-103,-117,-260,-1.5,-160,2.66,Guaranteed Rate Field,10,-4
2018-08-08,2018,LAD,OAK,2,3,-177,-1.5,-110,8.0,100,-120,157,1.5,-110,5.11,Oakland Coliseum,5,-1
2018-08-08,2018,ARI,PHI,6,0,-190,-1.5,115,7.5,-117,-103,170,1.5,-135,4.91,Chase Field,6,6
2018-08-08,2018,COL,PIT,3,4,-124,-1.5,149,10.0,-105,-115,114,1.5,-172,5.54,Coors Field,7,-1
2018-08-08,2018,MIL,SD,8,4,-204,-1.5,-110,8.5,-119,-101,174,1.5,-110,5.7,Miller Park,12,4
2018-08-08,2018,TEX,SEA,11,7,143,1.5,-112,11.0,110,-130,-158,-1.5,-108,4.53,Rangers Ballpark,18,4
2018-08-08,2018,MIA,STL,1,7,103,1.5,-168,8.0,-121,101,-113,-1.5,146,3.94,Marlins Park,8,-6
2018-08-08,2018,BAL,TB,5,4,155,1.5,-140,8.0,-102,-118,-175,-1.5,120,3.14,Tropicana Field,9,1
2018-08-08,2018,SEA,TEX,7,11,-158,-1.5,-108,11.0,110,-130,143,1.5,-112,6.74,Rangers Ballpark,18,-4
2018-08-08,2018,BOS,TOR,10,5,-150,-1.5,-101,9.5,-110,-110,135,1.5,-119,5.7,Rogers Centre,15,5
2018-08-08,2018,ATL,WSH,8,3,125,1.5,-172,9.5,105,-125,-140,-1.5,149,4.22,Nationals Park,11,5
2018-08-09,2018,WSH,ATL,6,3,-122,-1.5,172,9.0,100,-120,112,1.5,-205,4.95,Nationals Park,9,3
2018-08-09,2018,TB,BAL,5,4,-206,-1.5,-107,8.0,-105,-115,176,1.5,-113,5.39,Tropicana Field,9,1
2018-08-09,2018,TOR,BOS,8,5,145,1.5,-109,9.0,-118,-102,-160,-1.5,-111,3.67,Rogers Centre,13,3
2018-08-09,2018,MIN,CLE,4,5,180,1.5,-112,7.5,-115,-105,-210,-1.5,-108,2.68,Progressive Field,9,-1
2018-08-09,2018,LAD,COL,8,5,-132,-1.5,114,11.0,-105,-115,117,1.5,-134,6.26,Coors Field,13,3
2018-08-09,2018,SEA,HOU,8,6,120,1.5,-190,6.5,-114,-106,-135,-1.5,163,2.95,Minute Maid Park,14,2
2018-08-09,2018,COL,LAD,5,8,117,1.5,-134,11.0,-105,-115,-132,-1.5,114,5.07,Coors Field,13,-3
2018-08-09,2018,SD,MIL,8,4,162,1.5,-130,8.5,-113,-107,-182,-1.5,110,3.24,Miller Park,12,4
2018-08-09,2018,CLE,MIN,5,4,-210,-1.5,-108,7.5,-115,-105,180,1.5,-112,5.08,Progressive Field,9,1
2018-08-09,2018,TEX,NYY,3,7,200,1.5,106,9.5,-105,-115,-230,-1.5,-126,3.17,Yankee Stadium,10,-4
2018-08-09,2018,SF,PIT,5,10,-145,-1.5,143,8.0,-104,-116,130,1.5,-164,4.73,AT&T Park,15,-5
2018-08-09,2018,MIL,SD,4,8,-182,-1.5,110,8.5,-113,-107,162,1.5,-130,5.49,Miller Park,12,-4
2018-08-09,2018,HOU,SEA,6,8,-135,-1.5,163,6.5,-114,-106,120,1.5,-190,3.73,Minute Maid Park,14,-2
2018-08-09,2018,PIT,SF,10,5,130,1.5,-164,8.0,-104,-116,-145,-1.5,143,3.48,AT&T Park,15,5
2018-08-09,2018,BAL,TB,4,5,176,1.5,-113,8.0,-105,-115,-206,-1.5,-107,2.9,Tropicana Field,9,-1
2018-08-09,2018,NYY,TEX,7,3,-230,-1.5,-126,9.5,-105,-115,200,1.5,106,6.62,Yankee Stadium,10,4
2018-08-09,2018,BOS,TOR,5,8,-160,-1.5,-111,9.0,-118,-102,145,1.5,-109,5.54,Rogers Centre,13,-3
2018-08-09,2018,ATL,WSH,3,6,112,1.5,-205,9.0,100,-120,-122,-1.5,172,4.25,Nationals Park,9,-3
2018-08-10,2018,CIN,ARI,3,0,112,1.5,-144,9.0,-115,-105,-122,-1.5,124,4.25,Great American Ballpark,3,3
2018-08-10,2018,MIL,ATL,1,10,-106,-1.5,148,8.5,-115,-105,-104,1.5,-170,4.37,Suntrust Park,11,-9
2018-08-10,2018,BOS,BAL,19,12,-235,-1.5,-150,9.0,-116,-104,205,1.5,130,6.31,Camden Yards,31,7
2018-08-10,2018,BAL,BOS,12,19,205,1.5,130,9.0,-116,-104,-235,-1.5,-150,2.95,Camden Yards,31,-7
2018-08-10,2018,WSH,CHC,2,3,122,1.5,-170,8.5,-105,-115,-137,-1.5,148,3.83,Wrigley Field,5,-1
2018-08-10,2018,ARI,CIN,0,3,-122,-1.5,124,9.0,-115,-105,112,1.5,-144,4.95,Great American Ballpark,3,-3
2018-08-10,2018,CWS,CLE,1,0,130,1.5,-130,9.0,100,-120,-145,-1.5,110,3.91,Guaranteed Rate Field,1,1
2018-08-10,2018,LAD,COL,4,5,-105,1.5,-200,11.0,-118,-102,-105,-1.5,170,5.63,Coors Field,9,-1
2018-08-10,2018,CLE,CWS,0,1,-145,-1.5,110,9.0,100,-120,130,1.5,-130,5.33,Guaranteed Rate Field,1,-1
2018-08-10,2018,MIN,DET,3,5,-103,-1.5,148,9.5,-105,-115,-107,1.5,-170,4.82,Comerica Park,8,-2
2018-08-10,2018,SEA,HOU,5,2,175,1.5,-125,7.5,-105,-115,-195,-1.5,105,2.73,Minute Maid Park,7,3
2018-08-10,2018,STL,KC,7,0,-145,-1.5,109,9.5,-114,-106,130,1.5,-129,5.62,Kauffman Stadium,7,7
2018-08-10,2018,OAK,LAA,3,4,-133,-1.5,120,9.0,-105,-115,118,1.5,-140,5.14,Angel Stadium,7,-1
2018-08-10,2018,COL,LAD,5,4,-105,-1.5,170,11.0,-118,-102,-105,1.5,-200,5.63,Coors Field,9,1
2018-08-10,2018,NYM,MIA,6,2,-121,-1.5,134,7.5,-110,-110,111,1.5,-154,4.11,Marlins Park,8,4
2018-08-10,2018,ATL,MIL,10,1,-104,1.5,-170,8.5,-115,-105,-106,-1.5,148,4.33,Suntrust Park,11,9
2018-08-10,2018,DET,MIN,5,3,-107,1.5,-170,9.5,-105,-115,-103,-1.5,148,4.91,Comerica Park,8,2
2018-08-10,2018,MIA,NYM,2,6,111,1.5,-154,7.5,-110,-110,-121,-1.5,134,3.55,Marlins Park,8,-4
2018-08-10,2018,TEX,NYY,12,7,190,1.5,-103,9.0,105,-125,-220,-1.5,-117,3.1,Yankee Stadium,19,5
2018-08-10,2018,LAA,OAK,4,3,118,1.5,-140,9.0,-105,-115,-133,-1.5,120,4.13,Angel Stadium,7,1
2018-08-10,2018,SD,PHI,2,0,138,1.5,-120,8.5,-101,-119,-153,-1.5,100,3.57,PETCO Park,2,2
2018-08-10,2018,SF,PIT,13,10,-118,-1.5,176,8.0,-111,-109,108,1.5,-210,4.33,AT&T Park,23,3
2018-08-10,2018,PHI,SD,0,2,-153,-1.5,100,8.5,-101,-119,138,1.5,-120,5.14,PETCO Park,2,-2
2018-08-10,2018,HOU,SEA,2,5,-195,-1.5,105,7.5,-105,-115,175,1.5,-125,4.96,Minute Maid Park,7,-3
2018-08-10,2018,PIT,SF,10,13,108,1.5,-210,8.0,-111,-109,-118,-1.5,176,3.85,AT&T Park,23,-3
2018-08-10,2018,KC,STL,0,7,130,1.5,-129,9.5,-114,-106,-145,-1.5,109,4.13,Kauffman Stadium,7,-7
2018-08-10,2018,TOR,TB,0,7,109,1.5,-156,8.0,-110,-110,-119,-1.5,136,3.83,Rogers Centre,7,-7
2018-08-10,2018,NYY,TEX,7,12,-220,-1.5,-117,9.0,105,-125,190,1.5,-103,6.19,Yankee Stadium,19,-5
2018-08-10,2018,TB,TOR,7,0,-119,-1.5,136,8.0,-110,-110,109,1.5,-156,4.35,Rogers Centre,7,7
2018-08-10,2018,CHC,WSH,3,2,-137,-1.5,148,8.5,-105,-115,122,1.5,-170,4.91,Wrigley Field,5,1
2018-08-11,2018,CIN,ARI,6,3,146,1.5,-110,8.5,-115,-105,-161,-1.5,-110,3.46,Great American Ballpark,9,3
2018-08-11,2018,MIL,ATL,4,2,-101,1.5,-220,9.0,-125,105,-109,-1.5,184,4.52,Suntrust Park,6,2
2018-08-11,2018,BOS,BAL,5,0,-270,-1.5,-175,10.0,-118,-102,230,1.5,151,7.3,Camden Yards,5,5
2018-08-11,2018,BOS,BAL,6,4,-220,-1.5,-140,9.5,-120,100,190,1.5,120,6.53,Camden Yards,10,2
2018-08-11,2018,BAL,BOS,0,5,230,1.5,151,10.0,-118,-102,-270,-1.5,-175,3.03,Camden Yards,5,-5
2018-08-11,2018,BAL,BOS,4,6,190,1.5,120,9.5,-120,100,-220,-1.5,-140,3.28,Camden Yards,10,-2
2018-08-11,2018,WSH,CHC,9,4,115,1.5,-180,9.0,-124,104,-130,-1.5,155,4.19,Wrigley Field,13,5
2018-08-11,2018,ARI,CIN,3,6,-161,-1.5,-110,8.5,-115,-105,146,1.5,-110,5.24,Great American Ballpark,9,-3
2018-08-11,2018,CWS,CLE,1,3,190,1.5,126,9.0,-105,-115,-220,-1.5,-146,3.1,Guaranteed Rate Field,4,-2
2018-08-11,2018,LAD,COL,2,3,-138,-1.5,110,11.5,-120,100,123,1.5,-130,6.67,Coors Field,5,-1
2018-08-11,2018,CLE,CWS,3,1,-220,-1.5,-146,9.0,-105,-115,190,1.5,126,6.19,Guaranteed Rate Field,4,2
2018-08-11,2018,MIN,DET,4,3,-131,-1.5,124,8.5,-112,-108,116,1.5,-144,4.82,Comerica Park,7,1
2018-08-11,2018,SEA,HOU,3,2,171,1.5,-119,8.0,-122,102,-201,-1.5,-101,2.95,Minute Maid Park,5,1
2018-08-11,2018,STL,KC,8,3,-170,-1.5,-110,9.0,-102,-118,150,1.5,-110,5.67,Kauffman Stadium,11,5
2018-08-11,2018,OAK,LAA,7,0,105,1.5,-215,8.5,-120,100,-115,-1.5,180,4.15,Angel Stadium,7,7
2018-08-11,2018,COL,LAD,3,2,123,1.5,-130,11.5,-120,100,-138,-1.5,110,5.16,Coors Field,5,1
2018-08-11,2018,NYM,MIA,3,4,-109,-1.5,146,8.0,-115,-105,-101,1.5,-168,4.17,Marlins Park,7,-1
2018-08-11,2018,ATL,MIL,2,4,-109,-1.5,184,9.0,-125,105,-101,1.5,-220,4.69,Suntrust Park,6,-2
2018-08-11,2018,DET,MIN,3,4,116,1.5,-144,8.5,-112,-108,-131,-1.5,124,3.94,Comerica Park,7,-1
2018-08-11,2018,MIA,NYM,4,3,-101,1.5,-168,8.0,-115,-105,-109,-1.5,146,4.02,Marlins Park,7,1
2018-08-11,2018,TEX,NYY,3,5,185,1.5,110,9.5,-118,-102,-215,-1.5,-130,3.33,Yankee Stadium,8,-2
2018-08-11,2018,LAA,OAK,0,7,-115,-1.5,180,8.5,-120,100,105,1.5,-215,4.55,Angel Stadium,7,-7
2018-08-11,2018,SD,PHI,1,5,160,1.5,106,8.0,-106,-114,-180,-1.5,-127,3.08,PETCO Park,6,-4
2018-08-11,2018,SF,PIT,0,4,-131,-1.5,166,8.5,-101,-119,116,1.5,-195,4.82,AT&T Park,4,-4
2018-08-11,2018,PHI,SD,5,1,-180,-1.5,-127,8.0,-106,-114,160,1.5,106,5.14,PETCO Park,6,4
2018-08-11,2018,HOU,SEA,2,3,-201,-1.5,-101,8.0,-122,102,171,1.5,-119,5.34,Minute Maid Park,5,-1
2018-08-11,2018,PIT,SF,4,0,116,1.5,-195,8.5,-101,-119,-131,-1.5,166,3.94,AT&T Park,4,4
2018-08-11,2018,KC,STL,3,8,150,1.5,-110,9.0,-102,-118,-170,-1.5,-110,3.6,Kauffman Stadium,11,-5
2018-08-11,2018,TOR,TB,1,3,-103,1.5,-170,9.0,-107,-113,-107,-1.5,148,4.57,Rogers Centre,4,-2
2018-08-11,2018,NYY,TEX,5,3,-215,-1.5,-130,9.5,-118,-102,185,1.5,110,6.48,Yankee Stadium,8,2
2018-08-11,2018,TB,TOR,3,1,-107,-1.5,148,9.0,-107,-113,-103,1.5,-170,4.65,Rogers Centre,4,2
2018-08-11,2018,CHC,WSH,4,9,-130,-1.5,155,9.0,-124,104,115,1.5,-180,5.09,Wrigley Field,13,-5
2018-08-12,2018,CIN,ARI,2,9,-102,1.5,-165,8.5,-119,-101,-108,-1.5,144,4.29,Great American Ballpark,11,-7
2018-08-12,2018,MIL,ATL,7,8,120,1.5,-185,8.5,-120,100,-135,-1.5,160,3.86,Suntrust Park,15,-1
2018-08-12,2018,BOS,BAL,4,1,-339,-1.5,-200,8.5,-110,-110,289,1.5,170,6.56,Camden Yards,5,3
2018-08-12,2018,BAL,BOS,1,4,289,1.5,170,8.5,-110,-110,-339,-1.5,-200,2.19,Camden Yards,5,-3
2018-08-12,2018,WSH,CHC,3,4,-133,-1.5,127,7.5,-115,-105,118,1.5,-147,4.28,Wrigley Field,7,-1
2018-08-12,2018,ARI,CIN,9,2,-108,-1.5,144,8.5,-119,-101,-102,1.5,-165,4.41,Great American Ballpark,11,7
2018-08-12,2018,CWS,CLE,7,9,190,1.5,115,8.5,-119,-101,-220,-1.5,-135,2.93,Guaranteed Rate Field,16,-2
2018-08-12,2018,LAD,COL,3,4,-189,-1.5,-126,12.0,-125,105,169,1.5,106,7.85,Coors Field,7,-1
2018-08-12,2018,CLE,CWS,9,7,-220,-1.5,-135,8.5,-119,-101,190,1.5,115,5.84,Guaranteed Rate Field,16,2
2018-08-12,2018,MIN,DET,2,4,-112,-1.5,140,8.5,-115,-105,102,1.5,-160,4.49,Comerica Park,6,-2
2018-08-12,2018,SEA,HOU,4,3,171,1.5,-124,8.5,-105,-115,-191,-1.5,104,3.14,Minute Maid Park,7,1
2018-08-12,2018,STL,KC,8,2,-143,-1.5,109,9.0,-112,-108,128,1.5,-129,5.3,Kauffman Stadium,10,6
2018-08-12,2018,OAK,LAA,8,7,-140,-1.5,105,8.5,-101,-119,125,1.5,-125,4.96,Angel Stadium,15,1
2018-08-12,2018,COL,LAD,4,3,169,1.5,106,12.0,-125,105,-189,-1.5,-126,4.46,Coors Field,7,1
2018-08-12,2018,NYM,MIA,4,3,-175,-1.5,-105,7.0,-105,-115,155,1.5,-115,4.45,Marlins Park,7,1
2018-08-12,2018,ATL,MIL,8,7,-135,-1.5,160,8.5,-120,100,120,1.5,-185,4.88,Suntrust Park,15,1
2018-08-12,2018,DET,MIN,4,2,102,1.5,-160,8.5,-115,-105,-112,-1.5,140,4.21,Comerica Park,6,2
2018-08-12,2018,MIA,NYM,3,4,155,1.5,-115,7.0,-105,-115,-175,-1.5,-105,2.75,Marlins Park,7,-1
2018-08-12,2018,TEX,NYY,2,7,180,1.5,-105,9.5,105,-125,-210,-1.5,-115,3.39,Yankee Stadium,9,-5
2018-08-12,2018,LAA,OAK,7,8,125,1.5,-125,8.5,-101,-119,-140,-1.5,105,3.78,Angel Stadium,15,-1
2018-08-12,2018,SD,PHI,9,3,109,1.5,-160,7.5,-117,-103,-119,-1.5,140,3.59,PETCO Park,12,6
2018-08-12,2018,SF,PIT,4,3,-107,1.5,-180,7.5,-110,-110,-103,-1.5,155,3.88,AT&T Park,7,1
2018-08-12,2018,PHI,SD,3,9,-119,-1.5,140,7.5,-117,-103,109,1.5,-160,4.08,PETCO Park,12,-6
2018-08-12,2018,HOU,SEA,3,4,-191,-1.5,104,8.5,-105,-115,171,1.5,-124,5.58,Minute Maid Park,7,-1
2018-08-12,2018,PIT,SF,3,4,-103,-1.5,155,7.5,-110,-110,-107,1.5,-180,3.81,AT&T Park,7,-1
2018-08-12,2018,KC,STL,2,8,128,1.5,-129,9.0,-112,-108,-143,-1.5,109,3.95,Kauffman Stadium,10,-6
2018-08-12,2018,TOR,TB,2,1,-132,-1.5,161,8.0,-110,-110,117,1.5,-187,4.55,Rogers Centre,3,1
2018-08-12,2018,NYY,TEX,7,2,-210,-1.5,-115,9.5,105,-125,180,1.5,-105,6.44,Yankee Stadium,9,5
2018-08-12,2018,TB,TOR,1,2,117,1.5,-187,8.0,-110,-110,-132,-1.5,161,3.69,Rogers Centre,3,-1
2018-08-12,2018,CHC,WSH,4,3,118,1.5,-147,7.5,-115,-105,-133,-1.5,127,3.44,Wrigley Field,7,1
2018-08-13,2018,TEX,ARI,5,3,152,1.5,105,9.5,-101,-119,-172,-1.5,-125,3.77,Rangers Ballpark,8,2
2018-08-13,2018,MIA,ATL,1,9,175,1.5,-120,8.5,-115,-105,-195,-1.5,100,3.09,Suntrust Park,10,-8
2018-08-13,2018,MIA,ATL,1,6,260,1.5,130,9.0,-101,-119,-310,-1.5,-150,2.5,Suntrust Park,7,-5
2018-08-13,2018,CLE,CIN,10,3,-179,-1.5,-125,9.5,104,-124,159,1.5,105,6.09,Great American Ballpark,13,7
2018-08-13,2018,CIN,CLE,3,10,159,1.5,105,9.5,104,-124,-179,-1.5,-125,3.67,Great American Ballpark,13,-7
2018-08-13,2018,DET,CWS,9,5,-105,1.5,-170,9.0,-119,-101,-105,-1.5,149,4.61,Comerica Park,14,4
2018-08-13,2018,CWS,DET,5,9,-105,-1.5,149,9.0,-119,-101,-105,1.5,-170,4.61,Comerica Park,14,-4
2018-08-13,2018,TOR,KC,1,3,-131,-1.5,126,8.5,-120,100,116,1.5,-146,4.82,Kauffman Stadium,4,-2
2018-08-13,2018,SD,LAA,3,6,-324,-1.5,176,8.0,-105,-115,274,1.5,-210,6.11,PETCO Park,9,-3
2018-08-13,2018,SF,LAD,5,2,170,1.5,-125,7.0,-105,-115,-200,-1.5,105,2.59,Dodger Stadium,7,3
2018-08-13,2018,ATL,MIA,9,1,-195,-1.5,100,8.5,-115,-105,175,1.5,-120,5.62,Suntrust Park,10,8
2018-08-13,2018,ATL,MIA,6,1,-310,-1.5,-150,9.0,-101,-119,260,1.5,130,6.8,Suntrust Park,7,5
2018-08-13,2018,NYY,NYM,5,8,-210,-1.5,100,7.0,-125,105,180,1.5,-120,4.74,Yankee Stadium,13,-3
2018-08-13,2018,NYM,NYY,8,5,180,1.5,-120,7.0,-125,105,-210,-1.5,100,2.5,Yankee Stadium,13,3
2018-08-13,2018,SEA,OAK,6,7,121,1.5,-180,8.0,-115,-105,-136,-1.5,155,3.62,Oakland Coliseum,13,-1
2018-08-13,2018,LAA,SD,6,3,274,1.5,-210,8.0,-105,-115,-324,-1.5,176,2.14,PETCO Park,9,3
2018-08-13,2018,OAK,SEA,7,6,-136,-1.5,155,8.0,-115,-105,121,1.5,-180,4.61,Oakland Coliseum,13,1
2018-08-13,2018,LAD,SF,2,5,-200,-1.5,105,7.0,-105,-115,170,1.5,-125,4.67,Dodger Stadium,7,-3
2018-08-13,2018,WSH,STL,6,7,116,1.5,-180,9.0,-115,-105,-131,-1.5,155,4.17,Busch Stadium,13,-1
2018-08-13,2018,ARI,TEX,3,5,-172,-1.5,-125,9.5,-101,-119,152,1.5,105,6.01,Rangers Ballpark,8,-2
2018-08-13,2018,KC,TOR,3,1,116,1.5,-146,8.5,-120,100,-131,-1.5,126,3.94,Kauffman Stadium,4,2
2018-08-13,2018,STL,WSH,7,6,-131,-1.5,155,9.0,-115,-105,116,1.5,-180,5.1,Busch Stadium,13,1
2018-08-14,2018,TEX,ARI,4,6,154,1.5,100,10.0,105,-125,-174,-1.5,-120,3.94,Rangers Ballpark,10,-2
2018-08-14,2018,MIA,ATL,6,10,170,1.5,-115,8.5,-110,-110,-200,-1.5,-105,3.15,Suntrust Park,16,-4
2018-08-14,2018,NYM,BAL,3,6,-311,-1.5,148,10.0,-105,-115,261,1.5,-170,7.57,Camden Yards,9,-3
2018-08-14,2018,PHI,BOS,1,2,108,1.5,-155,8.5,-108,-112,-118,-1.5,135,4.09,Citizens Bank Park,3,-1
2018-08-14,2018,MIL,CHC,7,0,121,1.5,-160,9.5,-110,-110,-136,-1.5,140,4.3,Wrigley Field,7,7
2018-08-14,2018,CLE,CIN,8,1,-205,-1.5,-130,8.5,-125,105,175,1.5,110,5.71,Great American Ballpark,9,7
2018-08-14,2018,CIN,CLE,1,8,175,1.5,110,8.5,-125,105,-205,-1.5,-130,3.09,Great American Ballpark,9,-7
2018-08-14,2018,HOU,COL,1,5,-202,-1.5,-105,7.0,-110,-110,172,1.5,-115,4.68,Minute Maid Park,6,-4
2018-08-14,2018,DET,CWS,3,6,-131,-1.5,155,9.0,-112,-108,116,1.5,-180,5.1,Comerica Park,9,-3
2018-08-14,2018,CWS,DET,6,3,116,1.5,-180,9.0,-112,-108,-131,-1.5,155,4.17,Comerica Park,9,3
2018-08-14,2018,COL,HOU,5,1,172,1.5,-115,7.0,-110,-110,-202,-1.5,-105,2.57,Minute Maid Park,6,4
2018-08-14,2018,TOR,KC,6,5,-147,-1.5,105,9.0,100,-120,132,1.5,-125,5.36,Kauffman Stadium,11,1
2018-08-14,2018,SD,LAA,3,7,-131,-1.5,160,8.5,-110,-110,116,1.5,-185,4.82,PETCO Park,10,-4
2018-08-14,2018,SF,LAD,2,1,172,1.5,-120,8.0,-110,-110,-192,-1.5,100,2.94,Dodger Stadium,3,1
2018-08-14,2018,ATL,MIA,10,6,-200,-1.5,-105,8.5,-110,-110,170,1.5,-115,5.67,Suntrust Park,16,4
2018-08-14,2018,CHC,MIL,0,7,-136,-1.5,140,9.5,-110,-110,121,1.5,-160,5.47,Wrigley Field,7,-7
2018-08-14,2018,PIT,MIN,2,5,-129,-1.5,128,9.0,-113,-107,119,1.5,-148,5.07,Target Field,7,-3
2018-08-14,2018,BAL,NYM,6,3,261,1.5,-170,10.0,-105,-115,-311,-1.5,148,2.77,Camden Yards,9,3
2018-08-14,2018,TB,NYY,1,4,175,1.5,-115,8.5,-110,-110,-205,-1.5,-105,3.09,Yankee Stadium,5,-3
2018-08-14,2018,SEA,OAK,2,3,-135,-1.5,125,7.5,-110,-110,120,1.5,-145,4.31,Oakland Coliseum,5,-1
2018-08-14,2018,BOS,PHI,2,1,-118,-1.5,135,8.5,-108,-112,108,1.5,-155,4.6,Citizens Bank Park,3,1
2018-08-14,2018,MIN,PIT,5,2,119,1.5,-148,9.0,-113,-107,-129,-1.5,128,4.11,Target Field,7,3
2018-08-14,2018,LAA,SD,7,3,116,1.5,-185,8.5,-110,-110,-131,-1.5,160,3.94,PETCO Park,10,4
2018-08-14,2018,OAK,SEA,3,2,120,1.5,-145,7.5,-110,-110,-135,-1.5,125,3.41,Oakland Coliseum,5,1
2018-08-14,2018,LAD,SF,1,2,-192,-1.5,100,8.0,-110,-110,172,1.5,-120,5.26,Dodger Stadium,3,-1
2018-08-14,2018,WSH,STL,4,6,-102,-1.5,151,9.0,-119,-101,-108,1.5,-175,4.54,Busch Stadium,10,-2
2018-08-14,2018,NYY,TB,4,1,-205,-1.5,-105,8.5,-110,-110,175,1.5,-115,5.71,Yankee Stadium,5,3
2018-08-14,2018,ARI,TEX,6,4,-174,-1.5,-120,10.0,105,-125,154,1.5,100,6.35,Rangers Ballpark,10,2
2018-08-14,2018,KC,TOR,5,6,132,1.5,-125,9.0,100,-120,-147,-1.5,105,3.88,Kauffman Stadium,11,-1
2018-08-14,2018,STL,WSH,6,4,-108,1.5,-175,9.0,-119,-101,-102,-1.5,151,4.67,Busch Stadium,10,2
2018-08-15,2018,MIA,ATL,2,5,200,1.5,105,8.5,-101,-119,-240,-1.5,-125,2.83,Suntrust Park,7,-3
2018-08-15,2018,NYM,BAL,16,5,-126,-1.5,129,8.5,-120,100,116,1.5,-149,4.74,Camden Yards,21,11
2018-08-15,2018,PHI,BOS,7,4,-105,1.5,-175,8.5,-117,-103,-105,-1.5,151,4.35,Citizens Bank Park,11,3
2018-08-15,2018,MIL,CHC,4,8,125,1.5,-145,9.0,-110,-110,-140,-1.5,125,4.0,Wrigley Field,12,-4
2018-08-15,2018,CLE,CIN,4,3,-168,-1.5,-116,9.0,-110,-110,153,1.5,-104,5.64,Great American Ballpark,7,1
2018-08-15,2018,CIN,CLE,3,4,153,1.5,-104,9.0,-110,-110,-168,-1.5,-116,3.56,Great American Ballpark,7,-1
2018-08-15,2018,HOU,COL,12,1,-203,-1.5,105,7.5,107,-127,173,1.5,-125,5.02,Minute Maid Park,13,11
2018-08-15,2018,DET,CWS,5,6,-115,-1.5,170,9.0,-102,-118,105,1.5,-200,4.81,Comerica Park,11,-1
2018-08-15,2018,CWS,DET,6,5,105,1.5,-200,9.0,-102,-118,-115,-1.5,170,4.39,Comerica Park,11,1
2018-08-15,2018,COL,HOU,1,12,173,1.5,-125,7.5,107,-127,-203,-1.5,105,2.75,Minute Maid Park,13,-11
2018-08-15,2018,TOR,KC,6,5,-124,-1.5,132,9.0,-105,-115,114,1.5,-152,4.98,Kauffman Stadium,11,1
2018-08-15,2018,SD,LAA,2,3,-127,-1.5,163,8.0,-102,-118,117,1.5,-190,4.48,PETCO Park,5,-1
2018-08-15,2018,SF,LAD,3,4,160,1.5,-135,8.0,-119,-101,-180,-1.5,115,3.08,Dodger Stadium,7,-1
2018-08-15,2018,ATL,MIA,5,2,-240,-1.5,-125,8.5,-101,-119,200,1.5,105,6.0,Suntrust Park,7,3
2018-08-15,2018,CHC,MIL,8,4,-140,-1.5,125,9.0,-110,-110,125,1.5,-145,5.25,Wrigley Field,12,4
2018-08-15,2018,PIT,MIN,4,6,105,1.5,-210,7.5,-119,-101,-115,-1.5,176,3.66,Target Field,10,-2
2018-08-15,2018,BAL,NYM,5,16,116,1.5,-149,8.5,-120,100,-126,-1.5,129,3.94,Camden Yards,21,-11
2018-08-15,2018,TB,NYY,6,1,165,1.5,-128,9.0,-125,105,-185,-1.5,107,3.4,Yankee Stadium,7,5
2018-08-15,2018,SEA,OAK,2,0,101,1.5,-215,8.5,-112,-108,-111,-1.5,180,4.23,Oakland Coliseum,2,2
2018-08-15,2018,BOS,PHI,4,7,-105,-1.5,151,8.5,-117,-103,-105,1.5,-175,4.35,Citizens Bank Park,11,-3
2018-08-15,2018,MIN,PIT,6,4,-115,-1.5,176,7.5,-119,-101,105,1.5,-210,4.01,Target Field,10,2
2018-08-15,2018,LAA,SD,3,2,117,1.5,-190,8.0,-102,-118,-127,-1.5,163,3.69,PETCO Park,5,1
2018-08-15,2018,OAK,SEA,0,2,-111,-1.5,180,8.5,-112,-108,101,1.5,-215,4.47,Oakland Coliseum,2,-2
2018-08-15,2018,LAD,SF,4,3,-180,-1.5,115,8.0,-119,-101,160,1.5,-135,5.14,Dodger Stadium,7,1
2018-08-15,2018,WSH,STL,2,4,105,1.5,-210,9.0,-115,-105,-115,-1.5,176,4.39,Busch Stadium,6,-2
2018-08-15,2018,NYY,TB,1,6,-185,-1.5,107,9.0,-125,105,165,1.5,-128,5.84,Yankee Stadium,7,-5
2018-08-15,2018,KC,TOR,5,6,114,1.5,-152,9.0,-105,-115,-124,-1.5,132,4.21,Kauffman Stadium,11,-1
2018-08-15,2018,STL,WSH,4,2,-115,-1.5,176,9.0,-115,-105,105,1.5,-210,4.81,Busch Stadium,6,2
2018-08-16,2018,SD,ARI,1,5,125,1.5,-140,8.0,-101,-119,-140,-1.5,120,3.56,PETCO Park,6,-4
2018-08-16,2018,COL,ATL,5,3,261,1.5,-210,8.5,-114,-106,-311,-1.5,176,2.35,Suntrust Park,8,2
2018-08-16,2018,PIT,CHC,0,1,109,1.5,-154,8.5,-110,-110,-119,-1.5,134,4.07,PNC Park,1,-1
2018-08-16,2018,ATL,COL,3,5,-311,-1.5,176,8.5,-114,-106,261,1.5,-210,6.43,Suntrust Park,8,-2
2018-08-16,2018,MIN,DET,15,8,-171,-1.5,119,9.5,100,-120,151,1.5,-139,5.99,Target Field,23,7
2018-08-16,2018,TOR,KC,2,6,-133,-1.5,117,9.0,-104,-116,118,1.5,-137,5.14,Kauffman Stadium,8,-4
2018-08-16,2018,TEX,LAA,8,6,-111,-1.5,155,11.0,100,-120,101,1.5,-180,5.79,Rangers Ballpark,14,2
2018-08-16,2018,DET,MIN,8,15,151,1.5,-139,9.5,100,-120,-171,-1.5,119,3.78,Target Field,23,-7
2018-08-16,2018,PHI,NYM,4,24,-152,-1.5,130,10.0,-104,-116,137,1.5,-150,6.03,Citizens Bank Park,28,-20
2018-08-16,2018,PHI,NYM,9,6,-190,-1.5,-103,8.5,-115,-105,170,1.5,-117,5.57,Citizens Bank Park,15,3
2018-08-16,2018,TB,NYY,3,1,151,1.5,-147,8.0,-116,-104,-171,-1.5,126,3.19,Yankee Stadium,4,2
2018-08-16,2018,NYM,PHI,24,4,137,1.5,-150,10.0,-104,-116,-152,-1.5,130,4.22,Citizens Bank Park,28,20
2018-08-16,2018,NYM,PHI,6,9,170,1.5,-117,8.5,-115,-105,-190,-1.5,-103,3.15,Citizens Bank Park,15,-3
2018-08-16,2018,CHC,PIT,1,0,-119,-1.5,134,8.5,-110,-110,109,1.5,-154,4.62,PNC Park,1,1
2018-08-16,2018,ARI,SD,5,1,-140,-1.5,120,8.0,-101,-119,125,1.5,-140,4.67,PETCO Park,6,4
2018-08-16,2018,WSH,STL,5,4,102,1.5,-199,9.0,-110,-110,-112,-1.5,169,4.46,Busch Stadium,9,1
2018-08-16,2018,NYY,TB,1,3,-171,-1.5,126,8.0,-116,-104,151,1.5,-147,5.05,Yankee Stadium,4,-2
2018-08-16,2018,LAA,TEX,6,8,101,1.5,-180,11.0,100,-120,-111,-1.5,155,5.47,Rangers Ballpark,14,-2
2018-08-16,2018,KC,TOR,6,2,118,1.5,-137,9.0,-104,-116,-133,-1.5,117,4.13,Kauffman Stadium,8,4
2018-08-16,2018,STL,WSH,4,5,-112,-1.5,169,9.0,-110,-110,102,1.5,-199,4.75,Busch Stadium,9,-1
2018-08-17,2018,SD,ARI,4,9,116,1.5,-140,7.5,-110,-110,-126,-1.5,120,3.47,PETCO Park,13,-5
2018-08-17,2018,COL,ATL,11,5,117,1.5,-200,8.5,-115,-105,-127,-1.5,170,3.92,Suntrust Park,16,6
2018-08-17,2018,CLE,BAL,2,1,-357,-1.5,-167,8.5,-119,-101,297,1.5,145,6.64,Progressive Field,3,1
2018-08-17,2018,TB,BOS,3,7,165,1.5,-123,9.0,-119,-101,-185,-1.5,102,3.4,Fenway Park,10,-4
2018-08-17,2018,PIT,CHC,0,1,117,1.5,-150,8.0,-109,-111,-127,-1.5,130,3.69,PNC Park,1,-1
2018-08-17,2018,SF,CIN,1,2,100,1.5,-200,9.0,-123,103,-110,-1.5,170,4.5,Great American Ballpark,3,-1
2018-08-17,2018,BAL,CLE,1,2,297,1.5,145,8.5,-119,-101,-357,-1.5,-167,2.14,Progressive Field,3,-1
2018-08-17,2018,ATL,COL,5,11,-127,-1.5,170,8.5,-115,-105,117,1.5,-200,4.76,Suntrust Park,16,-6
2018-08-17,2018,KC,CWS,3,9,126,1.5,-160,8.5,-114,-106,-141,-1.5,140,3.76,Guaranteed Rate Field,12,-6
2018-08-17,2018,MIN,DET,5,4,-174,-1.5,111,8.5,-105,-115,154,1.5,-132,5.4,Target Field,9,1
2018-08-17,2018,OAK,HOU,4,3,133,1.5,-130,8.0,-115,-105,-148,-1.5,110,3.43,Oakland Coliseum,7,1
2018-08-17,2018,CWS,KC,9,3,-141,-1.5,140,8.5,-114,-106,126,1.5,-160,4.97,Guaranteed Rate Field,12,6
2018-08-17,2018,TEX,LAA,6,4,-111,-1.5,160,11.5,-110,-110,101,1.5,-185,6.05,Rangers Ballpark,10,2
2018-08-17,2018,SEA,LAD,1,11,119,1.5,-145,8.0,-120,100,-134,-1.5,125,3.65,T-Mobile Park,12,-10
2018-08-17,2018,WSH,MIA,8,2,-380,-1.5,-175,8.5,-103,-117,320,1.5,151,6.73,Nationals Park,10,6
2018-08-17,2018,STL,MIL,5,2,-121,-1.5,170,8.0,-101,-119,111,1.5,-200,4.38,Busch Stadium,7,3
2018-08-17,2018,DET,MIN,4,5,154,1.5,-132,8.5,-105,-115,-174,-1.5,111,3.35,Target Field,9,-1
2018-08-17,2018,PHI,NYM,4,2,-160,-1.5,130,7.5,-110,-110,145,1.5,-150,4.62,Citizens Bank Park,6,2
2018-08-17,2018,TOR,NYY,5,7,160,1.5,-125,9.0,-115,-105,-180,-1.5,105,3.46,Yankee Stadium,12,-2
2018-08-17,2018,HOU,OAK,3,4,-148,-1.5,110,8.0,-115,-105,133,1.5,-130,4.77,Oakland Coliseum,7,-1
2018-08-17,2018,NYM,PHI,2,4,145,1.5,-150,7.5,-110,-110,-160,-1.5,130,3.06,Citizens Bank Park,6,-2
2018-08-17,2018,CHC,PIT,1,0,-127,-1.5,130,8.0,-109,-111,117,1.5,-150,4.48,PNC Park,1,1
2018-08-17,2018,ARI,SD,9,4,-126,-1.5,120,7.5,-110,-110,116,1.5,-140,4.18,PETCO Park,13,5
2018-08-17,2018,LAD,SEA,11,1,-134,-1.5,125,8.0,-120,100,119,1.5,-145,4.58,T-Mobile Park,12,10
2018-08-17,2018,CIN,SF,2,1,-110,-1.5,170,9.0,-123,103,100,1.5,-200,4.71,Great American Ballpark,3,1
2018-08-17,2018,MIL,STL,2,5,111,1.5,-200,8.0,-101,-119,-121,-1.5,170,3.79,Busch Stadium,7,-3
2018-08-17,2018,BOS,TB,7,3,-185,-1.5,102,9.0,-119,-101,165,1.5,-123,5.84,Fenway Park,10,4
2018-08-17,2018,LAA,TEX,4,6,101,1.5,-185,11.5,-110,-110,-111,-1.5,160,5.72,Rangers Ballpark,10,-2
2018-08-17,2018,NYY,TOR,7,5,-180,-1.5,105,9.0,-115,-105,160,1.5,-125,5.79,Yankee Stadium,12,2
2018-08-17,2018,MIA,WSH,2,8,320,1.5,151,8.5,-103,-117,-380,-1.5,-175,2.02,Nationals Park,10,-6
2018-08-18,2018,SD,ARI,7,6,145,1.5,-115,8.0,101,-121,-160,-1.5,-105,3.27,PETCO Park,13,1
2018-08-18,2018,COL,ATL,5,3,147,1.5,-145,8.5,-101,-119,-162,-1.5,125,3.44,Suntrust Park,8,2
2018-08-18,2018,CLE,BAL,2,4,-185,-1.5,110,9.0,-114,-106,165,1.5,-130,5.84,Progressive Field,6,-2
2018-08-18,2018,TB,BOS,2,5,185,1.5,-105,8.5,-110,-110,-215,-1.5,-115,2.98,Fenway Park,7,-3
2018-08-18,2018,PIT,CHC,3,1,-150,-1.5,145,8.5,-120,100,135,1.5,-166,5.1,PNC Park,4,2
2018-08-18,2018,SF,CIN,1,7,-167,-1.5,-110,8.5,-110,-110,152,1.5,-110,5.32,Great American Ballpark,8,-6
2018-08-18,2018,BAL,CLE,4,2,165,1.5,-130,9.0,-114,-106,-185,-1.5,110,3.4,Progressive Field,6,2
2018-08-18,2018,ATL,COL,3,5,-162,-1.5,125,8.5,-101,-119,147,1.5,-145,5.26,Suntrust Park,8,-2
2018-08-18,2018,KC,CWS,3,1,119,1.5,-168,9.0,-110,-110,-129,-1.5,146,4.11,Guaranteed Rate Field,4,2
2018-08-18,2018,MIN,DET,5,7,-172,-1.5,114,9.5,-115,-105,152,1.5,-135,6.01,Target Field,12,-2
2018-08-18,2018,OAK,HOU,7,1,-103,-1.5,184,7.5,-120,100,-107,1.5,-220,3.81,Oakland Coliseum,8,6
2018-08-18,2018,CWS,KC,1,3,-129,-1.5,146,9.0,-110,-110,119,1.5,-168,5.07,Guaranteed Rate Field,4,-2
2018-08-18,2018,TEX,LAA,7,11,121,1.5,-136,10.5,-109,-111,-136,-1.5,116,4.75,Rangers Ballpark,18,-4
2018-08-18,2018,SEA,LAD,5,4,135,1.5,-119,8.5,-118,-102,-150,-1.5,-101,3.62,T-Mobile Park,9,1
2018-08-18,2018,WSH,MIA,5,7,-195,-1.5,-105,9.5,-115,-105,175,1.5,-115,6.28,Nationals Park,12,-2
2018-08-18,2018,STL,MIL,7,2,-152,-1.5,130,8.0,-110,-110,137,1.5,-150,4.83,Busch Stadium,9,5
2018-08-18,2018,DET,MIN,7,5,152,1.5,-135,9.5,-115,-105,-172,-1.5,114,3.77,Target Field,12,2
2018-08-18,2018,PHI,NYM,1,3,-105,1.5,-170,7.5,-120,100,-105,-1.5,148,3.84,Citizens Bank Park,4,-2
2018-08-18,2018,TOR,NYY,6,11,280,1.5,144,9.0,-125,105,-330,-1.5,-165,2.37,Yankee Stadium,17,-5
2018-08-18,2018,HOU,OAK,1,7,-107,1.5,-220,7.5,-120,100,-103,-1.5,184,3.88,Oakland Coliseum,8,-6
2018-08-18,2018,NYM,PHI,3,1,-105,-1.5,148,7.5,-120,100,-105,1.5,-170,3.84,Citizens Bank Park,4,2
2018-08-18,2018,CHC,PIT,1,3,135,1.5,-166,8.5,-120,100,-150,-1.5,145,3.62,PNC Park,4,-2
2018-08-18,2018,ARI,SD,6,7,-160,-1.5,-105,8.0,101,-121,145,1.5,-115,4.92,PETCO Park,13,-1
2018-08-18,2018,LAD,SEA,4,5,-150,-1.5,-101,8.5,-118,-102,135,1.5,-119,5.1,T-Mobile Park,9,-1
2018-08-18,2018,CIN,SF,7,1,152,1.5,-110,8.5,-110,-110,-167,-1.5,-110,3.37,Great American Ballpark,8,6
2018-08-18,2018,MIL,STL,2,7,137,1.5,-150,8.0,-110,-110,-152,-1.5,130,3.38,Busch Stadium,9,-5
2018-08-18,2018,BOS,TB,5,2,-215,-1.5,-115,8.5,-110,-110,185,1.5,-105,5.8,Fenway Park,7,3
2018-08-18,2018,LAA,TEX,11,7,-136,-1.5,116,10.5,-109,-111,121,1.5,-136,6.05,Rangers Ballpark,18,4
2018-08-18,2018,NYY,TOR,11,6,-330,-1.5,-165,9.0,-125,105,280,1.5,144,6.91,Yankee Stadium,17,5
2018-08-18,2018,MIA,WSH,7,5,175,1.5,-115,9.5,-115,-105,-195,-1.5,-105,3.45,Nationals Park,12,2
2018-08-19,2018,SD,ARI,3,4,170,1.5,114,8.0,-115,-105,-200,-1.5,-133,2.96,PETCO Park,7,-1
2018-08-19,2018,COL,ATL,4,2,116,1.5,-190,8.0,-103,-117,-131,-1.5,163,3.7,Suntrust Park,6,2
2018-08-19,2018,CLE,BAL,8,0,-253,-1.5,-127,8.5,100,-120,213,1.5,107,6.09,Progressive Field,8,8
2018-08-19,2018,TB,BOS,2,0,170,1.5,-110,9.0,-110,-110,-190,-1.5,-110,3.33,Fenway Park,2,2
2018-08-19,2018,PIT,CHC,2,1,-119,-1.5,170,8.0,-101,-119,109,1.5,-200,4.35,PNC Park,3,1
2018-08-19,2018,SF,CIN,4,11,-106,-1.5,144,8.5,-101,-119,-104,1.5,-165,4.37,Great American Ballpark,15,-7
2018-08-19,2018,BAL,CLE,0,8,213,1.5,107,8.5,100,-120,-253,-1.5,-127,2.72,Progressive Field,8,-8
2018-08-19,2018,ATL,COL,2,4,-131,-1.5,163,8.0,-103,-117,116,1.5,-190,4.54,Suntrust Park,6,-2
2018-08-19,2018,KC,CWS,6,7,136,1.5,-151,9.0,-125,105,-151,-1.5,132,3.81,Guaranteed Rate Field,13,-1
2018-08-19,2018,MIN,DET,5,4,-185,-1.5,-109,9.5,-111,-109,165,1.5,-111,6.17,Target Field,9,1
2018-08-19,2018,OAK,HOU,4,9,154,1.5,-120,7.5,-101,-119,-169,-1.5,-101,2.95,Oakland Coliseum,13,-5
2018-08-19,2018,CWS,KC,7,6,-151,-1.5,132,9.0,-125,105,136,1.5,-151,5.41,Guaranteed Rate Field,13,1
2018-08-19,2018,TEX,LAA,4,2,-105,-1.5,163,11.0,-115,-105,-105,1.5,-190,5.63,Rangers Ballpark,6,2
2018-08-19,2018,SEA,LAD,1,12,175,1.5,104,8.0,-108,-112,-195,-1.5,-123,2.91,T-Mobile Park,13,-11
2018-08-19,2018,WSH,MIA,1,12,-234,-1.5,-128,9.0,-109,-111,204,1.5,108,6.31,Nationals Park,13,-11
2018-08-19,2018,STL,MIL,1,2,-109,-1.5,184,8.5,100,-120,-101,1.5,-220,4.43,Busch Stadium,3,-1
2018-08-19,2018,DET,MIN,4,5,165,1.5,-111,9.5,-111,-109,-185,-1.5,-109,3.58,Target Field,9,-1
2018-08-19,2018,PHI,NYM,2,8,-190,-1.5,-105,8.5,-115,-105,170,1.5,-115,5.57,BB&T Ballpark at Bowman Field,10,-6
2018-08-19,2018,TOR,NYY,2,10,204,1.5,100,8.0,-114,-106,-234,-1.5,-120,2.63,Yankee Stadium,12,-8
2018-08-19,2018,HOU,OAK,9,4,-169,-1.5,-101,7.5,-101,-119,154,1.5,-120,4.71,Oakland Coliseum,13,5
2018-08-19,2018,NYM,PHI,8,2,170,1.5,-115,8.5,-115,-105,-190,-1.5,-105,3.15,BB&T Ballpark at Bowman Field,10,6
2018-08-19,2018,CHC,PIT,1,2,109,1.5,-200,8.0,-101,-119,-119,-1.5,170,3.83,PNC Park,3,-1
2018-08-19,2018,ARI,SD,4,3,-200,-1.5,-133,8.0,-115,-105,170,1.5,114,5.33,PETCO Park,7,1
2018-08-19,2018,LAD,SEA,12,1,-195,-1.5,-123,8.0,-108,-112,175,1.5,104,5.29,T-Mobile Park,13,11
2018-08-19,2018,CIN,SF,11,4,-104,1.5,-165,8.5,-101,-119,-106,-1.5,144,4.33,Great American Ballpark,15,7
2018-08-19,2018,MIL,STL,2,1,-101,1.5,-220,8.5,100,-120,-109,-1.5,184,4.27,Busch Stadium,3,1
2018-08-19,2018,BOS,TB,0,2,-190,-1.5,-110,9.0,-110,-110,170,1.5,-110,5.9,Fenway Park,2,-2
2018-08-19,2018,LAA,TEX,2,4,-105,1.5,-190,11.0,-115,-105,-105,-1.5,163,5.63,Rangers Ballpark,6,-2
2018-08-19,2018,NYY,TOR,10,2,-234,-1.5,-120,8.0,-114,-106,204,1.5,100,5.6,Yankee Stadium,12,8
2018-08-19,2018,MIA,WSH,12,1,204,1.5,108,9.0,-109,-111,-234,-1.5,-128,2.96,Nationals Park,13,11
2018-08-20,2018,PIT,ATL,0,1,-126,-1.5,160,8.0,-105,-115,116,1.5,-185,4.46,PNC Park,1,-1
2018-08-20,2018,TOR,BAL,5,3,-175,-1.5,110,9.0,105,-125,155,1.5,-130,5.73,Rogers Centre,8,2
2018-08-20,2018,CLE,BOS,5,4,261,1.5,-214,8.5,-103,-117,-311,-1.5,179,2.35,Fenway Park,9,1
2018-08-20,2018,MIL,CIN,5,2,-230,-1.5,-125,9.5,100,-120,200,1.5,105,6.62,Miller Park,7,3
2018-08-20,2018,BOS,CLE,4,5,-311,-1.5,179,8.5,-103,-117,261,1.5,-214,6.43,Fenway Park,9,-1
2018-08-20,2018,MIN,CWS,5,8,-163,-1.5,130,9.5,105,-125,148,1.5,-150,5.89,Target Field,13,-3
2018-08-20,2018,SEA,HOU,7,4,150,1.5,-105,8.0,-115,-105,-170,-1.5,-115,3.2,T-Mobile Park,11,3
2018-08-20,2018,TB,KC,1,0,-209,-1.5,-110,8.0,-109,-111,179,1.5,-110,5.41,Tropicana Field,1,1
2018-08-20,2018,STL,LAD,5,3,175,1.5,-110,8.5,-110,-110,-205,-1.5,-110,3.09,Dodger Stadium,8,2
2018-08-20,2018,CIN,MIL,2,5,200,1.5,105,9.5,100,-120,-230,-1.5,-125,3.17,Miller Park,7,-3
2018-08-20,2018,CWS,MIN,8,5,148,1.5,-150,9.5,105,-125,-163,-1.5,130,3.83,Target Field,13,3
2018-08-20,2018,SF,NYM,2,1,-111,-1.5,144,7.5,100,-120,101,1.5,-165,3.95,Citi Field,3,1
2018-08-20,2018,TEX,OAK,0,9,170,1.5,-119,9.0,-105,-115,-190,-1.5,-101,3.33,Oakland Coliseum,9,-9
2018-08-20,2018,ATL,PIT,1,0,116,1.5,-185,8.0,-105,-115,-126,-1.5,160,3.7,PNC Park,1,1
2018-08-20,2018,HOU,SEA,4,7,-170,-1.5,-115,8.0,-115,-105,150,1.5,-105,5.04,T-Mobile Park,11,-3
2018-08-20,2018,NYM,SF,1,2,101,1.5,-165,7.5,100,-120,-111,-1.5,144,3.73,Citi Field,3,-1
2018-08-20,2018,LAD,STL,3,5,-205,-1.5,-110,8.5,-110,-110,175,1.5,-110,5.71,Dodger Stadium,8,-2
2018-08-20,2018,KC,TB,0,1,179,1.5,-110,8.0,-109,-111,-209,-1.5,-110,2.87,Tropicana Field,1,-1
2018-08-20,2018,OAK,TEX,9,0,-190,-1.5,-101,9.0,-105,-115,170,1.5,-119,5.9,Oakland Coliseum,9,9
2018-08-20,2018,BAL,TOR,3,5,155,1.5,-130,9.0,105,-125,-175,-1.5,110,3.53,Rogers Centre,8,-2
2018-08-21,2018,LAA,ARI,4,5,185,1.5,-110,8.0,-112,-108,-215,-1.5,-110,2.81,Chase Field,9,-1
2018-08-21,2018,PIT,ATL,1,6,106,1.5,-156,7.5,-115,-105,-116,-1.5,136,3.64,PNC Park,7,-5
2018-08-21,2018,TOR,BAL,8,2,-139,-1.5,148,8.5,-119,-101,124,1.5,-170,4.94,Rogers Centre,10,6
2018-08-21,2018,CLE,BOS,6,3,142,1.5,-145,9.0,-115,-105,-157,-1.5,125,3.72,Fenway Park,9,3
2018-08-21,2018,DET,CHC,2,1,175,1.5,110,9.0,-110,-110,-205,-1.5,-130,3.27,Comerica Park,3,1
2018-08-21,2018,MIL,CIN,7,9,-200,-1.5,105,9.0,-105,-115,170,1.5,-125,6.0,Miller Park,16,-2
2018-08-21,2018,BOS,CLE,3,6,-157,-1.5,125,9.0,-115,-105,142,1.5,-145,5.5,Fenway Park,9,-3
2018-08-21,2018,SD,COL,4,3,155,1.5,-120,10.5,100,-120,-175,-1.5,100,4.12,Coors Field,7,1
2018-08-21,2018,MIN,CWS,5,2,-111,-1.5,144,8.5,-115,-105,101,1.5,-165,4.47,Guaranteed Rate Field,7,3
2018-08-21,2018,CHC,DET,1,2,-205,-1.5,-130,9.0,-110,-110,175,1.5,110,6.05,Comerica Park,3,-1
2018-08-21,2018,SEA,HOU,2,3,116,1.5,-144,8.5,-108,-112,-131,-1.5,124,3.94,T-Mobile Park,5,-1
2018-08-21,2018,TB,KC,4,1,-280,-1.5,-140,7.0,-120,100,240,1.5,120,5.16,Tropicana Field,5,3
2018-08-21,2018,ARI,LAA,5,4,-215,-1.5,-110,8.0,-112,-108,185,1.5,-110,5.46,Chase Field,9,1
2018-08-21,2018,STL,LAD,5,2,155,1.5,-135,8.5,-110,-110,-175,-1.5,115,3.33,Dodger Stadium,7,3
2018-08-21,2018,NYY,MIA,2,1,-220,-1.5,-139,7.5,100,-120,190,1.5,119,5.16,Marlins Park,3,1
2018-08-21,2018,CIN,MIL,9,7,170,1.5,-125,9.0,-105,-115,-200,-1.5,105,3.33,Miller Park,16,2
2018-08-21,2018,CWS,MIN,2,5,101,1.5,-165,8.5,-115,-105,-111,-1.5,144,4.23,Guaranteed Rate Field,7,-3
2018-08-21,2018,SF,NYM,3,6,100,1.5,-215,8.0,-113,-107,-110,-1.5,180,4.0,Citi Field,9,-3
2018-08-21,2018,MIA,NYY,1,2,190,1.5,119,7.5,100,-120,-220,-1.5,-139,2.59,Marlins Park,3,-1
2018-08-21,2018,TEX,OAK,0,6,190,1.5,-110,9.0,-105,-115,-220,-1.5,-110,3.1,Oakland Coliseum,6,-6
2018-08-21,2018,WSH,PHI,10,4,-129,-1.5,160,9.5,-110,-110,119,1.5,-185,5.35,Nationals Park,14,6
2018-08-21,2018,ATL,PIT,6,1,-116,-1.5,136,7.5,-115,-105,106,1.5,-156,4.03,PNC Park,7,5
2018-08-21,2018,COL,SD,3,4,-175,-1.5,100,10.5,100,-120,155,1.5,-120,6.68,Coors Field,7,-1
2018-08-21,2018,HOU,SEA,3,2,-131,-1.5,124,8.5,-108,-112,116,1.5,-144,4.82,T-Mobile Park,5,1
2018-08-21,2018,NYM,SF,6,3,-110,-1.5,180,8.0,-113,-107,100,1.5,-215,4.19,Citi Field,9,3
2018-08-21,2018,LAD,STL,2,5,-175,-1.5,115,8.5,-110,-110,155,1.5,-135,5.41,Dodger Stadium,7,-3
2018-08-21,2018,KC,TB,1,4,240,1.5,120,7.0,-120,100,-280,-1.5,-140,2.06,Tropicana Field,5,-3
2018-08-21,2018,OAK,TEX,6,0,-220,-1.5,-110,9.0,-105,-115,190,1.5,-110,6.19,Oakland Coliseum,6,6
2018-08-21,2018,BAL,TOR,2,8,124,1.5,-170,8.5,-119,-101,-139,-1.5,148,3.79,Rogers Centre,10,-6
2018-08-21,2018,PHI,WSH,4,10,119,1.5,-185,9.5,-110,-110,-129,-1.5,160,4.34,Nationals Park,14,-6
2018-08-22,2018,LAA,ARI,1,5,188,1.5,102,8.5,-121,101,-218,-1.5,-122,2.95,Chase Field,6,-4
2018-08-22,2018,PIT,ATL,1,2,-101,1.5,-160,8.0,-121,101,-109,-1.5,140,4.02,PNC Park,3,-1
2018-08-22,2018,TOR,BAL,6,0,-170,-1.5,118,9.5,103,-123,150,1.5,-138,5.98,Rogers Centre,6,6
2018-08-22,2018,CLE,BOS,4,10,-124,-1.5,126,9.5,100,-120,114,1.5,-146,5.26,Fenway Park,14,-6
2018-08-22,2018,DET,CHC,2,8,160,1.5,-101,9.5,-106,-114,-180,-1.5,-119,3.65,Comerica Park,10,-6
2018-08-22,2018,MIL,CIN,4,0,-271,-1.5,-139,9.0,-119,-101,231,1.5,119,6.57,Miller Park,4,4
2018-08-22,2018,BOS,CLE,10,4,114,1.5,-146,9.5,100,-120,-124,-1.5,126,4.44,Fenway Park,14,6
2018-08-22,2018,SD,COL,2,6,235,1.5,130,10.0,-101,-119,-275,-1.5,-150,2.99,Coors Field,8,-4
2018-08-22,2018,MIN,CWS,3,7,-101,1.5,-214,8.5,-110,-110,-109,-1.5,179,4.27,Guaranteed Rate Field,10,-4
2018-08-22,2018,CHC,DET,8,2,-180,-1.5,-119,9.5,-106,-114,160,1.5,-101,6.11,Comerica Park,10,6
2018-08-22,2018,SEA,HOU,7,10,137,1.5,-125,8.0,-110,-110,-152,-1.5,105,3.38,T-Mobile Park,17,-3
2018-08-22,2018,TB,KC,6,3,-180,-1.5,120,7.0,-125,105,160,1.5,-140,4.5,Tropicana Field,9,3
2018-08-22,2018,ARI,LAA,5,1,-218,-1.5,-122,8.5,-121,101,188,1.5,102,5.83,Chase Field,6,4
2018-08-22,2018,STL,LAD,3,1,156,1.5,-140,7.5,-116,-104,-176,-1.5,120,2.93,Dodger Stadium,4,2
2018-08-22,2018,NYY,MIA,3,9,-170,-1.5,-110,7.5,-105,-115,150,1.5,-110,4.72,Marlins Park,12,-6
2018-08-22,2018,CIN,MIL,0,4,231,1.5,119,9.0,-119,-101,-271,-1.5,-139,2.72,Miller Park,4,-4
2018-08-22,2018,CWS,MIN,7,3,-109,-1.5,179,8.5,-110,-110,-101,1.5,-214,4.43,Guaranteed Rate Field,10,4
2018-08-22,2018,SF,NYM,3,5,141,1.5,-160,7.0,-125,105,-156,-1.5,140,2.9,Citi Field,8,-2
2018-08-22,2018,MIA,NYY,9,3,150,1.5,-110,7.5,-105,-115,-170,-1.5,-110,3.0,Marlins Park,12,6
2018-08-22,2018,TEX,OAK,4,2,139,1.5,-145,8.5,-120,100,-154,-1.5,125,3.56,Oakland Coliseum,6,2
2018-08-22,2018,WSH,PHI,8,7,-153,-1.5,144,8.5,-119,-101,138,1.5,-165,5.14,Nationals Park,15,1
2018-08-22,2018,ATL,PIT,2,1,-109,-1.5,140,8.0,-121,101,-101,1.5,-160,4.17,PNC Park,3,1
2018-08-22,2018,COL,SD,6,2,-275,-1.5,-150,10.0,-101,-119,235,1.5,130,7.33,Coors Field,8,4
2018-08-22,2018,HOU,SEA,10,7,-152,-1.5,105,8.0,-110,-110,137,1.5,-125,4.83,T-Mobile Park,17,3
2018-08-22,2018,NYM,SF,5,3,-156,-1.5,140,7.0,-125,105,141,1.5,-160,4.27,Citi Field,8,2
2018-08-22,2018,LAD,STL,1,3,-176,-1.5,120,7.5,-116,-104,156,1.5,-140,4.78,Dodger Stadium,4,-2
2018-08-22,2018,KC,TB,3,6,160,1.5,-140,7.0,-125,105,-180,-1.5,120,2.69,Tropicana Field,9,-3
2018-08-22,2018,OAK,TEX,2,4,-154,-1.5,125,8.5,-120,100,139,1.5,-145,5.15,Oakland Coliseum,6,-2
2018-08-22,2018,BAL,TOR,0,6,150,1.5,-138,9.5,103,-123,-170,-1.5,118,3.8,Rogers Centre,6,-6
2018-08-22,2018,PHI,WSH,7,8,138,1.5,-165,8.5,-119,-101,-153,-1.5,144,3.57,Nationals Park,15,-1
2018-08-23,2018,MIA,ATL,0,5,170,1.5,104,8.5,-108,-112,-190,-1.5,-124,3.15,Marlins Park,5,-5
2018-08-23,2018,CLE,BOS,0,7,170,1.5,-110,10.0,-107,-113,-200,-1.5,-110,3.7,Fenway Park,7,-7
2018-08-23,2018,CIN,CHC,1,7,175,1.5,-120,9.0,-101,-119,-205,-1.5,100,3.27,Wrigley Field,8,-6
2018-08-23,2018,CHC,CIN,7,1,-205,-1.5,100,9.0,-101,-119,175,1.5,-120,6.05,Wrigley Field,8,6
2018-08-23,2018,BOS,CLE,7,0,-200,-1.5,-110,10.0,-107,-113,170,1.5,-110,6.67,Fenway Park,7,7
2018-08-23,2018,SD,COL,3,4,177,1.5,100,10.5,-110,-110,-207,-1.5,-120,3.79,Coors Field,7,-1
2018-08-23,2018,DET,CWS,7,2,-129,-1.5,148,8.5,-103,-117,119,1.5,-170,4.79,Comerica Park,9,5
2018-08-23,2018,CWS,DET,2,7,119,1.5,-170,8.5,-103,-117,-129,-1.5,148,3.88,Comerica Park,9,-5
2018-08-23,2018,TB,KC,4,3,-175,-1.5,124,7.0,102,-122,155,1.5,-144,4.45,Tropicana Field,7,1
2018-08-23,2018,ATL,MIA,5,0,-190,-1.5,-124,8.5,-108,-112,170,1.5,104,5.57,Marlins Park,5,5
2018-08-23,2018,OAK,MIN,4,6,-172,-1.5,-117,9.0,-123,103,152,1.5,-103,5.69,Target Field,10,-2
2018-08-23,2018,SF,NYM,3,1,132,1.5,-185,6.5,-113,-107,-147,-1.5,160,2.8,Citi Field,4,2
2018-08-23,2018,MIN,OAK,6,4,152,1.5,-103,9.0,-123,103,-172,-1.5,-117,3.57,Target Field,10,2
2018-08-23,2018,WSH,PHI,0,2,-161,-1.5,145,7.0,-110,-110,146,1.5,-166,4.32,Nationals Park,2,-2
2018-08-23,2018,COL,SD,4,3,-207,-1.5,-120,10.5,-110,-110,177,1.5,100,7.08,Coors Field,7,1
2018-08-23,2018,NYM,SF,1,3,-147,-1.5,160,6.5,-113,-107,132,1.5,-185,3.87,Citi Field,4,-2
2018-08-23,2018,KC,TB,3,4,155,1.5,-144,7.0,102,-122,-175,-1.5,124,2.75,Tropicana Field,7,-1
2018-08-23,2018,PHI,WSH,2,0,146,1.5,-166,7.0,-110,-110,-161,-1.5,145,2.85,Nationals Park,2,2
2018-08-24,2018,SEA,ARI,6,3,150,1.5,-150,8.5,-119,-101,-165,-1.5,130,3.4,Chase Field,9,3
2018-08-24,2018,MIA,ATL,1,0,172,1.5,101,7.5,-105,-115,-192,-1.5,-120,2.76,Marlins Park,1,1
2018-08-24,2018,NYY,BAL,7,5,-184,-1.5,-125,9.0,102,-122,164,1.5,105,5.83,Camden Yards,12,2
2018-08-24,2018,TB,BOS,10,3,109,1.5,-155,8.5,100,-120,-119,-1.5,135,4.07,Tropicana Field,13,7
2018-08-24,2018,CIN,CHC,2,3,172,1.5,-107,11.5,-103,-117,-202,-1.5,-113,4.23,Wrigley Field,5,-1
2018-08-24,2018,CHC,CIN,3,2,-202,-1.5,-113,11.5,-103,-117,172,1.5,-107,7.69,Wrigley Field,5,1
2018-08-24,2018,KC,CLE,5,4,181,1.5,115,9.5,100,-120,-211,-1.5,-135,3.38,Kauffman Stadium,9,1
2018-08-24,2018,STL,COL,7,5,-116,-1.5,130,11.0,-101,-119,106,1.5,-150,5.91,Coors Field,12,2
2018-08-24,2018,DET,CWS,3,6,-140,-1.5,146,8.0,-120,100,125,1.5,-167,4.67,Comerica Park,9,-3
2018-08-24,2018,CWS,DET,6,3,125,1.5,-167,8.0,-120,100,-140,-1.5,146,3.56,Comerica Park,9,3
2018-08-24,2018,LAA,HOU,3,9,119,1.5,-140,8.0,100,-120,-134,-1.5,120,3.65,Angel Stadium,12,-6
2018-08-24,2018,CLE,KC,4,5,-211,-1.5,-135,9.5,100,-120,181,1.5,115,6.45,Kauffman Stadium,9,-1
2018-08-24,2018,HOU,LAA,9,3,-134,-1.5,120,8.0,100,-120,119,1.5,-140,4.58,Angel Stadium,12,6
2018-08-24,2018,SD,LAD,1,11,208,1.5,108,8.5,-102,-118,-248,-1.5,-128,2.76,Dodger Stadium,12,-10
2018-08-24,2018,ATL,MIA,0,1,-192,-1.5,-120,7.5,-105,-115,172,1.5,101,4.93,Marlins Park,1,-1
2018-08-24,2018,PIT,MIL,6,7,116,1.5,-190,8.5,-105,-115,-126,-1.5,163,3.94,Miller Park,13,-1
2018-08-24,2018,OAK,MIN,7,1,-133,-1.5,119,9.0,-123,103,118,1.5,-139,5.14,Target Field,8,6
2018-08-24,2018,WSH,NYM,0,3,-144,-1.5,112,9.0,-101,-119,129,1.5,-132,5.31,Citi Field,3,-3
2018-08-24,2018,BAL,NYY,5,7,164,1.5,105,9.0,102,-122,-184,-1.5,-125,3.41,Camden Yards,12,-2
2018-08-24,2018,MIN,OAK,1,7,118,1.5,-139,9.0,-123,103,-133,-1.5,119,4.13,Target Field,8,-6
2018-08-24,2018,TOR,PHI,4,2,119,1.5,-135,9.0,-110,-110,-129,-1.5,115,4.11,Rogers Centre,6,2
2018-08-24,2018,MIL,PIT,7,6,-126,-1.5,163,8.5,-105,-115,116,1.5,-190,4.74,Miller Park,13,1
2018-08-24,2018,LAD,SD,11,1,-248,-1.5,-128,8.5,-102,-118,208,1.5,108,6.06,Dodger Stadium,12,10
2018-08-24,2018,ARI,SEA,3,6,-165,-1.5,130,8.5,-119,-101,150,1.5,-150,5.29,Chase Field,9,-3
2018-08-24,2018,TEX,SF,7,6,154,1.5,-135,8.5,-103,-117,-174,-1.5,115,3.35,AT&T Park,13,1
2018-08-24,2018,COL,STL,5,7,106,1.5,-150,11.0,-101,-119,-116,-1.5,130,5.34,Coors Field,12,-2
2018-08-24,2018,BOS,TB,3,10,-119,-1.5,135,8.5,100,-120,109,1.5,-155,4.62,Tropicana Field,13,-7
2018-08-24,2018,SF,TEX,6,7,-174,-1.5,115,8.5,-103,-117,154,1.5,-135,5.4,AT&T Park,13,-1
2018-08-24,2018,PHI,TOR,2,4,-129,-1.5,115,9.0,-110,-110,119,1.5,-135,5.07,Rogers Centre,6,-2
2018-08-24,2018,NYM,WSH,3,0,129,1.5,-132,9.0,-101,-119,-144,-1.5,112,3.93,Citi Field,3,3
2018-08-25,2018,SEA,ARI,4,3,136,1.5,-160,8.5,-125,105,-151,-1.5,140,3.6,Chase Field,7,1
2018-08-25,2018,MIA,ATL,3,1,155,1.5,-108,7.5,-105,-115,-175,-1.5,-112,2.94,Marlins Park,4,2
2018-08-25,2018,NYY,BAL,10,3,-250,-1.5,-163,9.0,-105,-115,210,1.5,143,6.43,Camden Yards,13,7
2018-08-25,2018,NYY,BAL,5,1,-190,-1.5,-125,9.0,-113,-107,170,1.5,105,5.9,Camden Yards,6,4
2018-08-25,2018,TB,BOS,5,1,144,1.5,-117,8.0,-110,-110,-159,-1.5,-103,3.28,Tropicana Field,6,4
2018-08-25,2018,CIN,CHC,6,10,154,1.5,-135,10.5,-103,-117,-174,-1.5,115,4.13,Wrigley Field,16,-4
2018-08-25,2018,CHC,CIN,10,6,-174,-1.5,115,10.5,-103,-117,154,1.5,-135,6.67,Wrigley Field,16,4
2018-08-25,2018,KC,CLE,7,1,253,1.5,160,9.5,100,-120,-303,-1.5,-186,2.69,Kauffman Stadium,8,6
2018-08-25,2018,STL,COL,1,9,148,1.5,-130,11.0,101,-121,-163,-1.5,110,4.44,Coors Field,10,-8
2018-08-25,2018,DET,CWS,1,6,-119,-1.5,172,9.0,105,-125,109,1.5,-205,4.89,Comerica Park,7,-5
2018-08-25,2018,CWS,DET,6,1,109,1.5,-205,9.0,105,-125,-119,-1.5,172,4.31,Comerica Park,7,5
2018-08-25,2018,LAA,HOU,3,8,183,1.5,111,7.5,-118,-102,-213,-1.5,-131,2.65,Angel Stadium,11,-5
2018-08-25,2018,CLE,KC,1,7,-303,-1.5,-186,9.5,100,-120,253,1.5,160,7.14,Kauffman Stadium,8,-6
2018-08-25,2018,HOU,LAA,8,3,-213,-1.5,-131,7.5,-118,-102,183,1.5,111,5.1,Angel Stadium,11,5
2018-08-25,2018,SD,LAD,4,5,315,1.5,148,7.5,-110,-110,-375,-1.5,-171,1.81,Dodger Stadium,9,-1
2018-08-25,2018,ATL,MIA,1,3,-175,-1.5,-112,7.5,-105,-115,155,1.5,-108,4.77,Marlins Park,4,-2
2018-08-25,2018,PIT,MIL,9,1,122,1.5,-175,8.5,-117,-103,-137,-1.5,151,3.83,Miller Park,10,8
2018-08-25,2018,OAK,MIN,6,2,-158,-1.5,-111,9.5,-115,-105,143,1.5,-109,5.82,Target Field,8,4
2018-08-25,2018,WSH,NYM,0,3,-102,1.5,-220,8.0,-109,-111,-108,-1.5,184,4.04,Citi Field,3,-3
2018-08-25,2018,BAL,NYY,3,10,210,1.5,143,9.0,-105,-115,-250,-1.5,-163,2.9,Camden Yards,13,-7
2018-08-25,2018,BAL,NYY,1,5,170,1.5,105,9.0,-113,-107,-190,-1.5,-125,3.33,Camden Yards,6,-4
2018-08-25,2018,MIN,OAK,2,6,143,1.5,-109,9.5,-115,-105,-158,-1.5,-111,3.91,Target Field,8,-4
2018-08-25,2018,TOR,PHI,8,6,121,1.5,-134,9.0,100,-120,-136,-1.5,114,4.07,Rogers Centre,14,2
2018-08-25,2018,MIL,PIT,1,9,-137,-1.5,151,8.5,-117,-103,122,1.5,-175,4.91,Miller Park,10,-8
2018-08-25,2018,LAD,SD,5,4,-375,-1.5,-171,7.5,-110,-110,315,1.5,148,5.92,Dodger Stadium,9,1
2018-08-25,2018,ARI,SEA,3,4,-151,-1.5,140,8.5,-125,105,136,1.5,-160,5.11,Chase Field,7,-1
2018-08-25,2018,TEX,SF,3,5,135,1.5,-160,8.5,-105,-115,-150,-1.5,140,3.62,AT&T Park,8,-2
2018-08-25,2018,COL,STL,9,1,-163,-1.5,110,11.0,101,-121,148,1.5,-130,6.82,Coors Field,10,8
2018-08-25,2018,BOS,TB,1,5,-159,-1.5,-103,8.0,-110,-110,144,1.5,-117,4.91,Tropicana Field,6,-4
2018-08-25,2018,SF,TEX,5,3,-150,-1.5,140,8.5,-105,-115,135,1.5,-160,5.1,AT&T Park,8,2
2018-08-25,2018,PHI,TOR,6,8,-136,-1.5,114,9.0,100,-120,121,1.5,-134,5.19,Rogers Centre,14,-2
2018-08-25,2018,NYM,WSH,3,0,-108,-1.5,184,8.0,-109,-111,-102,1.5,-220,4.15,Citi Field,3,3
2018-08-26,2018,SEA,ARI,2,5,152,1.5,-143,8.0,-116,-104,-167,-1.5,123,3.17,Chase Field,7,-3
2018-08-26,2018,MIA,ATL,0,4,165,1.5,-104,7.5,100,-120,-185,-1.5,-115,2.83,Marlins Park,4,-4
2018-08-26,2018,NYY,BAL,5,3,-275,-1.5,-160,8.5,-112,-108,235,1.5,140,6.23,Camden Yards,8,2
2018-08-26,2018,TB,BOS,9,1,-113,-1.5,172,7.0,110,-130,103,1.5,-205,3.71,Tropicana Field,10,8
2018-08-26,2018,CIN,CHC,0,9,245,1.5,120,10.5,106,-126,-285,-1.5,-140,3.04,Wrigley Field,9,-9
2018-08-26,2018,CHC,CIN,9,0,-285,-1.5,-140,10.5,106,-126,245,1.5,120,7.77,Wrigley Field,9,9
2018-08-26,2018,KC,CLE,5,12,200,1.5,130,9.5,-109,-111,-230,-1.5,-150,3.17,Kauffman Stadium,17,-7
2018-08-26,2018,STL,COL,12,3,133,1.5,-137,11.5,-105,-115,-148,-1.5,117,4.94,Coors Field,15,9
2018-08-26,2018,DET,CWS,2,7,105,1.5,-154,8.0,-119,-101,-115,-1.5,134,3.9,Comerica Park,9,-5
2018-08-26,2018,CWS,DET,7,2,-115,-1.5,134,8.0,-119,-101,105,1.5,-154,4.28,Comerica Park,9,5
2018-08-26,2018,LAA,HOU,1,3,114,1.5,-144,8.5,-120,100,-124,-1.5,123,3.97,Angel Stadium,4,-2
2018-08-26,2018,CLE,KC,12,5,-230,-1.5,-150,9.5,-109,-111,200,1.5,130,6.62,Kauffman Stadium,17,7
2018-08-26,2018,HOU,LAA,3,1,-124,-1.5,123,8.5,-120,100,114,1.5,-144,4.71,Angel Stadium,4,2
2018-08-26,2018,SD,LAD,3,7,200,1.5,-104,8.0,-105,-115,-230,-1.5,-116,2.67,Dodger Stadium,10,-4
2018-08-26,2018,ATL,MIA,4,0,-185,-1.5,-115,7.5,100,-120,165,1.5,-104,4.87,Marlins Park,4,4
2018-08-26,2018,PIT,MIL,4,7,119,1.5,-180,8.5,-119,-101,-134,-1.5,155,3.88,Miller Park,11,-3
2018-08-26,2018,OAK,MIN,6,2,114,1.5,-193,9.0,-115,-105,-124,-1.5,165,4.21,Target Field,8,4
2018-08-26,2018,WSH,NYM,15,0,-105,1.5,-220,8.5,-120,100,-105,-1.5,184,4.35,Citi Field,15,15
2018-08-26,2018,BAL,NYY,3,5,235,1.5,140,8.5,-112,-108,-275,-1.5,-160,2.54,Camden Yards,8,-2
2018-08-26,2018,MIN,OAK,2,6,-124,-1.5,165,9.0,-115,-105,114,1.5,-193,4.98,Target Field,8,-4
2018-08-26,2018,TOR,PHI,3,8,108,1.5,-152,9.0,-123,103,-118,-1.5,132,4.33,Rogers Centre,11,-5
2018-08-26,2018,MIL,PIT,7,4,-134,-1.5,155,8.5,-119,-101,119,1.5,-180,4.87,Miller Park,11,3
2018-08-26,2018,LAD,SD,7,3,-230,-1.5,-116,8.0,-105,-115,200,1.5,-104,5.58,Dodger Stadium,10,4
2018-08-26,2018,ARI,SEA,5,2,-167,-1.5,123,8.0,-116,-104,152,1.5,-143,5.0,Chase Field,7,3
2018-08-26,2018,TEX,SF,1,3,136,1.5,-158,8.5,107,-127,-151,-1.5,138,3.6,AT&T Park,4,-2
2018-08-26,2018,COL,STL,3,12,-148,-1.5,117,11.5,-105,-115,133,1.5,-137,6.86,Coors Field,15,-9
2018-08-26,2018,BOS,TB,1,9,103,1.5,-205,7.0,110,-130,-113,-1.5,172,3.45,Tropicana Field,10,-8
2018-08-26,2018,SF,TEX,3,1,-151,-1.5,138,8.5,107,-127,136,1.5,-158,5.11,AT&T Park,4,2
2018-08-26,2018,PHI,TOR,8,3,-118,-1.5,132,9.0,-123,103,108,1.5,-152,4.87,Rogers Centre,11,5
2018-08-26,2018,NYM,WSH,0,15,-105,-1.5,184,8.5,-120,100,-105,1.5,-220,4.35,Citi Field,15,-15
2018-08-27,2018,SF,ARI,2,0,154,1.5,-110,7.0,-120,100,-174,-1.5,-110,2.76,AT&T Park,2,2
2018-08-27,2018,TOR,BAL,0,7,-131,-1.5,104,9.5,-118,-102,116,1.5,-122,5.39,Camden Yards,7,-7
2018-08-27,2018,NYM,CHC,4,7,119,1.5,-172,10.5,100,-120,-129,-1.5,149,4.79,Wrigley Field,11,-3
2018-08-27,2018,LAA,COL,10,7,130,1.5,-130,8.0,-115,-105,-145,-1.5,110,3.48,Angel Stadium,17,3
2018-08-27,2018,NYY,CWS,2,6,-255,-1.5,-132,9.0,105,-125,215,1.5,112,6.46,Yankee Stadium,8,-4
2018-08-27,2018,OAK,HOU,4,11,170,1.5,-119,8.0,-110,-110,-200,-1.5,-101,2.96,Minute Maid Park,15,-7
2018-08-27,2018,COL,LAA,7,10,-145,-1.5,110,8.0,-115,-105,130,1.5,-130,4.73,Angel Stadium,17,-3
2018-08-27,2018,CHC,NYM,7,4,-129,-1.5,149,10.5,100,-120,119,1.5,-172,5.91,Wrigley Field,11,3
2018-08-27,2018,CWS,NYY,6,2,215,1.5,112,9.0,105,-125,-255,-1.5,-132,2.86,Yankee Stadium,8,4
2018-08-27,2018,HOU,OAK,11,4,-200,-1.5,-101,8.0,-110,-110,170,1.5,-119,5.33,Minute Maid Park,15,7
2018-08-27,2018,WSH,PHI,5,3,-110,-1.5,144,9.0,-105,-115,100,1.5,-165,4.71,Citizens Bank Park,8,2
2018-08-27,2018,ARI,SF,0,2,-174,-1.5,-110,7.0,-120,100,154,1.5,-110,4.45,AT&T Park,2,-2
2018-08-27,2018,BAL,TOR,7,0,116,1.5,-122,9.5,-118,-102,-131,-1.5,104,4.4,Camden Yards,7,7
2018-08-27,2018,PHI,WSH,3,5,100,1.5,-165,9.0,-105,-115,-110,-1.5,144,4.5,Citizens Bank Park,8,-2
2018-08-28,2018,SF,ARI,1,0,-105,-1.5,184,7.0,-120,100,-105,1.5,-220,3.59,AT&T Park,1,1
2018-08-28,2018,TB,ATL,5,9,117,1.5,-195,8.5,-105,-115,-127,-1.5,166,3.92,Suntrust Park,14,-4
2018-08-28,2018,TOR,BAL,5,12,-118,-1.5,120,9.5,-110,-110,108,1.5,-140,5.14,Camden Yards,17,-7
2018-08-28,2018,MIA,BOS,7,8,220,1.5,123,10.5,-110,-110,-260,-1.5,-143,3.28,Fenway Park,15,-1
2018-08-28,2018,NYM,CHC,1,2,107,1.5,-195,8.5,-110,-110,-117,-1.5,166,4.11,Wrigley Field,3,-1
2018-08-28,2018,MIL,CIN,7,9,-123,-1.5,130,9.0,-117,-103,113,1.5,-150,4.96,Great American Ballpark,16,-2
2018-08-28,2018,MIN,CLE,1,8,203,1.5,100,9.0,-110,-110,-233,-1.5,-120,2.97,Progressive Field,9,-7
2018-08-28,2018,LAA,COL,2,3,112,1.5,-155,8.5,-105,-115,-122,-1.5,135,4.01,Angel Stadium,5,-1
2018-08-28,2018,NYY,CWS,5,4,-247,-1.5,-137,10.0,-110,-110,207,1.5,117,7.12,Yankee Stadium,9,1
2018-08-28,2018,KC,DET,6,2,-118,-1.5,163,8.0,-110,-110,108,1.5,-190,4.33,Kauffman Stadium,8,4
2018-08-28,2018,OAK,HOU,4,3,196,1.5,-105,8.5,-120,100,-226,-1.5,-115,2.87,Minute Maid Park,7,1
2018-08-28,2018,DET,KC,2,6,108,1.5,-190,8.0,-110,-110,-118,-1.5,163,3.85,Kauffman Stadium,8,-4
2018-08-28,2018,COL,LAA,3,2,-122,-1.5,135,8.5,-105,-115,112,1.5,-155,4.67,Angel Stadium,5,1
2018-08-28,2018,TEX,LAD,4,8,200,1.5,130,11.5,-110,-110,-240,-1.5,-150,3.83,Rangers Ballpark,12,-4
2018-08-28,2018,BOS,MIA,8,7,-260,-1.5,-143,10.5,-110,-110,220,1.5,123,7.58,Fenway Park,15,1
2018-08-28,2018,CIN,MIL,9,7,113,1.5,-150,9.0,-117,-103,-123,-1.5,130,4.23,Great American Ballpark,16,2
2018-08-28,2018,CLE,MIN,8,1,-233,-1.5,-120,9.0,-110,-110,203,1.5,100,6.3,Progressive Field,9,7
2018-08-28,2018,CHC,NYM,2,1,-117,-1.5,166,8.5,-110,-110,107,1.5,-195,4.58,Wrigley Field,3,1
2018-08-28,2018,CWS,NYY,4,5,207,1.5,117,10.0,-110,-110,-247,-1.5,-137,3.26,Yankee Stadium,9,-1
2018-08-28,2018,HOU,OAK,3,4,-226,-1.5,-115,8.5,-120,100,196,1.5,-105,5.89,Minute Maid Park,7,-1
2018-08-28,2018,WSH,PHI,5,4,-110,-1.5,144,7.0,-128,108,100,1.5,-165,3.67,Citizens Bank Park,9,1
2018-08-28,2018,STL,PIT,5,2,-167,-1.5,115,8.0,-110,-110,152,1.5,-135,5.0,Busch Stadium,7,3
2018-08-28,2018,SEA,SD,1,2,-112,-1.5,140,8.5,-110,-110,102,1.5,-160,4.49,PETCO Park,3,-1
2018-08-28,2018,SD,SEA,2,1,102,1.5,-160,8.5,-110,-110,-112,-1.5,140,4.21,PETCO Park,3,1
2018-08-28,2018,ARI,SF,0,1,-105,1.5,-220,7.0,-120,100,-105,-1.5,184,3.59,AT&T Park,1,-1
2018-08-28,2018,PIT,STL,2,5,152,1.5,-135,8.0,-110,-110,-167,-1.5,115,3.17,Busch Stadium,7,-3
2018-08-28,2018,ATL,TB,9,5,-127,-1.5,166,8.5,-105,-115,117,1.5,-195,4.76,Suntrust Park,14,4
2018-08-28,2018,LAD,TEX,8,4,-240,-1.5,-150,11.5,-110,-110,200,1.5,130,8.12,Rangers Ballpark,12,4
2018-08-28,2018,BAL,TOR,12,5,108,1.5,-140,9.5,-110,-110,-118,-1.5,120,4.57,Camden Yards,17,7
2018-08-28,2018,PHI,WSH,4,5,100,1.5,-165,7.0,-128,108,-110,-1.5,144,3.5,Citizens Bank Park,9,-1
2018-08-29,2018,SF,ARI,1,3,109,1.5,-160,7.5,101,-121,-119,-1.5,140,3.59,AT&T Park,4,-2
2018-08-29,2018,TB,ATL,8,5,119,1.5,-190,8.0,-115,-105,-129,-1.5,163,3.65,Suntrust Park,13,3
2018-08-29,2018,TOR,BAL,5,10,-114,-1.5,141,9.0,-115,-105,104,1.5,-161,4.79,Camden Yards,15,-5
2018-08-29,2018,MIA,BOS,6,14,300,1.5,163,10.0,-115,-105,-360,-1.5,-190,2.5,Fenway Park,20,-8
2018-08-29,2018,NYM,CHC,10,3,163,1.5,-125,8.5,-115,-105,-183,-1.5,105,3.23,Wrigley Field,13,7
2018-08-29,2018,MIL,CIN,13,12,-150,-1.5,100,9.0,-125,105,135,1.5,-120,5.4,Great American Ballpark,25,1
2018-08-29,2018,MIN,CLE,4,3,163,1.5,-117,10.0,-110,-110,-183,-1.5,-103,3.8,Progressive Field,7,1
2018-08-29,2018,NYY,CWS,1,4,-275,-1.5,-146,9.5,-101,-119,235,1.5,126,6.97,Yankee Stadium,5,-3
2018-08-29,2018,KC,DET,9,2,-109,-1.5,184,7.5,-110,-110,-101,1.5,-220,3.91,Kauffman Stadium,11,7
2018-08-29,2018,OAK,HOU,4,5,135,1.5,-157,8.5,-105,-115,-150,-1.5,137,3.62,Minute Maid Park,9,-1
2018-08-29,2018,DET,KC,2,9,-101,1.5,-220,7.5,-110,-110,-109,-1.5,184,3.77,Kauffman Stadium,11,-7
2018-08-29,2018,TEX,LAD,1,3,150,1.5,-101,10.0,-101,-119,-165,-1.5,-119,4.0,Rangers Ballpark,4,-2
2018-08-29,2018,BOS,MIA,14,6,-360,-1.5,-190,10.0,-115,-105,300,1.5,163,7.83,Fenway Park,20,8
2018-08-29,2018,CIN,MIL,12,13,135,1.5,-120,9.0,-125,105,-150,-1.5,100,3.83,Great American Ballpark,25,-1
2018-08-29,2018,CLE,MIN,3,4,-183,-1.5,-103,10.0,-110,-110,163,1.5,-117,6.47,Progressive Field,7,-1
2018-08-29,2018,CHC,NYM,3,10,-183,-1.5,105,8.5,-115,-105,163,1.5,-125,5.5,Wrigley Field,13,-7
2018-08-29,2018,CWS,NYY,4,1,235,1.5,126,9.5,-101,-119,-275,-1.5,-146,2.84,Yankee Stadium,5,3
2018-08-29,2018,HOU,OAK,5,4,-150,-1.5,137,8.5,-105,-115,135,1.5,-157,5.1,Minute Maid Park,9,1
2018-08-29,2018,WSH,PHI,6,8,124,1.5,-150,9.5,-112,-108,-139,-1.5,130,4.24,Citizens Bank Park,14,-2
2018-08-29,2018,STL,PIT,0,2,-157,-1.5,135,7.5,-119,-101,142,1.5,-155,4.58,Busch Stadium,2,-2
2018-08-29,2018,SEA,SD,3,8,188,-1.5,147,8.0,-110,-110,-218,1.5,-169,2.78,PETCO Park,11,-5
2018-08-29,2018,SD,SEA,8,3,-218,1.5,-169,8.0,-110,-110,188,-1.5,147,5.48,PETCO Park,11,5
2018-08-29,2018,ARI,SF,3,1,-119,-1.5,140,7.5,101,-121,109,1.5,-160,4.08,AT&T Park,4,2
2018-08-29,2018,PIT,STL,2,0,142,1.5,-155,7.5,-119,-101,-157,-1.5,135,3.1,Busch Stadium,2,2
2018-08-29,2018,ATL,TB,5,8,-129,-1.5,163,8.0,-115,-105,119,1.5,-190,4.51,Suntrust Park,13,-3
2018-08-29,2018,LAD,TEX,3,1,-165,-1.5,-119,10.0,-101,-119,150,1.5,-101,6.23,Rangers Ballpark,4,2
2018-08-29,2018,BAL,TOR,10,5,104,1.5,-161,9.0,-115,-105,-114,-1.5,141,4.41,Camden Yards,15,5
2018-08-29,2018,PHI,WSH,8,6,-139,-1.5,130,9.5,-112,-108,124,1.5,-150,5.53,Citizens Bank Park,14,2
2018-08-30,2018,LAD,ARI,1,3,-155,-1.5,135,8.0,107,-127,140,1.5,-155,4.86,Dodger Stadium,4,-2
2018-08-30,2018,CHC,ATL,5,4,117,1.5,-175,8.5,-120,100,-132,-1.5,151,3.92,Suntrust Park,9,1
2018-08-30,2018,CWS,BOS,4,9,185,1.5,114,8.5,-110,-110,-215,-1.5,-134,2.98,Guaranteed Rate Field,13,-5
2018-08-30,2018,ATL,CHC,4,5,-132,-1.5,151,8.5,-120,100,117,1.5,-175,4.84,Suntrust Park,9,-1
2018-08-30,2018,MIL,CIN,2,1,-145,-1.5,104,9.0,-120,100,130,1.5,-124,5.33,Great American Ballpark,3,1
2018-08-30,2018,MIN,CLE,3,5,180,1.5,-104,8.5,-110,-110,-210,-1.5,-116,3.04,Progressive Field,8,-2
2018-08-30,2018,SD,COL,3,2,128,1.5,-132,7.5,106,-126,-143,-1.5,112,3.29,PETCO Park,5,1
2018-08-30,2018,BOS,CWS,9,4,-215,-1.5,-134,8.5,-110,-110,185,1.5,114,5.8,Guaranteed Rate Field,13,5
2018-08-30,2018,NYY,DET,7,8,-340,-1.5,-172,9.0,-105,-115,290,1.5,149,6.95,Yankee Stadium,15,-1
2018-08-30,2018,LAA,HOU,5,2,225,1.5,118,8.0,-119,-101,-265,-1.5,-138,2.46,Minute Maid Park,7,3
2018-08-30,2018,HOU,LAA,2,5,-265,-1.5,-138,8.0,-119,-101,225,1.5,118,5.81,Minute Maid Park,7,-3
2018-08-30,2018,ARI,LAD,3,1,140,1.5,-155,8.0,107,-127,-155,-1.5,135,3.33,Dodger Stadium,4,2
2018-08-30,2018,CIN,MIL,1,2,130,1.5,-124,9.0,-120,100,-145,-1.5,104,3.91,Great American Ballpark,3,-1
2018-08-30,2018,CLE,MIN,5,3,-210,-1.5,-116,8.5,-110,-110,180,1.5,-104,5.76,Progressive Field,8,2
2018-08-30,2018,DET,NYY,8,7,290,1.5,149,9.0,-105,-115,-340,-1.5,-172,2.31,Yankee Stadium,15,1
2018-08-30,2018,SEA,OAK,7,1,121,1.5,-172,8.5,-115,-105,-136,-1.5,149,3.85,Oakland Coliseum,8,6
2018-08-30,2018,STL,PIT,5,0,-115,-1.5,176,8.0,-101,-119,105,1.5,-210,4.28,Busch Stadium,5,5
2018-08-30,2018,COL,SD,2,3,-143,-1.5,112,7.5,106,-126,128,1.5,-132,4.41,PETCO Park,5,-1
2018-08-30,2018,OAK,SEA,1,7,-136,-1.5,149,8.5,-115,-105,121,1.5,-172,4.9,Oakland Coliseum,8,-6
2018-08-30,2018,PIT,STL,0,5,105,1.5,-210,8.0,-101,-119,-115,-1.5,176,3.9,Busch Stadium,5,-5
2018-08-31,2018,LAD,ARI,3,2,-140,-1.5,161,7.0,-120,100,125,1.5,-187,4.08,Dodger Stadium,5,1
2018-08-31,2018,PIT,ATL,3,2,117,1.5,-188,8.5,100,-120,-127,-1.5,162,3.92,Suntrust Park,5,1
2018-08-31,2018,KC,BAL,9,2,-124,-1.5,155,9.0,-110,-110,114,1.5,-180,4.98,Kauffman Stadium,11,7
2018-08-31,2018,CWS,BOS,6,1,150,1.5,-113,9.0,112,-132,-165,-1.5,-107,3.6,Guaranteed Rate Field,7,5
2018-08-31,2018,PHI,CHC,2,1,-124,-1.5,170,8.5,-110,-110,114,1.5,-200,4.71,Citizens Bank Park,3,1
2018-08-31,2018,STL,CIN,12,5,-180,-1.5,-101,9.0,-105,-115,160,1.5,-119,5.79,Busch Stadium,17,7
2018-08-31,2018,TB,CLE,0,3,165,1.5,-127,8.0,-116,-104,-185,-1.5,107,3.02,Progressive Field,3,-3
2018-08-31,2018,SD,COL,7,0,105,1.5,-155,8.5,-115,-105,-115,-1.5,135,4.15,PETCO Park,7,7
2018-08-31,2018,BOS,CWS,1,6,-165,-1.5,-107,9.0,112,-132,150,1.5,-113,5.6,Guaranteed Rate Field,7,-5
2018-08-31,2018,NYY,DET,7,5,-362,-1.5,-163,8.0,101,-121,302,1.5,143,6.27,Yankee Stadium,12,2
2018-08-31,2018,LAA,HOU,3,0,170,1.5,-123,9.0,-120,100,-190,-1.5,103,3.33,Minute Maid Park,3,3
2018-08-31,2018,BAL,KC,2,9,114,1.5,-180,9.0,-110,-110,-124,-1.5,155,4.21,Kauffman Stadium,11,-7
2018-08-31,2018,HOU,LAA,0,3,-190,-1.5,103,9.0,-120,100,170,1.5,-123,5.9,Minute Maid Park,3,-3
2018-08-31,2018,ARI,LAD,2,3,125,1.5,-187,7.0,-120,100,-140,-1.5,161,3.11,Dodger Stadium,5,-1
2018-08-31,2018,TOR,MIA,6,5,-113,-1.5,141,8.0,-107,-113,103,1.5,-161,4.24,Marlins Park,11,1
2018-08-31,2018,WSH,MIL,1,4,-121,-1.5,172,9.0,-105,-115,111,1.5,-205,4.93,Nationals Park,5,-3
2018-08-31,2018,TEX,MIN,7,10,-115,-1.5,148,11.5,100,-120,105,1.5,-170,6.15,Rangers Ballpark,17,-3
2018-08-31,2018,SF,NYM,7,0,-105,-1.5,188,7.0,-105,-115,-105,1.5,-225,3.59,AT&T Park,7,7
2018-08-31,2018,DET,NYY,5,7,302,1.5,143,8.0,101,-121,-362,-1.5,-163,1.99,Yankee Stadium,12,-2
2018-08-31,2018,SEA,OAK,5,7,119,1.5,-175,8.0,-105,-115,-134,-1.5,151,3.65,Oakland Coliseum,12,-2
2018-08-31,2018,CHC,PHI,1,2,114,1.5,-200,8.5,-110,-110,-124,-1.5,170,3.97,Citizens Bank Park,3,-1
2018-08-31,2018,ATL,PIT,2,3,-127,-1.5,162,8.5,100,-120,117,1.5,-188,4.76,Suntrust Park,5,-1
2018-08-31,2018,COL,SD,0,7,-115,-1.5,135,8.5,-115,-105,105,1.5,-155,4.55,PETCO Park,7,-7
2018-08-31,2018,OAK,SEA,7,5,-134,-1.5,151,8.0,-105,-115,119,1.5,-175,4.58,Oakland Coliseum,12,2
2018-08-31,2018,NYM,SF,0,7,-105,1.5,-225,7.0,-105,-115,-105,-1.5,188,3.59,AT&T Park,7,-7
2018-08-31,2018,CIN,STL,5,12,160,1.5,-119,9.0,-105,-115,-180,-1.5,-101,3.46,Busch Stadium,17,-7
2018-08-31,2018,CLE,TB,3,0,-185,-1.5,107,8.0,-116,-104,165,1.5,-127,5.19,Progressive Field,3,3
2018-08-31,2018,MIN,TEX,10,7,105,1.5,-170,11.5,100,-120,-115,-1.5,148,5.61,Rangers Ballpark,17,3
2018-08-31,2018,MIA,TOR,5,6,103,1.5,-161,8.0,-107,-113,-113,-1.5,141,3.94,Marlins Park,11,-1
2018-08-31,2018,MIL,WSH,4,1,111,1.5,-205,9.0,-105,-115,-121,-1.5,172,4.27,Nationals Park,5,3
2018-09-01,2018,LAD,ARI,3,2,-155,-1.5,148,6.5,-115,-105,140,1.5,-170,3.95,Dodger Stadium,5,1
2018-09-01,2018,PIT,ATL,3,5,107,1.5,-200,8.0,-110,-110,-117,-1.5,170,3.86,Suntrust Park,8,-2
2018-09-01,2018,KC,BAL,5,4,106,1.5,-158,9.0,-120,100,-116,-1.5,138,4.37,Kauffman Stadium,9,1
2018-09-01,2018,CWS,BOS,1,6,184,1.5,115,9.0,102,-122,-214,-1.5,-135,3.17,Guaranteed Rate Field,7,-5
2018-09-01,2018,PHI,CHC,1,7,117,1.5,-140,9.0,100,-120,-127,-1.5,120,4.15,Citizens Bank Park,8,-6
2018-09-01,2018,STL,CIN,0,4,-124,-1.5,163,8.5,-119,-101,114,1.5,-190,4.71,Busch Stadium,4,-4
2018-09-01,2018,TB,CLE,5,3,119,1.5,-190,8.0,103,-123,-134,-1.5,163,3.65,Progressive Field,8,2
2018-09-01,2018,SD,COL,2,4,121,1.5,-130,7.0,-120,100,-136,-1.5,110,3.17,PETCO Park,6,-2
2018-09-01,2018,BOS,CWS,6,1,-214,-1.5,-135,9.0,102,-122,184,1.5,115,6.13,Guaranteed Rate Field,7,5
2018-09-01,2018,NYY,DET,2,1,-360,-1.5,-175,8.5,-120,100,300,1.5,151,6.65,Yankee Stadium,3,1
2018-09-01,2018,LAA,HOU,3,7,167,1.5,-125,8.5,-120,100,-187,-1.5,105,3.18,Minute Maid Park,10,-4
2018-09-01,2018,BAL,KC,4,5,-116,-1.5,138,9.0,-120,100,106,1.5,-158,4.83,Kauffman Stadium,9,-1
2018-09-01,2018,HOU,LAA,7,3,-187,-1.5,105,8.5,-120,100,167,1.5,-125,5.54,Minute Maid Park,10,4
2018-09-01,2018,ARI,LAD,2,3,140,1.5,-170,6.5,-115,-105,-155,-1.5,148,2.71,Dodger Stadium,5,-1
2018-09-01,2018,TOR,MIA,3,6,-109,-1.5,146,7.5,-114,-106,-101,1.5,-167,3.91,Marlins Park,9,-3
2018-09-01,2018,WSH,MIL,5,4,-134,-1.5,159,8.5,-120,100,119,1.5,-184,4.87,Nationals Park,9,1
2018-09-01,2018,TEX,MIN,7,4,109,1.5,-145,10.0,-115,-105,-119,-1.5,125,4.78,Rangers Ballpark,11,3
2018-09-01,2018,SF,NYM,1,2,-128,-1.5,160,7.5,-116,-104,118,1.5,-185,4.21,AT&T Park,3,-1
2018-09-01,2018,DET,NYY,1,2,300,1.5,151,8.5,-120,100,-360,-1.5,-175,2.13,Yankee Stadium,3,-1
2018-09-01,2018,SEA,OAK,8,7,-126,-1.5,129,8.0,-106,-114,116,1.5,-149,4.46,Oakland Coliseum,15,1
2018-09-01,2018,CHC,PHI,7,1,-127,-1.5,120,9.0,100,-120,117,1.5,-140,5.04,Citizens Bank Park,8,6
2018-09-01,2018,ATL,PIT,5,3,-117,-1.5,170,8.0,-110,-110,107,1.5,-200,4.31,Suntrust Park,8,2
2018-09-01,2018,COL,SD,4,2,-136,-1.5,110,7.0,-120,100,121,1.5,-130,4.03,PETCO Park,6,2
2018-09-01,2018,OAK,SEA,7,8,116,1.5,-149,8.0,-106,-114,-126,-1.5,129,3.7,Oakland Coliseum,15,-1
2018-09-01,2018,NYM,SF,2,1,118,1.5,-185,7.5,-116,-104,-128,-1.5,160,3.44,AT&T Park,3,1
2018-09-01,2018,CIN,STL,4,0,114,1.5,-190,8.5,-119,-101,-124,-1.5,163,3.97,Busch Stadium,4,4
2018-09-01,2018,CLE,TB,3,5,-134,-1.5,163,8.0,103,-123,119,1.5,-190,4.58,Progressive Field,8,-2
2018-09-01,2018,MIN,TEX,4,7,-119,-1.5,125,10.0,-115,-105,109,1.5,-145,5.43,Rangers Ballpark,11,-3
2018-09-01,2018,MIA,TOR,6,3,-101,1.5,-167,7.5,-114,-106,-109,-1.5,146,3.77,Marlins Park,9,3
2018-09-01,2018,MIL,WSH,4,5,119,1.5,-184,8.5,-120,100,-134,-1.5,159,3.88,Nationals Park,9,-1
2018-09-02,2018,LAD,ARI,3,2,-200,-1.5,105,7.5,-132,112,170,1.5,-125,5.0,Dodger Stadium,5,1
2018-09-02,2018,PIT,ATL,1,5,162,1.5,-128,9.0,-115,-105,-182,-1.5,108,3.44,Suntrust Park,6,-4
2018-09-02,2018,KC,BAL,9,1,-127,-1.5,165,9.0,105,-125,117,1.5,-194,5.04,Kauffman Stadium,10,8
2018-09-02,2018,CWS,BOS,8,0,170,1.5,111,9.5,-110,-110,-200,-1.5,-131,3.52,Guaranteed Rate Field,8,8
2018-09-02,2018,PHI,CHC,1,8,-126,-1.5,159,8.5,104,-124,116,1.5,-184,4.74,Citizens Bank Park,9,-7
2018-09-02,2018,STL,CIN,4,6,-150,-1.5,135,8.5,-115,-105,135,1.5,-155,5.1,Busch Stadium,10,-2
2018-09-02,2018,TB,CLE,6,4,175,1.5,-115,8.5,-120,100,-205,-1.5,-105,3.09,Progressive Field,10,2
2018-09-02,2018,SD,COL,3,7,126,1.5,-130,8.5,-104,-116,-141,-1.5,110,3.76,PETCO Park,10,-4
2018-09-02,2018,BOS,CWS,0,8,-200,-1.5,-131,9.5,-110,-110,170,1.5,111,6.33,Guaranteed Rate Field,8,-8
2018-09-02,2018,NYY,DET,7,11,-256,-1.5,-130,8.5,-120,100,216,1.5,111,6.11,Yankee Stadium,18,-4
2018-09-02,2018,LAA,HOU,2,4,192,1.5,-106,7.5,-110,-110,-222,-1.5,-114,2.57,Minute Maid Park,6,-2
2018-09-02,2018,BAL,KC,1,9,117,1.5,-194,9.0,105,-125,-127,-1.5,165,4.15,Kauffman Stadium,10,-8
2018-09-02,2018,HOU,LAA,4,2,-222,-1.5,-114,7.5,-110,-110,192,1.5,-106,5.17,Minute Maid Park,6,2
2018-09-02,2018,ARI,LAD,2,3,170,1.5,-125,7.5,-132,112,-200,-1.5,105,2.78,Dodger Stadium,5,-1
2018-09-02,2018,TOR,MIA,6,1,-103,-1.5,148,7.5,-115,-105,-107,1.5,-170,3.81,Marlins Park,7,5
2018-09-02,2018,WSH,MIL,4,9,-101,1.5,-168,9.5,-121,101,-109,-1.5,147,4.77,Nationals Park,13,-5
2018-09-02,2018,TEX,MIN,18,4,-109,-1.5,170,10.5,-120,100,-101,1.5,-200,5.48,Rangers Ballpark,22,14
2018-09-02,2018,SF,NYM,1,4,133,1.5,-132,7.5,-101,-119,-148,-1.5,112,3.22,AT&T Park,5,-3
2018-09-02,2018,DET,NYY,11,7,216,1.5,111,8.5,-120,100,-256,-1.5,-130,2.69,Yankee Stadium,18,4
2018-09-02,2018,SEA,OAK,2,8,102,1.5,-187,9.0,-122,102,-112,-1.5,162,4.46,Oakland Coliseum,10,-6
2018-09-02,2018,CHC,PHI,8,1,116,1.5,-184,8.5,104,-124,-126,-1.5,159,3.94,Citizens Bank Park,9,7
2018-09-02,2018,ATL,PIT,5,1,-182,-1.5,108,9.0,-115,-105,162,1.5,-128,5.81,Suntrust Park,6,4
2018-09-02,2018,COL,SD,7,3,-141,-1.5,110,8.5,-104,-116,126,1.5,-130,4.97,PETCO Park,10,4
2018-09-02,2018,OAK,SEA,8,2,-112,-1.5,162,9.0,-122,102,102,1.5,-187,4.75,Oakland Coliseum,10,6
2018-09-02,2018,NYM,SF,4,1,-148,-1.5,112,7.5,-101,-119,133,1.5,-132,4.48,AT&T Park,5,3
2018-09-02,2018,CIN,STL,6,4,135,1.5,-155,8.5,-115,-105,-150,-1.5,135,3.62,Busch Stadium,10,2
2018-09-02,2018,CLE,TB,4,6,-205,-1.5,-105,8.5,-120,100,175,1.5,-115,5.71,Progressive Field,10,-2
2018-09-02,2018,MIN,TEX,4,18,-101,1.5,-200,10.5,-120,100,-109,-1.5,170,5.28,Rangers Ballpark,22,-14
2018-09-02,2018,MIA,TOR,1,6,-107,1.5,-170,7.5,-115,-105,-103,-1.5,148,3.88,Marlins Park,7,-5
2018-09-02,2018,MIL,WSH,9,4,-109,-1.5,147,9.5,-121,101,-101,1.5,-168,4.95,Nationals Park,13,5
2018-09-03,2018,SD,ARI,6,2,184,1.5,-105,8.5,-105,-115,-214,-1.5,-115,2.99,Chase Field,8,4
2018-09-03,2018,BOS,ATL,8,2,-129,-1.5,121,9.0,-105,-115,119,1.5,-141,5.07,Suntrust Park,10,6
2018-09-03,2018,SEA,BAL,2,1,-240,-1.5,-119,9.0,105,-125,200,1.5,-101,6.35,T-Mobile Park,3,1
2018-09-03,2018,ATL,BOS,2,8,119,1.5,-141,9.0,-105,-115,-129,-1.5,121,4.11,Suntrust Park,10,-6
2018-09-03,2018,MIL,CHC,4,3,116,1.5,-150,8.5,-115,-105,-126,-1.5,130,3.94,Miller Park,7,1
2018-09-03,2018,PIT,CIN,5,1,-129,-1.5,151,8.5,-115,-105,119,1.5,-175,4.79,PNC Park,6,4
2018-09-03,2018,KC,CLE,5,1,170,1.5,-120,9.0,-125,105,-200,-1.5,100,3.33,Progressive Field,6,4
2018-09-03,2018,SF,COL,8,9,136,1.5,-149,10.0,-115,-105,-151,-1.5,129,4.24,Coors Field,17,-1
2018-09-03,2018,DET,CWS,2,4,109,1.5,-185,8.5,100,-120,-119,-1.5,160,4.07,Guaranteed Rate Field,6,-2
2018-09-03,2018,CWS,DET,4,2,-119,-1.5,160,8.5,100,-120,109,1.5,-185,4.62,Guaranteed Rate Field,6,2
2018-09-03,2018,MIN,HOU,1,4,200,1.5,-112,7.5,-124,104,-240,-1.5,-108,2.5,Minute Maid Park,5,-3
2018-09-03,2018,CLE,KC,1,5,-200,-1.5,100,9.0,-125,105,170,1.5,-120,6.0,Progressive Field,6,-4
2018-09-03,2018,TEX,LAA,1,3,-137,-1.5,151,10.5,-101,-119,122,1.5,-175,6.07,Rangers Ballpark,4,-2
2018-09-03,2018,NYM,LAD,4,2,125,1.5,-187,7.0,106,-126,-140,-1.5,161,3.11,Dodger Stadium,6,2
2018-09-03,2018,PHI,MIA,1,3,-140,-1.5,115,7.5,-107,-113,125,1.5,-135,4.38,Marlins Park,4,-2
2018-09-03,2018,CHC,MIL,3,4,-126,-1.5,130,8.5,-115,-105,116,1.5,-150,4.74,Miller Park,7,-1
2018-09-03,2018,HOU,MIN,4,1,-240,-1.5,-108,7.5,-124,104,200,1.5,-112,5.29,Minute Maid Park,5,3
2018-09-03,2018,LAD,NYM,2,4,-140,-1.5,161,7.0,106,-126,125,1.5,-187,4.08,Dodger Stadium,6,-2
2018-09-03,2018,OAK,NYY,6,3,-114,-1.5,170,8.0,-105,-115,104,1.5,-200,4.26,Oakland Coliseum,9,3
2018-09-03,2018,NYY,OAK,3,6,104,1.5,-200,8.0,-105,-115,-114,-1.5,170,3.92,Oakland Coliseum,9,-3
2018-09-03,2018,MIA,PHI,3,1,125,1.5,-135,7.5,-107,-113,-140,-1.5,115,3.33,Marlins Park,4,2
2018-09-03,2018,CIN,PIT,1,5,119,1.5,-175,8.5,-115,-105,-129,-1.5,151,3.88,PNC Park,6,-4
2018-09-03,2018,ARI,SD,2,6,-214,-1.5,-115,8.5,-105,-115,184,1.5,-105,5.79,Chase Field,8,-4
2018-09-03,2018,BAL,SEA,1,2,200,1.5,-101,9.0,105,-125,-240,-1.5,-119,3.0,T-Mobile Park,3,-1
2018-09-03,2018,COL,SF,9,8,-151,-1.5,129,10.0,-115,-105,136,1.5,-149,6.02,Coors Field,17,1
2018-09-03,2018,WSH,STL,4,3,-190,-1.5,116,7.5,-112,-108,170,1.5,-136,4.91,Nationals Park,7,1
2018-09-03,2018,TOR,TB,1,7,-107,-1.5,180,8.0,-120,100,-103,1.5,-215,4.14,Rogers Centre,8,-6
2018-09-03,2018,LAA,TEX,3,1,122,1.5,-175,10.5,-101,-119,-137,-1.5,151,4.73,Rangers Ballpark,4,2
2018-09-03,2018,TB,TOR,7,1,-103,1.5,-215,8.0,-120,100,-107,-1.5,180,4.06,Rogers Centre,8,6
2018-09-03,2018,STL,WSH,3,4,170,1.5,-136,7.5,-112,-108,-190,-1.5,116,2.78,Nationals Park,7,-1
2018-09-04,2018,SD,ARI,0,6,164,1.5,-140,8.0,-105,-115,-184,-1.5,120,3.03,Chase Field,6,-6
2018-09-04,2018,BOS,ATL,5,1,-126,-1.5,125,8.5,-110,-110,116,1.5,-145,4.74,Suntrust Park,6,4
2018-09-04,2018,SEA,BAL,3,5,-202,-1.5,-108,7.5,-112,-108,172,1.5,-112,5.02,T-Mobile Park,8,-2
2018-09-04,2018,ATL,BOS,1,5,116,1.5,-145,8.5,-110,-110,-126,-1.5,125,3.94,Suntrust Park,6,-4
2018-09-04,2018,MIL,CHC,11,1,100,1.5,-175,9.0,-119,-101,-110,-1.5,151,4.5,Miller Park,12,10
2018-09-04,2018,PIT,CIN,7,3,-140,-1.5,151,8.0,-105,-115,125,1.5,-175,4.67,PNC Park,10,4
2018-09-04,2018,KC,CLE,3,9,200,1.5,105,8.5,-115,-105,-240,-1.5,-125,2.83,Progressive Field,12,-6
2018-09-04,2018,SF,COL,2,6,175,1.5,-115,10.0,100,-120,-195,-1.5,-105,3.64,Coors Field,8,-4
2018-09-04,2018,DET,CWS,8,3,146,1.5,-137,8.5,-115,-105,-161,-1.5,117,3.46,Guaranteed Rate Field,11,5
2018-09-04,2018,CWS,DET,3,8,-161,-1.5,117,8.5,-115,-105,146,1.5,-137,5.24,Guaranteed Rate Field,11,-5
2018-09-04,2018,MIN,HOU,2,5,250,1.5,125,7.5,100,-120,-300,-1.5,-145,2.14,Minute Maid Park,7,-3
2018-09-04,2018,CLE,KC,9,3,-240,-1.5,-125,8.5,-115,-105,200,1.5,105,6.0,Progressive Field,12,6
2018-09-04,2018,TEX,LAA,4,2,101,1.5,-162,9.0,-119,-101,-111,-1.5,142,4.48,Rangers Ballpark,6,2
2018-09-04,2018,NYM,LAD,4,11,205,1.5,105,8.0,-125,105,-245,-1.5,-125,2.62,Dodger Stadium,15,-7
2018-09-04,2018,PHI,MIA,9,4,-134,-1.5,135,7.0,-120,100,119,1.5,-155,4.01,Marlins Park,13,5
2018-09-04,2018,CHC,MIL,1,11,-110,-1.5,151,9.0,-119,-101,100,1.5,-175,4.71,Miller Park,12,-10
2018-09-04,2018,HOU,MIN,5,2,-300,-1.5,-145,7.5,100,-120,250,1.5,125,5.63,Minute Maid Park,7,3
2018-09-04,2018,LAD,NYM,11,4,-245,-1.5,-125,8.0,-125,105,205,1.5,105,5.68,Dodger Stadium,15,7
2018-09-04,2018,OAK,NYY,1,5,113,1.5,-161,8.0,-110,-110,-123,-1.5,140,3.76,Oakland Coliseum,6,-4
2018-09-04,2018,NYY,OAK,5,1,-123,-1.5,140,8.0,-110,-110,113,1.5,-161,4.41,Oakland Coliseum,6,4
2018-09-04,2018,MIA,PHI,4,9,119,1.5,-155,7.0,-120,100,-134,-1.5,135,3.2,Marlins Park,13,-5
2018-09-04,2018,CIN,PIT,3,7,125,1.5,-175,8.0,-105,-115,-140,-1.5,151,3.56,PNC Park,10,-4
2018-09-04,2018,ARI,SD,6,0,-184,-1.5,120,8.0,-105,-115,164,1.5,-140,5.18,Chase Field,6,6
2018-09-04,2018,BAL,SEA,5,3,172,1.5,-112,7.5,-112,-108,-202,-1.5,-108,2.76,T-Mobile Park,8,2
2018-09-04,2018,COL,SF,6,2,-195,-1.5,-105,10.0,100,-120,175,1.5,-115,6.61,Coors Field,8,4
2018-09-04,2018,WSH,STL,8,11,-119,-1.5,160,10.0,-111,-109,109,1.5,-185,5.43,Nationals Park,19,-3
2018-09-04,2018,TOR,TB,0,4,111,1.5,-147,8.5,-110,-110,-121,-1.5,127,4.03,Rogers Centre,4,-4
2018-09-04,2018,LAA,TEX,2,4,-111,-1.5,142,9.0,-119,-101,101,1.5,-162,4.73,Rangers Ballpark,6,-2
2018-09-04,2018,TB,TOR,4,0,-121,-1.5,127,8.5,-110,-110,111,1.5,-147,4.65,Rogers Centre,4,4
2018-09-04,2018,STL,WSH,11,8,109,1.5,-185,10.0,-111,-109,-119,-1.5,160,4.78,Nationals Park,19,3
2018-09-05,2018,BOS,ATL,9,8,153,1.5,-140,7.5,-110,-110,-173,-1.5,120,2.96,Suntrust Park,17,1
2018-09-05,2018,SEA,BAL,5,2,-238,-1.5,-128,8.0,-119,-101,208,1.5,108,5.63,T-Mobile Park,7,3
2018-09-05,2018,ATL,BOS,8,9,-173,-1.5,120,7.5,-110,-110,153,1.5,-140,4.75,Suntrust Park,17,-1
2018-09-05,2018,MIL,CHC,4,6,-107,-1.5,180,8.5,-120,100,-103,1.5,-215,4.39,Miller Park,10,-2
2018-09-05,2018,PIT,CIN,3,2,-190,-1.5,100,9.0,111,-131,170,1.5,-121,5.9,PNC Park,5,1
2018-09-05,2018,KC,CLE,1,3,276,1.5,130,8.5,-118,-102,-326,-1.5,-150,2.26,Progressive Field,4,-2
2018-09-05,2018,SF,COL,3,5,145,1.5,-135,10.5,-110,-110,-160,-1.5,115,4.29,Coors Field,8,-2
2018-09-05,2018,DET,CWS,10,2,136,1.5,-160,8.0,-119,-101,-151,-1.5,140,3.39,Guaranteed Rate Field,12,8
2018-09-05,2018,CWS,DET,2,10,-151,-1.5,140,8.0,-119,-101,136,1.5,-160,4.81,Guaranteed Rate Field,12,-8
2018-09-05,2018,MIN,HOU,1,9,200,1.5,105,8.5,-110,-110,-230,-1.5,-125,2.83,Minute Maid Park,10,-8
2018-09-05,2018,CLE,KC,3,1,-326,-1.5,-150,8.5,-118,-102,276,1.5,130,6.5,Progressive Field,4,2
2018-09-05,2018,TEX,LAA,3,9,-126,-1.5,160,10.5,-119,-101,116,1.5,-185,5.85,Rangers Ballpark,12,-6
2018-09-05,2018,NYM,LAD,7,3,167,1.5,-133,7.5,105,-125,-187,-1.5,113,2.81,Dodger Stadium,10,4
2018-09-05,2018,PHI,MIA,1,2,-190,-1.5,-119,8.5,-101,-119,170,1.5,-101,5.57,Marlins Park,3,-1
2018-09-05,2018,CHC,MIL,6,4,-103,1.5,-215,8.5,-120,100,-107,-1.5,180,4.31,Miller Park,10,2
2018-09-05,2018,HOU,MIN,9,1,-230,-1.5,-125,8.5,-110,-110,200,1.5,105,5.92,Minute Maid Park,10,8
2018-09-05,2018,LAD,NYM,3,7,-187,-1.5,113,7.5,105,-125,167,1.5,-133,4.89,Dodger Stadium,10,-4
2018-09-05,2018,OAK,NYY,8,2,138,1.5,-125,7.0,-119,-101,-153,-1.5,105,2.94,Oakland Coliseum,10,6
2018-09-05,2018,NYY,OAK,2,8,-153,-1.5,105,7.0,-119,-101,138,1.5,-125,4.23,Oakland Coliseum,10,-6
2018-09-05,2018,MIA,PHI,2,1,170,1.5,-101,8.5,-101,-119,-190,-1.5,-119,3.15,Marlins Park,3,1
2018-09-05,2018,CIN,PIT,2,3,170,1.5,-121,9.0,111,-131,-190,-1.5,100,3.33,PNC Park,5,-1
2018-09-05,2018,BAL,SEA,2,5,208,1.5,108,8.0,-119,-101,-238,-1.5,-128,2.6,T-Mobile Park,7,-3
2018-09-05,2018,COL,SF,5,3,-160,-1.5,115,10.5,-110,-110,145,1.5,-135,6.46,Coors Field,8,2
2018-09-05,2018,WSH,STL,6,7,-107,-1.5,184,9.0,-119,-101,-103,1.5,-220,4.65,Nationals Park,13,-1
2018-09-05,2018,TOR,TB,10,3,125,1.5,-135,8.5,-101,-119,-140,-1.5,115,3.78,Rogers Centre,13,7
2018-09-05,2018,LAA,TEX,9,3,116,1.5,-185,10.5,-119,-101,-126,-1.5,160,4.86,Rangers Ballpark,12,6
2018-09-05,2018,TB,TOR,3,10,-140,-1.5,115,8.5,-101,-119,125,1.5,-135,4.96,Rogers Centre,13,-7
2018-09-05,2018,STL,WSH,7,6,-103,1.5,-220,9.0,-119,-101,-107,-1.5,184,4.57,Nationals Park,13,1
2018-09-06,2018,ATL,ARI,7,6,149,1.5,-144,8.0,101,-121,-164,-1.5,124,3.21,Chase Field,13,1
2018-09-06,2018,ARI,ATL,6,7,-164,-1.5,124,8.0,101,-121,149,1.5,-144,4.97,Chase Field,13,-1
2018-09-06,2018,WSH,CHC,4,6,-105,-1.5,188,8.5,-113,-107,-105,1.5,-225,4.35,Nationals Park,10,-2
2018-09-06,2018,SD,CIN,6,2,150,1.5,-145,8.5,-113,-107,-165,-1.5,125,3.4,Great American Ballpark,8,4
2018-09-06,2018,TOR,CLE,4,9,145,1.5,-119,9.0,105,-125,-160,-1.5,-101,3.67,Rogers Centre,13,-5
2018-09-06,2018,CIN,SD,2,6,-165,-1.5,125,8.5,-113,-107,150,1.5,-145,5.29,Great American Ballpark,8,-4
2018-09-06,2018,CLE,TOR,9,4,-160,-1.5,-101,9.0,105,-125,145,1.5,-119,5.54,Rogers Centre,13,5
2018-09-06,2018,CHC,WSH,6,4,-105,1.5,-225,8.5,-113,-107,-105,-1.5,188,4.35,Nationals Park,10,2
2018-09-07,2018,ATL,ARI,3,5,175,1.5,-130,7.5,-102,-118,-195,-1.5,110,2.73,Chase Field,8,-2
2018-09-07,2018,ARI,ATL,5,3,-195,-1.5,110,7.5,-102,-118,175,1.5,-130,4.96,Chase Field,8,2
2018-09-07,2018,TB,BAL,14,2,-275,-1.5,-136,6.5,-125,105,235,1.5,116,4.77,Tropicana Field,16,12
2018-09-07,2018,HOU,BOS,6,3,-115,-1.5,139,8.5,-101,-119,105,1.5,-159,4.55,Fenway Park,9,3
2018-09-07,2018,SD,CIN,6,12,138,1.5,-157,9.0,-119,-101,-153,-1.5,137,3.78,Great American Ballpark,18,-6
2018-09-07,2018,TOR,CLE,3,2,200,1.5,120,8.5,-115,-105,-240,-1.5,-140,2.83,Rogers Centre,5,1
2018-09-07,2018,LAD,COL,4,2,-150,-1.5,100,9.5,-111,-109,135,1.5,-120,5.7,Coors Field,6,2
2018-09-07,2018,LAA,CWS,5,2,-117,-1.5,139,8.5,-125,105,107,1.5,-159,4.58,Guaranteed Rate Field,7,3
2018-09-07,2018,STL,DET,3,5,-136,-1.5,114,9.0,103,-123,121,1.5,-134,5.19,Comerica Park,8,-2
2018-09-07,2018,BOS,HOU,3,6,105,1.5,-159,8.5,-101,-119,-115,-1.5,139,4.15,Fenway Park,9,-3
2018-09-07,2018,MIN,KC,10,6,-170,-1.5,120,9.5,-115,-105,150,1.5,-140,5.98,Target Field,16,4
2018-09-07,2018,CWS,LAA,2,5,107,1.5,-159,8.5,-125,105,-117,-1.5,139,4.11,Guaranteed Rate Field,7,-3
2018-09-07,2018,COL,LAD,2,4,135,1.5,-120,9.5,-111,-109,-150,-1.5,100,4.04,Coors Field,6,-2
2018-09-07,2018,PIT,MIA,5,3,-210,-1.5,100,8.0,100,-120,180,1.5,-120,5.42,PNC Park,8,2
2018-09-07,2018,SF,MIL,2,4,158,1.5,-125,8.5,-101,-119,-178,-1.5,105,3.29,Miller Park,6,-2
2018-09-07,2018,KC,MIN,6,10,150,1.5,-140,9.5,-115,-105,-170,-1.5,120,3.8,Target Field,16,-4
2018-09-07,2018,PHI,NYM,4,3,-155,-1.5,105,7.0,-104,-116,140,1.5,-125,4.25,Citi Field,7,1
2018-09-07,2018,SEA,NYY,0,4,-111,-1.5,180,7.5,100,-120,101,1.5,-215,3.95,T-Mobile Park,4,-4
2018-09-07,2018,TEX,OAK,4,8,166,1.5,-120,9.0,-110,-110,-186,-1.5,100,3.38,Oakland Coliseum,12,-4
2018-09-07,2018,NYM,PHI,3,4,140,1.5,-125,7.0,-104,-116,-155,-1.5,105,2.92,Citi Field,7,-1
2018-09-07,2018,MIA,PIT,3,5,180,1.5,-120,8.0,100,-120,-210,-1.5,100,2.86,PNC Park,8,-2
2018-09-07,2018,CIN,SD,12,6,-153,-1.5,137,9.0,-119,-101,138,1.5,-157,5.44,Great American Ballpark,18,6
2018-09-07,2018,NYY,SEA,4,0,101,1.5,-215,7.5,100,-120,-111,-1.5,180,3.73,T-Mobile Park,4,4
2018-09-07,2018,MIL,SF,4,2,-178,-1.5,105,8.5,-101,-119,158,1.5,-125,5.44,Miller Park,6,2
2018-09-07,2018,DET,STL,5,3,121,1.5,-134,9.0,103,-123,-136,-1.5,114,4.07,Comerica Park,8,2
2018-09-07,2018,BAL,TB,2,14,235,1.5,116,6.5,-125,105,-275,-1.5,-136,1.94,Tropicana Field,16,-12
2018-09-07,2018,OAK,TEX,8,4,-186,-1.5,100,9.0,-110,-110,166,1.5,-120,5.85,Oakland Coliseum,12,4
2018-09-07,2018,CLE,TOR,2,3,-240,-1.5,-140,8.5,-115,-105,200,1.5,120,6.0,Rogers Centre,5,-1
2018-09-08,2018,ATL,ARI,5,4,119,1.5,-180,8.5,-110,-110,-134,-1.5,155,3.88,Chase Field,9,1
2018-09-08,2018,ARI,ATL,4,5,-134,-1.5,155,8.5,-110,-110,119,1.5,-180,4.87,Chase Field,9,-1
2018-09-08,2018,TB,BAL,10,5,-245,-1.5,-120,8.0,-103,-117,205,1.5,100,5.68,Tropicana Field,15,5
2018-09-08,2018,HOU,BOS,5,3,111,1.5,-193,9.0,-105,-115,-121,-1.5,165,4.27,Fenway Park,8,2
2018-09-08,2018,WSH,CHC,10,3,-200,-1.5,-106,7.5,-107,-113,170,1.5,-114,5.0,Nationals Park,13,7
2018-09-08,2018,WSH,CHC,6,5,158,1.5,-103,9.0,-115,-105,-178,-1.5,-117,3.49,Nationals Park,11,1
2018-09-08,2018,SD,CIN,2,7,109,1.5,-190,8.5,-103,-117,-119,-1.5,163,4.07,Great American Ballpark,9,-5
2018-09-08,2018,TOR,CLE,8,9,119,1.5,-141,9.5,102,-122,-134,-1.5,121,4.34,Rogers Centre,17,-1
2018-09-08,2018,LAD,COL,2,4,-126,-1.5,123,10.0,-111,-109,116,1.5,-143,5.58,Coors Field,6,-2
2018-09-08,2018,LAA,CWS,12,3,-142,-1.5,116,9.0,-110,-110,127,1.5,-136,5.28,Guaranteed Rate Field,15,9
2018-09-08,2018,STL,DET,3,4,-172,-1.5,-117,8.0,-108,-112,152,1.5,-103,5.06,Comerica Park,7,-1
2018-09-08,2018,BOS,HOU,3,5,-121,-1.5,165,9.0,-105,-115,111,1.5,-193,4.93,Fenway Park,8,-2
2018-09-08,2018,MIN,KC,1,4,-210,-1.5,-105,8.5,-115,-105,180,1.5,-115,5.76,Target Field,5,-3
2018-09-08,2018,CWS,LAA,3,12,127,1.5,-136,9.0,-110,-110,-142,-1.5,116,3.96,Guaranteed Rate Field,15,-9
2018-09-08,2018,COL,LAD,4,2,116,1.5,-143,10.0,-111,-109,-126,-1.5,123,4.63,Coors Field,6,2
2018-09-08,2018,PIT,MIA,5,1,-160,-1.5,135,7.0,-111,-109,145,1.5,-155,4.31,PNC Park,6,4
2018-09-08,2018,SF,MIL,3,4,174,1.5,-117,8.0,-117,-103,-194,-1.5,-103,2.92,Miller Park,7,-1
2018-09-08,2018,KC,MIN,4,1,180,1.5,-115,8.5,-115,-105,-210,-1.5,-105,3.04,Target Field,5,3
2018-09-08,2018,PHI,NYM,5,10,131,1.5,-170,7.0,-120,100,-146,-1.5,148,3.03,Citi Field,15,-5
2018-09-08,2018,SEA,NYY,2,4,103,1.5,-160,8.5,-110,-110,-113,-1.5,140,4.19,T-Mobile Park,6,-2
2018-09-08,2018,TEX,OAK,6,8,160,1.5,-122,9.5,-111,-109,-180,-1.5,101,3.65,Oakland Coliseum,14,-2
2018-09-08,2018,NYM,PHI,10,5,-146,-1.5,148,7.0,-120,100,131,1.5,-170,4.15,Citi Field,15,5
2018-09-08,2018,MIA,PIT,1,5,145,1.5,-155,7.0,-111,-109,-160,-1.5,135,2.86,PNC Park,6,-4
2018-09-08,2018,CIN,SD,7,2,-119,-1.5,163,8.5,-103,-117,109,1.5,-190,4.62,Great American Ballpark,9,5
2018-09-08,2018,NYY,SEA,4,2,-113,-1.5,140,8.5,-110,-110,103,1.5,-160,4.51,T-Mobile Park,6,2
2018-09-08,2018,MIL,SF,4,3,-194,-1.5,-103,8.0,-117,-103,174,1.5,-117,5.28,Miller Park,7,1
2018-09-08,2018,DET,STL,4,3,152,1.5,-103,8.0,-108,-112,-172,-1.5,-117,3.17,Comerica Park,7,1
2018-09-08,2018,BAL,TB,5,10,205,1.5,100,8.0,-103,-117,-245,-1.5,-120,2.62,Tropicana Field,15,-5
2018-09-08,2018,OAK,TEX,8,6,-180,-1.5,101,9.5,-111,-109,160,1.5,-122,6.11,Oakland Coliseum,14,2
2018-09-08,2018,CLE,TOR,9,8,-134,-1.5,121,9.5,102,-122,119,1.5,-141,5.44,Rogers Centre,17,1
2018-09-08,2018,CHC,WSH,3,10,170,1.5,-114,7.5,-107,-113,-200,-1.5,-106,2.78,Nationals Park,13,-7
2018-09-08,2018,CHC,WSH,5,6,-178,-1.5,-117,9.0,-115,-105,158,1.5,-103,5.76,Nationals Park,11,-1
2018-09-09,2018,ATL,ARI,9,5,124,1.5,-170,8.5,-107,-113,-139,-1.5,148,3.79,Chase Field,14,4
2018-09-09,2018,ARI,ATL,5,9,-139,-1.5,148,8.5,-107,-113,124,1.5,-170,4.94,Chase Field,14,-4
2018-09-09,2018,TB,BAL,8,3,-260,-1.5,-130,8.0,113,-133,220,1.5,110,5.78,Tropicana Field,11,5
2018-09-09,2018,HOU,BOS,5,6,-105,1.5,-201,9.0,102,-122,-105,-1.5,170,4.61,Fenway Park,11,-1
2018-09-09,2018,SD,CIN,7,6,125,1.5,-170,9.0,-121,101,-140,-1.5,148,4.0,Great American Ballpark,13,1
2018-09-09,2018,TOR,CLE,6,2,165,1.5,103,9.0,-105,-115,-185,-1.5,-123,3.4,Rogers Centre,8,4
2018-09-09,2018,LAD,COL,9,6,-111,-1.5,134,11.0,-103,-117,101,1.5,-154,5.79,Coors Field,15,3
2018-09-09,2018,LAA,CWS,1,0,-159,-1.5,-101,8.5,-107,-113,144,1.5,-119,5.22,Guaranteed Rate Field,1,1
2018-09-09,2018,STL,DET,5,2,-132,-1.5,124,8.5,-105,-115,117,1.5,-146,4.84,Comerica Park,7,3
2018-09-09,2018,BOS,HOU,6,5,-105,-1.5,170,9.0,102,-122,-105,1.5,-201,4.61,Fenway Park,11,1
2018-09-09,2018,MIN,KC,3,1,-134,-1.5,149,9.5,-104,-116,119,1.5,-172,5.44,Target Field,4,2
2018-09-09,2018,CWS,LAA,0,1,144,1.5,-119,8.5,-107,-113,-159,-1.5,-101,3.48,Guaranteed Rate Field,1,-1
2018-09-09,2018,COL,LAD,6,9,101,1.5,-154,11.0,-103,-117,-111,-1.5,134,5.47,Coors Field,15,-3
2018-09-09,2018,SF,MIL,3,6,135,1.5,-166,8.0,-105,-115,-150,-1.5,145,3.4,Miller Park,9,-3
2018-09-09,2018,KC,MIN,1,3,119,1.5,-172,9.5,-104,-116,-134,-1.5,149,4.34,Target Field,4,-2
2018-09-09,2018,PHI,NYM,4,6,-130,-1.5,120,8.5,100,-120,115,1.5,-140,4.8,Citi Field,10,-2
2018-09-09,2018,SEA,NYY,3,2,115,1.5,-144,8.0,-111,-109,-125,-1.5,124,3.72,T-Mobile Park,5,1
2018-09-09,2018,TEX,OAK,3,7,194,1.5,100,9.0,100,-120,-224,-1.5,-120,3.06,Oakland Coliseum,10,-4
2018-09-09,2018,NYM,PHI,6,4,115,1.5,-140,8.5,100,-120,-130,-1.5,120,3.95,Citi Field,10,2
2018-09-09,2018,CIN,SD,6,7,-140,-1.5,148,9.0,-121,101,125,1.5,-170,5.25,Great American Ballpark,13,-1
2018-09-09,2018,NYY,SEA,2,3,-125,-1.5,124,8.0,-111,-109,115,1.5,-144,4.44,T-Mobile Park,5,-1
2018-09-09,2018,MIL,SF,6,3,-150,-1.5,145,8.0,-105,-115,135,1.5,-166,4.8,Miller Park,9,3
2018-09-09,2018,DET,STL,2,5,117,1.5,-146,8.5,-105,-115,-132,-1.5,124,3.92,Comerica Park,7,-3
2018-09-09,2018,BAL,TB,3,8,220,1.5,110,8.0,113,-133,-260,-1.5,-130,2.5,Tropicana Field,11,-5
2018-09-09,2018,OAK,TEX,7,3,-224,-1.5,-120,9.0,100,-120,194,1.5,100,6.22,Oakland Coliseum,10,4
2018-09-09,2018,CLE,TOR,2,6,-185,-1.5,-123,9.0,-105,-115,165,1.5,103,5.84,Rogers Centre,8,-4
2018-09-10,2018,COL,ARI,13,2,-150,-1.5,130,10.0,-108,-112,135,1.5,-150,6.0,Coors Field,15,11
2018-09-10,2018,SF,ATL,1,4,108,1.5,-156,7.5,-109,-111,-118,-1.5,136,3.61,AT&T Park,5,-3
2018-09-10,2018,MIL,CHC,3,2,116,1.5,-184,8.5,-111,-109,-131,-1.5,159,3.94,Wrigley Field,5,1
2018-09-10,2018,LAD,CIN,6,10,-205,-1.5,-135,9.0,-110,-110,175,1.5,115,6.05,Great American Ballpark,16,-4
2018-09-10,2018,TB,CLE,6,5,135,1.5,-130,7.0,-115,-105,-150,-1.5,110,2.98,Tropicana Field,11,1
2018-09-10,2018,ARI,COL,2,13,135,1.5,-150,10.0,-108,-112,-150,-1.5,130,4.26,Coors Field,15,-11
2018-09-10,2018,KC,CWS,4,3,-131,-1.5,155,8.5,-110,-110,116,1.5,-180,4.82,Kauffman Stadium,7,1
2018-09-10,2018,HOU,DET,3,2,-360,-1.5,-215,8.5,-110,-110,300,1.5,180,6.65,Comerica Park,5,1
2018-09-10,2018,DET,HOU,2,3,300,1.5,180,8.5,-110,-110,-360,-1.5,-215,2.13,Comerica Park,5,-1
2018-09-10,2018,CWS,KC,3,4,116,1.5,-180,8.5,-110,-110,-131,-1.5,155,3.94,Kauffman Stadium,7,-1
2018-09-10,2018,TEX,LAA,5,2,116,1.5,-180,8.5,-110,-110,-126,-1.5,155,3.94,Angel Stadium,7,3
2018-09-10,2018,CIN,LAD,10,6,175,1.5,115,9.0,-110,-110,-205,-1.5,-135,3.27,Great American Ballpark,16,4
2018-09-10,2018,CHC,MIL,2,3,-131,-1.5,159,8.5,-111,-109,116,1.5,-184,4.82,Wrigley Field,5,-1
2018-09-10,2018,NYY,MIN,7,2,-189,-1.5,-120,8.5,-123,103,169,1.5,100,5.56,Target Field,9,5
2018-09-10,2018,MIN,NYY,2,7,169,1.5,100,8.5,-123,103,-189,-1.5,-120,3.16,Target Field,9,-5
2018-09-10,2018,STL,PIT,8,7,-136,-1.5,160,8.5,-105,-115,121,1.5,-185,4.9,Busch Stadium,15,1
2018-09-10,2018,ATL,SF,4,1,-118,-1.5,136,7.5,-109,-111,108,1.5,-156,4.06,AT&T Park,5,3
2018-09-10,2018,PIT,STL,7,8,121,1.5,-185,8.5,-105,-115,-136,-1.5,160,3.85,Busch Stadium,15,-1
2018-09-10,2018,CLE,TB,5,6,-150,-1.5,110,7.0,-115,-105,135,1.5,-130,4.2,Tropicana Field,11,-1
2018-09-10,2018,LAA,TEX,2,5,-126,-1.5,155,8.5,-110,-110,116,1.5,-180,4.74,Angel Stadium,7,-3
2018-09-11,2018,COL,ARI,3,6,109,1.5,-143,10.5,-105,-115,-119,-1.5,123,5.02,Coors Field,9,-3
2018-09-11,2018,SF,ATL,1,4,130,1.5,-135,7.0,-110,-110,-145,-1.5,115,3.04,AT&T Park,5,-3
2018-09-11,2018,OAK,BAL,3,2,-189,-1.5,-130,9.0,-115,-105,169,1.5,110,5.89,Camden Yards,5,1
2018-09-11,2018,TOR,BOS,2,7,280,1.5,140,9.0,-120,100,-330,-1.5,-160,2.37,Fenway Park,9,-5
2018-09-11,2018,MIL,CHC,0,3,114,1.5,-195,9.0,-105,-115,-124,-1.5,166,4.21,Wrigley Field,3,-3
2018-09-11,2018,LAD,CIN,1,3,-175,-1.5,-110,8.5,-110,-110,155,1.5,-110,5.41,Great American Ballpark,4,-2
2018-09-11,2018,TB,CLE,0,2,120,1.5,-150,8.5,-110,-110,-135,-1.5,130,3.86,Tropicana Field,2,-2
2018-09-11,2018,ARI,COL,6,3,-119,-1.5,123,10.5,-105,-115,109,1.5,-143,5.71,Coors Field,9,3
2018-09-11,2018,KC,CWS,6,3,-117,-1.5,172,8.5,-115,-105,107,1.5,-205,4.58,Kauffman Stadium,9,3
2018-09-11,2018,HOU,DET,5,4,-183,-1.5,-110,9.0,-101,-119,163,1.5,-110,5.82,Comerica Park,9,1
2018-09-11,2018,DET,HOU,4,5,163,1.5,-110,9.0,-101,-119,-183,-1.5,-110,3.42,Comerica Park,9,-1
2018-09-11,2018,CWS,KC,3,6,107,1.5,-205,8.5,-115,-105,-117,-1.5,172,4.11,Kauffman Stadium,9,-3
2018-09-11,2018,TEX,LAA,0,1,154,1.5,-135,9.0,-110,-110,-174,-1.5,115,3.54,Angel Stadium,1,-1
2018-09-11,2018,CIN,LAD,3,1,155,1.5,-110,8.5,-110,-110,-175,-1.5,-110,3.33,Great American Ballpark,4,2
2018-09-11,2018,NYM,MIA,3,5,-270,-1.5,-120,6.5,-110,-110,230,1.5,100,4.74,Citi Field,8,-2
2018-09-11,2018,CHC,MIL,3,0,-124,-1.5,166,9.0,-105,-115,114,1.5,-195,4.98,Wrigley Field,3,3
2018-09-11,2018,NYY,MIN,5,10,-182,-1.5,-120,9.5,-108,-112,162,1.5,100,6.13,Target Field,15,-5
2018-09-11,2018,MIA,NYM,5,3,230,1.5,100,6.5,-110,-110,-270,-1.5,-120,1.97,Citi Field,8,2
2018-09-11,2018,MIN,NYY,10,5,162,1.5,100,9.5,-108,-112,-182,-1.5,-120,3.63,Target Field,15,5
2018-09-11,2018,BAL,OAK,2,3,169,1.5,110,9.0,-115,-105,-189,-1.5,-130,3.35,Camden Yards,5,-1
2018-09-11,2018,WSH,PHI,3,1,127,1.5,-162,9.0,-115,-105,-142,-1.5,142,3.96,Citizens Bank Park,4,2
2018-09-11,2018,WSH,PHI,7,6,118,1.5,-169,8.5,-120,100,-133,-1.5,147,3.9,Citizens Bank Park,13,1
2018-09-11,2018,STL,PIT,11,5,-140,-1.5,160,7.5,100,-120,125,1.5,-185,4.38,Busch Stadium,16,6
2018-09-11,2018,SEA,SD,1,2,-210,-1.5,-110,8.5,-110,-110,180,1.5,-110,5.76,T-Mobile Park,3,-1
2018-09-11,2018,SD,SEA,2,1,180,1.5,-110,8.5,-110,-110,-210,-1.5,-110,3.04,T-Mobile Park,3,1
2018-09-11,2018,ATL,SF,4,1,-145,-1.5,115,7.0,-110,-110,130,1.5,-135,4.14,AT&T Park,5,3
2018-09-11,2018,PIT,STL,5,11,125,1.5,-185,7.5,100,-120,-140,-1.5,160,3.33,Busch Stadium,16,-6
2018-09-11,2018,CLE,TB,2,0,-135,-1.5,130,8.5,-110,-110,120,1.5,-150,4.88,Tropicana Field,2,2
2018-09-11,2018,LAA,TEX,1,0,-174,-1.5,115,9.0,-110,-110,154,1.5,-135,5.72,Angel Stadium,1,1
2018-09-11,2018,BOS,TOR,7,2,-330,-1.5,-160,9.0,-120,100,280,1.5,140,6.91,Fenway Park,9,5
2018-09-11,2018,PHI,WSH,1,3,-142,-1.5,142,9.0,-115,-105,127,1.5,-162,5.28,Citizens Bank Park,4,-2
2018-09-11,2018,PHI,WSH,6,7,-133,-1.5,147,8.5,-120,100,118,1.5,-169,4.85,Citizens Bank Park,13,-1
2018-09-12,2018,COL,ARI,5,4,109,1.5,-151,9.5,-115,-105,-119,-1.5,131,4.55,Coors Field,9,1
2018-09-12,2018,SF,ATL,1,2,126,1.5,-130,7.5,100,-120,-141,-1.5,110,3.32,AT&T Park,3,-1
2018-09-12,2018,OAK,BAL,10,0,-210,-1.5,-136,9.5,-105,-115,180,1.5,116,6.44,Camden Yards,10,10
2018-09-12,2018,TOR,BOS,0,1,255,1.5,121,9.0,-115,-105,-295,-1.5,-140,2.54,Fenway Park,1,-1
2018-09-12,2018,MIL,CHC,5,1,146,1.5,-150,8.5,100,-120,-161,-1.5,130,3.46,Wrigley Field,6,4
2018-09-12,2018,LAD,CIN,8,1,-183,-1.5,-121,8.5,-120,100,163,1.5,101,5.5,Great American Ballpark,9,7
2018-09-12,2018,TB,CLE,3,1,-107,-1.5,215,6.0,-115,-105,-103,1.5,-260,3.1,Tropicana Field,4,2
2018-09-12,2018,ARI,COL,4,5,-119,-1.5,131,9.5,-115,-105,109,1.5,-151,5.16,Coors Field,9,-1
2018-09-12,2018,KC,CWS,2,4,103,1.5,-162,8.5,-131,111,-113,-1.5,142,4.19,Kauffman Stadium,6,-2
2018-09-12,2018,HOU,DET,5,4,-280,-1.5,-165,8.0,-107,-113,240,1.5,144,5.89,Comerica Park,9,1
2018-09-12,2018,DET,HOU,4,5,240,1.5,144,8.0,-107,-113,-280,-1.5,-165,2.35,Comerica Park,9,-1
2018-09-12,2018,CWS,KC,4,2,-113,-1.5,142,8.5,-131,111,103,1.5,-162,4.51,Kauffman Stadium,6,2
2018-09-12,2018,TEX,LAA,1,8,162,1.5,-130,9.5,-105,-115,-182,-1.5,110,3.63,Angel Stadium,9,-7
2018-09-12,2018,CIN,LAD,1,8,163,1.5,101,8.5,-120,100,-183,-1.5,-121,3.23,Great American Ballpark,9,-7
2018-09-12,2018,NYM,MIA,13,0,-190,-1.5,111,7.0,100,-120,170,1.5,-131,4.59,Citi Field,13,13
2018-09-12,2018,CHC,MIL,1,5,-161,-1.5,130,8.5,100,-120,146,1.5,-150,5.24,Wrigley Field,6,-4
2018-09-12,2018,NYY,MIN,1,3,-215,-1.5,-140,9.0,-115,-105,185,1.5,120,6.14,Target Field,4,-2
2018-09-12,2018,MIA,NYM,0,13,170,1.5,-131,7.0,100,-120,-190,-1.5,111,2.59,Citi Field,13,-13
2018-09-12,2018,MIN,NYY,3,1,185,1.5,120,9.0,-115,-105,-215,-1.5,-140,3.16,Target Field,4,2
2018-09-12,2018,BAL,OAK,0,10,180,1.5,116,9.5,-105,-115,-210,-1.5,-136,3.39,Camden Yards,10,-10
2018-09-12,2018,WSH,PHI,5,1,116,1.5,-190,7.5,-110,-110,-126,-1.5,163,3.47,Citizens Bank Park,6,4
2018-09-12,2018,STL,PIT,3,4,-116,-1.5,176,7.5,-105,-115,106,1.5,-210,4.03,Busch Stadium,7,-1
2018-09-12,2018,SEA,SD,4,5,-138,-1.5,148,7.5,-103,-117,123,1.5,-171,4.35,T-Mobile Park,9,-1
2018-09-12,2018,SD,SEA,5,4,123,1.5,-171,7.5,-103,-117,-138,-1.5,148,3.36,T-Mobile Park,9,1
2018-09-12,2018,ATL,SF,2,1,-141,-1.5,110,7.5,100,-120,126,1.5,-130,4.39,AT&T Park,3,1
2018-09-12,2018,PIT,STL,4,3,106,1.5,-210,7.5,-105,-115,-116,-1.5,176,3.64,Busch Stadium,7,1
2018-09-12,2018,CLE,TB,1,3,-103,1.5,-260,6.0,-115,-105,-107,-1.5,215,3.04,Tropicana Field,4,-2
2018-09-12,2018,LAA,TEX,8,1,-182,-1.5,110,9.5,-105,-115,162,1.5,-130,6.13,Angel Stadium,9,7
2018-09-12,2018,BOS,TOR,1,0,-295,-1.5,-140,9.0,-115,-105,255,1.5,121,6.72,Fenway Park,1,1
2018-09-12,2018,PHI,WSH,1,5,-126,-1.5,163,7.5,-110,-110,116,1.5,-190,4.18,Citizens Bank Park,6,-4
2018-09-13,2018,COL,ARI,10,3,-119,-1.5,160,10.0,-112,-108,109,1.5,-185,5.43,Coors Field,13,7
2018-09-13,2018,OAK,BAL,3,5,-178,-1.5,-115,9.0,-119,-101,158,1.5,-105,5.76,Camden Yards,8,-2
2018-09-13,2018,TOR,BOS,3,4,190,1.5,-110,9.0,-112,-108,-220,-1.5,-110,3.1,Fenway Park,7,-1
2018-09-13,2018,WSH,CHC,3,4,101,1.5,-161,9.0,-120,100,-111,-1.5,141,4.48,Nationals Park,7,-1
2018-09-13,2018,ARI,COL,3,10,109,1.5,-185,10.0,-112,-108,-119,-1.5,160,4.78,Coors Field,13,-7
2018-09-13,2018,MIN,KC,4,6,-126,-1.5,120,9.5,-113,-107,116,1.5,-140,5.3,Kauffman Stadium,10,-2
2018-09-13,2018,SEA,LAA,8,2,103,1.5,-200,9.0,-110,-110,-113,-1.5,170,4.43,Angel Stadium,10,6
2018-09-13,2018,STL,LAD,7,9,170,1.5,105,7.5,-118,-102,-190,-1.5,-125,2.78,Busch Stadium,16,-2
2018-09-13,2018,NYM,MIA,4,3,-177,-1.5,120,7.5,-110,-110,157,1.5,-140,4.79,Citi Field,7,1
2018-09-13,2018,NYM,MIA,5,2,-175,-1.5,120,8.0,-104,-116,155,1.5,-140,5.09,Citi Field,7,3
2018-09-13,2018,KC,MIN,6,4,116,1.5,-140,9.5,-113,-107,-126,-1.5,120,4.4,Kauffman Stadium,10,2
2018-09-13,2018,MIA,NYM,3,4,157,1.5,-140,7.5,-110,-110,-177,-1.5,120,2.92,Citi Field,7,-1
2018-09-13,2018,MIA,NYM,2,5,155,1.5,-140,8.0,-104,-116,-175,-1.5,120,3.14,Citi Field,7,-3
2018-09-13,2018,BAL,OAK,5,3,158,1.5,-105,9.0,-119,-101,-178,-1.5,-115,3.49,Camden Yards,8,2
2018-09-13,2018,LAA,SEA,2,8,-113,-1.5,170,9.0,-110,-110,103,1.5,-200,4.77,Angel Stadium,10,-6
2018-09-13,2018,LAD,STL,9,7,-190,-1.5,-125,7.5,-118,-102,170,1.5,105,4.91,Busch Stadium,16,2
2018-09-13,2018,BOS,TOR,4,3,-220,-1.5,-110,9.0,-112,-108,190,1.5,-110,6.19,Fenway Park,7,1
2018-09-13,2018,CHC,WSH,4,3,-111,-1.5,141,9.0,-120,100,101,1.5,-161,4.73,Nationals Park,7,1
2018-09-14,2018,HOU,ARI,2,4,-178,-1.5,115,8.0,-109,-111,158,1.5,-135,5.12,Minute Maid Park,6,-2
2018-09-14,2018,WSH,ATL,5,10,-152,-1.5,108,8.0,-106,-114,137,1.5,-128,4.83,Suntrust Park,15,-5
2018-09-14,2018,CWS,BAL,8,6,-112,-1.5,140,9.0,-115,-105,102,1.5,-160,4.75,Camden Yards,14,2
2018-09-14,2018,NYM,BOS,8,0,102,1.5,-200,9.0,-119,-101,-112,-1.5,170,4.46,Fenway Park,8,8
2018-09-14,2018,CIN,CHC,2,3,175,1.5,-123,8.5,-101,-119,-205,-1.5,103,3.09,Wrigley Field,5,-1
2018-09-14,2018,CHC,CIN,3,2,-205,-1.5,103,8.5,-101,-119,175,1.5,-123,5.71,Wrigley Field,5,1
2018-09-14,2018,DET,CLE,5,4,174,1.5,-125,9.0,-105,-115,-194,-1.5,105,3.28,Progressive Field,9,1
2018-09-14,2018,SF,COL,2,0,101,1.5,-175,7.5,-115,-105,-111,-1.5,151,3.73,AT&T Park,2,2
2018-09-14,2018,BAL,CWS,6,8,102,1.5,-160,9.0,-115,-105,-112,-1.5,140,4.46,Camden Yards,14,-2
2018-09-14,2018,CLE,DET,4,5,-194,-1.5,105,9.0,-105,-115,174,1.5,-125,5.94,Progressive Field,9,-1
2018-09-14,2018,ARI,HOU,4,2,158,1.5,-135,8.0,-109,-111,-178,-1.5,115,3.1,Minute Maid Park,6,2
2018-09-14,2018,MIN,KC,4,8,-138,-1.5,118,8.5,-116,-104,123,1.5,-138,4.93,Kauffman Stadium,12,-4
2018-09-14,2018,SEA,LAA,5,0,134,1.5,-165,9.0,-119,-101,-149,-1.5,144,3.85,Angel Stadium,5,5
2018-09-14,2018,STL,LAD,0,3,113,1.5,-155,7.5,-105,-115,-123,-1.5,135,3.52,Busch Stadium,3,-3
2018-09-14,2018,PHI,MIA,14,2,-185,-1.5,110,8.5,-105,-115,165,1.5,-130,5.52,Citizens Bank Park,16,12
2018-09-14,2018,PIT,MIL,4,7,127,1.5,-170,8.5,-101,-119,-142,-1.5,148,3.74,Miller Park,11,-3
2018-09-14,2018,KC,MIN,8,4,123,1.5,-138,8.5,-116,-104,-138,-1.5,118,3.81,Kauffman Stadium,12,4
2018-09-14,2018,BOS,NYM,0,8,-112,-1.5,170,9.0,-119,-101,102,1.5,-200,4.75,Fenway Park,8,-8
2018-09-14,2018,TOR,NYY,0,11,258,1.5,131,9.0,-101,-119,-308,-1.5,-151,2.51,Yankee Stadium,11,-11
2018-09-14,2018,TB,OAK,1,2,-131,-1.5,160,8.5,100,-120,116,1.5,-186,4.82,Tropicana Field,3,-1
2018-09-14,2018,MIA,PHI,2,14,165,1.5,-130,8.5,-105,-115,-185,-1.5,110,3.21,Citizens Bank Park,16,-12
2018-09-14,2018,MIL,PIT,7,4,-142,-1.5,148,8.5,-101,-119,127,1.5,-170,4.99,Miller Park,11,3
2018-09-14,2018,TEX,SD,4,0,127,1.5,-172,8.0,-109,-111,-142,-1.5,149,3.52,PETCO Park,4,4
2018-09-14,2018,LAA,SEA,0,5,-149,-1.5,144,9.0,-119,-101,134,1.5,-165,5.39,Angel Stadium,5,-5
2018-09-14,2018,COL,SF,0,2,-111,-1.5,151,7.5,-115,-105,101,1.5,-175,3.95,AT&T Park,2,-2
2018-09-14,2018,LAD,STL,3,0,-123,-1.5,135,7.5,-105,-115,113,1.5,-155,4.14,Busch Stadium,3,3
2018-09-14,2018,OAK,TB,2,1,116,1.5,-186,8.5,100,-120,-131,-1.5,160,3.94,Tropicana Field,3,1
2018-09-14,2018,SD,TEX,0,4,-142,-1.5,149,8.0,-109,-111,127,1.5,-172,4.69,PETCO Park,4,-4
2018-09-14,2018,NYY,TOR,11,0,-308,-1.5,-151,9.0,-101,-119,258,1.5,131,6.79,Yankee Stadium,11,11
2018-09-14,2018,ATL,WSH,10,5,137,1.5,-128,8.0,-106,-114,-152,-1.5,108,3.38,Suntrust Park,15,5
2018-09-15,2018,HOU,ARI,10,4,-178,-1.5,116,8.0,-125,105,158,1.5,-137,5.12,Minute Maid Park,14,6
2018-09-15,2018,WSH,ATL,7,1,115,1.5,-182,9.5,-120,100,-125,-1.5,157,4.42,Suntrust Park,8,6
2018-09-15,2018,CWS,BAL,2,0,-109,-1.5,144,9.0,100,-120,-101,1.5,-165,4.69,Camden Yards,2,2
2018-09-15,2018,NYM,BOS,3,5,220,1.5,118,10.0,-107,-113,-260,-1.5,-140,3.13,Fenway Park,8,-2
2018-09-15,2018,CIN,CHC,0,1,185,1.5,-105,8.5,-105,-115,-215,-1.5,-115,2.98,Wrigley Field,1,-1
2018-09-15,2018,CHC,CIN,1,0,-215,-1.5,-115,8.5,-105,-115,185,1.5,-105,5.8,Wrigley Field,1,1
2018-09-15,2018,DET,CLE,0,15,240,1.5,108,8.0,-104,-116,-280,-1.5,-127,2.35,Progressive Field,15,-15
2018-09-15,2018,SF,COL,3,0,142,1.5,-134,6.5,-110,-110,-157,-1.5,113,2.69,AT&T Park,3,3
2018-09-15,2018,BAL,CWS,0,2,-101,1.5,-165,9.0,100,-120,-109,-1.5,144,4.52,Camden Yards,2,-2
2018-09-15,2018,CLE,DET,15,0,-280,-1.5,-127,8.0,-104,-116,240,1.5,108,5.89,Progressive Field,15,15
2018-09-15,2018,ARI,HOU,4,10,158,1.5,-137,8.0,-125,105,-178,-1.5,116,3.1,Minute Maid Park,14,-6
2018-09-15,2018,MIN,KC,3,10,102,1.5,-200,9.0,-115,-105,-112,-1.5,170,4.46,Kauffman Stadium,13,-7
2018-09-15,2018,SEA,LAA,6,5,135,1.5,-160,8.5,100,-120,-150,-1.5,140,3.62,Angel Stadium,11,1
2018-09-15,2018,STL,LAD,4,17,140,1.5,-125,8.5,-110,-110,-155,-1.5,105,3.54,Busch Stadium,21,-13
2018-09-15,2018,PHI,MIA,5,4,-215,-1.5,-121,8.5,-121,101,185,1.5,101,5.8,Citizens Bank Park,9,1
2018-09-15,2018,PIT,MIL,3,1,154,1.5,-142,8.5,-126,106,-174,-1.5,121,3.35,Miller Park,4,2
2018-09-15,2018,KC,MIN,10,3,-112,-1.5,170,9.0,-115,-105,102,1.5,-200,4.75,Kauffman Stadium,13,7
2018-09-15,2018,BOS,NYM,5,3,-260,-1.5,-140,10.0,-107,-113,220,1.5,118,7.22,Fenway Park,8,2
2018-09-15,2018,TOR,NYY,8,7,190,1.5,102,9.0,-132,112,-220,-1.5,-122,3.1,Yankee Stadium,15,1
2018-09-15,2018,TB,OAK,7,5,-113,-1.5,178,8.5,100,-120,103,1.5,-213,4.51,Tropicana Field,12,2
2018-09-15,2018,MIA,PHI,4,5,185,1.5,101,8.5,-121,101,-215,-1.5,-121,2.98,Citizens Bank Park,9,-1
2018-09-15,2018,MIL,PIT,1,3,-174,-1.5,121,8.5,-126,106,154,1.5,-142,5.4,Miller Park,4,-2
2018-09-15,2018,TEX,SD,6,3,123,1.5,-175,8.0,-119,-101,-138,-1.5,151,3.59,PETCO Park,9,3
2018-09-15,2018,LAA,SEA,5,6,-150,-1.5,140,8.5,100,-120,135,1.5,-160,5.1,Angel Stadium,11,-1
2018-09-15,2018,COL,SF,0,3,-157,-1.5,113,6.5,-110,-110,142,1.5,-134,3.97,AT&T Park,3,-3
2018-09-15,2018,LAD,STL,17,4,-155,-1.5,105,8.5,-110,-110,140,1.5,-125,5.17,Busch Stadium,21,13
2018-09-15,2018,OAK,TB,5,7,103,1.5,-213,8.5,100,-120,-113,-1.5,178,4.19,Tropicana Field,12,-2
2018-09-15,2018,SD,TEX,3,6,-138,-1.5,151,8.0,-119,-101,123,1.5,-175,4.64,PETCO Park,9,-3
2018-09-15,2018,NYY,TOR,7,8,-220,-1.5,-122,9.0,-132,112,190,1.5,102,6.19,Yankee Stadium,15,-1
2018-09-15,2018,ATL,WSH,1,7,-125,-1.5,157,9.5,-120,100,115,1.5,-182,5.28,Suntrust Park,8,-6
2018-09-16,2018,HOU,ARI,5,4,-195,-1.5,109,7.0,-105,-115,175,1.5,-130,4.63,Minute Maid Park,9,1
2018-09-16,2018,WSH,ATL,6,4,116,1.5,-180,9.0,102,-122,-131,-1.5,155,4.17,Suntrust Park,10,2
2018-09-16,2018,CWS,BAL,4,8,-119,-1.5,133,9.0,-109,-111,109,1.5,-153,4.89,Camden Yards,12,-4
2018-09-16,2018,NYM,BOS,3,4,158,1.5,-140,7.0,-111,-109,-178,-1.5,120,2.71,Fenway Park,7,-1
2018-09-16,2018,CIN,CHC,2,1,138,1.5,-155,8.0,-101,-119,-153,-1.5,135,3.36,Wrigley Field,3,1
2018-09-16,2018,CHC,CIN,1,2,-153,-1.5,135,8.0,-101,-119,138,1.5,-155,4.84,Wrigley Field,3,-1
2018-09-16,2018,DET,CLE,6,4,170,1.5,-122,8.0,-120,100,-190,-1.5,102,2.96,Progressive Field,10,2
2018-09-16,2018,SF,COL,2,3,115,1.5,-149,7.5,-105,-115,-125,-1.5,129,3.49,AT&T Park,5,-1
2018-09-16,2018,BAL,CWS,8,4,109,1.5,-153,9.0,-109,-111,-119,-1.5,133,4.31,Camden Yards,12,4
2018-09-16,2018,CLE,DET,4,6,-190,-1.5,102,8.0,-120,100,170,1.5,-122,5.24,Progressive Field,10,-2
2018-09-16,2018,ARI,HOU,4,5,175,1.5,-130,7.0,-105,-115,-195,-1.5,109,2.55,Minute Maid Park,9,-1
2018-09-16,2018,MIN,KC,9,6,-105,1.5,-215,8.5,-105,-115,-105,-1.5,180,4.35,Kauffman Stadium,15,3
2018-09-16,2018,SEA,LAA,3,4,-117,-1.5,135,8.5,-112,-108,107,1.5,-155,4.58,Angel Stadium,7,-1
2018-09-16,2018,STL,LAD,5,0,136,1.5,-130,8.5,-110,-110,-151,-1.5,110,3.6,Busch Stadium,5,5
2018-09-16,2018,PHI,MIA,4,6,-215,-1.5,-110,8.5,100,-120,185,1.5,-110,5.8,Citizens Bank Park,10,-2
2018-09-16,2018,PIT,MIL,3,2,153,1.5,-142,8.0,-115,-105,-168,-1.5,122,3.16,Miller Park,5,1
2018-09-16,2018,KC,MIN,6,9,-105,-1.5,180,8.5,-105,-115,-105,1.5,-215,4.35,Kauffman Stadium,15,-3
2018-09-16,2018,BOS,NYM,4,3,-178,-1.5,120,7.0,-111,-109,158,1.5,-140,4.48,Fenway Park,7,1
2018-09-16,2018,TOR,NYY,3,2,190,1.5,100,10.0,-105,-115,-220,-1.5,-121,3.45,Yankee Stadium,5,1
2018-09-16,2018,TB,OAK,5,4,260,1.5,-170,7.5,-119,-101,-310,-1.5,148,2.08,Tropicana Field,9,1
2018-09-16,2018,MIA,PHI,6,4,185,1.5,-110,8.5,100,-120,-215,-1.5,-110,2.98,Citizens Bank Park,10,2
2018-09-16,2018,MIL,PIT,2,3,-168,-1.5,122,8.0,-115,-105,153,1.5,-142,5.01,Miller Park,5,-1
2018-09-16,2018,TEX,SD,3,7,-122,-1.5,131,8.5,-101,-119,112,1.5,-151,4.67,PETCO Park,10,-4
2018-09-16,2018,LAA,SEA,4,3,107,1.5,-155,8.5,-112,-108,-117,-1.5,135,4.11,Angel Stadium,7,1
2018-09-16,2018,COL,SF,3,2,-125,-1.5,129,7.5,-105,-115,115,1.5,-149,4.17,AT&T Park,5,1
2018-09-16,2018,LAD,STL,0,5,-151,-1.5,110,8.5,-110,-110,136,1.5,-130,5.11,Busch Stadium,5,-5
2018-09-16,2018,OAK,TB,4,5,-310,-1.5,148,7.5,-119,-101,260,1.5,-170,5.67,Tropicana Field,9,-1
2018-09-16,2018,SD,TEX,7,3,112,1.5,-151,8.5,-101,-119,-122,-1.5,131,4.01,PETCO Park,10,4
2018-09-16,2018,NYY,TOR,2,3,-220,-1.5,-121,10.0,-105,-115,190,1.5,100,6.88,Yankee Stadium,5,-1
2018-09-16,2018,ATL,WSH,4,6,-131,-1.5,155,9.0,102,-122,116,1.5,-180,5.1,Suntrust Park,10,-2
2018-09-17,2018,CHC,ARI,5,1,128,1.5,-175,7.5,-114,-106,-143,-1.5,151,3.29,Chase Field,6,4
2018-09-17,2018,STL,ATL,11,6,127,1.5,-175,8.0,-110,-110,-142,-1.5,151,3.52,Suntrust Park,17,5
2018-09-17,2018,TOR,BAL,5,0,-126,-1.5,124,9.5,-102,-118,116,1.5,-144,5.3,Camden Yards,5,5
2018-09-17,2018,ARI,CHC,1,5,-143,-1.5,151,7.5,-114,-106,128,1.5,-175,4.41,Chase Field,6,-4
2018-09-17,2018,MIL,CIN,8,0,-192,-1.5,103,9.0,100,-120,172,1.5,-123,5.92,Miller Park,8,8
2018-09-17,2018,LAD,COL,8,2,-157,-1.5,135,7.5,100,-120,142,1.5,-155,4.58,Dodger Stadium,10,6
2018-09-17,2018,MIN,DET,6,1,-118,-1.5,130,9.0,-103,-117,108,1.5,-150,4.87,Comerica Park,7,5
2018-09-17,2018,SEA,HOU,4,1,140,1.5,-150,9.0,-107,-113,-155,-1.5,130,3.75,Minute Maid Park,5,3
2018-09-17,2018,PIT,KC,7,6,-170,-1.5,120,7.0,-120,100,150,1.5,-140,4.41,PNC Park,13,1
2018-09-17,2018,COL,LAD,2,8,142,1.5,-155,7.5,100,-120,-157,-1.5,135,3.1,Dodger Stadium,10,-6
2018-09-17,2018,WSH,MIA,5,8,-160,-1.5,-105,8.5,100,-120,145,1.5,-115,5.23,Marlins Park,13,-3
2018-09-17,2018,CIN,MIL,0,8,172,1.5,-123,9.0,100,-120,-192,-1.5,103,3.31,Miller Park,8,-8
2018-09-17,2018,DET,MIN,1,6,108,1.5,-150,9.0,-103,-117,-118,-1.5,130,4.33,Comerica Park,7,-5
2018-09-17,2018,PHI,NYM,4,9,-155,-1.5,140,7.5,-115,-105,140,1.5,-160,4.56,Citizens Bank Park,13,-5
2018-09-17,2018,NYM,PHI,9,4,140,1.5,-160,7.5,-115,-105,-155,-1.5,140,3.13,Citizens Bank Park,13,5
2018-09-17,2018,KC,PIT,6,7,150,1.5,-140,7.0,-120,100,-170,-1.5,120,2.8,PNC Park,13,-1
2018-09-17,2018,SF,SD,4,2,101,1.5,-210,7.5,-117,-103,-111,-1.5,176,3.73,PETCO Park,6,2
2018-09-17,2018,HOU,SEA,1,4,-155,-1.5,130,9.0,-107,-113,140,1.5,-150,5.47,Minute Maid Park,5,-3
2018-09-17,2018,SD,SF,2,4,-111,-1.5,176,7.5,-117,-103,101,1.5,-210,3.95,PETCO Park,6,-2
2018-09-17,2018,ATL,STL,6,11,-142,-1.5,151,8.0,-110,-110,127,1.5,-175,4.69,Suntrust Park,17,-5
2018-09-17,2018,TEX,TB,0,3,127,1.5,-126,10.5,-115,-105,-142,-1.5,106,4.63,Rangers Ballpark,3,-3
2018-09-17,2018,TB,TEX,3,0,-142,-1.5,106,10.5,-115,-105,127,1.5,-126,6.16,Rangers Ballpark,3,3
2018-09-17,2018,BAL,TOR,0,5,116,1.5,-144,9.5,-102,-118,-126,-1.5,124,4.4,Camden Yards,5,-5
2018-09-17,2018,MIA,WSH,8,5,145,1.5,-115,8.5,100,-120,-160,-1.5,-105,3.47,Marlins Park,13,3
2018-09-18,2018,CHC,ARI,9,1,103,1.5,-210,8.5,-125,105,-113,-1.5,176,4.19,Chase Field,10,8
2018-09-18,2018,STL,ATL,8,1,116,1.5,-190,9.0,-105,-115,-126,-1.5,163,4.17,Suntrust Park,9,7
2018-09-18,2018,TOR,BAL,6,4,-116,-1.5,139,9.0,-105,-115,106,1.5,-159,4.83,Camden Yards,10,2
2018-09-18,2018,NYY,BOS,3,2,-167,-1.5,115,9.0,-115,-105,152,1.5,-135,5.63,Yankee Stadium,5,1
2018-09-18,2018,ARI,CHC,1,9,-113,-1.5,176,8.5,-125,105,103,1.5,-210,4.51,Chase Field,10,-8
2018-09-18,2018,MIL,CIN,1,3,-205,-1.5,-105,9.0,-105,-115,175,1.5,-115,6.05,Miller Park,4,-2
2018-09-18,2018,CWS,CLE,3,5,250,1.5,119,8.0,-105,-115,-290,-1.5,-139,2.29,Progressive Field,8,-2
2018-09-18,2018,LAD,COL,3,2,-225,-1.5,-105,7.0,-115,-105,195,1.5,-115,4.85,Dodger Stadium,5,1
2018-09-18,2018,CLE,CWS,5,3,-290,-1.5,-139,8.0,-105,-115,250,1.5,119,5.95,Progressive Field,8,2
2018-09-18,2018,MIN,DET,5,3,-108,-1.5,148,8.5,-115,-105,-102,1.5,-170,4.41,Comerica Park,8,2
2018-09-18,2018,SEA,HOU,0,7,152,1.5,-140,8.5,-115,-105,-167,-1.5,120,3.37,Minute Maid Park,7,-7
2018-09-18,2018,PIT,KC,2,1,-226,-1.5,-120,7.5,-120,100,196,1.5,100,5.2,PNC Park,3,1
2018-09-18,2018,OAK,LAA,7,9,-143,-1.5,144,8.0,-115,-105,128,1.5,-165,4.71,Oakland Coliseum,16,-2
2018-09-18,2018,COL,LAD,2,3,195,1.5,-115,7.0,-115,-105,-225,-1.5,-105,2.37,Dodger Stadium,5,-1
2018-09-18,2018,WSH,MIA,4,2,-235,-1.5,-140,7.5,-110,-110,205,1.5,120,5.26,Marlins Park,6,2
2018-09-18,2018,CIN,MIL,3,1,175,1.5,-115,9.0,-105,-115,-205,-1.5,-105,3.27,Miller Park,4,2
2018-09-18,2018,DET,MIN,3,5,-102,1.5,-170,8.5,-115,-105,-108,-1.5,148,4.29,Comerica Park,8,-2
2018-09-18,2018,PHI,NYM,5,2,-190,-1.5,110,7.5,105,-125,170,1.5,-130,4.91,Citizens Bank Park,7,3
2018-09-18,2018,BOS,NYY,2,3,152,1.5,-135,9.0,-115,-105,-167,-1.5,115,3.57,Yankee Stadium,5,-1
2018-09-18,2018,LAA,OAK,9,7,128,1.5,-165,8.0,-115,-105,-143,-1.5,144,3.51,Oakland Coliseum,16,2
2018-09-18,2018,NYM,PHI,2,5,170,1.5,-130,7.5,105,-125,-190,-1.5,110,2.78,Citizens Bank Park,7,-3
2018-09-18,2018,KC,PIT,1,2,196,1.5,100,7.5,-120,100,-226,-1.5,-120,2.53,PNC Park,3,-1
2018-09-18,2018,SF,SD,5,4,165,1.5,-160,7.0,110,-130,-185,-1.5,140,2.64,PETCO Park,9,1
2018-09-18,2018,HOU,SEA,7,0,-167,-1.5,120,8.5,-115,-105,152,1.5,-140,5.32,Minute Maid Park,7,7
2018-09-18,2018,SD,SF,4,5,-185,-1.5,140,7.0,110,-130,165,1.5,-160,4.54,PETCO Park,9,-1
2018-09-18,2018,ATL,STL,1,8,-126,-1.5,163,9.0,-105,-115,116,1.5,-190,5.02,Suntrust Park,9,-7
2018-09-18,2018,TEX,TB,0,4,177,1.5,110,9.0,-113,-107,-197,-1.5,-130,3.25,Rangers Ballpark,4,-4
2018-09-18,2018,TB,TEX,4,0,-197,-1.5,-130,9.0,-113,-107,177,1.5,110,5.97,Rangers Ballpark,4,4
2018-09-18,2018,BAL,TOR,4,6,106,1.5,-159,9.0,-105,-115,-116,-1.5,139,4.37,Camden Yards,10,-2
2018-09-18,2018,MIA,WSH,2,4,205,1.5,120,7.5,-110,-110,-235,-1.5,-140,2.46,Marlins Park,6,-2
2018-09-19,2018,CHC,ARI,0,9,-155,-1.5,105,7.5,-109,-111,140,1.5,-125,4.56,Chase Field,9,-9
2018-09-19,2018,STL,ATL,3,7,-116,-1.5,139,8.5,-105,-115,106,1.5,-159,4.56,Suntrust Park,10,-4
2018-09-19,2018,TOR,BAL,1,2,-121,-1.5,129,9.5,-112,-108,111,1.5,-149,5.2,Camden Yards,3,-1
2018-09-19,2018,NYY,BOS,10,1,-160,-1.5,135,8.5,-119,-101,145,1.5,-155,5.23,Yankee Stadium,11,9
2018-09-19,2018,ARI,CHC,9,0,140,1.5,-125,7.5,-109,-111,-155,-1.5,105,3.13,Chase Field,9,9
2018-09-19,2018,MIL,CIN,7,0,-165,-1.5,120,8.5,-120,100,150,1.5,-140,5.29,Miller Park,7,7
2018-09-19,2018,CWS,CLE,1,4,310,1.5,148,9.0,105,-125,-370,-1.5,-170,2.2,Progressive Field,5,-3
2018-09-19,2018,LAD,COL,5,2,-215,-1.5,-105,7.0,-119,-101,185,1.5,-115,4.78,Dodger Stadium,7,3
2018-09-19,2018,CLE,CWS,4,1,-370,-1.5,-170,9.0,105,-125,310,1.5,148,7.09,Progressive Field,5,3
2018-09-19,2018,MIN,DET,8,2,-113,-1.5,142,9.0,100,-120,103,1.5,-162,4.77,Comerica Park,10,6
2018-09-19,2018,SEA,HOU,9,0,179,1.5,-121,8.5,-110,-110,-199,-1.5,101,3.05,Minute Maid Park,9,9
2018-09-19,2018,PIT,KC,2,1,-226,-1.5,-110,8.0,101,-121,196,1.5,-110,5.55,PNC Park,3,1
2018-09-19,2018,OAK,LAA,10,0,-145,-1.5,143,8.0,-119,-101,130,1.5,-163,4.73,Oakland Coliseum,10,10
2018-09-19,2018,COL,LAD,2,5,185,1.5,-115,7.0,-119,-101,-215,-1.5,-105,2.46,Dodger Stadium,7,-3
2018-09-19,2018,CIN,MIL,0,7,150,1.5,-140,8.5,-120,100,-165,-1.5,120,3.4,Miller Park,7,-7
2018-09-19,2018,DET,MIN,2,8,103,1.5,-162,9.0,100,-120,-113,-1.5,142,4.43,Comerica Park,10,-6
2018-09-19,2018,PHI,NYM,4,0,109,1.5,-157,8.0,-104,-116,-119,-1.5,137,3.83,Citizens Bank Park,4,4
2018-09-19,2018,BOS,NYY,1,10,145,1.5,-155,8.5,-119,-101,-160,-1.5,135,3.47,Yankee Stadium,11,-9
2018-09-19,2018,LAA,OAK,0,10,130,1.5,-163,8.0,-119,-101,-145,-1.5,143,3.48,Oakland Coliseum,10,-10
2018-09-19,2018,NYM,PHI,0,4,-119,-1.5,137,8.0,-104,-116,109,1.5,-157,4.35,Citizens Bank Park,4,-4
2018-09-19,2018,KC,PIT,1,2,196,1.5,-110,8.0,101,-121,-226,-1.5,-110,2.7,PNC Park,3,-1
2018-09-19,2018,SF,SD,4,8,150,1.5,-150,7.0,-119,-101,-165,-1.5,130,2.8,PETCO Park,12,-4
2018-09-19,2018,HOU,SEA,0,9,-199,-1.5,101,8.5,-110,-110,179,1.5,-121,5.66,Minute Maid Park,9,-9
2018-09-19,2018,SD,SF,8,4,-165,-1.5,130,7.0,-119,-101,150,1.5,-150,4.36,PETCO Park,12,4
2018-09-19,2018,ATL,STL,7,3,106,1.5,-159,8.5,-105,-115,-116,-1.5,139,4.13,Suntrust Park,10,4
2018-09-19,2018,TEX,TB,3,9,135,1.5,-125,9.5,104,-124,-150,-1.5,105,4.04,Rangers Ballpark,12,-6
2018-09-19,2018,TB,TEX,9,3,-150,-1.5,105,9.5,104,-124,135,1.5,-125,5.7,Rangers Ballpark,12,6
2018-09-19,2018,BAL,TOR,2,1,111,1.5,-149,9.5,-112,-108,-121,-1.5,129,4.5,Camden Yards,3,1
2018-09-20,2018,PHI,ATL,3,8,128,1.5,-160,9.0,-105,-115,-143,-1.5,140,3.95,Suntrust Park,11,-5
2018-09-20,2018,NYY,BOS,6,11,-153,-1.5,135,8.5,-106,-114,138,1.5,-155,5.14,Yankee Stadium,17,-5
2018-09-20,2018,MIA,CIN,2,4,119,1.5,-144,8.0,-115,-105,-129,-1.5,124,3.65,Marlins Park,6,-2
2018-09-20,2018,CWS,CLE,5,4,185,1.5,-112,10.5,-110,-110,-215,-1.5,-108,3.68,Progressive Field,9,1
2018-09-20,2018,CLE,CWS,4,5,-215,-1.5,-108,10.5,-110,-110,185,1.5,-112,7.17,Progressive Field,9,-1
2018-09-20,2018,KC,DET,8,11,127,1.5,-170,8.0,-101,-119,-142,-1.5,148,3.52,Comerica Park,19,-3
2018-09-20,2018,DET,KC,11,8,-142,-1.5,148,8.0,-101,-119,127,1.5,-170,4.69,Comerica Park,19,3
2018-09-20,2018,OAK,LAA,21,3,-129,-1.5,155,8.5,-121,101,119,1.5,-180,4.79,Oakland Coliseum,24,18
2018-09-20,2018,CIN,MIA,4,2,-129,-1.5,124,8.0,-115,-105,119,1.5,-144,4.51,Marlins Park,6,2
2018-09-20,2018,WSH,NYM,4,5,-295,-1.5,-140,8.0,-101,-119,255,1.5,120,5.97,Nationals Park,9,-1
2018-09-20,2018,BOS,NYY,11,6,138,1.5,-155,8.5,-106,-114,-153,-1.5,135,3.57,Yankee Stadium,17,5
2018-09-20,2018,LAA,OAK,3,21,119,1.5,-180,8.5,-121,101,-129,-1.5,155,3.88,Oakland Coliseum,24,-18
2018-09-20,2018,ATL,PHI,8,3,-143,-1.5,140,9.0,-105,-115,128,1.5,-160,5.3,Suntrust Park,11,5
2018-09-20,2018,TOR,TB,9,8,138,1.5,-120,8.5,-110,-110,-153,-1.5,100,3.57,Rogers Centre,17,1
2018-09-20,2018,TB,TOR,8,9,-153,-1.5,100,8.5,-110,-110,138,1.5,-120,5.14,Rogers Centre,17,-1
2018-09-20,2018,NYM,WSH,5,4,255,1.5,120,8.0,-101,-119,-295,-1.5,-140,2.25,Nationals Park,9,1
2018-09-21,2018,COL,ARI,6,2,108,1.5,-202,7.0,-120,100,-118,-1.5,170,3.37,Chase Field,8,4
2018-09-21,2018,PHI,ATL,5,6,112,1.5,-188,9.0,-116,-104,-122,-1.5,162,4.25,Suntrust Park,11,-1
2018-09-21,2018,NYY,BAL,10,8,-333,-1.5,-156,9.0,-119,-101,283,1.5,136,6.92,Yankee Stadium,18,2
2018-09-21,2018,CLE,BOS,5,7,-155,-1.5,140,7.0,-104,-116,140,1.5,-160,4.25,Progressive Field,12,-2
2018-09-21,2018,CWS,CHC,10,4,170,1.5,100,9.0,100,-120,-190,-1.5,-120,3.33,Guaranteed Rate Field,14,6
2018-09-21,2018,MIA,CIN,1,0,123,1.5,-137,7.5,-105,-115,-138,-1.5,117,3.36,Marlins Park,1,1
2018-09-21,2018,BOS,CLE,7,5,140,1.5,-160,7.0,-104,-116,-155,-1.5,140,2.92,Progressive Field,12,2
2018-09-21,2018,ARI,COL,2,6,-118,-1.5,170,7.0,-120,100,108,1.5,-202,3.79,Chase Field,8,-4
2018-09-21,2018,CHC,CWS,4,10,-190,-1.5,-120,9.0,100,-120,170,1.5,100,5.9,Guaranteed Rate Field,14,-6
2018-09-21,2018,KC,DET,4,3,-105,1.5,-214,8.5,-118,-102,-105,-1.5,179,4.35,Comerica Park,7,1
2018-09-21,2018,LAA,HOU,3,11,175,1.5,-130,7.5,-110,-110,-195,-1.5,110,2.73,Minute Maid Park,14,-8
2018-09-21,2018,DET,KC,3,4,-105,-1.5,179,8.5,-118,-102,-105,1.5,-214,4.35,Comerica Park,7,-1
2018-09-21,2018,HOU,LAA,11,3,-195,-1.5,110,7.5,-110,-110,175,1.5,-130,4.96,Minute Maid Park,14,8
2018-09-21,2018,SD,LAD,5,3,230,1.5,105,8.0,100,-120,-270,-1.5,-125,2.42,Dodger Stadium,8,2
2018-09-21,2018,CIN,MIA,0,1,-138,-1.5,117,7.5,-105,-115,123,1.5,-137,4.35,Marlins Park,1,-1
2018-09-21,2018,PIT,MIL,3,8,123,1.5,-137,8.0,-116,-104,-138,-1.5,117,3.59,PNC Park,11,-5
2018-09-21,2018,OAK,MIN,7,6,-178,-1.5,115,7.5,-120,100,158,1.5,-137,4.8,Oakland Coliseum,13,1
2018-09-21,2018,WSH,NYM,2,4,150,1.5,-117,8.0,100,-120,-170,-1.5,-103,3.2,Nationals Park,6,-2
2018-09-21,2018,BAL,NYY,8,10,283,1.5,136,9.0,-119,-101,-333,-1.5,-156,2.35,Yankee Stadium,18,-2
2018-09-21,2018,MIN,OAK,6,7,158,1.5,-137,7.5,-120,100,-178,-1.5,115,2.91,Oakland Coliseum,13,-1
2018-09-21,2018,ATL,PHI,6,5,-122,-1.5,162,9.0,-116,-104,112,1.5,-188,4.95,Suntrust Park,11,1
2018-09-21,2018,MIL,PIT,8,3,-138,-1.5,117,8.0,-116,-104,123,1.5,-137,4.64,PNC Park,11,5
2018-09-21,2018,LAD,SD,3,5,-270,-1.5,-125,8.0,100,-120,230,1.5,105,5.84,Dodger Stadium,8,-2
2018-09-21,2018,TEX,SEA,8,3,108,1.5,-146,10.5,-119,-101,-118,-1.5,126,5.05,Rangers Ballpark,11,5
2018-09-21,2018,STL,SF,5,3,-176,-1.5,125,7.5,-113,-107,156,1.5,-145,4.78,Busch Stadium,8,2
2018-09-21,2018,SF,STL,3,5,156,1.5,-145,7.5,-113,-107,-176,-1.5,125,2.93,Busch Stadium,8,-2
2018-09-21,2018,TOR,TB,3,11,137,1.5,-120,8.5,-120,100,-152,-1.5,100,3.59,Rogers Centre,14,-8
2018-09-21,2018,SEA,TEX,3,8,-118,-1.5,126,10.5,-119,-101,108,1.5,-146,5.68,Rangers Ballpark,11,-5
2018-09-21,2018,TB,TOR,11,3,-152,-1.5,100,8.5,-120,100,137,1.5,-120,5.13,Rogers Centre,14,8
2018-09-21,2018,NYM,WSH,4,2,-170,-1.5,-103,8.0,100,-120,150,1.5,-117,5.04,Nationals Park,6,2
2018-09-22,2018,COL,ARI,5,1,158,1.5,-135,8.0,-110,-110,-178,-1.5,115,3.1,Chase Field,6,4
2018-09-22,2018,PHI,ATL,3,5,140,1.5,-157,8.5,-120,100,-155,-1.5,137,3.54,Suntrust Park,8,-2
2018-09-22,2018,NYY,BAL,3,2,-327,-1.5,-155,10.0,-105,-115,277,1.5,135,7.66,Yankee Stadium,5,1
2018-09-22,2018,CLE,BOS,5,4,-149,-1.5,143,8.5,-105,-115,134,1.5,-163,5.09,Progressive Field,9,1
2018-09-22,2018,CWS,CHC,3,8,175,1.5,116,9.0,108,-128,-205,-1.5,-136,3.27,Guaranteed Rate Field,11,-5
2018-09-22,2018,MIA,CIN,5,1,105,1.5,-165,7.5,-110,-110,-115,-1.5,144,3.66,Marlins Park,6,4
2018-09-22,2018,BOS,CLE,4,5,134,1.5,-163,8.5,-105,-115,-149,-1.5,143,3.63,Progressive Field,9,-1
2018-09-22,2018,ARI,COL,1,5,-178,-1.5,115,8.0,-110,-110,158,1.5,-135,5.12,Chase Field,6,-4
2018-09-22,2018,CHC,CWS,8,3,-205,-1.5,-136,9.0,108,-128,175,1.5,116,6.05,Guaranteed Rate Field,11,5
2018-09-22,2018,KC,DET,4,5,-218,1.5,-212,8.5,-110,-110,188,-1.5,177,5.83,Comerica Park,9,-1
2018-09-22,2018,LAA,HOU,5,10,243,1.5,115,7.5,-115,-105,-283,-1.5,-135,2.19,Minute Maid Park,15,-5
2018-09-22,2018,DET,KC,5,4,188,-1.5,177,8.5,-110,-110,-218,1.5,-212,2.95,Comerica Park,9,1
2018-09-22,2018,HOU,LAA,10,5,-283,-1.5,-135,7.5,-115,-105,243,1.5,115,5.54,Minute Maid Park,15,5
2018-09-22,2018,SD,LAD,2,7,275,1.5,128,8.5,100,-120,-325,-1.5,-148,2.27,Dodger Stadium,9,-5
2018-09-22,2018,CIN,MIA,1,5,-115,-1.5,144,7.5,-110,-110,105,1.5,-165,4.01,Marlins Park,6,-4
2018-09-22,2018,PIT,MIL,3,0,109,1.5,-156,7.5,-110,-110,-119,-1.5,136,3.59,PNC Park,3,3
2018-09-22,2018,OAK,MIN,3,2,-252,-1.5,-132,8.5,-121,101,212,1.5,112,6.09,Oakland Coliseum,5,1
2018-09-22,2018,WSH,NYM,6,0,-146,-1.5,144,9.5,-108,-112,131,1.5,-165,5.64,Nationals Park,6,6
2018-09-22,2018,BAL,NYY,2,3,277,1.5,135,10.0,-105,-115,-327,-1.5,-155,2.65,Yankee Stadium,5,-1
2018-09-22,2018,MIN,OAK,2,3,212,1.5,112,8.5,-121,101,-252,-1.5,-132,2.72,Oakland Coliseum,5,-1
2018-09-22,2018,ATL,PHI,5,3,-155,-1.5,137,8.5,-120,100,140,1.5,-157,5.17,Suntrust Park,8,2
2018-09-22,2018,MIL,PIT,0,3,-119,-1.5,136,7.5,-110,-110,109,1.5,-156,4.08,PNC Park,3,-3
2018-09-22,2018,LAD,SD,7,2,-325,-1.5,-148,8.5,100,-120,275,1.5,128,6.5,Dodger Stadium,9,5
2018-09-22,2018,TEX,SEA,0,13,-109,-1.5,163,9.5,-101,-119,-101,1.5,-190,4.95,Rangers Ballpark,13,-13
2018-09-22,2018,STL,SF,5,4,-179,-1.5,120,7.5,-110,-110,159,1.5,-140,4.81,Busch Stadium,9,1
2018-09-22,2018,SF,STL,4,5,159,1.5,-140,7.5,-110,-110,-179,-1.5,120,2.9,Busch Stadium,9,-1
2018-09-22,2018,TOR,TB,5,2,136,1.5,-125,8.5,-119,-101,-151,-1.5,105,3.6,Rogers Centre,7,3
2018-09-22,2018,SEA,TEX,13,0,-101,1.5,-190,9.5,-101,-119,-109,-1.5,163,4.77,Rangers Ballpark,13,13
2018-09-22,2018,TB,TOR,2,5,-151,-1.5,105,8.5,-119,-101,136,1.5,-125,5.11,Rogers Centre,7,-3
2018-09-22,2018,NYM,WSH,0,6,131,1.5,-165,9.5,-108,-112,-146,-1.5,144,4.11,Nationals Park,6,-6
2018-09-23,2018,COL,ARI,2,0,-103,1.5,-215,8.0,-115,-105,-107,-1.5,180,4.06,Chase Field,2,2
2018-09-23,2018,PHI,ATL,1,2,-155,-1.5,-101,7.5,-110,-110,140,1.5,-119,4.56,Suntrust Park,3,-1
2018-09-23,2018,NYY,BAL,3,6,-305,-1.5,-140,8.5,-105,-115,255,1.5,121,6.4,Yankee Stadium,9,-3
2018-09-23,2018,CLE,BOS,4,3,107,1.5,-156,9.0,-115,-105,-117,-1.5,136,4.35,Progressive Field,7,1
2018-09-23,2018,CWS,CHC,1,6,170,1.5,105,8.0,-120,100,-190,-1.5,-125,2.96,Guaranteed Rate Field,7,-5
2018-09-23,2018,MIA,CIN,6,0,111,1.5,-151,7.5,-119,-101,-121,-1.5,131,3.55,Marlins Park,6,6
2018-09-23,2018,BOS,CLE,3,4,-117,-1.5,136,9.0,-115,-105,107,1.5,-156,4.85,Progressive Field,7,-1
2018-09-23,2018,ARI,COL,0,2,-107,-1.5,180,8.0,-115,-105,-103,1.5,-215,4.14,Chase Field,2,-2
2018-09-23,2018,CHC,CWS,6,1,-190,-1.5,-125,8.0,-120,100,170,1.5,105,5.24,Guaranteed Rate Field,7,5
2018-09-23,2018,KC,DET,3,2,110,1.5,-200,8.0,-110,-110,-120,-1.5,170,3.81,Comerica Park,5,1
2018-09-23,2018,LAA,HOU,2,6,180,1.5,-116,8.0,100,-120,-210,-1.5,-104,2.86,Minute Maid Park,8,-4
2018-09-23,2018,DET,KC,2,3,-120,-1.5,170,8.0,-110,-110,110,1.5,-200,4.36,Comerica Park,5,-1
2018-09-23,2018,HOU,LAA,6,2,-210,-1.5,-104,8.0,100,-120,180,1.5,-116,5.42,Minute Maid Park,8,4
2018-09-23,2018,SD,LAD,0,14,200,1.5,-101,7.5,-110,-110,-230,-1.5,-119,2.5,Dodger Stadium,14,-14
2018-09-23,2018,CIN,MIA,0,6,-121,-1.5,131,7.5,-119,-101,111,1.5,-151,4.11,Marlins Park,6,-6
2018-09-23,2018,PIT,MIL,6,13,141,1.5,-118,8.0,-115,-105,-156,-1.5,-102,3.32,PNC Park,19,-7
2018-09-23,2018,OAK,MIN,1,5,-185,-1.5,105,8.5,-105,-115,165,1.5,-125,5.52,Oakland Coliseum,6,-4
2018-09-23,2018,WSH,NYM,6,8,-126,-1.5,164,8.5,-113,-107,116,1.5,-192,4.74,Nationals Park,14,-2
2018-09-23,2018,BAL,NYY,6,3,255,1.5,121,8.5,-105,-115,-305,-1.5,-140,2.39,Yankee Stadium,9,3
2018-09-23,2018,MIN,OAK,5,1,165,1.5,-125,8.5,-105,-115,-185,-1.5,105,3.21,Oakland Coliseum,6,4
2018-09-23,2018,ATL,PHI,2,1,140,1.5,-119,7.5,-110,-110,-155,-1.5,-101,3.13,Suntrust Park,3,1
2018-09-23,2018,MIL,PIT,13,6,-156,-1.5,-102,8.0,-115,-105,141,1.5,-118,4.88,PNC Park,19,7
2018-09-23,2018,LAD,SD,14,0,-230,-1.5,-119,7.5,-110,-110,200,1.5,-101,5.23,Dodger Stadium,14,14
2018-09-23,2018,TEX,SEA,6,1,119,1.5,-135,10.0,-118,-102,-129,-1.5,115,4.57,Rangers Ballpark,7,5
2018-09-23,2018,STL,SF,9,2,-200,-1.5,110,7.5,-107,-113,170,1.5,-130,5.0,Busch Stadium,11,7
2018-09-23,2018,SF,STL,2,9,170,1.5,-130,7.5,-107,-113,-200,-1.5,110,2.78,Busch Stadium,11,-7
2018-09-23,2018,TOR,TB,2,5,165,1.5,109,7.5,-120,100,-185,-1.5,-129,2.83,Rogers Centre,7,-3
2018-09-23,2018,SEA,TEX,1,6,-129,-1.5,115,10.0,-118,-102,119,1.5,-135,5.63,Rangers Ballpark,7,-5
2018-09-23,2018,TB,TOR,5,2,-185,-1.5,-129,7.5,-120,100,165,1.5,109,4.87,Rogers Centre,7,3
2018-09-23,2018,NYM,WSH,8,6,116,1.5,-192,8.5,-113,-107,-126,-1.5,164,3.94,Nationals Park,14,2
2018-09-24,2018,LAD,ARI,7,4,-196,-1.5,-126,7.5,-103,-117,176,1.5,106,4.97,Chase Field,11,3
2018-09-24,2018,BOS,BAL,6,2,-250,-1.5,-130,8.0,-110,-110,210,1.5,110,5.71,Fenway Park,8,4
2018-09-24,2018,BAL,BOS,2,6,210,1.5,110,8.0,-110,-110,-250,-1.5,-130,2.58,Fenway Park,8,-4
2018-09-24,2018,PIT,CHC,5,1,144,1.5,-155,8.0,-105,-115,-159,-1.5,135,3.28,Wrigley Field,6,4
2018-09-24,2018,CWS,CLE,0,4,180,1.5,110,7.5,-103,-117,-210,-1.5,-130,2.68,Guaranteed Rate Field,4,-4
2018-09-24,2018,PHI,COL,1,10,157,1.5,-110,10.5,100,-120,-177,-1.5,-110,4.09,Coors Field,11,-9
2018-09-24,2018,CLE,CWS,4,0,-210,-1.5,-130,7.5,-103,-117,180,1.5,110,5.08,Guaranteed Rate Field,4,4
2018-09-24,2018,TOR,HOU,3,5,163,1.5,108,9.0,101,-121,-183,-1.5,-128,3.42,Rogers Centre,8,-2
2018-09-24,2018,TEX,LAA,4,5,130,1.5,-172,8.5,100,-120,-145,-1.5,149,3.7,Angel Stadium,9,-1
2018-09-24,2018,ARI,LAD,4,7,176,1.5,106,7.5,-103,-117,-196,-1.5,-126,2.72,Chase Field,11,-3
2018-09-24,2018,WSH,MIA,7,3,-271,-1.5,-135,7.5,-110,-110,231,1.5,115,5.48,Nationals Park,10,4
2018-09-24,2018,STL,MIL,4,6,-142,-1.5,144,8.0,-105,-115,127,1.5,-165,4.69,Busch Stadium,10,-2
2018-09-24,2018,TB,NYY,1,4,113,1.5,-161,8.0,-120,100,-123,-1.5,141,3.76,Tropicana Field,5,-3
2018-09-24,2018,SEA,OAK,3,7,-160,-1.5,135,7.5,100,-120,145,1.5,-155,4.62,T-Mobile Park,10,-4
2018-09-24,2018,COL,PHI,10,1,-177,-1.5,-110,10.5,100,-120,157,1.5,-110,6.71,Coors Field,11,9
2018-09-24,2018,CHC,PIT,1,5,-159,-1.5,135,8.0,-105,-115,144,1.5,-155,4.91,Wrigley Field,6,-4
2018-09-24,2018,SF,SD,0,5,-140,-1.5,151,7.5,-110,-110,125,1.5,-175,4.38,AT&T Park,5,-5
2018-09-24,2018,OAK,SEA,7,3,145,1.5,-155,7.5,100,-120,-160,-1.5,135,3.06,T-Mobile Park,10,4
2018-09-24,2018,SD,SF,5,0,125,1.5,-175,7.5,-110,-110,-140,-1.5,151,3.33,AT&T Park,5,5
2018-09-24,2018,MIL,STL,6,4,127,1.5,-165,8.0,-105,-115,-142,-1.5,144,3.52,Busch Stadium,10,2
2018-09-24,2018,NYY,TB,4,1,-123,-1.5,141,8.0,-120,100,113,1.5,-161,4.41,Tropicana Field,5,3
2018-09-24,2018,LAA,TEX,5,4,-145,-1.5,149,8.5,100,-120,130,1.5,-172,5.03,Angel Stadium,9,1
2018-09-24,2018,HOU,TOR,5,3,-183,-1.5,-128,9.0,101,-121,163,1.5,108,5.82,Rogers Centre,8,2
2018-09-24,2018,MIA,WSH,3,7,231,1.5,115,7.5,-110,-110,-271,-1.5,-135,2.27,Nationals Park,10,-4
2018-09-25,2018,LAD,ARI,3,4,-224,-1.5,-155,9.0,-108,-112,194,1.5,135,6.22,Chase Field,7,-1
2018-09-25,2018,NYM,ATL,3,7,-145,-1.5,149,7.5,105,-125,130,1.5,-172,4.44,Citi Field,10,-4
2018-09-25,2018,PIT,CHC,6,0,152,1.5,-135,9.0,-119,-101,-172,-1.5,115,3.57,Wrigley Field,6,6
2018-09-25,2018,KC,CIN,4,3,140,1.5,-152,9.0,-110,-110,-155,-1.5,132,3.75,Great American Ballpark,7,1
2018-09-25,2018,CWS,CLE,5,4,193,1.5,118,9.0,-110,-110,-223,-1.5,-138,3.07,Guaranteed Rate Field,9,1
2018-09-25,2018,PHI,COL,3,10,138,1.5,-140,11.0,-105,-115,-153,-1.5,120,4.62,Coors Field,13,-7
2018-09-25,2018,CLE,CWS,4,5,-223,-1.5,-138,9.0,-110,-110,193,1.5,118,6.21,Guaranteed Rate Field,9,-1
2018-09-25,2018,MIN,DET,2,4,-143,-1.5,140,8.5,-114,-106,128,1.5,-160,5.0,Target Field,6,-2
2018-09-25,2018,TOR,HOU,1,4,165,1.5,105,9.0,105,-125,-185,-1.5,-125,3.4,Rogers Centre,5,-3
2018-09-25,2018,CIN,KC,3,4,-155,-1.5,132,9.0,-110,-110,140,1.5,-152,5.47,Great American Ballpark,7,-1
2018-09-25,2018,TEX,LAA,1,4,145,1.5,-145,9.0,-117,-103,-160,-1.5,125,3.67,Angel Stadium,5,-3
2018-09-25,2018,ARI,LAD,4,3,194,1.5,135,9.0,-108,-112,-224,-1.5,-155,3.06,Chase Field,7,1
2018-09-25,2018,WSH,MIA,9,4,-385,-1.5,-171,7.5,-125,105,325,1.5,149,5.95,Nationals Park,13,5
2018-09-25,2018,STL,MIL,4,12,-109,-1.5,176,8.5,-110,-110,-101,1.5,-210,4.43,Busch Stadium,16,-8
2018-09-25,2018,DET,MIN,4,2,128,1.5,-160,8.5,-114,-106,-143,-1.5,140,3.73,Target Field,6,2
2018-09-25,2018,ATL,NYM,7,3,130,1.5,-172,7.5,105,-125,-145,-1.5,149,3.26,Citi Field,10,4
2018-09-25,2018,TB,NYY,2,9,170,1.5,105,8.0,-109,-111,-200,-1.5,-125,2.96,Tropicana Field,11,-7
2018-09-25,2018,SEA,OAK,10,8,-107,-1.5,172,8.0,-110,-110,-103,1.5,-205,4.14,T-Mobile Park,18,2
2018-09-25,2018,COL,PHI,10,3,-153,-1.5,120,11.0,-105,-115,138,1.5,-140,6.65,Coors Field,13,7
2018-09-25,2018,CHC,PIT,0,6,-172,-1.5,115,9.0,-119,-101,152,1.5,-135,5.69,Wrigley Field,6,-6
2018-09-25,2018,SF,SD,5,4,-105,-1.5,195,7.0,-115,-105,-105,1.5,-235,3.59,AT&T Park,9,1
2018-09-25,2018,OAK,SEA,8,10,-103,1.5,-205,8.0,-110,-110,-107,-1.5,172,4.06,T-Mobile Park,18,-2
2018-09-25,2018,SD,SF,4,5,-105,1.5,-235,7.0,-115,-105,-105,-1.5,195,3.59,AT&T Park,9,-1
2018-09-25,2018,MIL,STL,12,4,-101,1.5,-210,8.5,-110,-110,-109,-1.5,176,4.27,Busch Stadium,16,8
2018-09-25,2018,NYY,TB,9,2,-200,-1.5,-125,8.0,-109,-111,170,1.5,105,5.33,Tropicana Field,11,7
2018-09-25,2018,LAA,TEX,4,1,-160,-1.5,125,9.0,-117,-103,145,1.5,-145,5.54,Angel Stadium,5,3
2018-09-25,2018,HOU,TOR,4,1,-185,-1.5,-125,9.0,105,-125,165,1.5,105,5.84,Rogers Centre,5,3
2018-09-25,2018,MIA,WSH,4,9,325,1.5,149,7.5,-125,105,-385,-1.5,-171,1.76,Nationals Park,13,-5
2018-09-26,2018,LAD,ARI,2,7,-124,-1.5,125,8.0,-116,-104,114,1.5,-144,4.43,Chase Field,9,-5
2018-09-26,2018,NYM,ATL,3,0,-168,-1.5,140,7.0,105,-125,153,1.5,-160,4.39,Citi Field,3,3
2018-09-26,2018,BOS,BAL,19,3,-320,-1.5,-170,9.0,-120,100,270,1.5,148,6.86,Fenway Park,22,16
2018-09-26,2018,BOS,BAL,3,10,-350,-1.5,-170,8.0,-118,-102,290,1.5,148,6.22,Fenway Park,13,-7
2018-09-26,2018,BAL,BOS,3,19,270,1.5,148,9.0,-120,100,-320,-1.5,-170,2.43,Fenway Park,22,-16
2018-09-26,2018,BAL,BOS,10,3,290,1.5,148,8.0,-118,-102,-350,-1.5,-170,2.05,Fenway Park,13,7
2018-09-26,2018,PIT,CHC,6,7,170,1.5,-126,8.5,-101,-119,-190,-1.5,106,3.15,Wrigley Field,13,-1
2018-09-26,2018,KC,CIN,6,1,150,1.5,-145,9.0,101,-121,-165,-1.5,125,3.6,Great American Ballpark,7,5
2018-09-26,2018,CWS,CLE,2,10,165,1.5,105,9.0,100,-120,-185,-1.5,-125,3.4,Guaranteed Rate Field,12,-8
2018-09-26,2018,PHI,COL,0,14,175,1.5,108,9.5,-105,-115,-205,-1.5,-128,3.45,Coors Field,14,-14
2018-09-26,2018,CLE,CWS,10,2,-185,-1.5,-125,9.0,100,-120,165,1.5,105,5.84,Guaranteed Rate Field,12,8
2018-09-26,2018,MIN,DET,11,4,-140,-1.5,149,8.0,-115,-105,125,1.5,-172,4.67,Target Field,15,7
2018-09-26,2018,TOR,HOU,3,1,100,1.5,-171,8.0,-106,-114,-110,-1.5,150,4.0,Rogers Centre,4,2
2018-09-26,2018,CIN,KC,1,6,-165,-1.5,125,9.0,101,-121,150,1.5,-145,5.6,Great American Ballpark,7,-5
2018-09-26,2018,TEX,LAA,2,3,155,1.5,-137,9.0,105,-125,-175,-1.5,117,3.53,Angel Stadium,5,-1
2018-09-26,2018,ARI,LAD,7,2,114,1.5,-144,8.0,-116,-104,-124,-1.5,125,3.74,Chase Field,9,5
2018-09-26,2018,WSH,MIA,9,3,-181,-1.5,108,9.0,-101,-119,161,1.5,-128,5.8,Nationals Park,12,6
2018-09-26,2018,STL,MIL,1,2,-101,1.5,-170,8.5,-111,-109,-109,-1.5,148,4.27,Busch Stadium,3,-1
2018-09-26,2018,DET,MIN,4,11,125,1.5,-172,8.0,-115,-105,-140,-1.5,149,3.56,Target Field,15,-7
2018-09-26,2018,ATL,NYM,0,3,153,1.5,-160,7.0,105,-125,-168,-1.5,140,2.77,Citi Field,3,-3
2018-09-26,2018,TB,NYY,8,7,153,1.5,-105,7.0,-125,105,-168,-1.5,-115,2.77,Tropicana Field,15,1
2018-09-26,2018,SEA,OAK,3,9,-101,1.5,-174,8.5,-121,101,-109,-1.5,150,4.27,T-Mobile Park,12,-6
2018-09-26,2018,COL,PHI,14,0,-205,-1.5,-128,9.5,-105,-115,175,1.5,108,6.39,Coors Field,14,14
2018-09-26,2018,CHC,PIT,7,6,-190,-1.5,106,8.5,-101,-119,170,1.5,-126,5.57,Wrigley Field,13,1
2018-09-26,2018,SF,SD,2,3,-105,-1.5,188,7.5,-105,-115,-105,1.5,-225,3.84,AT&T Park,5,-1
2018-09-26,2018,OAK,SEA,9,3,-109,-1.5,150,8.5,-121,101,-101,1.5,-174,4.43,T-Mobile Park,12,6
2018-09-26,2018,SD,SF,3,2,-105,1.5,-225,7.5,-105,-115,-105,-1.5,188,3.84,AT&T Park,5,1
2018-09-26,2018,MIL,STL,2,1,-109,-1.5,148,8.5,-111,-109,-101,1.5,-170,4.43,Busch Stadium,3,1
2018-09-26,2018,NYY,TB,7,8,-168,-1.5,-115,7.0,-125,105,153,1.5,-105,4.39,Tropicana Field,15,-1
2018-09-26,2018,LAA,TEX,3,2,-175,-1.5,117,9.0,105,-125,155,1.5,-137,5.73,Angel Stadium,5,1
2018-09-26,2018,HOU,TOR,1,3,-110,-1.5,150,8.0,-106,-114,100,1.5,-171,4.19,Rogers Centre,4,-2
2018-09-26,2018,MIA,WSH,3,9,161,1.5,-128,9.0,-101,-119,-181,-1.5,108,3.45,Nationals Park,12,-6
2018-09-27,2018,NYM,ATL,4,1,111,1.5,-155,8.0,-105,-115,-121,-1.5,135,3.79,Citi Field,5,3
2018-09-27,2018,PIT,CHC,0,3,150,1.5,-137,9.0,-110,-110,-170,-1.5,117,3.6,Wrigley Field,3,-3
2018-09-27,2018,KC,CLE,2,1,121,1.5,-139,9.0,-112,-108,-136,-1.5,119,4.07,Kauffman Stadium,3,1
2018-09-27,2018,PHI,COL,3,5,160,1.5,-101,11.0,-101,-119,-180,-1.5,-119,4.23,Coors Field,8,-2
2018-09-27,2018,MIN,DET,9,3,-131,-1.5,149,8.5,-115,-105,116,1.5,-172,4.82,Target Field,12,6
2018-09-27,2018,CLE,KC,1,2,-136,-1.5,119,9.0,-112,-108,121,1.5,-139,5.19,Kauffman Stadium,3,-1
2018-09-27,2018,DET,MIN,3,9,116,1.5,-172,8.5,-115,-105,-131,-1.5,149,3.94,Target Field,12,-6
2018-09-27,2018,ATL,NYM,1,4,-121,-1.5,135,8.0,-105,-115,111,1.5,-155,4.38,Citi Field,5,-3
2018-09-27,2018,TB,NYY,1,12,132,1.5,-130,8.0,-110,-110,-147,-1.5,110,3.45,Tropicana Field,13,-11
2018-09-27,2018,COL,PHI,5,3,-180,-1.5,-119,11.0,-101,-119,160,1.5,-101,7.07,Coors Field,8,2
2018-09-27,2018,CHC,PIT,3,0,-170,-1.5,117,9.0,-110,-110,150,1.5,-137,5.67,Wrigley Field,3,3
2018-09-27,2018,TEX,SEA,2,0,175,1.5,-125,9.0,105,-125,-195,-1.5,105,3.27,T-Mobile Park,2,2
2018-09-27,2018,NYY,TB,12,1,-147,-1.5,110,8.0,-110,-110,132,1.5,-130,4.76,Tropicana Field,13,11
2018-09-27,2018,SEA,TEX,0,2,-195,-1.5,105,9.0,105,-125,175,1.5,-125,5.95,T-Mobile Park,2,-2
2018-09-28,2018,SD,ARI,3,2,140,1.5,-130,7.0,-109,-111,-155,-1.5,110,2.92,PETCO Park,5,1
2018-09-28,2018,PHI,ATL,2,10,127,1.5,-133,8.5,100,-120,-142,-1.5,113,3.74,Citizens Bank Park,12,-8
2018-09-28,2018,HOU,BAL,2,1,-272,-1.5,-161,8.5,-103,-117,232,1.5,141,6.22,Camden Yards,3,1
2018-09-28,2018,NYY,BOS,11,6,-155,-1.5,105,9.5,-115,-105,140,1.5,-125,5.77,Fenway Park,17,5
2018-09-28,2018,STL,CHC,4,8,133,1.5,-168,8.0,-110,-110,-148,-1.5,146,3.43,Wrigley Field,12,-4
2018-09-28,2018,PIT,CIN,8,4,116,1.5,-180,9.0,102,-122,-131,-1.5,155,4.17,Great American Ballpark,12,4
2018-09-28,2018,KC,CLE,6,14,170,1.5,105,8.0,100,-120,-190,-1.5,-125,2.96,Kauffman Stadium,20,-8
2018-09-28,2018,WSH,COL,2,5,182,1.5,102,10.5,-109,-111,-212,-1.5,-122,3.72,Coors Field,7,-3
2018-09-28,2018,MIN,CWS,2,1,-169,-1.5,125,8.0,-110,-110,154,1.5,-145,5.03,Target Field,3,1
2018-09-28,2018,MIN,CWS,12,4,-137,-1.5,151,9.0,-114,-106,122,1.5,-175,5.2,Target Field,16,8
2018-09-28,2018,MIL,DET,6,5,-267,-1.5,-132,8.0,-104,-116,227,1.5,112,5.82,Miller Park,11,1
2018-09-28,2018,BAL,HOU,1,2,232,1.5,141,8.5,-103,-117,-272,-1.5,-161,2.56,Camden Yards,3,-1
2018-09-28,2018,CLE,KC,14,6,-190,-1.5,-125,8.0,100,-120,170,1.5,105,5.24,Kauffman Stadium,20,8
2018-09-28,2018,OAK,LAA,5,8,-119,-1.5,136,9.0,105,-125,109,1.5,-156,4.89,Angel Stadium,13,-3
2018-09-28,2018,SF,LAD,1,3,170,1.5,102,7.0,-109,-111,-190,-1.5,-122,2.59,AT&T Park,4,-2
2018-09-28,2018,NYM,MIA,1,8,-135,-1.5,170,7.5,100,-120,120,1.5,-200,4.31,Citi Field,9,-7
2018-09-28,2018,DET,MIL,5,6,227,1.5,112,8.0,-104,-116,-267,-1.5,-132,2.45,Miller Park,11,-1
2018-09-28,2018,CWS,MIN,1,2,154,1.5,-145,8.0,-110,-110,-169,-1.5,125,3.15,Target Field,3,-1
2018-09-28,2018,CWS,MIN,4,12,122,1.5,-175,9.0,-114,-106,-137,-1.5,151,4.05,Target Field,16,-8
2018-09-28,2018,MIA,NYM,8,1,120,1.5,-200,7.5,100,-120,-135,-1.5,170,3.41,Citi Field,9,7
2018-09-28,2018,BOS,NYY,6,11,140,1.5,-125,9.5,-115,-105,-155,-1.5,105,3.96,Fenway Park,17,-5
2018-09-28,2018,LAA,OAK,8,5,109,1.5,-156,9.0,105,-125,-119,-1.5,136,4.31,Angel Stadium,13,3
2018-09-28,2018,ATL,PHI,10,2,-142,-1.5,113,8.5,100,-120,127,1.5,-133,4.99,Citizens Bank Park,12,8
2018-09-28,2018,CIN,PIT,4,8,-131,-1.5,155,9.0,102,-122,116,1.5,-180,5.1,Great American Ballpark,12,-4
2018-09-28,2018,ARI,SD,2,3,-155,-1.5,110,7.0,-109,-111,140,1.5,-130,4.25,PETCO Park,5,-1
2018-09-28,2018,TEX,SEA,6,12,150,1.5,-140,8.5,-109,-111,-165,-1.5,120,3.4,T-Mobile Park,18,-6
2018-09-28,2018,LAD,SF,3,1,-190,-1.5,-122,7.0,-109,-111,170,1.5,102,4.59,AT&T Park,4,2
2018-09-28,2018,CHC,STL,8,4,-148,-1.5,146,8.0,-110,-110,133,1.5,-168,4.77,Wrigley Field,12,4
2018-09-28,2018,TOR,TB,7,6,150,1.5,-145,7.5,-115,-105,-170,-1.5,125,3.0,Tropicana Field,13,1
2018-09-28,2018,SEA,TEX,12,6,-165,-1.5,120,8.5,-109,-111,150,1.5,-140,5.29,T-Mobile Park,18,6
2018-09-28,2018,TB,TOR,6,7,-170,-1.5,125,7.5,-115,-105,150,1.5,-145,4.72,Tropicana Field,13,-1
2018-09-28,2018,COL,WSH,5,2,-212,-1.5,-122,10.5,-109,-111,182,1.5,102,7.13,Coors Field,7,3
2018-09-29,2018,SD,ARI,4,5,116,1.5,-150,8.0,101,-121,-126,-1.5,130,3.7,PETCO Park,9,-1
2018-09-29,2018,PHI,ATL,3,0,-142,-1.5,146,7.5,100,-120,127,1.5,-167,4.4,Citizens Bank Park,3,3
2018-09-29,2018,HOU,BAL,4,3,-270,-1.5,-157,8.0,-115,-105,230,1.5,137,5.84,Camden Yards,7,1
2018-09-29,2018,HOU,BAL,5,2,-240,-1.5,-140,8.5,-105,-115,200,1.5,120,6.0,Camden Yards,7,3
2018-09-29,2018,NYY,BOS,8,5,147,1.5,-135,9.5,-105,-115,-162,-1.5,115,3.85,Fenway Park,13,3
2018-09-29,2018,STL,CHC,2,1,130,1.5,-165,8.0,-101,-119,-145,-1.5,144,3.48,Wrigley Field,3,1
2018-09-29,2018,PIT,CIN,0,3,-135,-1.5,109,8.5,-117,-103,120,1.5,-128,4.88,Great American Ballpark,3,-3
2018-09-29,2018,KC,CLE,9,4,205,1.5,120,7.5,-119,-101,-245,-1.5,-140,2.46,Kauffman Stadium,13,5
2018-09-29,2018,WSH,COL,12,2,-101,1.5,-205,10.0,-119,-101,-109,-1.5,172,5.02,Coors Field,14,10
2018-09-29,2018,MIN,CWS,8,3,-140,-1.5,150,8.0,-110,-110,125,1.5,-174,4.67,Target Field,11,5
2018-09-29,2018,MIL,DET,6,5,-254,-1.5,-135,8.5,-110,-110,214,1.5,115,6.1,Miller Park,11,1
2018-09-29,2018,BAL,HOU,3,4,230,1.5,137,8.0,-115,-105,-270,-1.5,-157,2.42,Camden Yards,7,-1
2018-09-29,2018,BAL,HOU,2,5,200,1.5,120,8.5,-105,-115,-240,-1.5,-140,2.83,Camden Yards,7,-3
2018-09-29,2018,CLE,KC,4,9,-245,-1.5,-140,7.5,-119,-101,205,1.5,120,5.33,Kauffman Stadium,13,-5
2018-09-29,2018,OAK,LAA,5,2,-101,1.5,-210,8.5,-119,-101,-109,-1.5,176,4.27,Angel Stadium,7,3
2018-09-29,2018,SF,LAD,6,10,230,1.5,142,7.0,-115,-105,-270,-1.5,-162,2.12,AT&T Park,16,-4
2018-09-29,2018,NYM,MIA,1,0,-165,-1.5,128,7.5,-101,-119,150,1.5,-148,4.67,Citi Field,1,1
2018-09-29,2018,DET,MIL,5,6,214,1.5,115,8.5,-110,-110,-254,-1.5,-135,2.71,Miller Park,11,-1
2018-09-29,2018,CWS,MIN,3,8,125,1.5,-174,8.0,-110,-110,-140,-1.5,150,3.56,Target Field,11,-5
2018-09-29,2018,MIA,NYM,0,1,150,1.5,-148,7.5,-101,-119,-165,-1.5,128,3.0,Citi Field,1,-1
2018-09-29,2018,BOS,NYY,5,8,-162,-1.5,115,9.5,-105,-115,147,1.5,-135,5.87,Fenway Park,13,-3
2018-09-29,2018,LAA,OAK,2,5,-109,-1.5,176,8.5,-119,-101,-101,1.5,-210,4.43,Angel Stadium,7,-3
2018-09-29,2018,ATL,PHI,0,3,127,1.5,-167,7.5,100,-120,-142,-1.5,146,3.3,Citizens Bank Park,3,-3
2018-09-29,2018,CIN,PIT,3,0,120,1.5,-128,8.5,-117,-103,-135,-1.5,109,3.86,Great American Ballpark,3,3
2018-09-29,2018,ARI,SD,5,4,-126,-1.5,130,8.0,101,-121,116,1.5,-150,4.46,PETCO Park,9,1
2018-09-29,2018,TEX,SEA,1,4,190,1.5,-105,8.0,106,-126,-220,-1.5,-115,2.76,T-Mobile Park,5,-3
2018-09-29,2018,LAD,SF,10,6,-270,-1.5,-162,7.0,-115,-105,230,1.5,142,5.11,AT&T Park,16,4
2018-09-29,2018,CHC,STL,1,2,-145,-1.5,144,8.0,-101,-119,130,1.5,-165,4.73,Wrigley Field,3,-1
2018-09-29,2018,TOR,TB,3,4,201,1.5,-111,7.0,100,-120,-231,-1.5,-108,2.33,Tropicana Field,7,-1
2018-09-29,2018,SEA,TEX,4,1,-220,-1.5,-115,8.0,106,-126,190,1.5,-105,5.5,T-Mobile Park,5,3
2018-09-29,2018,TB,TOR,4,3,-231,-1.5,-108,7.0,100,-120,201,1.5,-111,4.89,Tropicana Field,7,1
2018-09-29,2018,COL,WSH,2,12,-109,-1.5,172,10.0,-119,-101,-101,1.5,-205,5.22,Coors Field,14,-10
2018-09-30,2018,SD,ARI,4,3,105,1.5,-160,7.5,-106,-114,-115,-1.5,140,3.66,PETCO Park,7,1
2018-09-30,2018,PHI,ATL,3,1,130,1.5,-130,8.5,-120,100,-145,-1.5,110,3.7,Citizens Bank Park,4,2
2018-09-30,2018,HOU,BAL,0,4,-230,-1.5,-151,9.0,-101,-119,200,1.5,131,6.27,Camden Yards,4,-4
2018-09-30,2018,NYY,BOS,2,10,120,1.5,-160,9.0,-125,105,-135,-1.5,140,4.09,Fenway Park,12,-8
2018-09-30,2018,STL,CHC,5,10,145,1.5,-150,8.5,-105,-115,-160,-1.5,130,3.47,Wrigley Field,15,-5
2018-09-30,2018,PIT,CIN,6,5,114,1.5,-190,9.5,-102,-118,-124,-1.5,163,4.44,Great American Ballpark,11,1
2018-09-30,2018,KC,CLE,1,2,200,1.5,125,8.5,-109,-111,-230,-1.5,-145,2.83,Kauffman Stadium,3,-1
2018-09-30,2018,WSH,COL,0,12,162,1.5,-115,11.5,105,-125,-182,-1.5,-105,4.39,Coors Field,12,-12
2018-09-30,2018,MIN,CWS,5,4,-132,-1.5,150,9.0,-103,-117,117,1.5,-174,5.12,Target Field,9,1
2018-09-30,2018,MIL,DET,11,0,-285,-1.5,-144,9.0,100,-120,245,1.5,124,6.66,Miller Park,11,11
2018-09-30,2018,BAL,HOU,4,0,200,1.5,131,9.0,-101,-119,-230,-1.5,-151,3.0,Camden Yards,4,4
2018-09-30,2018,CLE,KC,2,1,-230,-1.5,-145,8.5,-109,-111,200,1.5,125,5.92,Kauffman Stadium,3,1
2018-09-30,2018,OAK,LAA,4,5,-102,1.5,-212,9.0,112,-132,-108,-1.5,177,4.54,Angel Stadium,9,-1
2018-09-30,2018,SF,LAD,0,15,195,1.5,118,7.5,-120,100,-225,-1.5,-138,2.54,AT&T Park,15,-15
2018-09-30,2018,NYM,MIA,1,0,-260,-1.5,-118,7.0,100,-120,220,1.5,100,5.06,Citi Field,1,1
2018-09-30,2018,DET,MIL,0,11,245,1.5,124,9.0,100,-120,-285,-1.5,-144,2.61,Miller Park,11,-11
2018-09-30,2018,CWS,MIN,4,5,117,1.5,-174,9.0,-103,-117,-132,-1.5,150,4.15,Target Field,9,-1
2018-09-30,2018,MIA,NYM,0,1,220,1.5,100,7.0,100,-120,-260,-1.5,-118,2.19,Citi Field,1,-1
2018-09-30,2018,BOS,NYY,10,2,-135,-1.5,140,9.0,-125,105,120,1.5,-160,5.17,Fenway Park,12,8
2018-09-30,2018,LAA,OAK,5,4,-108,-1.5,177,9.0,112,-132,-102,1.5,-212,4.67,Angel Stadium,9,1
2018-09-30,2018,ATL,PHI,1,3,-145,-1.5,110,8.5,-120,100,130,1.5,-130,5.03,Citizens Bank Park,4,-2
2018-09-30,2018,CIN,PIT,5,6,-124,-1.5,163,9.5,-102,-118,114,1.5,-190,5.26,Great American Ballpark,11,-1
2018-09-30,2018,ARI,SD,3,4,-115,-1.5,140,7.5,-106,-114,105,1.5,-160,4.01,PETCO Park,7,-1
2018-09-30,2018,TEX,SEA,1,3,145,1.5,-145,9.0,107,-127,-160,-1.5,125,3.67,T-Mobile Park,4,-2
2018-09-30,2018,LAD,SF,15,0,-225,-1.5,-138,7.5,-120,100,195,1.5,118,5.19,AT&T Park,15,15
2018-09-30,2018,CHC,STL,10,5,-160,-1.5,130,8.5,-105,-115,145,1.5,-150,5.23,Wrigley Field,15,5
2018-09-30,2018,TOR,TB,4,9,146,1.5,-145,8.0,-116,-104,-161,-1.5,125,3.25,Tropicana Field,13,-5
2018-09-30,2018,SEA,TEX,3,1,-160,-1.5,125,9.0,107,-127,145,1.5,-145,5.54,T-Mobile Park,4,2
2018-09-30,2018,TB,TOR,9,4,-161,-1.5,125,8.0,-116,-104,146,1.5,-145,4.93,Tropicana Field,13,5
2018-09-30,2018,COL,WSH,12,0,-182,-1.5,-105,11.5,105,-125,162,1.5,-115,7.42,Coors Field,12,12
2018-10-01,2018,MIL,CHC,3,1,112,1.5,-200,8.0,-105,-115,-122,-1.5,170,3.77,Wrigley Field,4,2
2018-10-01,2018,LAD,COL,5,2,-170,-1.5,122,7.0,-104,-116,150,1.5,-142,4.41,Dodger Stadium,7,3
2018-10-01,2018,COL,LAD,2,5,150,1.5,-142,7.0,-104,-116,-170,-1.5,122,2.8,Dodger Stadium,7,-3
2018-10-01,2018,CHC,MIL,1,3,-122,-1.5,170,8.0,-105,-115,112,1.5,-200,4.4,Wrigley Field,4,-2
2019-03-20,2019,SEA,OAK,9,7,120,1.5,-160,8.5,-120,100,-130,-1.5,140,3.86,Tokyo Dome,16,2
2019-03-20,2019,OAK,SEA,7,9,-130,-1.5,140,8.5,-120,100,120,1.5,-160,4.8,Tokyo Dome,16,-2
2019-03-21,2019,SEA,OAK,5,4,-125,1.5,-262,9.0,-130,110,115,-1.5,216,5.0,Tokyo Dome,9,1
2019-03-21,2019,OAK,SEA,4,5,115,-1.5,216,9.0,-130,110,-125,1.5,-262,4.19,Tokyo Dome,9,-1
2019-03-28,2019,LAD,ARI,12,5,-165,-1.5,125,7.0,-120,100,155,1.5,-145,4.36,Dodger Stadium,17,7
2019-03-28,2019,PHI,ATL,10,4,-185,-1.5,110,8.0,-105,-115,170,1.5,-130,5.19,Citizens Bank Park,14,6
2019-03-28,2019,NYY,BAL,7,2,-380,-1.5,-188,9.0,110,-130,320,1.5,161,7.13,Yankee Stadium,9,5
2019-03-28,2019,SEA,BOS,12,4,190,1.5,105,7.0,-110,-110,-210,-1.5,-125,2.41,T-Mobile Park,16,8
2019-03-28,2019,TEX,CHC,4,12,105,1.5,-152,9.5,100,-120,-115,-1.5,132,4.63,Rangers Ballpark,16,-8
2019-03-28,2019,PIT,CIN,3,5,107,1.5,-215,8.5,-105,-115,-117,-1.5,180,4.11,Great American Ballpark,8,-2
2019-03-28,2019,MIN,CLE,2,0,-117,-1.5,176,7.5,110,-130,107,1.5,-210,4.04,Target Field,2,2
2019-03-28,2019,MIA,COL,3,6,125,1.5,-140,7.5,-105,-115,-135,-1.5,120,3.33,Marlins Park,9,-3
2019-03-28,2019,KC,CWS,5,3,-116,-1.5,166,8.5,-105,-115,106,1.5,-195,4.56,Kauffman Stadium,8,2
2019-03-28,2019,TOR,DET,0,2,-142,-1.5,133,8.5,-120,100,132,1.5,-152,4.99,Rogers Centre,2,-2
2019-03-28,2019,TB,HOU,1,5,118,1.5,-152,7.0,100,-120,-128,-1.5,133,3.21,Tropicana Field,6,-4
2019-03-28,2019,CWS,KC,3,5,106,1.5,-195,8.5,-105,-115,-116,-1.5,166,4.13,Kauffman Stadium,8,-2
2019-03-28,2019,OAK,LAA,4,0,-102,1.5,-165,8.5,-115,-105,-108,-1.5,144,4.29,Oakland Coliseum,4,4
2019-03-28,2019,ARI,LAD,5,12,155,1.5,-145,7.0,-120,100,-165,-1.5,125,2.75,Dodger Stadium,17,-7
2019-03-28,2019,COL,MIA,6,3,-135,-1.5,120,7.5,-105,-115,125,1.5,-140,4.31,Marlins Park,9,3
2019-03-28,2019,STL,MIL,4,5,104,1.5,-205,8.5,-120,100,-114,-1.5,172,4.17,Miller Park,9,-1
2019-03-28,2019,CLE,MIN,0,2,107,1.5,-210,7.5,110,-130,-117,-1.5,176,3.62,Target Field,2,-2
2019-03-28,2019,WSH,NYM,0,2,-125,-1.5,180,6.5,-105,-115,115,1.5,-215,3.61,Nationals Park,2,-2
2019-03-28,2019,BAL,NYY,2,7,320,1.5,161,9.0,110,-130,-380,-1.5,-188,2.14,Yankee Stadium,9,-5
2019-03-28,2019,LAA,OAK,0,4,-108,-1.5,144,8.5,-115,-105,-102,1.5,-165,4.41,Oakland Coliseum,4,-4
2019-03-28,2019,ATL,PHI,4,10,170,1.5,-130,8.0,-105,-115,-185,-1.5,110,2.96,Citizens Bank Park,14,-6
2019-03-28,2019,CIN,PIT,5,3,-117,-1.5,180,8.5,-105,-115,107,1.5,-215,4.58,Great American Ballpark,8,2
2019-03-28,2019,SF,SD,0,2,117,1.5,-190,7.5,-105,-115,-127,-1.5,162,3.46,PETCO Park,2,-2
2019-03-28,2019,BOS,SEA,4,12,-210,-1.5,-125,7.0,-110,-110,190,1.5,105,4.74,T-Mobile Park,16,-8
2019-03-28,2019,SD,SF,2,0,-127,-1.5,162,7.5,-105,-115,117,1.5,-190,4.2,PETCO Park,2,2
2019-03-28,2019,MIL,STL,5,4,-114,-1.5,172,8.5,-120,100,104,1.5,-205,4.53,Miller Park,9,1
2019-03-28,2019,HOU,TB,5,1,-128,-1.5,133,7.0,100,-120,118,1.5,-152,3.93,Tropicana Field,6,4
2019-03-28,2019,CHC,TEX,12,4,-115,-1.5,132,9.5,100,-120,105,1.5,-152,5.08,Rangers Ballpark,16,8
2019-03-28,2019,DET,TOR,2,0,132,1.5,-152,8.5,-120,100,-142,-1.5,133,3.66,Rogers Centre,2,2
2019-03-28,2019,NYM,WSH,2,0,115,1.5,-215,6.5,-105,-115,-125,-1.5,180,3.02,Nationals Park,2,2
2019-03-29,2019,LAD,ARI,4,5,-170,-1.5,125,7.0,-115,-105,160,1.5,-145,4.41,Dodger Stadium,9,-1
2019-03-29,2019,SEA,BOS,6,7,129,1.5,-135,8.0,100,-120,-139,-1.5,115,3.49,T-Mobile Park,13,-1
2019-03-29,2019,MIA,COL,1,6,142,1.5,-126,7.0,-110,-110,-152,-1.5,105,2.89,Marlins Park,7,-5
2019-03-29,2019,TOR,DET,6,0,-121,-1.5,155,9.0,100,-120,111,1.5,-180,4.93,Rogers Centre,6,6
2019-03-29,2019,TB,HOU,4,2,128,1.5,-138,7.0,-125,105,-138,-1.5,118,3.07,Tropicana Field,6,2
2019-03-29,2019,OAK,LAA,2,6,-101,1.5,-175,8.5,-120,100,-109,-1.5,151,4.27,Oakland Coliseum,8,-4
2019-03-29,2019,ARI,LAD,5,4,160,1.5,-145,7.0,-115,-105,-170,-1.5,125,2.69,Dodger Stadium,9,1
2019-03-29,2019,COL,MIA,6,1,-152,-1.5,105,7.0,-110,-110,142,1.5,-126,4.22,Marlins Park,7,5
2019-03-29,2019,STL,MIL,9,5,-108,-1.5,140,8.5,105,-125,-102,1.5,-160,4.41,Miller Park,14,4
2019-03-29,2019,LAA,OAK,6,2,-109,-1.5,151,8.5,-120,100,-101,1.5,-175,4.43,Oakland Coliseum,8,4
2019-03-29,2019,SF,SD,1,4,145,1.5,-150,7.5,100,-120,-155,-1.5,130,3.06,PETCO Park,5,-3
2019-03-29,2019,BOS,SEA,7,6,-139,-1.5,115,8.0,100,-120,129,1.5,-135,4.65,T-Mobile Park,13,1
2019-03-29,2019,SD,SF,4,1,-155,-1.5,130,7.5,100,-120,145,1.5,-150,4.56,PETCO Park,5,3
2019-03-29,2019,MIL,STL,5,9,-102,1.5,-160,8.5,105,-125,-108,-1.5,140,4.29,Miller Park,14,-4
2019-03-29,2019,HOU,TB,2,4,-138,-1.5,118,7.0,-125,105,128,1.5,-138,4.06,Tropicana Field,6,-2
2019-03-29,2019,DET,TOR,0,6,111,1.5,-180,9.0,100,-120,-121,-1.5,155,4.27,Rogers Centre,6,-6
2019-03-30,2019,LAD,ARI,18,5,-194,-1.5,100,7.5,-120,100,177,1.5,-120,4.95,Dodger Stadium,23,13
2019-03-30,2019,PHI,ATL,8,6,-145,-1.5,140,9.0,-120,100,135,1.5,-160,5.33,Citizens Bank Park,14,2
2019-03-30,2019,NYY,BAL,3,5,-410,-1.5,-180,8.5,-105,-115,340,1.5,155,6.83,Yankee Stadium,8,-2
2019-03-30,2019,SEA,BOS,6,5,148,1.5,-108,8.5,100,-120,-158,-1.5,-112,3.43,T-Mobile Park,11,1
2019-03-30,2019,TEX,CHC,8,6,145,1.5,-105,9.5,100,-120,-155,-1.5,-115,3.88,Rangers Ballpark,14,2
2019-03-30,2019,MIN,CLE,1,2,110,1.5,-155,7.0,-110,-110,-120,-1.5,135,3.33,Target Field,3,-1
2019-03-30,2019,MIA,COL,7,3,118,1.5,-144,7.5,105,-125,-128,-1.5,124,3.44,Marlins Park,10,4
2019-03-30,2019,KC,CWS,8,6,-130,-1.5,155,7.5,-105,-115,120,1.5,-180,4.24,Kauffman Stadium,14,2
2019-03-30,2019,TOR,DET,3,0,-126,-1.5,158,8.5,-120,100,116,1.5,-183,4.74,Rogers Centre,3,3
2019-03-30,2019,TB,HOU,3,1,108,1.5,-161,8.0,-125,105,-118,-1.5,141,3.85,Tropicana Field,4,2
2019-03-30,2019,CWS,KC,6,8,120,1.5,-180,7.5,-105,-115,-130,-1.5,155,3.41,Kauffman Stadium,14,-2
2019-03-30,2019,OAK,LAA,4,2,-119,-1.5,166,8.5,-105,-115,109,1.5,-195,4.62,Oakland Coliseum,6,2
2019-03-30,2019,ARI,LAD,5,18,177,1.5,-120,7.5,-120,100,-194,-1.5,100,2.71,Dodger Stadium,23,-13
2019-03-30,2019,COL,MIA,3,7,-128,-1.5,124,7.5,105,-125,118,1.5,-144,4.21,Marlins Park,10,-4
2019-03-30,2019,STL,MIL,2,4,122,1.5,-170,9.0,-105,-115,-132,-1.5,147,4.05,Miller Park,6,-2
2019-03-30,2019,CLE,MIN,2,1,-120,-1.5,135,7.0,-110,-110,110,1.5,-155,3.82,Target Field,3,1
2019-03-30,2019,WSH,NYM,8,11,-112,-1.5,184,7.5,-105,-115,102,1.5,-220,3.96,Nationals Park,19,-3
2019-03-30,2019,BAL,NYY,5,3,340,1.5,155,8.5,-105,-115,-410,-1.5,-180,1.93,Yankee Stadium,8,2
2019-03-30,2019,LAA,OAK,2,4,109,1.5,-195,8.5,-105,-115,-119,-1.5,166,4.07,Oakland Coliseum,6,-2
2019-03-30,2019,ATL,PHI,6,8,135,1.5,-160,9.0,-120,100,-145,-1.5,140,3.83,Citizens Bank Park,14,-2
2019-03-30,2019,SF,SD,3,2,120,1.5,-190,7.5,-125,105,-130,-1.5,163,3.41,PETCO Park,5,1
2019-03-30,2019,BOS,SEA,5,6,-158,-1.5,-112,8.5,100,-120,148,1.5,-108,5.21,T-Mobile Park,11,-1
2019-03-30,2019,SD,SF,2,3,-130,-1.5,163,7.5,-125,105,120,1.5,-190,4.24,PETCO Park,5,-1
2019-03-30,2019,MIL,STL,4,2,-132,-1.5,147,9.0,-105,-115,122,1.5,-170,5.12,Miller Park,6,2
2019-03-30,2019,HOU,TB,1,3,-118,-1.5,141,8.0,-125,105,108,1.5,-161,4.33,Tropicana Field,4,-2
2019-03-30,2019,CHC,TEX,6,8,-155,-1.5,-115,9.5,100,-120,145,1.5,-105,5.77,Rangers Ballpark,14,-2
2019-03-30,2019,DET,TOR,0,3,116,1.5,-183,8.5,-120,100,-126,-1.5,158,3.94,Rogers Centre,3,-3
2019-03-30,2019,NYM,WSH,11,8,102,1.5,-220,7.5,-105,-115,-112,-1.5,184,3.71,Nationals Park,19,3
2019-03-31,2019,LAD,ARI,8,7,-194,-1.5,105,7.5,-110,-110,177,1.5,-125,4.95,Dodger Stadium,15,1
2019-03-31,2019,PHI,ATL,5,1,-140,-1.5,139,8.0,-120,100,130,1.5,-159,4.67,Citizens Bank Park,6,4
2019-03-31,2019,NYY,BAL,5,7,-320,-1.5,-149,8.5,-105,-115,280,1.5,129,6.48,Yankee Stadium,12,-2
2019-03-31,2019,SEA,BOS,10,8,126,1.5,-140,8.0,-120,100,-136,-1.5,120,3.54,T-Mobile Park,18,2
2019-03-31,2019,TEX,CHC,11,10,120,1.5,-140,8.5,-120,100,-130,-1.5,120,3.86,Rangers Ballpark,21,1
2019-03-31,2019,PIT,CIN,5,0,125,1.5,-180,8.0,-115,-105,-135,-1.5,155,3.56,Great American Ballpark,5,5
2019-03-31,2019,MIN,CLE,9,3,100,1.5,-170,7.0,-115,-105,-110,-1.5,148,3.5,Target Field,12,6
2019-03-31,2019,MIA,COL,3,0,148,1.5,-130,7.5,-105,-115,-158,-1.5,110,3.02,Marlins Park,3,3
2019-03-31,2019,KC,CWS,3,6,-127,-1.5,155,8.0,-120,100,117,1.5,-180,4.48,Kauffman Stadium,9,-3
2019-03-31,2019,TOR,DET,3,4,-152,-1.5,115,9.0,-115,-105,142,1.5,-135,5.43,Rogers Centre,7,-1
2019-03-31,2019,TB,HOU,3,1,103,1.5,-160,8.5,-110,-110,-113,-1.5,140,4.19,Tropicana Field,4,2
2019-03-31,2019,CWS,KC,6,3,117,1.5,-180,8.0,-120,100,-127,-1.5,155,3.69,Kauffman Stadium,9,3
2019-03-31,2019,OAK,LAA,2,1,-124,-1.5,163,8.5,-105,-115,114,1.5,-190,4.71,Oakland Coliseum,3,1
2019-03-31,2019,ARI,LAD,7,8,177,1.5,-125,7.5,-110,-110,-194,-1.5,105,2.71,Dodger Stadium,15,-1
2019-03-31,2019,COL,MIA,0,3,-158,-1.5,110,7.5,-105,-115,148,1.5,-130,4.59,Marlins Park,3,-3
2019-03-31,2019,STL,MIL,4,5,100,1.5,-215,9.0,105,-125,-110,-1.5,180,4.5,Miller Park,9,-1
2019-03-31,2019,CLE,MIN,3,9,-110,-1.5,148,7.0,-115,-105,100,1.5,-170,3.67,Target Field,12,-6
2019-03-31,2019,WSH,NYM,6,5,-165,-1.5,125,7.0,-110,-110,155,1.5,-145,4.36,Nationals Park,11,1
2019-03-31,2019,BAL,NYY,7,5,280,1.5,129,8.5,-105,-115,-320,-1.5,-149,2.24,Yankee Stadium,12,2
2019-03-31,2019,LAA,OAK,1,2,114,1.5,-190,8.5,-105,-115,-124,-1.5,163,3.97,Oakland Coliseum,3,-1
2019-03-31,2019,ATL,PHI,1,5,130,1.5,-159,8.0,-120,100,-140,-1.5,139,3.48,Citizens Bank Park,6,-4
2019-03-31,2019,CIN,PIT,0,5,-135,-1.5,155,8.0,-115,-105,125,1.5,-180,4.6,Great American Ballpark,5,-5
2019-03-31,2019,SF,SD,1,3,162,1.5,-131,7.5,-105,-115,-174,-1.5,111,2.86,PETCO Park,4,-2
2019-03-31,2019,BOS,SEA,8,10,-136,-1.5,120,8.0,-120,100,126,1.5,-140,4.61,T-Mobile Park,18,-2
2019-03-31,2019,SD,SF,3,1,-174,-1.5,111,7.5,-105,-115,162,1.5,-131,4.76,PETCO Park,4,2
2019-03-31,2019,MIL,STL,5,4,-110,-1.5,180,9.0,105,-125,100,1.5,-215,4.71,Miller Park,9,1
2019-03-31,2019,HOU,TB,1,3,-113,-1.5,140,8.5,-110,-110,103,1.5,-160,4.51,Tropicana Field,4,-2
2019-03-31,2019,CHC,TEX,10,11,-130,-1.5,120,8.5,-120,100,120,1.5,-140,4.8,Rangers Ballpark,21,-1
2019-03-31,2019,DET,TOR,4,3,142,1.5,-135,9.0,-115,-105,-152,-1.5,115,3.72,Rogers Centre,7,1
2019-03-31,2019,NYM,WSH,5,6,155,1.5,-145,7.0,-110,-110,-165,-1.5,125,2.75,Nationals Park,11,-1
2019-04-01,2019,SD,ARI,3,10,-165,-1.5,125,7.5,-115,-105,155,1.5,-145,4.67,PETCO Park,13,-7
2019-04-01,2019,CHC,ATL,0,8,100,1.5,-210,8.0,-115,-105,-110,-1.5,176,4.0,Suntrust Park,8,-8
2019-04-01,2019,TOR,BAL,5,6,-176,-1.5,115,9.0,105,-125,163,1.5,-135,5.74,Rogers Centre,11,-1
2019-04-01,2019,OAK,BOS,7,0,130,1.5,-130,9.0,-105,-115,-140,-1.5,110,3.91,Oakland Coliseum,7,7
2019-04-01,2019,ATL,CHC,8,0,-110,-1.5,176,8.0,-115,-105,100,1.5,-210,4.19,Suntrust Park,8,8
2019-04-01,2019,MIL,CIN,4,3,-109,-1.5,148,8.5,-125,105,-101,1.5,-170,4.43,Great American Ballpark,7,1
2019-04-01,2019,CWS,CLE,3,5,150,1.5,-150,7.5,-105,-115,-160,-1.5,130,3.0,Progressive Field,8,-2
2019-04-01,2019,TB,COL,7,1,-145,-1.5,135,8.5,-120,100,135,1.5,-155,5.03,Tropicana Field,8,6
2019-04-01,2019,CLE,CWS,5,3,-160,-1.5,130,7.5,-105,-115,150,1.5,-150,4.62,Progressive Field,8,2
2019-04-01,2019,NYY,DET,3,1,-210,-1.5,-116,8.5,-115,-105,190,1.5,-104,5.76,Yankee Stadium,4,2
2019-04-01,2019,TEX,HOU,1,2,155,1.5,103,9.5,-110,-110,-165,-1.5,-123,3.73,Rangers Ballpark,3,-1
2019-04-01,2019,SEA,LAA,6,3,-107,-1.5,176,9.0,-105,-115,-103,1.5,-210,4.65,T-Mobile Park,9,3
2019-04-01,2019,SF,LAD,4,2,185,1.5,-117,7.5,-115,-105,-205,-1.5,-103,2.63,Dodger Stadium,6,2
2019-04-01,2019,NYM,MIA,7,3,-125,-1.5,124,7.5,-105,-115,115,1.5,-144,4.17,Marlins Park,10,4
2019-04-01,2019,CIN,MIL,3,4,-101,1.5,-170,8.5,-125,105,-109,-1.5,148,4.27,Great American Ballpark,7,-1
2019-04-01,2019,MIA,NYM,3,7,115,1.5,-144,7.5,-105,-115,-125,-1.5,124,3.49,Marlins Park,10,-4
2019-04-01,2019,DET,NYY,1,3,190,1.5,-104,8.5,-115,-105,-210,-1.5,-116,2.93,Yankee Stadium,4,-2
2019-04-01,2019,BOS,OAK,0,7,-140,-1.5,110,9.0,-105,-115,130,1.5,-130,5.25,Oakland Coliseum,7,-7
2019-04-01,2019,STL,PIT,6,5,116,1.5,-200,7.5,105,-125,-126,-1.5,170,3.47,PNC Park,11,1
2019-04-01,2019,ARI,SD,10,3,155,1.5,-145,7.5,-115,-105,-165,-1.5,125,2.94,PETCO Park,13,7
2019-04-01,2019,LAA,SEA,3,6,-103,1.5,-210,9.0,-105,-115,-107,-1.5,176,4.57,T-Mobile Park,9,-3
2019-04-01,2019,LAD,SF,2,4,-205,-1.5,-103,7.5,-115,-105,185,1.5,-117,5.04,Dodger Stadium,6,-2
2019-04-01,2019,PIT,STL,5,6,-126,-1.5,170,7.5,105,-125,116,1.5,-200,4.18,PNC Park,11,-1
2019-04-01,2019,COL,TB,1,7,135,1.5,-155,8.5,-120,100,-145,-1.5,135,3.62,Tropicana Field,8,-6
2019-04-01,2019,HOU,TEX,2,1,-165,-1.5,-123,9.5,-110,-110,155,1.5,103,5.92,Rangers Ballpark,3,1
2019-04-01,2019,BAL,TOR,6,5,163,1.5,-135,9.0,105,-125,-176,-1.5,115,3.42,Rogers Centre,11,1
2019-04-02,2019,SD,ARI,5,8,-116,-1.5,184,7.5,100,-120,106,1.5,-220,4.03,PETCO Park,13,-3
2019-04-02,2019,TOR,BAL,1,2,-174,-1.5,105,8.5,-105,-115,162,1.5,-125,5.4,Rogers Centre,3,-1
2019-04-02,2019,OAK,BOS,1,0,160,1.5,-110,8.0,-105,-115,-170,-1.5,-110,3.08,Oakland Coliseum,1,1
2019-04-02,2019,MIL,CIN,4,3,-110,-1.5,144,9.0,100,-120,100,1.5,-165,4.71,Great American Ballpark,7,1
2019-04-02,2019,TB,COL,4,0,-170,-1.5,123,7.0,-105,-115,160,1.5,-143,4.41,Tropicana Field,4,4
2019-04-02,2019,NYY,DET,1,3,-230,-1.5,-110,7.5,-120,100,205,1.5,-110,5.23,Yankee Stadium,4,-2
2019-04-02,2019,TEX,HOU,6,4,200,1.5,135,9.0,100,-120,-220,-1.5,-155,3.0,Rangers Ballpark,10,2
2019-04-02,2019,MIN,KC,5,4,-145,-1.5,110,7.0,-120,100,135,1.5,-130,4.14,Kauffman Stadium,9,1
2019-04-02,2019,SEA,LAA,2,1,-110,-1.5,170,8.5,100,-120,100,1.5,-200,4.45,T-Mobile Park,3,1
2019-04-02,2019,SF,LAD,5,6,146,1.5,-155,7.0,-105,-115,-156,-1.5,135,2.85,Dodger Stadium,11,-1
2019-04-02,2019,NYM,MIA,6,5,-136,-1.5,115,8.0,-120,100,126,1.5,-135,4.61,Marlins Park,11,1
2019-04-02,2019,CIN,MIL,3,4,100,1.5,-165,9.0,100,-120,-110,-1.5,144,4.5,Great American Ballpark,7,-1
2019-04-02,2019,KC,MIN,4,5,135,1.5,-130,7.0,-120,100,-145,-1.5,110,2.98,Kauffman Stadium,9,-1
2019-04-02,2019,MIA,NYM,5,6,126,1.5,-135,8.0,-120,100,-136,-1.5,115,3.54,Marlins Park,11,-1
2019-04-02,2019,DET,NYY,3,1,205,1.5,-110,7.5,-120,100,-230,-1.5,-110,2.46,Yankee Stadium,4,2
2019-04-02,2019,BOS,OAK,0,1,-170,-1.5,-110,8.0,-105,-115,160,1.5,-110,5.04,Oakland Coliseum,1,-1
2019-04-02,2019,WSH,PHI,2,8,-180,-1.5,117,7.0,-125,105,165,1.5,-137,4.5,Nationals Park,10,-6
2019-04-02,2019,ARI,SD,8,5,106,1.5,-220,7.5,100,-120,-116,-1.5,184,3.64,PETCO Park,13,3
2019-04-02,2019,LAA,SEA,1,2,100,1.5,-200,8.5,100,-120,-110,-1.5,170,4.25,T-Mobile Park,3,-1
2019-04-02,2019,LAD,SF,6,5,-156,-1.5,135,7.0,-105,-115,146,1.5,-155,4.27,Dodger Stadium,11,1
2019-04-02,2019,COL,TB,0,4,160,1.5,-143,7.0,-105,-115,-170,-1.5,123,2.69,Tropicana Field,4,-4
2019-04-02,2019,HOU,TEX,4,6,-220,-1.5,-155,9.0,100,-120,200,1.5,135,6.19,Rangers Ballpark,10,-2
2019-04-02,2019,BAL,TOR,2,1,162,1.5,-125,8.5,-105,-115,-174,-1.5,105,3.24,Rogers Centre,3,1
2019-04-02,2019,PHI,WSH,8,2,165,1.5,-137,7.0,-125,105,-180,-1.5,117,2.64,Nationals Park,10,6
2019-04-03,2019,SD,ARI,4,1,-142,-1.5,160,7.0,-110,-110,132,1.5,-185,4.11,PETCO Park,5,3
2019-04-03,2019,CHC,ATL,4,6,120,1.5,-175,9.0,100,-120,-130,-1.5,151,4.09,Suntrust Park,10,-2
2019-04-03,2019,TOR,BAL,5,3,-150,-1.5,135,8.5,100,-120,140,1.5,-155,5.1,Rogers Centre,8,2
2019-04-03,2019,OAK,BOS,3,6,130,1.5,-134,8.5,-115,-105,-140,-1.5,114,3.7,Oakland Coliseum,9,-3
2019-04-03,2019,ATL,CHC,6,4,-130,-1.5,151,9.0,100,-120,120,1.5,-175,5.09,Suntrust Park,10,2
2019-04-03,2019,MIL,CIN,1,0,118,1.5,-185,8.5,-105,-115,-128,-1.5,160,3.9,Great American Ballpark,1,1
2019-04-03,2019,CWS,CLE,8,3,170,1.5,-130,6.5,-125,105,-185,-1.5,110,2.41,Progressive Field,11,5
2019-04-03,2019,TB,COL,0,1,-124,-1.5,170,6.5,-125,105,114,1.5,-200,3.6,Tropicana Field,1,-1
2019-04-03,2019,CLE,CWS,3,8,-185,-1.5,110,6.5,-125,105,170,1.5,-130,4.22,Progressive Field,11,-5
2019-04-03,2019,NYY,DET,1,2,-176,-1.5,105,9.5,105,-125,163,1.5,-125,6.06,Yankee Stadium,3,-1
2019-04-03,2019,TEX,HOU,4,0,190,1.5,120,9.0,-105,-115,-210,-1.5,-140,3.1,Rangers Ballpark,4,4
2019-04-03,2019,MIN,KC,7,6,-130,-1.5,120,8.5,-125,105,120,1.5,-140,4.8,Kauffman Stadium,13,1
2019-04-03,2019,SF,LAD,3,5,175,1.5,-120,7.0,-105,-115,-190,-1.5,100,2.55,Dodger Stadium,8,-2
2019-04-03,2019,NYM,MIA,6,4,-210,-1.5,-118,6.5,-110,-110,190,1.5,-102,4.4,Marlins Park,10,2
2019-04-03,2019,CIN,MIL,0,1,-128,-1.5,160,8.5,-105,-115,118,1.5,-185,4.77,Great American Ballpark,1,-1
2019-04-03,2019,KC,MIN,6,7,120,1.5,-140,8.5,-125,105,-130,-1.5,120,3.86,Kauffman Stadium,13,-1
2019-04-03,2019,MIA,NYM,4,6,190,1.5,-102,6.5,-110,-110,-210,-1.5,-118,2.24,Marlins Park,10,-2
2019-04-03,2019,DET,NYY,2,1,163,1.5,-125,9.5,105,-125,-176,-1.5,105,3.61,Yankee Stadium,3,1
2019-04-03,2019,BOS,OAK,6,3,-140,-1.5,114,8.5,-115,-105,130,1.5,-134,4.96,Oakland Coliseum,9,3
2019-04-03,2019,WSH,PHI,9,8,125,1.5,-135,8.0,-110,-110,-135,-1.5,115,3.56,Nationals Park,17,1
2019-04-03,2019,STL,PIT,5,4,-104,1.5,-225,7.5,105,-125,-106,-1.5,188,3.82,PNC Park,9,1
2019-04-03,2019,ARI,SD,1,4,132,1.5,-185,7.0,-110,-110,-142,-1.5,160,3.02,PETCO Park,5,-3
2019-04-03,2019,LAD,SF,5,3,-190,-1.5,100,7.0,-105,-115,175,1.5,-120,4.59,Dodger Stadium,8,2
2019-04-03,2019,PIT,STL,4,5,-106,-1.5,188,7.5,105,-125,-104,1.5,-225,3.86,PNC Park,9,-1
2019-04-03,2019,COL,TB,1,0,114,1.5,-200,6.5,-125,105,-124,-1.5,170,3.04,Tropicana Field,1,1
2019-04-03,2019,HOU,TEX,0,4,-210,-1.5,-140,9.0,-105,-115,190,1.5,120,6.1,Rangers Ballpark,4,-4
2019-04-03,2019,BAL,TOR,3,5,140,1.5,-155,8.5,100,-120,-150,-1.5,135,3.54,Rogers Centre,8,-2
2019-04-03,2019,PHI,WSH,8,9,-135,-1.5,115,8.0,-110,-110,125,1.5,-135,4.6,Nationals Park,17,-1
2019-04-04,2019,CHC,ATL,4,9,112,1.5,-190,9.0,100,-120,-122,-1.5,163,4.25,Suntrust Park,13,-5
2019-04-04,2019,NYY,BAL,8,4,-215,-1.5,-140,7.5,-120,100,195,1.5,120,5.12,Camden Yards,12,4
2019-04-04,2019,OAK,BOS,7,3,108,1.5,-160,8.0,-115,-105,-118,-1.5,140,3.85,Oakland Coliseum,10,4
2019-04-04,2019,ATL,CHC,9,4,-122,-1.5,163,9.0,100,-120,112,1.5,-190,4.95,Suntrust Park,13,5
2019-04-04,2019,PIT,CIN,2,0,100,1.5,-170,8.0,-115,-105,-110,-1.5,148,4.0,PNC Park,2,2
2019-04-04,2019,TOR,CLE,1,4,180,1.5,-127,6.5,-115,-105,-200,-1.5,109,2.32,Progressive Field,5,-3
2019-04-04,2019,KC,DET,4,5,-109,-1.5,148,7.5,-115,-105,-101,1.5,-170,3.91,Comerica Park,9,-1
2019-04-04,2019,DET,KC,5,4,-101,1.5,-170,7.5,-115,-105,-109,-1.5,148,3.77,Comerica Park,9,1
2019-04-04,2019,TEX,LAA,11,4,150,1.5,-136,9.0,-110,-110,-160,-1.5,116,3.6,Angel Stadium,15,7
2019-04-04,2019,WSH,NYM,4,0,120,1.5,-200,6.5,-120,100,-130,-1.5,170,2.95,Citi Field,4,4
2019-04-04,2019,BAL,NYY,4,8,195,1.5,120,7.5,-120,100,-215,-1.5,-140,2.54,Camden Yards,12,-4
2019-04-04,2019,BOS,OAK,3,7,-118,-1.5,140,8.0,-115,-105,108,1.5,-160,4.33,Oakland Coliseum,10,-4
2019-04-04,2019,CIN,PIT,0,2,-110,-1.5,148,8.0,-115,-105,100,1.5,-170,4.19,PNC Park,2,-2
2019-04-04,2019,LAA,TEX,4,11,-160,-1.5,116,9.0,-110,-110,150,1.5,-136,5.54,Angel Stadium,15,-7
2019-04-04,2019,CLE,TOR,4,1,-200,-1.5,109,6.5,-115,-105,180,1.5,-127,4.33,Progressive Field,5,3
2019-04-04,2019,NYM,WSH,0,4,-130,-1.5,170,6.5,-120,100,120,1.5,-200,3.67,Citi Field,4,-4
2019-04-05,2019,BOS,ARI,8,15,-127,-1.5,119,9.0,110,-130,117,1.5,-139,5.04,Chase Field,23,-7
2019-04-05,2019,MIA,ATL,0,4,150,1.5,-135,8.0,-115,-105,-160,-1.5,115,3.2,Suntrust Park,4,-4
2019-04-05,2019,ARI,BOS,15,8,117,1.5,-139,9.0,110,-130,-127,-1.5,119,4.15,Chase Field,23,7
2019-04-05,2019,MIL,CHC,13,10,-125,-1.5,160,8.5,-120,100,115,1.5,-185,4.72,Miller Park,23,3
2019-04-05,2019,PIT,CIN,2,0,-136,-1.5,148,8.0,100,-120,126,1.5,-170,4.61,PNC Park,2,2
2019-04-05,2019,TOR,CLE,2,3,130,1.5,-172,7.5,105,-125,-140,-1.5,150,3.26,Progressive Field,5,-1
2019-04-05,2019,LAD,COL,10,6,-130,-1.5,115,11.0,100,-120,120,1.5,-135,6.22,Coors Field,16,4
2019-04-05,2019,SEA,CWS,8,10,-125,-1.5,125,8.5,-105,-115,115,1.5,-145,4.72,Guaranteed Rate Field,18,-2
2019-04-05,2019,OAK,HOU,2,3,145,1.5,-140,8.5,-120,100,-155,-1.5,120,3.47,Minute Maid Park,5,-1
2019-04-05,2019,TEX,LAA,1,3,107,1.5,-195,8.5,100,-120,-117,-1.5,166,4.11,Angel Stadium,4,-2
2019-04-05,2019,COL,LAD,6,10,120,1.5,-135,11.0,100,-120,-130,-1.5,115,5.0,Coors Field,16,-4
2019-04-05,2019,ATL,MIA,4,0,-160,-1.5,115,8.0,-115,-105,150,1.5,-135,4.92,Suntrust Park,4,4
2019-04-05,2019,CHC,MIL,10,13,115,1.5,-185,8.5,-120,100,-125,-1.5,160,3.95,Miller Park,23,-3
2019-04-05,2019,PHI,MIN,10,4,-156,-1.5,127,8.0,-105,-115,146,1.5,-146,4.88,Citizens Bank Park,14,6
2019-04-05,2019,HOU,OAK,3,2,-155,-1.5,120,8.5,-120,100,145,1.5,-140,5.17,Minute Maid Park,5,1
2019-04-05,2019,MIN,PHI,4,10,146,1.5,-146,8.0,-105,-115,-156,-1.5,127,3.25,Citizens Bank Park,14,-6
2019-04-05,2019,CIN,PIT,0,2,126,1.5,-170,8.0,100,-120,-136,-1.5,148,3.54,PNC Park,2,-2
2019-04-05,2019,STL,SD,3,5,-176,-1.5,110,8.0,100,-120,163,1.5,-130,5.1,Busch Stadium,8,-2
2019-04-05,2019,CWS,SEA,10,8,115,1.5,-145,8.5,-105,-115,-125,-1.5,125,3.95,Guaranteed Rate Field,18,2
2019-04-05,2019,TB,SF,5,2,-113,-1.5,144,7.0,-110,-110,103,1.5,-165,3.71,AT&T Park,7,3
2019-04-05,2019,SD,STL,5,3,163,1.5,-130,8.0,100,-120,-176,-1.5,110,3.04,Busch Stadium,8,2
2019-04-05,2019,SF,TB,2,5,103,1.5,-165,7.0,-110,-110,-113,-1.5,144,3.45,AT&T Park,7,-3
2019-04-05,2019,LAA,TEX,3,1,-117,-1.5,166,8.5,100,-120,107,1.5,-195,4.58,Angel Stadium,4,2
2019-04-05,2019,CLE,TOR,3,2,-140,-1.5,150,7.5,105,-125,130,1.5,-172,4.38,Progressive Field,5,1
2019-04-06,2019,BOS,ARI,4,5,-132,-1.5,119,9.0,100,-120,122,1.5,-139,5.12,Chase Field,9,-1
2019-04-06,2019,MIA,ATL,4,2,161,1.5,-130,8.5,-120,100,-172,-1.5,111,3.26,Suntrust Park,6,2
2019-04-06,2019,NYY,BAL,6,4,-180,-1.5,-125,8.5,-110,-110,165,1.5,105,5.46,Camden Yards,10,2
2019-04-06,2019,ARI,BOS,5,4,122,1.5,-139,9.0,100,-120,-132,-1.5,119,4.05,Chase Field,9,1
2019-04-06,2019,MIL,CHC,8,14,-129,-1.5,155,8.5,-105,-115,119,1.5,-180,4.79,Miller Park,22,-6
2019-04-06,2019,PIT,CIN,6,5,-111,-1.5,172,8.0,-105,-115,101,1.5,-205,4.21,PNC Park,11,1
2019-04-06,2019,TOR,CLE,2,7,177,1.5,-114,8.0,100,-120,-194,-1.5,-106,2.89,Progressive Field,9,-5
2019-04-06,2019,LAD,COL,7,2,-116,-1.5,128,10.0,-120,100,106,1.5,-148,5.37,Coors Field,9,5
2019-04-06,2019,SEA,CWS,9,2,-105,-1.5,144,9.0,-105,-115,-105,1.5,-165,4.61,Guaranteed Rate Field,11,7
2019-04-06,2019,KC,DET,4,7,112,1.5,-185,9.0,-105,-115,-122,-1.5,160,4.25,Comerica Park,11,-3
2019-04-06,2019,OAK,HOU,0,6,125,1.5,-154,9.5,100,-120,-135,-1.5,136,4.22,Minute Maid Park,6,-6
2019-04-06,2019,DET,KC,7,4,-122,-1.5,160,9.0,-105,-115,112,1.5,-185,4.95,Comerica Park,11,3
2019-04-06,2019,TEX,LAA,1,5,150,1.5,-150,8.5,-110,-110,-160,-1.5,130,3.4,Angel Stadium,6,-4
2019-04-06,2019,COL,LAD,2,7,106,1.5,-148,10.0,-120,100,-116,-1.5,128,4.85,Coors Field,9,-5
2019-04-06,2019,ATL,MIA,2,4,-172,-1.5,111,8.5,-120,100,161,1.5,-130,5.38,Suntrust Park,6,-2
2019-04-06,2019,CHC,MIL,14,8,119,1.5,-180,8.5,-105,-115,-129,-1.5,155,3.88,Miller Park,22,6
2019-04-06,2019,PHI,MIN,2,6,-148,-1.5,135,8.5,100,-120,138,1.5,-156,5.07,Citizens Bank Park,8,-4
2019-04-06,2019,WSH,NYM,5,6,-128,-1.5,125,7.0,-110,-110,118,1.5,-145,3.93,Citi Field,11,-1
2019-04-06,2019,BAL,NYY,4,6,165,1.5,105,8.5,-110,-110,-180,-1.5,-125,3.21,Camden Yards,10,-2
2019-04-06,2019,HOU,OAK,6,0,-135,-1.5,136,9.5,100,-120,125,1.5,-154,5.46,Minute Maid Park,6,6
2019-04-06,2019,MIN,PHI,6,2,138,1.5,-156,8.5,100,-120,-148,-1.5,135,3.57,Citizens Bank Park,8,4
2019-04-06,2019,CIN,PIT,5,6,101,1.5,-205,8.0,-105,-115,-111,-1.5,172,3.98,PNC Park,11,-1
2019-04-06,2019,STL,SD,4,6,-120,-1.5,172,7.5,-105,-115,110,1.5,-205,4.09,Busch Stadium,10,-2
2019-04-06,2019,CWS,SEA,2,9,-105,1.5,-165,9.0,-105,-115,-105,-1.5,144,4.61,Guaranteed Rate Field,11,-7
2019-04-06,2019,TB,SF,4,6,-132,-1.5,125,7.5,-105,-115,122,1.5,-145,4.27,AT&T Park,10,-2
2019-04-06,2019,SD,STL,6,4,110,1.5,-205,7.5,-105,-115,-120,-1.5,172,3.57,Busch Stadium,10,2
2019-04-06,2019,SF,TB,6,4,122,1.5,-145,7.5,-105,-115,-132,-1.5,125,3.38,AT&T Park,10,2
2019-04-06,2019,LAA,TEX,5,1,-160,-1.5,130,8.5,-110,-110,150,1.5,-150,5.23,Angel Stadium,6,4
2019-04-06,2019,CLE,TOR,7,2,-194,-1.5,-106,8.0,100,-120,177,1.5,-114,5.28,Progressive Field,9,5
2019-04-06,2019,NYM,WSH,6,5,118,1.5,-145,7.0,-110,-110,-128,-1.5,125,3.21,Citi Field,11,1
2019-04-07,2019,BOS,ARI,1,0,-106,-1.5,130,9.5,-105,-115,-104,1.5,-150,4.89,Chase Field,1,1
2019-04-07,2019,MIA,ATL,3,4,160,1.5,-135,8.5,100,-120,-170,-1.5,115,3.27,Suntrust Park,7,-1
2019-04-07,2019,NYY,BAL,15,3,-185,-1.5,-119,9.0,-110,-110,170,1.5,-101,5.84,Camden Yards,18,12
2019-04-07,2019,ARI,BOS,0,1,-104,1.5,-150,9.5,-105,-115,-106,-1.5,130,4.84,Chase Field,1,-1
2019-04-07,2019,MIL,CHC,4,2,-106,-1.5,176,9.0,-110,-110,-104,1.5,-210,4.63,Miller Park,6,2
2019-04-07,2019,PIT,CIN,7,5,-150,-1.5,145,7.5,-115,-105,140,1.5,-166,4.5,PNC Park,12,2
2019-04-07,2019,TOR,CLE,1,3,150,1.5,-147,7.5,-120,100,-160,-1.5,128,3.0,Progressive Field,4,-2
2019-04-07,2019,LAD,COL,12,6,-170,-1.5,-122,11.5,100,-120,160,1.5,102,7.24,Coors Field,18,6
2019-04-07,2019,SEA,CWS,12,5,106,1.5,-178,9.0,-120,100,-116,-1.5,153,4.37,Guaranteed Rate Field,17,7
2019-04-07,2019,KC,DET,1,3,-106,-1.5,141,9.0,100,-120,-104,1.5,-161,4.63,Comerica Park,4,-2
2019-04-07,2019,OAK,HOU,8,9,165,1.5,-125,9.0,105,-125,-180,-1.5,105,3.4,Minute Maid Park,17,-1
2019-04-07,2019,DET,KC,3,1,-104,1.5,-161,9.0,100,-120,-106,-1.5,141,4.59,Comerica Park,4,2
2019-04-07,2019,TEX,LAA,2,7,107,1.5,-180,9.5,100,-120,-117,-1.5,155,4.59,Angel Stadium,9,-5
2019-04-07,2019,COL,LAD,6,12,160,1.5,102,11.5,100,-120,-170,-1.5,-122,4.42,Coors Field,18,-6
2019-04-07,2019,ATL,MIA,4,3,-170,-1.5,115,8.5,100,-120,160,1.5,-135,5.35,Suntrust Park,7,1
2019-04-07,2019,CHC,MIL,2,4,-104,1.5,-210,9.0,-110,-110,-106,-1.5,176,4.59,Miller Park,6,-2
2019-04-07,2019,PHI,MIN,2,1,-134,-1.5,155,8.5,100,-120,124,1.5,-180,4.87,Citizens Bank Park,3,1
2019-04-07,2019,WSH,NYM,12,9,-128,-1.5,125,6.5,100,-120,118,1.5,-145,3.65,Citi Field,21,3
2019-04-07,2019,BAL,NYY,3,15,170,1.5,-101,9.0,-110,-110,-185,-1.5,-119,3.33,Camden Yards,18,-12
2019-04-07,2019,HOU,OAK,9,8,-180,-1.5,105,9.0,105,-125,165,1.5,-125,5.79,Minute Maid Park,17,1
2019-04-07,2019,MIN,PHI,1,2,124,1.5,-180,8.5,100,-120,-134,-1.5,155,3.79,Citizens Bank Park,3,-1
2019-04-07,2019,CIN,PIT,5,7,140,1.5,-166,7.5,-115,-105,-150,-1.5,145,3.13,PNC Park,12,-2
2019-04-07,2019,STL,SD,4,1,-120,-1.5,168,9.0,-110,-110,110,1.5,-197,4.91,Busch Stadium,5,3
2019-04-07,2019,CWS,SEA,5,12,-116,-1.5,153,9.0,-120,100,106,1.5,-178,4.83,Guaranteed Rate Field,17,-7
2019-04-07,2019,TB,SF,3,0,-115,-1.5,148,7.0,-120,100,105,1.5,-170,3.74,AT&T Park,3,3
2019-04-07,2019,SD,STL,1,4,110,1.5,-197,9.0,-110,-110,-120,-1.5,168,4.29,Busch Stadium,5,-3
2019-04-07,2019,SF,TB,0,3,105,1.5,-170,7.0,-120,100,-115,-1.5,148,3.41,AT&T Park,3,-3
2019-04-07,2019,LAA,TEX,7,2,-117,-1.5,155,9.5,100,-120,107,1.5,-180,5.12,Angel Stadium,9,5
2019-04-07,2019,CLE,TOR,3,1,-160,-1.5,128,7.5,-120,100,150,1.5,-147,4.62,Progressive Field,4,2
2019-04-07,2019,NYM,WSH,9,12,118,1.5,-145,6.5,100,-120,-128,-1.5,125,2.98,Citi Field,21,-3
2019-04-08,2019,COL,ATL,6,8,-110,-1.5,163,10.5,-120,100,100,1.5,-190,5.5,Coors Field,14,-2
2019-04-08,2019,OAK,BAL,4,12,-162,-1.5,-115,10.0,-105,-115,152,1.5,-105,6.18,Camden Yards,16,-8
2019-04-08,2019,PIT,CHC,0,10,120,1.5,-175,8.5,-120,100,-130,-1.5,151,3.86,Wrigley Field,10,-10
2019-04-08,2019,ATL,COL,8,6,100,1.5,-190,10.5,-120,100,-110,-1.5,163,5.25,Coors Field,14,2
2019-04-08,2019,TB,CWS,5,1,-168,-1.5,-110,7.5,-115,-105,158,1.5,-110,4.7,Guaranteed Rate Field,6,4
2019-04-08,2019,NYY,HOU,3,4,138,1.5,-160,7.5,-120,100,-148,-1.5,140,3.15,Minute Maid Park,7,-1
2019-04-08,2019,SEA,KC,13,5,-110,-1.5,141,10.0,-110,-110,100,1.5,-161,5.24,Kauffman Stadium,18,8
2019-04-08,2019,MIL,LAA,2,5,-106,-1.5,141,9.0,-110,-110,-104,1.5,-161,4.63,Angel Stadium,7,-3
2019-04-08,2019,STL,LAD,4,3,-107,-1.5,180,8.0,-115,-105,-103,1.5,-215,4.14,Busch Stadium,7,1
2019-04-08,2019,LAA,MIL,5,2,-104,1.5,-161,9.0,-110,-110,-106,-1.5,141,4.59,Angel Stadium,7,3
2019-04-08,2019,HOU,NYY,4,3,-148,-1.5,140,7.5,-120,100,138,1.5,-160,4.48,Minute Maid Park,7,1
2019-04-08,2019,BAL,OAK,12,4,152,1.5,-105,10.0,-105,-115,-162,-1.5,-115,3.97,Camden Yards,16,8
2019-04-08,2019,WSH,PHI,3,4,135,1.5,-155,9.5,-120,100,-145,-1.5,135,4.04,Citizens Bank Park,7,-1
2019-04-08,2019,CHC,PIT,10,0,-130,-1.5,151,8.5,-120,100,120,1.5,-175,4.8,Wrigley Field,10,10
2019-04-08,2019,SF,SD,5,6,-130,-1.5,163,7.0,-115,-105,120,1.5,-190,3.96,AT&T Park,11,-1
2019-04-08,2019,KC,SEA,5,13,100,1.5,-161,10.0,-110,-110,-110,-1.5,141,5.0,Kauffman Stadium,18,-8
2019-04-08,2019,SD,SF,6,5,120,1.5,-190,7.0,-115,-105,-130,-1.5,163,3.18,AT&T Park,11,1
2019-04-08,2019,LAD,STL,3,4,-103,1.5,-215,8.0,-115,-105,-107,-1.5,180,4.06,Busch Stadium,7,-1
2019-04-08,2019,CWS,TB,1,5,158,1.5,-110,7.5,-115,-105,-168,-1.5,-110,2.91,Guaranteed Rate Field,6,-4
2019-04-08,2019,PHI,WSH,4,3,-145,-1.5,135,9.5,-120,100,135,1.5,-155,5.62,Citizens Bank Park,7,1
2019-04-09,2019,TEX,ARI,4,5,135,1.5,-155,8.5,-110,-110,-145,-1.5,135,3.62,Chase Field,9,-1
2019-04-09,2019,COL,ATL,1,7,-108,-1.5,166,10.5,-115,-105,-102,1.5,-195,5.45,Coors Field,8,-6
2019-04-09,2019,OAK,BAL,13,2,-180,-1.5,-119,9.5,100,-120,165,1.5,-101,6.11,Camden Yards,15,11
2019-04-09,2019,TOR,BOS,7,5,225,1.5,115,8.0,-105,-115,-255,-1.5,-135,2.46,Fenway Park,12,2
2019-04-09,2019,MIA,CIN,0,14,170,1.5,-122,8.5,-105,-115,-185,-1.5,102,3.15,Great American Ballpark,14,-14
2019-04-09,2019,DET,CLE,2,8,125,1.5,-135,8.0,100,-120,-135,-1.5,115,3.56,Comerica Park,10,-6
2019-04-09,2019,ATL,COL,7,1,-102,1.5,-195,10.5,-115,-105,-108,-1.5,166,5.3,Coors Field,8,6
2019-04-09,2019,TB,CWS,10,5,-170,-1.5,-105,8.5,-110,-110,160,1.5,-115,5.35,Guaranteed Rate Field,15,5
2019-04-09,2019,CLE,DET,8,2,-135,-1.5,115,8.0,100,-120,125,1.5,-135,4.6,Comerica Park,10,6
2019-04-09,2019,NYY,HOU,3,6,178,1.5,-117,8.0,-115,-105,-196,-1.5,-103,2.88,Minute Maid Park,9,-3
2019-04-09,2019,SEA,KC,6,3,100,1.5,-195,9.0,-105,-115,-110,-1.5,166,4.5,Kauffman Stadium,9,3
2019-04-09,2019,MIL,LAA,8,11,-138,-1.5,108,8.5,-125,105,128,1.5,-128,4.93,Angel Stadium,19,-3
2019-04-09,2019,STL,LAD,4,0,110,1.5,-153,8.5,100,-120,-120,-1.5,133,4.05,Busch Stadium,4,4
2019-04-09,2019,CIN,MIA,14,0,-185,-1.5,102,8.5,-105,-115,170,1.5,-122,5.52,Great American Ballpark,14,14
2019-04-09,2019,LAA,MIL,11,8,128,1.5,-128,8.5,-125,105,-138,-1.5,108,3.73,Angel Stadium,19,3
2019-04-09,2019,NYM,MIN,8,14,-260,-1.5,-115,6.5,-105,-115,230,1.5,-105,4.69,Citi Field,22,-6
2019-04-09,2019,MIN,NYM,14,8,230,1.5,-105,6.5,-105,-115,-260,-1.5,-115,1.97,Citi Field,22,6
2019-04-09,2019,HOU,NYY,6,3,-196,-1.5,-103,8.0,-115,-105,178,1.5,-117,5.3,Minute Maid Park,9,3
2019-04-09,2019,BAL,OAK,2,13,165,1.5,-101,9.5,100,-120,-180,-1.5,-119,3.58,Camden Yards,15,-11
2019-04-09,2019,WSH,PHI,10,6,133,1.5,-168,8.0,-115,-105,-143,-1.5,146,3.43,Citizens Bank Park,16,4
2019-04-09,2019,SF,SD,7,2,122,1.5,-140,7.5,100,-120,-132,-1.5,120,3.38,AT&T Park,9,5
2019-04-09,2019,KC,SEA,3,6,-110,-1.5,166,9.0,-105,-115,100,1.5,-195,4.71,Kauffman Stadium,9,-3
2019-04-09,2019,SD,SF,2,7,-132,-1.5,120,7.5,100,-120,122,1.5,-140,4.27,AT&T Park,9,-5
2019-04-09,2019,LAD,STL,0,4,-120,-1.5,133,8.5,100,-120,110,1.5,-153,4.64,Busch Stadium,4,-4
2019-04-09,2019,CWS,TB,5,10,160,1.5,-115,8.5,-110,-110,-170,-1.5,-105,3.27,Guaranteed Rate Field,15,-5
2019-04-09,2019,ARI,TEX,5,4,-145,-1.5,135,8.5,-110,-110,135,1.5,-155,5.03,Chase Field,9,1
2019-04-09,2019,BOS,TOR,5,7,-255,-1.5,-135,8.0,-105,-115,225,1.5,115,5.75,Fenway Park,12,-2
2019-04-09,2019,PHI,WSH,6,10,-143,-1.5,146,8.0,-115,-105,133,1.5,-168,4.71,Citizens Bank Park,16,-4
2019-04-10,2019,TEX,ARI,5,2,120,1.5,-180,8.0,-115,-105,-130,-1.5,155,3.64,Chase Field,7,3
2019-04-10,2019,OAK,BAL,10,3,-180,-1.5,-130,9.5,-115,-105,165,1.5,110,6.11,Camden Yards,13,7
2019-04-10,2019,PIT,CHC,5,2,157,1.5,-140,7.5,-120,100,-167,-1.5,120,2.92,Wrigley Field,7,3
2019-04-10,2019,MIA,CIN,1,2,145,1.5,-145,9.0,-105,-115,-155,-1.5,125,3.67,Great American Ballpark,3,-1
2019-04-10,2019,DET,CLE,4,1,135,1.5,-125,7.0,-110,-110,-145,-1.5,105,2.98,Comerica Park,5,3
2019-04-10,2019,TB,CWS,9,1,-170,-1.5,-107,8.5,-110,-110,160,1.5,-113,5.35,Guaranteed Rate Field,10,8
2019-04-10,2019,CLE,DET,1,4,-145,-1.5,105,7.0,-110,-110,135,1.5,-125,4.14,Comerica Park,5,-3
2019-04-10,2019,NYY,HOU,6,8,110,1.5,-190,8.0,-115,-105,-120,-1.5,163,3.81,Minute Maid Park,14,-2
2019-04-10,2019,SEA,KC,6,5,-155,-1.5,-110,9.5,-120,100,145,1.5,-110,5.77,Kauffman Stadium,11,1
2019-04-10,2019,MIL,LAA,2,4,-170,-1.5,-120,8.0,-125,105,160,1.5,100,5.04,Angel Stadium,6,-2
2019-04-10,2019,STL,LAD,7,2,-105,1.5,-170,8.0,-110,-110,-105,-1.5,148,4.1,Busch Stadium,9,5
2019-04-10,2019,CIN,MIA,2,1,-155,-1.5,125,9.0,-105,-115,145,1.5,-145,5.47,Great American Ballpark,3,1
2019-04-10,2019,LAA,MIL,4,2,160,1.5,100,8.0,-125,105,-170,-1.5,-120,3.08,Angel Stadium,6,2
2019-04-10,2019,NYM,MIN,9,6,-190,-1.5,111,7.0,-125,105,175,1.5,-131,4.59,Citi Field,15,3
2019-04-10,2019,MIN,NYM,6,9,175,1.5,-131,7.0,-125,105,-190,-1.5,111,2.55,Citi Field,15,-3
2019-04-10,2019,HOU,NYY,8,6,-120,-1.5,163,8.0,-115,-105,110,1.5,-190,4.36,Minute Maid Park,14,2
2019-04-10,2019,BAL,OAK,3,10,165,1.5,110,9.5,-115,-105,-180,-1.5,-130,3.58,Camden Yards,13,-7
2019-04-10,2019,WSH,PHI,15,1,147,1.5,-145,9.0,-120,100,-157,-1.5,125,3.64,Citizens Bank Park,16,14
2019-04-10,2019,CHC,PIT,2,5,-167,-1.5,120,7.5,-120,100,157,1.5,-140,4.69,Wrigley Field,7,-3
2019-04-10,2019,SF,SD,1,3,-105,1.5,-175,8.0,100,-120,-105,-1.5,151,4.1,AT&T Park,4,-2
2019-04-10,2019,KC,SEA,5,6,145,1.5,-110,9.5,-120,100,-155,-1.5,-110,3.88,Kauffman Stadium,11,-1
2019-04-10,2019,SD,SF,3,1,-105,-1.5,151,8.0,100,-120,-105,1.5,-175,4.1,AT&T Park,4,2
2019-04-10,2019,LAD,STL,2,7,-105,-1.5,148,8.0,-110,-110,-105,1.5,-170,4.1,Busch Stadium,9,-5
2019-04-10,2019,CWS,TB,1,9,160,1.5,-113,8.5,-110,-110,-170,-1.5,-107,3.27,Guaranteed Rate Field,10,-8
2019-04-10,2019,ARI,TEX,2,5,-130,-1.5,155,8.0,-115,-105,120,1.5,-180,4.52,Chase Field,7,-3
2019-04-10,2019,PHI,WSH,1,15,-157,-1.5,125,9.0,-120,100,147,1.5,-145,5.5,Citizens Bank Park,16,-14
2019-04-11,2019,SD,ARI,7,6,108,1.5,-185,9.0,-110,-110,-118,-1.5,160,4.33,Chase Field,13,1
2019-04-11,2019,NYM,ATL,6,3,122,1.5,-174,9.0,-110,-110,-132,-1.5,150,4.05,Suntrust Park,9,3
2019-04-11,2019,OAK,BAL,8,5,-150,-1.5,-105,8.5,-115,-105,140,1.5,-115,5.1,Camden Yards,13,3
2019-04-11,2019,TOR,BOS,6,7,165,1.5,-125,9.0,-120,100,-180,-1.5,105,3.4,Fenway Park,13,-1
2019-04-11,2019,PIT,CHC,0,2,116,1.5,-180,9.0,110,-130,-126,-1.5,155,4.17,Wrigley Field,2,-2
2019-04-11,2019,MIA,CIN,0,5,157,1.5,-139,8.5,-115,-105,-167,-1.5,118,3.31,Great American Ballpark,5,-5
2019-04-11,2019,DET,CLE,0,4,125,1.5,-145,7.5,105,-125,-135,-1.5,125,3.33,Comerica Park,4,-4
2019-04-11,2019,SF,COL,1,0,101,1.5,-170,7.5,-105,-115,-111,-1.5,148,3.73,AT&T Park,1,1
2019-04-11,2019,CLE,DET,4,0,-135,-1.5,125,7.5,105,-125,125,1.5,-145,4.31,Comerica Park,4,4
2019-04-11,2019,SEA,KC,7,6,-144,-1.5,110,10.0,-105,-115,134,1.5,-130,5.9,Kauffman Stadium,13,1
2019-04-11,2019,STL,LAD,11,7,124,1.5,-145,8.5,-105,-115,-134,-1.5,125,3.79,Busch Stadium,18,4
2019-04-11,2019,CIN,MIA,5,0,-167,-1.5,118,8.5,-115,-105,157,1.5,-139,5.32,Great American Ballpark,5,5
2019-04-11,2019,ATL,NYM,3,6,-132,-1.5,150,9.0,-110,-110,122,1.5,-174,5.12,Suntrust Park,9,-3
2019-04-11,2019,BAL,OAK,5,8,140,1.5,-115,8.5,-115,-105,-150,-1.5,-105,3.54,Camden Yards,13,-3
2019-04-11,2019,CHC,PIT,2,0,-126,-1.5,155,9.0,110,-130,116,1.5,-180,5.02,Wrigley Field,2,2
2019-04-11,2019,ARI,SD,6,7,-118,-1.5,160,9.0,-110,-110,108,1.5,-185,4.87,Chase Field,13,-1
2019-04-11,2019,KC,SEA,6,7,134,1.5,-130,10.0,-105,-115,-144,-1.5,110,4.27,Kauffman Stadium,13,-1
2019-04-11,2019,COL,SF,0,1,-111,-1.5,148,7.5,-105,-115,101,1.5,-170,3.95,AT&T Park,1,-1
2019-04-11,2019,LAD,STL,7,11,-134,-1.5,125,8.5,-105,-115,124,1.5,-145,4.87,Busch Stadium,18,-4
2019-04-11,2019,BOS,TOR,7,6,-180,-1.5,105,9.0,-120,100,165,1.5,-125,5.79,Fenway Park,13,1
2019-04-12,2019,SD,ARI,2,1,-120,-1.5,135,8.0,-115,-105,110,1.5,-155,4.36,Chase Field,3,1
2019-04-12,2019,NYM,ATL,6,2,100,1.5,-205,9.5,-105,-115,-110,-1.5,172,4.75,Suntrust Park,8,4
2019-04-12,2019,BOS,BAL,6,4,-250,-1.5,-135,10.0,-115,-105,220,1.5,115,7.14,Fenway Park,10,2
2019-04-12,2019,BAL,BOS,4,6,220,1.5,115,10.0,-115,-105,-250,-1.5,-135,3.13,Fenway Park,10,-2
2019-04-12,2019,LAA,CHC,1,5,156,1.5,-130,10.5,-105,-115,-166,-1.5,110,4.1,Wrigley Field,6,-4
2019-04-12,2019,KC,CLE,8,1,148,1.5,-117,7.5,100,-120,-158,-1.5,-103,3.02,Kauffman Stadium,9,7
2019-04-12,2019,SF,COL,3,2,-140,-1.5,146,7.5,100,-120,130,1.5,-167,4.38,AT&T Park,5,1
2019-04-12,2019,NYY,CWS,6,9,-205,-1.5,-110,9.5,-110,-110,185,1.5,-110,6.39,Yankee Stadium,15,-3
2019-04-12,2019,SEA,HOU,6,10,130,1.5,-135,9.0,-105,-115,-140,-1.5,115,3.91,T-Mobile Park,16,-4
2019-04-12,2019,CLE,KC,1,8,-158,-1.5,-103,7.5,100,-120,148,1.5,-117,4.59,Kauffman Stadium,9,-7
2019-04-12,2019,CHC,LAA,5,1,-166,-1.5,110,10.5,-105,-115,156,1.5,-130,6.55,Wrigley Field,6,4
2019-04-12,2019,MIL,LAD,8,5,145,1.5,-155,8.5,-105,-115,-155,-1.5,135,3.47,Dodger Stadium,13,3
2019-04-12,2019,PHI,MIA,9,1,-158,-1.5,-110,8.5,100,-120,148,1.5,-110,5.21,Marlins Park,10,8
2019-04-12,2019,LAD,MIL,5,8,-155,-1.5,135,8.5,-105,-115,145,1.5,-155,5.17,Dodger Stadium,13,-3
2019-04-12,2019,ATL,NYM,2,6,-110,-1.5,172,9.5,-105,-115,100,1.5,-205,4.98,Suntrust Park,8,-4
2019-04-12,2019,CWS,NYY,9,6,185,1.5,-110,9.5,-110,-110,-205,-1.5,-110,3.33,Yankee Stadium,15,3
2019-04-12,2019,TEX,OAK,6,8,105,1.5,-150,11.0,100,-120,-115,-1.5,130,5.37,Rangers Ballpark,14,-2
2019-04-12,2019,MIA,PHI,1,9,148,1.5,-110,8.5,100,-120,-158,-1.5,-110,3.43,Marlins Park,10,-8
2019-04-12,2019,WSH,PIT,3,6,-190,-1.5,100,8.0,-105,-115,175,1.5,-120,5.24,Nationals Park,9,-3
2019-04-12,2019,ARI,SD,1,2,110,1.5,-155,8.0,-115,-105,-120,-1.5,135,3.81,Chase Field,3,-1
2019-04-12,2019,HOU,SEA,10,6,-140,-1.5,115,9.0,-105,-115,130,1.5,-135,5.25,T-Mobile Park,16,4
2019-04-12,2019,COL,SF,2,3,130,1.5,-167,7.5,100,-120,-140,-1.5,146,3.26,AT&T Park,5,-1
2019-04-12,2019,TOR,TB,7,11,135,1.5,-130,8.5,-105,-115,-145,-1.5,110,3.62,Rogers Centre,18,-4
2019-04-12,2019,OAK,TEX,8,6,-115,-1.5,130,11.0,100,-120,105,1.5,-150,5.88,Rangers Ballpark,14,2
2019-04-12,2019,TB,TOR,11,7,-145,-1.5,110,8.5,-105,-115,135,1.5,-130,5.03,Rogers Centre,18,4
2019-04-12,2019,PIT,WSH,6,3,175,1.5,-120,8.0,-105,-115,-190,-1.5,100,2.91,Nationals Park,9,3
2019-04-13,2019,SD,ARI,5,4,100,1.5,-210,9.0,-110,-110,-110,-1.5,176,4.5,Chase Field,9,1
2019-04-13,2019,NYM,ATL,7,11,140,1.5,-135,10.0,100,-120,-150,-1.5,115,4.17,Suntrust Park,18,-4
2019-04-13,2019,BOS,BAL,5,9,-270,-1.5,-140,11.0,-105,-115,240,1.5,120,8.03,Fenway Park,14,-4
2019-04-13,2019,BAL,BOS,9,5,240,1.5,120,11.0,-105,-115,-270,-1.5,-140,3.24,Fenway Park,14,4
2019-04-13,2019,LAA,CHC,6,5,185,1.5,-110,9.0,-115,-105,-205,-1.5,-110,3.16,Wrigley Field,11,1
2019-04-13,2019,STL,CIN,2,5,-111,-1.5,135,11.0,100,-120,101,1.5,-155,5.79,Estadio Monterrey,7,-3
2019-04-13,2019,KC,CLE,3,0,-104,1.5,-165,9.0,100,-120,-106,-1.5,144,4.59,Kauffman Stadium,3,3
2019-04-13,2019,SF,COL,5,2,-113,-1.5,172,7.0,-105,-115,103,1.5,-205,3.71,AT&T Park,7,3
2019-04-13,2019,NYY,CWS,4,0,-155,-1.5,115,10.0,-110,-110,145,1.5,-135,6.08,Yankee Stadium,4,4
2019-04-13,2019,MIN,DET,4,3,-200,-1.5,-106,8.0,-120,100,180,1.5,-114,5.33,Target Field,7,1
2019-04-13,2019,SEA,HOU,1,3,173,1.5,111,8.5,-110,-110,-188,-1.5,-131,3.11,T-Mobile Park,4,-2
2019-04-13,2019,CLE,KC,0,3,-106,-1.5,144,9.0,100,-120,-104,1.5,-165,4.63,Kauffman Stadium,3,-3
2019-04-13,2019,CHC,LAA,5,6,-205,-1.5,-110,9.0,-115,-105,185,1.5,-110,6.05,Wrigley Field,11,-1
2019-04-13,2019,MIL,LAD,4,1,137,1.5,-155,9.0,-110,-110,-147,-1.5,135,3.8,Dodger Stadium,5,3
2019-04-13,2019,PHI,MIA,3,10,-165,-1.5,-105,7.5,-105,-115,155,1.5,-115,4.67,Marlins Park,13,-7
2019-04-13,2019,LAD,MIL,1,4,-147,-1.5,135,9.0,-110,-110,137,1.5,-155,5.36,Dodger Stadium,5,-3
2019-04-13,2019,DET,MIN,3,4,180,1.5,-114,8.0,-120,100,-200,-1.5,-106,2.86,Target Field,7,-1
2019-04-13,2019,ATL,NYM,11,7,-150,-1.5,115,10.0,100,-120,140,1.5,-135,6.0,Suntrust Park,18,4
2019-04-13,2019,CWS,NYY,0,4,145,1.5,-135,10.0,-110,-110,-155,-1.5,115,4.08,Yankee Stadium,4,-4
2019-04-13,2019,MIA,PHI,10,3,155,1.5,-115,7.5,-105,-115,-165,-1.5,-105,2.94,Marlins Park,13,7
2019-04-13,2019,WSH,PIT,3,2,-119,-1.5,166,9.0,100,-120,109,1.5,-195,4.89,Nationals Park,5,1
2019-04-13,2019,ARI,SD,4,5,-110,-1.5,176,9.0,-110,-110,100,1.5,-210,4.71,Chase Field,9,-1
2019-04-13,2019,HOU,SEA,3,1,-188,-1.5,-131,8.5,-110,-110,173,1.5,111,5.55,T-Mobile Park,4,2
2019-04-13,2019,COL,SF,2,5,103,1.5,-205,7.0,-105,-115,-113,-1.5,172,3.45,AT&T Park,7,-3
2019-04-13,2019,CIN,STL,5,2,101,1.5,-155,11.0,100,-120,-111,-1.5,135,5.47,Estadio Monterrey,7,3
2019-04-13,2019,TOR,TB,3,1,180,1.5,115,8.0,-110,-110,-200,-1.5,-135,2.86,Rogers Centre,4,2
2019-04-13,2019,TB,TOR,1,3,-200,-1.5,-135,8.0,-110,-110,180,1.5,115,5.33,Rogers Centre,4,-2
2019-04-13,2019,PIT,WSH,2,3,109,1.5,-195,9.0,100,-120,-119,-1.5,166,4.31,Nationals Park,5,-1
2019-04-14,2019,SD,ARI,4,8,125,1.5,-170,8.0,-120,100,-135,-1.5,148,3.56,Chase Field,12,-4
2019-04-14,2019,NYM,ATL,3,7,-150,-1.5,105,8.5,100,-120,140,1.5,-125,5.1,Suntrust Park,10,-4
2019-04-14,2019,BOS,BAL,4,0,-260,-1.5,-126,9.5,-115,-105,230,1.5,106,6.86,Fenway Park,4,4
2019-04-14,2019,BAL,BOS,0,4,230,1.5,106,9.5,-115,-105,-260,-1.5,-126,2.88,Fenway Park,4,-4
2019-04-14,2019,STL,CIN,9,5,-120,-1.5,136,10.0,-115,-105,110,1.5,-159,5.45,Estadio Monterrey,14,4
2019-04-14,2019,KC,CLE,9,8,120,1.5,-135,7.5,100,-120,-130,-1.5,115,3.41,Kauffman Stadium,17,1
2019-04-14,2019,SF,COL,0,4,-102,1.5,-180,7.0,100,-120,-108,-1.5,155,3.53,AT&T Park,4,-4
2019-04-14,2019,NYY,CWS,2,5,-200,-1.5,-101,9.0,105,-125,180,1.5,-119,6.0,Yankee Stadium,7,-3
2019-04-14,2019,MIN,DET,6,4,-240,-1.5,-117,8.0,-105,-115,210,1.5,-103,5.65,Target Field,10,2
2019-04-14,2019,SEA,HOU,2,3,170,1.5,-101,7.5,-120,100,-185,-1.5,-119,2.78,T-Mobile Park,5,-1
2019-04-14,2019,CLE,KC,8,9,-130,-1.5,115,7.5,100,-120,120,1.5,-135,4.24,Kauffman Stadium,17,-1
2019-04-14,2019,MIL,LAD,1,7,130,1.5,-175,9.0,105,-125,-140,-1.5,151,3.91,Dodger Stadium,8,-6
2019-04-14,2019,PHI,MIA,3,1,-150,-1.5,110,8.5,105,-125,140,1.5,-130,5.1,Marlins Park,4,2
2019-04-14,2019,LAD,MIL,7,1,-140,-1.5,151,9.0,105,-125,130,1.5,-175,5.25,Dodger Stadium,8,6
2019-04-14,2019,DET,MIN,4,6,210,1.5,-103,8.0,-105,-115,-240,-1.5,-117,2.58,Target Field,10,-2
2019-04-14,2019,ATL,NYM,7,3,140,1.5,-125,8.5,100,-120,-150,-1.5,105,3.54,Suntrust Park,10,4
2019-04-14,2019,CWS,NYY,5,2,180,1.5,-119,9.0,105,-125,-200,-1.5,-101,3.21,Yankee Stadium,7,3
2019-04-14,2019,TEX,OAK,8,7,135,1.5,-118,10.0,100,-120,-145,-1.5,-102,4.26,Rangers Ballpark,15,1
2019-04-14,2019,MIA,PHI,1,3,140,1.5,-130,8.5,105,-125,-150,-1.5,110,3.54,Marlins Park,4,-2
2019-04-14,2019,WSH,PIT,3,4,-180,-1.5,112,8.0,100,-120,165,1.5,-132,5.14,Nationals Park,7,-1
2019-04-14,2019,ARI,SD,8,4,-135,-1.5,148,8.0,-120,100,125,1.5,-170,4.6,Chase Field,12,4
2019-04-14,2019,HOU,SEA,3,2,-185,-1.5,-119,7.5,-120,100,170,1.5,-101,4.87,T-Mobile Park,5,1
2019-04-14,2019,COL,SF,4,0,-108,-1.5,155,7.0,100,-120,-102,1.5,-180,3.63,AT&T Park,4,4
2019-04-14,2019,CIN,STL,5,9,110,1.5,-159,10.0,-115,-105,-120,-1.5,136,4.76,Estadio Monterrey,14,-4
2019-04-14,2019,TOR,TB,4,8,118,1.5,-150,8.0,-110,-110,-128,-1.5,130,3.67,Rogers Centre,12,-4
2019-04-14,2019,OAK,TEX,7,8,-145,-1.5,-102,10.0,100,-120,135,1.5,-118,5.92,Rangers Ballpark,15,-1
2019-04-14,2019,TB,TOR,8,4,-128,-1.5,130,8.0,-110,-110,118,1.5,-150,4.49,Rogers Centre,12,4
2019-04-14,2019,PIT,WSH,4,3,165,1.5,-132,8.0,100,-120,-180,-1.5,112,3.02,Nationals Park,7,1
2019-04-15,2019,BOS,BAL,1,8,-260,-1.5,-149,11.0,-105,-115,230,1.5,129,7.94,Fenway Park,9,-7
2019-04-15,2019,BAL,BOS,8,1,230,1.5,129,11.0,-105,-115,-260,-1.5,-149,3.33,Fenway Park,9,7
2019-04-15,2019,MIA,CHC,2,7,125,1.5,-145,8.0,-110,-110,-135,-1.5,125,3.56,Marlins Park,9,-5
2019-04-15,2019,LAD,CIN,4,3,-185,-1.5,110,7.5,-110,-110,170,1.5,-130,4.87,Dodger Stadium,7,1
2019-04-15,2019,SEA,CLE,4,6,103,1.5,-174,7.0,-115,-105,-113,-1.5,150,3.45,T-Mobile Park,10,-2
2019-04-15,2019,SD,COL,2,5,-160,-1.5,125,7.5,-110,-110,150,1.5,-145,4.62,PETCO Park,7,-3
2019-04-15,2019,KC,CWS,4,5,106,1.5,-180,9.5,100,-120,-116,-1.5,155,4.61,Guaranteed Rate Field,9,-1
2019-04-15,2019,CWS,KC,5,4,-116,-1.5,155,9.5,100,-120,106,1.5,-180,5.1,Guaranteed Rate Field,9,1
2019-04-15,2019,TEX,LAA,12,7,112,1.5,-141,10.5,-120,100,-122,-1.5,121,4.95,Rangers Ballpark,19,5
2019-04-15,2019,CIN,LAD,3,4,170,1.5,-130,7.5,-110,-110,-185,-1.5,110,2.78,Dodger Stadium,7,-1
2019-04-15,2019,CHC,MIA,7,2,-135,-1.5,125,8.0,-110,-110,125,1.5,-145,4.6,Marlins Park,9,5
2019-04-15,2019,STL,MIL,7,10,125,1.5,-163,9.5,105,-125,-135,-1.5,143,4.22,Miller Park,17,-3
2019-04-15,2019,TOR,MIN,5,3,110,1.5,-190,8.5,-115,-105,-120,-1.5,163,4.05,Target Field,8,2
2019-04-15,2019,PHI,NYM,6,7,-113,-1.5,180,7.5,100,-120,103,1.5,-215,3.98,Citizens Bank Park,13,-1
2019-04-15,2019,NYM,PHI,7,6,103,1.5,-215,7.5,100,-120,-113,-1.5,180,3.69,Citizens Bank Park,13,1
2019-04-15,2019,COL,SD,5,2,150,1.5,-145,7.5,-110,-110,-160,-1.5,125,3.0,PETCO Park,7,3
2019-04-15,2019,CLE,SEA,6,4,-113,-1.5,150,7.0,-115,-105,103,1.5,-174,3.71,T-Mobile Park,10,2
2019-04-15,2019,MIL,STL,10,7,-135,-1.5,143,9.5,105,-125,125,1.5,-163,5.46,Miller Park,17,3
2019-04-15,2019,LAA,TEX,7,12,-122,-1.5,121,10.5,-120,100,112,1.5,-141,5.77,Rangers Ballpark,19,-5
2019-04-15,2019,MIN,TOR,3,5,-120,-1.5,163,8.5,-115,-105,110,1.5,-190,4.64,Target Field,8,-2
2019-04-16,2019,ATL,ARI,6,9,-135,-1.5,144,8.5,-105,-115,125,1.5,-165,4.88,Suntrust Park,15,-3
2019-04-16,2019,ARI,ATL,9,6,125,1.5,-165,8.5,-105,-115,-135,-1.5,144,3.78,Suntrust Park,15,3
2019-04-16,2019,TB,BAL,4,2,-245,-1.5,-123,8.0,-105,-115,215,1.5,103,5.68,Tropicana Field,6,2
2019-04-16,2019,NYY,BOS,8,0,-107,-1.5,176,8.5,100,-120,-103,1.5,-210,4.39,Yankee Stadium,8,8
2019-04-16,2019,MIA,CHC,0,4,120,1.5,-143,8.0,-105,-115,-130,-1.5,123,3.64,Marlins Park,4,-4
2019-04-16,2019,LAD,CIN,6,1,-168,-1.5,120,8.5,100,-120,158,1.5,-140,5.33,Dodger Stadium,7,5
2019-04-16,2019,SEA,CLE,2,4,115,1.5,-139,8.0,100,-120,-125,-1.5,119,3.72,T-Mobile Park,6,-2
2019-04-16,2019,SD,COL,2,8,-107,-1.5,180,7.5,105,-125,-103,1.5,-215,3.88,PETCO Park,10,-6
2019-04-16,2019,KC,CWS,1,5,110,1.5,-185,9.0,-110,-110,-120,-1.5,160,4.29,Guaranteed Rate Field,6,-4
2019-04-16,2019,PIT,DET,5,3,102,1.5,-215,7.5,-105,-115,-112,-1.5,180,3.71,Comerica Park,8,2
2019-04-16,2019,OAK,HOU,1,9,138,1.5,-119,9.0,-105,-115,-148,-1.5,-101,3.78,Oakland Coliseum,10,-8
2019-04-16,2019,CWS,KC,5,1,-120,-1.5,160,9.0,-110,-110,110,1.5,-185,4.91,Guaranteed Rate Field,6,4
2019-04-16,2019,TEX,LAA,5,0,-115,-1.5,148,10.0,-105,-115,105,1.5,-170,5.35,Rangers Ballpark,5,5
2019-04-16,2019,CIN,LAD,1,6,158,1.5,-140,8.5,100,-120,-168,-1.5,120,3.29,Dodger Stadium,7,-5
2019-04-16,2019,CHC,MIA,4,0,-130,-1.5,123,8.0,-105,-115,120,1.5,-143,4.52,Marlins Park,4,4
2019-04-16,2019,STL,MIL,4,8,111,1.5,-185,9.0,110,-130,-121,-1.5,160,4.27,Miller Park,12,-4
2019-04-16,2019,TOR,MIN,6,5,140,1.5,-150,9.0,100,-120,-150,-1.5,130,3.75,Target Field,11,1
2019-04-16,2019,PHI,NYM,14,3,-115,-1.5,158,9.0,-110,-110,105,1.5,-183,4.81,Citizens Bank Park,17,11
2019-04-16,2019,BOS,NYY,0,8,-103,1.5,-210,8.5,100,-120,-107,-1.5,176,4.31,Yankee Stadium,8,-8
2019-04-16,2019,HOU,OAK,9,1,-148,-1.5,-101,9.0,-105,-115,138,1.5,-119,5.37,Oakland Coliseum,10,8
2019-04-16,2019,NYM,PHI,3,14,105,1.5,-183,9.0,-110,-110,-115,-1.5,158,4.39,Citizens Bank Park,17,-11
2019-04-16,2019,DET,PIT,3,5,-112,-1.5,180,7.5,-105,-115,102,1.5,-215,3.96,Comerica Park,8,-2
2019-04-16,2019,COL,SD,8,2,-103,1.5,-215,7.5,105,-125,-107,-1.5,180,3.81,PETCO Park,10,6
2019-04-16,2019,CLE,SEA,4,2,-125,-1.5,119,8.0,100,-120,115,1.5,-139,4.44,T-Mobile Park,6,2
2019-04-16,2019,WSH,SF,3,7,-174,-1.5,106,8.0,-105,-115,162,1.5,-126,5.08,Nationals Park,10,-4
2019-04-16,2019,MIL,STL,8,4,-121,-1.5,160,9.0,110,-130,111,1.5,-185,4.93,Miller Park,12,4
2019-04-16,2019,BAL,TB,2,4,215,1.5,103,8.0,-105,-115,-245,-1.5,-123,2.54,Tropicana Field,6,-2
2019-04-16,2019,LAA,TEX,0,5,105,1.5,-170,10.0,-105,-115,-115,-1.5,148,4.88,Rangers Ballpark,5,-5
2019-04-16,2019,MIN,TOR,5,6,-150,-1.5,130,9.0,100,-120,140,1.5,-150,5.4,Target Field,11,-1
2019-04-16,2019,SF,WSH,7,3,162,1.5,-126,8.0,-105,-115,-174,-1.5,106,3.05,Nationals Park,10,4
2019-04-17,2019,ATL,ARI,2,3,-165,-1.5,110,9.0,-110,-110,155,1.5,-130,5.6,Suntrust Park,5,-1
2019-04-17,2019,ARI,ATL,3,2,155,1.5,-130,9.0,-110,-110,-165,-1.5,110,3.53,Suntrust Park,5,1
2019-04-17,2019,TB,BAL,8,1,-250,-1.5,-121,8.0,-115,-105,220,1.5,101,5.71,Tropicana Field,9,7
2019-04-17,2019,NYY,BOS,5,3,-114,-1.5,151,9.0,-115,-105,104,1.5,-175,4.79,Yankee Stadium,8,2
2019-04-17,2019,MIA,CHC,0,6,155,1.5,-105,8.0,-120,100,-165,-1.5,-115,3.14,Marlins Park,6,-6
2019-04-17,2019,LAD,CIN,3,2,-170,-1.5,120,8.0,-105,-115,160,1.5,-140,5.04,Dodger Stadium,5,1
2019-04-17,2019,SEA,CLE,0,1,118,1.5,-147,7.5,-120,100,-128,-1.5,127,3.44,T-Mobile Park,1,-1
2019-04-17,2019,KC,CWS,4,3,-115,-1.5,140,8.5,-115,-105,105,1.5,-160,4.55,Guaranteed Rate Field,7,1
2019-04-17,2019,PIT,DET,3,2,-108,-1.5,151,8.5,-105,-115,-102,1.5,-175,4.41,Comerica Park,5,1
2019-04-17,2019,OAK,HOU,2,1,-109,-1.5,172,8.5,-120,100,-101,1.5,-205,4.43,Oakland Coliseum,3,1
2019-04-17,2019,CWS,KC,3,4,105,1.5,-160,8.5,-115,-105,-115,-1.5,140,4.15,Guaranteed Rate Field,7,-1
2019-04-17,2019,TEX,LAA,5,4,-125,-1.5,140,10.5,-105,-115,115,1.5,-160,5.83,Rangers Ballpark,9,1
2019-04-17,2019,CIN,LAD,2,3,160,1.5,-140,8.0,-105,-115,-170,-1.5,120,3.08,Dodger Stadium,5,-1
2019-04-17,2019,CHC,MIA,6,0,-165,-1.5,-115,8.0,-120,100,155,1.5,-105,4.98,Marlins Park,6,6
2019-04-17,2019,STL,MIL,6,3,120,1.5,-170,10.0,-120,100,-130,-1.5,148,4.55,Miller Park,9,3
2019-04-17,2019,TOR,MIN,1,4,150,1.5,-140,8.5,100,-120,-160,-1.5,120,3.4,Target Field,5,-3
2019-04-17,2019,PHI,NYM,3,2,-110,-1.5,166,8.5,100,-120,100,1.5,-195,4.45,Citizens Bank Park,5,1
2019-04-17,2019,BOS,NYY,3,5,104,1.5,-175,9.0,-115,-105,-114,-1.5,151,4.41,Yankee Stadium,8,-2
2019-04-17,2019,HOU,OAK,1,2,-101,1.5,-205,8.5,-120,100,-109,-1.5,172,4.27,Oakland Coliseum,3,-1
2019-04-17,2019,NYM,PHI,2,3,100,1.5,-195,8.5,100,-120,-110,-1.5,166,4.25,Citizens Bank Park,5,-1
2019-04-17,2019,DET,PIT,2,3,-102,1.5,-175,8.5,-105,-115,-108,-1.5,151,4.29,Comerica Park,5,-1
2019-04-17,2019,CLE,SEA,1,0,-128,-1.5,127,7.5,-120,100,118,1.5,-147,4.21,T-Mobile Park,1,1
2019-04-17,2019,WSH,SF,9,6,-145,-1.5,142,8.5,-110,-110,135,1.5,-162,5.03,Nationals Park,15,3
2019-04-17,2019,MIL,STL,3,6,-130,-1.5,148,10.0,-120,100,120,1.5,-170,5.65,Miller Park,9,-3
2019-04-17,2019,BAL,TB,1,8,220,1.5,101,8.0,-115,-105,-250,-1.5,-121,2.5,Tropicana Field,9,-7
2019-04-17,2019,LAA,TEX,4,5,115,1.5,-160,10.5,-105,-115,-125,-1.5,140,4.88,Rangers Ballpark,9,-1
2019-04-17,2019,MIN,TOR,4,1,-160,-1.5,120,8.5,100,-120,150,1.5,-140,5.23,Target Field,5,3
2019-04-17,2019,SF,WSH,6,9,135,1.5,-162,8.5,-110,-110,-145,-1.5,142,3.62,Nationals Park,15,-3
2019-04-18,2019,ATL,ARI,1,4,-168,-1.5,120,8.5,-120,100,158,1.5,-140,5.33,Suntrust Park,5,-3
2019-04-18,2019,ARI,ATL,4,1,158,1.5,-140,8.5,-120,100,-168,-1.5,120,3.29,Suntrust Park,5,3
2019-04-18,2019,TB,BAL,5,6,-250,-1.5,-126,8.5,-115,-105,220,1.5,106,6.07,Tropicana Field,11,-1
2019-04-18,2019,SD,CIN,1,4,-170,-1.5,125,7.5,105,-125,160,1.5,-145,4.72,PETCO Park,5,-3
2019-04-18,2019,PHI,COL,2,6,108,1.5,-170,10.5,-120,100,-118,-1.5,148,5.05,Coors Field,8,-4
2019-04-18,2019,DET,CWS,9,7,-105,-1.5,176,8.5,-125,105,-105,1.5,-210,4.35,Comerica Park,16,2
2019-04-18,2019,CWS,DET,7,9,-105,1.5,-210,8.5,-125,105,-105,-1.5,176,4.35,Comerica Park,16,-2
2019-04-18,2019,NYY,KC,1,6,-200,-1.5,-105,9.0,100,-120,180,1.5,-115,6.0,Yankee Stadium,7,-5
2019-04-18,2019,SEA,LAA,11,10,110,1.5,-195,10.0,100,-120,-120,-1.5,166,4.76,Angel Stadium,21,1
2019-04-18,2019,MIL,LAD,1,3,-102,1.5,-160,9.5,-120,100,-108,-1.5,140,4.8,Miller Park,4,-2
2019-04-18,2019,LAD,MIL,3,1,-108,-1.5,140,9.5,-120,100,-102,1.5,-160,4.93,Miller Park,4,2
2019-04-18,2019,TOR,MIN,7,4,161,1.5,-125,8.0,-120,100,-172,-1.5,105,3.07,Target Field,11,3
2019-04-18,2019,KC,NYY,6,1,180,1.5,-115,9.0,100,-120,-200,-1.5,-105,3.21,Yankee Stadium,7,5
2019-04-18,2019,COL,PHI,6,2,-118,-1.5,148,10.5,-120,100,108,1.5,-170,5.68,Coors Field,8,4
2019-04-18,2019,CIN,SD,4,1,160,1.5,-145,7.5,105,-125,-170,-1.5,125,2.88,PETCO Park,5,3
2019-04-18,2019,LAA,SEA,10,11,-120,-1.5,166,10.0,100,-120,110,1.5,-195,5.45,Angel Stadium,21,-1
2019-04-18,2019,WSH,SF,4,2,-194,-1.5,105,7.5,-105,-115,177,1.5,-125,4.95,Nationals Park,6,2
2019-04-18,2019,BAL,TB,6,5,220,1.5,106,8.5,-115,-105,-250,-1.5,-126,2.66,Tropicana Field,11,1
2019-04-18,2019,MIN,TOR,4,7,-172,-1.5,105,8.0,-120,100,161,1.5,-125,5.06,Target Field,11,-3
2019-04-18,2019,SF,WSH,2,4,177,1.5,-125,7.5,-105,-115,-194,-1.5,105,2.71,Nationals Park,6,-2
2019-04-19,2019,CHC,ARI,5,1,-164,-1.5,135,7.0,105,-125,154,1.5,-155,4.35,Wrigley Field,6,4
2019-04-19,2019,TB,BOS,4,6,102,-1.5,184,8.5,100,-120,-112,1.5,-220,4.21,Tropicana Field,10,-2
2019-04-19,2019,ARI,CHC,1,5,154,1.5,-155,7.0,105,-125,-164,-1.5,135,2.76,Wrigley Field,6,-4
2019-04-19,2019,SD,CIN,2,3,-128,-1.5,151,8.0,-105,-115,118,1.5,-175,4.49,PETCO Park,5,-1
2019-04-19,2019,PHI,COL,3,4,138,1.5,-140,10.5,-110,-110,-148,-1.5,120,4.41,Coors Field,7,-1
2019-04-19,2019,DET,CWS,3,7,-106,-1.5,172,8.5,-115,-105,-104,1.5,-205,4.37,Comerica Park,10,-4
2019-04-19,2019,CWS,DET,7,3,-104,1.5,-205,8.5,-115,-105,-106,-1.5,172,4.33,Comerica Park,10,4
2019-04-19,2019,TEX,HOU,2,7,200,1.5,125,9.5,-105,-115,-220,-1.5,-145,3.17,Rangers Ballpark,9,-5
2019-04-19,2019,NYY,KC,6,2,-160,-1.5,120,8.5,100,-120,150,1.5,-140,5.23,Yankee Stadium,8,4
2019-04-19,2019,SEA,LAA,5,3,110,1.5,-200,9.0,100,-120,-120,-1.5,170,4.29,Angel Stadium,8,2
2019-04-19,2019,MIL,LAD,3,5,104,1.5,-160,9.5,100,-120,-114,-1.5,140,4.66,Miller Park,8,-2
2019-04-19,2019,WSH,MIA,2,3,-123,-1.5,130,7.5,-105,-115,113,1.5,-150,4.14,Marlins Park,5,-1
2019-04-19,2019,LAD,MIL,5,3,-114,-1.5,140,9.5,100,-120,104,1.5,-160,5.06,Miller Park,8,2
2019-04-19,2019,STL,NYM,4,5,-149,-1.5,130,9.0,-110,-110,139,1.5,-150,5.39,Busch Stadium,9,-1
2019-04-19,2019,KC,NYY,2,6,150,1.5,-140,8.5,100,-120,-160,-1.5,120,3.4,Yankee Stadium,8,-4
2019-04-19,2019,TOR,OAK,5,1,122,1.5,-170,8.0,-110,-110,-132,-1.5,148,3.6,Oakland Coliseum,6,4
2019-04-19,2019,COL,PHI,4,3,-148,-1.5,120,10.5,-110,-110,138,1.5,-140,6.27,Coors Field,7,1
2019-04-19,2019,SF,PIT,1,4,-115,-1.5,148,7.0,-120,100,105,1.5,-170,3.74,PNC Park,5,-3
2019-04-19,2019,CIN,SD,3,2,118,1.5,-175,8.0,-105,-115,-128,-1.5,151,3.67,PETCO Park,5,1
2019-04-19,2019,LAA,SEA,3,5,-120,-1.5,170,9.0,100,-120,110,1.5,-200,4.91,Angel Stadium,8,-2
2019-04-19,2019,PIT,SF,4,1,105,1.5,-170,7.0,-120,100,-115,-1.5,148,3.41,PNC Park,5,3
2019-04-19,2019,NYM,STL,5,4,139,1.5,-150,9.0,-110,-110,-149,-1.5,130,3.77,Busch Stadium,9,1
2019-04-19,2019,BOS,TB,6,4,-112,1.5,-220,8.5,100,-120,102,-1.5,184,4.49,Tropicana Field,10,2
2019-04-19,2019,HOU,TEX,7,2,-220,-1.5,-145,9.5,-105,-115,200,1.5,125,6.53,Rangers Ballpark,9,5
2019-04-19,2019,OAK,TOR,1,5,-132,-1.5,148,8.0,-110,-110,122,1.5,-170,4.55,Oakland Coliseum,6,-4
2019-04-19,2019,MIA,WSH,3,2,113,1.5,-150,7.5,-105,-115,-123,-1.5,130,3.52,Marlins Park,5,1
2019-04-20,2019,CHC,ARI,0,6,-133,-1.5,163,7.0,-110,-110,123,1.5,-190,4.0,Wrigley Field,6,-6
2019-04-20,2019,CLE,ATL,8,4,-134,-1.5,155,8.5,100,-120,124,1.5,-180,4.87,Progressive Field,12,4
2019-04-20,2019,CLE,ATL,7,8,-160,-1.5,126,8.0,-115,-105,150,1.5,-146,4.92,Progressive Field,15,-1
2019-04-20,2019,MIN,BAL,6,5,-200,-1.5,-125,9.0,-120,100,180,1.5,105,6.0,Camden Yards,11,1
2019-04-20,2019,MIN,BAL,16,7,-138,-1.5,115,10.0,-105,-115,128,1.5,-135,5.8,Camden Yards,23,9
2019-04-20,2019,TB,BOS,5,6,-138,-1.5,151,8.5,100,-120,128,1.5,-175,4.93,Tropicana Field,11,-1
2019-04-20,2019,ARI,CHC,6,0,123,1.5,-190,7.0,-110,-110,-133,-1.5,163,3.14,Wrigley Field,6,6
2019-04-20,2019,SD,CIN,2,4,-106,1.5,-190,7.0,-130,110,-104,-1.5,163,3.6,PETCO Park,6,-2
2019-04-20,2019,ATL,CLE,4,8,124,1.5,-180,8.5,100,-120,-134,-1.5,155,3.79,Progressive Field,12,-4
2019-04-20,2019,ATL,CLE,8,7,150,1.5,-146,8.0,-115,-105,-160,-1.5,126,3.2,Progressive Field,15,1
2019-04-20,2019,PHI,COL,8,5,-142,-1.5,103,9.0,-110,-110,132,1.5,-123,5.28,Coors Field,13,3
2019-04-20,2019,TEX,HOU,9,4,225,1.5,155,10.0,100,-120,-255,-1.5,-180,3.08,Rangers Ballpark,13,5
2019-04-20,2019,NYY,KC,9,2,-250,-1.5,-130,8.5,-120,100,220,1.5,110,6.07,Yankee Stadium,11,7
2019-04-20,2019,SEA,LAA,6,5,106,1.5,-195,8.5,-120,100,-116,-1.5,166,4.13,Angel Stadium,11,1
2019-04-20,2019,MIL,LAD,5,0,113,1.5,-141,9.0,-120,100,-123,-1.5,121,4.23,Miller Park,5,5
2019-04-20,2019,WSH,MIA,3,9,-255,-1.5,-150,7.0,-105,-115,225,1.5,130,5.03,Marlins Park,12,-6
2019-04-20,2019,LAD,MIL,0,5,-123,-1.5,121,9.0,-120,100,113,1.5,-141,4.96,Miller Park,5,-5
2019-04-20,2019,BAL,MIN,5,6,180,1.5,105,9.0,-120,100,-200,-1.5,-125,3.21,Camden Yards,11,-1
2019-04-20,2019,BAL,MIN,7,16,128,1.5,-135,10.0,-105,-115,-138,-1.5,115,4.39,Camden Yards,23,-9
2019-04-20,2019,STL,NYM,10,2,-144,-1.5,140,9.0,-115,-105,134,1.5,-160,5.31,Busch Stadium,12,8
2019-04-20,2019,KC,NYY,2,9,220,1.5,110,8.5,-120,100,-250,-1.5,-130,2.66,Yankee Stadium,11,-7
2019-04-20,2019,TOR,OAK,10,1,137,1.5,-166,8.0,-115,-105,-147,-1.5,145,3.38,Oakland Coliseum,11,9
2019-04-20,2019,COL,PHI,5,8,132,1.5,-123,9.0,-110,-110,-142,-1.5,103,3.88,Coors Field,13,-3
2019-04-20,2019,SF,PIT,1,3,122,1.5,-190,7.0,-125,105,-132,-1.5,163,3.15,PNC Park,4,-2
2019-04-20,2019,CIN,SD,4,2,-104,-1.5,163,7.0,-130,110,-106,1.5,-190,3.57,PETCO Park,6,2
2019-04-20,2019,LAA,SEA,5,6,-116,-1.5,166,8.5,-120,100,106,1.5,-195,4.56,Angel Stadium,11,-1
2019-04-20,2019,PIT,SF,3,1,-132,-1.5,163,7.0,-125,105,122,1.5,-190,3.98,PNC Park,4,2
2019-04-20,2019,NYM,STL,2,10,134,1.5,-160,9.0,-115,-105,-144,-1.5,140,3.85,Busch Stadium,12,-8
2019-04-20,2019,BOS,TB,6,5,128,1.5,-175,8.5,100,-120,-138,-1.5,151,3.73,Tropicana Field,11,1
2019-04-20,2019,HOU,TEX,4,9,-255,-1.5,-180,10.0,100,-120,225,1.5,155,7.18,Rangers Ballpark,13,-5
2019-04-20,2019,OAK,TOR,1,10,-147,-1.5,145,8.0,-115,-105,137,1.5,-166,4.76,Oakland Coliseum,11,-9
2019-04-20,2019,MIA,WSH,9,3,225,1.5,130,7.0,-105,-115,-255,-1.5,-150,2.15,Marlins Park,12,6
2019-04-21,2019,CHC,ARI,2,1,-107,-1.5,172,9.5,-105,-115,-103,1.5,-205,4.91,Wrigley Field,3,1
2019-04-21,2019,CLE,ATL,5,11,-110,-1.5,172,8.0,-110,-110,100,1.5,-205,4.19,Progressive Field,16,-6
2019-04-21,2019,MIN,BAL,4,3,-150,-1.5,-104,9.0,-120,100,140,1.5,-116,5.4,Camden Yards,7,1
2019-04-21,2019,TB,BOS,3,4,-110,-1.5,170,8.0,100,-120,100,1.5,-200,4.19,Tropicana Field,7,-1
2019-04-21,2019,ARI,CHC,1,2,-103,1.5,-205,9.5,-105,-115,-107,-1.5,172,4.82,Wrigley Field,3,-1
2019-04-21,2019,SD,CIN,4,3,-162,-1.5,135,7.5,100,-120,152,1.5,-155,4.64,PETCO Park,7,1
2019-04-21,2019,ATL,CLE,11,5,100,1.5,-205,8.0,-110,-110,-110,-1.5,172,4.0,Progressive Field,16,6
2019-04-21,2019,PHI,COL,1,4,132,1.5,-145,10.5,-120,100,-142,-1.5,125,4.53,Coors Field,5,-3
2019-04-21,2019,DET,CWS,4,3,-110,-1.5,166,9.0,-120,100,100,1.5,-195,4.71,Comerica Park,7,1
2019-04-21,2019,CWS,DET,3,4,100,1.5,-195,9.0,-120,100,-110,-1.5,166,4.5,Comerica Park,7,-1
2019-04-21,2019,TEX,HOU,11,10,170,1.5,110,10.5,-105,-115,-185,-1.5,-130,3.89,Rangers Ballpark,21,1
2019-04-21,2019,NYY,KC,7,6,-200,-1.5,100,7.5,-115,-105,180,1.5,-120,5.0,Yankee Stadium,13,1
2019-04-21,2019,SEA,LAA,6,8,109,1.5,-190,9.5,105,-125,-119,-1.5,163,4.55,Angel Stadium,14,-2
2019-04-21,2019,MIL,LAD,5,6,119,1.5,-139,8.5,-105,-115,-129,-1.5,119,3.88,Miller Park,11,-1
2019-04-21,2019,WSH,MIA,5,0,-160,-1.5,-105,7.0,-115,-105,150,1.5,-115,4.31,Marlins Park,5,5
2019-04-21,2019,LAD,MIL,6,5,-129,-1.5,119,8.5,-105,-115,119,1.5,-139,4.79,Miller Park,11,1
2019-04-21,2019,BAL,MIN,3,4,140,1.5,-116,9.0,-120,100,-150,-1.5,-104,3.75,Camden Yards,7,-1
2019-04-21,2019,STL,NYM,6,4,122,1.5,-140,9.0,100,-120,-132,-1.5,120,4.05,Busch Stadium,10,2
2019-04-21,2019,KC,NYY,6,7,180,1.5,-120,7.5,-115,-105,-200,-1.5,100,2.68,Yankee Stadium,13,-1
2019-04-21,2019,TOR,OAK,5,4,140,1.5,-152,8.0,-110,-110,-150,-1.5,131,3.33,Oakland Coliseum,9,1
2019-04-21,2019,COL,PHI,4,1,-142,-1.5,125,10.5,-120,100,132,1.5,-145,6.16,Coors Field,5,3
2019-04-21,2019,SF,PIT,3,2,132,1.5,-165,7.0,-110,-110,-142,-1.5,144,3.02,PNC Park,5,1
2019-04-21,2019,CIN,SD,3,4,152,1.5,-155,7.5,100,-120,-162,-1.5,135,2.98,PETCO Park,7,-1
2019-04-21,2019,LAA,SEA,8,6,-119,-1.5,163,9.5,105,-125,109,1.5,-190,5.16,Angel Stadium,14,2
2019-04-21,2019,PIT,SF,2,3,-142,-1.5,144,7.0,-110,-110,132,1.5,-165,4.11,PNC Park,5,-1
2019-04-21,2019,NYM,STL,4,6,-132,-1.5,120,9.0,100,-120,122,1.5,-140,5.12,Busch Stadium,10,-2
2019-04-21,2019,BOS,TB,4,3,100,1.5,-200,8.0,100,-120,-110,-1.5,170,4.0,Tropicana Field,7,1
2019-04-21,2019,HOU,TEX,10,11,-185,-1.5,-130,10.5,-105,-115,170,1.5,110,6.82,Rangers Ballpark,21,-1
2019-04-21,2019,OAK,TOR,4,5,-150,-1.5,131,8.0,-110,-110,140,1.5,-152,4.8,Oakland Coliseum,9,-1
2019-04-21,2019,MIA,WSH,0,5,150,1.5,-115,7.0,-115,-105,-160,-1.5,-105,2.8,Marlins Park,5,-5
2019-04-22,2019,PIT,ARI,4,12,-133,-1.5,155,7.5,-105,-115,123,1.5,-180,4.28,PNC Park,16,-8
2019-04-22,2019,CWS,BAL,12,2,-120,-1.5,125,9.5,-110,-110,110,1.5,-145,5.18,Camden Yards,14,10
2019-04-22,2019,WSH,COL,5,7,112,1.5,-163,11.0,-105,-115,-122,-1.5,143,5.19,Coors Field,12,-2
2019-04-22,2019,BAL,CWS,2,12,110,1.5,-145,9.5,-110,-110,-120,-1.5,125,4.52,Camden Yards,14,-10
2019-04-22,2019,MIN,HOU,9,5,158,1.5,-135,9.5,-105,-115,-168,-1.5,115,3.68,Minute Maid Park,14,4
2019-04-22,2019,TB,KC,6,3,-170,-1.5,110,7.5,-120,100,160,1.5,-128,4.72,Tropicana Field,9,3
2019-04-22,2019,NYY,LAA,4,3,105,1.5,-200,8.5,-105,-115,-115,-1.5,170,4.15,Angel Stadium,7,1
2019-04-22,2019,STL,MIL,13,5,-145,-1.5,140,8.5,-115,-105,135,1.5,-160,5.03,Busch Stadium,18,8
2019-04-22,2019,HOU,MIN,5,9,-168,-1.5,115,9.5,-105,-115,158,1.5,-135,5.96,Minute Maid Park,14,-4
2019-04-22,2019,PHI,NYM,1,5,-102,1.5,-210,9.0,100,-120,-108,-1.5,176,4.54,Citi Field,6,-4
2019-04-22,2019,LAA,NYY,3,4,-115,-1.5,170,8.5,-105,-115,105,1.5,-200,4.55,Angel Stadium,7,-1
2019-04-22,2019,TEX,OAK,1,6,130,1.5,-165,8.5,-110,-110,-140,-1.5,144,3.7,Oakland Coliseum,7,-5
2019-04-22,2019,NYM,PHI,5,1,-108,-1.5,176,9.0,100,-120,-102,1.5,-210,4.67,Citi Field,6,4
2019-04-22,2019,ARI,PIT,12,4,123,1.5,-180,7.5,-105,-115,-133,-1.5,155,3.36,PNC Park,16,8
2019-04-22,2019,MIL,STL,5,13,135,1.5,-160,8.5,-115,-105,-145,-1.5,140,3.62,Busch Stadium,18,-8
2019-04-22,2019,KC,TB,3,6,160,1.5,-128,7.5,-120,100,-170,-1.5,110,2.88,Tropicana Field,9,-3
2019-04-22,2019,OAK,TEX,6,1,-140,-1.5,144,8.5,-110,-110,130,1.5,-165,4.96,Oakland Coliseum,7,5
2019-04-22,2019,COL,WSH,7,5,-122,-1.5,143,11.0,-105,-115,112,1.5,-163,6.05,Coors Field,12,2
2019-04-23,2019,PIT,ARI,1,2,-106,-1.5,178,8.0,100,-120,-104,1.5,-212,4.12,PNC Park,3,-1
2019-04-23,2019,CIN,ATL,7,6,112,1.5,-160,9.5,100,-120,-122,-1.5,140,4.48,Great American Ballpark,13,1
2019-04-23,2019,CWS,BAL,1,9,-136,-1.5,105,9.5,-120,100,126,1.5,-125,5.47,Camden Yards,10,-8
2019-04-23,2019,DET,BOS,7,4,200,1.5,-115,8.0,100,-120,-220,-1.5,-105,2.67,Fenway Park,11,3
2019-04-23,2019,DET,BOS,4,2,165,1.5,-120,9.0,-115,-105,-180,-1.5,100,3.4,Fenway Park,6,2
2019-04-23,2019,LAD,CHC,2,7,100,1.5,-200,8.0,-115,-105,-110,-1.5,170,4.0,Wrigley Field,9,-5
2019-04-23,2019,ATL,CIN,6,7,-122,-1.5,140,9.5,100,-120,112,1.5,-160,5.22,Great American Ballpark,13,-1
2019-04-23,2019,MIA,CLE,3,1,205,1.5,104,7.5,-110,-110,-230,-1.5,-124,2.46,Progressive Field,4,2
2019-04-23,2019,WSH,COL,6,3,-154,-1.5,-112,11.0,105,-125,144,1.5,-108,6.67,Coors Field,9,3
2019-04-23,2019,BAL,CWS,9,1,126,1.5,-125,9.5,-120,100,-136,-1.5,105,4.2,Camden Yards,10,8
2019-04-23,2019,BOS,DET,4,7,-220,-1.5,-105,8.0,100,-120,200,1.5,-115,5.5,Fenway Park,11,-3
2019-04-23,2019,BOS,DET,2,4,-180,-1.5,100,9.0,-115,-105,165,1.5,-120,5.79,Fenway Park,6,-2
2019-04-23,2019,MIN,HOU,4,10,140,1.5,-140,9.5,-110,-110,-150,-1.5,120,3.96,Minute Maid Park,14,-6
2019-04-23,2019,TB,KC,5,2,-185,-1.5,105,8.0,-110,-110,170,1.5,-125,5.19,Tropicana Field,7,3
2019-04-23,2019,NYY,LAA,7,5,-105,-1.5,148,8.5,-115,-105,-105,1.5,-170,4.35,Angel Stadium,12,2
2019-04-23,2019,CHC,LAD,7,2,-110,-1.5,170,8.0,-115,-105,100,1.5,-200,4.19,Wrigley Field,9,5
2019-04-23,2019,CLE,MIA,1,3,-230,-1.5,-124,7.5,-110,-110,205,1.5,104,5.23,Progressive Field,4,-2
2019-04-23,2019,STL,MIL,4,3,-117,-1.5,152,9.0,100,-120,107,1.5,-177,4.85,Busch Stadium,7,1
2019-04-23,2019,HOU,MIN,10,4,-150,-1.5,120,9.5,-110,-110,140,1.5,-140,5.7,Minute Maid Park,14,6
2019-04-23,2019,PHI,NYM,0,9,113,1.5,-180,8.5,-110,-110,-123,-1.5,155,3.99,Citi Field,9,-9
2019-04-23,2019,LAA,NYY,5,7,-105,1.5,-170,8.5,-115,-105,-105,-1.5,148,4.35,Angel Stadium,12,-2
2019-04-23,2019,TEX,OAK,5,11,130,1.5,-145,8.0,-125,105,-140,-1.5,125,3.48,Oakland Coliseum,16,-6
2019-04-23,2019,NYM,PHI,9,0,-123,-1.5,155,8.5,-110,-110,113,1.5,-180,4.69,Citi Field,9,9
2019-04-23,2019,ARI,PIT,2,1,-104,1.5,-212,8.0,100,-120,-106,-1.5,178,4.08,PNC Park,3,1
2019-04-23,2019,SEA,SD,3,6,122,1.5,-191,8.0,-125,105,-132,-1.5,165,3.6,PETCO Park,9,-3
2019-04-23,2019,SD,SEA,6,3,-132,-1.5,165,8.0,-125,105,122,1.5,-191,4.55,PETCO Park,9,3
2019-04-23,2019,TOR,SF,6,7,-106,-1.5,180,8.5,-105,-115,-104,1.5,-215,4.37,Rogers Centre,13,-1
2019-04-23,2019,MIL,STL,3,4,107,1.5,-177,9.0,100,-120,-117,-1.5,152,4.35,Busch Stadium,7,-1
2019-04-23,2019,KC,TB,2,5,170,1.5,-125,8.0,-110,-110,-185,-1.5,105,2.96,Tropicana Field,7,-3
2019-04-23,2019,OAK,TEX,11,5,-140,-1.5,125,8.0,-125,105,130,1.5,-145,4.67,Oakland Coliseum,16,6
2019-04-23,2019,SF,TOR,7,6,-104,1.5,-215,8.5,-105,-115,-106,-1.5,180,4.33,Rogers Centre,13,1
2019-04-23,2019,COL,WSH,3,6,144,1.5,-108,11.0,105,-125,-154,-1.5,-112,4.51,Coors Field,9,-3
2019-04-24,2019,PIT,ARI,2,11,-110,-1.5,172,8.0,-105,-115,100,1.5,-205,4.19,PNC Park,13,-9
2019-04-24,2019,CIN,ATL,1,3,103,1.5,-160,9.5,-105,-115,-113,-1.5,140,4.68,Great American Ballpark,4,-2
2019-04-24,2019,CWS,BAL,3,4,115,1.5,-173,9.5,-110,-110,-125,-1.5,150,4.42,Camden Yards,7,-1
2019-04-24,2019,DET,BOS,4,11,195,1.5,103,9.5,-105,-115,-215,-1.5,-123,3.22,Fenway Park,15,-7
2019-04-24,2019,LAD,CHC,6,7,-116,-1.5,143,8.0,100,-120,106,1.5,-163,4.3,Wrigley Field,13,-1
2019-04-24,2019,ATL,CIN,3,1,-113,-1.5,140,9.5,-105,-115,103,1.5,-160,5.04,Great American Ballpark,4,2
2019-04-24,2019,MIA,CLE,2,6,147,1.5,-150,9.0,-120,100,-157,-1.5,130,3.64,Progressive Field,8,-4
2019-04-24,2019,WSH,COL,5,9,150,1.5,-119,10.5,-110,-110,-160,-1.5,-101,4.2,Coors Field,14,-4
2019-04-24,2019,BAL,CWS,4,3,-125,-1.5,150,9.5,-110,-110,115,1.5,-173,5.28,Camden Yards,7,1
2019-04-24,2019,BOS,DET,11,4,-215,-1.5,-123,9.5,-105,-115,195,1.5,103,6.48,Fenway Park,15,7
2019-04-24,2019,MIN,HOU,1,7,210,1.5,105,9.0,100,-120,-240,-1.5,-125,2.9,Minute Maid Park,8,-6
2019-04-24,2019,TB,KC,2,10,-240,-1.5,-109,7.0,100,-120,210,1.5,-111,4.94,Tropicana Field,12,-8
2019-04-24,2019,NYY,LAA,6,5,-114,-1.5,140,8.5,100,-120,104,1.5,-160,4.53,Angel Stadium,11,1
2019-04-24,2019,CHC,LAD,7,6,106,1.5,-163,8.0,100,-120,-116,-1.5,143,3.88,Wrigley Field,13,1
2019-04-24,2019,CLE,MIA,6,2,-157,-1.5,130,9.0,-120,100,147,1.5,-150,5.5,Progressive Field,8,4
2019-04-24,2019,STL,MIL,5,2,-125,-1.5,144,8.5,100,-120,115,1.5,-165,4.72,Busch Stadium,7,3
2019-04-24,2019,HOU,MIN,7,1,-240,-1.5,-125,9.0,100,-120,210,1.5,105,6.35,Minute Maid Park,8,6
2019-04-24,2019,PHI,NYM,6,0,-126,-1.5,115,9.0,-120,100,116,1.5,-135,5.02,Citi Field,6,6
2019-04-24,2019,LAA,NYY,5,6,104,1.5,-160,8.5,100,-120,-114,-1.5,140,4.17,Angel Stadium,11,-1
2019-04-24,2019,TEX,OAK,5,6,150,1.5,-140,9.5,100,-120,-160,-1.5,120,3.8,Oakland Coliseum,11,-1
2019-04-24,2019,NYM,PHI,0,6,116,1.5,-135,9.0,-120,100,-126,-1.5,115,4.17,Citi Field,6,-6
2019-04-24,2019,ARI,PIT,11,2,100,1.5,-205,8.0,-105,-115,-110,-1.5,172,4.0,PNC Park,13,9
2019-04-24,2019,SEA,SD,0,1,148,1.5,-134,8.5,-115,-105,-158,-1.5,115,3.43,PETCO Park,1,-1
2019-04-24,2019,SD,SEA,1,0,-158,-1.5,115,8.5,-115,-105,148,1.5,-134,5.21,PETCO Park,1,1
2019-04-24,2019,TOR,SF,0,4,112,1.5,-157,8.5,105,-125,-122,-1.5,137,4.01,Rogers Centre,4,-4
2019-04-24,2019,MIL,STL,2,5,115,1.5,-165,8.5,100,-120,-125,-1.5,144,3.95,Busch Stadium,7,-3
2019-04-24,2019,KC,TB,10,2,210,1.5,-111,7.0,100,-120,-240,-1.5,-109,2.26,Tropicana Field,12,8
2019-04-24,2019,OAK,TEX,6,5,-160,-1.5,120,9.5,100,-120,150,1.5,-140,5.85,Oakland Coliseum,11,1
2019-04-24,2019,SF,TOR,4,0,-122,-1.5,137,8.5,105,-125,112,1.5,-157,4.67,Rogers Centre,4,4
2019-04-24,2019,COL,WSH,9,5,-160,-1.5,-101,10.5,-110,-110,150,1.5,-119,6.46,Coors Field,14,4
2019-04-25,2019,PIT,ARI,0,5,-105,-1.5,180,7.0,105,-125,-105,1.5,-215,3.59,PNC Park,5,-5
2019-04-25,2019,CIN,ATL,4,2,-138,-1.5,129,9.0,-120,100,128,1.5,-148,5.22,Great American Ballpark,6,2
2019-04-25,2019,DET,BOS,3,7,205,1.5,-101,9.5,-115,-105,-230,-1.5,-119,3.11,Fenway Park,10,-4
2019-04-25,2019,LAD,CHC,2,1,-116,-1.5,135,8.5,105,-125,106,1.5,-155,4.56,Wrigley Field,3,1
2019-04-25,2019,ATL,CIN,2,4,128,1.5,-148,9.0,-120,100,-138,-1.5,129,3.95,Great American Ballpark,6,-2
2019-04-25,2019,HOU,CLE,1,2,-145,-1.5,125,7.5,-115,-105,135,1.5,-145,4.44,Minute Maid Park,3,-1
2019-04-25,2019,BOS,DET,7,3,-230,-1.5,-119,9.5,-115,-105,205,1.5,-101,6.62,Fenway Park,10,4
2019-04-25,2019,CLE,HOU,2,1,135,1.5,-145,7.5,-115,-105,-145,-1.5,125,3.19,Minute Maid Park,3,1
2019-04-25,2019,NYY,LAA,5,11,-112,1.5,-220,8.0,-110,-110,102,-1.5,184,4.23,Angel Stadium,16,-6
2019-04-25,2019,CHC,LAD,1,2,106,1.5,-155,8.5,105,-125,-116,-1.5,135,4.13,Wrigley Field,3,-1
2019-04-25,2019,PHI,MIA,1,3,-190,-1.5,110,7.5,100,-120,175,1.5,-130,4.91,Citizens Bank Park,4,-2
2019-04-25,2019,LAA,NYY,11,5,102,-1.5,184,8.0,-110,-110,-112,1.5,-220,3.96,Angel Stadium,16,6
2019-04-25,2019,MIA,PHI,3,1,175,1.5,-130,7.5,100,-120,-190,-1.5,110,2.73,Citizens Bank Park,4,2
2019-04-25,2019,ARI,PIT,5,0,-105,1.5,-215,7.0,105,-125,-105,-1.5,180,3.59,PNC Park,5,5
2019-04-25,2019,TEX,SEA,2,14,133,1.5,-159,8.5,-115,-105,-143,-1.5,138,3.65,T-Mobile Park,16,-12
2019-04-25,2019,SEA,TEX,14,2,-143,-1.5,138,8.5,-115,-105,133,1.5,-159,5.0,T-Mobile Park,16,12
2019-04-26,2019,CHC,ARI,3,8,-102,1.5,-200,9.0,-115,-105,-108,-1.5,170,4.54,Chase Field,11,-5
2019-04-26,2019,COL,ATL,8,4,150,1.5,-145,8.5,-110,-110,-160,-1.5,125,3.4,Suntrust Park,12,4
2019-04-26,2019,MIN,BAL,6,1,-185,-1.5,105,9.5,100,-120,170,1.5,-125,6.17,Target Field,7,5
2019-04-26,2019,ARI,CHC,8,3,-108,-1.5,170,9.0,-115,-105,-102,1.5,-200,4.67,Chase Field,11,5
2019-04-26,2019,STL,CIN,1,12,-145,-1.5,130,8.0,-120,100,135,1.5,-150,4.73,Busch Stadium,13,-11
2019-04-26,2019,HOU,CLE,3,6,-123,-1.5,151,8.5,-130,110,113,1.5,-175,4.69,Minute Maid Park,9,-3
2019-04-26,2019,ATL,COL,4,8,-160,-1.5,125,8.5,-110,-110,150,1.5,-145,5.23,Suntrust Park,12,-4
2019-04-26,2019,DET,CWS,11,12,117,1.5,-170,8.5,-115,-105,-127,-1.5,148,3.92,Guaranteed Rate Field,23,-1
2019-04-26,2019,CWS,DET,12,11,-127,-1.5,148,8.5,-115,-105,117,1.5,-170,4.76,Guaranteed Rate Field,23,1
2019-04-26,2019,CLE,HOU,6,3,113,1.5,-175,8.5,-130,110,-123,-1.5,151,3.99,Minute Maid Park,9,3
2019-04-26,2019,LAA,KC,5,1,-105,-1.5,148,9.0,-105,-115,-105,1.5,-170,4.61,Kauffman Stadium,6,4
2019-04-26,2019,KC,LAA,1,5,-105,1.5,-170,9.0,-105,-115,-105,-1.5,148,4.61,Kauffman Stadium,6,-4
2019-04-26,2019,PIT,LAD,2,6,165,1.5,-130,7.5,100,-120,-180,-1.5,110,2.83,Dodger Stadium,8,-4
2019-04-26,2019,PHI,MIA,4,0,-170,-1.5,115,8.5,-120,100,160,1.5,-135,5.35,Citizens Bank Park,4,4
2019-04-26,2019,NYM,MIL,2,10,-174,-1.5,131,7.0,-120,100,162,1.5,-151,4.45,Citi Field,12,-8
2019-04-26,2019,BAL,MIN,1,6,170,1.5,-125,9.5,100,-120,-185,-1.5,105,3.52,Target Field,7,-5
2019-04-26,2019,MIL,NYM,10,2,162,1.5,-151,7.0,-120,100,-174,-1.5,131,2.67,Citi Field,12,8
2019-04-26,2019,SF,NYY,3,7,100,1.5,-185,6.0,-110,-110,-110,-1.5,160,3.0,AT&T Park,10,-4
2019-04-26,2019,TOR,OAK,4,2,-124,-1.5,148,9.0,-120,100,114,1.5,-170,4.98,Rogers Centre,6,2
2019-04-26,2019,MIA,PHI,0,4,160,1.5,-135,8.5,-120,100,-170,-1.5,115,3.27,Citizens Bank Park,4,-4
2019-04-26,2019,LAD,PIT,6,2,-180,-1.5,110,7.5,100,-120,165,1.5,-130,4.82,Dodger Stadium,8,4
2019-04-26,2019,WSH,SD,3,4,-210,-1.5,104,7.0,-130,110,190,1.5,-124,4.74,Nationals Park,7,-1
2019-04-26,2019,TEX,SEA,4,5,130,1.5,-160,9.5,100,-120,-140,-1.5,140,4.13,T-Mobile Park,9,-1
2019-04-26,2019,NYY,SF,7,3,-110,-1.5,160,6.0,-110,-110,100,1.5,-185,3.14,AT&T Park,10,4
2019-04-26,2019,CIN,STL,12,1,135,1.5,-150,8.0,-120,100,-145,-1.5,130,3.4,Busch Stadium,13,11
2019-04-26,2019,SEA,TEX,5,4,-140,-1.5,140,9.5,100,-120,130,1.5,-160,5.54,T-Mobile Park,9,1
2019-04-26,2019,OAK,TOR,2,4,114,1.5,-170,9.0,-120,100,-124,-1.5,148,4.21,Rogers Centre,6,-2
2019-04-26,2019,SD,WSH,4,3,190,1.5,-124,7.0,-130,110,-210,-1.5,104,2.41,Nationals Park,7,1
2019-04-27,2019,CHC,ARI,9,1,104,-1.5,149,10.5,105,-125,-114,1.5,-172,5.15,Chase Field,10,8
2019-04-27,2019,COL,ATL,9,5,102,1.5,-210,8.5,-115,-105,-112,-1.5,176,4.21,Suntrust Park,14,4
2019-04-27,2019,MIN,BAL,9,2,-255,-1.5,-121,9.0,100,-120,225,1.5,101,6.46,Target Field,11,7
2019-04-27,2019,TB,BOS,2,1,120,1.5,-185,9.0,110,-130,-130,-1.5,160,4.09,Fenway Park,3,1
2019-04-27,2019,ARI,CHC,1,9,-114,1.5,-172,10.5,105,-125,104,-1.5,149,5.59,Chase Field,10,-8
2019-04-27,2019,STL,CIN,6,3,-123,-1.5,155,9.0,-115,-105,113,1.5,-180,4.96,Busch Stadium,9,3
2019-04-27,2019,HOU,CLE,4,3,-150,-1.5,140,9.0,100,-120,140,1.5,-160,5.4,Minute Maid Park,7,1
2019-04-27,2019,ATL,COL,5,9,-112,-1.5,176,8.5,-115,-105,102,1.5,-210,4.49,Suntrust Park,14,-4
2019-04-27,2019,CLE,HOU,3,4,140,1.5,-160,9.0,100,-120,-150,-1.5,140,3.75,Minute Maid Park,7,-1
2019-04-27,2019,LAA,KC,4,9,-116,-1.5,142,9.0,100,-120,106,1.5,-163,4.83,Kauffman Stadium,13,-5
2019-04-27,2019,KC,LAA,9,4,106,1.5,-163,9.0,100,-120,-116,-1.5,142,4.37,Kauffman Stadium,13,5
2019-04-27,2019,PIT,LAD,1,3,190,1.5,-117,7.5,100,-120,-210,-1.5,-104,2.59,Dodger Stadium,4,-2
2019-04-27,2019,PHI,MIA,12,9,-200,-1.5,-105,8.0,-115,-105,180,1.5,-115,5.33,Citizens Bank Park,21,3
2019-04-27,2019,NYM,MIL,6,8,-132,-1.5,160,7.0,-125,105,122,1.5,-185,3.98,Citi Field,14,-2
2019-04-27,2019,BAL,MIN,2,9,225,1.5,101,9.0,100,-120,-255,-1.5,-121,2.77,Target Field,11,-7
2019-04-27,2019,MIL,NYM,8,6,122,1.5,-185,7.0,-125,105,-132,-1.5,160,3.15,Citi Field,14,2
2019-04-27,2019,SF,NYY,4,6,-106,-1.5,180,7.5,105,-125,-104,1.5,-215,3.86,AT&T Park,10,-2
2019-04-27,2019,TOR,OAK,7,1,-105,1.5,-170,9.0,-120,100,-105,-1.5,148,4.61,Rogers Centre,8,6
2019-04-27,2019,MIA,PHI,9,12,180,1.5,-115,8.0,-115,-105,-200,-1.5,-105,2.86,Citizens Bank Park,21,-3
2019-04-27,2019,LAD,PIT,3,1,-210,-1.5,-104,7.5,100,-120,190,1.5,-117,5.08,Dodger Stadium,4,2
2019-04-27,2019,WSH,SD,3,8,-162,-1.5,127,8.5,-105,-115,152,1.5,-147,5.26,Nationals Park,11,-5
2019-04-27,2019,TEX,SEA,15,1,-107,-1.5,143,8.5,100,-120,-103,1.5,-164,4.39,T-Mobile Park,16,14
2019-04-27,2019,NYY,SF,6,4,-104,1.5,-215,7.5,105,-125,-106,-1.5,180,3.82,AT&T Park,10,2
2019-04-27,2019,CIN,STL,3,6,113,1.5,-180,9.0,-115,-105,-123,-1.5,155,4.23,Busch Stadium,9,-3
2019-04-27,2019,BOS,TB,1,2,-130,-1.5,160,9.0,110,-130,120,1.5,-185,5.09,Fenway Park,3,-1
2019-04-27,2019,SEA,TEX,1,15,-103,1.5,-164,8.5,100,-120,-107,-1.5,143,4.31,T-Mobile Park,16,-14
2019-04-27,2019,OAK,TOR,1,7,-105,-1.5,148,9.0,-120,100,-105,1.5,-170,4.61,Rogers Centre,8,-6
2019-04-27,2019,SD,WSH,8,3,152,1.5,-147,8.5,-105,-115,-162,-1.5,127,3.37,Nationals Park,11,5
2019-04-28,2019,CHC,ARI,6,5,-110,-1.5,148,8.5,-125,105,100,1.5,-170,4.45,Chase Field,11,1
2019-04-28,2019,COL,ATL,7,8,155,1.5,-135,9.0,-120,100,-165,-1.5,115,3.53,Suntrust Park,15,-1
2019-04-28,2019,MIN,BAL,4,1,-210,-1.5,-110,9.0,110,-130,190,1.5,-110,6.1,Target Field,5,3
2019-04-28,2019,TB,BOS,5,2,120,1.5,-170,8.0,-110,-110,-130,-1.5,148,3.64,Fenway Park,7,3
2019-04-28,2019,ARI,CHC,5,6,100,1.5,-170,8.5,-125,105,-110,-1.5,148,4.25,Chase Field,11,-1
2019-04-28,2019,STL,CIN,5,2,-140,-1.5,150,7.5,-105,-115,130,1.5,-174,4.38,Busch Stadium,7,3
2019-04-28,2019,HOU,CLE,4,1,-108,1.5,-193,8.5,-115,-105,-102,-1.5,167,4.41,Minute Maid Park,5,3
2019-04-28,2019,ATL,COL,8,7,-165,-1.5,115,9.0,-120,100,155,1.5,-135,5.6,Suntrust Park,15,1
2019-04-28,2019,DET,CWS,1,4,-120,-1.5,140,8.0,-105,-115,110,1.5,-160,4.36,Guaranteed Rate Field,5,-3
2019-04-28,2019,CWS,DET,4,1,110,1.5,-160,8.0,-105,-115,-120,-1.5,140,3.81,Guaranteed Rate Field,5,3
2019-04-28,2019,CLE,HOU,1,4,-102,-1.5,167,8.5,-115,-105,-108,1.5,-193,4.29,Minute Maid Park,5,-3
2019-04-28,2019,LAA,KC,7,3,-110,-1.5,148,9.5,110,-130,100,1.5,-170,4.98,Kauffman Stadium,10,4
2019-04-28,2019,KC,LAA,3,7,100,1.5,-170,9.5,110,-130,-110,-1.5,148,4.75,Kauffman Stadium,10,-4
2019-04-28,2019,PIT,LAD,6,7,170,1.5,-130,8.0,-105,-115,-185,-1.5,110,2.96,Dodger Stadium,13,-1
2019-04-28,2019,PHI,MIA,5,1,-170,-1.5,120,7.5,-110,-110,160,1.5,-140,4.72,Citizens Bank Park,6,4
2019-04-28,2019,NYM,MIL,5,2,-122,-1.5,163,8.0,-115,-105,112,1.5,-190,4.4,Citi Field,7,3
2019-04-28,2019,BAL,MIN,1,4,190,1.5,-110,9.0,110,-130,-210,-1.5,-110,3.1,Target Field,5,-3
2019-04-28,2019,MIL,NYM,2,5,112,1.5,-190,8.0,-115,-105,-122,-1.5,163,3.77,Citi Field,7,-3
2019-04-28,2019,SF,NYY,5,11,115,1.5,-150,7.5,105,-125,-125,-1.5,130,3.49,AT&T Park,16,-6
2019-04-28,2019,TOR,OAK,5,4,115,1.5,-140,9.5,100,-120,-125,-1.5,120,4.42,Rogers Centre,9,1
2019-04-28,2019,MIA,PHI,1,5,160,1.5,-140,7.5,-110,-110,-170,-1.5,120,2.88,Citizens Bank Park,6,-4
2019-04-28,2019,LAD,PIT,7,6,-185,-1.5,110,8.0,-105,-115,170,1.5,-130,5.19,Dodger Stadium,13,1
2019-04-28,2019,WSH,SD,7,6,111,1.5,-149,8.5,-120,100,-121,-1.5,129,4.03,Nationals Park,13,1
2019-04-28,2019,TEX,SEA,14,1,117,1.5,-170,8.5,-120,100,-127,-1.5,148,3.92,T-Mobile Park,15,13
2019-04-28,2019,NYY,SF,11,5,-125,-1.5,130,7.5,105,-125,115,1.5,-150,4.17,AT&T Park,16,6
2019-04-28,2019,CIN,STL,2,5,130,1.5,-174,7.5,-105,-115,-140,-1.5,150,3.26,Busch Stadium,7,-3
2019-04-28,2019,BOS,TB,2,5,-130,-1.5,148,8.0,-110,-110,120,1.5,-170,4.52,Fenway Park,7,-3
2019-04-28,2019,SEA,TEX,1,14,-127,-1.5,148,8.5,-120,100,117,1.5,-170,4.76,T-Mobile Park,15,-13
2019-04-28,2019,OAK,TOR,4,5,-125,-1.5,120,9.5,100,-120,115,1.5,-140,5.28,Rogers Centre,9,-1
2019-04-28,2019,SD,WSH,6,7,-121,-1.5,129,8.5,-120,100,111,1.5,-149,4.65,Nationals Park,13,-1
2019-04-29,2019,SD,ATL,1,3,150,1.5,-145,9.0,-110,-110,-160,-1.5,125,3.6,Suntrust Park,4,-2
2019-04-29,2019,CWS,BAL,5,3,-128,-1.5,155,8.5,-110,-110,118,1.5,-180,4.77,Guaranteed Rate Field,8,2
2019-04-29,2019,OAK,BOS,4,9,124,1.5,-165,9.0,-120,100,-134,-1.5,144,4.02,Fenway Park,13,-5
2019-04-29,2019,NYM,CIN,4,5,-152,-1.5,130,7.5,100,-120,142,1.5,-150,4.52,Citi Field,9,-1
2019-04-29,2019,MIL,COL,5,1,-105,-1.5,166,8.5,-120,100,-105,1.5,-195,4.35,Miller Park,6,4
2019-04-29,2019,BAL,CWS,3,5,118,1.5,-180,8.5,-110,-110,-128,-1.5,155,3.9,Guaranteed Rate Field,8,-2
2019-04-29,2019,MIN,HOU,1,0,155,1.5,-105,8.0,-110,-110,-165,-1.5,-115,3.14,Target Field,1,1
2019-04-29,2019,TB,KC,8,5,-148,-1.5,-109,8.5,-115,-105,138,1.5,-111,5.07,Kauffman Stadium,13,3
2019-04-29,2019,SF,LAD,3,2,140,1.5,-125,8.0,-110,-110,-150,-1.5,105,3.33,AT&T Park,5,1
2019-04-29,2019,COL,MIL,1,5,-105,1.5,-195,8.5,-120,100,-105,-1.5,166,4.35,Miller Park,6,-4
2019-04-29,2019,HOU,MIN,0,1,-165,-1.5,-115,8.0,-110,-110,155,1.5,-105,4.98,Target Field,1,-1
2019-04-29,2019,CIN,NYM,5,4,142,1.5,-150,7.5,100,-120,-152,-1.5,130,3.1,Citi Field,9,1
2019-04-29,2019,BOS,OAK,9,4,-134,-1.5,144,9.0,-120,100,124,1.5,-165,5.15,Fenway Park,13,5
2019-04-29,2019,ATL,SD,3,1,-160,-1.5,125,9.0,-110,-110,150,1.5,-145,5.54,Suntrust Park,4,2
2019-04-29,2019,LAD,SF,2,3,-150,-1.5,105,8.0,-110,-110,140,1.5,-125,4.8,AT&T Park,5,-1
2019-04-29,2019,WSH,STL,3,6,-134,-1.5,148,8.5,-105,-115,124,1.5,-170,4.87,Nationals Park,9,-3
2019-04-29,2019,KC,TB,5,8,138,1.5,-111,8.5,-115,-105,-148,-1.5,-109,3.57,Kauffman Stadium,13,-3
2019-04-29,2019,STL,WSH,6,3,124,1.5,-170,8.5,-105,-115,-134,-1.5,148,3.79,Nationals Park,9,3
2019-04-30,2019,NYY,ARI,1,3,135,1.5,-164,8.5,100,-120,-145,-1.5,143,3.62,Chase Field,4,-2
2019-04-30,2019,SD,ATL,4,3,100,1.5,-220,8.5,-120,100,-110,-1.5,184,4.25,Suntrust Park,7,1
2019-04-30,2019,OAK,BOS,1,5,150,1.5,-125,9.5,-120,100,-160,-1.5,105,3.8,Fenway Park,6,-4
2019-04-30,2019,SEA,CHC,5,6,119,1.5,-125,9.0,-105,-115,-129,-1.5,105,4.11,T-Mobile Park,11,-1
2019-04-30,2019,NYM,CIN,4,3,-104,1.5,-177,7.5,-115,-105,-106,-1.5,154,3.82,Citi Field,7,1
2019-04-30,2019,MIA,CLE,4,7,180,1.5,105,7.0,-120,100,-200,-1.5,-125,2.5,Marlins Park,11,-3
2019-04-30,2019,MIL,COL,4,3,-103,1.5,-163,8.0,-115,-105,-107,-1.5,143,4.06,Miller Park,7,1
2019-04-30,2019,PHI,DET,1,3,-190,-1.5,103,8.5,-105,-115,175,1.5,-124,5.57,Citizens Bank Park,4,-2
2019-04-30,2019,MIN,HOU,0,11,150,1.5,-125,7.5,-120,100,-160,-1.5,105,3.0,Target Field,11,-11
2019-04-30,2019,TOR,LAA,3,4,138,1.5,-155,9.0,-110,-110,-148,-1.5,135,3.78,Angel Stadium,7,-1
2019-04-30,2019,SF,LAD,3,10,135,1.5,-140,7.0,-125,105,-145,-1.5,120,2.98,AT&T Park,13,-7
2019-04-30,2019,CLE,MIA,7,4,-200,-1.5,-125,7.0,-120,100,180,1.5,105,4.67,Marlins Park,11,3
2019-04-30,2019,COL,MIL,3,4,-107,-1.5,143,8.0,-115,-105,-103,1.5,-163,4.14,Miller Park,7,-1
2019-04-30,2019,HOU,MIN,11,0,-160,-1.5,105,7.5,-120,100,150,1.5,-125,4.62,Target Field,11,11
2019-04-30,2019,CIN,NYM,3,4,-106,-1.5,154,7.5,-115,-105,-104,1.5,-177,3.86,Citi Field,7,-1
2019-04-30,2019,ARI,NYY,3,1,-145,-1.5,143,8.5,100,-120,135,1.5,-164,5.03,Chase Field,4,2
2019-04-30,2019,BOS,OAK,5,1,-160,-1.5,105,9.5,-120,100,150,1.5,-125,5.85,Fenway Park,6,4
2019-04-30,2019,DET,PHI,3,1,175,1.5,-124,8.5,-105,-115,-190,-1.5,103,3.09,Citizens Bank Park,4,2
2019-04-30,2019,TEX,PIT,4,6,-110,-1.5,166,11.0,-110,-110,100,1.5,-195,5.76,Rangers Ballpark,10,-2
2019-04-30,2019,ATL,SD,3,4,-110,-1.5,184,8.5,-120,100,100,1.5,-220,4.45,Suntrust Park,7,-1
2019-04-30,2019,CHC,SEA,6,5,-129,-1.5,105,9.0,-105,-115,119,1.5,-125,5.07,T-Mobile Park,11,1
2019-04-30,2019,LAD,SF,10,3,-145,-1.5,120,7.0,-125,105,135,1.5,-140,4.14,AT&T Park,13,7
2019-04-30,2019,WSH,STL,2,3,108,1.5,-145,9.5,-125,105,-118,-1.5,125,4.57,Nationals Park,5,-1
2019-04-30,2019,PIT,TEX,6,4,100,1.5,-195,11.0,-110,-110,-110,-1.5,166,5.5,Rangers Ballpark,10,2
2019-04-30,2019,LAA,TOR,4,3,-148,-1.5,135,9.0,-110,-110,138,1.5,-155,5.37,Angel Stadium,7,1
2019-04-30,2019,STL,WSH,3,2,-118,-1.5,125,9.5,-125,105,108,1.5,-145,5.14,Nationals Park,5,1
2019-05-01,2019,NYY,ARI,2,3,-115,-1.5,144,7.5,-115,-105,105,1.5,-165,4.01,Chase Field,5,-1
2019-05-01,2019,SD,ATL,1,5,130,1.5,-160,9.0,-110,-110,-140,-1.5,140,3.91,Suntrust Park,6,-4
2019-05-01,2019,CWS,BAL,4,5,-180,-1.5,100,9.0,100,-120,165,1.5,-120,5.79,Guaranteed Rate Field,9,-1
2019-05-01,2019,CWS,BAL,7,6,-142,-1.5,140,9.0,100,-120,132,1.5,-160,5.28,Guaranteed Rate Field,13,1
2019-05-01,2019,OAK,BOS,3,7,126,1.5,-150,9.5,-110,-110,-136,-1.5,130,4.2,Fenway Park,10,-4
2019-05-01,2019,SEA,CHC,0,11,-108,1.5,-164,9.0,-110,-110,-102,-1.5,142,4.67,T-Mobile Park,11,-11
2019-05-01,2019,NYM,CIN,0,1,-185,-1.5,115,7.0,100,-120,170,1.5,-135,4.54,Citi Field,1,-1
2019-05-01,2019,MIA,CLE,4,2,110,1.5,-165,6.5,105,-125,-120,-1.5,144,3.1,Marlins Park,6,2
2019-05-01,2019,MIL,COL,4,11,-145,-1.5,172,8.5,-120,100,135,1.5,-205,5.03,Miller Park,15,-7
2019-05-01,2019,BAL,CWS,5,4,165,1.5,-120,9.0,100,-120,-180,-1.5,100,3.4,Guaranteed Rate Field,9,1
2019-05-01,2019,BAL,CWS,6,7,132,1.5,-160,9.0,100,-120,-142,-1.5,140,3.88,Guaranteed Rate Field,13,-1
2019-05-01,2019,PHI,DET,7,3,-240,-1.5,-119,8.0,-105,-115,210,1.5,-101,5.65,Citizens Bank Park,10,4
2019-05-01,2019,MIN,HOU,6,2,137,1.5,-125,9.0,-110,-110,-147,-1.5,105,3.8,Target Field,8,4
2019-05-01,2019,TB,KC,2,3,-135,-1.5,115,8.5,-115,-105,125,1.5,-135,4.88,Kauffman Stadium,5,-1
2019-05-01,2019,TB,KC,2,8,-220,-1.5,-145,8.0,-110,-110,200,1.5,125,5.5,Kauffman Stadium,10,-6
2019-05-01,2019,TOR,LAA,3,6,-101,1.5,-225,8.5,-105,-115,-109,-1.5,188,4.27,Angel Stadium,9,-3
2019-05-01,2019,SF,LAD,2,1,120,1.5,-147,7.0,-105,-115,-130,-1.5,127,3.18,AT&T Park,3,1
2019-05-01,2019,CLE,MIA,2,4,-120,-1.5,144,6.5,105,-125,110,1.5,-165,3.55,Marlins Park,6,-2
2019-05-01,2019,COL,MIL,11,4,135,1.5,-205,8.5,-120,100,-145,-1.5,172,3.62,Miller Park,15,7
2019-05-01,2019,HOU,MIN,2,6,-147,-1.5,105,9.0,-110,-110,137,1.5,-125,5.36,Target Field,8,-4
2019-05-01,2019,CIN,NYM,1,0,170,1.5,-135,7.0,100,-120,-185,-1.5,115,2.59,Citi Field,1,1
2019-05-01,2019,ARI,NYY,3,2,105,1.5,-165,7.5,-115,-105,-115,-1.5,144,3.66,Chase Field,5,1
2019-05-01,2019,BOS,OAK,7,3,-136,-1.5,130,9.5,-110,-110,126,1.5,-150,5.47,Fenway Park,10,4
2019-05-01,2019,DET,PHI,3,7,210,1.5,-101,8.0,-105,-115,-240,-1.5,-119,2.58,Citizens Bank Park,10,-4
2019-05-01,2019,TEX,PIT,5,7,126,1.5,-127,10.5,-120,100,-136,-1.5,107,4.65,Rangers Ballpark,12,-2
2019-05-01,2019,ATL,SD,5,1,-140,-1.5,140,9.0,-110,-110,130,1.5,-160,5.25,Suntrust Park,6,4
2019-05-01,2019,CHC,SEA,11,0,-102,-1.5,142,9.0,-110,-110,-108,1.5,-164,4.54,T-Mobile Park,11,11
2019-05-01,2019,LAD,SF,1,2,-130,-1.5,127,7.0,-105,-115,120,1.5,-147,3.96,AT&T Park,3,-1
2019-05-01,2019,WSH,STL,1,5,-140,-1.5,146,7.5,-115,-105,130,1.5,-167,4.38,Nationals Park,6,-4
2019-05-01,2019,KC,TB,3,2,125,1.5,-135,8.5,-115,-105,-135,-1.5,115,3.78,Kauffman Stadium,5,1
2019-05-01,2019,KC,TB,8,2,200,1.5,125,8.0,-110,-110,-220,-1.5,-145,2.67,Kauffman Stadium,10,6
2019-05-01,2019,PIT,TEX,7,5,-136,-1.5,107,10.5,-120,100,126,1.5,-127,6.05,Rangers Ballpark,12,2
2019-05-01,2019,LAA,TOR,6,3,-109,-1.5,188,8.5,-105,-115,-101,1.5,-225,4.43,Angel Stadium,9,3
2019-05-01,2019,STL,WSH,5,1,130,1.5,-167,7.5,-115,-105,-140,-1.5,146,3.26,Nationals Park,6,4
2019-05-02,2019,SD,ATL,11,2,137,1.5,-150,8.5,-105,-115,-147,-1.5,130,3.59,Suntrust Park,13,9
2019-05-02,2019,CWS,BOS,6,4,164,1.5,110,9.0,100,-120,-178,-1.5,-129,3.41,Guaranteed Rate Field,10,2
2019-05-02,2019,NYM,CIN,1,0,-178,-1.5,110,7.5,-115,-105,164,1.5,-130,4.8,Citi Field,1,1
2019-05-02,2019,MIL,COL,6,11,-116,-1.5,170,8.0,-115,-105,106,1.5,-200,4.3,Miller Park,17,-5
2019-05-02,2019,BOS,CWS,4,6,-178,-1.5,-129,9.0,100,-120,164,1.5,110,5.76,Guaranteed Rate Field,10,-2
2019-05-02,2019,MIN,HOU,8,2,-115,-1.5,163,8.0,-115,-105,105,1.5,-190,4.28,Target Field,10,6
2019-05-02,2019,TB,KC,3,1,-162,-1.5,-115,8.0,-125,105,152,1.5,-105,4.95,Kauffman Stadium,4,2
2019-05-02,2019,TOR,LAA,2,6,152,1.5,-140,8.5,-115,-105,-162,-1.5,120,3.37,Angel Stadium,8,-4
2019-05-02,2019,COL,MIL,11,6,106,1.5,-200,8.0,-115,-105,-116,-1.5,170,3.88,Miller Park,17,5
2019-05-02,2019,HOU,MIN,2,8,105,1.5,-190,8.0,-115,-105,-115,-1.5,163,3.9,Target Field,10,-6
2019-05-02,2019,CIN,NYM,0,1,164,1.5,-130,7.5,-115,-105,-178,-1.5,110,2.84,Citi Field,1,-1
2019-05-02,2019,ATL,SD,2,11,-147,-1.5,130,8.5,-105,-115,137,1.5,-150,5.06,Suntrust Park,13,-9
2019-05-02,2019,WSH,STL,2,1,-150,-1.5,135,8.5,-120,100,140,1.5,-155,5.1,Nationals Park,3,1
2019-05-02,2019,KC,TB,1,3,152,1.5,-105,8.0,-125,105,-162,-1.5,-115,3.17,Kauffman Stadium,4,-2
2019-05-02,2019,LAA,TOR,6,2,-162,-1.5,120,8.5,-115,-105,152,1.5,-140,5.26,Angel Stadium,8,4
2019-05-02,2019,STL,WSH,1,2,140,1.5,-155,8.5,-120,100,-150,-1.5,135,3.54,Nationals Park,3,-1
2019-05-03,2019,COL,ARI,9,10,-105,1.5,-155,11.0,100,-120,-105,-1.5,135,5.63,Coors Field,19,-1
2019-05-03,2019,MIA,ATL,2,7,148,1.5,-119,8.0,-115,-105,-158,-1.5,-101,3.23,Marlins Park,9,-5
2019-05-03,2019,TB,BAL,7,0,-240,-1.5,-142,9.5,-105,-115,210,1.5,123,6.71,Camden Yards,7,7
2019-05-03,2019,CWS,BOS,1,6,161,1.5,-105,8.0,-120,100,-172,-1.5,-115,3.07,Guaranteed Rate Field,7,-5
2019-05-03,2019,STL,CHC,0,4,-108,-1.5,158,7.5,-105,-115,-102,1.5,-183,3.89,Wrigley Field,4,-4
2019-05-03,2019,SF,CIN,12,11,135,1.5,-165,8.0,100,-120,-145,-1.5,144,3.4,Great American Ballpark,23,1
2019-05-03,2019,SEA,CLE,1,2,133,1.5,-165,8.5,-115,-105,-143,-1.5,144,3.65,Progressive Field,3,-1
2019-05-03,2019,ARI,COL,10,9,-105,-1.5,135,11.0,100,-120,-105,1.5,-155,5.63,Coors Field,19,1
2019-05-03,2019,BOS,CWS,6,1,-172,-1.5,-115,8.0,-120,100,161,1.5,-105,5.06,Guaranteed Rate Field,7,5
2019-05-03,2019,KC,DET,3,4,135,1.5,-150,8.0,-110,-110,-145,-1.5,131,3.4,Comerica Park,7,-1
2019-05-03,2019,DET,KC,4,3,-145,-1.5,131,8.0,-110,-110,135,1.5,-150,4.73,Comerica Park,7,1
2019-05-03,2019,SD,LAD,3,4,143,1.5,-135,7.5,100,-120,-153,-1.5,115,3.09,PETCO Park,7,-1
2019-05-03,2019,ATL,MIA,7,2,-158,-1.5,-101,8.0,-115,-105,148,1.5,-119,4.9,Marlins Park,9,5
2019-05-03,2019,NYM,MIL,1,3,115,1.5,-185,8.5,-125,105,-125,-1.5,160,3.95,Miller Park,4,-2
2019-05-03,2019,NYY,MIN,6,3,-150,-1.5,135,7.5,-120,100,140,1.5,-155,4.5,Yankee Stadium,9,3
2019-05-03,2019,MIL,NYM,3,1,-125,-1.5,160,8.5,-125,105,115,1.5,-185,4.72,Miller Park,4,2
2019-05-03,2019,MIN,NYY,3,6,140,1.5,-155,7.5,-120,100,-150,-1.5,135,3.13,Yankee Stadium,9,-3
2019-05-03,2019,PIT,OAK,1,14,-120,-1.5,170,7.5,-115,-105,110,1.5,-200,4.09,PNC Park,15,-13
2019-05-03,2019,WSH,PHI,2,4,163,1.5,-130,9.0,-120,100,-176,-1.5,110,3.42,Citizens Bank Park,6,-2
2019-05-03,2019,OAK,PIT,14,1,110,1.5,-200,7.5,-115,-105,-120,-1.5,170,3.57,PNC Park,15,13
2019-05-03,2019,LAD,SD,4,3,-153,-1.5,115,7.5,100,-120,143,1.5,-135,4.54,PETCO Park,7,1
2019-05-03,2019,CLE,SEA,2,1,-143,-1.5,144,8.5,-115,-105,133,1.5,-165,5.0,Progressive Field,3,1
2019-05-03,2019,CIN,SF,11,12,-145,-1.5,144,8.0,100,-120,135,1.5,-165,4.73,Great American Ballpark,23,-1
2019-05-03,2019,CHC,STL,4,0,-102,1.5,-183,7.5,-105,-115,-108,-1.5,158,3.79,Wrigley Field,4,4
2019-05-03,2019,BAL,TB,0,7,210,1.5,123,9.5,-105,-115,-240,-1.5,-142,3.06,Camden Yards,7,-7
2019-05-03,2019,TOR,TEX,1,0,130,1.5,-151,9.0,-110,-110,-140,-1.5,131,3.91,Rangers Ballpark,1,1
2019-05-03,2019,TEX,TOR,0,1,-140,-1.5,131,9.0,-110,-110,130,1.5,-151,5.25,Rangers Ballpark,1,-1
2019-05-03,2019,PHI,WSH,4,2,-176,-1.5,110,9.0,-120,100,163,1.5,-130,5.74,Citizens Bank Park,6,2
2019-05-04,2019,COL,ARI,2,9,-134,-1.5,135,10.5,-120,100,124,1.5,-155,6.01,Coors Field,11,-7
2019-05-04,2019,MIA,ATL,2,9,146,1.5,-110,7.5,-105,-115,-156,-1.5,-110,3.05,Marlins Park,11,-7
2019-05-04,2019,TB,BAL,0,3,-170,-1.5,-115,9.0,-115,-105,160,1.5,-105,5.67,Camden Yards,3,-3
2019-05-04,2019,CWS,BOS,2,15,159,1.5,-110,9.0,105,-125,-169,-1.5,-110,3.47,Guaranteed Rate Field,17,-13
2019-05-04,2019,STL,CHC,5,6,107,1.5,-185,8.5,-105,-115,-117,-1.5,160,4.11,Wrigley Field,11,-1
2019-05-04,2019,SF,CIN,2,9,114,1.5,-185,8.5,-125,105,-124,-1.5,160,3.97,Great American Ballpark,11,-7
2019-05-04,2019,SEA,CLE,4,5,176,1.5,-120,8.5,-110,-110,-192,-1.5,100,3.08,Progressive Field,9,-1
2019-05-04,2019,ARI,COL,9,2,124,1.5,-155,10.5,-120,100,-134,-1.5,135,4.69,Coors Field,11,7
2019-05-04,2019,BOS,CWS,15,2,-169,-1.5,-110,9.0,105,-125,159,1.5,-110,5.65,Guaranteed Rate Field,17,13
2019-05-04,2019,KC,DET,15,3,-103,1.5,-205,9.0,-105,-115,-107,-1.5,172,4.57,Comerica Park,18,12
2019-05-04,2019,LAA,HOU,2,14,126,1.5,-130,10.5,-120,100,-136,-1.5,110,4.65,Estadio Monterrey,16,-12
2019-05-04,2019,DET,KC,3,15,-107,-1.5,172,9.0,-105,-115,-103,1.5,-205,4.65,Comerica Park,18,-12
2019-05-04,2019,HOU,LAA,14,2,-136,-1.5,110,10.5,-120,100,126,1.5,-130,6.05,Estadio Monterrey,16,12
2019-05-04,2019,SD,LAD,6,7,-110,1.5,-180,7.5,-120,100,100,-1.5,155,3.93,PETCO Park,13,-1
2019-05-04,2019,ATL,MIA,9,2,-156,-1.5,-110,7.5,-105,-115,146,1.5,-110,4.57,Marlins Park,11,7
2019-05-04,2019,NYM,MIL,3,4,104,1.5,-210,9.0,-105,-115,-114,-1.5,176,4.41,Miller Park,7,-1
2019-05-04,2019,NYY,MIN,3,7,-117,-1.5,160,9.0,-115,-105,107,1.5,-185,4.85,Yankee Stadium,10,-4
2019-05-04,2019,MIL,NYM,4,3,-114,-1.5,176,9.0,-105,-115,104,1.5,-210,4.79,Miller Park,7,1
2019-05-04,2019,MIN,NYY,7,3,107,1.5,-185,9.0,-115,-105,-117,-1.5,160,4.35,Yankee Stadium,10,4
2019-05-04,2019,PIT,OAK,6,4,-105,1.5,-191,7.5,-120,100,-105,-1.5,165,3.84,PNC Park,10,2
2019-05-04,2019,WSH,PHI,10,8,100,1.5,-210,8.0,-120,100,-110,-1.5,176,4.0,Citizens Bank Park,18,2
2019-05-04,2019,OAK,PIT,4,6,-105,-1.5,165,7.5,-120,100,-105,1.5,-191,3.84,PNC Park,10,-2
2019-05-04,2019,LAD,SD,7,6,100,-1.5,155,7.5,-120,100,-110,1.5,-180,3.75,PETCO Park,13,1
2019-05-04,2019,CLE,SEA,5,4,-192,-1.5,100,8.5,-110,-110,176,1.5,-120,5.59,Progressive Field,9,1
2019-05-04,2019,CIN,SF,9,2,-124,-1.5,160,8.5,-125,105,114,1.5,-185,4.71,Great American Ballpark,11,7
2019-05-04,2019,CHC,STL,6,5,-117,-1.5,160,8.5,-105,-115,107,1.5,-185,4.58,Wrigley Field,11,1
2019-05-04,2019,BAL,TB,3,0,160,1.5,-105,9.0,-115,-105,-170,-1.5,-115,3.46,Camden Yards,3,3
2019-05-04,2019,TOR,TEX,5,8,110,1.5,-170,10.0,-110,-110,-120,-1.5,148,4.76,Rangers Ballpark,13,-3
2019-05-04,2019,TEX,TOR,8,5,-120,-1.5,148,10.0,-110,-110,110,1.5,-170,5.45,Rangers Ballpark,13,3
2019-05-04,2019,PHI,WSH,8,10,-110,-1.5,176,8.0,-120,100,100,1.5,-210,4.19,Citizens Bank Park,18,-2
2019-05-05,2019,COL,ARI,8,7,-139,-1.5,144,9.5,-110,-110,129,1.5,-165,5.53,Coors Field,15,1
2019-05-05,2019,MIA,ATL,1,3,106,1.5,-162,7.5,100,-120,-116,-1.5,142,3.64,Marlins Park,4,-2
2019-05-05,2019,CWS,BOS,2,9,130,1.5,-135,9.5,-105,-115,-140,-1.5,115,4.13,Guaranteed Rate Field,11,-7
2019-05-05,2019,STL,CHC,5,13,113,1.5,-148,10.0,-110,-110,-123,-1.5,128,4.69,Wrigley Field,18,-8
2019-05-05,2019,SF,CIN,6,5,163,1.5,-130,8.0,-110,-110,-176,-1.5,110,3.04,Great American Ballpark,11,1
2019-05-05,2019,SEA,CLE,10,0,132,1.5,-170,9.0,-125,105,-142,-1.5,148,3.88,Progressive Field,10,10
2019-05-05,2019,ARI,COL,7,8,129,1.5,-165,9.5,-110,-110,-139,-1.5,144,4.15,Coors Field,15,-1
2019-05-05,2019,BOS,CWS,9,2,-140,-1.5,115,9.5,-105,-115,130,1.5,-135,5.54,Guaranteed Rate Field,11,7
2019-05-05,2019,KC,DET,2,5,108,1.5,-195,8.5,-115,-105,-118,-1.5,166,4.09,Comerica Park,7,-3
2019-05-05,2019,LAA,HOU,4,10,195,1.5,134,10.0,-115,-105,-215,-1.5,-154,3.39,Estadio Monterrey,14,-6
2019-05-05,2019,DET,KC,5,2,-118,-1.5,166,8.5,-115,-105,108,1.5,-195,4.6,Comerica Park,7,3
2019-05-05,2019,HOU,LAA,10,4,-215,-1.5,-154,10.0,-115,-105,195,1.5,134,6.83,Estadio Monterrey,14,6
2019-05-05,2019,SD,LAD,8,5,113,1.5,-159,8.0,-120,100,-123,-1.5,139,3.76,PETCO Park,13,3
2019-05-05,2019,ATL,MIA,3,1,-116,-1.5,142,7.5,100,-120,106,1.5,-162,4.03,Marlins Park,4,2
2019-05-05,2019,NYM,MIL,2,3,160,1.5,-126,9.0,-120,100,-170,-1.5,106,3.46,Miller Park,5,-1
2019-05-05,2019,NYY,MIN,4,1,-139,-1.5,143,8.5,-110,-110,129,1.5,-163,4.94,Yankee Stadium,5,3
2019-05-05,2019,MIL,NYM,3,2,-170,-1.5,106,9.0,-120,100,160,1.5,-126,5.67,Miller Park,5,1
2019-05-05,2019,MIN,NYY,1,4,129,1.5,-163,8.5,-110,-110,-139,-1.5,143,3.71,Yankee Stadium,5,-3
2019-05-05,2019,PIT,OAK,5,3,102,1.5,-170,8.0,100,-120,-112,-1.5,148,3.96,PNC Park,8,2
2019-05-05,2019,WSH,PHI,1,7,160,1.5,-140,8.5,105,-125,-170,-1.5,120,3.27,Citizens Bank Park,8,-6
2019-05-05,2019,OAK,PIT,3,5,-112,-1.5,148,8.0,100,-120,102,1.5,-170,4.23,PNC Park,8,-2
2019-05-05,2019,LAD,SD,5,8,-123,-1.5,139,8.0,-120,100,113,1.5,-159,4.41,PETCO Park,13,-3
2019-05-05,2019,CLE,SEA,0,10,-142,-1.5,148,9.0,-125,105,132,1.5,-170,5.28,Progressive Field,10,-10
2019-05-05,2019,CIN,SF,5,6,-176,-1.5,110,8.0,-110,-110,163,1.5,-130,5.1,Great American Ballpark,11,-1
2019-05-05,2019,CHC,STL,13,5,-123,-1.5,128,10.0,-110,-110,113,1.5,-148,5.52,Wrigley Field,18,8
2019-05-05,2019,TOR,TEX,2,10,124,1.5,-166,10.5,-110,-110,-134,-1.5,145,4.69,Rangers Ballpark,12,-8
2019-05-05,2019,TEX,TOR,10,2,-134,-1.5,145,10.5,-110,-110,124,1.5,-166,6.01,Rangers Ballpark,12,8
2019-05-05,2019,PHI,WSH,7,1,-170,-1.5,120,8.5,105,-125,160,1.5,-140,5.35,Citizens Bank Park,8,6
2019-05-06,2019,TB,ARI,12,1,-210,-1.5,-109,7.5,-120,100,190,1.5,-111,5.08,Tropicana Field,13,11
2019-05-06,2019,LAD,ATL,5,3,-155,-1.5,130,8.0,-120,100,145,1.5,-150,4.86,Dodger Stadium,8,2
2019-05-06,2019,BOS,BAL,1,4,-163,-1.5,-119,9.5,-110,-110,153,1.5,-101,5.89,Camden Yards,5,-3
2019-05-06,2019,BAL,BOS,4,1,153,1.5,-101,9.5,-110,-110,-163,-1.5,-119,3.75,Camden Yards,5,3
2019-05-06,2019,MIA,CHC,6,5,240,1.5,110,7.0,-120,100,-270,-1.5,-130,2.06,Wrigley Field,11,1
2019-05-06,2019,SF,CIN,4,12,125,1.5,-170,8.0,-120,100,-135,-1.5,148,3.56,Great American Ballpark,16,-8
2019-05-06,2019,CWS,CLE,9,1,220,1.5,115,9.0,105,-125,-250,-1.5,-135,2.81,Progressive Field,10,8
2019-05-06,2019,CLE,CWS,1,9,-250,-1.5,-135,9.0,105,-125,220,1.5,115,6.43,Progressive Field,10,-8
2019-05-06,2019,KC,HOU,4,6,250,1.5,124,8.0,-125,105,-290,-1.5,-144,2.29,Minute Maid Park,10,-2
2019-05-06,2019,HOU,KC,6,4,-290,-1.5,-144,8.0,-125,105,250,1.5,124,5.95,Minute Maid Park,10,2
2019-05-06,2019,ATL,LAD,3,5,145,1.5,-150,8.0,-120,100,-155,-1.5,130,3.27,Dodger Stadium,8,-2
2019-05-06,2019,CHC,MIA,5,6,-270,-1.5,-130,7.0,-120,100,240,1.5,110,5.11,Wrigley Field,11,-1
2019-05-06,2019,WSH,MIL,3,5,100,-1.5,155,7.5,-120,100,-110,1.5,-180,3.75,Miller Park,8,-2
2019-05-06,2019,TOR,MIN,0,8,-115,-1.5,176,8.5,-125,105,105,1.5,-210,4.55,Rogers Centre,8,-8
2019-05-06,2019,SD,NYM,4,0,105,1.5,-180,6.5,100,-120,-115,-1.5,155,3.17,PETCO Park,4,4
2019-05-06,2019,SEA,NYY,3,7,128,1.5,-160,9.0,-115,-105,-138,-1.5,140,3.95,Yankee Stadium,10,-4
2019-05-06,2019,STL,PHI,6,0,-125,-1.5,148,9.0,100,-120,115,1.5,-170,5.0,Busch Stadium,6,6
2019-05-06,2019,NYM,SD,0,4,-115,-1.5,155,6.5,100,-120,105,1.5,-180,3.48,PETCO Park,4,-4
2019-05-06,2019,NYY,SEA,7,3,-138,-1.5,140,9.0,-115,-105,128,1.5,-160,5.22,Yankee Stadium,10,4
2019-05-06,2019,CIN,SF,12,4,-135,-1.5,148,8.0,-120,100,125,1.5,-170,4.6,Great American Ballpark,16,8
2019-05-06,2019,PHI,STL,0,6,115,1.5,-170,9.0,100,-120,-125,-1.5,148,4.19,Busch Stadium,6,-6
2019-05-06,2019,ARI,TB,1,12,190,1.5,-111,7.5,-120,100,-210,-1.5,-109,2.59,Tropicana Field,13,-11
2019-05-06,2019,MIN,TOR,8,0,105,1.5,-210,8.5,-125,105,-115,-1.5,176,4.15,Rogers Centre,8,8
2019-05-06,2019,MIL,WSH,5,3,-110,1.5,-180,7.5,-120,100,100,-1.5,155,3.93,Miller Park,8,2
2019-05-07,2019,TB,ARI,6,3,-172,-1.5,105,8.5,-120,100,161,1.5,-125,5.38,Tropicana Field,9,3
2019-05-07,2019,LAD,ATL,9,0,-132,-1.5,144,7.5,-120,100,122,1.5,-165,4.27,Dodger Stadium,9,9
2019-05-07,2019,BOS,BAL,8,5,-205,-1.5,-145,10.0,-110,-110,185,1.5,125,6.72,Camden Yards,13,3
2019-05-07,2019,BAL,BOS,5,8,185,1.5,125,10.0,-110,-110,-205,-1.5,-145,3.51,Camden Yards,13,-3
2019-05-07,2019,MIA,CHC,2,5,155,1.5,-147,6.5,-125,105,-165,-1.5,126,2.55,Wrigley Field,7,-3
2019-05-07,2019,OAK,CIN,2,0,-122,-1.5,155,9.0,-110,-110,112,1.5,-180,4.95,Oakland Coliseum,2,2
2019-05-07,2019,CWS,CLE,2,0,127,1.5,-165,8.5,-120,100,-137,-1.5,144,3.74,Progressive Field,2,2
2019-05-07,2019,SF,COL,14,4,114,1.5,-165,10.0,-120,100,-124,-1.5,144,4.67,Coors Field,18,10
2019-05-07,2019,CLE,CWS,0,2,-137,-1.5,144,8.5,-120,100,127,1.5,-165,4.91,Progressive Field,2,-2
2019-05-07,2019,LAA,DET,5,2,-137,-1.5,115,9.0,105,-125,127,1.5,-135,5.2,Comerica Park,7,3
2019-05-07,2019,KC,HOU,12,2,210,1.5,100,9.0,-120,100,-240,-1.5,-118,2.9,Minute Maid Park,14,10
2019-05-07,2019,HOU,KC,2,12,-240,-1.5,-118,9.0,-120,100,210,1.5,100,6.35,Minute Maid Park,14,-10
2019-05-07,2019,DET,LAA,2,5,127,1.5,-135,9.0,105,-125,-137,-1.5,115,3.96,Comerica Park,7,-3
2019-05-07,2019,ATL,LAD,0,9,122,1.5,-165,7.5,-120,100,-132,-1.5,144,3.38,Dodger Stadium,9,-9
2019-05-07,2019,CHC,MIA,5,2,-165,-1.5,126,6.5,-125,105,155,1.5,-147,4.05,Wrigley Field,7,3
2019-05-07,2019,WSH,MIL,0,6,102,1.5,-200,8.0,-115,-105,-112,-1.5,170,3.96,Miller Park,6,-6
2019-05-07,2019,TOR,MIN,0,3,130,1.5,-135,9.0,100,-120,-140,-1.5,115,3.91,Rogers Centre,3,-3
2019-05-07,2019,SD,NYM,6,7,140,1.5,-135,7.5,100,-120,-150,-1.5,115,3.13,PETCO Park,13,-1
2019-05-07,2019,SEA,NYY,4,5,142,1.5,-140,9.5,-105,-115,-152,-1.5,120,3.93,Yankee Stadium,9,-1
2019-05-07,2019,CIN,OAK,0,2,112,1.5,-180,9.0,-110,-110,-122,-1.5,155,4.25,Oakland Coliseum,2,-2
2019-05-07,2019,STL,PHI,1,11,105,1.5,-160,9.0,-115,-105,-115,-1.5,140,4.39,Busch Stadium,12,-10
2019-05-07,2019,TEX,PIT,4,5,132,1.5,-160,8.5,-110,-110,-142,-1.5,140,3.66,PNC Park,9,-1
2019-05-07,2019,NYM,SD,7,6,-150,-1.5,115,7.5,100,-120,140,1.5,-135,4.5,PETCO Park,13,1
2019-05-07,2019,NYY,SEA,5,4,-152,-1.5,120,9.5,-105,-115,142,1.5,-140,5.73,Yankee Stadium,9,1
2019-05-07,2019,COL,SF,4,14,-124,-1.5,144,10.0,-120,100,114,1.5,-165,5.54,Coors Field,18,-10
2019-05-07,2019,PHI,STL,11,1,-115,-1.5,140,9.0,-115,-105,105,1.5,-160,4.81,Busch Stadium,12,10
2019-05-07,2019,ARI,TB,3,6,161,1.5,-125,8.5,-120,100,-172,-1.5,105,3.26,Tropicana Field,9,-3
2019-05-07,2019,PIT,TEX,5,4,-142,-1.5,140,8.5,-110,-110,132,1.5,-160,4.99,PNC Park,9,1
2019-05-07,2019,MIN,TOR,3,0,-140,-1.5,115,9.0,100,-120,130,1.5,-135,5.25,Rogers Centre,3,3
2019-05-07,2019,MIL,WSH,6,0,-112,-1.5,170,8.0,-115,-105,102,1.5,-200,4.23,Miller Park,6,6
2019-05-08,2019,TB,ARI,2,3,-155,-1.5,141,7.5,100,-120,145,1.5,-161,4.56,Tropicana Field,5,-1
2019-05-08,2019,LAD,ATL,9,4,-210,-1.5,-115,8.0,-105,-115,190,1.5,-105,5.42,Dodger Stadium,13,5
2019-05-08,2019,BOS,BAL,2,1,-280,-1.5,-165,8.5,-125,105,245,1.5,144,6.26,Camden Yards,3,1
2019-05-08,2019,BAL,BOS,1,2,245,1.5,144,8.5,-125,105,-280,-1.5,-165,2.46,Camden Yards,3,-1
2019-05-08,2019,MIA,CHC,2,3,205,1.5,-104,8.0,-125,105,-230,-1.5,-116,2.62,Wrigley Field,5,-1
2019-05-08,2019,OAK,CIN,5,4,-122,-1.5,160,8.5,-105,-115,112,1.5,-185,4.67,Oakland Coliseum,9,1
2019-05-08,2019,CWS,CLE,3,5,180,1.5,-120,8.5,-110,-110,-200,-1.5,100,3.04,Progressive Field,8,-2
2019-05-08,2019,CLE,CWS,5,3,-200,-1.5,100,8.5,-110,-110,180,1.5,-120,5.67,Progressive Field,8,2
2019-05-08,2019,LAA,DET,3,10,100,1.5,-195,8.0,-115,-105,-110,-1.5,166,4.0,Comerica Park,13,-7
2019-05-08,2019,KC,HOU,0,9,205,1.5,101,9.0,-120,100,-230,-1.5,-120,2.95,Minute Maid Park,9,-9
2019-05-08,2019,HOU,KC,9,0,-230,-1.5,-120,9.0,-120,100,205,1.5,101,6.27,Minute Maid Park,9,9
2019-05-08,2019,DET,LAA,10,3,-110,-1.5,166,8.0,-115,-105,100,1.5,-195,4.19,Comerica Park,13,7
2019-05-08,2019,ATL,LAD,4,9,190,1.5,-105,8.0,-105,-115,-210,-1.5,-115,2.76,Dodger Stadium,13,-5
2019-05-08,2019,CHC,MIA,3,2,-230,-1.5,-116,8.0,-125,105,205,1.5,-104,5.58,Wrigley Field,5,1
2019-05-08,2019,WSH,MIL,3,7,175,1.5,-120,8.5,-115,-105,-190,-1.5,100,3.09,Miller Park,10,-4
2019-05-08,2019,TOR,MIN,1,9,123,1.5,-145,9.0,100,-120,-133,-1.5,125,4.04,Rogers Centre,10,-8
2019-05-08,2019,SD,NYM,3,2,-130,-1.5,160,8.0,-105,-115,120,1.5,-185,4.52,PETCO Park,5,1
2019-05-08,2019,SEA,NYY,10,1,105,1.5,-181,9.0,-125,105,-115,-1.5,156,4.39,Yankee Stadium,11,9
2019-05-08,2019,CIN,OAK,4,5,112,1.5,-185,8.5,-105,-115,-122,-1.5,160,4.01,Oakland Coliseum,9,-1
2019-05-08,2019,STL,PHI,0,5,-148,-1.5,135,9.0,100,-120,138,1.5,-155,5.37,Busch Stadium,5,-5
2019-05-08,2019,TEX,PIT,9,6,111,1.5,-185,9.0,-120,100,-121,-1.5,160,4.27,PNC Park,15,3
2019-05-08,2019,NYM,SD,2,3,120,1.5,-185,8.0,-105,-115,-130,-1.5,160,3.64,PETCO Park,5,-1
2019-05-08,2019,NYY,SEA,1,10,-115,-1.5,156,9.0,-125,105,105,1.5,-181,4.81,Yankee Stadium,11,-9
2019-05-08,2019,PHI,STL,5,0,138,1.5,-155,9.0,100,-120,-148,-1.5,135,3.78,Busch Stadium,5,5
2019-05-08,2019,ARI,TB,3,2,145,1.5,-161,7.5,100,-120,-155,-1.5,141,3.06,Tropicana Field,5,1
2019-05-08,2019,PIT,TEX,6,9,-121,-1.5,160,9.0,-120,100,111,1.5,-185,4.93,PNC Park,15,-3
2019-05-08,2019,MIN,TOR,9,1,-133,-1.5,125,9.0,100,-120,123,1.5,-145,5.14,Rogers Centre,10,8
2019-05-08,2019,MIL,WSH,7,3,-190,-1.5,100,8.5,-115,-105,175,1.5,-120,5.57,Miller Park,10,4
2019-05-09,2019,ATL,ARI,2,3,-110,-1.5,148,8.5,-125,105,100,1.5,-170,4.45,Chase Field,5,-1
2019-05-09,2019,ARI,ATL,3,2,100,1.5,-170,8.5,-125,105,-110,-1.5,148,4.25,Chase Field,5,1
2019-05-09,2019,MIA,CHC,1,4,190,1.5,-110,10.0,100,-120,-210,-1.5,-110,3.45,Wrigley Field,5,-3
2019-05-09,2019,OAK,CIN,0,3,-166,-1.5,120,8.5,100,-120,156,1.5,-140,5.3,Oakland Coliseum,3,-3
2019-05-09,2019,CWS,CLE,0,5,210,1.5,-113,9.0,-115,-105,-240,-1.5,-107,2.9,Progressive Field,5,-5
2019-05-09,2019,SF,COL,11,12,148,1.5,-135,9.5,-110,-110,-158,-1.5,115,3.83,Coors Field,23,-1
2019-05-09,2019,CLE,CWS,5,0,-240,-1.5,-107,9.0,-115,-105,210,1.5,-113,6.35,Progressive Field,5,5
2019-05-09,2019,LAA,DET,13,0,-174,-1.5,-121,9.5,-120,100,162,1.5,101,6.03,Comerica Park,13,13
2019-05-09,2019,TEX,HOU,2,4,167,1.5,-115,9.0,100,-120,-182,-1.5,-105,3.37,Minute Maid Park,6,-2
2019-05-09,2019,DET,LAA,0,13,162,1.5,101,9.5,-120,100,-174,-1.5,-121,3.63,Comerica Park,13,-13
2019-05-09,2019,WSH,LAD,6,0,140,1.5,-155,7.0,-120,100,-150,-1.5,135,2.92,Dodger Stadium,6,6
2019-05-09,2019,CHC,MIA,4,1,-210,-1.5,-110,10.0,100,-120,190,1.5,-110,6.77,Wrigley Field,5,3
2019-05-09,2019,SEA,NYY,1,3,130,1.5,-165,9.0,-115,-105,-140,-1.5,144,3.91,Yankee Stadium,4,-2
2019-05-09,2019,CIN,OAK,3,0,156,1.5,-140,8.5,100,-120,-166,-1.5,120,3.32,Oakland Coliseum,3,3
2019-05-09,2019,STL,PIT,17,4,-145,-1.5,140,8.5,-110,-110,135,1.5,-160,5.03,Busch Stadium,21,13
2019-05-09,2019,NYY,SEA,3,1,-140,-1.5,144,9.0,-115,-105,130,1.5,-165,5.25,Yankee Stadium,4,2
2019-05-09,2019,COL,SF,12,11,-158,-1.5,115,9.5,-110,-110,148,1.5,-135,5.82,Coors Field,23,1
2019-05-09,2019,PIT,STL,4,17,135,1.5,-160,8.5,-110,-110,-145,-1.5,140,3.62,Busch Stadium,21,-13
2019-05-09,2019,HOU,TEX,4,2,-182,-1.5,-105,9.0,100,-120,167,1.5,-115,5.81,Minute Maid Park,6,2
2019-05-09,2019,LAD,WSH,0,6,-150,-1.5,135,7.0,-120,100,140,1.5,-155,4.2,Dodger Stadium,6,-6
2019-05-10,2019,ATL,ARI,2,1,120,1.5,-180,8.5,-115,-105,-130,-1.5,155,3.86,Chase Field,3,1
2019-05-10,2019,ARI,ATL,1,2,-130,-1.5,155,8.5,-115,-105,120,1.5,-180,4.8,Chase Field,3,-1
2019-05-10,2019,LAA,BAL,8,3,-185,-1.5,-125,11.0,-105,-115,170,1.5,105,7.14,Camden Yards,11,5
2019-05-10,2019,SEA,BOS,1,14,185,1.5,-115,10.5,100,-120,-205,-1.5,-105,3.68,Fenway Park,15,-13
2019-05-10,2019,MIL,CHC,7,0,106,1.5,-206,7.5,-115,-105,-116,-1.5,173,3.64,Wrigley Field,7,7
2019-05-10,2019,SF,CIN,0,7,140,1.5,-138,7.5,100,-120,-150,-1.5,117,3.13,AT&T Park,7,-7
2019-05-10,2019,OAK,CLE,4,3,-138,-1.5,140,8.5,-115,-105,128,1.5,-160,4.93,Oakland Coliseum,7,1
2019-05-10,2019,SD,COL,2,12,161,1.5,-126,10.0,-110,-110,-172,-1.5,106,3.83,Coors Field,14,-10
2019-05-10,2019,TOR,CWS,4,3,-126,-1.5,151,9.0,-110,-110,116,1.5,-175,5.02,Rogers Centre,7,1
2019-05-10,2019,MIN,DET,6,0,-210,-1.5,-127,9.0,-105,-115,190,1.5,106,6.1,Target Field,6,6
2019-05-10,2019,TEX,HOU,0,3,230,1.5,115,8.5,-110,-110,-260,-1.5,-135,2.58,Minute Maid Park,3,-3
2019-05-10,2019,PHI,KC,1,5,-143,-1.5,117,9.0,-115,-105,133,1.5,-137,5.3,Kauffman Stadium,6,-4
2019-05-10,2019,BAL,LAA,3,8,170,1.5,105,11.0,-105,-115,-185,-1.5,-125,4.07,Camden Yards,11,-5
2019-05-10,2019,WSH,LAD,0,5,200,1.5,-117,8.5,-115,-105,-220,-1.5,-103,2.83,Dodger Stadium,5,-5
2019-05-10,2019,NYM,MIA,11,2,-176,-1.5,135,7.5,100,-120,163,1.5,-155,4.78,Citi Field,13,9
2019-05-10,2019,CHC,MIL,0,7,-116,-1.5,173,7.5,-115,-105,106,1.5,-206,4.03,Wrigley Field,7,-7
2019-05-10,2019,DET,MIN,0,6,190,1.5,106,9.0,-105,-115,-210,-1.5,-127,3.1,Target Field,6,-6
2019-05-10,2019,MIA,NYM,2,11,163,1.5,-155,7.5,100,-120,-176,-1.5,135,2.85,Citi Field,13,-9
2019-05-10,2019,TB,NYY,3,4,-166,-1.5,125,7.0,-120,100,156,1.5,-145,4.37,Tropicana Field,7,-1
2019-05-10,2019,CLE,OAK,3,4,128,1.5,-160,8.5,-115,-105,-138,-1.5,140,3.73,Oakland Coliseum,7,-1
2019-05-10,2019,KC,PHI,5,1,133,1.5,-137,9.0,-115,-105,-143,-1.5,117,3.86,Kauffman Stadium,6,4
2019-05-10,2019,STL,PIT,1,2,-160,-1.5,115,8.5,-115,-105,150,1.5,-135,5.23,Busch Stadium,3,-1
2019-05-10,2019,COL,SD,12,2,-172,-1.5,106,10.0,-110,-110,161,1.5,-126,6.32,Coors Field,14,10
2019-05-10,2019,BOS,SEA,14,1,-205,-1.5,-105,10.5,100,-120,185,1.5,-115,7.06,Fenway Park,15,13
2019-05-10,2019,CIN,SF,7,0,-150,-1.5,117,7.5,100,-120,140,1.5,-138,4.5,AT&T Park,7,7
2019-05-10,2019,PIT,STL,2,1,150,1.5,-135,8.5,-115,-105,-160,-1.5,115,3.4,Busch Stadium,3,1
2019-05-10,2019,NYY,TB,4,3,156,1.5,-145,7.0,-120,100,-166,-1.5,125,2.73,Tropicana Field,7,1
2019-05-10,2019,HOU,TEX,3,0,-260,-1.5,-135,8.5,-110,-110,230,1.5,115,6.14,Minute Maid Park,3,3
2019-05-10,2019,CWS,TOR,3,4,116,1.5,-175,9.0,-110,-110,-126,-1.5,151,4.17,Rogers Centre,7,-1
2019-05-10,2019,LAD,WSH,5,0,-220,-1.5,-103,8.5,-115,-105,200,1.5,-117,5.84,Dodger Stadium,5,5
2019-05-11,2019,ATL,ARI,6,4,-125,-1.5,123,9.0,-120,100,115,1.5,-143,5.0,Chase Field,10,2
2019-05-11,2019,ARI,ATL,4,6,115,1.5,-143,9.0,-120,100,-125,-1.5,123,4.19,Chase Field,10,-2
2019-05-11,2019,LAA,BAL,7,2,-134,-1.5,120,9.5,-120,100,124,1.5,-140,5.44,Camden Yards,9,5
2019-05-11,2019,SEA,BOS,5,9,161,1.5,-110,11.5,-105,-115,-172,-1.5,-110,4.41,Fenway Park,14,-4
2019-05-11,2019,MIL,CHC,1,2,112,1.5,-204,7.5,-115,-105,-122,-1.5,171,3.54,Wrigley Field,3,-1
2019-05-11,2019,SF,CIN,4,5,125,1.5,-147,7.5,100,-120,-135,-1.5,127,3.33,AT&T Park,9,-1
2019-05-11,2019,OAK,CLE,3,2,108,1.5,-156,8.0,-115,-105,-118,-1.5,136,3.85,Oakland Coliseum,5,1
2019-05-11,2019,SD,COL,4,3,125,1.5,-145,10.0,-120,100,-135,-1.5,125,4.44,Coors Field,7,1
2019-05-11,2019,TOR,CWS,2,7,-156,-1.5,125,8.5,-120,100,146,1.5,-145,5.18,Rogers Centre,9,-5
2019-05-11,2019,MIN,DET,3,5,-158,-1.5,115,8.5,-120,100,148,1.5,-135,5.21,Target Field,8,-2
2019-05-11,2019,MIN,DET,8,3,-210,-1.5,-115,9.5,-115,-105,190,1.5,-105,6.44,Target Field,11,5
2019-05-11,2019,TEX,HOU,4,11,250,1.5,135,9.0,-105,-115,-290,-1.5,-155,2.57,Minute Maid Park,15,-7
2019-05-11,2019,PHI,KC,7,0,-130,-1.5,119,9.0,-120,100,120,1.5,-139,5.09,Kauffman Stadium,7,7
2019-05-11,2019,BAL,LAA,2,7,124,1.5,-140,9.5,-120,100,-134,-1.5,120,4.24,Camden Yards,9,-5
2019-05-11,2019,WSH,LAD,5,2,125,1.5,-190,7.0,-105,-115,-135,-1.5,163,3.11,Dodger Stadium,7,3
2019-05-11,2019,NYM,MIA,4,1,-310,-1.5,-145,7.0,-110,-110,270,1.5,125,5.29,Citi Field,5,3
2019-05-11,2019,CHC,MIL,2,1,-122,-1.5,171,7.5,-115,-105,112,1.5,-204,4.12,Wrigley Field,3,1
2019-05-11,2019,DET,MIN,5,3,148,1.5,-135,8.5,-120,100,-158,-1.5,115,3.43,Target Field,8,2
2019-05-11,2019,DET,MIN,3,8,190,1.5,-105,9.5,-115,-105,-210,-1.5,-115,3.28,Target Field,11,-5
2019-05-11,2019,MIA,NYM,1,4,270,1.5,125,7.0,-110,-110,-310,-1.5,-145,1.89,Citi Field,5,-3
2019-05-11,2019,TB,NYY,7,2,-135,-1.5,144,8.5,-105,-115,125,1.5,-165,4.88,Tropicana Field,9,5
2019-05-11,2019,CLE,OAK,2,3,-118,-1.5,136,8.0,-115,-105,108,1.5,-156,4.33,Oakland Coliseum,5,-1
2019-05-11,2019,KC,PHI,0,7,120,1.5,-139,9.0,-120,100,-130,-1.5,119,4.09,Kauffman Stadium,7,-7
2019-05-11,2019,STL,PIT,1,2,-180,-1.5,-105,7.5,-115,-105,165,1.5,-115,4.82,Busch Stadium,3,-1
2019-05-11,2019,COL,SD,3,4,-135,-1.5,125,10.0,-120,100,125,1.5,-145,5.74,Coors Field,7,-1
2019-05-11,2019,BOS,SEA,9,5,-172,-1.5,-110,11.5,-105,-115,161,1.5,-110,7.27,Fenway Park,14,4
2019-05-11,2019,CIN,SF,5,4,-135,-1.5,127,7.5,100,-120,125,1.5,-147,4.31,AT&T Park,9,1
2019-05-11,2019,PIT,STL,2,1,165,1.5,-115,7.5,-115,-105,-180,-1.5,-105,2.83,Busch Stadium,3,1
2019-05-11,2019,NYY,TB,2,7,125,1.5,-165,8.5,-105,-115,-135,-1.5,144,3.78,Tropicana Field,9,-5
2019-05-11,2019,HOU,TEX,11,4,-290,-1.5,-155,9.0,-105,-115,250,1.5,135,6.69,Minute Maid Park,15,7
2019-05-11,2019,CWS,TOR,7,2,146,1.5,-145,8.5,-120,100,-156,-1.5,125,3.46,Rogers Centre,9,5
2019-05-11,2019,LAD,WSH,2,5,-135,-1.5,163,7.0,-105,-115,125,1.5,-190,4.02,Dodger Stadium,7,-3
2019-05-12,2019,ATL,ARI,5,3,-115,-1.5,137,9.0,-120,100,105,1.5,-157,4.81,Chase Field,8,2
2019-05-12,2019,ARI,ATL,3,5,105,1.5,-157,9.0,-120,100,-115,-1.5,137,4.39,Chase Field,8,-2
2019-05-12,2019,LAA,BAL,1,5,-155,-1.5,100,8.5,-105,-115,145,1.5,-120,5.17,Camden Yards,6,-4
2019-05-12,2019,SEA,BOS,2,11,120,1.5,-160,10.0,-115,-105,-130,-1.5,140,4.55,Fenway Park,13,-9
2019-05-12,2019,MIL,CHC,1,4,108,1.5,-195,7.0,-120,100,-118,-1.5,166,3.37,Wrigley Field,5,-3
2019-05-12,2019,SF,CIN,6,5,-111,-1.5,169,7.0,-110,-110,101,1.5,-201,3.68,AT&T Park,11,1
2019-05-12,2019,OAK,CLE,3,5,-120,-1.5,166,8.5,-120,100,110,1.5,-195,4.64,Oakland Coliseum,8,-2
2019-05-12,2019,SD,COL,7,10,100,1.5,-185,12.0,-105,-115,-110,-1.5,160,6.0,Coors Field,17,-3
2019-05-12,2019,TOR,CWS,1,5,-112,-1.5,170,8.5,-120,100,102,1.5,-200,4.49,Rogers Centre,6,-4
2019-05-12,2019,MIN,DET,3,5,-172,-1.5,100,8.5,-120,100,161,1.5,-120,5.38,Target Field,8,-2
2019-05-12,2019,TEX,HOU,5,15,190,1.5,105,10.0,100,-120,-210,-1.5,-125,3.45,Minute Maid Park,20,-10
2019-05-12,2019,PHI,KC,6,1,-105,-1.5,148,9.0,-120,100,-105,1.5,-170,4.61,Kauffman Stadium,7,5
2019-05-12,2019,BAL,LAA,5,1,145,1.5,-120,8.5,-105,-115,-155,-1.5,100,3.47,Camden Yards,6,4
2019-05-12,2019,WSH,LAD,0,6,132,1.5,-180,7.5,100,-120,-142,-1.5,155,3.23,Dodger Stadium,6,-6
2019-05-12,2019,CHC,MIL,4,1,-118,-1.5,166,7.0,-120,100,108,1.5,-195,3.79,Wrigley Field,5,3
2019-05-12,2019,DET,MIN,5,3,161,1.5,-120,8.5,-120,100,-172,-1.5,100,3.26,Target Field,8,2
2019-05-12,2019,TB,NYY,1,7,-185,-1.5,115,7.0,-115,-105,170,1.5,-135,4.54,Tropicana Field,8,-6
2019-05-12,2019,CLE,OAK,5,3,110,1.5,-195,8.5,-120,100,-120,-1.5,166,4.05,Oakland Coliseum,8,2
2019-05-12,2019,KC,PHI,1,6,-105,1.5,-170,9.0,-120,100,-105,-1.5,148,4.61,Kauffman Stadium,7,-5
2019-05-12,2019,STL,PIT,6,10,-170,-1.5,110,9.0,100,-120,160,1.5,-130,5.67,Busch Stadium,16,-4
2019-05-12,2019,COL,SD,10,7,-110,-1.5,160,12.0,-105,-115,100,1.5,-185,6.29,Coors Field,17,3
2019-05-12,2019,BOS,SEA,11,2,-130,-1.5,140,10.0,-115,-105,120,1.5,-160,5.65,Fenway Park,13,9
2019-05-12,2019,CIN,SF,5,6,101,1.5,-201,7.0,-110,-110,-111,-1.5,169,3.48,AT&T Park,11,-1
2019-05-12,2019,PIT,STL,10,6,160,1.5,-130,9.0,100,-120,-170,-1.5,110,3.46,Busch Stadium,16,4
2019-05-12,2019,NYY,TB,7,1,170,1.5,-135,7.0,-115,-105,-185,-1.5,115,2.59,Tropicana Field,8,6
2019-05-12,2019,HOU,TEX,15,5,-210,-1.5,-125,10.0,100,-120,190,1.5,105,6.77,Minute Maid Park,20,10
2019-05-12,2019,CWS,TOR,5,1,102,1.5,-200,8.5,-120,100,-112,-1.5,170,4.21,Rogers Centre,6,4
2019-05-12,2019,LAD,WSH,6,0,-142,-1.5,155,7.5,100,-120,132,1.5,-180,4.4,Dodger Stadium,6,6
2019-05-13,2019,PIT,ARI,3,9,165,1.5,-118,9.0,-115,-105,-180,-1.5,-102,3.4,Chase Field,12,-6
2019-05-13,2019,CWS,CLE,5,2,145,1.5,-115,8.5,-115,-105,-155,-1.5,-105,3.47,Guaranteed Rate Field,7,3
2019-05-13,2019,CLE,CWS,2,5,-155,-1.5,-105,8.5,-115,-105,145,1.5,-115,5.17,Guaranteed Rate Field,7,-3
2019-05-13,2019,HOU,DET,8,1,-162,-1.5,-105,9.0,100,-120,152,1.5,-115,5.56,Comerica Park,9,7
2019-05-13,2019,DET,HOU,1,8,152,1.5,-115,9.0,100,-120,-162,-1.5,-105,3.57,Comerica Park,9,-7
2019-05-13,2019,MIN,LAA,4,5,-128,-1.5,148,9.0,100,-120,118,1.5,-170,5.05,Target Field,9,-1
2019-05-13,2019,PHI,MIL,7,4,-143,-1.5,130,8.5,100,-120,133,1.5,-150,5.0,Citizens Bank Park,11,3
2019-05-13,2019,LAA,MIN,5,4,118,1.5,-170,9.0,100,-120,-128,-1.5,148,4.13,Target Field,9,1
2019-05-13,2019,SEA,OAK,6,5,-115,-1.5,160,9.0,-110,-110,105,1.5,-185,4.81,T-Mobile Park,11,1
2019-05-13,2019,MIL,PHI,4,7,133,1.5,-150,8.5,100,-120,-143,-1.5,130,3.65,Citizens Bank Park,11,-3
2019-05-13,2019,ARI,PIT,9,3,-180,-1.5,-102,9.0,-115,-105,165,1.5,-118,5.79,Chase Field,12,6
2019-05-13,2019,OAK,SEA,5,6,105,1.5,-185,9.0,-110,-110,-115,-1.5,160,4.39,T-Mobile Park,11,-1
2019-05-14,2019,PIT,ARI,6,2,148,1.5,-140,9.0,-105,-115,-158,-1.5,120,3.63,Chase Field,8,4
2019-05-14,2019,STL,ATL,14,3,-125,-1.5,135,9.0,-115,-105,115,1.5,-155,5.0,Suntrust Park,17,11
2019-05-14,2019,COL,BOS,5,4,220,1.5,111,8.5,-115,-105,-250,-1.5,-131,2.66,Fenway Park,9,1
2019-05-14,2019,CIN,CHC,1,3,100,1.5,-160,9.5,-105,-115,-110,-1.5,140,4.75,Great American Ballpark,4,-2
2019-05-14,2019,CHC,CIN,3,1,-110,-1.5,140,9.5,-105,-115,100,1.5,-160,4.98,Great American Ballpark,4,2
2019-05-14,2019,CWS,CLE,0,9,178,1.5,120,8.0,-105,-115,-196,-1.5,-140,2.88,Guaranteed Rate Field,9,-9
2019-05-14,2019,BOS,COL,4,5,-250,-1.5,-131,8.5,-115,-105,220,1.5,111,6.07,Fenway Park,9,-1
2019-05-14,2019,CLE,CWS,9,0,-196,-1.5,-140,8.0,-105,-115,178,1.5,120,5.3,Guaranteed Rate Field,9,9
2019-05-14,2019,HOU,DET,11,4,-220,-1.5,-156,10.5,-120,100,200,1.5,136,7.22,Comerica Park,15,7
2019-05-14,2019,DET,HOU,4,11,200,1.5,136,10.5,-120,100,-220,-1.5,-156,3.5,Comerica Park,15,-7
2019-05-14,2019,TEX,KC,5,11,133,1.5,-150,10.0,-105,-115,-143,-1.5,130,4.29,Kauffman Stadium,16,-6
2019-05-14,2019,MIN,LAA,4,3,-128,-1.5,144,9.5,-105,-115,118,1.5,-165,5.33,Target Field,7,1
2019-05-14,2019,SD,LAD,3,6,147,1.5,-158,7.0,-130,110,-157,-1.5,138,2.83,Dodger Stadium,9,-3
2019-05-14,2019,TB,MIA,4,0,-143,-1.5,120,6.5,-110,-110,133,1.5,-140,3.83,Marlins Park,4,4
2019-05-14,2019,PHI,MIL,1,6,105,1.5,-170,8.0,-120,100,-115,-1.5,148,3.9,Citizens Bank Park,7,-5
2019-05-14,2019,LAA,MIN,3,4,118,1.5,-165,9.5,-105,-115,-128,-1.5,144,4.36,Target Field,7,-1
2019-05-14,2019,WSH,NYM,2,6,134,1.5,-135,8.0,-115,-105,-144,-1.5,115,3.42,Nationals Park,8,-4
2019-05-14,2019,SEA,OAK,4,3,105,1.5,-155,9.0,-115,-105,-115,-1.5,135,4.39,T-Mobile Park,7,1
2019-05-14,2019,MIL,PHI,6,1,-115,-1.5,148,8.0,-120,100,105,1.5,-170,4.28,Citizens Bank Park,7,5
2019-05-14,2019,ARI,PIT,2,6,-158,-1.5,120,9.0,-105,-115,148,1.5,-140,5.51,Chase Field,8,-4
2019-05-14,2019,LAD,SD,6,3,-157,-1.5,138,7.0,-130,110,147,1.5,-158,4.28,Dodger Stadium,9,3
2019-05-14,2019,OAK,SEA,3,4,-115,-1.5,135,9.0,-115,-105,105,1.5,-155,4.81,T-Mobile Park,7,-1
2019-05-14,2019,TOR,SF,7,3,115,1.5,-195,7.5,-105,-115,-125,-1.5,166,3.49,AT&T Park,10,4
2019-05-14,2019,ATL,STL,3,14,115,1.5,-155,9.0,-115,-105,-125,-1.5,135,4.19,Suntrust Park,17,-11
2019-05-14,2019,MIA,TB,0,4,133,1.5,-140,6.5,-110,-110,-143,-1.5,120,2.79,Marlins Park,4,-4
2019-05-14,2019,KC,TEX,11,5,-143,-1.5,130,10.0,-105,-115,133,1.5,-150,5.88,Kauffman Stadium,16,6
2019-05-14,2019,SF,TOR,3,7,-125,-1.5,166,7.5,-105,-115,115,1.5,-195,4.17,AT&T Park,10,-4
2019-05-14,2019,NYM,WSH,6,2,-144,-1.5,115,8.0,-115,-105,134,1.5,-135,4.72,Nationals Park,8,4
2019-05-15,2019,PIT,ARI,1,11,147,1.5,-150,7.0,-120,100,-157,-1.5,130,2.83,Chase Field,12,-10
2019-05-15,2019,STL,ATL,0,4,124,1.5,-160,9.5,-115,-105,-134,-1.5,140,4.24,Suntrust Park,4,-4
2019-05-15,2019,NYY,BAL,5,3,-270,-1.5,-128,9.5,-110,-110,240,1.5,110,6.93,Yankee Stadium,8,2
2019-05-15,2019,NYY,BAL,3,1,-240,-1.5,-121,9.0,100,-120,210,1.5,103,6.35,Yankee Stadium,4,2
2019-05-15,2019,COL,BOS,5,6,136,1.5,-150,9.0,-120,100,-146,-1.5,130,3.81,Fenway Park,11,-1
2019-05-15,2019,CIN,CHC,6,5,-134,-1.5,140,9.0,-115,-105,124,1.5,-160,5.15,Great American Ballpark,11,1
2019-05-15,2019,CHC,CIN,5,6,124,1.5,-160,9.0,-115,-105,-134,-1.5,140,4.02,Great American Ballpark,11,-1
2019-05-15,2019,BOS,COL,6,5,-146,-1.5,130,9.0,-120,100,136,1.5,-150,5.34,Fenway Park,11,1
2019-05-15,2019,HOU,DET,5,1,-380,-1.5,-240,9.5,-120,100,320,1.5,199,7.52,Comerica Park,6,4
2019-05-15,2019,DET,HOU,1,5,320,1.5,199,9.5,-120,100,-380,-1.5,-240,2.26,Comerica Park,6,-4
2019-05-15,2019,TEX,KC,6,1,-118,-1.5,130,9.5,100,-120,108,1.5,-150,5.14,Kauffman Stadium,7,5
2019-05-15,2019,MIN,LAA,8,7,-135,-1.5,140,9.5,-105,-115,125,1.5,-160,5.46,Target Field,15,1
2019-05-15,2019,SD,LAD,0,2,148,1.5,-140,7.5,-120,100,-158,-1.5,120,3.02,Dodger Stadium,2,-2
2019-05-15,2019,TB,MIA,1,0,-176,-1.5,-110,7.5,-115,-105,163,1.5,-110,4.78,Marlins Park,1,1
2019-05-15,2019,PHI,MIL,2,5,-122,-1.5,168,9.0,-115,-105,112,1.5,-198,4.95,Citizens Bank Park,7,-3
2019-05-15,2019,LAA,MIN,7,8,125,1.5,-160,9.5,-105,-115,-135,-1.5,140,4.22,Target Field,15,-1
2019-05-15,2019,WSH,NYM,5,1,-147,-1.5,133,8.5,-105,-115,137,1.5,-153,5.06,Nationals Park,6,4
2019-05-15,2019,BAL,NYY,3,5,240,1.5,110,9.5,-110,-110,-270,-1.5,-128,2.79,Yankee Stadium,8,-2
2019-05-15,2019,BAL,NYY,1,3,210,1.5,103,9.0,100,-120,-240,-1.5,-121,2.9,Yankee Stadium,4,-2
2019-05-15,2019,MIL,PHI,5,2,112,1.5,-198,9.0,-115,-105,-122,-1.5,168,4.25,Citizens Bank Park,7,3
2019-05-15,2019,ARI,PIT,11,1,-157,-1.5,130,7.0,-120,100,147,1.5,-150,4.28,Chase Field,12,10
2019-05-15,2019,LAD,SD,2,0,-158,-1.5,120,7.5,-120,100,148,1.5,-140,4.59,Dodger Stadium,2,2
2019-05-15,2019,TOR,SF,3,4,130,1.5,-160,7.5,-110,-110,-140,-1.5,140,3.26,AT&T Park,7,-1
2019-05-15,2019,ATL,STL,4,0,-134,-1.5,140,9.5,-115,-105,124,1.5,-160,5.44,Suntrust Park,4,4
2019-05-15,2019,MIA,TB,0,1,163,1.5,-110,7.5,-115,-105,-176,-1.5,-110,2.85,Marlins Park,1,-1
2019-05-15,2019,KC,TEX,1,6,108,1.5,-150,9.5,100,-120,-118,-1.5,130,4.57,Kauffman Stadium,7,-5
2019-05-15,2019,SF,TOR,4,3,-140,-1.5,140,7.5,-110,-110,130,1.5,-160,4.38,AT&T Park,7,1
2019-05-15,2019,NYM,WSH,1,5,137,1.5,-153,8.5,-105,-115,-147,-1.5,133,3.59,Nationals Park,6,-4
2019-05-16,2019,STL,ATL,2,10,102,1.5,-195,10.0,-110,-110,-112,-1.5,166,4.95,Suntrust Park,12,-8
2019-05-16,2019,CLE,BAL,14,7,-340,-1.5,-170,9.0,-110,-110,290,1.5,148,6.95,Progressive Field,21,7
2019-05-16,2019,CIN,CHC,4,2,-136,-1.5,152,8.0,-120,100,126,1.5,-176,4.61,Great American Ballpark,6,2
2019-05-16,2019,CHC,CIN,2,4,126,1.5,-176,8.0,-120,100,-136,-1.5,152,3.54,Great American Ballpark,6,-2
2019-05-16,2019,BAL,CLE,7,14,290,1.5,148,9.0,-110,-110,-340,-1.5,-170,2.31,Progressive Field,21,-7
2019-05-16,2019,TOR,CWS,2,4,-116,-1.5,134,10.0,100,-120,106,1.5,-154,5.37,Guaranteed Rate Field,6,-2
2019-05-16,2019,OAK,DET,17,3,-148,-1.5,-102,8.5,-105,-115,138,1.5,-118,5.07,Comerica Park,20,14
2019-05-16,2019,TEX,KC,16,1,102,1.5,-200,10.5,-105,-115,-112,-1.5,170,5.2,Kauffman Stadium,17,15
2019-05-16,2019,PHI,MIL,3,11,-121,-1.5,170,9.0,-115,-105,111,1.5,-200,4.93,Citizens Bank Park,14,-8
2019-05-16,2019,SEA,MIN,6,11,-103,1.5,-175,10.0,100,-120,-107,-1.5,152,5.07,T-Mobile Park,17,-5
2019-05-16,2019,WSH,NYM,7,6,115,1.5,-146,9.0,100,-120,-125,-1.5,126,4.19,Nationals Park,13,1
2019-05-16,2019,DET,OAK,3,17,138,1.5,-118,8.5,-105,-115,-148,-1.5,-102,3.57,Comerica Park,20,-14
2019-05-16,2019,MIL,PHI,11,3,111,1.5,-200,9.0,-115,-105,-121,-1.5,170,4.27,Citizens Bank Park,14,8
2019-05-16,2019,SD,PIT,4,3,-144,-1.5,151,7.5,100,-120,134,1.5,-175,4.43,PETCO Park,7,1
2019-05-16,2019,PIT,SD,3,4,134,1.5,-175,7.5,100,-120,-144,-1.5,151,3.21,PETCO Park,7,-1
2019-05-16,2019,MIN,SEA,11,6,-107,-1.5,152,10.0,100,-120,-103,1.5,-175,5.17,T-Mobile Park,17,5
2019-05-16,2019,ATL,STL,10,2,-112,-1.5,166,10.0,-110,-110,102,1.5,-195,5.28,Suntrust Park,12,8
2019-05-16,2019,KC,TEX,1,16,-112,-1.5,170,10.5,-105,-115,102,1.5,-200,5.55,Kauffman Stadium,17,-15
2019-05-16,2019,CWS,TOR,4,2,106,1.5,-154,10.0,100,-120,-116,-1.5,134,4.85,Guaranteed Rate Field,6,2
2019-05-16,2019,NYM,WSH,6,7,-125,-1.5,126,9.0,100,-120,115,1.5,-146,5.0,Nationals Park,13,-1
2019-05-17,2019,SF,ARI,0,7,131,1.5,-166,9.0,-105,-115,-141,-1.5,144,3.9,Chase Field,7,-7
2019-05-17,2019,MIL,ATL,8,12,118,1.5,-174,9.0,-120,100,-128,-1.5,150,4.13,Suntrust Park,20,-4
2019-05-17,2019,CLE,BAL,1,5,-170,-1.5,104,9.0,-125,105,160,1.5,-124,5.67,Progressive Field,6,-4
2019-05-17,2019,HOU,BOS,3,1,-141,-1.5,110,9.5,-120,100,131,1.5,-130,5.56,Fenway Park,4,2
2019-05-17,2019,WSH,CHC,6,14,-158,-1.5,130,8.0,-115,-105,148,1.5,-150,4.9,Nationals Park,20,-8
2019-05-17,2019,LAD,CIN,6,0,-137,-1.5,105,10.0,-115,-105,127,1.5,-125,5.78,Great American Ballpark,6,6
2019-05-17,2019,BAL,CLE,5,1,160,1.5,-124,9.0,-125,105,-170,-1.5,104,3.46,Progressive Field,6,4
2019-05-17,2019,PHI,COL,5,4,-119,-1.5,163,9.5,100,-120,109,1.5,-190,5.16,Citizens Bank Park,9,1
2019-05-17,2019,TOR,CWS,10,2,106,1.5,-180,9.0,-115,-105,-116,-1.5,155,4.37,Guaranteed Rate Field,12,8
2019-05-17,2019,OAK,DET,7,2,-192,-1.5,-130,9.0,-115,-105,176,1.5,110,5.92,Comerica Park,9,5
2019-05-17,2019,BOS,HOU,1,3,131,1.5,-130,9.5,-120,100,-141,-1.5,110,4.11,Fenway Park,4,-2
2019-05-17,2019,LAA,KC,5,2,-185,-1.5,105,10.0,-115,-105,170,1.5,-125,6.49,Angel Stadium,7,3
2019-05-17,2019,KC,LAA,2,5,170,1.5,-125,10.0,-115,-105,-185,-1.5,105,3.7,Angel Stadium,7,-3
2019-05-17,2019,CIN,LAD,0,6,127,1.5,-125,10.0,-115,-105,-137,-1.5,105,4.41,Great American Ballpark,6,-6
2019-05-17,2019,NYM,MIA,6,8,-230,-1.5,-126,6.5,-115,-105,205,1.5,107,4.53,Marlins Park,14,-2
2019-05-17,2019,ATL,MIL,12,8,-128,-1.5,150,9.0,-120,100,118,1.5,-174,5.05,Suntrust Park,20,4
2019-05-17,2019,SEA,MIN,1,7,-112,1.5,-180,8.5,-105,-115,102,-1.5,155,4.49,T-Mobile Park,8,-6
2019-05-17,2019,MIA,NYM,8,6,205,1.5,107,6.5,-115,-105,-230,-1.5,-126,2.13,Marlins Park,14,2
2019-05-17,2019,TB,NYY,3,4,-103,1.5,-210,9.5,-110,-110,-107,-1.5,176,4.82,Yankee Stadium,7,-1
2019-05-17,2019,DET,OAK,2,7,176,1.5,110,9.0,-115,-105,-192,-1.5,-130,3.26,Comerica Park,9,-5
2019-05-17,2019,COL,PHI,4,5,109,1.5,-190,9.5,100,-120,-119,-1.5,163,4.55,Citizens Bank Park,9,-1
2019-05-17,2019,SD,PIT,3,5,-168,-1.5,138,7.0,-105,-115,158,1.5,-158,4.39,PETCO Park,8,-2
2019-05-17,2019,PIT,SD,5,3,158,1.5,-158,7.0,-105,-115,-168,-1.5,138,2.71,PETCO Park,8,2
2019-05-17,2019,MIN,SEA,7,1,102,-1.5,155,8.5,-105,-115,-112,1.5,-180,4.21,T-Mobile Park,8,6
2019-05-17,2019,ARI,SF,7,0,-141,-1.5,144,9.0,-105,-115,131,1.5,-166,5.27,Chase Field,7,7
2019-05-17,2019,TEX,STL,7,3,147,1.5,-109,11.5,-110,-110,-157,-1.5,-111,4.66,Rangers Ballpark,10,4
2019-05-17,2019,NYY,TB,4,3,-107,-1.5,176,9.5,-110,-110,-103,1.5,-210,4.91,Yankee Stadium,7,1
2019-05-17,2019,STL,TEX,3,7,-157,-1.5,-111,11.5,-110,-110,147,1.5,-109,7.03,Rangers Ballpark,10,-4
2019-05-17,2019,CWS,TOR,2,10,-116,-1.5,155,9.0,-115,-105,106,1.5,-180,4.83,Guaranteed Rate Field,12,-8
2019-05-17,2019,CHC,WSH,14,6,148,1.5,-150,8.0,-115,-105,-158,-1.5,130,3.23,Nationals Park,20,8
2019-05-18,2019,SF,ARI,8,5,-116,-1.5,148,8.5,-105,-115,106,1.5,-170,4.56,Chase Field,13,3
2019-05-18,2019,MIL,ATL,3,4,110,1.5,-180,9.5,-120,100,-120,-1.5,155,4.52,Suntrust Park,7,-1
2019-05-18,2019,CLE,BAL,4,1,-150,-1.5,120,9.0,-115,-105,140,1.5,-140,5.4,Progressive Field,5,3
2019-05-18,2019,HOU,BOS,7,3,-110,-1.5,142,10.5,-110,-110,100,1.5,-162,5.5,Fenway Park,10,4
2019-05-18,2019,WSH,CHC,5,2,-135,-1.5,160,8.5,-110,-110,125,1.5,-185,4.88,Nationals Park,7,3
2019-05-18,2019,LAD,CIN,0,4,-167,-1.5,-122,10.0,-115,-105,157,1.5,102,6.25,Great American Ballpark,4,-4
2019-05-18,2019,BAL,CLE,1,4,140,1.5,-140,9.0,-115,-105,-150,-1.5,120,3.75,Progressive Field,5,-3
2019-05-18,2019,PHI,COL,2,1,-176,-1.5,105,9.5,-115,-105,163,1.5,-125,6.06,Citizens Bank Park,3,1
2019-05-18,2019,TOR,CWS,1,4,145,1.5,-137,9.5,-115,-105,-155,-1.5,116,3.88,Guaranteed Rate Field,5,-3
2019-05-18,2019,OAK,DET,4,1,-118,-1.5,135,9.0,-120,100,108,1.5,-155,4.87,Comerica Park,5,3
2019-05-18,2019,BOS,HOU,3,7,100,1.5,-162,10.5,-110,-110,-110,-1.5,142,5.25,Fenway Park,10,-4
2019-05-18,2019,LAA,KC,6,3,-190,-1.5,-105,9.0,-120,100,175,1.5,-115,5.9,Angel Stadium,9,3
2019-05-18,2019,KC,LAA,3,6,175,1.5,-115,9.0,-120,100,-190,-1.5,-105,3.27,Angel Stadium,9,-3
2019-05-18,2019,CIN,LAD,4,0,157,1.5,102,10.0,-115,-105,-167,-1.5,-122,3.89,Great American Ballpark,4,4
2019-05-18,2019,NYM,MIA,0,2,-126,-1.5,120,7.5,-105,-115,116,1.5,-140,4.18,Marlins Park,2,-2
2019-05-18,2019,ATL,MIL,4,3,-120,-1.5,155,9.5,-120,100,110,1.5,-180,5.18,Suntrust Park,7,1
2019-05-18,2019,SEA,MIN,4,18,122,1.5,-139,9.0,-115,-105,-132,-1.5,119,4.05,T-Mobile Park,22,-14
2019-05-18,2019,MIA,NYM,2,0,116,1.5,-140,7.5,-105,-115,-126,-1.5,120,3.47,Marlins Park,2,2
2019-05-18,2019,TB,NYY,2,1,-117,-1.5,144,8.5,-105,-115,107,1.5,-165,4.58,Yankee Stadium,3,1
2019-05-18,2019,DET,OAK,1,4,108,1.5,-155,9.0,-120,100,-118,-1.5,135,4.33,Comerica Park,5,-3
2019-05-18,2019,COL,PHI,1,2,163,1.5,-125,9.5,-115,-105,-176,-1.5,105,3.61,Citizens Bank Park,3,-1
2019-05-18,2019,SD,PIT,2,7,-150,-1.5,143,8.0,-115,-105,140,1.5,-164,4.8,PETCO Park,9,-5
2019-05-18,2019,PIT,SD,7,2,140,1.5,-164,8.0,-115,-105,-150,-1.5,143,3.33,PETCO Park,9,5
2019-05-18,2019,MIN,SEA,18,4,-132,-1.5,119,9.0,-115,-105,122,1.5,-139,5.12,T-Mobile Park,22,14
2019-05-18,2019,ARI,SF,5,8,106,1.5,-170,8.5,-105,-115,-116,-1.5,148,4.13,Chase Field,13,-3
2019-05-18,2019,TEX,STL,2,8,100,1.5,-155,12.0,-115,-105,-110,-1.5,135,6.0,Rangers Ballpark,10,-6
2019-05-18,2019,NYY,TB,1,2,107,1.5,-165,8.5,-105,-115,-117,-1.5,144,4.11,Yankee Stadium,3,-1
2019-05-18,2019,STL,TEX,8,2,-110,-1.5,135,12.0,-115,-105,100,1.5,-155,6.29,Rangers Ballpark,10,6
2019-05-18,2019,CWS,TOR,4,1,-155,-1.5,116,9.5,-115,-105,145,1.5,-137,5.77,Guaranteed Rate Field,5,3
2019-05-18,2019,CHC,WSH,2,5,125,1.5,-185,8.5,-110,-110,-135,-1.5,160,3.78,Nationals Park,7,-3
2019-05-19,2019,SF,ARI,3,2,180,1.5,-110,8.0,-105,-115,-200,-1.5,-110,2.86,Chase Field,5,1
2019-05-19,2019,MIL,ATL,3,2,-140,-1.5,110,9.0,-120,100,130,1.5,-130,5.25,Suntrust Park,5,1
2019-05-19,2019,CLE,BAL,10,0,-240,-1.5,-127,10.0,-105,-115,210,1.5,108,7.06,Progressive Field,10,10
2019-05-19,2019,HOU,BOS,3,4,176,1.5,-120,9.5,-110,-110,-192,-1.5,100,3.44,Fenway Park,7,-1
2019-05-19,2019,WSH,CHC,5,6,140,1.5,-110,10.0,-105,-115,-150,-1.5,-110,4.17,Nationals Park,11,-1
2019-05-19,2019,LAD,CIN,8,3,-170,-1.5,-119,9.0,-120,100,160,1.5,-101,5.67,Great American Ballpark,11,5
2019-05-19,2019,BAL,CLE,0,10,210,1.5,108,10.0,-105,-115,-240,-1.5,-127,3.23,Progressive Field,10,-10
2019-05-19,2019,PHI,COL,7,5,-113,-1.5,163,10.0,-115,-105,103,1.5,-190,5.31,Citizens Bank Park,12,2
2019-05-19,2019,TOR,CWS,5,2,100,1.5,-195,9.5,100,-120,-110,-1.5,166,4.75,Guaranteed Rate Field,7,3
2019-05-19,2019,OAK,DET,7,3,-200,-1.5,-135,10.5,-105,-115,180,1.5,116,7.0,Comerica Park,10,4
2019-05-19,2019,BOS,HOU,4,3,-192,-1.5,100,9.5,-110,-110,176,1.5,-120,6.25,Fenway Park,7,1
2019-05-19,2019,LAA,KC,1,5,-167,-1.5,120,8.5,-120,100,157,1.5,-140,5.32,Angel Stadium,6,-4
2019-05-19,2019,KC,LAA,5,1,157,1.5,-140,8.5,-120,100,-167,-1.5,120,3.31,Angel Stadium,6,4
2019-05-19,2019,CIN,LAD,3,8,160,1.5,-101,9.0,-120,100,-170,-1.5,-119,3.46,Great American Ballpark,11,-5
2019-05-19,2019,NYM,MIA,0,3,-196,-1.5,-130,7.0,-125,105,178,1.5,110,4.64,Marlins Park,3,-3
2019-05-19,2019,ATL,MIL,2,3,130,1.5,-130,9.0,-120,100,-140,-1.5,110,3.91,Suntrust Park,5,-1
2019-05-19,2019,SEA,MIN,7,4,-120,1.5,-194,8.5,-115,-105,110,-1.5,167,4.64,T-Mobile Park,11,3
2019-05-19,2019,MIA,NYM,3,0,178,1.5,110,7.0,-125,105,-196,-1.5,-130,2.52,Marlins Park,3,3
2019-05-19,2019,TB,NYY,5,13,-101,-1.5,151,9.0,-115,-105,-109,1.5,-175,4.52,Yankee Stadium,18,-8
2019-05-19,2019,DET,OAK,3,7,180,1.5,116,10.5,-105,-115,-200,-1.5,-135,3.75,Comerica Park,10,-4
2019-05-19,2019,COL,PHI,5,7,103,1.5,-190,10.0,-115,-105,-113,-1.5,163,4.93,Citizens Bank Park,12,-2
2019-05-19,2019,SD,PIT,4,6,-112,-1.5,176,8.0,-110,-110,102,1.5,-210,4.23,PETCO Park,10,-2
2019-05-19,2019,PIT,SD,6,4,102,1.5,-210,8.0,-110,-110,-112,-1.5,176,3.96,PETCO Park,10,2
2019-05-19,2019,MIN,SEA,4,7,110,-1.5,167,8.5,-115,-105,-120,1.5,-194,4.05,T-Mobile Park,11,-3
2019-05-19,2019,ARI,SF,2,3,-200,-1.5,-110,8.0,-105,-115,180,1.5,-110,5.33,Chase Field,5,-1
2019-05-19,2019,TEX,STL,5,4,148,1.5,-101,11.0,-105,-115,-158,-1.5,-119,4.44,Rangers Ballpark,9,1
2019-05-19,2019,NYY,TB,13,5,-109,1.5,-175,9.0,-115,-105,-101,-1.5,151,4.69,Yankee Stadium,18,8
2019-05-19,2019,STL,TEX,4,5,-158,-1.5,-119,11.0,-105,-115,148,1.5,-101,6.74,Rangers Ballpark,9,-1
2019-05-19,2019,CWS,TOR,2,5,-110,-1.5,166,9.5,100,-120,100,1.5,-195,4.98,Guaranteed Rate Field,7,-3
2019-05-19,2019,CHC,WSH,6,5,-150,-1.5,-110,10.0,-105,-115,140,1.5,-110,6.0,Nationals Park,11,1
2019-05-20,2019,SD,ARI,2,1,-145,-1.5,166,6.5,-110,-110,135,1.5,-195,3.85,PETCO Park,3,1
2019-05-20,2019,SF,ATL,1,4,140,1.5,-130,7.5,-115,-105,-150,-1.5,110,3.13,AT&T Park,5,-3
2019-05-20,2019,NYY,BAL,10,7,-180,-1.5,-115,9.0,-120,100,165,1.5,-105,5.79,Camden Yards,17,3
2019-05-20,2019,TOR,BOS,2,12,200,1.5,125,9.0,-105,-115,-220,-1.5,-145,3.0,Rogers Centre,14,-10
2019-05-20,2019,PHI,CHC,5,4,108,1.5,-190,8.5,100,-120,-118,-1.5,163,4.09,Wrigley Field,9,1
2019-05-20,2019,OAK,CLE,6,4,165,1.5,-125,8.0,-110,-110,-180,-1.5,105,3.02,Progressive Field,10,2
2019-05-20,2019,HOU,CWS,3,0,-230,-1.5,-127,9.0,-115,-105,205,1.5,107,6.27,Minute Maid Park,3,3
2019-05-20,2019,CWS,HOU,0,3,205,1.5,107,9.0,-115,-105,-230,-1.5,-127,2.95,Minute Maid Park,3,-3
2019-05-20,2019,MIN,LAA,3,1,130,1.5,-175,8.5,-120,100,-140,-1.5,151,3.7,Angel Stadium,4,2
2019-05-20,2019,LAA,MIN,1,3,-140,-1.5,151,8.5,-120,100,130,1.5,-175,4.96,Angel Stadium,4,-2
2019-05-20,2019,WSH,NYM,3,5,-155,-1.5,-101,8.5,-120,100,145,1.5,-119,5.17,Citi Field,8,-2
2019-05-20,2019,BAL,NYY,7,10,165,1.5,-105,9.0,-120,100,-180,-1.5,-115,3.4,Camden Yards,17,-3
2019-05-20,2019,CLE,OAK,4,6,-180,-1.5,105,8.0,-110,-110,165,1.5,-125,5.14,Progressive Field,10,-2
2019-05-20,2019,CHC,PHI,4,5,-118,-1.5,163,8.5,100,-120,108,1.5,-190,4.6,Wrigley Field,9,-1
2019-05-20,2019,ARI,SD,1,2,135,1.5,-195,6.5,-110,-110,-145,-1.5,166,2.77,PETCO Park,3,-1
2019-05-20,2019,TEX,SEA,10,9,-142,-1.5,125,11.0,105,-125,132,1.5,-145,6.45,Rangers Ballpark,19,1
2019-05-20,2019,ATL,SF,4,1,-150,-1.5,110,7.5,-115,-105,140,1.5,-130,4.5,AT&T Park,5,3
2019-05-20,2019,SEA,TEX,9,10,132,1.5,-145,11.0,105,-125,-142,-1.5,125,4.74,Rangers Ballpark,19,-1
2019-05-20,2019,BOS,TOR,12,2,-220,-1.5,-145,9.0,-105,-115,200,1.5,125,6.19,Rogers Centre,14,10
2019-05-20,2019,NYM,WSH,5,3,145,1.5,-119,8.5,-120,100,-155,-1.5,-101,3.47,Citi Field,8,2
2019-05-21,2019,SD,ARI,3,2,-105,1.5,-180,7.0,-105,-115,-105,-1.5,155,3.59,PETCO Park,5,1
2019-05-21,2019,SF,ATL,4,3,105,1.5,-165,8.0,-105,-115,-115,-1.5,144,3.9,AT&T Park,7,1
2019-05-21,2019,NYY,BAL,11,4,-260,-1.5,-163,9.5,-110,-110,230,1.5,143,6.86,Camden Yards,15,7
2019-05-21,2019,TOR,BOS,10,3,130,1.5,-126,8.5,-110,-110,-140,-1.5,106,3.7,Rogers Centre,13,7
2019-05-21,2019,PHI,CHC,2,3,115,1.5,-200,7.5,110,-130,-125,-1.5,170,3.49,Wrigley Field,5,-1
2019-05-21,2019,MIL,CIN,0,3,-132,-1.5,148,8.5,105,-125,122,1.5,-170,4.84,Miller Park,3,-3
2019-05-21,2019,OAK,CLE,5,3,110,1.5,-175,8.5,-110,-110,-120,-1.5,151,4.05,Progressive Field,8,2
2019-05-21,2019,PIT,COL,0,5,110,1.5,-165,7.5,-105,-115,-120,-1.5,144,3.57,PNC Park,5,-5
2019-05-21,2019,HOU,CWS,5,1,-350,-1.5,-180,8.5,-120,100,300,1.5,155,6.61,Minute Maid Park,6,4
2019-05-21,2019,MIA,DET,5,4,102,1.5,-220,7.5,-105,-115,-112,-1.5,184,3.71,Comerica Park,9,1
2019-05-21,2019,CWS,HOU,1,5,300,1.5,155,8.5,-120,100,-350,-1.5,-180,2.13,Minute Maid Park,6,-4
2019-05-21,2019,MIN,LAA,8,3,104,1.5,-190,9.0,-120,100,-114,-1.5,163,4.41,Angel Stadium,11,5
2019-05-21,2019,TB,LAD,3,7,130,1.5,-135,8.0,-110,-110,-140,-1.5,115,3.48,Tropicana Field,10,-4
2019-05-21,2019,DET,MIA,4,5,-112,-1.5,184,7.5,-105,-115,102,1.5,-220,3.96,Comerica Park,9,-1
2019-05-21,2019,CIN,MIL,3,0,122,1.5,-170,8.5,105,-125,-132,-1.5,148,3.83,Miller Park,3,3
2019-05-21,2019,LAA,MIN,3,8,-114,-1.5,163,9.0,-120,100,104,1.5,-190,4.79,Angel Stadium,11,-5
2019-05-21,2019,WSH,NYM,5,6,125,1.5,-185,7.5,-115,-105,-135,-1.5,160,3.33,Citi Field,11,-1
2019-05-21,2019,BAL,NYY,4,11,230,1.5,143,9.5,-110,-110,-260,-1.5,-163,2.88,Camden Yards,15,-7
2019-05-21,2019,CLE,OAK,3,5,-120,-1.5,151,8.5,-110,-110,110,1.5,-175,4.64,Progressive Field,8,-2
2019-05-21,2019,CHC,PHI,3,2,-125,-1.5,170,7.5,110,-130,115,1.5,-200,4.17,Wrigley Field,5,1
2019-05-21,2019,COL,PIT,5,0,-120,-1.5,144,7.5,-105,-115,110,1.5,-165,4.09,PNC Park,5,5
2019-05-21,2019,ARI,SD,2,3,-105,-1.5,155,7.0,-105,-115,-105,1.5,-180,3.59,PETCO Park,5,-1
2019-05-21,2019,TEX,SEA,5,3,-120,-1.5,144,11.5,-105,-115,110,1.5,-165,6.27,Rangers Ballpark,8,2
2019-05-21,2019,ATL,SF,3,4,-115,-1.5,144,8.0,-105,-115,105,1.5,-165,4.28,AT&T Park,7,-1
2019-05-21,2019,LAD,TB,7,3,-140,-1.5,115,8.0,-110,-110,130,1.5,-135,4.67,Tropicana Field,10,4
2019-05-21,2019,SEA,TEX,3,5,110,1.5,-165,11.5,-105,-115,-120,-1.5,144,5.48,Rangers Ballpark,8,-2
2019-05-21,2019,BOS,TOR,3,10,-140,-1.5,106,8.5,-110,-110,130,1.5,-126,4.96,Rogers Centre,13,-7
2019-05-21,2019,NYM,WSH,6,5,-135,-1.5,160,7.5,-115,-105,125,1.5,-185,4.31,Citi Field,11,1
2019-05-22,2019,SD,ARI,5,2,-134,-1.5,155,8.0,-105,-115,124,1.5,-180,4.58,PETCO Park,7,3
2019-05-22,2019,SF,ATL,2,9,147,1.5,-124,7.5,-105,-115,-157,-1.5,104,3.04,AT&T Park,11,-7
2019-05-22,2019,NYY,BAL,7,5,-250,-1.5,-163,10.5,100,-120,220,1.5,143,7.5,Camden Yards,12,2
2019-05-22,2019,TOR,BOS,5,6,134,1.5,-124,9.0,-120,100,-144,-1.5,104,3.85,Rogers Centre,11,-1
2019-05-22,2019,PHI,CHC,4,8,152,1.5,-130,10.5,-125,105,-162,-1.5,110,4.17,Wrigley Field,12,-4
2019-05-22,2019,MIL,CIN,11,9,-101,1.5,-170,7.5,100,-120,-109,-1.5,148,3.77,Miller Park,20,2
2019-05-22,2019,OAK,CLE,7,2,-120,-1.5,129,9.5,-105,-115,110,1.5,-149,5.18,Progressive Field,9,5
2019-05-22,2019,PIT,COL,3,9,102,1.5,-162,8.5,-105,-115,-112,-1.5,142,4.21,PNC Park,12,-6
2019-05-22,2019,HOU,CWS,4,9,-360,-1.5,-180,8.5,-105,-115,310,1.5,155,6.65,Minute Maid Park,13,-5
2019-05-22,2019,MIA,DET,6,3,105,1.5,-195,9.0,-105,-115,-115,-1.5,166,4.39,Comerica Park,9,3
2019-05-22,2019,CWS,HOU,9,4,310,1.5,155,8.5,-105,-115,-360,-1.5,-180,2.07,Minute Maid Park,13,5
2019-05-22,2019,STL,KC,2,8,-180,-1.5,110,9.5,100,-120,165,1.5,-130,6.11,Busch Stadium,10,-6
2019-05-22,2019,STL,KC,10,3,-200,-1.5,-106,9.5,105,-125,180,1.5,-114,6.33,Busch Stadium,13,7
2019-05-22,2019,TB,LAD,8,1,113,1.5,-156,8.0,-110,-110,-123,-1.5,136,3.76,Tropicana Field,9,7
2019-05-22,2019,DET,MIA,3,6,-115,-1.5,166,9.0,-105,-115,105,1.5,-195,4.81,Comerica Park,9,-3
2019-05-22,2019,CIN,MIL,9,11,-109,-1.5,148,7.5,100,-120,-101,1.5,-170,3.91,Miller Park,20,-2
2019-05-22,2019,WSH,NYM,1,6,-123,1.5,-265,6.5,100,-120,113,-1.5,219,3.59,Citi Field,7,-5
2019-05-22,2019,BAL,NYY,5,7,220,1.5,143,10.5,100,-120,-250,-1.5,-163,3.28,Camden Yards,12,-2
2019-05-22,2019,CLE,OAK,2,7,110,1.5,-149,9.5,-105,-115,-120,-1.5,129,4.52,Progressive Field,9,-5
2019-05-22,2019,CHC,PHI,8,4,-162,-1.5,110,10.5,-125,105,152,1.5,-130,6.49,Wrigley Field,12,4
2019-05-22,2019,COL,PIT,9,3,-112,-1.5,142,8.5,-105,-115,102,1.5,-162,4.49,PNC Park,12,6
2019-05-22,2019,ARI,SD,2,5,124,1.5,-180,8.0,-105,-115,-134,-1.5,155,3.57,PETCO Park,7,-3
2019-05-22,2019,TEX,SEA,2,1,112,1.5,-135,12.0,105,-125,-122,-1.5,115,5.66,Rangers Ballpark,3,1
2019-05-22,2019,ATL,SF,9,2,-157,-1.5,104,7.5,-105,-115,147,1.5,-124,4.58,AT&T Park,11,7
2019-05-22,2019,KC,STL,8,2,165,1.5,-130,9.5,100,-120,-180,-1.5,110,3.58,Busch Stadium,10,6
2019-05-22,2019,KC,STL,3,10,180,1.5,-114,9.5,105,-125,-200,-1.5,-106,3.39,Busch Stadium,13,-7
2019-05-22,2019,LAD,TB,1,8,-123,-1.5,136,8.0,-110,-110,113,1.5,-156,4.41,Tropicana Field,9,-7
2019-05-22,2019,SEA,TEX,1,2,-122,-1.5,115,12.0,105,-125,112,1.5,-135,6.59,Rangers Ballpark,3,-1
2019-05-22,2019,BOS,TOR,6,5,-144,-1.5,104,9.0,-120,100,134,1.5,-124,5.31,Rogers Centre,11,1
2019-05-22,2019,NYM,WSH,6,1,113,-1.5,219,6.5,100,-120,-123,1.5,-265,3.05,Citi Field,7,5
2019-05-23,2019,SF,ATL,4,5,104,1.5,-166,7.5,100,-120,-114,-1.5,145,3.68,AT&T Park,9,-1
2019-05-23,2019,NYY,BAL,6,5,-200,-1.5,-126,9.0,-105,-115,180,1.5,107,6.0,Camden Yards,11,1
2019-05-23,2019,TOR,BOS,2,8,122,1.5,-131,10.0,-105,-115,-132,-1.5,111,4.5,Rogers Centre,10,-6
2019-05-23,2019,PHI,CHC,9,7,-125,-1.5,118,9.5,-115,-105,115,1.5,-138,5.28,Wrigley Field,16,2
2019-05-23,2019,TB,CLE,7,2,-124,-1.5,130,9.5,-110,-110,114,1.5,-150,5.26,Progressive Field,9,5
2019-05-23,2019,PIT,COL,14,6,-132,-1.5,155,9.0,-105,-115,122,1.5,-180,5.12,PNC Park,20,8
2019-05-23,2019,HOU,CWS,0,4,-185,-1.5,105,9.0,-105,-115,170,1.5,-125,5.84,Minute Maid Park,4,-4
2019-05-23,2019,MIA,DET,5,2,135,1.5,-160,9.0,-110,-110,-145,-1.5,140,3.83,Comerica Park,7,3
2019-05-23,2019,CWS,HOU,4,0,170,1.5,-125,9.0,-105,-115,-185,-1.5,105,3.33,Minute Maid Park,4,4
2019-05-23,2019,MIN,LAA,16,7,-134,-1.5,120,9.0,-105,-115,124,1.5,-140,5.15,Angel Stadium,23,9
2019-05-23,2019,DET,MIA,2,5,-145,-1.5,140,9.0,-110,-110,135,1.5,-160,5.33,Comerica Park,7,-3
2019-05-23,2019,LAA,MIN,7,16,124,1.5,-140,9.0,-105,-115,-134,-1.5,120,4.02,Angel Stadium,23,-9
2019-05-23,2019,WSH,NYM,4,6,-163,-1.5,-101,7.5,105,-125,153,1.5,-119,4.65,Citi Field,10,-2
2019-05-23,2019,BAL,NYY,5,6,180,1.5,107,9.0,-105,-115,-200,-1.5,-126,3.21,Camden Yards,11,-1
2019-05-23,2019,CHC,PHI,7,9,115,1.5,-138,9.5,-115,-105,-125,-1.5,118,4.42,Wrigley Field,16,-2
2019-05-23,2019,COL,PIT,6,14,122,1.5,-180,9.0,-105,-115,-132,-1.5,155,4.05,PNC Park,20,-8
2019-05-23,2019,ATL,SF,5,4,-114,-1.5,145,7.5,100,-120,104,1.5,-166,4.0,AT&T Park,9,1
2019-05-23,2019,CLE,TB,2,7,114,1.5,-150,9.5,-110,-110,-124,-1.5,130,4.44,Progressive Field,9,-5
2019-05-23,2019,BOS,TOR,8,2,-132,-1.5,111,10.0,-105,-115,122,1.5,-131,5.69,Rogers Centre,10,6
2019-05-23,2019,NYM,WSH,6,4,153,1.5,-119,7.5,105,-125,-163,-1.5,-101,2.96,Citi Field,10,2
2019-05-24,2019,SF,ARI,2,18,128,1.5,-140,6.5,-120,100,-138,-1.5,120,2.85,AT&T Park,20,-16
2019-05-24,2019,STL,ATL,2,5,-148,-1.5,138,10.0,100,-120,138,1.5,-158,5.97,Busch Stadium,7,-3
2019-05-24,2019,COL,BAL,8,6,-145,-1.5,120,12.0,105,-125,135,1.5,-140,7.1,Coors Field,14,2
2019-05-24,2019,HOU,BOS,4,3,140,1.5,-120,8.5,-120,100,-150,-1.5,100,3.54,Minute Maid Park,7,1
2019-05-24,2019,CIN,CHC,6,5,165,1.5,-120,8.0,-110,-110,-180,-1.5,100,3.02,Wrigley Field,11,1
2019-05-24,2019,CHC,CIN,5,6,-180,-1.5,100,8.0,-110,-110,165,1.5,-120,5.14,Wrigley Field,11,-1
2019-05-24,2019,TB,CLE,1,3,-130,-1.5,128,7.5,100,-120,120,1.5,-148,4.24,Progressive Field,4,-2
2019-05-24,2019,BAL,COL,6,8,135,1.5,-140,12.0,105,-125,-145,-1.5,120,5.11,Coors Field,14,-2
2019-05-24,2019,MIN,CWS,11,4,-205,-1.5,-119,9.0,-115,-105,185,1.5,-101,6.05,Target Field,15,7
2019-05-24,2019,NYM,DET,8,9,-290,-1.5,-142,8.0,-105,-115,250,1.5,122,5.95,Citi Field,17,-1
2019-05-24,2019,BOS,HOU,3,4,-150,-1.5,100,8.5,-120,100,140,1.5,-120,5.1,Minute Maid Park,7,-1
2019-05-24,2019,TEX,LAA,4,3,152,1.5,-135,9.5,-105,-115,-162,-1.5,115,3.77,Angel Stadium,7,1
2019-05-24,2019,PIT,LAD,2,10,175,1.5,113,9.0,-105,-115,-190,-1.5,-133,3.27,PNC Park,12,-8
2019-05-24,2019,WSH,MIA,12,10,-148,-1.5,135,9.0,-110,-110,138,1.5,-155,5.37,Nationals Park,22,2
2019-05-24,2019,PHI,MIL,6,4,132,1.5,-150,9.5,100,-120,-142,-1.5,130,4.09,Miller Park,10,2
2019-05-24,2019,CWS,MIN,4,11,185,1.5,-101,9.0,-115,-105,-205,-1.5,-119,3.16,Target Field,15,-7
2019-05-24,2019,DET,NYM,9,8,250,1.5,122,8.0,-105,-115,-290,-1.5,-142,2.29,Citi Field,17,1
2019-05-24,2019,SEA,OAK,2,6,148,1.5,-140,9.5,-115,-105,-158,-1.5,120,3.83,Oakland Coliseum,8,-4
2019-05-24,2019,MIL,PHI,4,6,-142,-1.5,130,9.5,100,-120,132,1.5,-150,5.57,Miller Park,10,-2
2019-05-24,2019,LAD,PIT,10,2,-190,-1.5,-133,9.0,-105,-115,175,1.5,113,5.9,PNC Park,12,8
2019-05-24,2019,TOR,SD,3,6,110,1.5,-149,8.5,-120,100,-120,-1.5,129,4.05,Rogers Centre,9,-3
2019-05-24,2019,OAK,SEA,6,2,-158,-1.5,120,9.5,-115,-105,148,1.5,-140,5.82,Oakland Coliseum,8,4
2019-05-24,2019,ARI,SF,18,2,-138,-1.5,120,6.5,-120,100,128,1.5,-140,3.77,AT&T Park,20,16
2019-05-24,2019,ATL,STL,5,2,138,1.5,-158,10.0,100,-120,-148,-1.5,138,4.2,Busch Stadium,7,3
2019-05-24,2019,CLE,TB,3,1,120,1.5,-148,7.5,100,-120,-130,-1.5,128,3.41,Progressive Field,4,2
2019-05-24,2019,LAA,TEX,3,4,-162,-1.5,115,9.5,-105,-115,152,1.5,-135,5.87,Angel Stadium,7,-1
2019-05-24,2019,SD,TOR,6,3,-120,-1.5,129,8.5,-120,100,110,1.5,-149,4.64,Rogers Centre,9,3
2019-05-24,2019,MIA,WSH,10,12,138,1.5,-155,9.0,-110,-110,-148,-1.5,135,3.78,Nationals Park,22,-2
2019-05-25,2019,SF,ARI,4,10,-115,-1.5,180,8.0,-115,-105,105,1.5,-215,4.28,AT&T Park,14,-6
2019-05-25,2019,STL,ATL,6,3,108,1.5,-156,9.5,-110,-110,-118,-1.5,136,4.57,Busch Stadium,9,3
2019-05-25,2019,COL,BAL,6,9,-168,-1.5,100,12.0,100,-120,158,1.5,-120,7.52,Coors Field,15,-3
2019-05-25,2019,HOU,BOS,4,3,-130,-1.5,163,8.5,-120,100,120,1.5,-190,4.8,Minute Maid Park,7,1
2019-05-25,2019,CIN,CHC,6,8,131,1.5,-145,11.0,100,-120,-141,-1.5,125,4.76,Wrigley Field,14,-2
2019-05-25,2019,CHC,CIN,8,6,-141,-1.5,125,11.0,100,-120,131,1.5,-145,6.44,Wrigley Field,14,2
2019-05-25,2019,TB,CLE,6,2,110,1.5,-200,8.5,-120,100,-120,-1.5,170,4.05,Progressive Field,8,4
2019-05-25,2019,BAL,COL,9,6,158,1.5,-120,12.0,100,-120,-168,-1.5,100,4.65,Coors Field,15,3
2019-05-25,2019,MIN,CWS,8,1,-215,-1.5,-125,10.5,-105,-115,195,1.5,105,7.17,Target Field,9,7
2019-05-25,2019,NYM,DET,5,4,-180,-1.5,101,9.0,100,-120,165,1.5,-120,5.79,Citi Field,9,1
2019-05-25,2019,BOS,HOU,3,4,120,1.5,-190,8.5,-120,100,-130,-1.5,163,3.86,Minute Maid Park,7,-1
2019-05-25,2019,NYY,KC,7,3,-132,-1.5,120,9.5,-120,100,122,1.5,-140,5.41,Kauffman Stadium,10,4
2019-05-25,2019,NYY,KC,6,5,-155,-1.5,-111,9.5,-110,-110,145,1.5,-109,5.77,Kauffman Stadium,11,1
2019-05-25,2019,TEX,LAA,2,3,-105,1.5,-213,8.5,100,-120,-105,-1.5,178,4.35,Angel Stadium,5,-1
2019-05-25,2019,PIT,LAD,2,7,170,1.5,120,8.0,-115,-105,-185,-1.5,-140,2.96,PNC Park,9,-5
2019-05-25,2019,WSH,MIA,5,0,-230,-1.5,-125,9.0,-105,-115,205,1.5,105,6.27,Nationals Park,5,5
2019-05-25,2019,PHI,MIL,7,2,123,1.5,-170,10.0,-110,-110,-133,-1.5,148,4.48,Miller Park,9,5
2019-05-25,2019,CWS,MIN,1,8,195,1.5,105,10.5,-105,-115,-215,-1.5,-125,3.56,Target Field,9,-7
2019-05-25,2019,DET,NYM,4,5,165,1.5,-120,9.0,100,-120,-180,-1.5,101,3.4,Citi Field,9,-1
2019-05-25,2019,KC,NYY,3,7,122,1.5,-140,9.5,-120,100,-132,-1.5,120,4.28,Kauffman Stadium,10,-4
2019-05-25,2019,KC,NYY,5,6,145,1.5,-109,9.5,-110,-110,-155,-1.5,-111,3.88,Kauffman Stadium,11,-1
2019-05-25,2019,SEA,OAK,5,6,109,1.5,-185,9.5,100,-120,-119,-1.5,160,4.55,Oakland Coliseum,11,-1
2019-05-25,2019,MIL,PHI,2,7,-133,-1.5,148,10.0,-110,-110,123,1.5,-170,5.71,Miller Park,9,-5
2019-05-25,2019,LAD,PIT,7,2,-185,-1.5,-140,8.0,-115,-105,170,1.5,120,5.19,PNC Park,9,5
2019-05-25,2019,TOR,SD,4,19,-101,1.5,-168,10.0,100,-120,-109,-1.5,146,5.02,Rogers Centre,23,-15
2019-05-25,2019,OAK,SEA,6,5,-119,-1.5,160,9.5,100,-120,109,1.5,-185,5.16,Oakland Coliseum,11,1
2019-05-25,2019,ARI,SF,10,4,105,1.5,-215,8.0,-115,-105,-115,-1.5,180,3.9,AT&T Park,14,6
2019-05-25,2019,ATL,STL,3,6,-118,-1.5,136,9.5,-110,-110,108,1.5,-156,5.14,Busch Stadium,9,-3
2019-05-25,2019,CLE,TB,2,6,-120,-1.5,170,8.5,-120,100,110,1.5,-200,4.64,Progressive Field,8,-4
2019-05-25,2019,LAA,TEX,3,2,-105,-1.5,178,8.5,100,-120,-105,1.5,-213,4.35,Angel Stadium,5,1
2019-05-25,2019,SD,TOR,19,4,-109,-1.5,146,10.0,100,-120,-101,1.5,-168,5.22,Rogers Centre,23,15
2019-05-25,2019,MIA,WSH,0,5,205,1.5,105,9.0,-105,-115,-230,-1.5,-125,2.95,Nationals Park,5,-5
2019-05-26,2019,SF,ARI,2,6,-105,1.5,-170,7.0,100,-120,-105,-1.5,148,3.59,AT&T Park,8,-4
2019-05-26,2019,STL,ATL,3,4,-138,-1.5,140,9.0,-105,-115,128,1.5,-160,5.22,Busch Stadium,7,-1
2019-05-26,2019,COL,BAL,8,7,-340,-1.5,-174,12.0,-105,-115,290,1.5,151,9.27,Coors Field,15,1
2019-05-26,2019,HOU,BOS,1,4,-160,-1.5,120,8.0,-115,-105,150,1.5,-140,4.92,Minute Maid Park,5,-3
2019-05-26,2019,CIN,CHC,10,2,150,1.5,-146,7.5,100,-120,-160,-1.5,126,3.0,Wrigley Field,12,8
2019-05-26,2019,CHC,CIN,2,10,-160,-1.5,126,7.5,100,-120,150,1.5,-146,4.62,Wrigley Field,12,-8
2019-05-26,2019,TB,CLE,6,3,-104,-1.5,151,8.5,-110,-110,-106,1.5,-175,4.33,Progressive Field,9,3
2019-05-26,2019,BAL,COL,7,8,290,1.5,151,12.0,-105,-115,-340,-1.5,-174,3.08,Coors Field,15,-1
2019-05-26,2019,MIN,CWS,7,0,-250,-1.5,-143,10.0,-105,-115,220,1.5,123,7.14,Target Field,7,7
2019-05-26,2019,NYM,DET,4,3,-165,-1.5,120,7.5,-110,-110,155,1.5,-140,4.67,Citi Field,7,1
2019-05-26,2019,BOS,HOU,4,1,150,1.5,-140,8.0,-115,-105,-160,-1.5,120,3.2,Minute Maid Park,5,3
2019-05-26,2019,NYY,KC,7,8,-160,-1.5,-115,9.5,100,-120,150,1.5,-105,5.85,Kauffman Stadium,15,-1
2019-05-26,2019,TEX,LAA,6,7,150,1.5,-140,9.0,100,-120,-160,-1.5,120,3.6,Angel Stadium,13,-1
2019-05-26,2019,PIT,LAD,7,11,149,1.5,-110,9.0,-120,100,-159,-1.5,-110,3.61,PNC Park,18,-4
2019-05-26,2019,WSH,MIA,9,6,-130,-1.5,140,8.5,-120,100,120,1.5,-159,4.8,Nationals Park,15,3
2019-05-26,2019,PHI,MIL,1,9,145,1.5,-150,9.0,100,-120,-155,-1.5,130,3.67,Miller Park,10,-8
2019-05-26,2019,CWS,MIN,0,7,220,1.5,123,10.0,-105,-115,-250,-1.5,-143,3.13,Target Field,7,-7
2019-05-26,2019,DET,NYM,3,4,155,1.5,-140,7.5,-110,-110,-165,-1.5,120,2.94,Citi Field,7,-1
2019-05-26,2019,KC,NYY,8,7,150,1.5,-105,9.5,100,-120,-160,-1.5,-115,3.8,Kauffman Stadium,15,1
2019-05-26,2019,SEA,OAK,1,7,125,1.5,-175,9.5,100,-120,-135,-1.5,151,4.22,Oakland Coliseum,8,-6
2019-05-26,2019,MIL,PHI,9,1,-155,-1.5,130,9.0,100,-120,145,1.5,-150,5.47,Miller Park,10,8
2019-05-26,2019,LAD,PIT,11,7,-159,-1.5,-110,9.0,-120,100,149,1.5,-110,5.53,PNC Park,18,4
2019-05-26,2019,TOR,SD,10,1,-115,-1.5,176,8.5,100,-120,105,1.5,-210,4.55,Rogers Centre,11,9
2019-05-26,2019,OAK,SEA,7,1,-135,-1.5,151,9.5,100,-120,125,1.5,-175,5.46,Oakland Coliseum,8,6
2019-05-26,2019,ARI,SF,6,2,-105,-1.5,148,7.0,100,-120,-105,1.5,-170,3.59,AT&T Park,8,4
2019-05-26,2019,ATL,STL,4,3,128,1.5,-160,9.0,-105,-115,-138,-1.5,140,3.95,Busch Stadium,7,1
2019-05-26,2019,CLE,TB,3,6,-106,1.5,-175,8.5,-110,-110,-104,-1.5,151,4.37,Progressive Field,9,-3
2019-05-26,2019,LAA,TEX,7,6,-160,-1.5,120,9.0,100,-120,150,1.5,-140,5.54,Angel Stadium,13,1
2019-05-26,2019,SD,TOR,1,10,105,1.5,-210,8.5,100,-120,-115,-1.5,176,4.15,Rogers Centre,11,-9
2019-05-26,2019,MIA,WSH,6,9,120,1.5,-159,8.5,-120,100,-130,-1.5,140,3.86,Nationals Park,15,-3
2019-05-27,2019,COL,ARI,4,3,-106,-1.5,172,10.0,-115,-105,-107,1.5,-205,5.15,Coors Field,7,1
2019-05-27,2019,DET,BAL,3,5,-104,-1.5,144,9.5,105,-125,-106,1.5,-165,4.84,Camden Yards,8,-2
2019-05-27,2019,CLE,BOS,5,12,165,1.5,-119,10.5,-105,-115,-180,-1.5,-101,3.96,Fenway Park,17,-7
2019-05-27,2019,HOU,CHC,6,5,-174,-1.5,110,8.0,-110,-110,162,1.5,-130,5.08,Minute Maid Park,11,1
2019-05-27,2019,PIT,CIN,8,5,185,1.5,-107,9.5,100,-120,-205,-1.5,-113,3.33,Great American Ballpark,13,3
2019-05-27,2019,PIT,CIN,1,8,155,1.5,-135,9.0,-105,-115,-165,-1.5,115,3.53,Great American Ballpark,9,-7
2019-05-27,2019,BOS,CLE,12,5,-180,-1.5,-101,10.5,-105,-115,165,1.5,-119,6.75,Fenway Park,17,7
2019-05-27,2019,ARI,COL,3,4,-107,1.5,-205,10.0,-115,-105,-106,-1.5,172,5.17,Coors Field,7,-1
2019-05-27,2019,KC,CWS,1,2,104,1.5,-185,9.5,-105,-115,-114,-1.5,160,4.66,Guaranteed Rate Field,3,-1
2019-05-27,2019,BAL,DET,5,3,-106,1.5,-165,9.5,105,-125,-104,-1.5,144,4.89,Camden Yards,8,2
2019-05-27,2019,CHC,HOU,5,6,162,1.5,-130,8.0,-110,-110,-174,-1.5,110,3.05,Minute Maid Park,11,-1
2019-05-27,2019,CWS,KC,2,1,-114,-1.5,160,9.5,-105,-115,104,1.5,-185,5.06,Guaranteed Rate Field,3,1
2019-05-27,2019,OAK,LAA,8,5,-150,-1.5,132,9.0,-105,-115,140,1.5,-152,5.4,Oakland Coliseum,13,3
2019-05-27,2019,NYM,LAD,5,9,170,1.5,-147,6.5,-120,100,-185,-1.5,127,2.41,Dodger Stadium,14,-4
2019-05-27,2019,WSH,MIA,2,3,-310,-1.5,-150,8.0,-120,100,270,1.5,130,6.05,Nationals Park,5,-1
2019-05-27,2019,MIN,MIL,4,5,110,1.5,-159,9.5,100,-120,-120,-1.5,139,4.52,Target Field,9,-1
2019-05-27,2019,MIL,MIN,5,4,-120,-1.5,139,9.5,100,-120,110,1.5,-159,5.18,Target Field,9,1
2019-05-27,2019,LAD,NYM,9,5,-185,-1.5,127,6.5,-120,100,170,1.5,-147,4.22,Dodger Stadium,14,4
2019-05-27,2019,SD,NYY,2,5,115,1.5,-178,10.0,100,-120,-125,-1.5,154,4.65,Yankee Stadium,7,-3
2019-05-27,2019,LAA,OAK,5,8,140,1.5,-152,9.0,-105,-115,-150,-1.5,132,3.75,Oakland Coliseum,13,-3
2019-05-27,2019,CIN,PIT,5,8,-205,-1.5,-113,9.5,100,-120,185,1.5,-107,6.39,Great American Ballpark,13,-3
2019-05-27,2019,CIN,PIT,8,1,-165,-1.5,115,9.0,-105,-115,155,1.5,-135,5.6,Great American Ballpark,9,7
2019-05-27,2019,NYY,SD,5,2,-125,-1.5,154,10.0,100,-120,115,1.5,-178,5.56,Yankee Stadium,7,3
2019-05-27,2019,TEX,SEA,2,6,113,1.5,-195,9.5,-110,-110,-123,-1.5,166,4.46,T-Mobile Park,8,-4
2019-05-27,2019,TOR,TB,3,8,165,1.5,-120,8.0,-115,-105,-180,-1.5,100,3.02,Tropicana Field,11,-5
2019-05-27,2019,SEA,TEX,6,2,-123,-1.5,166,9.5,-110,-110,113,1.5,-195,5.24,T-Mobile Park,8,4
2019-05-27,2019,TB,TOR,8,3,-180,-1.5,100,8.0,-115,-105,165,1.5,-120,5.14,Tropicana Field,11,5
2019-05-27,2019,MIA,WSH,3,2,270,1.5,130,8.0,-120,100,-310,-1.5,-150,2.16,Nationals Park,5,1
2019-05-28,2019,COL,ARI,6,2,-138,-1.5,138,11.5,-110,-110,128,1.5,-158,6.67,Coors Field,8,4
2019-05-28,2019,WSH,ATL,5,4,110,1.5,-200,9.0,-115,-105,-120,-1.5,170,4.29,Suntrust Park,9,1
2019-05-28,2019,DET,BAL,3,0,-112,-1.5,148,9.0,105,-125,102,1.5,-170,4.75,Camden Yards,3,3
2019-05-28,2019,CLE,BOS,7,5,180,1.5,-115,9.0,-110,-110,-200,-1.5,-105,3.21,Fenway Park,12,2
2019-05-28,2019,HOU,CHC,9,6,-132,-1.5,170,9.0,-110,-110,122,1.5,-200,5.12,Minute Maid Park,15,3
2019-05-28,2019,PIT,CIN,6,11,-108,1.5,-190,10.0,-110,-110,-102,-1.5,163,5.19,Great American Ballpark,17,-5
2019-05-28,2019,BOS,CLE,5,7,-200,-1.5,-105,9.0,-110,-110,180,1.5,-115,6.0,Fenway Park,12,-2
2019-05-28,2019,ARI,COL,2,6,128,1.5,-158,11.5,-110,-110,-138,-1.5,138,5.04,Coors Field,8,-4
2019-05-28,2019,KC,CWS,3,4,149,1.5,-145,8.5,100,-120,-159,-1.5,125,3.41,Guaranteed Rate Field,7,-1
2019-05-28,2019,BAL,DET,0,3,102,1.5,-170,9.0,105,-125,-112,-1.5,148,4.46,Camden Yards,3,-3
2019-05-28,2019,CHC,HOU,6,9,122,1.5,-200,9.0,-110,-110,-132,-1.5,170,4.05,Minute Maid Park,15,-3
2019-05-28,2019,CWS,KC,4,3,-159,-1.5,125,8.5,100,-120,149,1.5,-145,5.22,Guaranteed Rate Field,7,1
2019-05-28,2019,OAK,LAA,4,6,-180,-1.5,108,9.0,-105,-115,165,1.5,-128,5.79,Oakland Coliseum,10,-2
2019-05-28,2019,NYM,LAD,7,3,180,1.5,-120,8.0,-110,-110,-200,-1.5,100,2.86,Dodger Stadium,10,4
2019-05-28,2019,SF,MIA,3,11,-103,1.5,-210,7.5,-110,-110,-107,-1.5,176,3.81,Marlins Park,14,-8
2019-05-28,2019,MIN,MIL,5,3,105,1.5,-155,10.0,-115,-105,-115,-1.5,135,4.88,Target Field,8,2
2019-05-28,2019,MIL,MIN,3,5,-115,-1.5,135,10.0,-115,-105,105,1.5,-155,5.35,Target Field,8,-2
2019-05-28,2019,LAD,NYM,3,7,-200,-1.5,100,8.0,-110,-110,180,1.5,-120,5.33,Dodger Stadium,10,-4
2019-05-28,2019,SD,NYY,5,4,175,1.5,-115,9.5,100,-120,-190,-1.5,-105,3.45,Yankee Stadium,9,1
2019-05-28,2019,LAA,OAK,6,4,165,1.5,-128,9.0,-105,-115,-180,-1.5,108,3.4,Oakland Coliseum,10,2
2019-05-28,2019,STL,PHI,3,4,105,1.5,-175,10.5,-105,-115,-115,-1.5,151,5.12,Citizens Bank Park,7,-1
2019-05-28,2019,CIN,PIT,11,6,-102,-1.5,163,10.0,-110,-110,-108,1.5,-190,5.05,Great American Ballpark,17,5
2019-05-28,2019,NYY,SD,4,5,-190,-1.5,-105,9.5,100,-120,175,1.5,-115,6.22,Yankee Stadium,9,-1
2019-05-28,2019,TEX,SEA,11,4,145,1.5,-140,9.5,-115,-105,-155,-1.5,120,3.88,T-Mobile Park,15,7
2019-05-28,2019,MIA,SF,11,3,-107,-1.5,176,7.5,-110,-110,-103,1.5,-210,3.88,Marlins Park,14,8
2019-05-28,2019,PHI,STL,4,3,-115,-1.5,151,10.5,-105,-115,105,1.5,-175,5.62,Citizens Bank Park,7,1
2019-05-28,2019,TOR,TB,1,3,178,1.5,-110,8.5,-105,-115,-196,-1.5,-110,3.06,Tropicana Field,4,-2
2019-05-28,2019,SEA,TEX,4,11,-155,-1.5,120,9.5,-115,-105,145,1.5,-140,5.77,T-Mobile Park,15,-7
2019-05-28,2019,TB,TOR,3,1,-196,-1.5,-110,8.5,-105,-115,178,1.5,-110,5.63,Tropicana Field,4,2
2019-05-28,2019,ATL,WSH,4,5,-120,-1.5,170,9.0,-115,-105,110,1.5,-200,4.91,Suntrust Park,9,-1
2019-05-29,2019,COL,ARI,5,4,105,1.5,-148,11.0,-105,-115,-115,-1.5,128,5.37,Coors Field,9,1
2019-05-29,2019,WSH,ATL,14,4,154,1.5,-133,10.5,-105,-115,-164,-1.5,114,4.13,Suntrust Park,18,10
2019-05-29,2019,DET,BAL,4,2,118,1.5,-151,9.5,-120,100,-128,-1.5,131,4.36,Camden Yards,6,2
2019-05-29,2019,CLE,BOS,14,9,-101,-1.5,148,9.0,-110,-110,-109,1.5,-170,4.52,Fenway Park,23,5
2019-05-29,2019,HOU,CHC,1,2,-105,1.5,-165,9.0,-110,-110,-105,-1.5,144,4.61,Minute Maid Park,3,-1
2019-05-29,2019,PIT,CIN,7,2,135,1.5,-150,10.0,-115,-105,-145,-1.5,130,4.26,Great American Ballpark,9,5
2019-05-29,2019,BOS,CLE,9,14,-109,1.5,-170,9.0,-110,-110,-101,-1.5,148,4.69,Fenway Park,23,-5
2019-05-29,2019,ARI,COL,4,5,-115,-1.5,128,11.0,-105,-115,105,1.5,-148,5.88,Coors Field,9,-1
2019-05-29,2019,KC,CWS,7,8,110,1.5,-200,9.0,-120,100,-120,-1.5,170,4.29,Guaranteed Rate Field,15,-1
2019-05-29,2019,BAL,DET,2,4,-128,-1.5,131,9.5,-120,100,118,1.5,-151,5.33,Camden Yards,6,-2
2019-05-29,2019,CHC,HOU,2,1,-105,-1.5,144,9.0,-110,-110,-105,1.5,-165,4.61,Minute Maid Park,3,1
2019-05-29,2019,CWS,KC,8,7,-120,-1.5,170,9.0,-120,100,110,1.5,-200,4.91,Guaranteed Rate Field,15,1
2019-05-29,2019,OAK,LAA,7,12,-134,-1.5,148,9.0,100,-120,124,1.5,-170,5.15,Oakland Coliseum,19,-5
2019-05-29,2019,NYM,LAD,8,9,165,1.5,-136,7.5,-115,-105,-180,-1.5,116,2.83,Dodger Stadium,17,-1
2019-05-29,2019,SF,MIA,2,4,-120,-1.5,144,7.0,-110,-110,110,1.5,-165,3.82,Marlins Park,6,-2
2019-05-29,2019,LAD,NYM,9,8,-180,-1.5,116,7.5,-115,-105,165,1.5,-136,4.82,Dodger Stadium,17,1
2019-05-29,2019,SD,NYY,0,7,125,1.5,-174,7.5,-120,100,-135,-1.5,150,3.33,Yankee Stadium,7,-7
2019-05-29,2019,LAA,OAK,12,7,124,1.5,-170,9.0,100,-120,-134,-1.5,148,4.02,Oakland Coliseum,19,5
2019-05-29,2019,STL,PHI,4,11,165,1.5,-119,10.0,100,-120,-180,-1.5,-101,3.77,Citizens Bank Park,15,-7
2019-05-29,2019,CIN,PIT,2,7,-145,-1.5,130,10.0,-115,-105,135,1.5,-150,5.92,Great American Ballpark,9,-5
2019-05-29,2019,NYY,SD,7,0,-135,-1.5,150,7.5,-120,100,125,1.5,-174,4.31,Yankee Stadium,7,7
2019-05-29,2019,TEX,SEA,8,7,125,1.5,-163,9.5,100,-120,-135,-1.5,142,4.22,T-Mobile Park,15,1
2019-05-29,2019,MIA,SF,4,2,110,1.5,-165,7.0,-110,-110,-120,-1.5,144,3.33,Marlins Park,6,2
2019-05-29,2019,PHI,STL,11,4,-180,-1.5,-101,10.0,100,-120,165,1.5,-119,6.43,Citizens Bank Park,15,7
2019-05-29,2019,TOR,TB,3,4,210,1.5,115,7.0,-120,100,-240,-1.5,-135,2.26,Tropicana Field,7,-1
2019-05-29,2019,SEA,TEX,7,8,-135,-1.5,142,9.5,100,-120,125,1.5,-163,5.46,T-Mobile Park,15,-1
2019-05-29,2019,TB,TOR,4,3,-240,-1.5,-135,7.0,-120,100,210,1.5,115,4.94,Tropicana Field,7,1
2019-05-29,2019,ATL,WSH,4,14,-164,-1.5,114,10.5,-105,-115,154,1.5,-133,6.52,Suntrust Park,18,-10
2019-05-30,2019,COL,ARI,11,10,-120,-1.5,151,12.0,-105,-115,110,1.5,-175,6.55,Coors Field,21,1
2019-05-30,2019,CWS,CLE,10,4,175,1.5,111,8.5,-115,-105,-190,-1.5,-131,3.09,Guaranteed Rate Field,14,6
2019-05-30,2019,ARI,COL,10,11,110,1.5,-175,12.0,-105,-115,-120,-1.5,151,5.71,Coors Field,21,-1
2019-05-30,2019,CLE,CWS,4,10,-190,-1.5,-131,8.5,-115,-105,175,1.5,111,5.57,Guaranteed Rate Field,14,-6
2019-05-30,2019,TEX,KC,2,4,-168,-1.5,101,10.0,100,-120,158,1.5,-121,6.27,Rangers Ballpark,6,-2
2019-05-30,2019,SEA,LAA,3,9,-134,-1.5,148,9.0,-130,110,124,1.5,-170,5.15,T-Mobile Park,12,-6
2019-05-30,2019,NYM,LAD,0,2,220,1.5,110,8.5,-110,-110,-250,-1.5,-130,2.66,Dodger Stadium,2,-2
2019-05-30,2019,SF,MIA,3,1,-105,1.5,-210,7.5,-105,-105,-105,-1.5,176,3.84,Marlins Park,4,2
2019-05-30,2019,PIT,MIL,5,11,110,1.5,-150,9.0,-115,-105,-120,-1.5,130,4.29,PNC Park,16,-6
2019-05-30,2019,TB,MIN,14,3,-153,-1.5,120,8.0,100,-120,143,1.5,-140,4.84,Tropicana Field,17,11
2019-05-30,2019,LAD,NYM,2,0,-250,-1.5,-130,8.5,-110,-110,220,1.5,110,6.07,Dodger Stadium,2,2
2019-05-30,2019,STL,PHI,5,3,-107,1.5,-215,10.5,-105,-115,-103,-1.5,180,5.43,Citizens Bank Park,8,2
2019-05-30,2019,MIL,PIT,11,5,-120,-1.5,130,9.0,-115,-105,110,1.5,-150,4.91,PNC Park,16,6
2019-05-30,2019,LAA,SEA,9,3,124,1.5,-170,9.0,-130,110,-134,-1.5,148,4.02,T-Mobile Park,12,6
2019-05-30,2019,MIA,SF,1,3,-105,-1.5,176,7.5,-105,-105,-105,1.5,-210,3.84,Marlins Park,4,-2
2019-05-30,2019,PHI,STL,3,5,-103,-1.5,180,10.5,-105,-115,-107,1.5,-215,5.33,Citizens Bank Park,8,-2
2019-05-30,2019,MIN,TB,3,14,143,1.5,-140,8.0,100,-120,-153,-1.5,120,3.29,Tropicana Field,17,-11
2019-05-30,2019,KC,TEX,4,2,158,1.5,-121,10.0,100,-120,-168,-1.5,101,3.88,Rangers Ballpark,6,2
2019-05-31,2019,NYM,ARI,5,4,-115,-1.5,140,9.0,-110,-110,105,1.5,-160,4.81,Chase Field,9,1
2019-05-31,2019,DET,ATL,8,2,175,1.5,-115,9.5,110,-130,-190,-1.5,-105,3.45,Suntrust Park,10,6
2019-05-31,2019,SF,BAL,6,9,-108,-1.5,136,9.0,-115,-105,-102,1.5,-156,4.67,Camden Yards,15,-3
2019-05-31,2019,NYY,BOS,4,1,132,1.5,-120,9.0,110,-130,-142,-1.5,100,3.88,Yankee Stadium,5,3
2019-05-31,2019,STL,CHC,2,1,-127,-1.5,149,9.0,105,-125,117,1.5,-172,5.04,Busch Stadium,3,1
2019-05-31,2019,WSH,CIN,3,9,-125,-1.5,135,9.0,-105,-115,115,1.5,-155,5.0,Great American Ballpark,12,-6
2019-05-31,2019,CWS,CLE,6,1,150,1.5,-110,10.0,-105,-115,-160,-1.5,-110,4.0,Guaranteed Rate Field,7,5
2019-05-31,2019,TOR,COL,6,13,255,1.5,137,12.0,-105,-115,-295,-1.5,-157,3.38,Coors Field,19,-7
2019-05-31,2019,CLE,CWS,1,6,-160,-1.5,-110,10.0,-105,-115,150,1.5,-110,6.15,Guaranteed Rate Field,7,-5
2019-05-31,2019,ATL,DET,2,8,-190,-1.5,-105,9.5,110,-130,175,1.5,-115,6.22,Suntrust Park,10,-6
2019-05-31,2019,OAK,HOU,2,3,112,1.5,-163,8.5,-125,105,-122,-1.5,141,4.01,Oakland Coliseum,5,-1
2019-05-31,2019,TEX,KC,6,2,-108,-1.5,160,10.5,-105,-115,-102,1.5,-186,5.45,Rangers Ballpark,8,4
2019-05-31,2019,SEA,LAA,4,3,115,1.5,-146,9.5,-110,-110,-125,-1.5,126,4.42,T-Mobile Park,7,1
2019-05-31,2019,PHI,LAD,3,6,141,1.5,-140,9.0,-105,-115,-151,-1.5,120,3.73,Dodger Stadium,9,-3
2019-05-31,2019,SD,MIA,5,2,-165,-1.5,121,7.0,-110,-110,155,1.5,-142,4.36,PETCO Park,7,3
2019-05-31,2019,PIT,MIL,9,4,123,1.5,-130,9.5,100,-120,-133,-1.5,110,4.26,PNC Park,13,5
2019-05-31,2019,TB,MIN,3,5,-125,-1.5,155,8.0,-120,100,115,1.5,-180,4.44,Tropicana Field,8,-2
2019-05-31,2019,ARI,NYM,4,5,105,1.5,-160,9.0,-110,-110,-115,-1.5,140,4.39,Chase Field,9,-1
2019-05-31,2019,BOS,NYY,1,4,-142,-1.5,100,9.0,110,-130,132,1.5,-120,5.28,Yankee Stadium,5,-3
2019-05-31,2019,HOU,OAK,3,2,-122,-1.5,141,8.5,-125,105,112,1.5,-163,4.67,Oakland Coliseum,5,1
2019-05-31,2019,LAD,PHI,6,3,-151,-1.5,120,9.0,-105,-115,141,1.5,-140,5.41,Dodger Stadium,9,3
2019-05-31,2019,MIL,PIT,4,9,-133,-1.5,110,9.5,100,-120,123,1.5,-130,5.42,PNC Park,13,-5
2019-05-31,2019,MIA,SD,2,5,155,1.5,-142,7.0,-110,-110,-165,-1.5,121,2.75,PETCO Park,7,-3
2019-05-31,2019,LAA,SEA,3,4,-125,-1.5,126,9.5,-110,-110,115,1.5,-146,5.28,T-Mobile Park,7,-1
2019-05-31,2019,BAL,SF,9,6,-102,1.5,-156,9.0,-115,-105,-108,-1.5,136,4.54,Camden Yards,15,3
2019-05-31,2019,CHC,STL,1,2,117,1.5,-172,9.0,105,-125,-127,-1.5,149,4.15,Busch Stadium,3,-1
2019-05-31,2019,MIN,TB,5,3,115,1.5,-180,8.0,-120,100,-125,-1.5,155,3.72,Tropicana Field,8,2
2019-05-31,2019,KC,TEX,2,6,-102,1.5,-186,10.5,-105,-115,-108,-1.5,160,5.3,Rangers Ballpark,8,-4
2019-05-31,2019,COL,TOR,13,6,-295,-1.5,-157,12.0,-105,-115,255,1.5,137,8.96,Coors Field,19,7
2019-05-31,2019,CIN,WSH,9,3,115,1.5,-155,9.0,-105,-115,-125,-1.5,135,4.19,Great American Ballpark,12,6
2019-06-01,2019,NYM,ARI,5,6,102,1.5,-225,7.5,-120,100,-112,-1.5,188,3.71,Chase Field,11,-1
2019-06-01,2019,DET,ATL,5,10,245,1.5,120,9.5,100,-120,-280,-1.5,-140,2.75,Suntrust Park,15,-5
2019-06-01,2019,SF,BAL,8,2,-136,-1.5,110,10.5,-110,-110,126,1.5,-130,6.05,Camden Yards,10,6
2019-06-01,2019,NYY,BOS,5,3,-126,-1.5,138,9.5,-115,-105,116,1.5,-158,5.3,Yankee Stadium,8,2
2019-06-01,2019,STL,CHC,7,4,-153,-1.5,135,9.0,100,-120,143,1.5,-155,5.44,Busch Stadium,11,3
2019-06-01,2019,WSH,CIN,5,2,115,1.5,-165,10.5,-115,-105,-125,-1.5,144,4.88,Great American Ballpark,7,3
2019-06-01,2019,CWS,CLE,2,5,-105,1.5,-160,10.5,-120,100,-105,-1.5,140,5.38,Guaranteed Rate Field,7,-3
2019-06-01,2019,TOR,COL,2,4,140,1.5,-130,10.5,-120,100,-150,-1.5,110,4.38,Coors Field,6,-2
2019-06-01,2019,CLE,CWS,5,2,-105,-1.5,140,10.5,-120,100,-105,1.5,-160,5.38,Guaranteed Rate Field,7,3
2019-06-01,2019,ATL,DET,10,5,-280,-1.5,-140,9.5,100,-120,245,1.5,120,7.0,Suntrust Park,15,5
2019-06-01,2019,OAK,HOU,1,5,137,1.5,-126,7.5,-115,-105,-147,-1.5,106,3.16,Oakland Coliseum,6,-4
2019-06-01,2019,TEX,KC,6,2,-172,-1.5,-105,10.5,-120,100,161,1.5,-115,6.64,Rangers Ballpark,8,4
2019-06-01,2019,SEA,LAA,3,6,110,1.5,-149,9.0,-125,105,-120,-1.5,129,4.29,T-Mobile Park,9,-3
2019-06-01,2019,PHI,LAD,3,4,178,1.5,-125,8.5,-105,-115,-196,-1.5,104,3.06,Dodger Stadium,7,-1
2019-06-01,2019,SD,MIA,3,9,-152,-1.5,130,8.0,-115,-105,142,1.5,-150,4.83,PETCO Park,12,-6
2019-06-01,2019,PIT,MIL,10,12,180,1.5,111,9.5,100,-120,-200,-1.5,-131,3.39,PNC Park,22,-2
2019-06-01,2019,TB,MIN,2,6,-114,-1.5,166,8.0,-105,-115,104,1.5,-195,4.26,Tropicana Field,8,-4
2019-06-01,2019,ARI,NYM,6,5,-112,-1.5,188,7.5,-120,100,102,1.5,-225,3.96,Chase Field,11,1
2019-06-01,2019,BOS,NYY,3,5,116,1.5,-158,9.5,-115,-105,-126,-1.5,138,4.4,Yankee Stadium,8,-2
2019-06-01,2019,HOU,OAK,5,1,-147,-1.5,106,7.5,-115,-105,137,1.5,-126,4.46,Oakland Coliseum,6,4
2019-06-01,2019,LAD,PHI,4,3,-196,-1.5,104,8.5,-105,-115,178,1.5,-125,5.63,Dodger Stadium,7,1
2019-06-01,2019,MIL,PIT,12,10,-200,-1.5,-131,9.5,100,-120,180,1.5,111,6.33,PNC Park,22,2
2019-06-01,2019,MIA,SD,9,3,142,1.5,-150,8.0,-115,-105,-152,-1.5,130,3.31,PETCO Park,12,6
2019-06-01,2019,LAA,SEA,6,3,-120,-1.5,129,9.0,-125,105,110,1.5,-149,4.91,T-Mobile Park,9,3
2019-06-01,2019,BAL,SF,2,8,126,1.5,-130,10.5,-110,-110,-136,-1.5,110,4.65,Camden Yards,10,-6
2019-06-01,2019,CHC,STL,4,7,143,1.5,-155,9.0,100,-120,-153,-1.5,135,3.7,Busch Stadium,11,-3
2019-06-01,2019,MIN,TB,6,2,104,1.5,-195,8.0,-105,-115,-114,-1.5,166,3.92,Tropicana Field,8,4
2019-06-01,2019,KC,TEX,2,6,161,1.5,-115,10.5,-120,100,-172,-1.5,-105,4.02,Rangers Ballpark,8,-4
2019-06-01,2019,COL,TOR,4,2,-150,-1.5,110,10.5,-120,100,140,1.5,-130,6.3,Coors Field,6,2
2019-06-01,2019,CIN,WSH,2,5,-125,-1.5,144,10.5,-115,-105,115,1.5,-165,5.83,Great American Ballpark,7,-3
2019-06-02,2019,NYM,ARI,1,7,-102,1.5,-215,9.5,-105,-115,-108,-1.5,180,4.8,Chase Field,8,-6
2019-06-02,2019,DET,ATL,4,7,162,1.5,-130,9.0,-105,-115,-174,-1.5,110,3.44,Suntrust Park,11,-3
2019-06-02,2019,SF,BAL,8,1,-108,-1.5,140,10.0,-115,-105,-102,1.5,-160,5.19,Camden Yards,9,7
2019-06-02,2019,NYY,BOS,5,8,110,1.5,-155,10.0,-105,-115,-120,-1.5,135,4.76,Yankee Stadium,13,-3
2019-06-02,2019,STL,CHC,2,1,-105,1.5,-170,9.5,100,-120,-105,-1.5,148,4.87,Busch Stadium,3,1
2019-06-02,2019,WSH,CIN,4,1,-130,-1.5,130,8.5,-115,-105,120,1.5,-150,4.8,Great American Ballpark,5,3
2019-06-02,2019,CWS,CLE,2,0,-113,-1.5,172,8.0,-115,-105,103,1.5,-205,4.24,Guaranteed Rate Field,2,2
2019-06-02,2019,TOR,COL,1,5,132,1.5,-160,12.5,-115,-105,-142,-1.5,140,5.39,Coors Field,6,-4
2019-06-02,2019,CLE,CWS,0,2,103,1.5,-205,8.0,-115,-105,-113,-1.5,172,3.94,Guaranteed Rate Field,2,-2
2019-06-02,2019,ATL,DET,7,4,-174,-1.5,110,9.0,-105,-115,162,1.5,-130,5.72,Suntrust Park,11,3
2019-06-02,2019,OAK,HOU,4,6,122,1.5,-132,7.5,-105,-115,-132,-1.5,113,3.38,Oakland Coliseum,10,-2
2019-06-02,2019,TEX,KC,5,1,-120,-1.5,151,11.0,-105,-115,110,1.5,-175,6.0,Rangers Ballpark,6,4
2019-06-02,2019,SEA,LAA,3,13,-120,-1.5,160,10.0,-105,-115,110,1.5,-185,5.45,T-Mobile Park,16,-10
2019-06-02,2019,PHI,LAD,0,8,163,1.5,-125,9.0,-115,-105,-176,-1.5,105,3.42,Dodger Stadium,8,-8
2019-06-02,2019,SD,MIA,3,9,-180,-1.5,115,8.0,-105,-115,165,1.5,-135,5.14,PETCO Park,12,-6
2019-06-02,2019,PIT,MIL,2,4,102,1.5,-170,9.0,-125,105,-112,-1.5,148,4.46,PNC Park,6,-2
2019-06-02,2019,TB,MIN,7,9,-121,-1.5,166,8.5,-105,-115,111,1.5,-195,4.65,Tropicana Field,16,-2
2019-06-02,2019,ARI,NYM,7,1,-108,-1.5,180,9.5,-105,-115,-102,1.5,-215,4.93,Chase Field,8,6
2019-06-02,2019,BOS,NYY,8,5,-120,-1.5,135,10.0,-105,-115,110,1.5,-155,5.45,Yankee Stadium,13,3
2019-06-02,2019,HOU,OAK,6,4,-132,-1.5,113,7.5,-105,-115,122,1.5,-132,4.27,Oakland Coliseum,10,2
2019-06-02,2019,LAD,PHI,8,0,-176,-1.5,105,9.0,-115,-105,163,1.5,-125,5.74,Dodger Stadium,8,8
2019-06-02,2019,MIL,PIT,4,2,-112,-1.5,148,9.0,-125,105,102,1.5,-170,4.75,PNC Park,6,2
2019-06-02,2019,MIA,SD,9,3,165,1.5,-135,8.0,-105,-115,-180,-1.5,115,3.02,PETCO Park,12,6
2019-06-02,2019,LAA,SEA,13,3,110,1.5,-185,10.0,-105,-115,-120,-1.5,160,4.76,T-Mobile Park,16,10
2019-06-02,2019,BAL,SF,1,8,-102,1.5,-160,10.0,-115,-105,-108,-1.5,140,5.05,Camden Yards,9,-7
2019-06-02,2019,CHC,STL,1,2,-105,-1.5,148,9.5,100,-120,-105,1.5,-170,4.87,Busch Stadium,3,-1
2019-06-02,2019,MIN,TB,9,7,111,1.5,-195,8.5,-105,-115,-121,-1.5,166,4.03,Tropicana Field,16,2
2019-06-02,2019,KC,TEX,1,5,110,1.5,-175,11.0,-105,-115,-120,-1.5,151,5.24,Rangers Ballpark,6,-4
2019-06-02,2019,COL,TOR,5,1,-142,-1.5,140,12.5,-115,-105,132,1.5,-160,7.33,Coors Field,6,4
2019-06-02,2019,CIN,WSH,1,4,120,1.5,-150,8.5,-115,-105,-130,-1.5,130,3.86,Great American Ballpark,5,-3
2019-06-03,2019,LAD,ARI,3,1,-130,-1.5,129,8.5,-105,-115,120,1.5,-149,4.8,Chase Field,4,2
2019-06-03,2019,LAA,CHC,1,8,160,1.5,-145,9.0,-105,-115,-170,-1.5,125,3.46,Wrigley Field,9,-7
2019-06-03,2019,SEA,HOU,2,4,112,1.5,-138,9.5,-120,100,-122,-1.5,118,4.48,T-Mobile Park,6,-2
2019-06-03,2019,CHC,LAA,8,1,-170,-1.5,125,9.0,-105,-115,160,1.5,-145,5.67,Wrigley Field,9,7
2019-06-03,2019,ARI,LAD,1,3,120,1.5,-149,8.5,-105,-115,-130,-1.5,129,3.86,Chase Field,4,-2
2019-06-03,2019,SD,PHI,8,2,123,1.5,-135,7.5,-120,100,-133,-1.5,115,3.36,PETCO Park,10,6
2019-06-03,2019,PHI,SD,2,8,-133,-1.5,115,7.5,-120,100,123,1.5,-135,4.28,PETCO Park,10,-6
2019-06-03,2019,HOU,SEA,4,2,-122,-1.5,118,9.5,-120,100,112,1.5,-138,5.22,T-Mobile Park,6,2
2019-06-04,2019,LAD,ARI,9,0,-215,-1.5,-142,10.0,-110,-110,195,1.5,122,6.83,Chase Field,9,9
2019-06-04,2019,PIT,ATL,5,12,180,1.5,120,9.0,-130,110,-200,-1.5,-140,3.21,PNC Park,17,-7
2019-06-04,2019,TEX,BAL,11,12,-131,-1.5,130,10.5,-105,-115,121,1.5,-150,5.95,Rangers Ballpark,23,-1
2019-06-04,2019,KC,BOS,3,8,180,1.5,115,10.0,100,-120,-200,-1.5,-135,3.57,Kauffman Stadium,11,-5
2019-06-04,2019,COL,CHC,3,6,190,1.5,100,10.5,-110,-110,-210,-1.5,-120,3.62,Wrigley Field,9,-3
2019-06-04,2019,STL,CIN,1,4,-108,-1.5,170,8.5,-120,100,-102,1.5,-200,4.41,Busch Stadium,5,-3
2019-06-04,2019,MIN,CLE,2,5,118,1.5,-180,9.0,-115,-105,-128,-1.5,155,4.13,Progressive Field,7,-3
2019-06-04,2019,CHC,COL,6,3,-210,-1.5,-120,10.5,-110,-110,190,1.5,100,7.11,Wrigley Field,9,3
2019-06-04,2019,WSH,CWS,9,5,-250,-1.5,-125,8.5,-110,-110,220,1.5,105,6.07,Nationals Park,14,4
2019-06-04,2019,TB,DET,6,9,-265,-1.5,-167,8.5,-120,100,235,1.5,146,6.17,Comerica Park,15,-3
2019-06-04,2019,SEA,HOU,5,11,150,1.5,-113,9.5,-125,105,-160,-1.5,-107,3.8,T-Mobile Park,16,-6
2019-06-04,2019,BOS,KC,8,3,-200,-1.5,-135,10.0,100,-120,180,1.5,115,6.67,Kauffman Stadium,11,5
2019-06-04,2019,OAK,LAA,4,2,-102,-1.5,148,8.5,-125,105,-108,1.5,-170,4.29,Angel Stadium,6,2
2019-06-04,2019,ARI,LAD,0,9,195,1.5,122,10.0,-110,-110,-215,-1.5,-142,3.39,Chase Field,9,-9
2019-06-04,2019,MIL,MIA,0,16,-192,-1.5,-115,9.0,100,-120,176,1.5,-105,5.92,Miller Park,16,-16
2019-06-04,2019,MIA,MIL,16,0,176,1.5,-105,9.0,100,-120,-192,-1.5,-115,3.26,Miller Park,16,16
2019-06-04,2019,CLE,MIN,5,2,-128,-1.5,155,9.0,-115,-105,118,1.5,-180,5.05,Progressive Field,7,3
2019-06-04,2019,SF,NYM,9,3,137,1.5,-172,7.0,-115,-105,-147,-1.5,150,2.95,Citi Field,12,6
2019-06-04,2019,TOR,NYY,4,3,175,1.5,111,9.0,-115,-105,-190,-1.5,-130,3.27,Rogers Centre,7,1
2019-06-04,2019,LAA,OAK,2,4,-108,1.5,-170,8.5,-125,105,-102,-1.5,148,4.41,Angel Stadium,6,-2
2019-06-04,2019,SD,PHI,6,9,-150,-1.5,133,7.5,-130,110,140,1.5,-153,4.5,PETCO Park,15,-3
2019-06-04,2019,ATL,PIT,12,5,-200,-1.5,-140,9.0,-130,110,180,1.5,120,6.0,PNC Park,17,7
2019-06-04,2019,PHI,SD,9,6,140,1.5,-153,7.5,-130,110,-150,-1.5,133,3.13,PETCO Park,15,3
2019-06-04,2019,HOU,SEA,11,5,-160,-1.5,-107,9.5,-125,105,150,1.5,-113,5.85,T-Mobile Park,16,6
2019-06-04,2019,NYM,SF,3,9,-147,-1.5,150,7.0,-115,-105,137,1.5,-172,4.17,Citi Field,12,-6
2019-06-04,2019,CIN,STL,4,1,-102,1.5,-200,8.5,-120,100,-108,-1.5,170,4.29,Busch Stadium,5,3
2019-06-04,2019,DET,TB,9,6,235,1.5,146,8.5,-120,100,-265,-1.5,-167,2.54,Comerica Park,15,3
2019-06-04,2019,BAL,TEX,12,11,121,1.5,-150,10.5,-105,-115,-131,-1.5,130,4.75,Rangers Ballpark,23,1
2019-06-04,2019,NYY,TOR,3,4,-190,-1.5,-130,9.0,-115,-105,175,1.5,111,5.9,Rogers Centre,7,-1
2019-06-04,2019,CWS,WSH,5,9,220,1.5,105,8.5,-110,-110,-250,-1.5,-125,2.66,Nationals Park,14,-4
2019-06-05,2019,LAD,ARI,2,3,-164,-1.5,-111,9.5,100,-120,154,1.5,-109,5.9,Chase Field,5,-1
2019-06-05,2019,PIT,ATL,7,4,118,1.5,-139,9.5,-105,-115,-128,-1.5,119,4.36,PNC Park,11,3
2019-06-05,2019,TEX,BAL,2,1,-170,-1.5,115,9.0,-115,-105,160,1.5,-135,5.67,Rangers Ballpark,3,1
2019-06-05,2019,KC,BOS,0,8,220,1.5,130,8.5,-120,100,-250,-1.5,-150,2.66,Kauffman Stadium,8,-8
2019-06-05,2019,COL,CHC,8,9,112,1.5,-200,7.0,-120,100,-122,-1.5,170,3.3,Wrigley Field,17,-1
2019-06-05,2019,MIN,CLE,7,9,-118,-1.5,131,9.5,100,-120,108,1.5,-151,5.14,Progressive Field,16,-2
2019-06-05,2019,CHC,COL,9,8,-122,-1.5,170,7.0,-120,100,112,1.5,-200,3.85,Wrigley Field,17,1
2019-06-05,2019,WSH,CWS,6,4,-185,-1.5,-110,10.5,-105,-115,170,1.5,-110,6.82,Nationals Park,10,2
2019-06-05,2019,TB,DET,4,0,-200,-1.5,-130,8.5,-120,100,180,1.5,110,5.67,Comerica Park,4,4
2019-06-05,2019,SEA,HOU,14,1,146,1.5,-127,8.5,-115,-105,-156,-1.5,105,3.46,T-Mobile Park,15,13
2019-06-05,2019,BOS,KC,8,0,-250,-1.5,-150,8.5,-120,100,220,1.5,130,6.07,Kauffman Stadium,8,8
2019-06-05,2019,OAK,LAA,9,10,116,1.5,-177,9.0,-110,-110,-126,-1.5,152,4.17,Angel Stadium,19,-1
2019-06-05,2019,ARI,LAD,3,2,154,1.5,-109,9.5,100,-120,-164,-1.5,-111,3.74,Chase Field,5,1
2019-06-05,2019,MIL,MIA,3,8,-260,-1.5,-134,9.0,-105,-115,230,1.5,114,6.5,Miller Park,11,-5
2019-06-05,2019,MIA,MIL,8,3,230,1.5,114,9.0,-105,-115,-260,-1.5,-134,2.73,Miller Park,11,5
2019-06-05,2019,CLE,MIN,9,7,108,1.5,-151,9.5,100,-120,-118,-1.5,131,4.57,Progressive Field,16,2
2019-06-05,2019,SF,NYM,0,7,148,1.5,-145,8.5,-120,100,-158,-1.5,125,3.43,Citi Field,7,-7
2019-06-05,2019,TOR,NYY,11,7,175,1.5,106,8.5,-110,-110,-190,-1.5,-125,3.09,Rogers Centre,18,4
2019-06-05,2019,LAA,OAK,10,9,-126,-1.5,152,9.0,-110,-110,116,1.5,-177,5.02,Angel Stadium,19,1
2019-06-05,2019,SD,PHI,5,7,104,1.5,-162,8.5,-120,100,-114,-1.5,142,4.17,PETCO Park,12,-2
2019-06-05,2019,ATL,PIT,4,7,-128,-1.5,119,9.5,-105,-115,118,1.5,-139,5.33,PNC Park,11,-3
2019-06-05,2019,PHI,SD,7,5,-114,-1.5,142,8.5,-120,100,104,1.5,-162,4.53,PETCO Park,12,2
2019-06-05,2019,HOU,SEA,1,14,-156,-1.5,105,8.5,-115,-105,146,1.5,-127,5.18,T-Mobile Park,15,-13
2019-06-05,2019,NYM,SF,7,0,-158,-1.5,125,8.5,-120,100,148,1.5,-145,5.21,Citi Field,7,7
2019-06-05,2019,DET,TB,0,4,180,1.5,110,8.5,-120,100,-200,-1.5,-130,3.04,Comerica Park,4,-4
2019-06-05,2019,BAL,TEX,1,2,160,1.5,-135,9.0,-115,-105,-170,-1.5,115,3.46,Rangers Ballpark,3,-1
2019-06-05,2019,NYY,TOR,7,11,-190,-1.5,-125,8.5,-110,-110,175,1.5,106,5.57,Rogers Centre,18,-4
2019-06-05,2019,CWS,WSH,4,6,170,1.5,-110,10.5,-105,-115,-185,-1.5,-110,3.89,Nationals Park,10,-2
2019-06-06,2019,PIT,ATL,6,1,103,1.5,-160,9.5,-105,-115,-113,-1.5,140,4.68,PNC Park,7,5
2019-06-06,2019,TEX,BAL,4,3,-174,-1.5,-111,11.0,-105,-115,162,1.5,-108,6.99,Rangers Ballpark,7,1
2019-06-06,2019,KC,BOS,5,7,124,1.5,-123,10.0,-105,-115,-134,-1.5,105,4.46,Kauffman Stadium,12,-2
2019-06-06,2019,COL,CHC,3,1,175,1.5,-130,8.5,-105,-115,-190,-1.5,110,3.09,Wrigley Field,4,2
2019-06-06,2019,STL,CIN,3,1,-150,-1.5,131,9.0,-115,-105,140,1.5,-151,5.4,Busch Stadium,4,2
2019-06-06,2019,MIN,CLE,5,4,107,1.5,-215,8.5,-120,100,-117,-1.5,180,4.11,Progressive Field,9,1
2019-06-06,2019,CHC,COL,1,3,-190,-1.5,110,8.5,-105,-115,175,1.5,-130,5.57,Wrigley Field,4,-2
2019-06-06,2019,TB,DET,6,1,-176,-1.5,-125,9.0,-115,-105,163,1.5,105,5.74,Comerica Park,7,5
2019-06-06,2019,SEA,HOU,7,8,178,1.5,108,8.0,-110,-110,-196,-1.5,-128,2.88,T-Mobile Park,15,-1
2019-06-06,2019,BOS,KC,7,5,-134,-1.5,105,10.0,-105,-115,124,1.5,-123,5.73,Kauffman Stadium,12,2
2019-06-06,2019,OAK,LAA,7,4,110,1.5,-175,9.5,-105,-115,-120,-1.5,151,4.52,Angel Stadium,11,3
2019-06-06,2019,MIL,MIA,5,1,-178,-1.5,110,8.5,-105,-115,164,1.5,-130,5.44,Miller Park,6,4
2019-06-06,2019,MIA,MIL,1,5,164,1.5,-130,8.5,-105,-115,-178,-1.5,110,3.22,Miller Park,6,-4
2019-06-06,2019,CLE,MIN,4,5,-117,-1.5,180,8.5,-120,100,107,1.5,-215,4.58,Progressive Field,9,-1
2019-06-06,2019,SF,NYM,3,7,155,1.5,-140,7.5,-110,-110,-165,-1.5,120,2.94,Citi Field,10,-4
2019-06-06,2019,TOR,NYY,2,6,190,1.5,130,10.5,-110,-110,-210,-1.5,-150,3.62,Rogers Centre,8,-4
2019-06-06,2019,LAA,OAK,4,7,-120,-1.5,151,9.5,-105,-115,110,1.5,-175,5.18,Angel Stadium,11,-3
2019-06-06,2019,ATL,PIT,1,6,-113,-1.5,140,9.5,-105,-115,103,1.5,-160,5.04,PNC Park,7,-5
2019-06-06,2019,WSH,SD,4,5,102,1.5,-225,7.5,-120,100,-112,-1.5,188,3.71,PETCO Park,9,-1
2019-06-06,2019,HOU,SEA,8,7,-196,-1.5,-128,8.0,-110,-110,178,1.5,108,5.3,T-Mobile Park,15,1
2019-06-06,2019,NYM,SF,7,3,-165,-1.5,120,7.5,-110,-110,155,1.5,-140,4.67,Citi Field,10,4
2019-06-06,2019,CIN,STL,1,3,140,1.5,-151,9.0,-115,-105,-150,-1.5,131,3.75,Busch Stadium,4,-2
2019-06-06,2019,DET,TB,1,6,163,1.5,105,9.0,-115,-105,-176,-1.5,-125,3.42,Comerica Park,7,-5
2019-06-06,2019,BAL,TEX,3,4,162,1.5,-108,11.0,-105,-115,-174,-1.5,-111,4.2,Rangers Ballpark,7,-1
2019-06-06,2019,NYY,TOR,6,2,-210,-1.5,-150,10.5,-110,-110,190,1.5,130,7.11,Rogers Centre,8,4
2019-06-06,2019,SD,WSH,5,4,-112,-1.5,188,7.5,-120,100,102,1.5,-225,3.96,PETCO Park,9,1
2019-06-07,2019,TOR,ARI,2,8,-130,-1.5,151,8.5,-120,100,120,1.5,-174,4.8,Rogers Centre,10,-6
2019-06-07,2019,MIA,ATL,1,7,170,1.5,-110,7.5,-120,100,-185,-1.5,-109,2.78,Marlins Park,8,-6
2019-06-07,2019,HOU,BAL,4,3,-360,-1.5,-175,8.0,-110,-110,310,1.5,151,6.26,Minute Maid Park,7,1
2019-06-07,2019,TB,BOS,5,1,104,1.5,-190,10.0,-115,-105,-114,-1.5,163,4.9,Fenway Park,6,4
2019-06-07,2019,STL,CHC,1,3,113,1.5,-200,7.5,-120,100,-123,-1.5,170,3.52,Wrigley Field,4,-2
2019-06-07,2019,PHI,CIN,4,2,-120,-1.5,155,9.0,-120,100,110,1.5,-180,4.91,Citizens Bank Park,6,2
2019-06-07,2019,NYY,CLE,2,5,-119,-1.5,136,9.0,-105,-115,109,1.5,-156,4.89,Progressive Field,7,-3
2019-06-07,2019,NYM,COL,1,5,-205,-1.5,100,7.5,-115,-105,185,1.5,-118,5.04,Citi Field,6,-4
2019-06-07,2019,KC,CWS,6,4,-118,-1.5,160,10.0,-105,-115,108,1.5,-185,5.41,Kauffman Stadium,10,2
2019-06-07,2019,MIN,DET,6,3,-128,-1.5,130,9.0,-110,-110,118,1.5,-150,5.05,Comerica Park,9,3
2019-06-07,2019,BAL,HOU,3,4,310,1.5,151,8.0,-110,-110,-360,-1.5,-175,1.95,Minute Maid Park,7,-1
2019-06-07,2019,CWS,KC,4,6,108,1.5,-185,10.0,-105,-115,-118,-1.5,160,4.81,Kauffman Stadium,10,-2
2019-06-07,2019,SEA,LAA,6,2,165,1.5,-130,9.0,100,-120,-180,-1.5,110,3.4,Angel Stadium,8,4
2019-06-07,2019,SF,LAD,2,1,205,1.5,140,7.5,-110,-110,-230,-1.5,-160,2.46,AT&T Park,3,1
2019-06-07,2019,ATL,MIA,7,1,-185,-1.5,-109,7.5,-120,100,170,1.5,-110,4.87,Marlins Park,8,6
2019-06-07,2019,PIT,MIL,4,10,205,1.5,120,9.5,100,-120,-230,-1.5,-140,3.11,Miller Park,14,-6
2019-06-07,2019,DET,MIN,3,6,118,1.5,-150,9.0,-110,-110,-128,-1.5,130,4.13,Comerica Park,9,-3
2019-06-07,2019,COL,NYM,5,1,185,1.5,-118,7.5,-115,-105,-205,-1.5,100,2.63,Citi Field,6,4
2019-06-07,2019,CLE,NYY,5,2,109,1.5,-156,9.0,-105,-115,-119,-1.5,136,4.31,Progressive Field,7,3
2019-06-07,2019,TEX,OAK,3,5,-110,-1.5,166,10.0,-115,-105,100,1.5,-195,5.24,Rangers Ballpark,8,-2
2019-06-07,2019,CIN,PHI,2,4,110,1.5,-180,9.0,-120,100,-120,-1.5,155,4.29,Citizens Bank Park,6,-2
2019-06-07,2019,MIL,PIT,10,4,-230,-1.5,-140,9.5,100,-120,205,1.5,120,6.62,Miller Park,14,6
2019-06-07,2019,WSH,SD,4,5,-110,-1.5,134,9.0,-120,100,100,1.5,-154,4.71,PETCO Park,9,-1
2019-06-07,2019,LAA,SEA,2,6,-180,-1.5,110,9.0,100,-120,165,1.5,-130,5.79,Angel Stadium,8,-4
2019-06-07,2019,LAD,SF,1,2,-230,-1.5,-160,7.5,-110,-110,205,1.5,140,5.23,AT&T Park,3,-1
2019-06-07,2019,CHC,STL,3,1,-123,-1.5,170,7.5,-120,100,113,1.5,-200,4.14,Wrigley Field,4,2
2019-06-07,2019,BOS,TB,1,5,-114,-1.5,163,10.0,-115,-105,104,1.5,-190,5.33,Fenway Park,6,-4
2019-06-07,2019,OAK,TEX,5,3,100,1.5,-195,10.0,-115,-105,-110,-1.5,166,5.0,Rangers Ballpark,8,2
2019-06-07,2019,ARI,TOR,8,2,120,1.5,-174,8.5,-120,100,-130,-1.5,151,3.86,Rogers Centre,10,6
2019-06-07,2019,SD,WSH,5,4,100,1.5,-154,9.0,-120,100,-110,-1.5,134,4.5,PETCO Park,9,1
2019-06-08,2019,TOR,ARI,0,6,123,1.5,-151,8.5,-115,-105,-133,-1.5,131,3.81,Rogers Centre,6,-6
2019-06-08,2019,MIA,ATL,0,1,130,1.5,-120,8.0,-105,-115,-140,-1.5,100,3.48,Marlins Park,1,-1
2019-06-08,2019,HOU,BAL,1,4,-240,-1.5,-118,8.5,-115,-105,210,1.5,-101,6.0,Minute Maid Park,5,-3
2019-06-08,2019,TB,BOS,9,2,-120,-1.5,126,10.5,-115,-105,110,1.5,-146,5.73,Fenway Park,11,7
2019-06-08,2019,TB,BOS,1,5,144,1.5,-148,9.0,-105,-115,-154,-1.5,128,3.69,Fenway Park,6,-4
2019-06-08,2019,STL,CHC,4,9,-108,-1.5,143,7.5,-120,100,-102,1.5,-164,3.89,Wrigley Field,13,-5
2019-06-08,2019,PHI,CIN,4,1,-131,-1.5,148,9.5,-105,-115,121,1.5,-170,5.39,Citizens Bank Park,5,3
2019-06-08,2019,NYY,CLE,4,8,-128,-1.5,124,10.0,100,-120,118,1.5,-144,5.61,Progressive Field,12,-4
2019-06-08,2019,NYM,COL,5,3,-114,-1.5,176,8.0,-120,100,104,1.5,-210,4.26,Citi Field,8,2
2019-06-08,2019,KC,CWS,0,2,135,1.5,-120,8.5,100,-120,-145,-1.5,100,3.62,Kauffman Stadium,2,-2
2019-06-08,2019,MIN,DET,3,9,-240,-1.5,-140,10.0,-105,-115,210,1.5,122,7.06,Comerica Park,12,-6
2019-06-08,2019,BAL,HOU,4,1,210,1.5,-101,8.5,-115,-105,-240,-1.5,-118,2.74,Minute Maid Park,5,3
2019-06-08,2019,CWS,KC,2,0,-145,-1.5,100,8.5,100,-120,135,1.5,-120,5.03,Kauffman Stadium,2,2
2019-06-08,2019,SEA,LAA,3,12,125,1.5,-168,9.5,100,-120,-135,-1.5,146,4.22,Angel Stadium,15,-9
2019-06-08,2019,SF,LAD,2,7,190,1.5,120,8.5,-105,-115,-210,-1.5,-140,2.93,AT&T Park,9,-5
2019-06-08,2019,ATL,MIA,1,0,-140,-1.5,100,8.0,-105,-115,130,1.5,-120,4.67,Marlins Park,1,1
2019-06-08,2019,PIT,MIL,3,5,160,1.5,-142,9.5,-105,-115,-170,-1.5,120,3.65,Miller Park,8,-2
2019-06-08,2019,DET,MIN,9,3,210,1.5,122,10.0,-105,-115,-240,-1.5,-140,3.23,Comerica Park,12,6
2019-06-08,2019,COL,NYM,3,5,104,1.5,-210,8.0,-120,100,-114,-1.5,176,3.92,Citi Field,8,-2
2019-06-08,2019,CLE,NYY,8,4,118,1.5,-144,10.0,100,-120,-128,-1.5,124,4.59,Progressive Field,12,4
2019-06-08,2019,TEX,OAK,10,5,124,1.5,-129,11.5,-110,-110,-134,-1.5,109,5.13,Rangers Ballpark,15,5
2019-06-08,2019,TEX,OAK,3,1,130,1.5,-115,10.5,-110,-110,-140,-1.5,-105,4.57,Rangers Ballpark,4,2
2019-06-08,2019,CIN,PHI,1,4,121,1.5,-170,9.5,-105,-115,-131,-1.5,148,4.3,Citizens Bank Park,5,-3
2019-06-08,2019,MIL,PIT,5,3,-170,-1.5,120,9.5,-105,-115,160,1.5,-142,5.98,Miller Park,8,2
2019-06-08,2019,WSH,SD,4,1,-185,-1.5,-115,7.5,-105,-115,170,1.5,-105,4.87,PETCO Park,5,3
2019-06-08,2019,LAA,SEA,12,3,-135,-1.5,146,9.5,100,-120,125,1.5,-168,5.46,Angel Stadium,15,9
2019-06-08,2019,LAD,SF,7,2,-210,-1.5,-140,8.5,-105,-115,190,1.5,120,5.76,AT&T Park,9,5
2019-06-08,2019,CHC,STL,9,4,-102,1.5,-164,7.5,-120,100,-108,-1.5,143,3.79,Wrigley Field,13,5
2019-06-08,2019,BOS,TB,2,9,110,1.5,-146,10.5,-115,-105,-120,-1.5,126,5.0,Fenway Park,11,-7
2019-06-08,2019,BOS,TB,5,1,-154,-1.5,128,9.0,-105,-115,144,1.5,-148,5.46,Fenway Park,6,4
2019-06-08,2019,OAK,TEX,5,10,-134,-1.5,109,11.5,-110,-110,124,1.5,-129,6.59,Rangers Ballpark,15,-5
2019-06-08,2019,OAK,TEX,1,3,-140,-1.5,-105,10.5,-110,-110,130,1.5,-115,6.13,Rangers Ballpark,4,-2
2019-06-08,2019,ARI,TOR,6,0,-133,-1.5,131,8.5,-115,-105,123,1.5,-151,4.85,Rogers Centre,6,6
2019-06-08,2019,SD,WSH,1,4,170,1.5,-105,7.5,-105,-115,-185,-1.5,-115,2.78,PETCO Park,5,-3
2019-06-09,2019,TOR,ARI,2,8,135,1.5,-131,9.0,-105,-115,-145,-1.5,112,3.83,Rogers Centre,10,-6
2019-06-09,2019,MIA,ATL,6,7,125,1.5,-139,7.5,-105,-115,-135,-1.5,119,3.33,Marlins Park,13,-1
2019-06-09,2019,HOU,BAL,4,0,-190,-1.5,-105,8.5,-120,100,175,1.5,-115,5.57,Minute Maid Park,4,4
2019-06-09,2019,TB,BOS,6,1,-129,-1.5,121,8.5,-115,-105,119,1.5,-141,4.79,Fenway Park,7,5
2019-06-09,2019,STL,CHC,1,5,163,1.5,-130,8.0,-115,-105,-176,-1.5,110,3.04,Wrigley Field,6,-4
2019-06-09,2019,PHI,CIN,3,4,-138,-1.5,149,8.5,-110,-110,128,1.5,-171,4.93,Citizens Bank Park,7,-1
2019-06-09,2019,NYY,CLE,7,6,123,1.5,-160,9.5,-115,-105,-133,-1.5,140,4.26,Progressive Field,13,1
2019-06-09,2019,NYM,COL,6,1,-158,-1.5,125,8.0,-115,-105,148,1.5,-145,4.9,Citi Field,7,5
2019-06-09,2019,KC,CWS,2,5,-124,-1.5,138,9.5,-110,-110,114,1.5,-158,5.26,Kauffman Stadium,7,-3
2019-06-09,2019,MIN,DET,12,2,-220,-1.5,-135,9.5,100,-120,200,1.5,118,6.53,Comerica Park,14,10
2019-06-09,2019,BAL,HOU,0,4,175,1.5,-115,8.5,-120,100,-190,-1.5,-105,3.09,Minute Maid Park,4,-4
2019-06-09,2019,CWS,KC,5,2,114,1.5,-158,9.5,-110,-110,-124,-1.5,138,4.44,Kauffman Stadium,7,3
2019-06-09,2019,SEA,LAA,9,3,142,1.5,-145,10.5,-105,-115,-152,-1.5,125,4.34,Angel Stadium,12,6
2019-06-09,2019,SF,LAD,0,1,147,1.5,-137,7.5,-105,-115,-157,-1.5,117,3.04,AT&T Park,1,-1
2019-06-09,2019,ATL,MIA,7,6,-135,-1.5,119,7.5,-105,-115,125,1.5,-139,4.31,Marlins Park,13,1
2019-06-09,2019,PIT,MIL,2,5,177,1.5,-119,9.5,-115,-105,-194,-1.5,-101,3.43,Miller Park,7,-3
2019-06-09,2019,DET,MIN,2,12,200,1.5,118,9.5,100,-120,-220,-1.5,-135,3.17,Comerica Park,14,-10
2019-06-09,2019,COL,NYM,1,6,148,1.5,-145,8.0,-115,-105,-158,-1.5,125,3.23,Citi Field,7,-5
2019-06-09,2019,CLE,NYY,6,7,-133,-1.5,140,9.5,-115,-105,123,1.5,-160,5.42,Progressive Field,13,-1
2019-06-09,2019,TEX,OAK,8,9,175,1.5,127,11.5,-105,-115,-190,-1.5,-147,4.18,Rangers Ballpark,17,-1
2019-06-09,2019,CIN,PHI,4,3,128,1.5,-171,8.5,-110,-110,-138,-1.5,149,3.73,Citizens Bank Park,7,1
2019-06-09,2019,MIL,PIT,5,2,-194,-1.5,-101,9.5,-115,-105,177,1.5,-119,6.27,Miller Park,7,3
2019-06-09,2019,WSH,SD,5,2,-153,-1.5,104,8.0,-110,-110,143,1.5,-124,4.84,PETCO Park,7,3
2019-06-09,2019,LAA,SEA,3,9,-152,-1.5,125,10.5,-105,-115,142,1.5,-145,6.33,Angel Stadium,12,-6
2019-06-09,2019,LAD,SF,1,0,-157,-1.5,117,7.5,-105,-115,147,1.5,-137,4.58,AT&T Park,1,1
2019-06-09,2019,CHC,STL,5,1,-176,-1.5,110,8.0,-115,-105,163,1.5,-130,5.1,Wrigley Field,6,4
2019-06-09,2019,BOS,TB,1,6,119,1.5,-141,8.5,-115,-105,-129,-1.5,121,3.88,Fenway Park,7,-5
2019-06-09,2019,OAK,TEX,9,8,-190,-1.5,-147,11.5,-105,-115,175,1.5,127,7.53,Rangers Ballpark,17,1
2019-06-09,2019,ARI,TOR,8,2,-145,-1.5,112,9.0,-105,-115,135,1.5,-131,5.33,Rogers Centre,10,6
2019-06-09,2019,SD,WSH,2,5,143,1.5,-124,8.0,-110,-110,-153,-1.5,104,3.29,PETCO Park,7,-3
2019-06-10,2019,PHI,ARI,8,13,-134,-1.5,143,9.5,-120,100,124,1.5,-164,5.44,Citizens Bank Park,21,-5
2019-06-10,2019,PIT,ATL,7,13,133,1.5,-155,10.0,100,-120,-143,-1.5,135,4.29,Suntrust Park,20,-6
2019-06-10,2019,TEX,BOS,4,3,220,1.5,101,7.5,-120,100,-250,-1.5,-120,2.34,Fenway Park,7,1
2019-06-10,2019,COL,CHC,6,5,-129,-1.5,140,11.5,-120,100,119,1.5,-160,6.48,Coors Field,11,1
2019-06-10,2019,CHC,COL,5,6,119,1.5,-160,11.5,-120,100,-129,-1.5,140,5.25,Coors Field,11,-1
2019-06-10,2019,WSH,CWS,12,1,-145,-1.5,-104,10.5,-120,100,135,1.5,-116,6.21,Guaranteed Rate Field,13,11
2019-06-10,2019,LAD,LAA,3,5,-185,-1.5,-130,9.0,-115,-105,170,1.5,110,5.84,Angel Stadium,8,-2
2019-06-10,2019,LAA,LAD,5,3,170,1.5,110,9.0,-115,-105,-185,-1.5,-130,3.33,Angel Stadium,8,2
2019-06-10,2019,STL,MIA,4,1,-126,-1.5,126,8.5,-110,-110,116,1.5,-146,4.74,Marlins Park,5,3
2019-06-10,2019,TB,OAK,6,2,-230,-1.5,-127,8.5,-120,100,205,1.5,107,5.92,Tropicana Field,8,4
2019-06-10,2019,ARI,PHI,13,8,124,1.5,-164,9.5,-120,100,-134,-1.5,143,4.24,Citizens Bank Park,21,5
2019-06-10,2019,ATL,PIT,13,7,-143,-1.5,135,10.0,100,-120,133,1.5,-155,5.88,Suntrust Park,20,6
2019-06-10,2019,MIA,STL,1,4,116,1.5,-146,8.5,-110,-110,-126,-1.5,126,3.94,Marlins Park,5,-3
2019-06-10,2019,OAK,TB,2,6,205,1.5,107,8.5,-120,100,-230,-1.5,-127,2.79,Tropicana Field,8,-4
2019-06-10,2019,BOS,TEX,3,4,-250,-1.5,-120,7.5,-120,100,220,1.5,101,5.36,Fenway Park,7,-1
2019-06-10,2019,CWS,WSH,1,12,135,1.5,-116,10.5,-120,100,-145,-1.5,-104,4.47,Guaranteed Rate Field,13,-11
2019-06-11,2019,PHI,ARI,7,4,-140,-1.5,145,9.0,-105,-115,130,1.5,-165,5.25,Citizens Bank Park,11,3
2019-06-11,2019,PIT,ATL,5,7,138,1.5,-160,10.0,100,-120,-148,-1.5,140,4.2,Suntrust Park,12,-2
2019-06-11,2019,TOR,BAL,2,4,-116,-1.5,129,8.5,-115,-105,106,1.5,-148,4.56,Camden Yards,6,-2
2019-06-11,2019,TEX,BOS,9,5,160,1.5,-125,10.5,-110,-110,-170,-1.5,105,4.04,Fenway Park,14,4
2019-06-11,2019,COL,CHC,10,3,118,1.5,-125,12.0,-105,-115,-128,-1.5,105,5.5,Coors Field,13,7
2019-06-11,2019,CLE,CIN,2,1,-126,-1.5,166,8.0,-120,100,116,1.5,-195,4.46,Progressive Field,3,1
2019-06-11,2019,CIN,CLE,1,2,116,1.5,-195,8.0,-120,100,-126,-1.5,166,3.7,Progressive Field,3,-1
2019-06-11,2019,CHC,COL,3,10,-128,-1.5,105,12.0,-105,-115,118,1.5,-125,6.74,Coors Field,13,-7
2019-06-11,2019,WSH,CWS,5,7,-180,-1.5,-127,9.5,-115,-105,165,1.5,107,6.11,Guaranteed Rate Field,12,-2
2019-06-11,2019,KC,DET,3,2,-140,-1.5,140,8.5,-115,-105,130,1.5,-160,4.96,Kauffman Stadium,5,1
2019-06-11,2019,MIL,HOU,8,10,108,1.5,-185,8.5,-120,100,-118,-1.5,160,4.09,Minute Maid Park,18,-2
2019-06-11,2019,DET,KC,2,3,130,1.5,-160,8.5,-115,-105,-140,-1.5,140,3.7,Kauffman Stadium,5,-1
2019-06-11,2019,LAD,LAA,3,5,-160,-1.5,101,9.5,-115,-105,150,1.5,-121,5.85,Angel Stadium,8,-2
2019-06-11,2019,LAA,LAD,5,3,150,1.5,-121,9.5,-115,-105,-160,-1.5,101,3.8,Angel Stadium,8,2
2019-06-11,2019,STL,MIA,7,1,-145,-1.5,100,8.0,105,-125,135,1.5,-120,4.73,Marlins Park,8,6
2019-06-11,2019,HOU,MIL,10,8,-118,-1.5,160,8.5,-120,100,108,1.5,-185,4.6,Minute Maid Park,18,2
2019-06-11,2019,SEA,MIN,5,6,177,1.5,-105,9.5,-120,100,-194,-1.5,-115,3.43,Target Field,11,-1
2019-06-11,2019,NYY,NYM,12,5,-150,-1.5,133,9.0,-115,-105,140,1.5,-154,5.4,Yankee Stadium,17,7
2019-06-11,2019,NYY,NYM,4,10,-210,-1.5,-115,9.0,-115,-105,190,1.5,-105,6.1,Yankee Stadium,14,-6
2019-06-11,2019,NYM,NYY,5,12,140,1.5,-154,9.0,-115,-105,-150,-1.5,133,3.75,Yankee Stadium,17,-7
2019-06-11,2019,NYM,NYY,10,4,190,1.5,-105,9.0,-115,-105,-210,-1.5,-115,3.1,Yankee Stadium,14,6
2019-06-11,2019,TB,OAK,3,4,-150,-1.5,125,9.0,-105,-115,140,1.5,-145,5.4,Tropicana Field,7,-1
2019-06-11,2019,ARI,PHI,4,7,130,1.5,-165,9.0,-105,-115,-140,-1.5,145,3.91,Citizens Bank Park,11,-3
2019-06-11,2019,ATL,PIT,7,5,-148,-1.5,140,10.0,100,-120,138,1.5,-160,5.97,Suntrust Park,12,2
2019-06-11,2019,SF,SD,6,5,135,1.5,-120,7.5,-115,-105,-145,-1.5,100,3.19,AT&T Park,11,1
2019-06-11,2019,MIN,SEA,6,5,-194,-1.5,-115,9.5,-120,100,177,1.5,-105,6.27,Target Field,11,1
2019-06-11,2019,SD,SF,5,6,-145,-1.5,100,7.5,-115,-105,135,1.5,-120,4.44,AT&T Park,11,-1
2019-06-11,2019,MIA,STL,1,7,135,1.5,-120,8.0,105,-125,-145,-1.5,100,3.4,Marlins Park,8,-6
2019-06-11,2019,OAK,TB,4,3,140,1.5,-145,9.0,-105,-115,-150,-1.5,125,3.75,Tropicana Field,7,1
2019-06-11,2019,BOS,TEX,5,9,-170,-1.5,105,10.5,-110,-110,160,1.5,-125,6.61,Fenway Park,14,-4
2019-06-11,2019,BAL,TOR,4,2,106,1.5,-148,8.5,-115,-105,-116,-1.5,129,4.13,Camden Yards,6,2
2019-06-11,2019,CWS,WSH,7,5,165,1.5,107,9.5,-115,-105,-180,-1.5,-127,3.58,Guaranteed Rate Field,12,2
2019-06-12,2019,PHI,ARI,0,2,-140,-1.5,155,9.5,-105,-115,130,1.5,-180,5.54,Citizens Bank Park,2,-2
2019-06-12,2019,PIT,ATL,7,8,179,1.5,-110,9.0,-101,-119,-200,-1.5,-110,3.23,Suntrust Park,15,-1
2019-06-12,2019,TOR,BAL,8,6,-116,-1.5,140,10.5,-105,-115,106,1.5,-161,5.64,Camden Yards,14,2
2019-06-12,2019,TEX,BOS,3,4,145,1.5,-130,9.5,100,-120,-155,-1.5,110,3.88,Fenway Park,7,-1
2019-06-12,2019,COL,CHC,1,10,108,1.5,-142,12.0,100,-120,-118,-1.5,122,5.77,Coors Field,11,-9
2019-06-12,2019,CLE,CIN,2,7,-152,-1.5,130,9.5,100,-120,142,1.5,-150,5.73,Progressive Field,9,-5
2019-06-12,2019,CIN,CLE,7,2,142,1.5,-150,9.5,100,-120,-152,-1.5,130,3.93,Progressive Field,9,5
2019-06-12,2019,CHC,COL,10,1,-118,-1.5,122,12.0,100,-120,108,1.5,-142,6.5,Coors Field,11,9
2019-06-12,2019,KC,DET,2,3,-125,-1.5,172,8.5,-115,-105,115,1.5,-205,4.72,Kauffman Stadium,5,-1
2019-06-12,2019,MIL,HOU,6,3,130,1.5,-180,7.5,-115,-105,-140,-1.5,155,3.26,Minute Maid Park,9,3
2019-06-12,2019,DET,KC,3,2,115,1.5,-205,8.5,-115,-105,-125,-1.5,172,3.95,Kauffman Stadium,5,1
2019-06-12,2019,STL,MIA,0,9,-180,-1.5,-120,8.0,-110,-110,165,1.5,100,5.14,Marlins Park,9,-9
2019-06-12,2019,HOU,MIL,3,6,-140,-1.5,155,7.5,-115,-105,130,1.5,-180,4.38,Minute Maid Park,9,-3
2019-06-12,2019,SEA,MIN,9,6,200,1.5,101,9.0,-120,100,-220,-1.5,-121,3.0,Target Field,15,3
2019-06-12,2019,TB,OAK,2,6,-150,-1.5,130,8.5,-115,-105,140,1.5,-152,5.1,Tropicana Field,8,-4
2019-06-12,2019,ARI,PHI,2,0,130,1.5,-180,9.5,-105,-115,-140,-1.5,155,4.13,Citizens Bank Park,2,2
2019-06-12,2019,ATL,PIT,8,7,-200,-1.5,-110,9.0,-101,-119,179,1.5,-110,6.0,Suntrust Park,15,1
2019-06-12,2019,SF,SD,4,2,120,1.5,-146,7.0,-120,100,-130,-1.5,126,3.18,AT&T Park,6,2
2019-06-12,2019,MIN,SEA,6,9,-220,-1.5,-121,9.0,-120,100,200,1.5,101,6.19,Target Field,15,-3
2019-06-12,2019,SD,SF,2,4,-130,-1.5,126,7.0,-120,100,120,1.5,-146,3.96,AT&T Park,6,-2
2019-06-12,2019,MIA,STL,9,0,165,1.5,100,8.0,-110,-110,-180,-1.5,-120,3.02,Marlins Park,9,9
2019-06-12,2019,OAK,TB,6,2,140,1.5,-152,8.5,-115,-105,-150,-1.5,130,3.54,Tropicana Field,8,4
2019-06-12,2019,BOS,TEX,4,3,-155,-1.5,110,9.5,100,-120,145,1.5,-130,5.77,Fenway Park,7,1
2019-06-12,2019,BAL,TOR,6,8,106,1.5,-161,10.5,-105,-115,-116,-1.5,140,5.1,Camden Yards,14,-2
2019-06-13,2019,WSH,ARI,0,5,109,1.5,-166,8.5,-120,100,-119,-1.5,145,4.07,Nationals Park,5,-5
2019-06-13,2019,PIT,ATL,5,6,137,1.5,-145,9.5,105,-125,-147,-1.5,125,4.01,Suntrust Park,11,-1
2019-06-13,2019,TOR,BAL,12,3,-130,-1.5,110,9.0,-115,-105,120,1.5,-130,5.09,Camden Yards,15,9
2019-06-13,2019,TEX,BOS,6,7,210,1.5,105,9.0,100,-120,-240,-1.5,-125,2.9,Fenway Park,13,-1
2019-06-13,2019,LAD,CHC,7,3,-170,-1.5,110,8.0,-120,100,160,1.5,-130,5.04,Dodger Stadium,10,4
2019-06-13,2019,SD,COL,6,9,138,1.5,-140,11.5,-105,-115,-148,-1.5,120,4.83,Coors Field,15,-3
2019-06-13,2019,NYY,CWS,4,5,-165,-1.5,-126,9.5,-105,-115,155,1.5,106,5.92,Guaranteed Rate Field,9,-1
2019-06-13,2019,KC,DET,7,3,125,1.5,-136,8.5,-115,-105,-135,-1.5,116,3.78,TD Ameritrade Park,10,4
2019-06-13,2019,DET,KC,3,7,-135,-1.5,116,8.5,-115,-105,125,1.5,-136,4.88,TD Ameritrade Park,10,-4
2019-06-13,2019,TB,LAA,3,5,-135,-1.5,135,8.5,-120,100,125,1.5,-155,4.88,Tropicana Field,8,-2
2019-06-13,2019,CHC,LAD,3,7,160,1.5,-130,8.0,-120,100,-170,-1.5,110,3.08,Dodger Stadium,10,-4
2019-06-13,2019,SEA,MIN,5,10,158,1.5,-123,10.0,-125,105,-168,-1.5,102,3.88,Target Field,15,-5
2019-06-13,2019,STL,NYM,5,4,130,1.5,-172,7.0,-105,-115,-140,-1.5,149,3.04,Citi Field,9,1
2019-06-13,2019,CWS,NYY,5,4,155,1.5,106,9.5,-105,-115,-165,-1.5,-126,3.73,Guaranteed Rate Field,9,1
2019-06-13,2019,ATL,PIT,6,5,-147,-1.5,125,9.5,105,-125,137,1.5,-145,5.65,Suntrust Park,11,1
2019-06-13,2019,COL,SD,9,6,-148,-1.5,120,11.5,-105,-115,138,1.5,-140,6.86,Coors Field,15,3
2019-06-13,2019,MIN,SEA,10,5,-168,-1.5,102,10.0,-125,105,158,1.5,-123,6.27,Target Field,15,5
2019-06-13,2019,NYM,STL,4,5,-140,-1.5,149,7.0,-105,-115,130,1.5,-172,4.08,Citi Field,9,-1
2019-06-13,2019,LAA,TB,5,3,125,1.5,-155,8.5,-120,100,-135,-1.5,135,3.78,Tropicana Field,8,2
2019-06-13,2019,BOS,TEX,7,6,-240,-1.5,-125,9.0,100,-120,210,1.5,105,6.35,Fenway Park,13,1
2019-06-13,2019,BAL,TOR,3,12,120,1.5,-130,9.0,-115,-105,-130,-1.5,110,4.09,Camden Yards,15,-9
2019-06-13,2019,ARI,WSH,5,0,-119,-1.5,145,8.5,-120,100,109,1.5,-166,4.62,Nationals Park,5,5
2019-06-14,2019,WSH,ARI,7,3,-170,-1.5,100,7.0,-110,-110,160,1.5,-120,4.41,Nationals Park,10,4
2019-06-14,2019,PHI,ATL,8,9,125,1.5,-175,9.0,-120,100,-135,-1.5,151,4.0,Suntrust Park,17,-1
2019-06-14,2019,BOS,BAL,13,2,-250,-1.5,-160,10.0,-115,-105,220,1.5,140,7.14,Camden Yards,15,11
2019-06-14,2019,BAL,BOS,2,13,220,1.5,140,10.0,-115,-105,-250,-1.5,-160,3.13,Camden Yards,15,-11
2019-06-14,2019,LAD,CHC,5,3,-152,-1.5,141,7.5,-115,-105,142,1.5,-161,4.52,Dodger Stadium,8,2
2019-06-14,2019,TEX,CIN,7,1,152,1.5,-135,9.0,-115,-105,-162,-1.5,115,3.57,Great American Ballpark,8,6
2019-06-14,2019,DET,CLE,4,13,150,1.5,-101,9.5,-115,-105,-160,-1.5,-119,3.8,Comerica Park,17,-9
2019-06-14,2019,SD,COL,16,12,100,1.5,-185,12.5,100,-120,-110,-1.5,160,6.25,Coors Field,28,4
2019-06-14,2019,NYY,CWS,2,10,-109,-1.5,151,9.0,100,-120,-101,1.5,-175,4.69,Guaranteed Rate Field,12,-8
2019-06-14,2019,CLE,DET,13,4,-160,-1.5,-119,9.5,-115,-105,150,1.5,-101,5.85,Comerica Park,17,9
2019-06-14,2019,TOR,HOU,2,15,260,1.5,124,8.0,-115,-105,-300,-1.5,-144,2.22,Minute Maid Park,17,-13
2019-06-14,2019,MIN,KC,2,0,-240,-1.5,-127,10.0,-105,-115,210,1.5,107,7.06,Target Field,2,2
2019-06-14,2019,TB,LAA,9,4,-168,-1.5,120,7.5,-105,-115,158,1.5,-140,4.7,Tropicana Field,13,5
2019-06-14,2019,CHC,LAD,3,5,142,1.5,-161,7.5,-115,-105,-152,-1.5,141,3.1,Dodger Stadium,8,-2
2019-06-14,2019,PIT,MIA,11,0,108,1.5,-200,8.5,-120,100,-118,-1.5,170,4.09,Marlins Park,11,11
2019-06-14,2019,SF,MIL,5,3,144,1.5,-128,8.0,-110,-110,-154,-1.5,108,3.28,AT&T Park,8,2
2019-06-14,2019,KC,MIN,0,2,210,1.5,107,10.0,-105,-115,-240,-1.5,-127,3.23,Target Field,2,-2
2019-06-14,2019,STL,NYM,9,5,122,1.5,-185,9.0,-105,-115,-132,-1.5,160,4.05,Citi Field,14,4
2019-06-14,2019,CWS,NYY,10,2,-101,1.5,-175,9.0,100,-120,-109,-1.5,151,4.52,Guaranteed Rate Field,12,8
2019-06-14,2019,SEA,OAK,9,2,170,1.5,-135,9.5,-105,-115,-185,-1.5,115,3.52,Oakland Coliseum,11,7
2019-06-14,2019,ATL,PHI,9,8,-135,-1.5,151,9.0,-120,100,125,1.5,-175,5.17,Suntrust Park,17,1
2019-06-14,2019,MIA,PIT,0,11,-118,-1.5,170,8.5,-120,100,108,1.5,-200,4.6,Marlins Park,11,-11
2019-06-14,2019,COL,SD,12,16,-110,-1.5,160,12.5,100,-120,100,1.5,-185,6.55,Coors Field,28,-4
2019-06-14,2019,OAK,SEA,2,9,-185,-1.5,115,9.5,-105,-115,170,1.5,-135,6.17,Oakland Coliseum,11,-7
2019-06-14,2019,MIL,SF,3,5,-154,-1.5,108,8.0,-110,-110,144,1.5,-128,4.85,AT&T Park,8,-2
2019-06-14,2019,NYM,STL,5,9,-132,-1.5,160,9.0,-105,-115,122,1.5,-185,5.12,Citi Field,14,-4
2019-06-14,2019,LAA,TB,4,9,158,1.5,-140,7.5,-105,-115,-168,-1.5,120,2.91,Tropicana Field,13,-5
2019-06-14,2019,CIN,TEX,1,7,-162,-1.5,115,9.0,-115,-105,152,1.5,-135,5.56,Great American Ballpark,8,-6
2019-06-14,2019,HOU,TOR,15,2,-300,-1.5,-144,8.0,-115,-105,260,1.5,124,6.0,Minute Maid Park,17,13
2019-06-14,2019,ARI,WSH,3,7,160,1.5,-120,7.0,-110,-110,-170,-1.5,100,2.69,Nationals Park,10,-4
2019-06-15,2019,WSH,ARI,3,10,-215,-1.5,-119,9.0,-115,-105,195,1.5,-101,6.14,Nationals Park,13,-7
2019-06-15,2019,PHI,ATL,6,5,-102,-1.5,151,9.5,-105,-115,-108,1.5,-175,4.8,Suntrust Park,11,1
2019-06-15,2019,BOS,BAL,7,2,-320,-1.5,-200,9.0,100,-120,280,1.5,170,6.86,Camden Yards,9,5
2019-06-15,2019,BAL,BOS,2,7,280,1.5,170,9.0,100,-120,-320,-1.5,-200,2.37,Camden Yards,9,-5
2019-06-15,2019,LAD,CHC,1,2,-190,-1.5,111,8.0,-110,-110,175,1.5,-131,5.24,Dodger Stadium,3,-1
2019-06-15,2019,TEX,CIN,4,3,106,1.5,-180,8.5,100,-120,-116,-1.5,155,4.13,Great American Ballpark,7,1
2019-06-15,2019,DET,CLE,2,4,215,1.5,130,9.0,-125,105,-245,-1.5,-150,2.86,Comerica Park,6,-2
2019-06-15,2019,SD,COL,8,14,155,1.5,-119,11.5,-115,-105,-165,-1.5,-101,4.51,Coors Field,22,-6
2019-06-15,2019,NYY,CWS,8,4,-185,-1.5,-130,9.5,-110,-110,170,1.5,110,6.17,Guaranteed Rate Field,12,4
2019-06-15,2019,CLE,DET,4,2,-245,-1.5,-150,9.0,-125,105,215,1.5,130,6.39,Comerica Park,6,2
2019-06-15,2019,TOR,HOU,2,7,205,1.5,105,9.0,100,-120,-230,-1.5,-125,2.95,Minute Maid Park,9,-5
2019-06-15,2019,MIN,KC,5,4,-255,-1.5,-133,9.0,-115,-105,225,1.5,113,6.46,Target Field,9,1
2019-06-15,2019,TB,LAA,3,5,-200,-1.5,-110,8.0,-120,100,180,1.5,-110,5.33,Tropicana Field,8,-2
2019-06-15,2019,CHC,LAD,2,1,175,1.5,-131,8.0,-110,-110,-190,-1.5,111,2.91,Dodger Stadium,3,1
2019-06-15,2019,PIT,MIA,3,4,106,1.5,-205,8.0,100,-120,-116,-1.5,172,3.88,Marlins Park,7,-1
2019-06-15,2019,SF,MIL,8,7,-114,-1.5,172,7.5,-105,-115,104,1.5,-205,4.0,AT&T Park,15,1
2019-06-15,2019,KC,MIN,4,5,225,1.5,113,9.0,-115,-105,-255,-1.5,-133,2.77,Target Field,9,-1
2019-06-15,2019,STL,NYM,7,8,135,1.5,-150,9.0,100,-120,-145,-1.5,130,3.83,Citi Field,15,-1
2019-06-15,2019,CWS,NYY,4,8,170,1.5,110,9.5,-110,-110,-185,-1.5,-130,3.52,Guaranteed Rate Field,12,-4
2019-06-15,2019,SEA,OAK,2,11,200,1.5,-105,9.0,-115,-105,-220,-1.5,-115,3.0,Oakland Coliseum,13,-9
2019-06-15,2019,ATL,PHI,5,6,-108,1.5,-175,9.5,-105,-115,-102,-1.5,151,4.93,Suntrust Park,11,-1
2019-06-15,2019,MIA,PIT,4,3,-116,-1.5,172,8.0,100,-120,106,1.5,-205,4.3,Marlins Park,7,1
2019-06-15,2019,COL,SD,14,8,-165,-1.5,-101,11.5,-115,-105,155,1.5,-119,7.16,Coors Field,22,6
2019-06-15,2019,OAK,SEA,11,2,-220,-1.5,-115,9.0,-115,-105,200,1.5,-105,6.19,Oakland Coliseum,13,9
2019-06-15,2019,MIL,SF,7,8,104,1.5,-205,7.5,-105,-115,-114,-1.5,172,3.68,AT&T Park,15,-1
2019-06-15,2019,NYM,STL,8,7,-145,-1.5,130,9.0,100,-120,135,1.5,-150,5.33,Citi Field,15,1
2019-06-15,2019,LAA,TB,5,3,180,1.5,-110,8.0,-120,100,-200,-1.5,-110,2.86,Tropicana Field,8,2
2019-06-15,2019,CIN,TEX,3,4,-116,-1.5,155,8.5,100,-120,106,1.5,-180,4.56,Great American Ballpark,7,-1
2019-06-15,2019,HOU,TOR,7,2,-230,-1.5,-125,9.0,100,-120,205,1.5,105,6.27,Minute Maid Park,9,5
2019-06-15,2019,ARI,WSH,10,3,195,1.5,-101,9.0,-115,-105,-215,-1.5,-119,3.05,Nationals Park,13,7
2019-06-16,2019,WSH,ARI,15,5,-147,-1.5,125,9.5,-115,-105,137,1.5,-145,5.65,Nationals Park,20,10
2019-06-16,2019,PHI,ATL,1,15,151,1.5,-140,10.5,-120,100,-161,-1.5,120,4.18,Suntrust Park,16,-14
2019-06-16,2019,BOS,BAL,8,6,-152,-1.5,-105,10.5,-120,100,142,1.5,-115,6.33,Camden Yards,14,2
2019-06-16,2019,BAL,BOS,6,8,142,1.5,-115,10.5,-120,100,-152,-1.5,-105,4.34,Camden Yards,14,-2
2019-06-16,2019,LAD,CHC,3,2,-168,-1.5,114,8.0,-110,-110,158,1.5,-134,5.01,Dodger Stadium,5,1
2019-06-16,2019,TEX,CIN,3,11,160,1.5,-135,8.5,-120,100,-170,-1.5,115,3.27,Great American Ballpark,14,-8
2019-06-16,2019,DET,CLE,0,8,165,1.5,-101,8.0,-115,-105,-180,-1.5,-119,3.02,Comerica Park,8,-8
2019-06-16,2019,SD,COL,14,13,138,1.5,-130,13.0,100,-120,-148,-1.5,110,5.46,Coors Field,27,1
2019-06-16,2019,NYY,CWS,10,3,-230,-1.5,-131,9.0,-120,100,205,1.5,112,6.27,Guaranteed Rate Field,13,7
2019-06-16,2019,CLE,DET,8,0,-180,-1.5,-119,8.0,-115,-105,165,1.5,-101,5.14,Comerica Park,8,8
2019-06-16,2019,TOR,HOU,12,0,205,1.5,-102,9.0,-115,-105,-230,-1.5,-117,2.95,Minute Maid Park,12,12
2019-06-16,2019,MIN,KC,6,8,-200,-1.5,-105,9.5,-105,-115,180,1.5,-115,6.33,Target Field,14,-2
2019-06-16,2019,TB,LAA,6,5,-137,-1.5,156,8.5,-110,-110,127,1.5,-179,4.91,Tropicana Field,11,1
2019-06-16,2019,CHC,LAD,2,3,158,1.5,-134,8.0,-110,-110,-168,-1.5,114,3.1,Dodger Stadium,5,-1
2019-06-16,2019,PIT,MIA,5,4,-130,-1.5,120,8.0,-105,-115,120,1.5,-140,4.52,Marlins Park,9,1
2019-06-16,2019,SF,MIL,3,5,145,1.5,-110,8.0,-120,100,-155,-1.5,-110,3.27,AT&T Park,8,-2
2019-06-16,2019,KC,MIN,8,6,180,1.5,-115,9.5,-105,-115,-200,-1.5,-105,3.39,Target Field,14,2
2019-06-16,2019,STL,NYM,4,3,-123,-1.5,131,9.0,-115,-105,113,1.5,-151,4.96,Citi Field,7,1
2019-06-16,2019,CWS,NYY,3,10,205,1.5,112,9.0,-120,100,-230,-1.5,-131,2.95,Guaranteed Rate Field,13,-7
2019-06-16,2019,SEA,OAK,6,3,140,1.5,-135,9.5,-110,-110,-150,-1.5,115,3.96,Oakland Coliseum,9,3
2019-06-16,2019,ATL,PHI,15,1,-161,-1.5,120,10.5,-120,100,151,1.5,-140,6.48,Suntrust Park,16,14
2019-06-16,2019,MIA,PIT,4,5,120,1.5,-140,8.0,-105,-115,-130,-1.5,120,3.64,Marlins Park,9,-1
2019-06-16,2019,COL,SD,13,14,-148,-1.5,110,13.0,100,-120,138,1.5,-130,7.76,Coors Field,27,-1
2019-06-16,2019,OAK,SEA,3,6,-150,-1.5,115,9.5,-110,-110,140,1.5,-135,5.7,Oakland Coliseum,9,-3
2019-06-16,2019,MIL,SF,5,3,-155,-1.5,-110,8.0,-120,100,145,1.5,-110,4.86,AT&T Park,8,2
2019-06-16,2019,NYM,STL,3,4,113,1.5,-151,9.0,-115,-105,-123,-1.5,131,4.23,Citi Field,7,-1
2019-06-16,2019,LAA,TB,5,6,127,1.5,-179,8.5,-110,-110,-137,-1.5,156,3.74,Tropicana Field,11,-1
2019-06-16,2019,CIN,TEX,11,3,-170,-1.5,115,8.5,-120,100,160,1.5,-135,5.35,Great American Ballpark,14,8
2019-06-16,2019,HOU,TOR,0,12,-230,-1.5,-117,9.0,-115,-105,205,1.5,-102,6.27,Minute Maid Park,12,-12
2019-06-16,2019,ARI,WSH,5,15,137,1.5,-145,9.5,-115,-105,-147,-1.5,125,4.01,Nationals Park,20,-10
2019-06-17,2019,NYM,ATL,3,12,125,1.5,-173,9.0,-110,-110,-135,-1.5,150,4.0,Suntrust Park,15,-9
2019-06-17,2019,OAK,BAL,3,2,-220,-1.5,-129,9.0,100,-120,200,1.5,109,6.19,Oakland Coliseum,5,1
2019-06-17,2019,MIN,BOS,0,2,-145,-1.5,130,10.5,-105,-115,135,1.5,-150,6.21,Target Field,2,-2
2019-06-17,2019,HOU,CIN,2,3,107,1.5,-195,8.5,-105,-115,-117,-1.5,166,4.11,Great American Ballpark,5,-1
2019-06-17,2019,TEX,CLE,7,2,110,1.5,-142,9.5,100,-120,-120,-1.5,122,4.52,Rangers Ballpark,9,5
2019-06-17,2019,CIN,HOU,3,2,-117,-1.5,166,8.5,-105,-115,107,1.5,-195,4.58,Great American Ballpark,5,1
2019-06-17,2019,SEA,KC,4,6,-112,-1.5,160,8.5,-110,-110,-102,1.5,-185,4.49,T-Mobile Park,10,-2
2019-06-17,2019,TOR,LAA,5,10,148,1.5,-115,11.0,-105,-115,-158,-1.5,-105,4.44,Rogers Centre,15,-5
2019-06-17,2019,SF,LAD,3,2,220,1.5,-101,8.5,-105,-115,-250,-1.5,-119,2.66,Dodger Stadium,5,1
2019-06-17,2019,STL,MIA,5,0,-220,-1.5,-115,8.0,-115,-105,200,1.5,-105,5.5,Busch Stadium,5,5
2019-06-17,2019,SD,MIL,2,0,-120,-1.5,166,8.0,-110,-110,110,1.5,-195,4.36,PETCO Park,2,2
2019-06-17,2019,BOS,MIN,2,0,135,1.5,-150,10.5,-105,-115,-145,-1.5,130,4.47,Target Field,2,2
2019-06-17,2019,ATL,NYM,12,3,-135,-1.5,150,9.0,-110,-110,125,1.5,-173,5.17,Suntrust Park,15,9
2019-06-17,2019,TB,NYY,0,3,123,1.5,-178,9.5,-105,-115,-133,-1.5,153,4.26,Yankee Stadium,3,-3
2019-06-17,2019,BAL,OAK,2,3,200,1.5,109,9.0,100,-120,-220,-1.5,-129,3.0,Oakland Coliseum,5,-1
2019-06-17,2019,MIL,SD,0,2,110,1.5,-195,8.0,-110,-110,-120,-1.5,166,3.81,PETCO Park,2,-2
2019-06-17,2019,KC,SEA,6,4,-102,1.5,-185,8.5,-110,-110,-112,-1.5,160,4.29,T-Mobile Park,10,2
2019-06-17,2019,LAD,SF,2,3,-250,-1.5,-119,8.5,-105,-115,220,1.5,-101,6.07,Dodger Stadium,5,-1
2019-06-17,2019,MIA,STL,0,5,200,1.5,-105,8.0,-115,-105,-220,-1.5,-115,2.67,Busch Stadium,5,-5
2019-06-17,2019,NYY,TB,3,0,-133,-1.5,153,9.5,-105,-115,123,1.5,-178,5.42,Yankee Stadium,3,3
2019-06-17,2019,CLE,TEX,2,7,-120,-1.5,122,9.5,100,-120,110,1.5,-142,5.18,Rangers Ballpark,9,-5
2019-06-17,2019,LAA,TOR,10,5,-158,-1.5,-105,11.0,-105,-115,148,1.5,-115,6.74,Rogers Centre,15,5
2019-06-18,2019,COL,ARI,8,1,145,1.5,-142,10.0,-125,105,-155,-1.5,122,4.08,Chase Field,9,7
2019-06-18,2019,NYM,ATL,10,2,-120,-1.5,130,9.0,100,-120,110,1.5,-150,4.91,Suntrust Park,12,8
2019-06-18,2019,OAK,BAL,16,2,-220,-1.5,-117,9.0,-105,-115,200,1.5,-102,6.19,Oakland Coliseum,18,14
2019-06-18,2019,MIN,BOS,4,3,113,1.5,-145,9.5,-120,100,-123,-1.5,125,4.46,Target Field,7,1
2019-06-18,2019,CWS,CHC,3,1,195,1.5,103,8.5,-115,-105,-215,-1.5,-123,2.88,Wrigley Field,4,2
2019-06-18,2019,HOU,CIN,3,4,-180,-1.5,-120,8.5,-110,-110,165,1.5,100,5.46,Great American Ballpark,7,-1
2019-06-18,2019,TEX,CLE,3,10,104,1.5,-140,10.5,-105,-115,-114,-1.5,120,5.15,Rangers Ballpark,13,-7
2019-06-18,2019,ARI,COL,1,8,-155,-1.5,122,10.0,-125,105,145,1.5,-142,6.08,Chase Field,9,-7
2019-06-18,2019,CHC,CWS,1,3,-215,-1.5,-123,8.5,-115,-105,195,1.5,103,5.8,Wrigley Field,4,-2
2019-06-18,2019,PIT,DET,4,5,-155,-1.5,125,9.0,-110,-110,145,1.5,-145,5.47,PNC Park,9,-1
2019-06-18,2019,CIN,HOU,4,3,165,1.5,100,8.5,-110,-110,-180,-1.5,-120,3.21,Great American Ballpark,7,1
2019-06-18,2019,SEA,KC,0,9,-134,-1.5,127,9.0,-105,-115,124,1.5,-148,5.15,T-Mobile Park,9,-9
2019-06-18,2019,TOR,LAA,1,3,112,1.5,-137,9.5,-115,-105,-122,-1.5,117,4.48,Rogers Centre,4,-2
2019-06-18,2019,SF,LAD,0,9,230,1.5,119,7.5,-110,-110,-260,-1.5,-138,2.27,Dodger Stadium,9,-9
2019-06-18,2019,STL,MIA,0,6,-260,-1.5,-135,8.0,-115,-105,230,1.5,115,5.78,Busch Stadium,6,-6
2019-06-18,2019,SD,MIL,4,1,156,1.5,-127,8.0,105,-125,-166,-1.5,105,3.13,PETCO Park,5,3
2019-06-18,2019,BOS,MIN,3,4,-123,-1.5,125,9.5,-120,100,113,1.5,-145,5.24,Target Field,7,-1
2019-06-18,2019,ATL,NYM,2,10,110,1.5,-150,9.0,100,-120,-120,-1.5,130,4.29,Suntrust Park,12,-8
2019-06-18,2019,TB,NYY,3,6,137,1.5,-137,9.5,-120,100,-147,-1.5,115,4.01,Yankee Stadium,9,-3
2019-06-18,2019,BAL,OAK,2,16,200,1.5,-102,9.0,-105,-115,-220,-1.5,-117,3.0,Oakland Coliseum,18,-14
2019-06-18,2019,DET,PIT,5,4,145,1.5,-145,9.0,-110,-110,-155,-1.5,125,3.67,PNC Park,9,1
2019-06-18,2019,MIL,SD,1,4,-166,-1.5,105,8.0,105,-125,156,1.5,-127,4.99,PETCO Park,5,-3
2019-06-18,2019,KC,SEA,9,0,124,1.5,-148,9.0,-105,-115,-134,-1.5,127,4.02,T-Mobile Park,9,9
2019-06-18,2019,LAD,SF,9,0,-260,-1.5,-138,7.5,-110,-110,230,1.5,119,5.42,Dodger Stadium,9,9
2019-06-18,2019,MIA,STL,6,0,230,1.5,115,8.0,-115,-105,-260,-1.5,-135,2.42,Busch Stadium,6,6
2019-06-18,2019,NYY,TB,6,3,-147,-1.5,115,9.5,-120,100,137,1.5,-137,5.65,Yankee Stadium,9,3
2019-06-18,2019,CLE,TEX,10,3,-114,-1.5,120,10.5,-105,-115,104,1.5,-140,5.59,Rangers Ballpark,13,7
2019-06-18,2019,LAA,TOR,3,1,-122,-1.5,117,9.5,-115,-105,112,1.5,-137,5.22,Rogers Centre,4,2
2019-06-19,2019,COL,ARI,6,4,140,1.5,-150,8.5,-120,100,-150,-1.5,130,3.54,Chase Field,10,2
2019-06-19,2019,NYM,ATL,2,7,132,1.5,-157,10.0,-120,100,-142,-1.5,138,4.31,Suntrust Park,9,-5
2019-06-19,2019,OAK,BAL,8,3,-300,-1.5,-155,9.5,-115,-105,260,1.5,135,7.13,Oakland Coliseum,11,5
2019-06-19,2019,MIN,BOS,4,9,-113,-1.5,170,9.5,-105,-115,103,1.5,-200,5.04,Target Field,13,-5
2019-06-19,2019,CWS,CHC,3,7,128,1.5,-195,7.0,-115,-105,-138,-1.5,166,3.07,Wrigley Field,10,-4
2019-06-19,2019,HOU,CIN,2,3,-200,-1.5,-131,8.0,-120,100,180,1.5,111,5.33,Great American Ballpark,5,-1
2019-06-19,2019,TEX,CLE,4,10,113,1.5,-162,11.0,-105,-115,-123,-1.5,140,5.16,Rangers Ballpark,14,-6
2019-06-19,2019,ARI,COL,4,6,-150,-1.5,130,8.5,-120,100,140,1.5,-150,5.1,Chase Field,10,-2
2019-06-19,2019,CHC,CWS,7,3,-138,-1.5,166,7.0,-115,-105,128,1.5,-195,4.06,Wrigley Field,10,4
2019-06-19,2019,PIT,DET,8,7,-200,-1.5,-110,9.0,-105,-115,180,1.5,-110,6.0,PNC Park,15,1
2019-06-19,2019,CIN,HOU,3,2,180,1.5,111,8.0,-120,100,-200,-1.5,-131,2.86,Great American Ballpark,5,1
2019-06-19,2019,SEA,KC,8,2,-125,-1.5,162,8.5,-120,100,115,1.5,-188,4.72,T-Mobile Park,10,6
2019-06-19,2019,TOR,LAA,6,11,175,1.5,115,10.5,-110,-110,-190,-1.5,-135,3.82,Rogers Centre,17,-5
2019-06-19,2019,SF,LAD,2,9,220,1.5,-103,7.5,-120,100,-250,-1.5,-117,2.34,Dodger Stadium,11,-7
2019-06-19,2019,STL,MIA,2,1,-168,-1.5,110,8.5,-110,-110,158,1.5,-130,5.33,Busch Stadium,3,1
2019-06-19,2019,SD,MIL,8,7,104,1.5,-166,8.5,-105,-115,-114,-1.5,145,4.17,PETCO Park,15,1
2019-06-19,2019,BOS,MIN,9,4,103,1.5,-200,9.5,-105,-115,-113,-1.5,170,4.68,Target Field,13,5
2019-06-19,2019,ATL,NYM,7,2,-142,-1.5,138,10.0,-120,100,132,1.5,-157,5.87,Suntrust Park,9,5
2019-06-19,2019,TB,NYY,1,12,-125,-1.5,120,9.0,-120,100,115,1.5,-140,5.0,Yankee Stadium,13,-11
2019-06-19,2019,BAL,OAK,3,8,260,1.5,135,9.5,-115,-105,-300,-1.5,-155,2.64,Oakland Coliseum,11,-5
2019-06-19,2019,WSH,PHI,6,2,-150,-1.5,130,9.5,-110,-110,140,1.5,-150,5.7,Nationals Park,8,4
2019-06-19,2019,WSH,PHI,2,0,-210,-1.5,-105,8.5,-115,-105,190,1.5,-115,5.76,Nationals Park,2,2
2019-06-19,2019,DET,PIT,7,8,180,1.5,-110,9.0,-105,-115,-200,-1.5,-110,3.21,PNC Park,15,-1
2019-06-19,2019,MIL,SD,7,8,-114,-1.5,145,8.5,-105,-115,104,1.5,-166,4.53,PETCO Park,15,-1
2019-06-19,2019,KC,SEA,2,8,115,1.5,-188,8.5,-120,100,-125,-1.5,162,3.95,T-Mobile Park,10,-6
2019-06-19,2019,LAD,SF,9,2,-250,-1.5,-117,7.5,-120,100,220,1.5,-103,5.36,Dodger Stadium,11,7
2019-06-19,2019,MIA,STL,1,2,158,1.5,-130,8.5,-110,-110,-168,-1.5,110,3.29,Busch Stadium,3,-1
2019-06-19,2019,NYY,TB,12,1,115,1.5,-140,9.0,-120,100,-125,-1.5,120,4.19,Yankee Stadium,13,11
2019-06-19,2019,CLE,TEX,10,4,-123,-1.5,140,11.0,-105,-115,113,1.5,-162,6.07,Rangers Ballpark,14,6
2019-06-19,2019,LAA,TOR,11,6,-190,-1.5,-135,10.5,-110,-110,175,1.5,115,6.88,Rogers Centre,17,5
2019-06-19,2019,PHI,WSH,2,6,140,1.5,-150,9.5,-110,-110,-150,-1.5,130,3.96,Nationals Park,8,-4
2019-06-19,2019,PHI,WSH,0,2,190,1.5,-115,8.5,-115,-105,-210,-1.5,-105,2.93,Nationals Park,2,-2
2019-06-20,2019,COL,ARI,6,4,161,1.5,-135,8.5,-115,-105,-172,-1.5,115,3.26,Chase Field,10,2
2019-06-20,2019,SEA,BAL,5,2,-138,-1.5,149,9.0,100,-120,128,1.5,-171,5.22,T-Mobile Park,7,3
2019-06-20,2019,NYM,CHC,4,7,140,1.5,-150,9.5,-120,100,-150,-1.5,130,3.96,Wrigley Field,11,-3
2019-06-20,2019,MIL,CIN,1,7,-153,-1.5,125,9.5,-105,-115,143,1.5,-145,5.75,Miller Park,8,-6
2019-06-20,2019,TEX,CLE,4,2,107,1.5,-146,9.0,-105,-115,-117,-1.5,126,4.35,Rangers Ballpark,6,2
2019-06-20,2019,ARI,COL,4,6,-172,-1.5,115,8.5,-115,-105,161,1.5,-135,5.38,Chase Field,10,-2
2019-06-20,2019,NYY,HOU,10,6,-128,-1.5,131,10.0,-110,-110,118,1.5,-150,5.61,Yankee Stadium,16,4
2019-06-20,2019,MIN,KC,1,4,-190,-1.5,-130,9.5,-120,100,175,1.5,110,6.22,Kauffman Stadium,5,-3
2019-06-20,2019,TOR,LAA,7,5,136,1.5,-115,10.5,-110,-110,-146,-1.5,-105,4.45,Rogers Centre,12,2
2019-06-20,2019,SF,LAD,8,9,150,1.5,-150,7.5,-115,-105,-160,-1.5,130,3.0,Dodger Stadium,17,-1
2019-06-20,2019,STL,MIA,6,7,-176,-1.5,110,8.0,-110,-110,163,1.5,-130,5.1,Busch Stadium,13,-1
2019-06-20,2019,CIN,MIL,7,1,143,1.5,-145,9.5,-105,-115,-153,-1.5,125,3.91,Miller Park,8,6
2019-06-20,2019,KC,MIN,4,1,175,1.5,110,9.5,-120,100,-190,-1.5,-130,3.45,Kauffman Stadium,5,3
2019-06-20,2019,CHC,NYM,7,4,-150,-1.5,130,9.5,-120,100,140,1.5,-150,5.7,Wrigley Field,11,3
2019-06-20,2019,HOU,NYY,6,10,118,1.5,-150,10.0,-110,-110,-128,-1.5,131,4.59,Yankee Stadium,16,-4
2019-06-20,2019,TB,OAK,4,5,100,1.5,-215,7.5,-110,-110,-110,-1.5,180,3.75,Oakland Coliseum,9,-1
2019-06-20,2019,WSH,PHI,7,4,-102,1.5,-160,10.5,-120,100,-108,-1.5,140,5.3,Nationals Park,11,3
2019-06-20,2019,BAL,SEA,2,5,128,1.5,-171,9.0,100,-120,-138,-1.5,149,3.95,T-Mobile Park,7,-3
2019-06-20,2019,LAD,SF,9,8,-160,-1.5,130,7.5,-115,-105,150,1.5,-150,4.62,Dodger Stadium,17,1
2019-06-20,2019,MIA,STL,7,6,163,1.5,-130,8.0,-110,-110,-176,-1.5,110,3.04,Busch Stadium,13,1
2019-06-20,2019,OAK,TB,5,4,-110,-1.5,180,7.5,-110,-110,100,1.5,-215,3.93,Oakland Coliseum,9,1
2019-06-20,2019,CLE,TEX,2,4,-117,-1.5,126,9.0,-105,-115,107,1.5,-146,4.85,Rangers Ballpark,6,-2
2019-06-20,2019,LAA,TOR,5,7,-146,-1.5,-105,10.5,-110,-110,136,1.5,-115,6.23,Rogers Centre,12,-2
2019-06-20,2019,PHI,WSH,4,7,-108,-1.5,140,10.5,-120,100,-102,1.5,-160,5.45,Nationals Park,11,-3
2019-06-21,2019,SF,ARI,11,5,220,1.5,-154,10.0,105,-125,-250,-1.5,134,3.13,Chase Field,16,6
2019-06-21,2019,WSH,ATL,4,3,125,-1.5,130,9.5,100,-120,-135,1.5,-150,4.22,Nationals Park,7,1
2019-06-21,2019,SEA,BAL,10,9,-172,-1.5,-106,9.0,-120,100,161,1.5,-114,5.69,T-Mobile Park,19,1
2019-06-21,2019,TOR,BOS,5,7,165,1.5,130,8.5,-105,-115,-180,-1.5,-150,3.21,Fenway Park,12,-2
2019-06-21,2019,NYM,CHC,5,4,150,1.5,-138,9.0,-115,-105,-160,-1.5,118,3.6,Wrigley Field,9,1
2019-06-21,2019,MIL,CIN,7,11,-105,-1.5,166,8.5,-120,100,-105,1.5,-195,4.35,Miller Park,18,-4
2019-06-21,2019,DET,CLE,6,7,-125,1.5,-126,7.5,100,-120,115,-1.5,105,4.17,Progressive Field,13,-1
2019-06-21,2019,LAD,COL,4,2,-141,-1.5,110,7.5,100,-120,131,1.5,-130,4.39,Dodger Stadium,6,2
2019-06-21,2019,TEX,CWS,4,5,130,-1.5,110,11.5,-110,-110,-140,1.5,-130,5.0,Rangers Ballpark,9,-1
2019-06-21,2019,CLE,DET,7,6,115,-1.5,105,7.5,100,-120,-125,1.5,-126,3.49,Progressive Field,13,1
2019-06-21,2019,NYY,HOU,4,1,-160,-1.5,130,9.5,-110,-110,150,1.5,-151,5.85,Yankee Stadium,5,3
2019-06-21,2019,MIN,KC,8,7,115,-1.5,-105,10.5,100,-120,-125,1.5,-115,4.88,Kauffman Stadium,15,1
2019-06-21,2019,STL,LAA,5,1,-143,1.5,-158,9.5,-105,-115,133,-1.5,138,5.59,Busch Stadium,6,4
2019-06-21,2019,COL,LAD,2,4,131,1.5,-130,7.5,100,-120,-141,-1.5,110,3.25,Dodger Stadium,6,-2
2019-06-21,2019,PHI,MIA,1,2,140,-1.5,-126,8.0,-105,-115,-150,1.5,107,3.33,Citizens Bank Park,3,-1
2019-06-21,2019,CIN,MIL,11,7,-105,1.5,-195,8.5,-120,100,-105,-1.5,166,4.35,Miller Park,18,4
2019-06-21,2019,KC,MIN,7,8,-125,1.5,-115,10.5,100,-120,115,-1.5,-105,5.83,Kauffman Stadium,15,-1
2019-06-21,2019,CHC,NYM,4,5,-160,-1.5,118,9.0,-115,-105,150,1.5,-138,5.54,Wrigley Field,9,-1
2019-06-21,2019,HOU,NYY,1,4,150,1.5,-151,9.5,-110,-110,-160,-1.5,130,3.8,Yankee Stadium,5,-3
2019-06-21,2019,TB,OAK,5,3,112,-1.5,155,9.0,-110,-110,-122,1.5,-180,4.25,Oakland Coliseum,8,2
2019-06-21,2019,MIA,PHI,2,1,-150,1.5,107,8.0,-105,-115,140,-1.5,-126,4.8,Citizens Bank Park,3,1
2019-06-21,2019,SD,PIT,1,2,176,1.5,-201,9.5,-110,-110,-192,-1.5,169,3.44,PNC Park,3,-1
2019-06-21,2019,PIT,SD,2,1,-192,-1.5,169,9.5,-110,-110,176,1.5,-201,6.25,PNC Park,3,1
2019-06-21,2019,BAL,SEA,9,10,161,1.5,-114,9.0,-120,100,-172,-1.5,-106,3.45,T-Mobile Park,19,-1
2019-06-21,2019,ARI,SF,5,11,-250,-1.5,134,10.0,105,-125,220,1.5,-154,7.14,Chase Field,16,-6
2019-06-21,2019,LAA,STL,1,5,133,-1.5,138,9.5,-105,-115,-143,1.5,-158,4.08,Busch Stadium,6,-4
2019-06-21,2019,OAK,TB,3,5,-122,1.5,-180,9.0,-110,-110,112,-1.5,155,4.95,Oakland Coliseum,8,-2
2019-06-21,2019,CWS,TEX,5,4,-140,1.5,-130,11.5,-110,-110,130,-1.5,110,6.71,Rangers Ballpark,9,1
2019-06-21,2019,BOS,TOR,7,5,-180,-1.5,-150,8.5,-105,-115,165,1.5,130,5.46,Fenway Park,12,2
2019-06-21,2019,ATL,WSH,3,4,-135,1.5,-150,9.5,100,-120,125,-1.5,130,5.46,Nationals Park,7,-1
2019-06-22,2019,SF,ARI,7,4,117,1.5,-170,10.0,-115,-105,-127,-1.5,148,4.61,Chase Field,11,3
2019-06-22,2019,WSH,ATL,9,13,-105,-1.5,165,10.5,-120,100,-105,1.5,-193,5.38,Nationals Park,22,-4
2019-06-22,2019,SEA,BAL,4,8,-174,-1.5,106,9.0,-105,-115,162,1.5,-126,5.72,T-Mobile Park,12,-4
2019-06-22,2019,TOR,BOS,8,7,162,1.5,-115,11.5,-115,-105,-174,-1.5,-105,4.39,Fenway Park,15,1
2019-06-22,2019,NYM,CHC,10,2,120,1.5,-170,8.5,-120,100,-130,-1.5,148,3.86,Wrigley Field,12,8
2019-06-22,2019,MIL,CIN,6,5,-120,-1.5,170,9.0,-105,-115,110,1.5,-200,4.91,Miller Park,11,1
2019-06-22,2019,DET,CLE,0,2,175,1.5,-125,9.0,-115,-105,-190,-1.5,105,3.27,Progressive Field,2,-2
2019-06-22,2019,LAD,COL,5,4,-260,-1.5,-130,8.5,-120,100,230,1.5,110,6.14,Dodger Stadium,9,1
2019-06-22,2019,TEX,CWS,6,5,-185,-1.5,-106,10.5,100,-120,170,1.5,-114,6.82,Rangers Ballpark,11,1
2019-06-22,2019,CLE,DET,2,0,-190,-1.5,105,9.0,-115,-105,175,1.5,-125,5.9,Progressive Field,2,2
2019-06-22,2019,NYY,HOU,7,5,-164,-1.5,105,10.5,-110,-110,154,1.5,-125,6.52,Yankee Stadium,12,2
2019-06-22,2019,MIN,KC,5,3,-166,-1.5,-122,10.0,-105,-115,156,1.5,102,6.24,Kauffman Stadium,8,2
2019-06-22,2019,STL,LAA,4,2,-136,-1.5,140,9.5,100,-120,126,1.5,-160,5.47,Busch Stadium,6,2
2019-06-22,2019,COL,LAD,4,5,230,1.5,110,8.5,-120,100,-260,-1.5,-130,2.58,Dodger Stadium,9,-1
2019-06-22,2019,PHI,MIA,3,5,-200,-1.5,-105,9.0,-105,-115,180,1.5,-115,6.0,Citizens Bank Park,8,-2
2019-06-22,2019,CIN,MIL,5,6,110,1.5,-200,9.0,-105,-115,-120,-1.5,170,4.29,Miller Park,11,-1
2019-06-22,2019,KC,MIN,3,5,156,1.5,102,10.0,-105,-115,-166,-1.5,-122,3.91,Kauffman Stadium,8,-2
2019-06-22,2019,CHC,NYM,2,10,-130,-1.5,148,8.5,-120,100,120,1.5,-170,4.8,Wrigley Field,12,-8
2019-06-22,2019,HOU,NYY,5,7,154,1.5,-125,10.5,-110,-110,-164,-1.5,105,4.13,Yankee Stadium,12,-2
2019-06-22,2019,TB,OAK,2,4,-105,1.5,-210,9.0,-115,-105,-105,-1.5,176,4.61,Oakland Coliseum,6,-2
2019-06-22,2019,MIA,PHI,5,3,180,1.5,-115,9.0,-105,-115,-200,-1.5,-105,3.21,Citizens Bank Park,8,2
2019-06-22,2019,SD,PIT,3,6,-111,-1.5,136,9.0,-105,-115,101,1.5,-156,4.73,PNC Park,9,-3
2019-06-22,2019,PIT,SD,6,3,101,1.5,-156,9.0,-105,-115,-111,-1.5,136,4.48,PNC Park,9,3
2019-06-22,2019,BAL,SEA,8,4,162,1.5,-126,9.0,-105,-115,-174,-1.5,106,3.44,T-Mobile Park,12,4
2019-06-22,2019,ARI,SF,4,7,-127,-1.5,148,10.0,-115,-105,117,1.5,-170,5.59,Chase Field,11,-3
2019-06-22,2019,LAA,STL,2,4,126,1.5,-160,9.5,100,-120,-136,-1.5,140,4.2,Busch Stadium,6,-2
2019-06-22,2019,OAK,TB,4,2,-105,-1.5,176,9.0,-115,-105,-105,1.5,-210,4.61,Oakland Coliseum,6,2
2019-06-22,2019,CWS,TEX,5,6,170,1.5,-114,10.5,100,-120,-185,-1.5,-106,3.89,Rangers Ballpark,11,-1
2019-06-22,2019,BOS,TOR,7,8,-174,-1.5,-105,11.5,-115,-105,162,1.5,-115,7.3,Fenway Park,15,-1
2019-06-22,2019,ATL,WSH,13,9,-105,1.5,-193,10.5,-120,100,-105,-1.5,165,5.38,Nationals Park,22,4
2019-06-23,2019,SF,ARI,2,3,131,1.5,-156,9.0,-110,-110,-141,-1.5,136,3.9,Chase Field,5,-1
2019-06-23,2019,WSH,ATL,3,4,140,1.5,-125,10.5,-105,-115,-150,-1.5,105,4.38,Nationals Park,7,-1
2019-06-23,2019,SEA,BAL,13,3,-172,-1.5,110,10.0,105,-125,161,1.5,-130,6.32,T-Mobile Park,16,10
2019-06-23,2019,TOR,BOS,6,1,150,1.5,-120,10.0,-115,-105,-160,-1.5,100,4.0,Fenway Park,7,5
2019-06-23,2019,NYM,CHC,3,5,-105,-1.5,140,8.5,100,-120,-105,1.5,-160,4.35,Wrigley Field,8,-2
2019-06-23,2019,MIL,CIN,7,5,-192,-1.5,103,9.0,100,-120,176,1.5,-123,5.92,Miller Park,12,2
2019-06-23,2019,DET,CLE,3,8,165,1.5,-123,9.5,-105,-115,-180,-1.5,103,3.58,Progressive Field,11,-5
2019-06-23,2019,LAD,COL,6,3,-250,-1.5,-125,9.0,100,-120,220,1.5,106,6.43,Dodger Stadium,9,3
2019-06-23,2019,TEX,CWS,7,4,-125,-1.5,148,12.0,-115,-105,115,1.5,-170,6.67,Rangers Ballpark,11,3
2019-06-23,2019,CLE,DET,8,3,-180,-1.5,103,9.5,-105,-115,165,1.5,-123,6.11,Progressive Field,11,5
2019-06-23,2019,NYY,HOU,4,9,115,1.5,-150,10.0,-105,-115,-125,-1.5,130,4.65,Yankee Stadium,13,-5
2019-06-23,2019,MIN,KC,1,6,-140,-1.5,-110,10.5,-105,-115,130,1.5,-110,6.13,Kauffman Stadium,7,-5
2019-06-23,2019,STL,LAA,4,6,-143,-1.5,135,9.0,-110,-110,133,1.5,-155,5.3,Busch Stadium,10,-2
2019-06-23,2019,COL,LAD,3,6,220,1.5,106,9.0,100,-120,-250,-1.5,-125,2.81,Dodger Stadium,9,-3
2019-06-23,2019,PHI,MIA,4,6,-160,-1.5,125,9.0,100,-120,150,1.5,-145,5.54,Citizens Bank Park,10,-2
2019-06-23,2019,CIN,MIL,5,7,176,1.5,-123,9.0,100,-120,-192,-1.5,103,3.26,Miller Park,12,-2
2019-06-23,2019,KC,MIN,6,1,130,1.5,-110,10.5,-105,-115,-140,-1.5,-110,4.57,Kauffman Stadium,7,5
2019-06-23,2019,CHC,NYM,5,3,-105,1.5,-160,8.5,100,-120,-105,-1.5,140,4.35,Wrigley Field,8,2
2019-06-23,2019,HOU,NYY,9,4,-125,-1.5,130,10.0,-105,-115,115,1.5,-150,5.56,Yankee Stadium,13,5
2019-06-23,2019,TB,OAK,8,2,112,1.5,-183,9.0,-120,100,-122,-1.5,157,4.25,Oakland Coliseum,10,6
2019-06-23,2019,MIA,PHI,6,4,150,1.5,-145,9.0,100,-120,-160,-1.5,125,3.6,Citizens Bank Park,10,2
2019-06-23,2019,SD,PIT,10,11,-135,-1.5,120,9.5,-110,-110,125,1.5,-140,5.46,PNC Park,21,-1
2019-06-23,2019,PIT,SD,11,10,125,1.5,-140,9.5,-110,-110,-135,-1.5,120,4.22,PNC Park,21,1
2019-06-23,2019,BAL,SEA,3,13,161,1.5,-130,10.0,105,-125,-172,-1.5,110,3.83,T-Mobile Park,16,-10
2019-06-23,2019,ARI,SF,3,2,-141,-1.5,136,9.0,-110,-110,131,1.5,-156,5.27,Chase Field,5,1
2019-06-23,2019,LAA,STL,6,4,133,1.5,-155,9.0,-110,-110,-143,-1.5,135,3.86,Busch Stadium,10,2
2019-06-23,2019,OAK,TB,2,8,-122,-1.5,157,9.0,-120,100,112,1.5,-183,4.95,Oakland Coliseum,10,-6
2019-06-23,2019,CWS,TEX,4,7,115,1.5,-170,12.0,-115,-105,-125,-1.5,148,5.58,Rangers Ballpark,11,-3
2019-06-23,2019,BOS,TOR,1,6,-160,-1.5,100,10.0,-115,-105,150,1.5,-120,6.15,Fenway Park,7,-5
2019-06-23,2019,ATL,WSH,4,3,-150,-1.5,105,10.5,-105,-115,140,1.5,-125,6.3,Nationals Park,7,1
2019-06-24,2019,LAD,ARI,5,8,-125,-1.5,130,8.5,-115,-105,115,1.5,-150,4.72,Chase Field,13,-3
2019-06-24,2019,CHC,ATL,8,3,-132,-1.5,135,12.0,-115,-105,122,1.5,-155,6.83,Wrigley Field,11,5
2019-06-24,2019,CWS,BOS,5,6,157,1.5,-130,9.0,-115,-105,-167,-1.5,110,3.5,Fenway Park,11,-1
2019-06-24,2019,ATL,CHC,3,8,122,1.5,-155,12.0,-115,-105,-132,-1.5,135,5.41,Wrigley Field,11,-5
2019-06-24,2019,KC,CLE,2,3,170,1.5,-115,10.0,-110,-110,-185,-1.5,-105,3.7,Progressive Field,5,-1
2019-06-24,2019,SF,COL,0,2,109,1.5,-160,7.5,-120,100,-119,-1.5,140,3.59,AT&T Park,2,-2
2019-06-24,2019,BOS,CWS,6,5,-167,-1.5,110,9.0,-115,-105,157,1.5,-130,5.63,Fenway Park,11,1
2019-06-24,2019,CLE,KC,3,2,-185,-1.5,-105,10.0,-110,-110,170,1.5,-115,6.49,Progressive Field,5,1
2019-06-24,2019,ARI,LAD,8,5,115,1.5,-150,8.5,-115,-105,-125,-1.5,130,3.95,Chase Field,13,3
2019-06-24,2019,PHI,NYM,13,7,-133,-1.5,140,10.0,-115,-105,123,1.5,-160,5.71,Citizens Bank Park,20,6
2019-06-24,2019,TOR,NYY,8,10,220,1.5,125,11.0,-110,-110,-250,-1.5,-145,3.44,Yankee Stadium,18,-2
2019-06-24,2019,NYM,PHI,7,13,123,1.5,-160,10.0,-115,-105,-133,-1.5,140,4.48,Citizens Bank Park,20,-6
2019-06-24,2019,COL,SF,2,0,-119,-1.5,140,7.5,-120,100,109,1.5,-160,4.08,AT&T Park,2,2
2019-06-24,2019,NYY,TOR,10,8,-250,-1.5,-145,11.0,-110,-110,220,1.5,125,7.86,Yankee Stadium,18,2
2019-06-25,2019,LAD,ARI,3,2,110,-1.5,160,9.5,100,-120,-120,1.5,-180,4.52,Chase Field,5,1
2019-06-25,2019,CHC,ATL,2,3,-105,1.5,-160,12.5,100,-120,-105,-1.5,140,6.4,Wrigley Field,5,-1
2019-06-25,2019,SD,BAL,8,3,-190,-1.5,-125,11.0,-105,-115,175,1.5,105,7.21,Camden Yards,11,5
2019-06-25,2019,CWS,BOS,3,6,245,1.5,125,10.5,105,-125,-280,-1.5,-145,3.04,Fenway Park,9,-3
2019-06-25,2019,ATL,CHC,3,2,-105,-1.5,140,12.5,100,-120,-105,1.5,-160,6.4,Wrigley Field,5,1
2019-06-25,2019,LAA,CIN,5,1,-140,-1.5,135,9.0,-110,-110,130,1.5,-155,5.25,Angel Stadium,6,4
2019-06-25,2019,KC,CLE,8,6,220,1.5,115,9.5,100,-120,-250,-1.5,-135,2.97,Progressive Field,14,2
2019-06-25,2019,SF,COL,4,2,-156,-1.5,130,8.0,-105,-115,146,1.5,-150,4.88,AT&T Park,6,2
2019-06-25,2019,BOS,CWS,6,3,-280,-1.5,-145,10.5,105,-125,245,1.5,125,7.74,Fenway Park,9,3
2019-06-25,2019,TEX,DET,5,3,-150,-1.5,-105,10.0,-115,-105,140,1.5,-115,6.0,Comerica Park,8,2
2019-06-25,2019,PIT,HOU,1,5,245,1.5,130,9.0,100,-120,-280,-1.5,-150,2.61,Minute Maid Park,6,-4
2019-06-25,2019,CLE,KC,6,8,-250,-1.5,-135,9.5,100,-120,220,1.5,115,6.79,Progressive Field,14,-2
2019-06-25,2019,CIN,LAA,1,5,130,1.5,-155,9.0,-110,-110,-140,-1.5,135,3.91,Angel Stadium,6,-4
2019-06-25,2019,ARI,LAD,2,3,-120,1.5,-180,9.5,100,-120,110,-1.5,160,5.18,Chase Field,5,-1
2019-06-25,2019,WSH,MIA,6,1,-240,-1.5,-130,7.0,-115,-105,210,1.5,110,4.94,Marlins Park,7,5
2019-06-25,2019,SEA,MIL,8,3,160,1.5,-130,10.5,-110,-110,-170,-1.5,110,4.04,Miller Park,11,5
2019-06-25,2019,TB,MIN,4,9,-106,-1.5,150,9.5,-105,-115,-104,1.5,-170,4.89,Target Field,13,-5
2019-06-25,2019,PHI,NYM,7,5,-156,-1.5,115,11.0,-120,100,146,1.5,-135,6.7,Citizens Bank Park,12,2
2019-06-25,2019,TOR,NYY,3,4,270,1.5,145,12.5,100,-120,-310,-1.5,-165,3.38,Yankee Stadium,7,-1
2019-06-25,2019,STL,OAK,3,7,-160,-1.5,125,9.0,100,-120,150,1.5,-145,5.54,Busch Stadium,10,-4
2019-06-25,2019,NYM,PHI,5,7,146,1.5,-135,11.0,-120,100,-156,-1.5,115,4.47,Citizens Bank Park,12,-2
2019-06-25,2019,HOU,PIT,5,1,-280,-1.5,-150,9.0,100,-120,245,1.5,130,6.63,Minute Maid Park,6,4
2019-06-25,2019,BAL,SD,3,8,175,1.5,105,11.0,-105,-115,-190,-1.5,-125,4.0,Camden Yards,11,-5
2019-06-25,2019,MIL,SEA,3,8,-170,-1.5,110,10.5,-110,-110,160,1.5,-130,6.61,Miller Park,11,-5
2019-06-25,2019,COL,SF,2,4,146,1.5,-150,8.0,-105,-115,-156,-1.5,130,3.25,AT&T Park,6,-2
2019-06-25,2019,OAK,STL,7,3,150,1.5,-145,9.0,100,-120,-160,-1.5,125,3.6,Busch Stadium,10,4
2019-06-25,2019,MIN,TB,9,4,-104,1.5,-170,9.5,-105,-115,-106,-1.5,150,4.84,Target Field,13,5
2019-06-25,2019,DET,TEX,3,5,140,1.5,-115,10.0,-115,-105,-150,-1.5,-105,4.17,Comerica Park,8,-2
2019-06-25,2019,NYY,TOR,4,3,-310,-1.5,-165,12.5,100,-120,270,1.5,145,9.45,Yankee Stadium,7,1
2019-06-25,2019,MIA,WSH,1,6,210,1.5,110,7.0,-115,-105,-240,-1.5,-130,2.26,Marlins Park,7,-5
2019-06-26,2019,LAD,ARI,2,8,-150,-1.5,100,10.0,100,-120,140,1.5,-120,6.0,Chase Field,10,-6
2019-06-26,2019,CHC,ATL,3,5,-123,-1.5,150,9.5,100,-120,113,1.5,-170,5.24,Wrigley Field,8,-2
2019-06-26,2019,SD,BAL,10,5,-122,-1.5,115,10.0,-110,-110,112,1.5,-135,5.5,Camden Yards,15,5
2019-06-26,2019,CWS,BOS,8,7,320,1.5,160,9.0,-120,100,-380,-1.5,-180,2.14,Fenway Park,15,1
2019-06-26,2019,ATL,CHC,5,3,113,1.5,-170,9.5,100,-120,-123,-1.5,150,4.46,Wrigley Field,8,2
2019-06-26,2019,LAA,CIN,5,1,-118,-1.5,170,9.5,-110,-110,108,1.5,-190,5.14,Angel Stadium,6,4
2019-06-26,2019,KC,CLE,3,5,205,1.5,100,8.5,-120,100,-230,-1.5,-120,2.79,Progressive Field,8,-2
2019-06-26,2019,SF,COL,3,6,130,1.5,-140,7.5,-110,-110,-140,-1.5,120,3.26,AT&T Park,9,-3
2019-06-26,2019,BOS,CWS,7,8,-380,-1.5,-180,9.0,-120,100,320,1.5,160,7.13,Fenway Park,15,-1
2019-06-26,2019,TEX,DET,4,1,-114,1.5,-220,8.5,-120,100,104,-1.5,195,4.53,Comerica Park,5,3
2019-06-26,2019,PIT,HOU,14,2,210,1.5,110,9.5,-120,100,-240,-1.5,-130,3.06,Minute Maid Park,16,12
2019-06-26,2019,CLE,KC,5,3,-230,-1.5,-120,8.5,-120,100,205,1.5,100,5.92,Progressive Field,8,2
2019-06-26,2019,CIN,LAA,1,5,108,1.5,-190,9.5,-110,-110,-118,-1.5,170,4.57,Angel Stadium,6,-4
2019-06-26,2019,ARI,LAD,8,2,140,1.5,-120,10.0,100,-120,-150,-1.5,100,4.17,Chase Field,10,6
2019-06-26,2019,WSH,MIA,7,5,-142,-1.5,110,7.5,-120,100,132,1.5,-130,4.4,Marlins Park,12,2
2019-06-26,2019,SEA,MIL,4,2,190,1.5,100,10.5,-120,100,-210,-1.5,-120,3.62,Miller Park,6,2
2019-06-26,2019,TB,MIN,4,6,-113,1.5,-210,9.0,100,-120,103,-1.5,185,4.77,Target Field,10,-2
2019-06-26,2019,PHI,NYM,5,4,-150,-1.5,120,11.0,-105,-115,140,1.5,-140,6.6,Citizens Bank Park,9,1
2019-06-26,2019,TOR,NYY,7,8,225,1.5,115,10.0,-110,-110,-255,-1.5,-135,3.08,Yankee Stadium,15,-1
2019-06-26,2019,STL,OAK,0,2,-140,-1.5,140,9.5,105,-125,130,1.5,-160,5.54,Busch Stadium,2,-2
2019-06-26,2019,NYM,PHI,4,5,140,1.5,-140,11.0,-105,-115,-150,-1.5,120,4.58,Citizens Bank Park,9,-1
2019-06-26,2019,HOU,PIT,2,14,-240,-1.5,-130,9.5,-120,100,210,1.5,110,6.71,Minute Maid Park,16,-12
2019-06-26,2019,BAL,SD,5,10,112,1.5,-135,10.0,-110,-110,-122,-1.5,115,4.72,Camden Yards,15,-5
2019-06-26,2019,MIL,SEA,2,4,-210,-1.5,-120,10.5,-120,100,190,1.5,100,7.11,Miller Park,6,-2
2019-06-26,2019,COL,SF,6,3,-140,-1.5,120,7.5,-110,-110,130,1.5,-140,4.38,AT&T Park,9,3
2019-06-26,2019,OAK,STL,2,0,130,1.5,-160,9.5,105,-125,-140,-1.5,140,4.13,Busch Stadium,2,2
2019-06-26,2019,MIN,TB,6,4,103,-1.5,185,9.0,100,-120,-113,1.5,-210,4.43,Target Field,10,2
2019-06-26,2019,DET,TEX,1,4,104,-1.5,195,8.5,-120,100,-114,1.5,-220,4.17,Comerica Park,5,-3
2019-06-26,2019,NYY,TOR,8,7,-255,-1.5,-135,10.0,-110,-110,225,1.5,115,7.18,Yankee Stadium,15,1
2019-06-26,2019,MIA,WSH,5,7,132,1.5,-130,7.5,-120,100,-142,-1.5,110,3.23,Marlins Park,12,-2
2019-06-27,2019,SF,ARI,1,5,-104,1.5,-170,8.5,-110,-110,-106,-1.5,150,4.33,AT&T Park,6,-4
2019-06-27,2019,CHC,ATL,9,7,-108,-1.5,165,11.0,105,-125,-102,1.5,-185,5.71,Wrigley Field,16,2
2019-06-27,2019,ATL,CHC,7,9,-102,1.5,-185,11.0,105,-125,-108,-1.5,165,5.55,Wrigley Field,16,-2
2019-06-27,2019,LAD,COL,12,8,-220,-1.5,-140,12.5,-110,-110,200,1.5,120,8.59,Coors Field,20,4
2019-06-27,2019,TEX,DET,3,1,-117,-1.5,135,9.5,-110,-110,107,1.5,-155,5.12,Comerica Park,4,2
2019-06-27,2019,PIT,HOU,10,0,185,1.5,-105,9.5,-110,-110,-205,-1.5,-115,3.33,Minute Maid Park,10,10
2019-06-27,2019,OAK,LAA,3,8,147,1.5,-150,9.5,-125,105,-157,-1.5,130,3.85,Angel Stadium,11,-5
2019-06-27,2019,COL,LAD,8,12,200,1.5,120,12.5,-110,-110,-220,-1.5,-140,4.17,Coors Field,20,-4
2019-06-27,2019,WSH,MIA,8,5,-200,-1.5,-130,7.5,-105,-115,180,1.5,110,5.0,Marlins Park,13,3
2019-06-27,2019,SEA,MIL,2,4,178,1.5,-115,10.5,105,-125,-196,-1.5,-105,3.78,Miller Park,6,-2
2019-06-27,2019,TB,MIN,5,2,100,1.5,-190,10.0,-115,-105,-110,-1.5,170,5.0,Target Field,7,3
2019-06-27,2019,PHI,NYM,6,3,-132,-1.5,140,9.0,-110,-110,122,1.5,-160,5.12,Citizens Bank Park,9,3
2019-06-27,2019,LAA,OAK,8,3,-157,-1.5,130,9.5,-125,105,147,1.5,-150,5.8,Angel Stadium,11,5
2019-06-27,2019,NYM,PHI,3,6,122,1.5,-160,9.0,-110,-110,-132,-1.5,140,4.05,Citizens Bank Park,9,-3
2019-06-27,2019,HOU,PIT,0,10,-205,-1.5,-115,9.5,-110,-110,185,1.5,-105,6.39,Minute Maid Park,10,-10
2019-06-27,2019,MIL,SEA,4,2,-196,-1.5,-105,10.5,105,-125,178,1.5,-115,6.95,Miller Park,6,2
2019-06-27,2019,ARI,SF,5,1,-106,-1.5,150,8.5,-110,-110,-104,1.5,-170,4.37,AT&T Park,6,4
2019-06-27,2019,MIN,TB,2,5,-110,-1.5,170,10.0,-115,-105,100,1.5,-190,5.24,Target Field,7,-3
2019-06-27,2019,DET,TEX,1,3,107,1.5,-155,9.5,-110,-110,-117,-1.5,135,4.59,Comerica Park,4,-2
2019-06-27,2019,MIA,WSH,5,8,180,1.5,110,7.5,-105,-115,-200,-1.5,-130,2.68,Marlins Park,13,-3
2019-06-28,2019,SF,ARI,6,3,115,1.5,-155,7.5,-115,-105,-125,-1.5,135,3.49,AT&T Park,9,3
2019-06-28,2019,NYM,ATL,2,6,-144,-1.5,150,8.0,100,-120,134,1.5,-170,4.72,Citi Field,8,-4
2019-06-28,2019,CLE,BAL,0,13,-200,-1.5,-130,9.0,-105,-115,180,1.5,110,6.0,Camden Yards,13,-13
2019-06-28,2019,CIN,CHC,6,3,118,1.5,-145,9.0,-120,100,-128,-1.5,125,4.13,Great American Ballpark,9,3
2019-06-28,2019,CHC,CIN,3,6,-128,-1.5,125,9.0,-120,100,118,1.5,-145,5.05,Great American Ballpark,9,-3
2019-06-28,2019,BAL,CLE,13,0,180,1.5,110,9.0,-105,-115,-200,-1.5,-130,3.21,Camden Yards,13,13
2019-06-28,2019,LAD,COL,9,13,-196,-1.5,-140,13.0,-110,-110,178,1.5,120,8.61,Coors Field,22,-4
2019-06-28,2019,MIN,CWS,4,6,-185,-1.5,-130,10.0,-105,-115,170,1.5,110,6.49,Guaranteed Rate Field,10,-2
2019-06-28,2019,WSH,DET,3,1,-172,-1.5,-120,10.5,-120,100,161,1.5,100,6.64,Comerica Park,4,2
2019-06-28,2019,SEA,HOU,1,2,200,1.5,100,9.5,-105,-115,-220,-1.5,-120,3.17,Minute Maid Park,3,-1
2019-06-28,2019,TOR,KC,6,2,-128,1.5,-190,9.5,-110,-110,118,-1.5,170,5.33,Rogers Centre,8,4
2019-06-28,2019,OAK,LAA,7,2,125,1.5,-165,10.0,-115,-105,-135,-1.5,145,4.44,Angel Stadium,9,5
2019-06-28,2019,COL,LAD,13,9,178,1.5,120,13.0,-110,-110,-196,-1.5,-140,4.68,Coors Field,22,4
2019-06-28,2019,PHI,MIA,2,6,-143,-1.5,110,8.5,100,-120,133,1.5,-130,5.0,Marlins Park,8,-4
2019-06-28,2019,PIT,MIL,3,2,140,1.5,-145,10.5,-105,-115,-150,-1.5,125,4.38,Miller Park,5,1
2019-06-28,2019,CWS,MIN,6,4,170,1.5,110,10.0,-105,-115,-185,-1.5,-130,3.7,Guaranteed Rate Field,10,2
2019-06-28,2019,ATL,NYM,6,2,134,1.5,-170,8.0,100,-120,-144,-1.5,150,3.42,Citi Field,8,4
2019-06-28,2019,LAA,OAK,2,7,-135,-1.5,145,10.0,-115,-105,125,1.5,-165,5.74,Angel Stadium,9,-5
2019-06-28,2019,MIA,PHI,6,2,133,1.5,-130,8.5,100,-120,-143,-1.5,110,3.65,Marlins Park,8,4
2019-06-28,2019,MIL,PIT,2,3,-150,-1.5,125,10.5,-105,-115,140,1.5,-145,6.3,Miller Park,5,-1
2019-06-28,2019,STL,SD,1,3,122,1.5,-170,9.0,-105,-115,-132,-1.5,150,4.05,PETCO Park,4,-2
2019-06-28,2019,HOU,SEA,2,1,-220,-1.5,-120,9.5,-105,-115,200,1.5,100,6.53,Minute Maid Park,3,1
2019-06-28,2019,ARI,SF,3,6,-125,-1.5,135,7.5,-115,-105,115,1.5,-155,4.17,AT&T Park,9,-3
2019-06-28,2019,SD,STL,3,1,-132,-1.5,150,9.0,-105,-115,122,1.5,-170,5.12,PETCO Park,4,2
2019-06-28,2019,TEX,TB,5,0,118,1.5,-185,8.0,-110,-110,-128,-1.5,165,3.67,Tropicana Field,5,5
2019-06-28,2019,TB,TEX,0,5,-128,-1.5,165,8.0,-110,-110,118,1.5,-185,4.49,Tropicana Field,5,-5
2019-06-28,2019,KC,TOR,2,6,118,-1.5,170,9.5,-110,-110,-128,1.5,-190,4.36,Rogers Centre,8,-4
2019-06-28,2019,DET,WSH,1,3,161,1.5,100,10.5,-120,100,-172,-1.5,-120,4.02,Comerica Park,4,-2
2019-06-29,2019,SF,ARI,3,4,143,1.5,-120,7.0,-120,100,-153,-1.5,100,2.88,AT&T Park,7,-1
2019-06-29,2019,NYM,ATL,4,5,-103,1.5,-160,10.5,-110,-110,-107,-1.5,140,5.33,Citi Field,9,-1
2019-06-29,2019,CLE,BAL,0,13,-185,-1.5,-130,11.0,-105,-115,170,1.5,110,7.14,Camden Yards,13,-13
2019-06-29,2019,NYY,BOS,17,13,-143,-1.5,100,11.5,-105,-115,133,1.5,-120,6.77,London Stadium,30,4
2019-06-29,2019,CIN,CHC,0,6,-123,-1.5,155,9.5,-110,-110,113,1.5,-175,5.24,Great American Ballpark,6,-6
2019-06-29,2019,CHC,CIN,6,0,113,1.5,-175,9.5,-110,-110,-123,-1.5,155,4.46,Great American Ballpark,6,6
2019-06-29,2019,BAL,CLE,13,0,170,1.5,110,11.0,-105,-115,-185,-1.5,-130,4.07,Camden Yards,13,13
2019-06-29,2019,LAD,COL,3,5,-159,-1.5,-115,12.5,105,-125,149,1.5,-105,7.67,Coors Field,8,-2
2019-06-29,2019,MIN,CWS,10,3,-144,-1.5,-105,10.5,100,-120,134,1.5,-115,6.2,Guaranteed Rate Field,13,7
2019-06-29,2019,WSH,DET,5,7,-200,-1.5,-135,11.0,-120,100,180,1.5,115,7.33,Comerica Park,12,-2
2019-06-29,2019,SEA,HOU,5,6,260,1.5,140,9.5,100,-120,-300,-1.5,-160,2.64,Minute Maid Park,11,-1
2019-06-29,2019,TOR,KC,7,5,-185,-1.5,105,9.0,-125,105,170,1.5,-125,5.84,Rogers Centre,12,2
2019-06-29,2019,OAK,LAA,4,0,130,1.5,-160,9.5,-120,100,-140,-1.5,140,4.13,Angel Stadium,4,4
2019-06-29,2019,COL,LAD,5,3,149,1.5,-105,12.5,105,-125,-159,-1.5,-115,5.02,Coors Field,8,2
2019-06-29,2019,PHI,MIA,6,9,-140,-1.5,115,8.5,-105,-115,130,1.5,-135,4.96,Marlins Park,15,-3
2019-06-29,2019,PIT,MIL,1,3,190,1.5,-115,9.0,-120,100,-210,-1.5,-105,3.1,Miller Park,4,-2
2019-06-29,2019,CWS,MIN,3,10,134,1.5,-115,10.5,100,-120,-144,-1.5,-105,4.49,Guaranteed Rate Field,13,-7
2019-06-29,2019,ATL,NYM,5,4,-107,-1.5,140,10.5,-110,-110,-103,1.5,-160,5.43,Citi Field,9,1
2019-06-29,2019,BOS,NYY,13,17,133,1.5,-120,11.5,-105,-115,-143,-1.5,100,4.94,London Stadium,30,-4
2019-06-29,2019,LAA,OAK,0,4,-140,-1.5,140,9.5,-120,100,130,1.5,-160,5.54,Angel Stadium,4,-4
2019-06-29,2019,MIA,PHI,9,6,130,1.5,-135,8.5,-105,-115,-140,-1.5,115,3.7,Marlins Park,15,3
2019-06-29,2019,MIL,PIT,3,1,-210,-1.5,-105,9.0,-120,100,190,1.5,-115,6.1,Miller Park,4,2
2019-06-29,2019,STL,SD,2,12,114,1.5,-190,8.0,100,-120,-124,-1.5,170,3.74,PETCO Park,14,-10
2019-06-29,2019,HOU,SEA,6,5,-300,-1.5,-160,9.5,100,-120,260,1.5,140,7.13,Minute Maid Park,11,1
2019-06-29,2019,ARI,SF,4,3,-153,-1.5,100,7.0,-120,100,143,1.5,-120,4.23,AT&T Park,7,1
2019-06-29,2019,SD,STL,12,2,-124,-1.5,170,8.0,100,-120,114,1.5,-190,4.43,PETCO Park,14,10
2019-06-29,2019,TEX,TB,2,5,175,1.5,-125,8.0,-120,100,-190,-1.5,105,2.91,Tropicana Field,7,-3
2019-06-29,2019,TB,TEX,5,2,-190,-1.5,105,8.0,-120,100,175,1.5,-125,5.24,Tropicana Field,7,3
2019-06-29,2019,KC,TOR,5,7,170,1.5,-125,9.0,-125,105,-185,-1.5,105,3.33,Rogers Centre,12,-2
2019-06-29,2019,DET,WSH,7,5,180,1.5,115,11.0,-120,100,-200,-1.5,-135,3.93,Comerica Park,12,2
2019-06-30,2019,SF,ARI,10,4,103,-1.5,210,7.0,-110,-110,-113,1.5,-240,3.45,AT&T Park,14,6
2019-06-30,2019,NYM,ATL,8,5,-102,-1.5,180,8.5,100,-120,-108,1.5,-205,4.29,Citi Field,13,3
2019-06-30,2019,CLE,BAL,2,0,-255,-1.5,-160,10.5,-110,-110,225,1.5,140,7.54,Camden Yards,2,2
2019-06-30,2019,NYY,BOS,12,8,-103,-1.5,140,15.0,-110,-110,-107,1.5,-160,7.61,London Stadium,20,4
2019-06-30,2019,CIN,CHC,8,6,103,1.5,-155,10.5,-115,-105,-113,-1.5,135,5.17,Great American Ballpark,14,2
2019-06-30,2019,CHC,CIN,6,8,-113,-1.5,135,10.5,-115,-105,103,1.5,-155,5.57,Great American Ballpark,14,-2
2019-06-30,2019,BAL,CLE,0,2,225,1.5,140,10.5,-110,-110,-255,-1.5,-160,3.23,Camden Yards,2,-2
2019-06-30,2019,LAD,COL,10,5,-155,-1.5,-120,14.0,100,-120,145,1.5,100,8.51,Coors Field,15,5
2019-06-30,2019,MIN,CWS,3,4,106,1.5,-180,9.0,-125,105,-116,-1.5,160,4.37,Guaranteed Rate Field,7,-1
2019-06-30,2019,WSH,DET,2,1,-330,-1.5,-185,9.0,-110,-110,285,1.5,165,6.91,Comerica Park,3,1
2019-06-30,2019,SEA,HOU,1,6,250,1.5,115,8.5,-120,100,-290,-1.5,-135,2.43,Minute Maid Park,7,-5
2019-06-30,2019,TOR,KC,6,7,-119,-1.5,155,9.5,-115,-105,109,1.5,-175,5.16,Rogers Centre,13,-1
2019-06-30,2019,OAK,LAA,12,3,128,1.5,-150,10.5,-115,-105,-138,-1.5,130,4.61,Angel Stadium,15,9
2019-06-30,2019,COL,LAD,5,10,145,1.5,100,14.0,100,-120,-155,-1.5,-120,5.71,Coors Field,15,-5
2019-06-30,2019,PHI,MIA,13,6,-137,-1.5,120,8.5,-105,-115,127,1.5,-140,4.91,Marlins Park,19,7
2019-06-30,2019,PIT,MIL,1,2,148,1.5,-130,10.5,100,-120,-158,-1.5,110,4.23,Miller Park,3,-1
2019-06-30,2019,CWS,MIN,4,3,-116,-1.5,160,9.0,-125,105,106,1.5,-180,4.83,Guaranteed Rate Field,7,1
2019-06-30,2019,ATL,NYM,5,8,-108,1.5,-205,8.5,100,-120,-102,-1.5,180,4.41,Citi Field,13,-3
2019-06-30,2019,BOS,NYY,8,12,-107,1.5,-160,15.0,-110,-110,-103,-1.5,140,7.75,London Stadium,20,-4
2019-06-30,2019,LAA,OAK,3,12,-138,-1.5,130,10.5,-115,-105,128,1.5,-150,6.09,Angel Stadium,15,-9
2019-06-30,2019,MIA,PHI,6,13,127,1.5,-140,8.5,-105,-115,-137,-1.5,120,3.74,Marlins Park,19,-7
2019-06-30,2019,MIL,PIT,2,1,-158,-1.5,110,10.5,100,-120,148,1.5,-130,6.43,Miller Park,3,1
2019-06-30,2019,STL,SD,5,3,110,1.5,-190,8.0,-105,-115,-120,-1.5,170,3.81,PETCO Park,8,2
2019-06-30,2019,HOU,SEA,6,1,-290,-1.5,-135,8.5,-120,100,250,1.5,115,6.32,Minute Maid Park,7,5
2019-06-30,2019,ARI,SF,4,10,-113,1.5,-240,7.0,-110,-110,103,-1.5,210,3.71,AT&T Park,14,-6
2019-06-30,2019,SD,STL,3,5,-120,-1.5,170,8.0,-105,-115,110,1.5,-190,4.36,PETCO Park,8,-2
2019-06-30,2019,TEX,TB,2,6,185,1.5,-110,7.5,-115,-105,-205,-1.5,-110,2.63,Tropicana Field,8,-4
2019-06-30,2019,TB,TEX,6,2,-205,-1.5,-110,7.5,-115,-105,185,1.5,-110,5.04,Tropicana Field,8,4
2019-06-30,2019,KC,TOR,7,6,109,1.5,-175,9.5,-115,-105,-119,-1.5,155,4.55,Rogers Centre,13,1
2019-06-30,2019,DET,WSH,1,2,285,1.5,165,9.0,-110,-110,-330,-1.5,-185,2.34,Comerica Park,3,-1
2019-07-01,2019,TB,BAL,6,3,-260,-1.5,-150,9.0,-110,-110,230,1.5,130,6.5,Tropicana Field,9,3
2019-07-01,2019,PIT,CHC,18,5,115,1.5,-145,9.5,-115,-105,-125,-1.5,125,4.42,PNC Park,23,13
2019-07-01,2019,MIL,CIN,8,6,-109,1.5,-210,10.5,100,-120,-101,-1.5,185,5.48,Great American Ballpark,14,2
2019-07-01,2019,TOR,KC,11,4,-144,-1.5,125,10.5,-125,105,134,1.5,-145,6.2,Rogers Centre,15,7
2019-07-01,2019,CIN,MIL,6,8,-101,-1.5,185,10.5,100,-120,-109,1.5,-210,5.28,Great American Ballpark,14,-2
2019-07-01,2019,CHC,PIT,5,18,-125,-1.5,125,9.5,-115,-105,115,1.5,-145,5.28,PNC Park,23,-13
2019-07-01,2019,SF,SD,13,2,155,1.5,-125,8.5,100,-120,-165,-1.5,105,3.33,PETCO Park,15,11
2019-07-01,2019,SD,SF,2,13,-165,-1.5,105,8.5,100,-120,155,1.5,-125,5.29,PETCO Park,15,-11
2019-07-01,2019,BAL,TB,3,6,230,1.5,130,9.0,-110,-110,-260,-1.5,-150,2.73,Tropicana Field,9,-3
2019-07-01,2019,KC,TOR,4,11,134,1.5,-145,10.5,-125,105,-144,-1.5,125,4.49,Rogers Centre,15,-7
2019-07-02,2019,LAD,ARI,5,4,-230,-1.5,-125,9.0,-120,100,205,1.5,105,6.27,Dodger Stadium,9,1
2019-07-02,2019,PHI,ATL,2,0,-105,1.5,-200,10.0,-115,-105,-105,-1.5,175,5.12,Suntrust Park,2,2
2019-07-02,2019,TB,BAL,6,3,-300,-1.5,-155,9.0,100,-120,260,1.5,135,6.75,Tropicana Field,9,3
2019-07-02,2019,TOR,BOS,6,10,148,1.5,-105,10.0,-105,-115,-158,-1.5,-115,4.03,Rogers Centre,16,-4
2019-07-02,2019,PIT,CHC,5,1,114,1.5,-145,9.5,-105,-115,-124,-1.5,125,4.44,PNC Park,6,4
2019-07-02,2019,MIL,CIN,4,5,-105,1.5,-185,10.5,-115,-105,-105,-1.5,165,5.38,Great American Ballpark,9,-1
2019-07-02,2019,KC,CLE,5,9,169,1.5,100,9.0,-120,100,-184,-1.5,-120,3.35,Kauffman Stadium,14,-4
2019-07-02,2019,HOU,COL,9,8,118,1.5,-160,13.0,100,-120,-128,-1.5,140,5.96,Coors Field,17,1
2019-07-02,2019,COL,HOU,8,9,-128,-1.5,140,13.0,100,-120,118,1.5,-160,7.3,Coors Field,17,-1
2019-07-02,2019,CLE,KC,9,5,-184,-1.5,-120,9.0,-120,100,169,1.5,100,5.83,Kauffman Stadium,14,4
2019-07-02,2019,TEX,LAA,4,9,-136,-1.5,140,11.0,100,-120,126,1.5,-160,6.34,Rangers Ballpark,13,-5
2019-07-02,2019,ARI,LAD,4,5,205,1.5,105,9.0,-120,100,-230,-1.5,-125,2.95,Dodger Stadium,9,-1
2019-07-02,2019,WSH,MIA,3,2,-205,-1.5,-110,9.0,-120,100,185,1.5,-110,6.05,Nationals Park,5,1
2019-07-02,2019,CIN,MIL,5,4,-105,-1.5,165,10.5,-115,-105,-105,1.5,-185,5.38,Great American Ballpark,9,1
2019-07-02,2019,OAK,MIN,8,6,-102,1.5,-165,9.5,100,-120,-108,-1.5,145,4.8,Oakland Coliseum,14,2
2019-07-02,2019,NYY,NYM,2,4,-132,-1.5,110,9.0,-130,110,122,1.5,-130,5.12,Citi Field,6,-2
2019-07-02,2019,NYM,NYY,4,2,122,1.5,-130,9.0,-130,110,-132,-1.5,110,4.05,Citi Field,6,2
2019-07-02,2019,MIN,OAK,6,8,-108,-1.5,145,9.5,100,-120,-102,1.5,-165,4.93,Oakland Coliseum,14,-2
2019-07-02,2019,ATL,PHI,0,2,-105,-1.5,175,10.0,-115,-105,-105,1.5,-200,5.12,Suntrust Park,2,-2
2019-07-02,2019,CHC,PIT,1,5,-124,-1.5,125,9.5,-105,-115,114,1.5,-145,5.26,PNC Park,6,-4
2019-07-02,2019,SF,SD,10,4,140,1.5,-150,8.5,-105,-115,-150,-1.5,130,3.54,PETCO Park,14,6
2019-07-02,2019,STL,SEA,4,5,-148,-1.5,105,9.0,-105,-115,138,1.5,-125,5.37,T-Mobile Park,9,-1
2019-07-02,2019,SD,SF,4,10,-150,-1.5,130,8.5,-105,-115,140,1.5,-150,5.1,PETCO Park,14,-6
2019-07-02,2019,SEA,STL,5,4,138,1.5,-125,9.0,-105,-115,-148,-1.5,105,3.78,T-Mobile Park,9,1
2019-07-02,2019,BAL,TB,3,6,260,1.5,135,9.0,100,-120,-300,-1.5,-155,2.5,Tropicana Field,9,-3
2019-07-02,2019,LAA,TEX,9,4,126,1.5,-160,11.0,100,-120,-136,-1.5,140,4.87,Rangers Ballpark,13,5
2019-07-02,2019,BOS,TOR,10,6,-158,-1.5,-115,10.0,-105,-115,148,1.5,-105,6.12,Rogers Centre,16,4
2019-07-02,2019,MIA,WSH,2,3,185,1.5,-110,9.0,-120,100,-205,-1.5,-110,3.16,Nationals Park,5,-1
2019-07-03,2019,LAD,ARI,5,4,-230,-1.5,-120,7.5,-110,-110,205,1.5,100,5.23,Dodger Stadium,9,1
2019-07-03,2019,PHI,ATL,2,9,128,1.5,-155,11.5,-105,-115,-138,-1.5,135,5.04,Suntrust Park,11,-7
2019-07-03,2019,TB,BAL,6,9,-205,-1.5,-105,8.5,-110,-110,185,1.5,-115,5.71,Tropicana Field,15,-3
2019-07-03,2019,TOR,BOS,6,3,230,1.5,150,9.5,-120,100,-260,-1.5,-170,2.88,Rogers Centre,9,3
2019-07-03,2019,PIT,CHC,6,5,104,1.5,-150,9.5,-115,-105,-114,-1.5,130,4.66,PNC Park,11,1
2019-07-03,2019,MIL,CIN,0,3,136,1.5,-155,9.5,100,-120,-146,-1.5,135,4.03,Great American Ballpark,3,-3
2019-07-03,2019,KC,CLE,0,4,138,1.5,-125,9.0,-110,-110,-148,-1.5,105,3.78,Kauffman Stadium,4,-4
2019-07-03,2019,HOU,COL,4,2,-131,-1.5,105,14.5,-120,100,121,1.5,-125,8.22,Coors Field,6,2
2019-07-03,2019,DET,CWS,5,7,145,1.5,-135,9.5,-105,-115,-155,-1.5,115,3.88,Guaranteed Rate Field,12,-2
2019-07-03,2019,DET,CWS,6,9,116,1.5,-165,10.5,-110,-110,-126,-1.5,145,4.86,Guaranteed Rate Field,15,-3
2019-07-03,2019,CWS,DET,7,5,-155,-1.5,115,9.5,-105,-115,145,1.5,-135,5.77,Guaranteed Rate Field,12,2
2019-07-03,2019,CWS,DET,9,6,-126,-1.5,145,10.5,-110,-110,116,1.5,-165,5.85,Guaranteed Rate Field,15,3
2019-07-03,2019,COL,HOU,2,4,121,1.5,-125,14.5,-120,100,-131,-1.5,105,6.56,Coors Field,6,-2
2019-07-03,2019,CLE,KC,4,0,-148,-1.5,105,9.0,-110,-110,138,1.5,-125,5.37,Kauffman Stadium,4,4
2019-07-03,2019,TEX,LAA,2,6,-102,1.5,-150,11.5,-110,-110,-108,-1.5,130,5.81,Rangers Ballpark,8,-4
2019-07-03,2019,ARI,LAD,4,5,205,1.5,100,7.5,-110,-110,-230,-1.5,-120,2.46,Dodger Stadium,9,-1
2019-07-03,2019,WSH,MIA,3,1,-280,-1.5,-150,9.5,-110,-110,245,1.5,130,7.0,Nationals Park,4,2
2019-07-03,2019,CIN,MIL,3,0,-146,-1.5,135,9.5,100,-120,136,1.5,-155,5.64,Great American Ballpark,3,3
2019-07-03,2019,OAK,MIN,3,4,-110,1.5,-165,9.0,-120,100,100,-1.5,145,4.71,Oakland Coliseum,7,-1
2019-07-03,2019,NYY,NYM,5,1,-140,-1.5,110,10.0,-110,-110,130,1.5,-130,5.83,Citi Field,6,4
2019-07-03,2019,NYM,NYY,1,5,130,1.5,-130,10.0,-110,-110,-140,-1.5,110,4.35,Citi Field,6,-4
2019-07-03,2019,MIN,OAK,4,3,100,-1.5,145,9.0,-120,100,-110,1.5,-165,4.5,Oakland Coliseum,7,1
2019-07-03,2019,ATL,PHI,9,2,-138,-1.5,135,11.5,-105,-115,128,1.5,-155,6.67,Suntrust Park,11,7
2019-07-03,2019,CHC,PIT,5,6,-114,-1.5,130,9.5,-115,-105,104,1.5,-150,5.06,PNC Park,11,-1
2019-07-03,2019,SF,SD,7,5,125,1.5,-170,8.5,-120,100,-135,-1.5,150,3.78,PETCO Park,12,2
2019-07-03,2019,STL,SEA,5,2,-113,-1.5,135,9.0,-120,100,103,1.5,-155,4.77,T-Mobile Park,7,3
2019-07-03,2019,SD,SF,5,7,-135,-1.5,150,8.5,-120,100,125,1.5,-170,4.88,PETCO Park,12,-2
2019-07-03,2019,SEA,STL,2,5,103,1.5,-155,9.0,-120,100,-113,-1.5,135,4.43,T-Mobile Park,7,-3
2019-07-03,2019,BAL,TB,9,6,185,1.5,-115,8.5,-110,-110,-205,-1.5,-105,2.98,Tropicana Field,15,3
2019-07-03,2019,LAA,TEX,6,2,-108,-1.5,130,11.5,-110,-110,-102,1.5,-150,5.97,Rangers Ballpark,8,4
2019-07-03,2019,BOS,TOR,3,6,-260,-1.5,-170,9.5,-120,100,230,1.5,150,6.86,Rogers Centre,9,-3
2019-07-03,2019,MIA,WSH,1,3,245,1.5,130,9.5,-110,-110,-280,-1.5,-150,2.75,Nationals Park,4,-2
2019-07-04,2019,PHI,ATL,6,12,150,1.5,-135,10.5,-115,-105,-160,-1.5,115,4.2,Suntrust Park,18,-6
2019-07-04,2019,TOR,BOS,7,8,117,1.5,-135,11.0,-110,-110,-127,-1.5,115,5.07,Rogers Centre,15,-1
2019-07-04,2019,PIT,CHC,3,11,107,1.5,-155,10.0,100,-120,-117,-1.5,135,4.83,PNC Park,14,-8
2019-07-04,2019,MIL,CIN,0,1,-111,-1.5,140,9.0,-115,-105,101,1.5,-160,4.73,Great American Ballpark,1,-1
2019-07-04,2019,KC,CLE,4,8,113,1.5,-145,10.0,-105,-115,-123,-1.5,125,4.69,Kauffman Stadium,12,-4
2019-07-04,2019,DET,CWS,11,5,100,-1.5,150,9.5,-110,-110,-110,1.5,-170,4.75,Guaranteed Rate Field,16,6
2019-07-04,2019,CWS,DET,5,11,-110,1.5,-170,9.5,-110,-110,100,-1.5,150,4.98,Guaranteed Rate Field,16,-6
2019-07-04,2019,CLE,KC,8,4,-123,-1.5,125,10.0,-105,-115,113,1.5,-145,5.52,Kauffman Stadium,12,4
2019-07-04,2019,TEX,LAA,9,3,-116,-1.5,155,11.0,-105,-115,106,1.5,-175,5.91,Rangers Ballpark,12,6
2019-07-04,2019,SD,LAD,1,5,200,1.5,-105,8.5,-120,100,-220,-1.5,-115,2.83,Dodger Stadium,6,-4
2019-07-04,2019,WSH,MIA,5,2,-185,-1.5,-105,10.5,-105,-115,170,1.5,-115,6.82,Nationals Park,7,3
2019-07-04,2019,CIN,MIL,1,0,101,1.5,-160,9.0,-115,-105,-111,-1.5,140,4.48,Great American Ballpark,1,1
2019-07-04,2019,OAK,MIN,7,2,120,1.5,-135,9.5,-110,-110,-130,-1.5,115,4.32,Oakland Coliseum,9,5
2019-07-04,2019,TB,NYY,4,8,-111,1.5,-175,9.0,-105,-115,101,-1.5,155,4.73,Tropicana Field,12,-4
2019-07-04,2019,MIN,OAK,2,7,-130,-1.5,115,9.5,-110,-110,120,1.5,-135,5.37,Oakland Coliseum,9,-5
2019-07-04,2019,ATL,PHI,12,6,-160,-1.5,115,10.5,-115,-105,150,1.5,-135,6.46,Suntrust Park,18,6
2019-07-04,2019,CHC,PIT,11,3,-117,-1.5,135,10.0,100,-120,107,1.5,-155,5.39,PNC Park,14,8
2019-07-04,2019,LAD,SD,5,1,-220,-1.5,-115,8.5,-120,100,200,1.5,-105,5.84,Dodger Stadium,6,4
2019-07-04,2019,STL,SEA,5,4,-108,-1.5,145,9.5,-110,-110,-102,1.5,-165,4.93,T-Mobile Park,9,1
2019-07-04,2019,SEA,STL,4,5,-102,1.5,-165,9.5,-110,-110,-108,-1.5,145,4.8,T-Mobile Park,9,-1
2019-07-04,2019,NYY,TB,8,4,101,-1.5,155,9.0,-105,-115,-111,1.5,-175,4.48,Tropicana Field,12,4
2019-07-04,2019,LAA,TEX,3,9,106,1.5,-175,11.0,-105,-115,-116,-1.5,155,5.34,Rangers Ballpark,12,-6
2019-07-04,2019,BOS,TOR,8,7,-127,-1.5,115,11.0,-110,-110,117,1.5,-135,6.15,Rogers Centre,15,1
2019-07-04,2019,MIA,WSH,2,5,170,1.5,-115,10.5,-105,-115,-185,-1.5,-105,3.89,Nationals Park,7,-3
2019-07-05,2019,COL,ARI,0,8,154,1.5,-140,8.5,-115,-105,-164,-1.5,120,3.35,Chase Field,8,-8
2019-07-05,2019,MIA,ATL,0,1,170,1.5,-115,10.0,-105,-115,-185,-1.5,-105,3.7,Suntrust Park,1,-1
2019-07-05,2019,TOR,BAL,1,4,-130,-1.5,140,11.0,-105,-115,120,1.5,-160,6.22,Rogers Centre,5,-3
2019-07-05,2019,DET,BOS,6,9,205,1.5,130,11.0,-105,-115,-230,-1.5,-150,3.61,Comerica Park,15,-3
2019-07-05,2019,ARI,COL,8,0,-164,-1.5,120,8.5,-115,-105,154,1.5,-140,5.28,Chase Field,8,8
2019-07-05,2019,BOS,DET,9,6,-230,-1.5,-150,11.0,-105,-115,205,1.5,130,7.67,Comerica Park,15,3
2019-07-05,2019,LAA,HOU,5,4,205,1.5,105,9.0,-105,-115,-230,-1.5,-125,2.95,Minute Maid Park,9,1
2019-07-05,2019,WSH,KC,4,7,-185,-1.5,-105,10.5,-105,-115,170,1.5,-115,6.82,Nationals Park,11,-3
2019-07-05,2019,HOU,LAA,4,5,-230,-1.5,-125,9.0,-105,-115,205,1.5,105,6.27,Minute Maid Park,9,-1
2019-07-05,2019,SD,LAD,3,2,179,1.5,-110,8.5,-115,-105,-198,-1.5,-110,3.05,Dodger Stadium,5,1
2019-07-05,2019,ATL,MIA,1,0,-185,-1.5,-105,10.0,-105,-115,170,1.5,-115,6.49,Suntrust Park,1,1
2019-07-05,2019,PIT,MIL,6,7,102,1.5,-165,10.5,-110,-110,-112,-1.5,145,5.2,PNC Park,13,-1
2019-07-05,2019,TEX,MIN,6,15,161,1.5,-105,10.5,100,-120,-172,-1.5,-115,4.02,Target Field,21,-9
2019-07-05,2019,PHI,NYM,7,2,168,1.5,-120,8.5,-105,-115,-183,-1.5,100,3.17,Citi Field,9,5
2019-07-05,2019,TB,NYY,4,8,-104,1.5,-160,8.5,-120,100,-106,-1.5,140,4.33,Tropicana Field,12,-4
2019-07-05,2019,SEA,OAK,2,5,135,1.5,-120,10.0,-110,-110,-145,-1.5,100,4.26,T-Mobile Park,7,-3
2019-07-05,2019,NYM,PHI,2,7,-183,-1.5,100,8.5,-105,-115,168,1.5,-120,5.5,Citi Field,9,-5
2019-07-05,2019,MIL,PIT,7,6,-112,-1.5,145,10.5,-110,-110,102,1.5,-165,5.55,PNC Park,13,1
2019-07-05,2019,LAD,SD,2,3,-198,-1.5,-110,8.5,-115,-105,179,1.5,-110,5.65,Dodger Stadium,5,-1
2019-07-05,2019,OAK,SEA,5,2,-145,-1.5,100,10.0,-110,-110,135,1.5,-120,5.92,T-Mobile Park,7,3
2019-07-05,2019,STL,SF,9,4,110,1.5,-205,8.5,-110,-110,-120,-1.5,180,4.05,AT&T Park,13,5
2019-07-05,2019,SF,STL,4,9,-120,-1.5,180,8.5,-110,-110,110,1.5,-205,4.64,AT&T Park,13,-5
2019-07-05,2019,NYY,TB,8,4,-106,-1.5,140,8.5,-120,100,-104,1.5,-160,4.37,Tropicana Field,12,4
2019-07-05,2019,MIN,TEX,15,6,-172,-1.5,-115,10.5,100,-120,161,1.5,-105,6.64,Target Field,21,9
2019-07-05,2019,BAL,TOR,4,1,120,1.5,-160,11.0,-105,-115,-130,-1.5,140,5.0,Rogers Centre,5,3
2019-07-05,2019,KC,WSH,7,4,170,1.5,-115,10.5,-105,-115,-185,-1.5,-105,3.89,Nationals Park,11,3
2019-07-06,2019,COL,ARI,2,4,-102,1.5,-195,8.0,-110,-110,-108,-1.5,175,4.04,Chase Field,6,-2
2019-07-06,2019,MIA,ATL,5,4,179,1.5,-115,9.5,100,-120,-198,-1.5,-105,3.41,Suntrust Park,9,1
2019-07-06,2019,TOR,BAL,1,8,-138,-1.5,130,11.0,100,-120,128,1.5,-150,6.38,Rogers Centre,9,-7
2019-07-06,2019,DET,BOS,6,10,162,1.5,100,10.5,-115,-105,-174,-1.5,-120,4.01,Comerica Park,16,-4
2019-07-06,2019,CWS,CHC,3,6,113,1.5,-145,9.5,-110,-110,-123,-1.5,125,4.46,Guaranteed Rate Field,9,-3
2019-07-06,2019,CLE,CIN,7,2,-128,-1.5,125,9.0,-110,-110,118,1.5,-145,5.05,Great American Ballpark,9,5
2019-07-06,2019,CIN,CLE,2,7,118,1.5,-145,9.0,-110,-110,-128,-1.5,125,4.13,Great American Ballpark,9,-5
2019-07-06,2019,ARI,COL,4,2,-108,-1.5,175,8.0,-110,-110,-102,1.5,-195,4.15,Chase Field,6,2
2019-07-06,2019,CHC,CWS,6,3,-123,-1.5,125,9.5,-110,-110,113,1.5,-145,5.24,Guaranteed Rate Field,9,3
2019-07-06,2019,BOS,DET,10,6,-174,-1.5,-120,10.5,-115,-105,162,1.5,100,6.67,Comerica Park,16,4
2019-07-06,2019,LAA,HOU,0,4,210,1.5,105,9.0,-105,-115,-240,-1.5,-125,2.9,Minute Maid Park,4,-4
2019-07-06,2019,WSH,KC,6,0,-410,-1.5,-190,9.0,-115,-105,340,1.5,170,7.24,Nationals Park,6,6
2019-07-06,2019,HOU,LAA,4,0,-240,-1.5,-125,9.0,-105,-115,210,1.5,105,6.35,Minute Maid Park,4,4
2019-07-06,2019,SD,LAD,3,1,155,1.5,-140,8.5,-105,-115,-165,-1.5,120,3.33,Dodger Stadium,4,2
2019-07-06,2019,ATL,MIA,4,5,-198,-1.5,-105,9.5,100,-120,179,1.5,-115,6.31,Suntrust Park,9,-1
2019-07-06,2019,PIT,MIL,12,2,116,1.5,-145,10.5,-105,-115,-126,-1.5,125,4.86,PNC Park,14,10
2019-07-06,2019,TEX,MIN,4,7,143,1.5,-140,10.0,-115,-105,-153,-1.5,120,4.12,Target Field,11,-3
2019-07-06,2019,PHI,NYM,5,6,125,1.5,-160,9.0,-110,-110,-135,-1.5,140,4.0,Citi Field,11,-1
2019-07-06,2019,TB,NYY,4,3,-136,-1.5,140,8.5,-110,-110,126,1.5,-160,4.9,Tropicana Field,7,1
2019-07-06,2019,SEA,OAK,6,3,135,1.5,-125,9.5,-105,-115,-145,-1.5,105,4.04,T-Mobile Park,9,3
2019-07-06,2019,NYM,PHI,6,5,-135,-1.5,140,9.0,-110,-110,125,1.5,-160,5.17,Citi Field,11,1
2019-07-06,2019,MIL,PIT,2,12,-126,-1.5,125,10.5,-105,-115,116,1.5,-145,5.85,PNC Park,14,-10
2019-07-06,2019,LAD,SD,1,3,-165,-1.5,120,8.5,-105,-115,155,1.5,-140,5.29,Dodger Stadium,4,-2
2019-07-06,2019,OAK,SEA,3,6,-145,-1.5,105,9.5,-105,-115,135,1.5,-125,5.62,T-Mobile Park,9,-3
2019-07-06,2019,STL,SF,4,8,114,1.5,-190,7.5,-115,-105,-124,-1.5,170,3.5,AT&T Park,12,-4
2019-07-06,2019,SF,STL,8,4,-124,-1.5,170,7.5,-115,-105,114,1.5,-190,4.15,AT&T Park,12,4
2019-07-06,2019,NYY,TB,3,4,126,1.5,-160,8.5,-110,-110,-136,-1.5,140,3.76,Tropicana Field,7,-1
2019-07-06,2019,MIN,TEX,7,4,-153,-1.5,120,10.0,-115,-105,143,1.5,-140,6.05,Target Field,11,3
2019-07-06,2019,BAL,TOR,8,1,128,1.5,-150,11.0,100,-120,-138,-1.5,130,4.82,Rogers Centre,9,7
2019-07-06,2019,KC,WSH,0,6,340,1.5,170,9.0,-115,-105,-410,-1.5,-190,2.05,Nationals Park,6,-6
2019-07-07,2019,COL,ARI,3,5,-147,-1.5,110,8.5,-105,-115,137,1.5,-130,5.06,Chase Field,8,-2
2019-07-07,2019,MIA,ATL,3,4,190,1.5,-110,9.5,-120,100,-210,-1.5,-110,3.28,Suntrust Park,7,-1
2019-07-07,2019,TOR,BAL,6,1,-185,-1.5,100,11.0,-105,-115,170,1.5,-120,7.14,Rogers Centre,7,5
2019-07-07,2019,DET,BOS,3,6,260,1.5,155,10.5,100,-120,-300,-1.5,-175,2.92,Comerica Park,9,-3
2019-07-07,2019,CWS,CHC,3,1,165,1.5,100,10.5,-110,-110,-180,-1.5,-120,3.96,Guaranteed Rate Field,4,2
2019-07-07,2019,CLE,CIN,11,1,-122,-1.5,130,9.0,-120,100,112,1.5,-150,4.95,Great American Ballpark,12,10
2019-07-07,2019,CIN,CLE,1,11,112,1.5,-150,9.0,-120,100,-122,-1.5,130,4.25,Great American Ballpark,12,-10
2019-07-07,2019,ARI,COL,5,3,137,1.5,-130,8.5,-105,-115,-147,-1.5,110,3.59,Chase Field,8,2
2019-07-07,2019,CHC,CWS,1,3,-180,-1.5,-120,10.5,-110,-110,165,1.5,100,6.75,Guaranteed Rate Field,4,-2
2019-07-07,2019,BOS,DET,6,3,-300,-1.5,-175,10.5,100,-120,260,1.5,155,7.88,Comerica Park,9,3
2019-07-07,2019,LAA,HOU,10,11,150,1.5,-130,10.0,-120,100,-160,-1.5,110,4.0,Minute Maid Park,21,-1
2019-07-07,2019,WSH,KC,5,2,-245,-1.5,-130,9.0,-120,100,215,1.5,110,6.39,Nationals Park,7,3
2019-07-07,2019,HOU,LAA,11,10,-160,-1.5,110,10.0,-120,100,150,1.5,-130,6.15,Minute Maid Park,21,1
2019-07-07,2019,SD,LAD,5,3,146,1.5,-150,8.5,100,-120,-156,-1.5,130,3.46,Dodger Stadium,8,2
2019-07-07,2019,ATL,MIA,4,3,-210,-1.5,-110,9.5,-120,100,190,1.5,-110,6.44,Suntrust Park,7,1
2019-07-07,2019,PIT,MIL,6,5,-118,-1.5,165,9.0,-120,100,108,1.5,-185,4.87,PNC Park,11,1
2019-07-07,2019,TEX,MIN,4,1,165,1.5,-120,10.5,-120,100,-180,-1.5,100,3.96,Target Field,5,3
2019-07-07,2019,PHI,NYM,8,3,-114,1.5,-240,8.0,-115,-105,104,-1.5,210,4.26,Citi Field,11,5
2019-07-07,2019,TB,NYY,2,1,-123,-1.5,165,7.5,-105,-115,113,1.5,-185,4.14,Tropicana Field,3,1
2019-07-07,2019,SEA,OAK,4,7,120,1.5,-140,10.0,-115,-105,-130,-1.5,120,4.55,T-Mobile Park,11,-3
2019-07-07,2019,NYM,PHI,3,8,104,-1.5,210,8.0,-115,-105,-114,1.5,-240,3.92,Citi Field,11,-5
2019-07-07,2019,MIL,PIT,5,6,108,1.5,-185,9.0,-120,100,-118,-1.5,165,4.33,PNC Park,11,-1
2019-07-07,2019,LAD,SD,3,5,-156,-1.5,130,8.5,100,-120,146,1.5,-150,5.18,Dodger Stadium,8,-2
2019-07-07,2019,OAK,SEA,7,4,-130,-1.5,120,10.0,-115,-105,120,1.5,-140,5.65,T-Mobile Park,11,3
2019-07-07,2019,STL,SF,0,1,-121,-1.5,135,8.0,-110,-110,111,1.5,-155,4.38,AT&T Park,1,-1
2019-07-07,2019,SF,STL,1,0,111,1.5,-155,8.0,-110,-110,-121,-1.5,135,3.79,AT&T Park,1,1
2019-07-07,2019,NYY,TB,1,2,113,1.5,-185,7.5,-105,-115,-123,-1.5,165,3.52,Tropicana Field,3,-1
2019-07-07,2019,MIN,TEX,1,4,-180,-1.5,100,10.5,-120,100,165,1.5,-120,6.75,Target Field,5,-3
2019-07-07,2019,BAL,TOR,1,6,170,1.5,-120,11.0,-105,-115,-185,-1.5,100,4.07,Rogers Centre,7,-5
2019-07-07,2019,KC,WSH,2,5,215,1.5,110,9.0,-120,100,-245,-1.5,-130,2.86,Nationals Park,7,-3
2019-07-11,2019,TEX,HOU,5,0,125,1.5,-130,10.5,-105,-115,-135,-1.5,110,4.67,Rangers Ballpark,5,5
2019-07-11,2019,HOU,TEX,0,5,-135,-1.5,110,10.5,-105,-115,125,1.5,-130,6.03,Rangers Ballpark,5,-5
2019-07-12,2019,STL,ARI,2,4,-122,-1.5,160,8.5,-110,-110,112,1.5,-180,4.67,Busch Stadium,6,-2
2019-07-12,2019,SD,ATL,3,5,-105,1.5,-170,9.0,-105,-115,-105,-1.5,150,4.61,PETCO Park,8,-2
2019-07-12,2019,TB,BAL,16,4,-162,-1.5,-105,9.5,-125,105,152,1.5,-115,5.87,Camden Yards,20,12
2019-07-12,2019,LAD,BOS,1,8,101,1.5,-185,10.5,100,-120,-111,-1.5,165,5.22,Fenway Park,9,-7
2019-07-12,2019,PIT,CHC,3,4,155,1.5,-130,9.5,-120,100,-165,-1.5,110,3.73,Wrigley Field,7,-1
2019-07-12,2019,COL,CIN,3,2,-137,-1.5,135,12.0,-115,-105,127,1.5,-155,6.94,Coors Field,5,1
2019-07-12,2019,MIN,CLE,5,3,140,1.5,-160,9.0,-110,-110,-150,-1.5,140,3.75,Progressive Field,8,2
2019-07-12,2019,CIN,COL,2,3,127,1.5,-155,12.0,-115,-105,-137,-1.5,135,5.29,Coors Field,5,-1
2019-07-12,2019,OAK,CWS,5,1,-200,-1.5,-110,9.0,-115,-105,180,1.5,-110,6.0,Oakland Coliseum,6,4
2019-07-12,2019,KC,DET,8,5,-138,-1.5,145,9.0,-120,100,128,1.5,-165,5.22,Kauffman Stadium,13,3
2019-07-12,2019,TEX,HOU,9,8,190,1.5,115,9.5,-110,-110,-210,-1.5,-135,3.28,Rangers Ballpark,17,1
2019-07-12,2019,DET,KC,5,8,128,1.5,-165,9.0,-120,100,-138,-1.5,145,3.95,Kauffman Stadium,13,-3
2019-07-12,2019,SEA,LAA,0,13,150,1.5,-135,10.0,-110,-110,-160,-1.5,115,4.0,Angel Stadium,13,-13
2019-07-12,2019,BOS,LAD,8,1,-111,-1.5,165,10.5,100,-120,101,1.5,-185,5.52,Fenway Park,9,7
2019-07-12,2019,NYM,MIA,4,8,-110,1.5,-230,8.0,-115,-105,100,-1.5,200,4.19,Marlins Park,12,-4
2019-07-12,2019,SF,MIL,10,7,165,1.5,-120,9.5,-110,-110,-180,-1.5,100,3.58,Miller Park,17,3
2019-07-12,2019,CLE,MIN,3,5,-150,-1.5,140,9.0,-110,-110,140,1.5,-160,5.4,Progressive Field,8,-2
2019-07-12,2019,MIA,NYM,8,4,100,-1.5,200,8.0,-115,-105,-110,1.5,-230,4.0,Marlins Park,12,4
2019-07-12,2019,TOR,NYY,0,4,245,1.5,135,11.0,-110,-110,-280,-1.5,-155,3.19,Yankee Stadium,4,-4
2019-07-12,2019,CWS,OAK,1,5,180,1.5,-110,9.0,-115,-105,-200,-1.5,-110,3.21,Oakland Coliseum,6,-4
2019-07-12,2019,WSH,PHI,4,0,-147,-1.5,110,9.5,-105,-115,137,1.5,-130,5.65,Citizens Bank Park,4,4
2019-07-12,2019,CHC,PIT,4,3,-165,-1.5,110,9.5,-120,100,155,1.5,-130,5.92,Wrigley Field,7,1
2019-07-12,2019,ATL,SD,5,3,-105,-1.5,150,9.0,-105,-115,-105,1.5,-170,4.61,PETCO Park,8,2
2019-07-12,2019,LAA,SEA,13,0,-160,-1.5,115,10.0,-110,-110,150,1.5,-135,6.15,Angel Stadium,13,13
2019-07-12,2019,MIL,SF,7,10,-180,-1.5,100,9.5,-110,-110,165,1.5,-120,6.11,Miller Park,17,-3
2019-07-12,2019,ARI,STL,4,2,112,1.5,-180,8.5,-110,-110,-122,-1.5,160,4.01,Busch Stadium,6,2
2019-07-12,2019,BAL,TB,4,16,152,1.5,-115,9.5,-125,105,-162,-1.5,-105,3.77,Camden Yards,20,-12
2019-07-12,2019,HOU,TEX,8,9,-210,-1.5,-135,9.5,-110,-110,190,1.5,115,6.44,Rangers Ballpark,17,-1
2019-07-12,2019,NYY,TOR,4,0,-280,-1.5,-155,11.0,-110,-110,245,1.5,135,8.11,Yankee Stadium,4,4
2019-07-12,2019,PHI,WSH,0,4,137,1.5,-130,9.5,-105,-115,-147,-1.5,110,4.01,Citizens Bank Park,4,-4
2019-07-13,2019,STL,ARI,4,2,-138,-1.5,145,9.0,100,-120,128,1.5,-165,5.22,Busch Stadium,6,2
2019-07-13,2019,SD,ATL,5,7,-116,-1.5,170,8.5,-120,100,106,1.5,-190,4.56,PETCO Park,12,-2
2019-07-13,2019,TB,BAL,1,2,-240,-1.5,-160,10.5,-120,100,210,1.5,140,7.41,Camden Yards,3,-1
2019-07-13,2019,TB,BAL,12,4,-220,-1.5,-140,9.0,100,-120,200,1.5,120,6.19,Camden Yards,16,8
2019-07-13,2019,LAD,BOS,11,2,157,1.5,-135,9.0,-120,100,-167,-1.5,115,3.5,Fenway Park,13,9
2019-07-13,2019,PIT,CHC,4,10,165,1.5,-120,10.5,-110,-110,-180,-1.5,100,3.96,Wrigley Field,14,-6
2019-07-13,2019,COL,CIN,9,17,-111,-1.5,145,14.0,100,-120,101,1.5,-165,7.36,Coors Field,26,-8
2019-07-13,2019,MIN,CLE,6,2,131,1.5,-160,9.0,-120,100,-141,-1.5,140,3.9,Progressive Field,8,4
2019-07-13,2019,CIN,COL,17,9,101,1.5,-165,14.0,100,-120,-111,-1.5,145,6.97,Coors Field,26,8
2019-07-13,2019,OAK,CWS,13,2,-210,-1.5,-115,10.0,-105,-115,190,1.5,-105,6.77,Oakland Coliseum,15,11
2019-07-13,2019,KC,DET,4,1,-101,1.5,-170,8.5,-115,-105,-109,-1.5,150,4.27,Kauffman Stadium,5,3
2019-07-13,2019,TEX,HOU,6,7,125,1.5,-135,10.0,-110,-110,-135,-1.5,115,4.44,Rangers Ballpark,13,-1
2019-07-13,2019,DET,KC,1,4,-109,-1.5,150,8.5,-115,-105,-101,1.5,-170,4.43,Kauffman Stadium,5,-3
2019-07-13,2019,SEA,LAA,2,9,150,1.5,-140,10.5,-120,100,-160,-1.5,120,4.2,Angel Stadium,11,-7
2019-07-13,2019,BOS,LAD,2,11,-167,-1.5,115,9.0,-120,100,157,1.5,-135,5.63,Fenway Park,13,-9
2019-07-13,2019,NYM,MIA,4,2,-139,-1.5,120,8.0,105,-125,129,1.5,-140,4.65,Marlins Park,6,2
2019-07-13,2019,SF,MIL,4,5,117,1.5,-175,9.0,100,-120,-127,-1.5,155,4.15,Miller Park,9,-1
2019-07-13,2019,CLE,MIN,2,6,-141,-1.5,140,9.0,-120,100,131,1.5,-160,5.27,Progressive Field,8,-4
2019-07-13,2019,MIA,NYM,2,4,129,1.5,-140,8.0,105,-125,-139,-1.5,120,3.49,Marlins Park,6,-2
2019-07-13,2019,TOR,NYY,2,1,245,1.5,145,12.0,-105,-115,-280,-1.5,-165,3.48,Yankee Stadium,3,1
2019-07-13,2019,CWS,OAK,2,13,190,1.5,-105,10.0,-105,-115,-210,-1.5,-115,3.45,Oakland Coliseum,15,-11
2019-07-13,2019,WSH,PHI,4,3,106,1.5,-200,8.5,105,-125,-116,-1.5,175,4.13,Citizens Bank Park,7,1
2019-07-13,2019,CHC,PIT,10,4,-180,-1.5,100,10.5,-110,-110,165,1.5,-120,6.75,Wrigley Field,14,6
2019-07-13,2019,ATL,SD,7,5,106,1.5,-190,8.5,-120,100,-116,-1.5,170,4.13,PETCO Park,12,2
2019-07-13,2019,LAA,SEA,9,2,-160,-1.5,120,10.5,-120,100,150,1.5,-140,6.46,Angel Stadium,11,7
2019-07-13,2019,MIL,SF,5,4,-127,-1.5,155,9.0,100,-120,117,1.5,-175,5.04,Miller Park,9,1
2019-07-13,2019,ARI,STL,2,4,128,1.5,-165,9.0,100,-120,-138,-1.5,145,3.95,Busch Stadium,6,-2
2019-07-13,2019,BAL,TB,2,1,210,1.5,140,10.5,-120,100,-240,-1.5,-160,3.39,Camden Yards,3,1
2019-07-13,2019,BAL,TB,4,12,200,1.5,120,9.0,100,-120,-220,-1.5,-140,3.0,Camden Yards,16,-8
2019-07-13,2019,HOU,TEX,7,6,-135,-1.5,115,10.0,-110,-110,125,1.5,-135,5.74,Rangers Ballpark,13,1
2019-07-13,2019,NYY,TOR,1,2,-280,-1.5,-165,12.0,-105,-115,245,1.5,145,8.84,Yankee Stadium,3,-1
2019-07-13,2019,PHI,WSH,3,4,-116,-1.5,175,8.5,105,-125,106,1.5,-200,4.56,Citizens Bank Park,7,-1
2019-07-14,2019,STL,ARI,5,2,105,1.5,-155,7.5,-115,-105,-115,-1.5,135,3.66,Busch Stadium,7,3
2019-07-14,2019,SD,ATL,1,4,143,1.5,-120,9.0,-120,100,-153,-1.5,100,3.7,PETCO Park,5,-3
2019-07-14,2019,TB,BAL,4,1,-220,-1.5,-145,10.5,-120,100,200,1.5,125,7.22,Camden Yards,5,3
2019-07-14,2019,LAD,BOS,7,4,-101,1.5,-190,9.5,-110,-110,-109,-1.5,170,4.77,Fenway Park,11,3
2019-07-14,2019,PIT,CHC,3,8,162,1.5,-125,9.5,100,-120,-174,-1.5,105,3.63,Wrigley Field,11,-5
2019-07-14,2019,COL,CIN,10,9,-112,-1.5,140,13.5,105,-125,102,1.5,-160,7.13,Coors Field,19,1
2019-07-14,2019,MIN,CLE,3,4,135,1.5,-165,8.5,-105,-115,-145,-1.5,145,3.62,Progressive Field,7,-1
2019-07-14,2019,CIN,COL,9,10,102,1.5,-160,13.5,105,-125,-112,-1.5,140,6.68,Coors Field,19,-1
2019-07-14,2019,OAK,CWS,3,2,-185,-1.5,-105,9.5,-120,100,170,1.5,-115,6.17,Oakland Coliseum,5,1
2019-07-14,2019,KC,DET,8,12,-138,-1.5,130,10.5,-115,-105,128,1.5,-150,6.09,Kauffman Stadium,20,-4
2019-07-14,2019,TEX,HOU,4,12,195,1.5,120,10.5,-110,-110,-215,-1.5,-140,3.56,Rangers Ballpark,16,-8
2019-07-14,2019,DET,KC,12,8,128,1.5,-150,10.5,-115,-105,-138,-1.5,130,4.61,Kauffman Stadium,20,4
2019-07-14,2019,SEA,LAA,3,6,160,1.5,-120,10.5,-110,-110,-170,-1.5,100,4.04,Angel Stadium,9,-3
2019-07-14,2019,BOS,LAD,4,7,-109,-1.5,170,9.5,-110,-110,-101,1.5,-190,4.95,Fenway Park,11,-3
2019-07-14,2019,NYM,MIA,6,2,-240,-1.5,-125,7.0,-115,-105,210,1.5,105,4.94,Marlins Park,8,4
2019-07-14,2019,SF,MIL,8,3,165,1.5,-120,10.0,-115,-105,-180,-1.5,100,3.77,Miller Park,11,5
2019-07-14,2019,CLE,MIN,4,3,-145,-1.5,145,8.5,-105,-115,135,1.5,-165,5.03,Progressive Field,7,1
2019-07-14,2019,MIA,NYM,2,6,210,1.5,105,7.0,-115,-105,-240,-1.5,-125,2.26,Marlins Park,8,-4
2019-07-14,2019,TOR,NYY,2,4,200,1.5,105,10.0,-105,-115,-220,-1.5,-125,3.33,Yankee Stadium,6,-2
2019-07-14,2019,CWS,OAK,2,3,170,1.5,-115,9.5,-120,100,-185,-1.5,-105,3.52,Oakland Coliseum,5,-1
2019-07-14,2019,WSH,PHI,3,4,103,1.5,-190,11.0,-105,-115,-113,-1.5,170,5.42,Citizens Bank Park,7,-1
2019-07-14,2019,CHC,PIT,8,3,-174,-1.5,105,9.5,100,-120,162,1.5,-125,6.03,Wrigley Field,11,5
2019-07-14,2019,ATL,SD,4,1,-153,-1.5,100,9.0,-120,100,143,1.5,-120,5.44,PETCO Park,5,3
2019-07-14,2019,LAA,SEA,6,3,-170,-1.5,100,10.5,-110,-110,160,1.5,-120,6.61,Angel Stadium,9,3
2019-07-14,2019,MIL,SF,3,8,-180,-1.5,100,10.0,-115,-105,165,1.5,-120,6.43,Miller Park,11,-5
2019-07-14,2019,ARI,STL,2,5,-115,-1.5,135,7.5,-115,-105,105,1.5,-155,4.01,Busch Stadium,7,-3
2019-07-14,2019,BAL,TB,1,4,200,1.5,125,10.5,-120,100,-220,-1.5,-145,3.5,Camden Yards,5,-3
2019-07-14,2019,HOU,TEX,12,4,-215,-1.5,-140,10.5,-110,-110,195,1.5,120,7.17,Rangers Ballpark,16,8
2019-07-14,2019,NYY,TOR,4,2,-220,-1.5,-125,10.0,-105,-115,200,1.5,105,6.88,Yankee Stadium,6,2
2019-07-14,2019,PHI,WSH,4,3,-113,-1.5,170,11.0,-105,-115,103,1.5,-190,5.84,Citizens Bank Park,7,1
2019-07-15,2019,MIL,ATL,2,4,-108,1.5,-165,10.0,-120,100,-102,-1.5,145,5.19,Miller Park,6,-2
2019-07-15,2019,TOR,BOS,8,10,165,1.5,-120,11.0,-110,-110,-180,-1.5,100,4.15,Fenway Park,18,-2
2019-07-15,2019,CIN,CHC,6,3,139,1.5,-145,10.5,-105,-115,-149,-1.5,125,4.39,Wrigley Field,9,3
2019-07-15,2019,CHC,CIN,3,6,-149,-1.5,125,10.5,-105,-115,139,1.5,-145,6.28,Wrigley Field,9,-3
2019-07-15,2019,DET,CLE,6,8,185,1.5,-105,10.5,-115,-105,-205,-1.5,-115,3.68,Progressive Field,14,-2
2019-07-15,2019,SF,COL,19,2,185,1.5,-105,13.0,-110,-110,-205,-1.5,-115,4.56,Coors Field,21,17
2019-07-15,2019,SF,COL,2,1,128,1.5,-150,14.0,-120,100,-138,-1.5,130,6.14,Coors Field,3,1
2019-07-15,2019,KC,CWS,5,2,112,1.5,-140,9.0,-105,-115,-122,-1.5,120,4.25,Kauffman Stadium,7,3
2019-07-15,2019,CLE,DET,8,6,-205,-1.5,-115,10.5,-115,-105,185,1.5,-105,7.06,Progressive Field,14,2
2019-07-15,2019,LAA,HOU,9,6,122,1.5,-140,9.5,100,-120,-132,-1.5,120,4.28,Angel Stadium,15,3
2019-07-15,2019,CWS,KC,2,5,-122,-1.5,120,9.0,-105,-115,112,1.5,-140,4.95,Kauffman Stadium,7,-3
2019-07-15,2019,HOU,LAA,6,9,-132,-1.5,120,9.5,100,-120,122,1.5,-140,5.41,Angel Stadium,15,-3
2019-07-15,2019,PHI,LAD,2,16,161,1.5,100,9.0,-120,100,-172,-1.5,-120,3.45,Citizens Bank Park,18,-14
2019-07-15,2019,ATL,MIL,4,2,-102,-1.5,145,10.0,-120,100,-108,1.5,-165,5.05,Miller Park,6,2
2019-07-15,2019,TB,NYY,5,4,135,1.5,-150,9.0,-105,-115,-145,-1.5,130,3.83,Yankee Stadium,9,1
2019-07-15,2019,LAD,PHI,16,2,-172,-1.5,-120,9.0,-120,100,161,1.5,100,5.69,Citizens Bank Park,18,14
2019-07-15,2019,STL,PIT,7,0,-135,-1.5,150,8.0,-110,-110,125,1.5,-170,4.6,Busch Stadium,7,7
2019-07-15,2019,COL,SF,2,19,-205,-1.5,-115,13.0,-110,-110,185,1.5,-105,8.74,Coors Field,21,-17
2019-07-15,2019,COL,SF,1,2,-138,-1.5,130,14.0,-120,100,128,1.5,-150,8.12,Coors Field,3,-1
2019-07-15,2019,PIT,STL,0,7,125,1.5,-170,8.0,-110,-110,-135,-1.5,150,3.56,Busch Stadium,7,-7
2019-07-15,2019,NYY,TB,4,5,-145,-1.5,130,9.0,-105,-115,135,1.5,-150,5.33,Yankee Stadium,9,-1
2019-07-15,2019,BOS,TOR,10,8,-180,-1.5,100,11.0,-110,-110,165,1.5,-120,7.07,Fenway Park,18,2
2019-07-16,2019,TEX,ARI,2,9,-163,-1.5,110,10.0,100,-120,153,1.5,-130,6.2,Rangers Ballpark,11,-7
2019-07-16,2019,MIL,ATL,13,1,-176,-1.5,105,9.5,-110,-110,163,1.5,-125,6.06,Miller Park,14,12
2019-07-16,2019,WSH,BAL,8,1,-192,-1.5,-140,11.5,-105,-115,176,1.5,120,7.56,Camden Yards,9,7
2019-07-16,2019,TOR,BOS,10,4,171,1.5,-105,11.5,-105,-115,-186,-1.5,-115,4.24,Fenway Park,14,6
2019-07-16,2019,CIN,CHC,3,4,115,1.5,-165,10.5,100,-120,-125,-1.5,145,4.88,Wrigley Field,7,-1
2019-07-16,2019,CHC,CIN,4,3,-125,-1.5,145,10.5,100,-120,115,1.5,-165,5.83,Wrigley Field,7,1
2019-07-16,2019,DET,CLE,0,8,215,1.5,110,10.5,-105,-115,-245,-1.5,-130,3.33,Progressive Field,8,-8
2019-07-16,2019,SF,COL,8,4,120,1.5,-145,14.0,-110,-110,-130,-1.5,125,6.36,Coors Field,12,4
2019-07-16,2019,KC,CWS,11,0,109,1.5,-140,10.5,-115,-105,-119,-1.5,120,5.02,Kauffman Stadium,11,11
2019-07-16,2019,CLE,DET,8,0,-245,-1.5,-130,10.5,-105,-115,215,1.5,110,7.46,Progressive Field,8,8
2019-07-16,2019,LAA,HOU,7,2,120,1.5,-135,9.5,-120,100,-130,-1.5,115,4.32,Angel Stadium,9,5
2019-07-16,2019,CWS,KC,0,11,-119,-1.5,120,10.5,-115,-105,109,1.5,-140,5.71,Kauffman Stadium,11,-11
2019-07-16,2019,HOU,LAA,2,7,-130,-1.5,115,9.5,-120,100,120,1.5,-135,5.37,Angel Stadium,9,-5
2019-07-16,2019,PHI,LAD,9,8,180,1.5,110,10.0,-105,-115,-200,-1.5,-130,3.57,Citizens Bank Park,17,1
2019-07-16,2019,SD,MIA,7,12,-106,-1.5,155,8.0,-110,-110,-104,1.5,-175,4.12,Marlins Park,19,-5
2019-07-16,2019,ATL,MIL,1,13,163,1.5,-125,9.5,-110,-110,-176,-1.5,105,3.61,Miller Park,14,-12
2019-07-16,2019,NYM,MIN,3,2,156,1.5,-125,11.0,100,-120,-166,-1.5,105,4.3,Target Field,5,1
2019-07-16,2019,MIN,NYM,2,3,-166,-1.5,105,11.0,100,-120,156,1.5,-125,6.86,Target Field,5,-1
2019-07-16,2019,TB,NYY,3,8,138,1.5,-155,10.5,-110,-110,-148,-1.5,135,4.41,Yankee Stadium,11,-5
2019-07-16,2019,SEA,OAK,2,9,155,1.5,-130,9.5,-105,-115,-165,-1.5,110,3.73,Oakland Coliseum,11,-7
2019-07-16,2019,LAD,PHI,8,9,-200,-1.5,-130,10.0,-105,-115,180,1.5,110,6.67,Citizens Bank Park,17,-1
2019-07-16,2019,STL,PIT,1,3,-180,-1.5,105,9.0,-110,-110,165,1.5,-125,5.79,Busch Stadium,4,-2
2019-07-16,2019,MIA,SD,12,7,-104,1.5,-175,8.0,-110,-110,-106,-1.5,155,4.08,Marlins Park,19,5
2019-07-16,2019,OAK,SEA,9,2,-165,-1.5,110,9.5,-105,-115,155,1.5,-130,5.92,Oakland Coliseum,11,7
2019-07-16,2019,COL,SF,4,8,-130,-1.5,125,14.0,-110,-110,120,1.5,-145,7.91,Coors Field,12,-4
2019-07-16,2019,PIT,STL,3,1,165,1.5,-125,9.0,-110,-110,-180,-1.5,105,3.4,Busch Stadium,4,2
2019-07-16,2019,NYY,TB,8,3,-148,-1.5,135,10.5,-110,-110,138,1.5,-155,6.27,Yankee Stadium,11,5
2019-07-16,2019,ARI,TEX,9,2,153,1.5,-130,10.0,100,-120,-163,-1.5,110,3.95,Rangers Ballpark,11,7
2019-07-16,2019,BOS,TOR,4,10,-186,-1.5,-115,11.5,-105,-115,171,1.5,-105,7.48,Fenway Park,14,-6
2019-07-16,2019,BAL,WSH,1,8,176,1.5,120,11.5,-105,-115,-192,-1.5,-140,4.17,Camden Yards,9,-7
2019-07-17,2019,TEX,ARI,4,19,115,1.5,-140,10.5,-105,-115,-125,-1.5,120,4.88,Rangers Ballpark,23,-15
2019-07-17,2019,MIL,ATL,5,4,102,-1.5,180,10.0,-120,100,-112,1.5,-205,4.95,Miller Park,9,1
2019-07-17,2019,WSH,BAL,2,9,-174,-1.5,-130,11.5,-105,-115,162,1.5,110,7.3,Camden Yards,11,-7
2019-07-17,2019,TOR,BOS,4,5,220,1.5,115,11.0,-105,-115,-250,-1.5,-135,3.44,Fenway Park,9,-1
2019-07-17,2019,CIN,CHC,2,5,120,1.5,-175,8.5,-110,-110,-130,-1.5,155,3.86,Wrigley Field,7,-3
2019-07-17,2019,CHC,CIN,5,2,-130,-1.5,155,8.5,-110,-110,120,1.5,-175,4.8,Wrigley Field,7,3
2019-07-17,2019,DET,CLE,2,7,250,1.5,140,9.0,100,-120,-290,-1.5,-160,2.57,Progressive Field,9,-5
2019-07-17,2019,SF,COL,11,8,185,1.5,105,13.5,100,-120,-205,-1.5,-125,4.74,Coors Field,19,3
2019-07-17,2019,KC,CWS,7,5,-130,-1.5,135,10.5,-115,-105,120,1.5,-155,5.93,Kauffman Stadium,12,2
2019-07-17,2019,CLE,DET,7,2,-290,-1.5,-160,9.0,100,-120,250,1.5,140,6.69,Progressive Field,9,5
2019-07-17,2019,LAA,HOU,2,11,180,1.5,115,9.0,105,-125,-200,-1.5,-135,3.21,Angel Stadium,13,-9
2019-07-17,2019,CWS,KC,5,7,120,1.5,-155,10.5,-115,-105,-130,-1.5,135,4.77,Kauffman Stadium,12,-2
2019-07-17,2019,HOU,LAA,11,2,-200,-1.5,-135,9.0,105,-125,180,1.5,115,6.0,Angel Stadium,13,9
2019-07-17,2019,PHI,LAD,2,7,154,1.5,-105,11.0,-115,-105,-164,-1.5,-115,4.33,Citizens Bank Park,9,-5
2019-07-17,2019,SD,MIA,3,2,-167,-1.5,100,7.5,-120,100,157,1.5,-120,4.69,Marlins Park,5,1
2019-07-17,2019,ATL,MIL,4,5,-112,1.5,-205,10.0,-120,100,102,-1.5,180,5.28,Miller Park,9,-1
2019-07-17,2019,NYM,MIN,14,4,164,1.5,-125,11.0,-110,-110,-178,-1.5,105,4.17,Target Field,18,10
2019-07-17,2019,MIN,NYM,4,14,-178,-1.5,105,11.0,-110,-110,164,1.5,-125,7.04,Target Field,18,-10
2019-07-17,2019,SEA,OAK,2,10,180,1.5,100,10.0,-110,-110,-200,-1.5,-120,3.57,Oakland Coliseum,12,-8
2019-07-17,2019,LAD,PHI,7,2,-164,-1.5,-115,11.0,-115,-105,154,1.5,-105,6.83,Citizens Bank Park,9,5
2019-07-17,2019,STL,PIT,6,5,-143,-1.5,135,8.5,-125,105,133,1.5,-155,5.0,Busch Stadium,11,1
2019-07-17,2019,MIA,SD,2,3,157,1.5,-120,7.5,-120,100,-167,-1.5,100,2.92,Marlins Park,5,-1
2019-07-17,2019,OAK,SEA,10,2,-200,-1.5,-120,10.0,-110,-110,180,1.5,100,6.67,Oakland Coliseum,12,8
2019-07-17,2019,COL,SF,8,11,-205,-1.5,-125,13.5,100,-120,185,1.5,105,9.07,Coors Field,19,-3
2019-07-17,2019,PIT,STL,5,6,133,1.5,-155,8.5,-125,105,-143,-1.5,135,3.65,Busch Stadium,11,-1
2019-07-17,2019,ARI,TEX,19,4,-125,-1.5,120,10.5,-105,-115,115,1.5,-140,5.83,Rangers Ballpark,23,15
2019-07-17,2019,BOS,TOR,5,4,-250,-1.5,-135,11.0,-105,-115,220,1.5,115,7.86,Fenway Park,9,1
2019-07-17,2019,BAL,WSH,9,2,162,1.5,110,11.5,-105,-115,-174,-1.5,-130,4.39,Camden Yards,11,7
2019-07-18,2019,MIL,ARI,5,1,-103,1.5,-200,9.5,-115,-105,-107,-1.5,175,4.82,Chase Field,6,4
2019-07-18,2019,WSH,ATL,13,4,-150,-1.5,105,10.0,-115,-105,140,1.5,-125,6.0,Suntrust Park,17,9
2019-07-18,2019,TOR,BOS,0,5,243,1.5,130,10.0,-105,-115,-275,-1.5,-150,2.92,Fenway Park,5,-5
2019-07-18,2019,STL,CIN,7,4,108,1.5,-175,10.0,-105,-115,-118,-1.5,155,4.81,Great American Ballpark,11,3
2019-07-18,2019,DET,CLE,3,6,190,1.5,-105,8.5,-120,100,-210,-1.5,-115,2.93,Progressive Field,9,-3
2019-07-18,2019,KC,CWS,6,5,-160,-1.5,125,11.0,-105,-115,144,1.5,-145,6.77,Kauffman Stadium,11,1
2019-07-18,2019,CLE,DET,6,3,-210,-1.5,-115,8.5,-120,100,190,1.5,-105,5.76,Progressive Field,9,3
2019-07-18,2019,LAA,HOU,2,6,142,1.5,-120,10.5,-105,-115,-152,-1.5,100,4.34,Angel Stadium,8,-4
2019-07-18,2019,CWS,KC,5,6,144,1.5,-145,11.0,-105,-115,-160,-1.5,125,4.51,Kauffman Stadium,11,-1
2019-07-18,2019,HOU,LAA,6,2,-152,-1.5,100,10.5,-105,-115,142,1.5,-120,6.33,Angel Stadium,8,4
2019-07-18,2019,PHI,LAD,7,6,-103,1.5,-175,9.0,-120,100,-107,-1.5,155,4.57,Citizens Bank Park,13,1
2019-07-18,2019,SD,MIA,3,4,-127,-1.5,125,7.5,-105,-115,117,1.5,-145,4.2,Marlins Park,7,-1
2019-07-18,2019,ARI,MIL,1,5,-107,-1.5,175,9.5,-115,-105,-103,1.5,-200,4.91,Chase Field,6,-4
2019-07-18,2019,OAK,MIN,3,6,116,1.5,-170,10.5,-125,105,-126,-1.5,150,4.86,Target Field,9,-3
2019-07-18,2019,SF,NYM,3,2,-118,-1.5,170,7.5,-105,-115,108,1.5,-190,4.06,AT&T Park,5,1
2019-07-18,2019,TB,NYY,2,6,-130,-1.5,-180,9.0,-110,-110,110,1.5,160,5.09,Yankee Stadium,8,-4
2019-07-18,2019,TB,NYY,1,5,108,1.5,-170,9.5,-105,-115,-118,-1.5,150,4.57,Yankee Stadium,6,-4
2019-07-18,2019,MIN,OAK,6,3,-126,-1.5,150,10.5,-125,105,116,1.5,-170,5.85,Target Field,9,3
2019-07-18,2019,LAD,PHI,6,7,-107,-1.5,155,9.0,-120,100,-103,1.5,-175,4.65,Citizens Bank Park,13,-1
2019-07-18,2019,MIA,SD,4,3,117,1.5,-145,7.5,-105,-115,-127,-1.5,125,3.46,Marlins Park,7,1
2019-07-18,2019,NYM,SF,2,3,108,1.5,-190,7.5,-105,-115,-118,-1.5,170,3.61,AT&T Park,5,-1
2019-07-18,2019,CIN,STL,4,7,-118,-1.5,155,10.0,-105,-115,108,1.5,-175,5.41,Great American Ballpark,11,-3
2019-07-18,2019,NYY,TB,6,2,110,1.5,160,9.0,-110,-110,-130,-1.5,-180,4.29,Yankee Stadium,8,4
2019-07-18,2019,NYY,TB,5,1,-118,-1.5,150,9.5,-105,-115,108,1.5,-170,5.14,Yankee Stadium,6,4
2019-07-18,2019,BOS,TOR,5,0,-275,-1.5,-150,10.0,-105,-115,243,1.5,130,7.33,Fenway Park,5,5
2019-07-18,2019,ATL,WSH,4,13,140,1.5,-125,10.0,-115,-105,-150,-1.5,105,4.17,Suntrust Park,17,-9
2019-07-19,2019,MIL,ARI,7,10,-132,-1.5,115,10.5,100,-120,122,1.5,-135,5.97,Chase Field,17,-3
2019-07-19,2019,WSH,ATL,3,4,-120,-1.5,125,10.0,-115,-105,110,1.5,-145,5.45,Suntrust Park,7,-1
2019-07-19,2019,BOS,BAL,2,11,-240,-1.5,-155,9.5,-120,100,210,1.5,135,6.71,Camden Yards,13,-9
2019-07-19,2019,BAL,BOS,11,2,210,1.5,135,9.5,-120,100,-240,-1.5,-155,3.06,Camden Yards,13,9
2019-07-19,2019,SD,CHC,5,6,155,1.5,-120,12.5,-105,-115,-165,-1.5,100,4.9,Wrigley Field,11,-1
2019-07-19,2019,STL,CIN,12,11,-106,1.5,-200,10.0,-105,-115,-104,-1.5,175,5.15,Great American Ballpark,23,1
2019-07-19,2019,KC,CLE,5,10,260,1.5,135,10.0,-110,-110,-300,-1.5,-155,2.78,Progressive Field,15,-5
2019-07-19,2019,NYY,COL,8,2,-220,-1.5,-130,11.5,-115,-105,200,1.5,110,7.91,Yankee Stadium,10,6
2019-07-19,2019,TB,CWS,2,9,-240,-1.5,-120,8.5,-120,100,210,1.5,100,6.0,Tropicana Field,11,-7
2019-07-19,2019,TOR,DET,12,1,-160,-1.5,-110,10.0,-115,-105,150,1.5,-110,6.15,Comerica Park,13,11
2019-07-19,2019,TEX,HOU,3,4,190,1.5,-105,8.0,-115,-105,-210,-1.5,-115,2.76,Minute Maid Park,7,-1
2019-07-19,2019,CLE,KC,10,5,-300,-1.5,-155,10.0,-110,-110,260,1.5,135,7.5,Progressive Field,15,5
2019-07-19,2019,SEA,LAA,10,0,113,1.5,-135,10.0,-110,-110,-123,-1.5,115,4.69,T-Mobile Park,10,10
2019-07-19,2019,MIA,LAD,1,2,290,1.5,145,7.5,-115,-105,-335,-1.5,-165,1.92,Dodger Stadium,3,-1
2019-07-19,2019,LAD,MIA,2,1,-335,-1.5,-165,7.5,-115,-105,290,1.5,145,5.78,Dodger Stadium,3,1
2019-07-19,2019,ARI,MIL,10,7,122,1.5,-135,10.5,100,-120,-132,-1.5,115,4.73,Chase Field,17,3
2019-07-19,2019,OAK,MIN,5,3,120,1.5,-155,11.0,-105,-115,-130,-1.5,135,5.0,Target Field,8,2
2019-07-19,2019,SF,NYM,1,0,157,1.5,-115,7.5,-120,100,-167,-1.5,-105,2.92,AT&T Park,1,1
2019-07-19,2019,COL,NYY,2,8,200,1.5,110,11.5,-115,-105,-220,-1.5,-130,3.83,Yankee Stadium,10,-6
2019-07-19,2019,MIN,OAK,3,5,-130,-1.5,135,11.0,-105,-115,120,1.5,-155,6.22,Target Field,8,-2
2019-07-19,2019,PIT,PHI,1,6,-115,-1.5,160,11.0,100,-120,105,1.5,-180,5.88,PNC Park,7,-5
2019-07-19,2019,PHI,PIT,6,1,105,1.5,-180,11.0,100,-120,-115,-1.5,160,5.37,PNC Park,7,5
2019-07-19,2019,CHC,SD,6,5,-165,-1.5,100,12.5,-105,-115,155,1.5,-120,7.78,Wrigley Field,11,1
2019-07-19,2019,LAA,SEA,0,10,-123,-1.5,115,10.0,-110,-110,113,1.5,-135,5.52,T-Mobile Park,10,-10
2019-07-19,2019,NYM,SF,0,1,-167,-1.5,-105,7.5,-120,100,157,1.5,-115,4.69,AT&T Park,1,-1
2019-07-19,2019,CIN,STL,11,12,-104,-1.5,175,10.0,-105,-115,-106,1.5,-200,5.1,Great American Ballpark,23,-1
2019-07-19,2019,CWS,TB,9,2,210,1.5,100,8.5,-120,100,-240,-1.5,-120,2.74,Tropicana Field,11,7
2019-07-19,2019,HOU,TEX,4,3,-210,-1.5,-115,8.0,-115,-105,190,1.5,-105,5.42,Minute Maid Park,7,1
2019-07-19,2019,DET,TOR,1,12,150,1.5,-110,10.0,-115,-105,-160,-1.5,-110,4.0,Comerica Park,13,-11
2019-07-19,2019,ATL,WSH,4,3,110,1.5,-145,10.0,-115,-105,-120,-1.5,125,4.76,Suntrust Park,7,1
2019-07-20,2019,MIL,ARI,8,3,143,1.5,-145,9.0,-115,-105,-153,-1.5,125,3.7,Chase Field,11,5
2019-07-20,2019,WSH,ATL,5,3,156,1.5,-125,10.0,-120,100,-166,-1.5,105,3.91,Suntrust Park,8,2
2019-07-20,2019,BOS,BAL,17,6,-220,-1.5,-150,12.5,100,-120,200,1.5,130,8.59,Camden Yards,23,11
2019-07-20,2019,BAL,BOS,6,17,200,1.5,130,12.5,100,-120,-220,-1.5,-150,4.17,Camden Yards,23,-11
2019-07-20,2019,SD,CHC,5,6,125,1.5,-155,12.5,-110,-110,-135,-1.5,135,5.56,Wrigley Field,11,-1
2019-07-20,2019,STL,CIN,2,3,132,1.5,-155,9.5,100,-120,-142,-1.5,135,4.09,Great American Ballpark,5,-1
2019-07-20,2019,KC,CLE,1,0,154,1.5,-125,10.5,-110,-110,-164,-1.5,105,4.13,Progressive Field,1,1
2019-07-20,2019,NYY,COL,11,5,-260,-1.5,-160,11.5,-110,-110,230,1.5,140,8.31,Yankee Stadium,16,6
2019-07-20,2019,TB,CWS,1,2,-155,-1.5,135,8.5,-105,-115,145,1.5,-155,5.17,Tropicana Field,3,-1
2019-07-20,2019,TOR,DET,7,5,-122,-1.5,120,10.5,-105,-115,112,1.5,-140,5.77,Comerica Park,12,2
2019-07-20,2019,TEX,HOU,1,6,175,1.5,-115,10.0,-120,100,-190,-1.5,-105,3.64,Minute Maid Park,7,-5
2019-07-20,2019,CLE,KC,0,1,-164,-1.5,105,10.5,-110,-110,154,1.5,-125,6.52,Progressive Field,1,-1
2019-07-20,2019,SEA,LAA,2,6,132,1.5,-130,10.5,-110,-110,-142,-1.5,110,4.53,T-Mobile Park,8,-4
2019-07-20,2019,MIA,LAD,6,10,280,1.5,140,8.0,-125,105,-320,-1.5,-160,2.11,Dodger Stadium,16,-4
2019-07-20,2019,LAD,MIA,10,6,-320,-1.5,-160,8.0,-125,105,280,1.5,140,6.1,Dodger Stadium,16,4
2019-07-20,2019,ARI,MIL,3,8,-153,-1.5,125,9.0,-115,-105,143,1.5,-145,5.44,Chase Field,11,-5
2019-07-20,2019,OAK,MIN,5,4,128,1.5,-145,10.0,-120,100,-138,-1.5,125,4.39,Target Field,9,1
2019-07-20,2019,SF,NYM,4,11,-150,-1.5,130,9.0,-105,-115,140,1.5,-150,5.4,AT&T Park,15,-7
2019-07-20,2019,COL,NYY,5,11,230,1.5,140,11.5,-110,-110,-260,-1.5,-160,3.48,Yankee Stadium,16,-6
2019-07-20,2019,MIN,OAK,4,5,-138,-1.5,125,10.0,-120,100,128,1.5,-145,5.8,Target Field,9,-1
2019-07-20,2019,PIT,PHI,5,1,-130,-1.5,145,10.0,-110,-110,120,1.5,-165,5.65,PNC Park,6,4
2019-07-20,2019,PHI,PIT,1,5,120,1.5,-165,10.0,-110,-110,-130,-1.5,145,4.55,PNC Park,6,-4
2019-07-20,2019,CHC,SD,6,5,-135,-1.5,135,12.5,-110,-110,125,1.5,-155,7.18,Wrigley Field,11,1
2019-07-20,2019,LAA,SEA,6,2,-142,-1.5,110,10.5,-110,-110,132,1.5,-130,6.16,T-Mobile Park,8,4
2019-07-20,2019,NYM,SF,11,4,140,1.5,-150,9.0,-105,-115,-150,-1.5,130,3.75,AT&T Park,15,7
2019-07-20,2019,CIN,STL,3,2,-142,-1.5,135,9.5,100,-120,132,1.5,-155,5.57,Great American Ballpark,5,1
2019-07-20,2019,CWS,TB,2,1,145,1.5,-155,8.5,-105,-115,-155,-1.5,135,3.47,Tropicana Field,3,1
2019-07-20,2019,HOU,TEX,6,1,-190,-1.5,-105,10.0,-120,100,175,1.5,-115,6.55,Minute Maid Park,7,5
2019-07-20,2019,DET,TOR,5,7,112,1.5,-140,10.5,-105,-115,-122,-1.5,120,4.95,Comerica Park,12,-2
2019-07-20,2019,ATL,WSH,3,5,-166,-1.5,105,10.0,-120,100,156,1.5,-125,6.24,Suntrust Park,8,-2
2019-07-21,2019,MIL,ARI,7,4,-125,-1.5,120,8.5,100,-120,115,1.5,-140,4.72,Chase Field,11,3
2019-07-21,2019,WSH,ATL,1,7,160,1.5,-120,11.0,-110,-110,-170,-1.5,100,4.23,Suntrust Park,8,-6
2019-07-21,2019,BOS,BAL,0,5,-215,-1.5,-150,12.5,100,-120,195,1.5,130,8.53,Camden Yards,5,-5
2019-07-21,2019,BAL,BOS,5,0,195,1.5,130,12.5,100,-120,-215,-1.5,-150,4.24,Camden Yards,5,5
2019-07-21,2019,SD,CHC,5,1,160,1.5,-145,8.0,-115,-105,-170,-1.5,125,3.08,Wrigley Field,6,4
2019-07-21,2019,STL,CIN,3,1,100,-1.5,155,9.5,-105,-115,-110,1.5,-175,4.75,Great American Ballpark,4,2
2019-07-21,2019,KC,CLE,4,5,190,1.5,-110,10.5,-110,-110,-210,-1.5,-110,3.62,Progressive Field,9,-1
2019-07-21,2019,NYY,COL,4,8,-190,-1.5,-120,10.5,100,-120,175,1.5,100,6.88,Yankee Stadium,12,-4
2019-07-21,2019,TB,CWS,4,2,-270,-1.5,-125,8.0,-110,-110,240,1.5,105,5.84,Tropicana Field,6,2
2019-07-21,2019,TOR,DET,3,4,-118,-1.5,130,10.5,-105,-115,108,1.5,-150,5.68,Comerica Park,7,-1
2019-07-21,2019,TEX,HOU,3,5,125,1.5,-160,9.0,-105,-115,-135,-1.5,140,4.0,Minute Maid Park,8,-2
2019-07-21,2019,CLE,KC,5,4,-210,-1.5,-110,10.5,-110,-110,190,1.5,-110,7.11,Progressive Field,9,1
2019-07-21,2019,SEA,LAA,3,9,128,1.5,-135,11.0,100,-120,-138,-1.5,115,4.82,T-Mobile Park,12,-6
2019-07-21,2019,MIA,LAD,0,9,280,1.5,135,8.5,-110,-110,-320,-1.5,-155,2.24,Dodger Stadium,9,-9
2019-07-21,2019,LAD,MIA,9,0,-320,-1.5,-155,8.5,-110,-110,280,1.5,135,6.48,Dodger Stadium,9,9
2019-07-21,2019,ARI,MIL,4,7,115,1.5,-140,8.5,100,-120,-125,-1.5,120,3.95,Chase Field,11,-3
2019-07-21,2019,OAK,MIN,6,7,120,1.5,-165,10.5,-115,-105,-130,-1.5,145,4.77,Target Field,13,-1
2019-07-21,2019,SF,NYM,3,2,-110,-1.5,170,8.5,-120,100,100,1.5,-190,4.45,AT&T Park,5,1
2019-07-21,2019,COL,NYY,8,4,175,1.5,100,10.5,100,-120,-190,-1.5,-120,3.82,Yankee Stadium,12,4
2019-07-21,2019,MIN,OAK,7,6,-130,-1.5,145,10.5,-115,-105,120,1.5,-165,5.93,Target Field,13,1
2019-07-21,2019,PIT,PHI,1,2,-132,-1.5,125,11.0,-110,-110,122,1.5,-145,6.26,PNC Park,3,-1
2019-07-21,2019,PHI,PIT,2,1,122,1.5,-145,11.0,-110,-110,-132,-1.5,125,4.95,PNC Park,3,1
2019-07-21,2019,CHC,SD,1,5,-170,-1.5,125,8.0,-115,-105,160,1.5,-145,5.04,Wrigley Field,6,-4
2019-07-21,2019,LAA,SEA,9,3,-138,-1.5,115,11.0,100,-120,128,1.5,-135,6.38,T-Mobile Park,12,6
2019-07-21,2019,NYM,SF,2,3,100,1.5,-190,8.5,-120,100,-110,-1.5,170,4.25,AT&T Park,5,-1
2019-07-21,2019,CIN,STL,1,3,-110,1.5,-175,9.5,-105,-115,100,-1.5,155,4.98,Great American Ballpark,4,-2
2019-07-21,2019,CWS,TB,2,4,240,1.5,105,8.0,-110,-110,-270,-1.5,-125,2.35,Tropicana Field,6,-2
2019-07-21,2019,HOU,TEX,5,3,-135,-1.5,140,9.0,-105,-115,125,1.5,-160,5.17,Minute Maid Park,8,2
2019-07-21,2019,DET,TOR,4,3,108,1.5,-150,10.5,-105,-115,-118,-1.5,130,5.05,Comerica Park,7,1
2019-07-21,2019,ATL,WSH,7,1,-170,-1.5,100,11.0,-110,-110,160,1.5,-120,6.93,Suntrust Park,8,6
2019-07-22,2019,BAL,ARI,3,6,215,1.5,105,9.0,100,-120,-245,-1.5,-125,2.86,Chase Field,9,-3
2019-07-22,2019,ARI,BAL,6,3,-245,-1.5,-125,9.0,100,-120,215,1.5,105,6.39,Chase Field,9,3
2019-07-22,2019,TB,BOS,4,9,112,1.5,-155,8.5,-105,-115,-122,-1.5,135,4.01,Tropicana Field,13,-5
2019-07-22,2019,SF,CHC,5,4,-102,1.5,-170,8.5,-120,100,-108,-1.5,150,4.29,AT&T Park,9,1
2019-07-22,2019,MIL,CIN,5,6,-113,-1.5,170,9.0,100,-120,103,1.5,-190,4.77,Miller Park,11,-1
2019-07-22,2019,TOR,CLE,3,7,161,1.5,100,9.0,-115,-105,-172,-1.5,-120,3.45,Rogers Centre,10,-4
2019-07-22,2019,MIA,CWS,1,9,-102,1.5,-180,10.0,100,-120,-108,-1.5,160,5.05,Guaranteed Rate Field,10,-8
2019-07-22,2019,OAK,HOU,1,11,240,1.5,115,9.0,105,-125,-270,-1.5,-135,2.65,Minute Maid Park,12,-10
2019-07-22,2019,CWS,MIA,9,1,-108,-1.5,160,10.0,100,-120,-102,1.5,-180,5.19,Guaranteed Rate Field,10,8
2019-07-22,2019,CIN,MIL,6,5,103,1.5,-190,9.0,100,-120,-113,-1.5,170,4.43,Miller Park,11,1
2019-07-22,2019,NYY,MIN,6,8,-115,-1.5,125,11.0,-115,-105,105,1.5,-145,5.88,Target Field,14,-2
2019-07-22,2019,MIN,NYY,8,6,105,1.5,-145,11.0,-115,-105,-115,-1.5,125,5.37,Target Field,14,2
2019-07-22,2019,HOU,OAK,11,1,-270,-1.5,-135,9.0,105,-125,240,1.5,115,6.57,Minute Maid Park,12,10
2019-07-22,2019,STL,PIT,6,5,-108,-1.5,140,9.5,100,-120,-102,1.5,-160,4.93,PNC Park,11,1
2019-07-22,2019,TEX,SEA,3,7,103,1.5,-190,10.0,-105,-115,-113,-1.5,170,4.93,T-Mobile Park,10,-4
2019-07-22,2019,CHC,SF,4,5,-108,-1.5,150,8.5,-120,100,-102,1.5,-170,4.41,AT&T Park,9,-1
2019-07-22,2019,PIT,STL,5,6,-102,1.5,-160,9.5,100,-120,-108,-1.5,140,4.8,PNC Park,11,-1
2019-07-22,2019,BOS,TB,9,4,-122,-1.5,135,8.5,-105,-115,112,1.5,-155,4.67,Tropicana Field,13,5
2019-07-22,2019,SEA,TEX,7,3,-113,-1.5,170,10.0,-105,-115,103,1.5,-190,5.31,T-Mobile Park,10,4
2019-07-22,2019,CLE,TOR,7,3,-172,-1.5,-120,9.0,-115,-105,161,1.5,100,5.69,Rogers Centre,10,4
2019-07-23,2019,BAL,ARI,7,2,170,1.5,-125,9.0,-105,-115,-185,-1.5,105,3.33,Chase Field,9,5
2019-07-23,2019,KC,ATL,5,4,210,1.5,105,9.5,105,-125,-240,-1.5,-125,3.06,Suntrust Park,9,1
2019-07-23,2019,ARI,BAL,2,7,-185,-1.5,105,9.0,-105,-115,170,1.5,-125,5.84,Chase Field,9,-5
2019-07-23,2019,TB,BOS,4,5,145,1.5,-130,7.5,-110,-110,-155,-1.5,110,3.06,Tropicana Field,9,-1
2019-07-23,2019,SF,CHC,5,4,-108,1.5,-190,7.0,-115,-105,-102,-1.5,170,3.63,AT&T Park,9,1
2019-07-23,2019,MIL,CIN,6,14,-149,-1.5,125,9.5,-110,-110,139,1.5,-145,5.68,Miller Park,20,-8
2019-07-23,2019,TOR,CLE,2,1,162,1.5,110,9.5,100,-120,-174,-1.5,-130,3.63,Rogers Centre,3,1
2019-07-23,2019,WSH,COL,11,1,-230,-1.5,-115,9.0,-120,100,205,1.5,-105,6.27,Nationals Park,12,10
2019-07-23,2019,MIA,CWS,5,1,-122,-1.5,125,9.0,-110,-110,112,1.5,-145,4.95,Guaranteed Rate Field,6,4
2019-07-23,2019,PHI,DET,3,2,-137,-1.5,110,8.0,-115,-105,127,1.5,-130,4.62,Comerica Park,5,1
2019-07-23,2019,OAK,HOU,4,3,145,1.5,-135,9.5,-125,105,-155,-1.5,115,3.88,Minute Maid Park,7,1
2019-07-23,2019,ATL,KC,4,5,-240,-1.5,-125,9.5,105,-125,210,1.5,105,6.71,Suntrust Park,9,-1
2019-07-23,2019,LAD,LAA,4,5,-210,-1.5,-105,10.0,100,-120,190,1.5,-115,6.77,Dodger Stadium,9,-1
2019-07-23,2019,LAA,LAD,5,4,190,1.5,-115,10.0,100,-120,-210,-1.5,-105,3.45,Dodger Stadium,9,1
2019-07-23,2019,CWS,MIA,1,5,112,1.5,-145,9.0,-110,-110,-122,-1.5,125,4.25,Guaranteed Rate Field,6,-4
2019-07-23,2019,CIN,MIL,14,6,139,1.5,-145,9.5,-110,-110,-149,-1.5,125,3.97,Miller Park,20,8
2019-07-23,2019,NYY,MIN,14,12,-122,-1.5,125,10.0,-115,-105,112,1.5,-145,5.5,Target Field,26,2
2019-07-23,2019,SD,NYM,2,5,-137,-1.5,115,8.5,-105,-115,127,1.5,-135,4.91,Citi Field,7,-3
2019-07-23,2019,MIN,NYY,12,14,112,1.5,-145,10.0,-115,-105,-122,-1.5,125,4.72,Target Field,26,-2
2019-07-23,2019,HOU,OAK,3,4,-155,-1.5,115,9.5,-125,105,145,1.5,-135,5.77,Minute Maid Park,7,-1
2019-07-23,2019,DET,PHI,2,3,127,1.5,-130,8.0,-115,-105,-137,-1.5,110,3.52,Comerica Park,5,-1
2019-07-23,2019,STL,PIT,4,3,127,1.5,-170,9.0,-120,100,-137,-1.5,150,3.96,PNC Park,7,1
2019-07-23,2019,NYM,SD,5,2,127,1.5,-135,8.5,-105,-115,-137,-1.5,115,3.74,Citi Field,7,3
2019-07-23,2019,TEX,SEA,7,2,110,1.5,-175,10.0,100,-120,-120,-1.5,155,4.76,T-Mobile Park,9,5
2019-07-23,2019,CHC,SF,4,5,-102,-1.5,170,7.0,-115,-105,-108,1.5,-190,3.53,AT&T Park,9,-1
2019-07-23,2019,PIT,STL,3,4,-137,-1.5,150,9.0,-120,100,127,1.5,-170,5.2,PNC Park,7,-1
2019-07-23,2019,BOS,TB,5,4,-155,-1.5,110,7.5,-110,-110,145,1.5,-130,4.56,Tropicana Field,9,1
2019-07-23,2019,SEA,TEX,2,7,-120,-1.5,155,10.0,100,-120,110,1.5,-175,5.45,T-Mobile Park,9,-5
2019-07-23,2019,CLE,TOR,1,2,-174,-1.5,-130,9.5,100,-120,162,1.5,110,6.03,Rogers Centre,3,-1
2019-07-23,2019,COL,WSH,1,11,205,1.5,-105,9.0,-120,100,-230,-1.5,-115,2.95,Nationals Park,12,-10
2019-07-24,2019,BAL,ARI,2,5,124,1.5,-165,9.5,-110,-110,-134,-1.5,145,4.24,Chase Field,7,-3
2019-07-24,2019,KC,ATL,2,0,170,1.5,-125,9.5,-115,-105,-185,-1.5,105,3.52,Suntrust Park,2,2
2019-07-24,2019,ARI,BAL,5,2,-134,-1.5,145,9.5,-110,-110,124,1.5,-165,5.44,Chase Field,7,3
2019-07-24,2019,TB,BOS,3,2,-110,-1.5,190,7.5,-120,100,100,1.5,-215,3.93,Tropicana Field,5,1
2019-07-24,2019,SF,CHC,1,4,138,1.5,-125,8.5,-115,-105,-148,-1.5,105,3.57,AT&T Park,5,-3
2019-07-24,2019,MIL,CIN,5,4,-157,-1.5,125,10.0,-110,-110,147,1.5,-145,6.11,Miller Park,9,1
2019-07-24,2019,TOR,CLE,0,4,124,1.5,-135,8.5,-120,100,-134,-1.5,115,3.79,Rogers Centre,4,-4
2019-07-24,2019,WSH,COL,3,2,-111,-1.5,160,10.0,-120,100,101,1.5,-180,5.26,Nationals Park,5,1
2019-07-24,2019,WSH,COL,2,0,-230,-1.5,-135,9.5,-115,-105,205,1.5,115,6.62,Nationals Park,2,2
2019-07-24,2019,MIA,CWS,2,0,111,1.5,-175,9.0,-110,-110,-121,-1.5,155,4.27,Guaranteed Rate Field,2,2
2019-07-24,2019,PHI,DET,4,0,-152,-1.5,100,10.0,-115,-105,142,1.5,-120,6.03,Comerica Park,4,4
2019-07-24,2019,OAK,HOU,2,4,200,1.5,-105,9.0,-105,-115,-220,-1.5,-115,3.0,Minute Maid Park,6,-2
2019-07-24,2019,ATL,KC,0,2,-185,-1.5,105,9.5,-115,-105,170,1.5,-125,6.17,Suntrust Park,2,-2
2019-07-24,2019,LAD,LAA,2,3,-210,-1.5,-110,10.0,-105,-115,190,1.5,-110,6.77,Dodger Stadium,5,-1
2019-07-24,2019,LAA,LAD,3,2,190,1.5,-110,10.0,-105,-115,-210,-1.5,-110,3.45,Dodger Stadium,5,1
2019-07-24,2019,CWS,MIA,0,2,-121,-1.5,155,9.0,-110,-110,111,1.5,-175,4.93,Guaranteed Rate Field,2,-2
2019-07-24,2019,CIN,MIL,4,5,147,1.5,-145,10.0,-110,-110,-157,-1.5,125,4.05,Miller Park,9,-1
2019-07-24,2019,NYY,MIN,10,7,-119,-1.5,140,10.5,-120,100,109,1.5,-160,5.71,Target Field,17,3
2019-07-24,2019,SD,NYM,7,2,140,1.5,-155,8.5,100,-120,-150,-1.5,135,3.54,Citi Field,9,5
2019-07-24,2019,MIN,NYY,7,10,109,1.5,-160,10.5,-120,100,-119,-1.5,140,5.02,Target Field,17,-3
2019-07-24,2019,HOU,OAK,4,2,-220,-1.5,-115,9.0,-105,-115,200,1.5,-105,6.19,Minute Maid Park,6,2
2019-07-24,2019,DET,PHI,0,4,142,1.5,-120,10.0,-115,-105,-152,-1.5,100,4.13,Comerica Park,4,-4
2019-07-24,2019,STL,PIT,14,8,-105,1.5,-210,9.5,-105,-115,-105,-1.5,185,4.87,PNC Park,22,6
2019-07-24,2019,NYM,SD,2,7,-150,-1.5,135,8.5,100,-120,140,1.5,-155,5.1,Citi Field,9,-5
2019-07-24,2019,TEX,SEA,3,5,-145,-1.5,120,8.5,-120,100,135,1.5,-140,5.03,T-Mobile Park,8,-2
2019-07-24,2019,CHC,SF,4,1,-148,-1.5,105,8.5,-115,-105,138,1.5,-125,5.07,AT&T Park,5,3
2019-07-24,2019,PIT,STL,8,14,-105,-1.5,185,9.5,-105,-115,-105,1.5,-210,4.87,PNC Park,22,-6
2019-07-24,2019,BOS,TB,2,3,100,1.5,-215,7.5,-120,100,-110,-1.5,190,3.75,Tropicana Field,5,-1
2019-07-24,2019,SEA,TEX,5,3,135,1.5,-140,8.5,-120,100,-145,-1.5,120,3.62,T-Mobile Park,8,2
2019-07-24,2019,CLE,TOR,4,0,-134,-1.5,115,8.5,-120,100,124,1.5,-135,4.87,Rogers Centre,4,4
2019-07-24,2019,COL,WSH,2,3,101,1.5,-180,10.0,-120,100,-111,-1.5,160,4.98,Nationals Park,5,-1
2019-07-24,2019,COL,WSH,0,2,205,1.5,115,9.5,-115,-105,-230,-1.5,-135,3.11,Nationals Park,2,-2
2019-07-25,2019,LAA,BAL,8,10,-240,-1.5,-135,10.5,-115,-105,210,1.5,115,7.41,Angel Stadium,18,-2
2019-07-25,2019,NYY,BOS,3,19,-109,-1.5,135,11.0,-110,-110,-101,1.5,-155,5.74,Fenway Park,22,-16
2019-07-25,2019,KC,CLE,4,5,144,1.5,-120,10.0,100,-120,-154,-1.5,100,4.1,Kauffman Stadium,9,-1
2019-07-25,2019,WSH,COL,7,8,-320,-1.5,-160,8.5,-125,105,280,1.5,140,6.48,Nationals Park,15,-1
2019-07-25,2019,MIN,CWS,10,3,-150,-1.5,100,8.5,-120,100,140,1.5,-120,5.1,Guaranteed Rate Field,13,7
2019-07-25,2019,SEA,DET,10,2,-155,-1.5,115,9.5,-115,-105,145,1.5,-135,5.77,T-Mobile Park,12,8
2019-07-25,2019,CLE,KC,5,4,-154,-1.5,100,10.0,100,-120,144,1.5,-120,6.06,Kauffman Stadium,9,1
2019-07-25,2019,BAL,LAA,10,8,210,1.5,115,10.5,-115,-105,-240,-1.5,-135,3.39,Angel Stadium,18,2
2019-07-25,2019,CWS,MIN,3,10,140,1.5,-120,8.5,-120,100,-150,-1.5,100,3.54,Guaranteed Rate Field,13,-7
2019-07-25,2019,SD,NYM,0,4,185,1.5,-130,7.5,-110,-110,-205,-1.5,110,2.63,Citi Field,4,-4
2019-07-25,2019,BOS,NYY,19,3,-101,1.5,-155,11.0,-110,-110,-109,-1.5,135,5.53,Fenway Park,22,16
2019-07-25,2019,TEX,OAK,11,3,175,1.5,-115,9.0,-120,100,-190,-1.5,-105,3.27,Oakland Coliseum,14,8
2019-07-25,2019,STL,PIT,6,3,108,1.5,-185,9.0,-105,-115,-118,-1.5,165,4.33,PNC Park,9,3
2019-07-25,2019,NYM,SD,4,0,-205,-1.5,110,7.5,-110,-110,185,1.5,-130,5.04,Citi Field,4,4
2019-07-25,2019,DET,SEA,2,10,145,1.5,-135,9.5,-115,-105,-155,-1.5,115,3.88,T-Mobile Park,12,-8
2019-07-25,2019,PIT,STL,3,6,-118,-1.5,165,9.0,-105,-115,108,1.5,-185,4.87,PNC Park,9,-3
2019-07-25,2019,OAK,TEX,3,11,-190,-1.5,-105,9.0,-120,100,175,1.5,-115,5.9,Oakland Coliseum,14,-8
2019-07-25,2019,COL,WSH,8,7,280,1.5,140,8.5,-125,105,-320,-1.5,-160,2.24,Nationals Park,15,1
2019-07-26,2019,MIA,ARI,3,2,170,1.5,100,7.5,-110,-110,-185,-1.5,-120,2.78,Marlins Park,5,1
2019-07-26,2019,PHI,ATL,2,9,115,1.5,-145,10.0,-105,-115,-125,-1.5,125,4.65,Citizens Bank Park,11,-7
2019-07-26,2019,LAA,BAL,3,9,-186,-1.5,100,10.0,-120,100,171,1.5,-120,6.5,Angel Stadium,12,-6
2019-07-26,2019,NYY,BOS,5,10,-126,-1.5,115,11.0,-120,100,116,1.5,-135,6.13,Fenway Park,15,-5
2019-07-26,2019,MIL,CHC,3,2,-119,1.5,-170,9.5,-110,-110,109,-1.5,150,5.16,Miller Park,5,1
2019-07-26,2019,COL,CIN,12,2,130,1.5,-160,8.5,-120,100,-140,-1.5,140,3.7,Great American Ballpark,14,10
2019-07-26,2019,KC,CLE,3,8,101,1.5,-160,9.5,-110,-110,-111,-1.5,140,4.73,Kauffman Stadium,11,-5
2019-07-26,2019,CIN,COL,2,12,-140,-1.5,140,8.5,-120,100,130,1.5,-160,4.96,Great American Ballpark,14,-10
2019-07-26,2019,MIN,CWS,6,2,-182,-1.5,-125,10.0,-110,-110,167,1.5,105,6.45,Guaranteed Rate Field,8,4
2019-07-26,2019,SEA,DET,3,2,-128,-1.5,145,9.5,-105,-115,118,1.5,-165,5.33,T-Mobile Park,5,1
2019-07-26,2019,STL,HOU,5,3,100,1.5,-160,8.5,-120,100,-110,-1.5,140,4.25,Busch Stadium,8,2
2019-07-26,2019,CLE,KC,8,3,-111,-1.5,140,9.5,-110,-110,101,1.5,-160,5.0,Kauffman Stadium,11,5
2019-07-26,2019,BAL,LAA,9,3,171,1.5,-120,10.0,-120,100,-186,-1.5,100,3.69,Angel Stadium,12,6
2019-07-26,2019,WSH,LAD,2,4,150,1.5,-110,9.5,-110,-110,-160,-1.5,-110,3.8,Nationals Park,6,-2
2019-07-26,2019,ARI,MIA,2,3,-185,-1.5,-120,7.5,-110,-110,170,1.5,100,4.87,Marlins Park,5,-1
2019-07-26,2019,CHC,MIL,2,3,109,-1.5,150,9.5,-110,-110,-119,1.5,-170,4.55,Miller Park,5,-1
2019-07-26,2019,CWS,MIN,2,6,167,1.5,105,10.0,-110,-110,-182,-1.5,-125,3.75,Guaranteed Rate Field,8,-4
2019-07-26,2019,PIT,NYM,3,6,160,1.5,-135,9.0,-120,100,-170,-1.5,115,3.46,Citi Field,9,-3
2019-07-26,2019,BOS,NYY,10,5,116,1.5,-135,11.0,-120,100,-126,-1.5,115,5.09,Fenway Park,15,5
2019-07-26,2019,TEX,OAK,5,2,105,1.5,-190,9.0,-105,-115,-115,-1.5,170,4.39,Oakland Coliseum,7,3
2019-07-26,2019,ATL,PHI,9,2,-125,-1.5,125,10.0,-105,-115,115,1.5,-145,5.56,Citizens Bank Park,11,7
2019-07-26,2019,NYM,PIT,6,3,-170,-1.5,115,9.0,-120,100,160,1.5,-135,5.67,Citi Field,9,3
2019-07-26,2019,SF,SD,2,1,122,1.5,-175,8.0,-115,-105,-132,-1.5,155,3.6,PETCO Park,3,1
2019-07-26,2019,DET,SEA,2,3,118,1.5,-165,9.5,-105,-115,-128,-1.5,145,4.36,T-Mobile Park,5,-1
2019-07-26,2019,SD,SF,1,2,-132,-1.5,155,8.0,-115,-105,122,1.5,-175,4.55,PETCO Park,3,-1
2019-07-26,2019,HOU,STL,3,5,-110,-1.5,140,8.5,-120,100,100,1.5,-160,4.45,Busch Stadium,8,-2
2019-07-26,2019,TOR,TB,1,3,126,1.5,-130,9.5,-110,-110,-136,-1.5,110,4.2,Rogers Centre,4,-2
2019-07-26,2019,OAK,TEX,2,5,-115,-1.5,170,9.0,-105,-115,105,1.5,-190,4.81,Oakland Coliseum,7,-3
2019-07-26,2019,TB,TOR,3,1,-136,-1.5,110,9.5,-110,-110,126,1.5,-130,5.47,Rogers Centre,4,2
2019-07-26,2019,LAD,WSH,4,2,-160,-1.5,-110,9.5,-110,-110,150,1.5,-110,5.85,Nationals Park,6,2
2019-07-27,2019,MIA,ARI,2,9,107,1.5,-160,8.0,-110,-110,-117,-1.5,140,3.86,Marlins Park,11,-7
2019-07-27,2019,PHI,ATL,7,15,123,1.5,-135,9.5,-115,-105,-133,-1.5,115,4.26,Citizens Bank Park,22,-8
2019-07-27,2019,LAA,BAL,7,8,-240,-1.5,-125,10.0,-120,100,210,1.5,105,7.06,Angel Stadium,15,-1
2019-07-27,2019,NYY,BOS,5,9,137,1.5,-140,12.0,100,-120,-147,-1.5,120,5.06,Fenway Park,14,-4
2019-07-27,2019,MIL,CHC,5,3,-107,-1.5,180,9.5,-115,-105,-103,1.5,-205,4.91,Miller Park,8,2
2019-07-27,2019,COL,CIN,1,3,146,1.5,-140,10.5,-120,100,-156,-1.5,120,4.27,Great American Ballpark,4,-2
2019-07-27,2019,KC,CLE,1,9,190,1.5,115,9.0,-120,100,-210,-1.5,-135,3.1,Kauffman Stadium,10,-8
2019-07-27,2019,CIN,COL,3,1,-156,-1.5,120,10.5,-120,100,146,1.5,-140,6.4,Great American Ballpark,4,2
2019-07-27,2019,MIN,CWS,1,5,-174,-1.5,-120,11.0,-115,-105,162,1.5,100,6.99,Guaranteed Rate Field,6,-4
2019-07-27,2019,SEA,DET,8,1,-159,-1.5,120,9.0,-120,100,149,1.5,-140,5.53,T-Mobile Park,9,7
2019-07-27,2019,STL,HOU,2,8,180,1.5,100,8.5,100,-120,-200,-1.5,-120,3.04,Busch Stadium,10,-6
2019-07-27,2019,CLE,KC,9,1,-210,-1.5,-135,9.0,-120,100,190,1.5,115,6.1,Kauffman Stadium,10,8
2019-07-27,2019,BAL,LAA,8,7,210,1.5,105,10.0,-120,100,-240,-1.5,-125,3.23,Angel Stadium,15,1
2019-07-27,2019,WSH,LAD,3,9,170,1.5,110,10.0,-120,100,-185,-1.5,-130,3.7,Nationals Park,12,-6
2019-07-27,2019,ARI,MIA,9,2,-117,-1.5,140,8.0,-110,-110,107,1.5,-160,4.31,Marlins Park,11,7
2019-07-27,2019,CHC,MIL,3,5,-103,1.5,-205,9.5,-115,-105,-107,-1.5,180,4.82,Miller Park,8,-2
2019-07-27,2019,CWS,MIN,5,1,162,1.5,100,11.0,-115,-105,-174,-1.5,-120,4.2,Guaranteed Rate Field,6,4
2019-07-27,2019,PIT,NYM,0,3,124,1.5,-160,9.0,-120,100,-134,-1.5,140,4.02,Citi Field,3,-3
2019-07-27,2019,BOS,NYY,9,5,-147,-1.5,120,12.0,100,-120,137,1.5,-140,7.14,Fenway Park,14,4
2019-07-27,2019,TEX,OAK,4,5,165,1.5,-125,9.5,-115,-105,-180,-1.5,105,3.58,Oakland Coliseum,9,-1
2019-07-27,2019,ATL,PHI,15,7,-133,-1.5,115,9.5,-115,-105,123,1.5,-135,5.42,Citizens Bank Park,22,8
2019-07-27,2019,NYM,PIT,3,0,-134,-1.5,140,9.0,-120,100,124,1.5,-160,5.15,Citi Field,3,3
2019-07-27,2019,SF,SD,1,5,127,1.5,-170,8.5,-120,100,-137,-1.5,150,3.74,PETCO Park,6,-4
2019-07-27,2019,DET,SEA,1,8,149,1.5,-140,9.0,-120,100,-159,-1.5,120,3.61,T-Mobile Park,9,-7
2019-07-27,2019,SD,SF,5,1,-137,-1.5,150,8.5,-120,100,127,1.5,-170,4.91,PETCO Park,6,4
2019-07-27,2019,HOU,STL,8,2,-200,-1.5,-120,8.5,100,-120,180,1.5,100,5.67,Busch Stadium,10,6
2019-07-27,2019,TOR,TB,10,9,119,1.5,-140,10.0,100,-120,-129,-1.5,120,4.57,Rogers Centre,19,1
2019-07-27,2019,OAK,TEX,5,4,-180,-1.5,105,9.5,-115,-105,165,1.5,-125,6.11,Oakland Coliseum,9,1
2019-07-27,2019,TB,TOR,9,10,-129,-1.5,120,10.0,100,-120,119,1.5,-140,5.63,Rogers Centre,19,-1
2019-07-27,2019,LAD,WSH,9,3,-185,-1.5,-130,10.0,-120,100,170,1.5,110,6.49,Nationals Park,12,6
2019-07-28,2019,MIA,ARI,5,1,146,1.5,-115,8.0,-105,-115,-156,-1.5,-105,3.25,Marlins Park,6,4
2019-07-28,2019,PHI,ATL,9,4,-139,-1.5,130,9.5,105,-125,129,1.5,-150,5.53,Citizens Bank Park,13,5
2019-07-28,2019,LAA,BAL,5,4,-250,-1.5,-130,10.5,105,-125,220,1.5,110,7.5,Angel Stadium,9,1
2019-07-28,2019,NYY,BOS,9,6,154,1.5,-135,10.0,-120,100,-164,-1.5,115,3.94,Fenway Park,15,3
2019-07-28,2019,MIL,CHC,4,11,-114,-1.5,170,10.0,-115,-105,104,1.5,-190,5.33,Miller Park,15,-7
2019-07-28,2019,COL,CIN,2,3,142,1.5,-145,10.0,-115,-105,-152,-1.5,125,4.13,Great American Ballpark,5,-1
2019-07-28,2019,KC,CLE,9,6,158,1.5,-110,9.0,-125,105,-168,-1.5,-110,3.49,Kauffman Stadium,15,3
2019-07-28,2019,CIN,COL,3,2,-152,-1.5,125,10.0,-115,-105,142,1.5,-145,6.03,Great American Ballpark,5,1
2019-07-28,2019,MIN,CWS,11,1,-205,-1.5,-140,10.5,-120,100,185,1.5,120,7.06,Guaranteed Rate Field,12,10
2019-07-28,2019,SEA,DET,3,2,-115,-1.5,170,8.0,-115,-105,105,1.5,-190,4.28,T-Mobile Park,5,1
2019-07-28,2019,STL,HOU,2,6,122,1.5,-135,9.5,-105,-115,-132,-1.5,115,4.28,Busch Stadium,8,-4
2019-07-28,2019,CLE,KC,6,9,-168,-1.5,-110,9.0,-125,105,158,1.5,-110,5.64,Kauffman Stadium,15,-3
2019-07-28,2019,BAL,LAA,4,5,220,1.5,110,10.5,105,-125,-250,-1.5,-130,3.28,Angel Stadium,9,-1
2019-07-28,2019,WSH,LAD,11,4,104,1.5,-165,8.5,-110,-110,-114,-1.5,145,4.17,Nationals Park,15,7
2019-07-28,2019,ARI,MIA,1,5,-156,-1.5,-105,8.0,-105,-115,146,1.5,-115,4.88,Marlins Park,6,-4
2019-07-28,2019,CHC,MIL,11,4,104,1.5,-190,10.0,-115,-105,-114,-1.5,170,4.9,Miller Park,15,7
2019-07-28,2019,CWS,MIN,1,11,185,1.5,120,10.5,-120,100,-205,-1.5,-140,3.68,Guaranteed Rate Field,12,-10
2019-07-28,2019,PIT,NYM,7,8,122,1.5,-170,9.0,-120,100,-132,-1.5,150,4.05,Citi Field,15,-1
2019-07-28,2019,BOS,NYY,6,9,-164,-1.5,115,10.0,-120,100,154,1.5,-135,6.21,Fenway Park,15,-3
2019-07-28,2019,TEX,OAK,5,6,180,1.5,-110,9.5,-115,-105,-200,-1.5,-110,3.39,Oakland Coliseum,11,-1
2019-07-28,2019,ATL,PHI,4,9,129,1.5,-150,9.5,105,-125,-139,-1.5,130,4.15,Citizens Bank Park,13,-5
2019-07-28,2019,NYM,PIT,8,7,-132,-1.5,150,9.0,-120,100,122,1.5,-170,5.12,Citi Field,15,1
2019-07-28,2019,SF,SD,7,6,108,-1.5,160,8.0,-115,-105,-118,1.5,-180,3.85,PETCO Park,13,1
2019-07-28,2019,DET,SEA,2,3,105,1.5,-190,8.0,-115,-105,-115,-1.5,170,3.9,T-Mobile Park,5,-1
2019-07-28,2019,SD,SF,6,7,-118,1.5,-180,8.0,-115,-105,108,-1.5,160,4.33,PETCO Park,13,-1
2019-07-28,2019,HOU,STL,6,2,-132,-1.5,115,9.5,-105,-115,122,1.5,-135,5.41,Busch Stadium,8,4
2019-07-28,2019,TOR,TB,9,10,142,1.5,-110,10.0,-115,-105,-152,-1.5,-110,4.13,Rogers Centre,19,-1
2019-07-28,2019,OAK,TEX,6,5,-200,-1.5,-110,9.5,-115,-105,180,1.5,-110,6.33,Oakland Coliseum,11,1
2019-07-28,2019,TB,TOR,10,9,-152,-1.5,-110,10.0,-115,-105,142,1.5,-110,6.03,Rogers Centre,19,1
2019-07-28,2019,LAD,WSH,4,11,-114,-1.5,145,8.5,-110,-110,104,1.5,-165,4.53,Nationals Park,15,-7
2019-07-29,2019,MIA,ARI,11,6,-110,-1.5,190,7.5,-115,-105,100,1.5,-215,3.93,Marlins Park,17,5
2019-07-29,2019,WSH,ATL,6,3,-150,-1.5,130,9.5,-105,-115,140,1.5,-150,5.7,Nationals Park,9,3
2019-07-29,2019,SD,BAL,8,1,-285,-1.5,-149,8.5,-120,100,251,1.5,129,6.29,PETCO Park,9,7
2019-07-29,2019,PIT,CIN,6,11,170,1.5,-115,9.5,-115,-105,-185,-1.5,-105,3.52,Great American Ballpark,17,-5
2019-07-29,2019,LAD,COL,1,9,-125,-1.5,110,13.0,-110,-110,115,1.5,-130,7.22,Coors Field,10,-8
2019-07-29,2019,LAA,DET,2,7,-240,-1.5,-130,10.5,-105,-115,210,1.5,110,7.41,Angel Stadium,9,-5
2019-07-29,2019,TOR,KC,7,3,118,1.5,-170,9.5,-115,-105,-128,-1.5,150,4.36,Kauffman Stadium,10,4
2019-07-29,2019,DET,LAA,7,2,210,1.5,110,10.5,-105,-115,-240,-1.5,-130,3.39,Angel Stadium,9,5
2019-07-29,2019,COL,LAD,9,1,115,1.5,-130,13.0,-110,-110,-125,-1.5,110,6.05,Coors Field,10,8
2019-07-29,2019,ARI,MIA,6,11,100,1.5,-215,7.5,-115,-105,-110,-1.5,190,3.75,Marlins Park,17,-5
2019-07-29,2019,CIN,PIT,11,6,-185,-1.5,-105,9.5,-115,-105,170,1.5,-115,6.17,Great American Ballpark,17,5
2019-07-29,2019,BAL,SD,1,8,251,1.5,129,8.5,-120,100,-285,-1.5,-149,2.42,PETCO Park,9,-7
2019-07-29,2019,KC,TOR,3,7,-128,-1.5,150,9.5,-115,-105,118,1.5,-170,5.33,Kauffman Stadium,10,-4
2019-07-29,2019,ATL,WSH,3,6,140,1.5,-150,9.5,-105,-115,-150,-1.5,130,3.96,Nationals Park,9,-3
2019-07-30,2019,NYY,ARI,2,4,-240,-1.5,-135,11.5,-105,-115,210,1.5,115,8.12,Yankee Stadium,6,-2
2019-07-30,2019,WSH,ATL,8,11,-105,-1.5,165,10.5,-120,100,-105,1.5,-185,5.38,Nationals Park,19,-3
2019-07-30,2019,SD,BAL,5,8,-240,-1.5,-125,9.0,-115,-105,210,1.5,105,6.35,PETCO Park,13,-3
2019-07-30,2019,TB,BOS,6,5,127,1.5,-155,9.5,-110,-110,-137,-1.5,135,4.19,Fenway Park,11,1
2019-07-30,2019,STL,CHC,2,1,115,1.5,-155,8.5,-120,100,-125,-1.5,135,3.95,Busch Stadium,3,1
2019-07-30,2019,PIT,CIN,11,4,120,1.5,-165,9.5,-115,-105,-130,-1.5,145,4.32,Great American Ballpark,15,7
2019-07-30,2019,HOU,CLE,2,0,-138,-1.5,115,9.0,100,-120,128,1.5,-135,5.22,Progressive Field,2,2
2019-07-30,2019,LAD,COL,9,4,-145,-1.5,-105,13.5,-120,100,135,1.5,-115,7.99,Coors Field,13,5
2019-07-30,2019,NYM,CWS,5,2,-145,-1.5,100,9.0,-115,-105,135,1.5,-120,5.33,Guaranteed Rate Field,7,3
2019-07-30,2019,LAA,DET,6,1,-290,-1.5,-160,9.5,-115,-105,250,1.5,140,7.06,Angel Stadium,7,5
2019-07-30,2019,CLE,HOU,0,2,128,1.5,-135,9.0,100,-120,-138,-1.5,115,3.95,Progressive Field,2,-2
2019-07-30,2019,TOR,KC,9,2,-108,1.5,-205,10.0,-110,-110,-102,-1.5,180,5.19,Kauffman Stadium,11,7
2019-07-30,2019,DET,LAA,1,6,250,1.5,140,9.5,-115,-105,-290,-1.5,-160,2.71,Angel Stadium,7,-5
2019-07-30,2019,COL,LAD,4,9,135,1.5,-115,13.5,-120,100,-145,-1.5,-105,5.74,Coors Field,13,-5
2019-07-30,2019,MIN,MIA,2,1,-143,-1.5,105,8.0,-120,100,133,1.5,-125,4.71,Marlins Park,3,1
2019-07-30,2019,OAK,MIL,3,2,-115,-1.5,165,9.0,-120,100,105,1.5,-185,4.81,Oakland Coliseum,5,1
2019-07-30,2019,MIA,MIN,1,2,133,1.5,-125,8.0,-120,100,-143,-1.5,105,3.43,Marlins Park,3,-1
2019-07-30,2019,CWS,NYM,2,5,135,1.5,-120,9.0,-115,-105,-145,-1.5,100,3.83,Guaranteed Rate Field,7,-3
2019-07-30,2019,ARI,NYY,4,2,210,1.5,115,11.5,-105,-115,-240,-1.5,-135,3.71,Yankee Stadium,6,2
2019-07-30,2019,MIL,OAK,2,3,105,1.5,-185,9.0,-120,100,-115,-1.5,165,4.39,Oakland Coliseum,5,-1
2019-07-30,2019,SF,PHI,2,4,120,1.5,-165,10.5,-105,-115,-130,-1.5,145,4.77,Citizens Bank Park,6,-2
2019-07-30,2019,CIN,PIT,4,11,-130,-1.5,145,9.5,-115,-105,120,1.5,-165,5.37,Great American Ballpark,15,-7
2019-07-30,2019,BAL,SD,8,5,210,1.5,105,9.0,-115,-105,-240,-1.5,-125,2.9,PETCO Park,13,3
2019-07-30,2019,TEX,SEA,5,8,-122,-1.5,140,11.5,100,-120,112,1.5,-160,6.32,Rangers Ballpark,13,-3
2019-07-30,2019,PHI,SF,4,2,-130,-1.5,145,10.5,-105,-115,120,1.5,-165,5.93,Citizens Bank Park,6,2
2019-07-30,2019,CHC,STL,1,2,-125,-1.5,135,8.5,-120,100,115,1.5,-155,4.72,Busch Stadium,3,-1
2019-07-30,2019,BOS,TB,5,6,-137,-1.5,135,9.5,-110,-110,127,1.5,-155,5.49,Fenway Park,11,-1
2019-07-30,2019,SEA,TEX,8,5,112,1.5,-160,11.5,100,-120,-122,-1.5,140,5.42,Rangers Ballpark,13,3
2019-07-30,2019,KC,TOR,2,9,-102,-1.5,180,10.0,-110,-110,-108,1.5,-205,5.05,Kauffman Stadium,11,-7
2019-07-30,2019,ATL,WSH,11,8,-105,1.5,-185,10.5,-120,100,-105,-1.5,165,5.38,Nationals Park,19,3
2019-07-31,2019,NYY,ARI,7,5,-130,-1.5,150,9.0,-112,-107,120,1.5,-170,5.09,Yankee Stadium,12,2
2019-07-31,2019,WSH,ATL,4,5,120,1.5,-145,9.5,-101,-119,-130,-1.5,125,4.32,Nationals Park,9,-1
2019-07-31,2019,TB,BOS,8,5,121,1.5,-160,11.0,-111,-109,-131,-1.5,140,4.98,Fenway Park,13,3
2019-07-31,2019,STL,CHC,0,2,-102,1.5,-155,8.5,100,-120,-108,-1.5,135,4.29,Busch Stadium,2,-2
2019-07-31,2019,PIT,CIN,1,4,175,1.5,-120,9.5,-110,-110,-190,-1.5,100,3.45,Great American Ballpark,5,-3
2019-07-31,2019,HOU,CLE,4,10,-147,-1.5,100,10.0,-105,-115,137,1.5,-120,5.95,Progressive Field,14,-6
2019-07-31,2019,LAD,COL,5,1,-140,-1.5,-110,12.0,-115,-105,130,1.5,-110,7.0,Coors Field,6,4
2019-07-31,2019,NYM,CWS,4,2,-196,-1.5,-125,8.0,-120,100,178,1.5,105,5.3,Guaranteed Rate Field,6,2
2019-07-31,2019,LAA,DET,1,9,-190,-1.5,-105,9.5,-103,-117,175,1.5,-115,6.22,Angel Stadium,10,-8
2019-07-31,2019,CLE,HOU,10,4,137,1.5,-120,10.0,-105,-115,-147,-1.5,100,4.22,Progressive Field,14,6
2019-07-31,2019,TOR,KC,4,1,123,1.5,-170,9.5,-102,-118,-133,-1.5,150,4.26,Kauffman Stadium,5,3
2019-07-31,2019,DET,LAA,9,1,175,1.5,-115,9.5,-103,-117,-190,-1.5,-105,3.45,Angel Stadium,10,8
2019-07-31,2019,COL,LAD,1,5,130,1.5,-110,12.0,-115,-105,-140,-1.5,-110,5.22,Coors Field,6,-4
2019-07-31,2019,MIN,MIA,7,4,-185,-1.5,-130,8.0,-113,-107,170,1.5,110,5.19,Marlins Park,11,3
2019-07-31,2019,OAK,MIL,2,4,-118,-1.5,165,9.5,101,-121,108,1.5,-185,5.14,Oakland Coliseum,6,-2
2019-07-31,2019,MIA,MIN,4,7,170,1.5,110,8.0,-113,-107,-185,-1.5,-130,2.96,Marlins Park,11,-3
2019-07-31,2019,CWS,NYM,2,4,178,1.5,105,8.0,-120,100,-196,-1.5,-125,2.88,Guaranteed Rate Field,6,-2
2019-07-31,2019,ARI,NYY,5,7,120,1.5,-170,9.0,-112,-107,-130,-1.5,150,4.09,Yankee Stadium,12,-2
2019-07-31,2019,MIL,OAK,4,2,108,1.5,-185,9.5,101,-121,-118,-1.5,165,4.57,Oakland Coliseum,6,2
2019-07-31,2019,SF,PHI,5,1,118,1.5,-170,9.5,-110,-110,-128,-1.5,150,4.36,Citizens Bank Park,6,4
2019-07-31,2019,CIN,PIT,4,1,-190,-1.5,100,9.5,-110,-110,175,1.5,-120,6.22,Great American Ballpark,5,3
2019-07-31,2019,TEX,SEA,9,7,-155,-1.5,110,10.5,-115,-105,145,1.5,-130,6.38,Rangers Ballpark,16,2
2019-07-31,2019,PHI,SF,1,5,-128,-1.5,150,9.5,-110,-110,118,1.5,-170,5.33,Citizens Bank Park,6,-4
2019-07-31,2019,CHC,STL,2,0,-108,-1.5,135,8.5,100,-120,-102,1.5,-155,4.41,Busch Stadium,2,2
2019-07-31,2019,BOS,TB,5,8,-131,-1.5,140,11.0,-111,-109,121,1.5,-160,6.24,Fenway Park,13,-3
2019-07-31,2019,SEA,TEX,7,9,145,1.5,-130,10.5,-115,-105,-155,-1.5,110,4.29,Rangers Ballpark,16,-2
2019-07-31,2019,KC,TOR,1,4,-133,-1.5,150,9.5,-102,-118,123,1.5,-170,5.42,Kauffman Stadium,5,-3
2019-07-31,2019,ATL,WSH,5,4,-130,-1.5,125,9.5,-101,-119,120,1.5,-145,5.37,Nationals Park,9,1
2019-08-01,2019,CIN,ATL,1,4,155,1.5,-145,9.0,-105,-115,-165,-1.5,125,3.53,Suntrust Park,5,-3
2019-08-01,2019,TOR,BAL,11,2,-103,-1.5,140,10.5,100,-120,-107,1.5,-160,5.33,Camden Yards,13,9
2019-08-01,2019,TB,BOS,9,4,106,1.5,-170,11.0,-110,-110,-116,-1.5,150,5.34,Fenway Park,13,5
2019-08-01,2019,STL,CHC,8,0,-115,-1.5,170,8.5,100,-120,105,1.5,-190,4.55,Busch Stadium,8,8
2019-08-01,2019,ATL,CIN,4,1,-165,-1.5,125,9.0,-105,-115,155,1.5,-145,5.6,Suntrust Park,5,3
2019-08-01,2019,HOU,CLE,7,1,-190,-1.5,-135,8.5,-125,105,175,1.5,115,5.57,Progressive Field,8,6
2019-08-01,2019,NYM,CWS,4,0,-194,-1.5,-135,10.0,-110,-110,177,1.5,115,6.6,Guaranteed Rate Field,4,4
2019-08-01,2019,CLE,HOU,1,7,175,1.5,115,8.5,-125,105,-190,-1.5,-135,3.09,Progressive Field,8,-6
2019-08-01,2019,SD,LAD,2,8,180,1.5,-120,8.0,-105,-115,-200,-1.5,100,2.86,Dodger Stadium,10,-6
2019-08-01,2019,MIN,MIA,4,5,-164,-1.5,-105,7.5,-115,-105,154,1.5,-115,4.66,Marlins Park,9,-1
2019-08-01,2019,OAK,MIL,5,3,-108,-1.5,170,9.5,100,-120,-102,1.5,-190,4.93,Oakland Coliseum,8,2
2019-08-01,2019,MIA,MIN,5,4,154,1.5,-115,7.5,-115,-105,-164,-1.5,-105,2.95,Marlins Park,9,1
2019-08-01,2019,CWS,NYM,0,4,177,1.5,115,10.0,-110,-110,-194,-1.5,-135,3.61,Guaranteed Rate Field,4,-4
2019-08-01,2019,MIL,OAK,3,5,-102,1.5,-190,9.5,100,-120,-108,-1.5,170,4.8,Oakland Coliseum,8,-2
2019-08-01,2019,SF,PHI,2,10,150,1.5,-135,10.5,-111,-109,-160,-1.5,115,4.2,Citizens Bank Park,12,-8
2019-08-01,2019,LAD,SD,8,2,-200,-1.5,100,8.0,-105,-115,180,1.5,-120,5.33,Dodger Stadium,10,6
2019-08-01,2019,PHI,SF,10,2,-160,-1.5,115,10.5,-111,-109,150,1.5,-135,6.46,Citizens Bank Park,12,8
2019-08-01,2019,CHC,STL,0,8,105,1.5,-190,8.5,100,-120,-115,-1.5,170,4.15,Busch Stadium,8,-8
2019-08-01,2019,BOS,TB,4,9,-116,-1.5,150,11.0,-110,-110,106,1.5,-170,5.91,Fenway Park,13,-5
2019-08-01,2019,BAL,TOR,2,11,-107,1.5,-160,10.5,100,-120,-103,-1.5,140,5.43,Camden Yards,13,-9
2019-08-02,2019,WSH,ARI,3,0,106,1.5,-175,10.0,-112,-108,-116,-1.5,155,4.85,Chase Field,3,3
2019-08-02,2019,CIN,ATL,5,2,155,1.5,-140,9.5,-110,-110,-165,-1.5,120,3.73,Suntrust Park,7,3
2019-08-02,2019,TOR,BAL,5,2,-128,-1.5,110,10.5,-115,-105,118,1.5,-130,5.89,Camden Yards,7,3
2019-08-02,2019,NYY,BOS,4,2,-130,-1.5,145,10.0,-116,-103,120,1.5,-165,5.65,Yankee Stadium,6,2
2019-08-02,2019,MIL,CHC,2,6,133,1.5,-165,9.0,-101,-119,-143,-1.5,145,3.86,Wrigley Field,8,-4
2019-08-02,2019,ATL,CIN,2,5,-165,-1.5,120,9.5,-110,-110,155,1.5,-140,5.92,Suntrust Park,7,-3
2019-08-02,2019,LAA,CLE,3,7,200,1.5,105,9.5,-103,-117,-220,-1.5,-125,3.17,Progressive Field,10,-4
2019-08-02,2019,SF,COL,4,5,130,1.5,-140,13.5,-120,100,-140,-1.5,120,5.87,Coors Field,9,-1
2019-08-02,2019,PHI,CWS,3,4,-180,-1.5,-105,10.0,100,-120,165,1.5,-115,6.43,Citizens Bank Park,7,-1
2019-08-02,2019,TEX,DET,5,4,-240,-1.5,-135,9.5,-105,-115,210,1.5,115,6.71,Rangers Ballpark,9,1
2019-08-02,2019,SEA,HOU,2,10,260,1.5,140,10.0,-105,-115,-300,-1.5,-160,2.78,Minute Maid Park,12,-8
2019-08-02,2019,MIN,KC,11,9,-220,-1.5,-135,11.0,-110,-110,200,1.5,115,7.56,Target Field,20,2
2019-08-02,2019,CLE,LAA,7,3,-220,-1.5,-125,9.5,-103,-117,200,1.5,105,6.53,Progressive Field,10,4
2019-08-02,2019,SD,LAD,5,2,150,1.5,-135,9.0,-110,-110,-160,-1.5,115,3.6,Dodger Stadium,7,3
2019-08-02,2019,CHC,MIL,6,2,-143,-1.5,145,9.0,-101,-119,133,1.5,-165,5.3,Wrigley Field,8,4
2019-08-02,2019,KC,MIN,9,11,200,1.5,115,11.0,-110,-110,-220,-1.5,-135,3.67,Target Field,20,-2
2019-08-02,2019,PIT,NYM,8,4,110,1.5,-145,9.5,-105,-115,-120,-1.5,125,4.52,PNC Park,12,4
2019-08-02,2019,BOS,NYY,2,4,120,1.5,-165,10.0,-116,-103,-130,-1.5,145,4.55,Yankee Stadium,6,-2
2019-08-02,2019,CWS,PHI,4,3,165,1.5,-115,10.0,100,-120,-180,-1.5,-105,3.77,Citizens Bank Park,7,1
2019-08-02,2019,NYM,PIT,4,8,-120,-1.5,125,9.5,-105,-115,110,1.5,-145,5.18,PNC Park,12,-4
2019-08-02,2019,LAD,SD,2,5,-160,-1.5,115,9.0,-110,-110,150,1.5,-135,5.54,Dodger Stadium,7,-3
2019-08-02,2019,HOU,SEA,10,2,-300,-1.5,-160,10.0,-105,-115,260,1.5,140,7.5,Minute Maid Park,12,8
2019-08-02,2019,COL,SF,5,4,-140,-1.5,120,13.5,-120,100,130,1.5,-140,7.88,Coors Field,9,1
2019-08-02,2019,DET,TEX,4,5,210,1.5,115,9.5,-105,-115,-240,-1.5,-135,3.06,Rangers Ballpark,9,-1
2019-08-02,2019,BAL,TOR,2,5,118,1.5,-130,10.5,-115,-105,-128,-1.5,110,4.82,Camden Yards,7,-3
2019-08-02,2019,ARI,WSH,0,3,-116,-1.5,155,10.0,-112,-108,106,1.5,-175,5.37,Chase Field,3,-3
2019-08-03,2019,WSH,ARI,7,18,-128,-1.5,130,8.0,-105,-115,118,1.5,-150,4.49,Chase Field,25,-11
2019-08-03,2019,CIN,ATL,4,5,126,1.5,-170,8.5,-115,-105,-136,-1.5,150,3.76,Suntrust Park,9,-1
2019-08-03,2019,TOR,BAL,4,6,-110,-1.5,130,10.5,-108,-112,100,1.5,-150,5.5,Camden Yards,10,-2
2019-08-03,2019,NYY,BOS,9,2,114,1.5,-150,9.0,-115,-105,-124,-1.5,130,4.21,Yankee Stadium,11,7
2019-08-03,2019,NYY,BOS,6,4,-139,-1.5,130,11.0,-103,-117,129,1.5,-150,6.4,Yankee Stadium,10,2
2019-08-03,2019,MIL,CHC,1,4,130,1.5,-160,9.5,-106,-114,-140,-1.5,140,4.13,Wrigley Field,5,-3
2019-08-03,2019,ATL,CIN,5,4,-136,-1.5,150,8.5,-115,-105,126,1.5,-170,4.9,Suntrust Park,9,1
2019-08-03,2019,LAA,CLE,2,7,110,1.5,-170,11.0,-105,-115,-120,-1.5,150,5.24,Progressive Field,9,-5
2019-08-03,2019,SF,COL,6,5,112,1.5,-160,11.0,-119,-101,-122,-1.5,140,5.19,Coors Field,11,1
2019-08-03,2019,PHI,CWS,3,2,-300,-1.5,-160,9.0,-115,-105,260,1.5,140,6.75,Citizens Bank Park,5,1
2019-08-03,2019,TEX,DET,5,4,-107,-1.5,175,9.5,100,-120,-103,1.5,-200,4.91,Rangers Ballpark,9,1
2019-08-03,2019,SEA,HOU,0,9,195,1.5,100,10.5,-101,-119,-215,-1.5,-120,3.56,Minute Maid Park,9,-9
2019-08-03,2019,MIN,KC,11,3,-230,-1.5,-130,10.5,-110,-110,205,1.5,110,7.32,Target Field,14,8
2019-08-03,2019,CLE,LAA,7,2,-120,-1.5,150,11.0,-105,-115,110,1.5,-170,6.0,Progressive Field,9,5
2019-08-03,2019,SD,LAD,1,4,230,1.5,105,8.5,-117,-103,-260,-1.5,-125,2.58,Dodger Stadium,5,-3
2019-08-03,2019,TB,MIA,8,6,-220,-1.5,-115,8.5,-119,-102,200,1.5,-105,5.84,Tropicana Field,14,2
2019-08-03,2019,CHC,MIL,4,1,-140,-1.5,140,9.5,-106,-114,130,1.5,-160,5.54,Wrigley Field,5,3
2019-08-03,2019,KC,MIN,3,11,205,1.5,110,10.5,-110,-110,-230,-1.5,-130,3.44,Target Field,14,-8
2019-08-03,2019,PIT,NYM,5,7,122,1.5,-140,9.0,-110,-110,-132,-1.5,120,4.05,PNC Park,12,-2
2019-08-03,2019,BOS,NYY,2,9,-124,-1.5,130,9.0,-115,-105,114,1.5,-150,4.98,Yankee Stadium,11,-7
2019-08-03,2019,BOS,NYY,4,6,129,1.5,-150,11.0,-103,-117,-139,-1.5,130,4.8,Yankee Stadium,10,-2
2019-08-03,2019,STL,OAK,3,8,145,1.5,-145,9.5,-105,-115,-155,-1.5,125,3.88,Oakland Coliseum,11,-5
2019-08-03,2019,CWS,PHI,2,3,260,1.5,140,9.0,-115,-105,-300,-1.5,-160,2.5,Citizens Bank Park,5,-1
2019-08-03,2019,NYM,PIT,7,5,-132,-1.5,120,9.0,-110,-110,122,1.5,-140,5.12,PNC Park,12,2
2019-08-03,2019,LAD,SD,4,1,-260,-1.5,-125,8.5,-117,-103,230,1.5,105,6.14,Dodger Stadium,5,3
2019-08-03,2019,HOU,SEA,9,0,-215,-1.5,-120,10.5,-101,-119,195,1.5,100,7.17,Minute Maid Park,9,9
2019-08-03,2019,COL,SF,5,6,-122,-1.5,140,11.0,-119,-101,112,1.5,-160,6.05,Coors Field,11,-1
2019-08-03,2019,OAK,STL,8,3,-155,-1.5,125,9.5,-105,-115,145,1.5,-145,5.77,Oakland Coliseum,11,5
2019-08-03,2019,MIA,TB,6,8,200,1.5,-105,8.5,-119,-102,-220,-1.5,-115,2.83,Tropicana Field,14,-2
2019-08-03,2019,DET,TEX,4,5,-103,1.5,-200,9.5,100,-120,-107,-1.5,175,4.82,Rangers Ballpark,9,-1
2019-08-03,2019,BAL,TOR,6,4,100,1.5,-150,10.5,-108,-112,-110,-1.5,130,5.25,Camden Yards,10,2
2019-08-03,2019,ARI,WSH,18,7,118,1.5,-150,8.0,-105,-115,-128,-1.5,130,3.67,Chase Field,25,11
2019-08-04,2019,WSH,ARI,5,7,-160,-1.5,-105,9.5,-109,-111,145,1.5,-115,5.85,Chase Field,12,-2
2019-08-04,2019,CIN,ATL,6,4,110,1.5,-190,9.0,-105,-115,-121,-1.5,163,4.29,Suntrust Park,10,2
2019-08-04,2019,TOR,BAL,5,6,-151,-1.5,-110,11.0,-110,-110,136,1.5,-110,6.62,Camden Yards,11,-1
2019-08-04,2019,NYY,BOS,7,4,123,1.5,-130,10.0,-116,-104,-136,-1.5,110,4.48,Yankee Stadium,11,3
2019-08-04,2019,MIL,CHC,2,7,117,1.5,-188,8.5,-103,-118,-129,-1.5,161,3.92,Wrigley Field,9,-5
2019-08-04,2019,ATL,CIN,4,6,-121,-1.5,163,9.0,-105,-115,110,1.5,-190,4.93,Suntrust Park,10,-2
2019-08-04,2019,LAA,CLE,2,6,210,1.5,105,9.5,-101,-119,-236,-1.5,-125,3.06,Progressive Field,8,-4
2019-08-04,2019,SF,COL,2,6,121,1.5,-149,13.0,-115,-105,-134,-1.5,128,5.88,Coors Field,8,-4
2019-08-04,2019,PHI,CWS,5,10,-160,-1.5,120,9.0,-115,-105,144,1.5,-140,5.54,Citizens Bank Park,15,-5
2019-08-04,2019,TEX,DET,9,4,-200,-1.5,-115,11.0,-112,-108,179,1.5,-105,7.33,Rangers Ballpark,13,5
2019-08-04,2019,SEA,HOU,1,3,360,1.5,180,9.0,-110,-110,-420,-1.5,-215,1.96,Minute Maid Park,4,-2
2019-08-04,2019,MIN,KC,3,0,-190,-1.5,-105,10.5,-110,-110,170,1.5,-115,6.88,Target Field,3,3
2019-08-04,2019,CLE,LAA,6,2,-236,-1.5,-125,9.5,-101,-119,210,1.5,105,6.67,Progressive Field,8,4
2019-08-04,2019,SD,LAD,10,11,135,1.5,-165,8.5,-108,-112,-150,-1.5,144,3.62,Dodger Stadium,21,-1
2019-08-04,2019,TB,MIA,7,2,-190,-1.5,100,8.0,-103,-116,170,1.5,-120,5.24,Tropicana Field,9,5
2019-08-04,2019,CHC,MIL,7,2,-129,-1.5,161,8.5,-103,-118,117,1.5,-188,4.79,Wrigley Field,9,5
2019-08-04,2019,KC,MIN,0,3,170,1.5,-115,10.5,-110,-110,-190,-1.5,-105,3.89,Target Field,3,-3
2019-08-04,2019,PIT,NYM,2,13,108,1.5,-154,8.5,100,-120,-118,-1.5,134,4.09,PNC Park,15,-11
2019-08-04,2019,BOS,NYY,4,7,-136,-1.5,110,10.0,-116,-104,123,1.5,-130,5.76,Yankee Stadium,11,-3
2019-08-04,2019,STL,OAK,2,4,123,1.5,-170,9.5,-105,-115,-136,-1.5,148,4.26,Oakland Coliseum,6,-2
2019-08-04,2019,CWS,PHI,10,5,144,1.5,-140,9.0,-115,-105,-160,-1.5,120,3.69,Citizens Bank Park,15,5
2019-08-04,2019,NYM,PIT,13,2,-118,-1.5,134,8.5,100,-120,108,1.5,-154,4.6,PNC Park,15,11
2019-08-04,2019,LAD,SD,11,10,-150,-1.5,144,8.5,-108,-112,135,1.5,-165,5.1,Dodger Stadium,21,1
2019-08-04,2019,HOU,SEA,3,1,-420,-1.5,-215,9.0,-110,-110,360,1.5,180,7.27,Minute Maid Park,4,2
2019-08-04,2019,COL,SF,6,2,-134,-1.5,128,13.0,-115,-105,121,1.5,-149,7.44,Coors Field,8,4
2019-08-04,2019,OAK,STL,4,2,-136,-1.5,148,9.5,-105,-115,123,1.5,-170,5.47,Oakland Coliseum,6,2
2019-08-04,2019,MIA,TB,2,7,170,1.5,-120,8.0,-103,-116,-190,-1.5,100,2.96,Tropicana Field,9,-5
2019-08-04,2019,DET,TEX,4,9,179,1.5,-105,11.0,-112,-108,-200,-1.5,-115,3.94,Rangers Ballpark,13,-5
2019-08-04,2019,BAL,TOR,6,5,136,1.5,-110,11.0,-110,-110,-151,-1.5,-110,4.66,Camden Yards,11,1
2019-08-04,2019,ARI,WSH,7,5,145,1.5,-115,9.5,-109,-111,-160,-1.5,-105,3.88,Chase Field,12,2
2019-08-05,2019,PHI,ARI,7,3,-105,1.5,-205,9.5,-110,-110,-105,-1.5,180,4.87,Chase Field,10,4
2019-08-05,2019,MIN,ATL,5,3,-108,1.5,-160,10.0,-101,-119,-102,-1.5,140,5.19,Target Field,8,2
2019-08-05,2019,NYY,BAL,9,6,-250,-1.5,-170,10.5,-119,-101,220,1.5,150,7.5,Camden Yards,15,3
2019-08-05,2019,KC,BOS,5,7,205,1.5,-105,11.0,-120,100,-230,-1.5,-115,3.61,Fenway Park,12,-2
2019-08-05,2019,OAK,CHC,5,6,145,1.5,-140,10.5,-120,100,-155,-1.5,120,4.29,Wrigley Field,11,-1
2019-08-05,2019,LAA,CIN,4,7,175,1.5,-115,9.5,-105,-115,-190,-1.5,-105,3.45,Great American Ballpark,11,-3
2019-08-05,2019,TEX,CLE,1,0,150,1.5,-135,9.5,-115,-104,-160,-1.5,115,3.8,Progressive Field,1,1
2019-08-05,2019,DET,CWS,4,7,118,1.5,-140,8.5,-122,101,-128,-1.5,120,3.9,Comerica Park,11,-3
2019-08-05,2019,CWS,DET,7,4,-128,-1.5,120,8.5,-122,101,118,1.5,-140,4.77,Comerica Park,11,3
2019-08-05,2019,BOS,KC,7,5,-230,-1.5,-115,11.0,-120,100,205,1.5,-105,7.67,Fenway Park,12,2
2019-08-05,2019,CIN,LAA,7,4,-190,-1.5,-105,9.5,-105,-115,175,1.5,-115,6.22,Great American Ballpark,11,3
2019-08-05,2019,STL,LAD,0,8,138,1.5,-145,9.5,-121,102,-148,-1.5,125,3.99,Dodger Stadium,8,-8
2019-08-05,2019,NYM,MIA,6,2,-360,-1.5,-180,8.0,-111,-108,165,1.5,-125,6.26,Citi Field,8,4
2019-08-05,2019,NYM,MIA,5,4,-180,-1.5,105,9.0,-112,-109,310,1.5,160,5.79,Citi Field,9,1
2019-08-05,2019,PIT,MIL,7,9,137,1.5,-125,10.0,-110,-110,-147,-1.5,105,4.22,PNC Park,16,-2
2019-08-05,2019,ATL,MIN,3,5,-102,-1.5,140,10.0,-101,-119,-108,1.5,-160,5.05,Target Field,8,-2
2019-08-05,2019,MIA,NYM,2,6,165,1.5,-125,9.0,-111,-108,-360,-1.5,-180,3.4,Citi Field,8,-4
2019-08-05,2019,MIA,NYM,4,5,310,1.5,160,8.0,-112,-109,-180,-1.5,105,1.95,Citi Field,9,-1
2019-08-05,2019,BAL,NYY,6,9,220,1.5,150,10.5,-119,-101,-250,-1.5,-170,3.28,Camden Yards,15,-3
2019-08-05,2019,CHC,OAK,6,5,-155,-1.5,120,10.5,-120,100,145,1.5,-140,6.38,Wrigley Field,11,1
2019-08-05,2019,ARI,PHI,3,7,-105,-1.5,180,9.5,-110,-110,-105,1.5,-205,4.87,Chase Field,10,-4
2019-08-05,2019,MIL,PIT,9,7,-147,-1.5,105,10.0,-110,-110,137,1.5,-125,5.95,PNC Park,16,2
2019-08-05,2019,WSH,SF,4,0,122,1.5,-170,8.5,-105,-115,-132,-1.5,150,3.83,AT&T Park,4,4
2019-08-05,2019,LAD,STL,8,0,-148,-1.5,125,9.5,-121,102,138,1.5,-145,5.67,Dodger Stadium,8,8
2019-08-05,2019,TOR,TB,2,0,250,1.5,120,8.0,-115,-105,-290,-1.5,-140,2.29,Tropicana Field,2,2
2019-08-05,2019,CLE,TEX,0,1,-160,-1.5,115,9.5,-115,-104,150,1.5,-135,5.85,Progressive Field,1,-1
2019-08-05,2019,TB,TOR,0,2,-290,-1.5,-140,8.0,-115,-105,250,1.5,120,5.95,Tropicana Field,2,-2
2019-08-05,2019,SF,WSH,0,4,-132,-1.5,150,8.5,-105,-115,122,1.5,-170,4.84,AT&T Park,4,-4
2019-08-06,2019,PHI,ARI,4,8,118,1.5,-170,9.5,-124,103,-128,-1.5,150,4.36,Chase Field,12,-4
2019-08-06,2019,MIN,ATL,7,12,-154,-1.5,110,10.5,-105,-115,144,1.5,-130,6.37,Target Field,19,-5
2019-08-06,2019,NYY,BAL,9,4,-196,-1.5,-140,11.0,-105,-115,178,1.5,120,7.28,Camden Yards,13,5
2019-08-06,2019,KC,BOS,6,2,175,1.5,-110,11.0,-108,-112,-190,-1.5,-110,4.0,Fenway Park,8,4
2019-08-06,2019,OAK,CHC,11,4,130,1.5,-160,9.5,-109,-112,-140,-1.5,140,4.13,Wrigley Field,15,7
2019-08-06,2019,LAA,CIN,4,8,120,1.5,-165,9.5,-113,-107,-130,-1.5,145,4.32,Great American Ballpark,12,-4
2019-08-06,2019,HOU,COL,11,6,-215,-1.5,-115,8.5,-107,-113,195,1.5,-105,5.8,Minute Maid Park,17,5
2019-08-06,2019,DET,CWS,3,5,-105,-1.5,190,9.0,-105,-115,-105,1.5,-215,4.61,Comerica Park,8,-2
2019-08-06,2019,DET,CWS,10,6,-115,-1.5,170,10.0,-111,-109,105,1.5,-190,5.35,Comerica Park,16,4
2019-08-06,2019,CWS,DET,5,3,-105,1.5,-215,9.0,-105,-115,-105,-1.5,190,4.61,Comerica Park,8,2
2019-08-06,2019,CWS,DET,6,10,105,1.5,-190,10.0,-111,-109,-115,-1.5,170,4.88,Comerica Park,16,-4
2019-08-06,2019,COL,HOU,6,11,195,1.5,-105,8.5,-107,-113,-215,-1.5,-115,2.88,Minute Maid Park,17,-5
2019-08-06,2019,BOS,KC,2,6,-190,-1.5,-110,11.0,-108,-112,175,1.5,-110,7.21,Fenway Park,8,-4
2019-08-06,2019,CIN,LAA,8,4,-130,-1.5,145,9.5,-113,-107,120,1.5,-165,5.37,Great American Ballpark,12,4
2019-08-06,2019,STL,LAD,1,3,180,1.5,-110,8.0,-112,-107,-200,-1.5,-110,2.86,Dodger Stadium,4,-2
2019-08-06,2019,NYM,MIA,5,0,-255,-1.5,-130,8.0,-115,-105,225,1.5,110,5.75,Citi Field,5,5
2019-08-06,2019,PIT,MIL,3,4,135,1.5,-125,9.5,-105,-115,-145,-1.5,105,4.04,PNC Park,7,-1
2019-08-06,2019,ATL,MIN,12,7,144,1.5,-130,10.5,-105,-115,-154,-1.5,110,4.3,Target Field,19,5
2019-08-06,2019,MIA,NYM,0,5,225,1.5,110,8.0,-115,-105,-255,-1.5,-130,2.46,Citi Field,5,-5
2019-08-06,2019,BAL,NYY,4,9,178,1.5,120,11.0,-105,-115,-196,-1.5,-140,3.96,Camden Yards,13,-5
2019-08-06,2019,CHC,OAK,4,11,-140,-1.5,140,9.5,-109,-112,130,1.5,-160,5.54,Wrigley Field,15,-7
2019-08-06,2019,ARI,PHI,8,4,-128,-1.5,150,9.5,-124,103,118,1.5,-170,5.33,Chase Field,12,4
2019-08-06,2019,MIL,PIT,4,3,-145,-1.5,105,9.5,-105,-115,135,1.5,-125,5.62,PNC Park,7,1
2019-08-06,2019,SEA,SD,4,9,115,1.5,-145,9.5,-105,-115,-125,-1.5,125,4.42,T-Mobile Park,13,-5
2019-08-06,2019,SD,SEA,9,4,-125,-1.5,125,9.5,-105,-115,115,1.5,-145,5.28,T-Mobile Park,13,5
2019-08-06,2019,WSH,SF,5,3,-111,-1.5,145,8.5,-115,-105,101,1.5,-165,4.47,AT&T Park,8,2
2019-08-06,2019,LAD,STL,3,1,-200,-1.5,-110,8.0,-112,-107,180,1.5,-110,5.33,Dodger Stadium,4,2
2019-08-06,2019,TOR,TB,6,7,180,1.5,-110,8.5,-110,-110,-200,-1.5,-110,3.04,Tropicana Field,13,-1
2019-08-06,2019,TB,TOR,7,6,-200,-1.5,-110,8.5,-110,-110,180,1.5,-110,5.67,Tropicana Field,13,1
2019-08-06,2019,SF,WSH,3,5,101,1.5,-165,8.5,-115,-105,-111,-1.5,145,4.23,AT&T Park,8,-2
2019-08-07,2019,PHI,ARI,1,6,128,1.5,-165,9.0,-125,105,-142,-1.5,144,3.95,Chase Field,7,-5
2019-08-07,2019,MIN,ATL,7,11,105,1.5,-160,11.0,101,-120,-115,-1.5,140,5.37,Target Field,18,-4
2019-08-07,2019,NYY,BAL,14,2,-260,-1.5,-165,9.5,-103,-117,230,1.5,145,6.86,Camden Yards,16,12
2019-08-07,2019,KC,BOS,4,5,-120,-1.5,130,10.0,-110,-110,120,1.5,-160,5.45,Fenway Park,9,-1
2019-08-07,2019,OAK,CHC,1,10,127,1.5,-150,10.5,-110,-110,-137,-1.5,130,4.63,Wrigley Field,11,-9
2019-08-07,2019,TEX,CLE,0,2,175,1.5,-110,10.0,-119,-101,-190,-1.5,-110,3.64,Progressive Field,2,-2
2019-08-07,2019,TEX,CLE,1,5,-107,-1.5,140,10.0,100,-120,-103,1.5,-160,5.17,Progressive Field,6,-4
2019-08-07,2019,HOU,COL,14,3,-360,-1.5,-180,9.0,105,-126,310,1.5,160,7.04,Minute Maid Park,17,11
2019-08-07,2019,DET,CWS,1,8,-101,1.5,-160,9.0,-119,-101,-109,-1.5,140,4.52,Comerica Park,9,-7
2019-08-07,2019,CWS,DET,8,1,-109,-1.5,140,9.0,-119,-101,-101,1.5,-160,4.69,Comerica Park,9,7
2019-08-07,2019,COL,HOU,3,14,310,1.5,160,9.0,105,-126,-360,-1.5,-180,2.2,Minute Maid Park,17,-11
2019-08-07,2019,BOS,KC,5,4,120,1.5,-160,10.0,-110,-110,-120,-1.5,130,4.55,Fenway Park,9,1
2019-08-07,2019,STL,LAD,1,2,120,1.5,-170,8.5,-120,100,-130,-1.5,150,3.86,Dodger Stadium,3,-1
2019-08-07,2019,NYM,MIA,7,2,-195,-1.5,-110,9.0,-125,105,175,1.5,-110,5.95,Citi Field,9,5
2019-08-07,2019,PIT,MIL,3,8,120,1.5,-140,9.5,-115,-105,-130,-1.5,120,4.32,PNC Park,11,-5
2019-08-07,2019,ATL,MIN,11,7,-115,-1.5,140,11.0,101,-120,105,1.5,-160,5.88,Target Field,18,4
2019-08-07,2019,MIA,NYM,2,7,175,1.5,-110,9.0,-125,105,-195,-1.5,-110,3.27,Citi Field,9,-5
2019-08-07,2019,BAL,NYY,2,14,230,1.5,145,9.5,-103,-117,-260,-1.5,-165,2.88,Camden Yards,16,-12
2019-08-07,2019,CHC,OAK,10,1,-137,-1.5,130,10.5,-110,-110,127,1.5,-150,6.07,Wrigley Field,11,9
2019-08-07,2019,ARI,PHI,6,1,-142,-1.5,144,9.0,-125,105,128,1.5,-165,5.28,Chase Field,7,5
2019-08-07,2019,MIL,PIT,8,3,-130,-1.5,120,9.5,-115,-105,120,1.5,-140,5.37,PNC Park,11,5
2019-08-07,2019,SEA,SD,3,2,140,1.5,-120,9.5,-119,-101,-150,-1.5,100,3.96,T-Mobile Park,5,1
2019-08-07,2019,SD,SEA,2,3,-150,-1.5,100,9.5,-119,-101,140,1.5,-120,5.7,T-Mobile Park,5,-1
2019-08-07,2019,WSH,SF,4,1,-111,-1.5,140,9.0,-125,105,101,1.5,-160,4.73,AT&T Park,5,3
2019-08-07,2019,LAD,STL,2,1,-130,-1.5,150,8.5,-120,100,120,1.5,-170,4.8,Dodger Stadium,3,1
2019-08-07,2019,TOR,TB,4,3,195,1.5,-101,9.0,-101,-119,-219,-1.5,-120,3.05,Tropicana Field,7,1
2019-08-07,2019,CLE,TEX,2,0,-190,-1.5,-110,10.0,-119,-101,175,1.5,-110,6.55,Progressive Field,2,2
2019-08-07,2019,CLE,TEX,5,1,-103,1.5,-160,10.0,100,-120,-107,-1.5,140,5.07,Progressive Field,6,4
2019-08-07,2019,TB,TOR,3,4,-219,-1.5,-120,9.0,-101,-119,195,1.5,-101,6.18,Tropicana Field,7,-1
2019-08-07,2019,SF,WSH,1,4,101,1.5,-160,9.0,-125,105,-111,-1.5,140,4.48,AT&T Park,5,-3
2019-08-08,2019,MIA,ATL,9,2,185,1.5,120,8.5,-107,-113,-205,-1.5,-140,2.98,Marlins Park,11,7
2019-08-08,2019,LAA,BOS,0,3,220,1.5,120,11.0,-112,-108,-250,-1.5,-140,3.44,Fenway Park,3,-3
2019-08-08,2019,CIN,CHC,5,12,115,1.5,-140,9.5,100,-120,-125,-1.5,120,4.42,Great American Ballpark,17,-7
2019-08-08,2019,CHC,CIN,12,5,-125,-1.5,120,9.5,100,-120,115,1.5,-140,5.28,Great American Ballpark,17,7
2019-08-08,2019,MIN,CLE,5,7,108,-1.5,195,9.0,-110,-110,-118,1.5,-220,4.33,Target Field,12,-2
2019-08-08,2019,SD,COL,9,3,-105,-1.5,180,8.0,-115,-105,-105,1.5,-205,4.1,PETCO Park,12,6
2019-08-08,2019,KC,DET,8,10,143,1.5,-145,9.0,-108,-113,-153,-1.5,125,3.7,Comerica Park,18,-2
2019-08-08,2019,DET,KC,10,8,-153,-1.5,125,9.0,-108,-113,143,1.5,-145,5.44,Comerica Park,18,2
2019-08-08,2019,BOS,LAA,3,0,-250,-1.5,-140,11.0,-112,-108,220,1.5,120,7.86,Fenway Park,3,3
2019-08-08,2019,ATL,MIA,2,9,-205,-1.5,-140,8.5,-107,-113,185,1.5,120,5.71,Marlins Park,11,-7
2019-08-08,2019,CLE,MIN,7,5,-118,1.5,-220,9.0,-110,-110,108,-1.5,195,4.87,Target Field,12,2
2019-08-08,2019,TOR,NYY,6,12,175,1.5,115,10.5,-105,-115,-190,-1.5,-135,3.82,Rogers Centre,18,-6
2019-08-08,2019,SF,PHI,5,0,-104,1.5,-170,7.0,-116,-104,-106,-1.5,150,3.57,AT&T Park,5,5
2019-08-08,2019,COL,SD,3,9,-105,1.5,-205,8.0,-115,-105,-105,-1.5,180,4.1,PETCO Park,12,-6
2019-08-08,2019,PHI,SF,0,5,-106,-1.5,150,7.0,-116,-104,-104,1.5,-170,3.6,AT&T Park,5,-5
2019-08-08,2019,NYY,TOR,12,6,-190,-1.5,-135,10.5,-105,-115,175,1.5,115,6.88,Rogers Centre,18,6
2019-08-09,2019,LAD,ARI,2,3,-180,-1.5,115,7.5,-105,-115,165,1.5,-135,4.82,Dodger Stadium,5,-1
2019-08-09,2019,MIA,ATL,4,8,135,1.5,-135,7.5,-119,-101,-145,-1.5,115,3.19,Marlins Park,12,-4
2019-08-09,2019,HOU,BAL,3,2,-270,-1.5,-180,10.5,-119,-101,240,1.5,160,7.66,Camden Yards,5,1
2019-08-09,2019,LAA,BOS,4,16,143,1.5,-130,12.0,-106,-114,-153,-1.5,110,4.94,Fenway Park,20,-12
2019-08-09,2019,CIN,CHC,5,2,110,1.5,-155,9.0,-119,-101,-120,-1.5,135,4.29,Great American Ballpark,7,3
2019-08-09,2019,CHC,CIN,2,5,-120,-1.5,135,9.0,-119,-101,110,1.5,-155,4.91,Great American Ballpark,7,-3
2019-08-09,2019,MIN,CLE,2,6,128,1.5,-130,9.0,-117,-103,-138,-1.5,110,3.95,Target Field,8,-4
2019-08-09,2019,SD,COL,7,1,-146,-1.5,135,9.0,-110,-110,136,1.5,-155,5.34,PETCO Park,8,6
2019-08-09,2019,OAK,CWS,7,0,-260,-1.5,-165,11.0,-110,-110,230,1.5,145,7.94,Guaranteed Rate Field,7,7
2019-08-09,2019,KC,DET,2,5,-165,-1.5,-115,10.0,-120,100,155,1.5,-105,6.23,Comerica Park,7,-3
2019-08-09,2019,BAL,HOU,2,3,240,1.5,160,10.5,-119,-101,-270,-1.5,-180,3.09,Camden Yards,5,-1
2019-08-09,2019,DET,KC,5,2,155,1.5,-105,10.0,-120,100,-165,-1.5,-115,3.92,Comerica Park,7,3
2019-08-09,2019,BOS,LAA,16,4,-153,-1.5,110,12.0,-106,-114,143,1.5,-130,7.26,Fenway Park,20,12
2019-08-09,2019,ARI,LAD,3,2,165,1.5,-135,7.5,-105,-115,-180,-1.5,115,2.83,Dodger Stadium,5,1
2019-08-09,2019,ATL,MIA,8,4,-145,-1.5,115,7.5,-119,-101,135,1.5,-135,4.44,Marlins Park,12,4
2019-08-09,2019,TEX,MIL,5,6,185,1.5,-105,9.5,100,-120,-205,-1.5,-115,3.33,Miller Park,11,-1
2019-08-09,2019,CLE,MIN,6,2,-138,-1.5,110,9.0,-117,-103,128,1.5,-130,5.22,Target Field,8,4
2019-08-09,2019,WSH,NYM,6,7,-130,-1.5,130,8.0,-120,100,120,1.5,-150,4.52,Citi Field,13,-1
2019-08-09,2019,TOR,NYY,8,2,135,1.5,-120,10.5,100,-120,-145,-1.5,100,4.47,Rogers Centre,10,6
2019-08-09,2019,CWS,OAK,0,7,230,1.5,145,11.0,-110,-110,-260,-1.5,-165,3.33,Guaranteed Rate Field,7,-7
2019-08-09,2019,SF,PHI,6,9,118,1.5,-140,8.5,-120,100,-128,-1.5,120,3.9,AT&T Park,15,-3
2019-08-09,2019,STL,PIT,6,2,-146,-1.5,120,9.0,-116,-104,136,1.5,-140,5.34,Busch Stadium,8,4
2019-08-09,2019,COL,SD,1,7,136,1.5,-155,9.0,-110,-110,-146,-1.5,135,3.81,PETCO Park,8,-6
2019-08-09,2019,TB,SEA,5,3,-135,-1.5,120,9.0,-120,100,125,1.5,-140,5.17,T-Mobile Park,8,2
2019-08-09,2019,PHI,SF,9,6,-128,-1.5,120,8.5,-120,100,118,1.5,-140,4.77,AT&T Park,15,3
2019-08-09,2019,PIT,STL,2,6,136,1.5,-140,9.0,-116,-104,-146,-1.5,120,3.81,Busch Stadium,8,-4
2019-08-09,2019,SEA,TB,3,5,125,1.5,-140,9.0,-120,100,-135,-1.5,120,4.0,T-Mobile Park,8,-2
2019-08-09,2019,MIL,TEX,6,5,-205,-1.5,-115,9.5,100,-120,185,1.5,-105,6.39,Miller Park,11,1
2019-08-09,2019,NYY,TOR,2,8,-145,-1.5,100,10.5,100,-120,135,1.5,-120,6.21,Rogers Centre,10,-6
2019-08-09,2019,NYM,WSH,7,6,120,1.5,-150,8.0,-120,100,-130,-1.5,130,3.64,Citi Field,13,1
2019-08-10,2019,LAD,ARI,4,0,-162,-1.5,125,8.5,-119,-101,152,1.5,-145,5.26,Dodger Stadium,4,4
2019-08-10,2019,MIA,ATL,7,6,230,1.5,150,8.5,100,-120,-260,-1.5,-170,2.58,Marlins Park,13,1
2019-08-10,2019,HOU,BAL,23,2,-260,-1.5,-175,11.5,-115,-105,230,1.5,155,8.31,Camden Yards,25,21
2019-08-10,2019,LAA,BOS,12,4,131,1.5,-145,11.5,-115,-105,-141,-1.5,125,4.98,Fenway Park,16,8
2019-08-10,2019,CIN,CHC,10,1,-108,-1.5,170,8.5,-115,-105,-102,1.5,-190,4.41,Great American Ballpark,11,9
2019-08-10,2019,CHC,CIN,1,10,-102,1.5,-190,8.5,-115,-105,-108,-1.5,170,4.29,Great American Ballpark,11,-9
2019-08-10,2019,MIN,CLE,4,1,-152,-1.5,125,10.5,100,-120,142,1.5,-145,6.33,Target Field,5,3
2019-08-10,2019,SD,COL,8,5,-210,-1.5,-115,8.5,-125,105,190,1.5,-105,5.76,PETCO Park,13,3
2019-08-10,2019,OAK,CWS,2,3,-166,-1.5,-115,9.5,-110,-110,156,1.5,-105,5.93,Guaranteed Rate Field,5,-1
2019-08-10,2019,KC,DET,7,0,115,1.5,-175,9.5,-105,-115,-125,-1.5,155,4.42,Comerica Park,7,7
2019-08-10,2019,BAL,HOU,2,23,230,1.5,155,11.5,-115,-105,-260,-1.5,-175,3.48,Camden Yards,25,-21
2019-08-10,2019,DET,KC,0,7,-125,-1.5,155,9.5,-105,-115,115,1.5,-175,5.28,Comerica Park,7,-7
2019-08-10,2019,BOS,LAA,4,12,-141,-1.5,125,11.5,-115,-105,131,1.5,-145,6.73,Fenway Park,16,-8
2019-08-10,2019,ARI,LAD,0,4,152,1.5,-145,8.5,-119,-101,-162,-1.5,125,3.37,Dodger Stadium,4,-4
2019-08-10,2019,ATL,MIA,6,7,-260,-1.5,-170,8.5,100,-120,230,1.5,150,6.14,Marlins Park,13,-1
2019-08-10,2019,TEX,MIL,2,3,175,1.5,-115,10.0,-105,-115,-190,-1.5,-105,3.64,Miller Park,5,-1
2019-08-10,2019,CLE,MIN,1,4,142,1.5,-145,10.5,100,-120,-152,-1.5,125,4.34,Target Field,5,-3
2019-08-10,2019,WSH,NYM,3,4,120,1.5,-180,8.0,-109,-111,-130,-1.5,160,3.64,Citi Field,7,-1
2019-08-10,2019,TOR,NYY,5,4,148,1.5,-105,11.0,-110,-110,-158,-1.5,-115,4.44,Rogers Centre,9,1
2019-08-10,2019,CWS,OAK,3,2,156,1.5,-105,9.5,-110,-110,-166,-1.5,-115,3.71,Guaranteed Rate Field,5,1
2019-08-10,2019,SF,PHI,3,1,-103,-1.5,185,8.5,-110,-110,-107,1.5,-210,4.31,AT&T Park,4,2
2019-08-10,2019,STL,PIT,3,1,-170,-1.5,120,9.0,-105,-115,160,1.5,-140,5.67,Busch Stadium,4,2
2019-08-10,2019,COL,SD,5,8,190,1.5,-105,8.5,-125,105,-210,-1.5,-115,2.93,PETCO Park,13,-3
2019-08-10,2019,TB,SEA,5,4,-200,-1.5,-130,8.5,-101,-119,180,1.5,110,5.67,T-Mobile Park,9,1
2019-08-10,2019,PHI,SF,1,3,-107,1.5,-210,8.5,-110,-110,-103,-1.5,185,4.39,AT&T Park,4,-2
2019-08-10,2019,PIT,STL,1,3,160,1.5,-140,9.0,-105,-115,-170,-1.5,120,3.46,Busch Stadium,4,-2
2019-08-10,2019,SEA,TB,4,5,180,1.5,110,8.5,-101,-119,-200,-1.5,-130,3.04,T-Mobile Park,9,-1
2019-08-10,2019,MIL,TEX,3,2,-190,-1.5,-105,10.0,-105,-115,175,1.5,-115,6.55,Miller Park,5,1
2019-08-10,2019,NYY,TOR,4,5,-158,-1.5,-115,11.0,-110,-110,148,1.5,-105,6.74,Rogers Centre,9,-1
2019-08-10,2019,NYM,WSH,4,3,-130,-1.5,160,8.0,-109,-111,120,1.5,-180,4.52,Citi Field,7,1
2019-08-11,2019,LAD,ARI,9,3,-220,-1.5,-120,8.5,-113,-108,200,1.5,100,5.84,Dodger Stadium,12,6
2019-08-11,2019,MIA,ATL,4,5,180,1.5,100,9.0,-113,-107,-200,-1.5,-120,3.21,Marlins Park,9,-1
2019-08-11,2019,HOU,BAL,7,8,-500,-1.5,-270,10.0,-114,-106,400,1.5,235,8.33,Camden Yards,15,-1
2019-08-11,2019,LAA,BOS,5,4,115,1.5,-145,11.5,-115,-105,-125,-1.5,125,5.35,Fenway Park,9,1
2019-08-11,2019,CIN,CHC,3,6,-142,-1.5,140,9.0,-115,-105,132,1.5,-160,5.28,Great American Ballpark,9,-3
2019-08-11,2019,CHC,CIN,6,3,132,1.5,-160,9.0,-115,-105,-142,-1.5,140,3.88,Great American Ballpark,9,3
2019-08-11,2019,MIN,CLE,3,7,-145,-1.5,125,10.0,-105,-115,135,1.5,-145,5.92,Target Field,10,-4
2019-08-11,2019,SD,COL,3,8,-132,-1.5,155,8.0,-101,-119,122,1.5,-175,4.55,PETCO Park,11,-5
2019-08-11,2019,OAK,CWS,2,0,-129,-1.5,120,9.0,-110,-110,119,1.5,-140,5.07,Guaranteed Rate Field,2,2
2019-08-11,2019,KC,DET,10,2,-123,-1.5,120,9.0,107,-128,113,1.5,-140,4.96,Comerica Park,12,8
2019-08-11,2019,BAL,HOU,8,7,400,1.5,235,10.0,-114,-106,-500,-1.5,-270,2.0,Camden Yards,15,1
2019-08-11,2019,DET,KC,2,10,113,1.5,-140,9.0,107,-128,-123,-1.5,120,4.23,Comerica Park,12,-8
2019-08-11,2019,BOS,LAA,4,5,-125,-1.5,125,11.5,-115,-105,115,1.5,-145,6.39,Fenway Park,9,-1
2019-08-11,2019,ARI,LAD,3,9,200,1.5,100,8.5,-113,-108,-220,-1.5,-120,2.83,Dodger Stadium,12,-6
2019-08-11,2019,ATL,MIA,5,4,-200,-1.5,-120,9.0,-113,-107,180,1.5,100,6.0,Marlins Park,9,1
2019-08-11,2019,TEX,MIL,1,0,114,1.5,-175,9.0,-105,-115,-124,-1.5,155,4.21,Miller Park,1,1
2019-08-11,2019,CLE,MIN,7,3,135,1.5,-145,10.0,-105,-115,-145,-1.5,125,4.26,Target Field,10,4
2019-08-11,2019,WSH,NYM,7,4,190,1.5,-110,8.0,-113,-107,-210,-1.5,-110,2.76,Citi Field,11,3
2019-08-11,2019,TOR,NYY,0,1,165,1.5,110,11.0,-115,-105,-180,-1.5,-130,4.15,Rogers Centre,1,-1
2019-08-11,2019,CWS,OAK,0,2,119,1.5,-140,9.0,-110,-110,-129,-1.5,120,4.11,Guaranteed Rate Field,2,-2
2019-08-11,2019,SF,PHI,9,6,115,1.5,-152,9.0,-120,100,-127,-1.5,132,4.19,AT&T Park,15,3
2019-08-11,2019,STL,PIT,11,9,-194,-1.5,100,9.0,-119,-101,177,1.5,-120,5.94,Busch Stadium,20,2
2019-08-11,2019,COL,SD,8,3,122,1.5,-175,8.0,-101,-119,-132,-1.5,155,3.6,PETCO Park,11,5
2019-08-11,2019,TB,SEA,1,0,-175,-1.5,-120,8.5,-120,100,163,1.5,100,5.41,T-Mobile Park,1,1
2019-08-11,2019,PHI,SF,6,9,-127,-1.5,132,9.0,-120,100,115,1.5,-152,5.04,AT&T Park,15,-3
2019-08-11,2019,PIT,STL,9,11,177,1.5,-120,9.0,-119,-101,-194,-1.5,100,3.25,Busch Stadium,20,-2
2019-08-11,2019,SEA,TB,0,1,163,1.5,100,8.5,-120,100,-175,-1.5,-120,3.23,T-Mobile Park,1,-1
2019-08-11,2019,MIL,TEX,0,1,-124,-1.5,155,9.0,-105,-115,114,1.5,-175,4.98,Miller Park,1,-1
2019-08-11,2019,NYY,TOR,1,0,-180,-1.5,-130,11.0,-115,-105,165,1.5,110,7.07,Rogers Centre,1,1
2019-08-11,2019,NYM,WSH,4,7,-210,-1.5,-110,8.0,-113,-107,190,1.5,-110,5.42,Citi Field,11,-3
2019-08-12,2019,COL,ARI,6,8,-111,-1.5,150,14.0,105,-125,101,1.5,-170,7.36,Coors Field,14,-2
2019-08-12,2019,NYY,BAL,8,5,-350,-1.5,-180,10.5,-110,-110,300,1.5,160,8.17,Yankee Stadium,13,3
2019-08-12,2019,NYY,BAL,11,8,-325,-1.5,-175,11.5,100,-120,284,1.5,151,8.79,Yankee Stadium,19,3
2019-08-12,2019,CLE,BOS,6,5,105,1.5,-150,10.5,-110,-110,-115,-1.5,130,5.12,Progressive Field,11,1
2019-08-12,2019,WSH,CIN,7,6,108,1.5,-150,10.5,-105,-115,-118,-1.5,130,5.05,Nationals Park,13,1
2019-08-12,2019,BOS,CLE,5,6,-115,-1.5,130,10.5,-110,-110,105,1.5,-150,5.62,Progressive Field,11,-1
2019-08-12,2019,ARI,COL,8,6,101,1.5,-170,14.0,105,-125,-111,-1.5,150,6.97,Coors Field,14,2
2019-08-12,2019,PIT,LAA,10,2,135,1.5,-150,10.0,-115,-105,-145,-1.5,130,4.26,Angel Stadium,12,8
2019-08-12,2019,BAL,NYY,5,8,300,1.5,160,10.5,-110,-110,-350,-1.5,-180,2.63,Yankee Stadium,13,-3
2019-08-12,2019,BAL,NYY,8,11,284,1.5,151,11.5,100,-120,-325,-1.5,-175,2.99,Yankee Stadium,19,-3
2019-08-12,2019,LAA,PIT,2,10,-145,-1.5,130,10.0,-115,-105,135,1.5,-150,5.92,Angel Stadium,12,-8
2019-08-12,2019,TB,SD,10,4,116,1.5,-170,8.0,-115,-105,-126,-1.5,150,3.7,PETCO Park,14,6
2019-08-12,2019,SD,TB,4,10,-126,-1.5,150,8.0,-115,-105,116,1.5,-170,4.46,PETCO Park,14,-6
2019-08-12,2019,TOR,TEX,19,4,-122,-1.5,150,10.5,-120,100,112,1.5,-170,5.77,Rogers Centre,23,15
2019-08-12,2019,TEX,TOR,4,19,112,1.5,-170,10.5,-120,100,-122,-1.5,150,4.95,Rogers Centre,23,-15
2019-08-12,2019,CIN,WSH,6,7,-118,-1.5,130,10.5,-105,-115,108,1.5,-150,5.68,Nationals Park,13,-1
2019-08-13,2019,COL,ARI,3,9,120,1.5,-125,13.0,-110,-110,-130,-1.5,105,5.91,Coors Field,12,-6
2019-08-13,2019,NYM,ATL,3,5,115,1.5,-175,9.5,-105,-115,-125,-1.5,155,4.42,Suntrust Park,8,-2
2019-08-13,2019,NYY,BAL,8,3,-300,-1.5,-165,10.5,-110,-110,260,1.5,145,7.88,Yankee Stadium,11,5
2019-08-13,2019,CLE,BOS,6,7,-101,1.5,-175,7.5,-115,-105,-109,-1.5,155,3.77,Progressive Field,13,-1
2019-08-13,2019,PHI,CHC,4,2,117,1.5,-140,10.5,105,-125,-127,-1.5,120,4.84,Citizens Bank Park,6,2
2019-08-13,2019,WSH,CIN,3,1,-128,-1.5,150,10.5,-115,-105,118,1.5,-170,5.89,Nationals Park,4,2
2019-08-13,2019,BOS,CLE,7,6,-109,-1.5,155,7.5,-115,-105,-101,1.5,-175,3.91,Progressive Field,13,1
2019-08-13,2019,ARI,COL,9,3,-130,-1.5,105,13.0,-110,-110,120,1.5,-125,7.35,Coors Field,12,6
2019-08-13,2019,HOU,CWS,6,2,-320,-1.5,-205,10.0,-105,-115,280,1.5,180,7.62,Guaranteed Rate Field,8,4
2019-08-13,2019,HOU,CWS,1,4,-350,-1.5,-200,9.0,-110,-110,300,1.5,175,7.0,Guaranteed Rate Field,5,-3
2019-08-13,2019,SEA,DET,11,6,147,1.5,-150,9.0,100,-120,-157,-1.5,130,3.64,Comerica Park,17,5
2019-08-13,2019,CWS,HOU,2,6,280,1.5,180,10.0,-105,-115,-320,-1.5,-205,2.63,Guaranteed Rate Field,8,-4
2019-08-13,2019,CWS,HOU,4,1,300,1.5,175,9.0,-110,-110,-350,-1.5,-200,2.25,Guaranteed Rate Field,5,3
2019-08-13,2019,STL,KC,2,0,-240,-1.5,-160,9.5,-110,-110,210,1.5,140,6.71,Kauffman Stadium,2,2
2019-08-13,2019,PIT,LAA,10,7,155,1.5,-135,9.5,-115,-105,-165,-1.5,115,3.73,Angel Stadium,17,3
2019-08-13,2019,MIA,LAD,1,15,190,1.5,110,8.5,-110,-110,-210,-1.5,-130,2.93,Marlins Park,16,-14
2019-08-13,2019,LAD,MIA,15,1,-210,-1.5,-130,8.5,-110,-110,190,1.5,110,5.76,Marlins Park,16,14
2019-08-13,2019,MIN,MIL,7,5,148,1.5,-135,10.0,100,-120,-158,-1.5,115,4.03,Miller Park,12,2
2019-08-13,2019,MIL,MIN,5,7,-158,-1.5,115,10.0,100,-120,148,1.5,-135,6.12,Miller Park,12,-2
2019-08-13,2019,ATL,NYM,5,3,-125,-1.5,155,9.5,-105,-115,115,1.5,-175,5.28,Suntrust Park,8,2
2019-08-13,2019,BAL,NYY,3,8,260,1.5,145,10.5,-110,-110,-300,-1.5,-165,2.92,Yankee Stadium,11,-5
2019-08-13,2019,SF,OAK,3,2,-105,-1.5,185,8.0,-115,-105,-105,1.5,-210,4.1,AT&T Park,5,1
2019-08-13,2019,CHC,PHI,2,4,-127,-1.5,120,10.5,105,-125,117,1.5,-140,5.87,Citizens Bank Park,6,-2
2019-08-13,2019,LAA,PIT,7,10,-165,-1.5,115,9.5,-115,-105,155,1.5,-135,5.92,Angel Stadium,17,-3
2019-08-13,2019,TB,SD,7,5,-118,-1.5,130,8.0,-120,100,108,1.5,-150,4.33,PETCO Park,12,2
2019-08-13,2019,DET,SEA,6,11,-157,-1.5,130,9.0,100,-120,147,1.5,-150,5.5,Comerica Park,17,-5
2019-08-13,2019,OAK,SF,2,3,-105,1.5,-210,8.0,-115,-105,-105,-1.5,185,4.1,AT&T Park,5,-1
2019-08-13,2019,KC,STL,0,2,210,1.5,140,9.5,-110,-110,-240,-1.5,-160,3.06,Kauffman Stadium,2,-2
2019-08-13,2019,SD,TB,5,7,108,1.5,-150,8.0,-120,100,-118,-1.5,130,3.85,PETCO Park,12,-2
2019-08-13,2019,TOR,TEX,3,0,120,1.5,-130,9.0,-120,100,-130,-1.5,110,4.09,Rogers Centre,3,3
2019-08-13,2019,TEX,TOR,0,3,-130,-1.5,110,9.0,-120,100,120,1.5,-130,5.09,Rogers Centre,3,-3
2019-08-13,2019,CIN,WSH,1,3,118,1.5,-170,10.5,-115,-105,-128,-1.5,150,4.82,Nationals Park,4,-2
2019-08-14,2019,COL,ARI,7,6,142,1.5,-110,13.0,-110,-110,-152,-1.5,-110,5.37,Coors Field,13,1
2019-08-14,2019,NYM,ATL,4,6,134,1.5,-155,10.0,-115,-105,-144,-1.5,135,4.27,Suntrust Park,10,-2
2019-08-14,2019,NYY,BAL,6,5,-240,-1.5,-140,10.5,-115,-105,210,1.5,120,7.41,Yankee Stadium,11,1
2019-08-14,2019,CLE,BOS,1,5,-185,-1.5,100,9.5,105,-125,170,1.5,-120,6.17,Progressive Field,6,-4
2019-08-14,2019,PHI,CHC,11,1,-120,-1.5,165,8.5,-120,100,110,1.5,-185,4.64,Citizens Bank Park,12,10
2019-08-14,2019,WSH,CIN,17,7,-168,-1.5,125,9.0,-105,-115,158,1.5,-145,5.64,Nationals Park,24,10
2019-08-14,2019,BOS,CLE,5,1,170,1.5,-120,9.5,105,-125,-185,-1.5,100,3.52,Progressive Field,6,4
2019-08-14,2019,ARI,COL,6,7,-152,-1.5,-110,13.0,-110,-110,142,1.5,-110,7.84,Coors Field,13,-1
2019-08-14,2019,HOU,CWS,9,13,-310,-1.5,-200,11.0,-105,-115,270,1.5,175,8.32,Guaranteed Rate Field,22,-4
2019-08-14,2019,SEA,DET,2,3,-170,-1.5,-120,10.0,-110,-110,160,1.5,100,6.3,Comerica Park,5,-1
2019-08-14,2019,CWS,HOU,13,9,270,1.5,175,11.0,-105,-115,-310,-1.5,-200,2.97,Guaranteed Rate Field,22,4
2019-08-14,2019,STL,KC,6,0,-128,-1.5,110,9.5,-110,-110,118,1.5,-130,5.33,Kauffman Stadium,6,6
2019-08-14,2019,PIT,LAA,4,7,117,1.5,-170,10.0,100,-120,-127,-1.5,150,4.61,Angel Stadium,11,-3
2019-08-14,2019,MIA,LAD,1,9,250,1.5,170,8.0,-110,-110,-290,-1.5,-190,2.29,Marlins Park,10,-8
2019-08-14,2019,LAD,MIA,9,1,-290,-1.5,-190,8.0,-110,-110,250,1.5,170,5.95,Marlins Park,10,8
2019-08-14,2019,MIN,MIL,5,6,106,1.5,-190,9.5,-105,-115,-116,-1.5,170,4.61,Miller Park,11,-1
2019-08-14,2019,MIL,MIN,6,5,-116,-1.5,170,9.5,-105,-115,106,1.5,-190,5.1,Miller Park,11,1
2019-08-14,2019,ATL,NYM,6,4,-144,-1.5,135,10.0,-115,-105,134,1.5,-155,5.9,Suntrust Park,10,2
2019-08-14,2019,BAL,NYY,5,6,210,1.5,120,10.5,-115,-105,-240,-1.5,-140,3.39,Yankee Stadium,11,-1
2019-08-14,2019,SF,OAK,5,9,105,1.5,-155,9.0,-120,100,-115,-1.5,135,4.39,AT&T Park,14,-4
2019-08-14,2019,CHC,PHI,1,11,110,1.5,-185,8.5,-120,100,-120,-1.5,165,4.05,Citizens Bank Park,12,-10
2019-08-14,2019,LAA,PIT,7,4,-127,-1.5,150,10.0,100,-120,117,1.5,-170,5.59,Angel Stadium,11,3
2019-08-14,2019,TB,SD,2,7,102,1.5,-190,8.5,-115,-105,-112,-1.5,170,4.21,PETCO Park,9,-5
2019-08-14,2019,DET,SEA,3,2,160,1.5,100,10.0,-110,-110,-170,-1.5,-120,3.85,Comerica Park,5,1
2019-08-14,2019,OAK,SF,9,5,-115,-1.5,135,9.0,-120,100,105,1.5,-155,4.81,AT&T Park,14,4
2019-08-14,2019,KC,STL,0,6,118,1.5,-130,9.5,-110,-110,-128,-1.5,110,4.36,Kauffman Stadium,6,-6
2019-08-14,2019,SD,TB,7,2,-112,-1.5,170,8.5,-115,-105,102,1.5,-190,4.49,PETCO Park,9,5
2019-08-14,2019,TOR,TEX,3,7,-142,-1.5,125,10.0,-115,-105,132,1.5,-145,5.87,Rogers Centre,10,-4
2019-08-14,2019,TEX,TOR,7,3,132,1.5,-145,10.0,-115,-105,-142,-1.5,125,4.31,Rogers Centre,10,4
2019-08-14,2019,CIN,WSH,7,17,158,1.5,-145,9.0,-105,-115,-168,-1.5,125,3.49,Nationals Park,24,-10
2019-08-15,2019,SF,ARI,7,0,150,1.5,-140,9.5,-105,-115,-160,-1.5,120,3.8,Chase Field,7,7
2019-08-15,2019,NYM,ATL,10,8,113,1.5,-170,10.0,-115,-105,-123,-1.5,150,4.69,Suntrust Park,18,2
2019-08-15,2019,PHI,CHC,7,5,128,1.5,-130,9.5,-115,-105,-138,-1.5,110,4.17,Citizens Bank Park,12,2
2019-08-15,2019,STL,CIN,1,2,130,1.5,-155,9.5,-105,-115,-140,-1.5,135,4.13,Great American Ballpark,3,-1
2019-08-15,2019,NYY,CLE,5,19,-160,-1.5,115,11.0,-105,-115,150,1.5,-135,6.77,Yankee Stadium,24,-14
2019-08-15,2019,LAA,CWS,8,7,-154,-1.5,120,9.0,100,-120,144,1.5,-140,5.46,Angel Stadium,15,1
2019-08-15,2019,SEA,DET,7,2,-111,-1.5,137,9.5,100,-120,-101,1.5,-157,5.0,Comerica Park,9,5
2019-08-15,2019,OAK,HOU,7,6,102,1.5,-155,10.0,-115,-105,-112,-1.5,135,4.95,Oakland Coliseum,13,1
2019-08-15,2019,CWS,LAA,7,8,144,1.5,-140,9.0,100,-120,-154,-1.5,120,3.69,Angel Stadium,15,-1
2019-08-15,2019,MIA,LAD,13,7,220,1.5,140,7.5,100,-120,-250,-1.5,-160,2.34,Marlins Park,20,6
2019-08-15,2019,LAD,MIA,7,13,-250,-1.5,-160,7.5,100,-120,220,1.5,140,5.36,Marlins Park,20,-6
2019-08-15,2019,TEX,MIN,6,13,145,1.5,100,12.0,-110,-110,-155,-1.5,-120,4.9,Rangers Ballpark,19,-7
2019-08-15,2019,ATL,NYM,8,10,-123,-1.5,150,10.0,-115,-105,113,1.5,-170,5.52,Suntrust Park,18,-2
2019-08-15,2019,CLE,NYY,19,5,150,1.5,-135,11.0,-105,-115,-160,-1.5,115,4.4,Yankee Stadium,24,14
2019-08-15,2019,HOU,OAK,6,7,-112,-1.5,135,10.0,-115,-105,102,1.5,-155,5.28,Oakland Coliseum,13,-1
2019-08-15,2019,CHC,PHI,5,7,-138,-1.5,110,9.5,-115,-105,128,1.5,-130,5.51,Citizens Bank Park,12,-2
2019-08-15,2019,DET,SEA,2,7,-101,1.5,-157,9.5,100,-120,-111,-1.5,137,4.77,Comerica Park,9,-5
2019-08-15,2019,ARI,SF,0,7,-160,-1.5,120,9.5,-105,-115,150,1.5,-140,5.85,Chase Field,7,-7
2019-08-15,2019,CIN,STL,2,1,-140,-1.5,135,9.5,-105,-115,130,1.5,-155,5.54,Great American Ballpark,3,1
2019-08-15,2019,MIN,TEX,13,6,-155,-1.5,-120,12.0,-110,-110,145,1.5,100,7.29,Rangers Ballpark,19,7
2019-08-16,2019,SF,ARI,10,9,122,1.5,-170,9.5,-105,-115,-132,-1.5,150,4.28,Chase Field,19,1
2019-08-16,2019,LAD,ATL,8,3,105,1.5,-180,10.0,-110,-110,-115,-1.5,160,4.88,Suntrust Park,11,5
2019-08-16,2019,BOS,BAL,9,1,-280,-1.5,-160,12.5,-105,-115,245,1.5,140,9.21,Fenway Park,10,8
2019-08-16,2019,BAL,BOS,1,9,245,1.5,140,12.5,-105,-115,-280,-1.5,-160,3.62,Fenway Park,10,-8
2019-08-16,2019,PIT,CHC,3,2,125,1.5,-135,9.0,-115,-105,-135,-1.5,115,4.0,PNC Park,5,1
2019-08-16,2019,STL,CIN,13,4,122,1.5,-165,8.5,-120,100,-132,-1.5,145,3.83,Great American Ballpark,17,9
2019-08-16,2019,NYY,CLE,3,2,-140,-1.5,125,10.5,-105,-115,130,1.5,-145,6.13,Yankee Stadium,5,1
2019-08-16,2019,MIA,COL,0,3,215,1.5,115,12.5,-105,-115,-245,-1.5,-135,3.97,Coors Field,3,-3
2019-08-16,2019,LAA,CWS,2,7,-115,-1.5,170,8.5,-105,-115,105,1.5,-190,4.55,Angel Stadium,9,-5
2019-08-16,2019,TB,DET,0,2,-330,-1.5,-160,7.5,-110,-110,285,1.5,140,5.76,Tropicana Field,2,-2
2019-08-16,2019,OAK,HOU,3,2,170,1.5,105,9.0,-110,-110,-185,-1.5,-125,3.33,Oakland Coliseum,5,1
2019-08-16,2019,NYM,KC,1,4,-176,-1.5,-115,9.0,-110,-110,163,1.5,-105,5.74,Kauffman Stadium,5,-3
2019-08-16,2019,CWS,LAA,7,2,105,1.5,-190,8.5,-105,-115,-115,-1.5,170,4.15,Angel Stadium,9,5
2019-08-16,2019,ATL,LAD,3,8,-115,-1.5,160,10.0,-110,-110,105,1.5,-180,5.35,Suntrust Park,11,-5
2019-08-16,2019,COL,MIA,3,0,-245,-1.5,-135,12.5,-105,-115,215,1.5,115,8.88,Coors Field,3,3
2019-08-16,2019,WSH,MIL,2,1,-155,-1.5,120,9.0,-120,100,145,1.5,-140,5.47,Nationals Park,3,1
2019-08-16,2019,TEX,MIN,3,4,-106,-1.5,170,10.0,-120,100,-104,1.5,-190,5.15,Rangers Ballpark,7,-1
2019-08-16,2019,KC,NYM,4,1,163,1.5,-105,9.0,-110,-110,-176,-1.5,-115,3.42,Kauffman Stadium,5,3
2019-08-16,2019,CLE,NYY,2,3,130,1.5,-145,10.5,-105,-115,-140,-1.5,125,4.57,Yankee Stadium,5,-1
2019-08-16,2019,HOU,OAK,2,3,-185,-1.5,-125,9.0,-110,-110,170,1.5,105,5.84,Oakland Coliseum,5,-1
2019-08-16,2019,SD,PHI,4,8,102,1.5,-200,9.0,-110,-110,-112,-1.5,175,4.46,Citizens Bank Park,12,-4
2019-08-16,2019,CHC,PIT,2,3,-135,-1.5,115,9.0,-115,-105,125,1.5,-135,5.17,PNC Park,5,-1
2019-08-16,2019,PHI,SD,8,4,-112,-1.5,175,9.0,-110,-110,102,1.5,-200,4.75,Citizens Bank Park,12,4
2019-08-16,2019,TOR,SEA,7,3,-145,-1.5,130,10.0,-120,100,135,1.5,-150,5.92,Rogers Centre,10,4
2019-08-16,2019,ARI,SF,9,10,-132,-1.5,150,9.5,-105,-115,122,1.5,-170,5.41,Chase Field,19,-1
2019-08-16,2019,CIN,STL,4,13,-132,-1.5,145,8.5,-120,100,122,1.5,-165,4.84,Great American Ballpark,17,-9
2019-08-16,2019,DET,TB,2,0,285,1.5,140,7.5,-110,-110,-330,-1.5,-160,1.95,Tropicana Field,2,2
2019-08-16,2019,MIN,TEX,4,3,-104,1.5,-190,10.0,-120,100,-106,-1.5,170,5.1,Rangers Ballpark,7,1
2019-08-16,2019,SEA,TOR,3,7,135,1.5,-150,10.0,-120,100,-145,-1.5,130,4.26,Rogers Centre,10,-4
2019-08-16,2019,MIL,WSH,1,2,145,1.5,-140,9.0,-120,100,-155,-1.5,120,3.67,Nationals Park,3,-1
2019-08-17,2019,SF,ARI,11,6,105,1.5,-180,10.0,-120,100,-115,-1.5,160,4.88,Chase Field,17,5
2019-08-17,2019,LAD,ATL,3,4,-155,-1.5,-110,10.0,-110,-110,145,1.5,-110,6.08,Suntrust Park,7,-1
2019-08-17,2019,BOS,BAL,4,0,-320,-1.5,-170,10.5,-120,100,280,1.5,150,8.0,Fenway Park,4,4
2019-08-17,2019,BAL,BOS,0,4,280,1.5,150,10.5,-120,100,-320,-1.5,-170,2.76,Fenway Park,4,-4
2019-08-17,2019,PIT,CHC,0,2,133,1.5,-125,10.5,-105,-115,-143,-1.5,105,4.51,PNC Park,2,-2
2019-08-17,2019,STL,CIN,1,6,-130,-1.5,125,9.0,-115,-105,120,1.5,-145,5.09,Great American Ballpark,7,-5
2019-08-17,2019,NYY,CLE,6,5,-165,-1.5,110,10.0,-115,-105,155,1.5,-130,6.23,Yankee Stadium,11,1
2019-08-17,2019,MIA,COL,4,11,240,1.5,130,12.5,-110,-110,-270,-1.5,-150,3.68,Coors Field,15,-7
2019-08-17,2019,LAA,CWS,6,5,-185,-1.5,100,10.0,-105,-115,170,1.5,-120,6.49,Angel Stadium,11,1
2019-08-17,2019,TB,DET,1,0,-310,-1.5,-150,8.5,-105,-115,270,1.5,130,6.43,Tropicana Field,1,1
2019-08-17,2019,OAK,HOU,8,4,102,1.5,-150,10.0,-115,-105,-112,-1.5,130,4.95,Oakland Coliseum,12,4
2019-08-17,2019,NYM,KC,4,1,-200,-1.5,-130,8.5,-105,-115,180,1.5,110,5.67,Kauffman Stadium,5,3
2019-08-17,2019,CWS,LAA,5,6,170,1.5,-120,10.0,-105,-115,-185,-1.5,100,3.7,Angel Stadium,11,-1
2019-08-17,2019,ATL,LAD,4,3,145,1.5,-110,10.0,-110,-110,-155,-1.5,-110,4.08,Suntrust Park,7,1
2019-08-17,2019,COL,MIA,11,4,-270,-1.5,-150,12.5,-110,-110,240,1.5,130,9.12,Coors Field,15,7
2019-08-17,2019,WSH,MIL,14,15,-114,-1.5,165,10.5,-105,-115,104,1.5,-185,5.59,Nationals Park,29,-1
2019-08-17,2019,TEX,MIN,7,12,160,1.5,110,11.5,-110,-110,-170,-1.5,-130,4.42,Rangers Ballpark,19,-5
2019-08-17,2019,KC,NYM,1,4,180,1.5,110,8.5,-105,-115,-200,-1.5,-130,3.04,Kauffman Stadium,5,-3
2019-08-17,2019,CLE,NYY,5,6,155,1.5,-130,10.0,-115,-105,-165,-1.5,110,3.92,Yankee Stadium,11,-1
2019-08-17,2019,HOU,OAK,4,8,-112,-1.5,130,10.0,-115,-105,102,1.5,-150,5.28,Oakland Coliseum,12,-4
2019-08-17,2019,SD,PHI,5,3,102,1.5,-200,9.5,-115,-105,-112,-1.5,175,4.7,Citizens Bank Park,8,2
2019-08-17,2019,CHC,PIT,2,0,-143,-1.5,105,10.5,-105,-115,133,1.5,-125,6.18,PNC Park,2,2
2019-08-17,2019,PHI,SD,3,5,-112,-1.5,175,9.5,-115,-105,102,1.5,-200,5.02,Citizens Bank Park,8,-2
2019-08-17,2019,TOR,SEA,3,4,-165,-1.5,105,10.5,-110,-110,155,1.5,-125,6.54,Rogers Centre,7,-1
2019-08-17,2019,ARI,SF,6,11,-115,-1.5,160,10.0,-120,100,105,1.5,-180,5.35,Chase Field,17,-5
2019-08-17,2019,CIN,STL,6,1,120,1.5,-145,9.0,-115,-105,-130,-1.5,125,4.09,Great American Ballpark,7,5
2019-08-17,2019,DET,TB,0,1,270,1.5,130,8.5,-105,-115,-310,-1.5,-150,2.3,Tropicana Field,1,-1
2019-08-17,2019,MIN,TEX,12,7,-170,-1.5,-130,11.5,-110,-110,160,1.5,110,7.24,Rangers Ballpark,19,5
2019-08-17,2019,SEA,TOR,4,3,155,1.5,-125,10.5,-110,-110,-165,-1.5,105,4.12,Rogers Centre,7,1
2019-08-17,2019,MIL,WSH,15,14,104,1.5,-185,10.5,-105,-115,-114,-1.5,165,5.15,Nationals Park,29,1
2019-08-18,2019,SF,ARI,1,6,-102,-1.5,155,9.0,-110,-110,-108,1.5,-175,4.54,Chase Field,7,-5
2019-08-18,2019,LAD,ATL,3,5,117,1.5,-170,10.0,-115,-105,-127,-1.5,150,4.61,Suntrust Park,8,-2
2019-08-18,2019,BOS,BAL,13,7,-300,-1.5,-160,12.0,-115,-105,260,1.5,140,9.0,Fenway Park,20,6
2019-08-18,2019,BAL,BOS,7,13,260,1.5,140,12.0,-115,-105,-300,-1.5,-160,3.33,Fenway Park,20,-6
2019-08-18,2019,PIT,CHC,1,7,150,1.5,-115,9.5,-120,100,-160,-1.5,-105,3.8,BB&T Ballpark at Bowman Field,8,-6
2019-08-18,2019,STL,CIN,5,4,-167,-1.5,-115,9.0,-105,-115,157,1.5,-105,5.63,Great American Ballpark,9,1
2019-08-18,2019,NYY,CLE,4,8,110,1.5,-150,10.0,-120,100,-120,-1.5,130,4.76,Yankee Stadium,12,-4
2019-08-18,2019,MIA,COL,6,7,158,1.5,-115,13.5,-120,100,-168,-1.5,-105,5.23,Coors Field,13,-1
2019-08-18,2019,LAA,CWS,9,2,-155,-1.5,120,9.0,-110,-110,145,1.5,-140,5.47,Angel Stadium,11,7
2019-08-18,2019,TB,DET,5,4,-190,-1.5,110,7.5,-105,-115,175,1.5,-130,4.91,Tropicana Field,9,1
2019-08-18,2019,OAK,HOU,1,4,176,1.5,110,9.5,-115,-105,-192,-1.5,-130,3.44,Oakland Coliseum,5,-3
2019-08-18,2019,NYM,KC,11,5,-178,-1.5,-120,9.5,-115,-105,164,1.5,100,6.08,Kauffman Stadium,16,6
2019-08-18,2019,CWS,LAA,2,9,145,1.5,-140,9.0,-110,-110,-155,-1.5,120,3.67,Angel Stadium,11,-7
2019-08-18,2019,ATL,LAD,5,3,-127,-1.5,150,10.0,-115,-105,117,1.5,-170,5.59,Suntrust Park,8,2
2019-08-18,2019,COL,MIA,7,6,-168,-1.5,-105,13.5,-120,100,158,1.5,-115,8.46,Coors Field,13,1
2019-08-18,2019,WSH,MIL,16,8,-105,1.5,-165,11.0,-120,100,-105,-1.5,145,5.63,Nationals Park,24,8
2019-08-18,2019,TEX,MIN,3,6,-134,-1.5,140,10.5,-110,-110,124,1.5,-160,6.01,Rangers Ballpark,9,-3
2019-08-18,2019,KC,NYM,5,11,164,1.5,100,9.5,-115,-105,-178,-1.5,-120,3.6,Kauffman Stadium,16,-6
2019-08-18,2019,CLE,NYY,8,4,-120,-1.5,130,10.0,-120,100,110,1.5,-150,5.45,Yankee Stadium,12,4
2019-08-18,2019,HOU,OAK,4,1,-192,-1.5,-130,9.5,-115,-105,176,1.5,110,6.25,Oakland Coliseum,5,3
2019-08-18,2019,SD,PHI,3,2,109,1.5,-175,10.5,-110,-110,-119,-1.5,155,5.02,Citizens Bank Park,5,1
2019-08-18,2019,CHC,PIT,7,1,-160,-1.5,-105,9.5,-120,100,150,1.5,-115,5.85,BB&T Ballpark at Bowman Field,8,6
2019-08-18,2019,PHI,SD,2,3,-119,-1.5,155,10.5,-110,-110,109,1.5,-175,5.71,Citizens Bank Park,5,-1
2019-08-18,2019,TOR,SEA,0,7,-165,-1.5,105,10.0,-115,-105,155,1.5,-125,6.23,Rogers Centre,7,-7
2019-08-18,2019,ARI,SF,6,1,-108,1.5,-175,9.0,-110,-110,-102,-1.5,155,4.67,Chase Field,7,5
2019-08-18,2019,CIN,STL,4,5,157,1.5,-105,9.0,-105,-115,-167,-1.5,-115,3.5,Great American Ballpark,9,-1
2019-08-18,2019,DET,TB,4,5,175,1.5,-130,7.5,-105,-115,-190,-1.5,110,2.73,Tropicana Field,9,-1
2019-08-18,2019,MIN,TEX,6,3,124,1.5,-160,10.5,-110,-110,-134,-1.5,140,4.69,Rangers Ballpark,9,3
2019-08-18,2019,SEA,TOR,7,0,155,1.5,-125,10.0,-115,-105,-165,-1.5,105,3.92,Rogers Centre,7,7
2019-08-18,2019,MIL,WSH,8,16,-105,-1.5,145,11.0,-120,100,-105,1.5,-165,5.63,Nationals Park,24,-8
2019-08-19,2019,COL,ARI,3,5,190,1.5,-115,9.5,-110,-110,-210,-1.5,-105,3.28,Chase Field,8,-2
2019-08-19,2019,KC,BAL,5,4,120,1.5,-160,10.5,-125,105,-130,-1.5,140,4.77,Camden Yards,9,1
2019-08-19,2019,SD,CIN,3,2,130,1.5,-155,9.0,-120,100,-140,-1.5,135,3.91,Great American Ballpark,5,1
2019-08-19,2019,ARI,COL,5,3,-210,-1.5,-105,9.5,-110,-110,190,1.5,-115,6.44,Chase Field,8,2
2019-08-19,2019,MIN,CWS,4,6,-220,-1.5,-120,10.0,100,-120,200,1.5,100,6.88,Target Field,10,-2
2019-08-19,2019,HOU,DET,5,4,-420,-1.5,-200,10.0,-120,100,350,1.5,175,8.08,Minute Maid Park,9,1
2019-08-19,2019,DET,HOU,4,5,350,1.5,175,10.0,-120,100,-420,-1.5,-200,2.22,Minute Maid Park,9,-1
2019-08-19,2019,BAL,KC,4,5,-130,-1.5,140,10.5,-125,105,120,1.5,-160,5.93,Camden Yards,9,-1
2019-08-19,2019,TEX,LAA,8,7,108,1.5,-145,11.5,-110,-110,-118,-1.5,125,5.53,Rangers Ballpark,15,1
2019-08-19,2019,STL,MIL,3,0,-118,-1.5,160,9.5,-120,100,108,1.5,-180,5.14,Busch Stadium,3,3
2019-08-19,2019,CWS,MIN,6,4,200,1.5,100,10.0,100,-120,-220,-1.5,-120,3.33,Target Field,10,2
2019-08-19,2019,WSH,PIT,13,0,-118,-1.5,120,10.5,-120,100,108,1.5,-140,5.68,PNC Park,13,13
2019-08-19,2019,CIN,SD,2,3,-140,-1.5,135,9.0,-120,100,130,1.5,-155,5.25,Great American Ballpark,5,-1
2019-08-19,2019,TB,SEA,3,9,-190,-1.5,105,8.0,-105,-115,175,1.5,-125,5.24,Tropicana Field,12,-6
2019-08-19,2019,MIL,STL,0,3,108,1.5,-180,9.5,-120,100,-118,-1.5,160,4.57,Busch Stadium,3,-3
2019-08-19,2019,SEA,TB,9,3,175,1.5,-125,8.0,-105,-115,-190,-1.5,105,2.91,Tropicana Field,12,6
2019-08-19,2019,LAA,TEX,7,8,-118,-1.5,125,11.5,-110,-110,108,1.5,-145,6.22,Rangers Ballpark,15,-1
2019-08-19,2019,PIT,WSH,0,13,108,1.5,-140,10.5,-120,100,-118,-1.5,120,5.05,PNC Park,13,-13
2019-08-20,2019,COL,ARI,7,8,138,1.5,-140,10.0,-105,-115,-148,-1.5,120,4.2,Chase Field,15,-1
2019-08-20,2019,MIA,ATL,1,5,245,1.5,125,9.5,-115,-105,-275,-1.5,-145,2.75,Suntrust Park,6,-4
2019-08-20,2019,KC,BAL,1,4,107,1.5,-190,9.5,-110,-110,-117,-1.5,170,4.59,Camden Yards,5,-3
2019-08-20,2019,PHI,BOS,3,2,100,1.5,-190,11.0,-105,-115,-110,-1.5,170,5.5,Fenway Park,5,1
2019-08-20,2019,SF,CHC,3,5,180,1.5,-110,10.5,100,-120,-200,-1.5,-110,3.75,Wrigley Field,8,-2
2019-08-20,2019,SD,CIN,2,3,140,1.5,-160,8.5,-105,-115,-150,-1.5,140,3.54,Great American Ballpark,5,-1
2019-08-20,2019,NYM,CLE,9,2,135,1.5,-125,8.0,-110,-110,-145,-1.5,105,3.4,Citi Field,11,7
2019-08-20,2019,ARI,COL,8,7,-148,-1.5,120,10.0,-105,-115,138,1.5,-140,5.97,Chase Field,15,1
2019-08-20,2019,MIN,CWS,14,4,-230,-1.5,-135,10.0,-110,-110,205,1.5,115,6.97,Target Field,18,10
2019-08-20,2019,HOU,DET,6,3,-270,-1.5,-140,9.0,-110,-110,240,1.5,120,6.57,Minute Maid Park,9,3
2019-08-20,2019,DET,HOU,3,6,240,1.5,120,9.0,-110,-110,-270,-1.5,-140,2.65,Minute Maid Park,9,-3
2019-08-20,2019,BAL,KC,4,1,-117,-1.5,170,9.5,-110,-110,107,1.5,-190,5.12,Camden Yards,5,3
2019-08-20,2019,TEX,LAA,1,5,127,1.5,-130,11.5,-120,100,-137,-1.5,110,5.07,Rangers Ballpark,6,-4
2019-08-20,2019,TEX,LAA,3,2,118,1.5,-130,12.0,-110,-110,-128,-1.5,110,5.5,Rangers Ballpark,5,1
2019-08-20,2019,TOR,LAD,3,16,285,1.5,140,9.0,-120,100,-330,-1.5,-160,2.34,Dodger Stadium,19,-13
2019-08-20,2019,ATL,MIA,5,1,-275,-1.5,-145,9.5,-115,-105,245,1.5,125,6.97,Suntrust Park,6,4
2019-08-20,2019,STL,MIL,9,4,-105,-1.5,175,9.5,-110,-110,-105,1.5,-200,4.87,Busch Stadium,13,5
2019-08-20,2019,CWS,MIN,4,14,205,1.5,115,10.0,-110,-110,-230,-1.5,-135,3.28,Target Field,18,-10
2019-08-20,2019,CLE,NYM,2,9,-145,-1.5,105,8.0,-110,-110,135,1.5,-125,4.73,Citi Field,11,-7
2019-08-20,2019,OAK,NYY,6,2,120,1.5,-135,9.5,-105,-115,-130,-1.5,115,4.32,Oakland Coliseum,8,4
2019-08-20,2019,NYY,OAK,2,6,-130,-1.5,115,9.5,-105,-115,120,1.5,-135,5.37,Oakland Coliseum,8,-4
2019-08-20,2019,BOS,PHI,2,3,-110,-1.5,170,11.0,-105,-115,100,1.5,-190,5.76,Fenway Park,5,-1
2019-08-20,2019,WSH,PIT,1,4,-155,-1.5,-105,9.0,-105,-115,145,1.5,-115,5.47,PNC Park,5,-3
2019-08-20,2019,CIN,SD,3,2,-150,-1.5,140,8.5,-105,-115,140,1.5,-160,5.1,Great American Ballpark,5,1
2019-08-20,2019,TB,SEA,4,7,-196,-1.5,-105,8.5,-120,100,178,1.5,-115,5.63,Tropicana Field,11,-3
2019-08-20,2019,CHC,SF,5,3,-200,-1.5,-110,10.5,100,-120,180,1.5,-110,7.0,Wrigley Field,8,2
2019-08-20,2019,MIL,STL,4,9,-105,1.5,-200,9.5,-110,-110,-105,-1.5,175,4.87,Busch Stadium,13,-5
2019-08-20,2019,SEA,TB,7,4,178,1.5,-115,8.5,-120,100,-196,-1.5,-105,3.06,Tropicana Field,11,3
2019-08-20,2019,LAA,TEX,5,1,-137,-1.5,110,11.5,-120,100,127,1.5,-130,6.65,Rangers Ballpark,6,4
2019-08-20,2019,LAA,TEX,2,3,-128,-1.5,110,12.0,-110,-110,118,1.5,-130,6.74,Rangers Ballpark,5,-1
2019-08-20,2019,LAD,TOR,16,3,-330,-1.5,-160,9.0,-120,100,285,1.5,140,6.91,Dodger Stadium,19,13
2019-08-20,2019,PIT,WSH,4,1,145,1.5,-115,9.0,-105,-115,-155,-1.5,-105,3.67,PNC Park,5,3
2019-08-21,2019,COL,ARI,7,2,164,1.5,-135,10.0,-105,-115,-178,-1.5,115,3.79,Chase Field,9,5
2019-08-21,2019,MIA,ATL,0,5,165,1.5,-120,9.5,100,-120,-180,-1.5,100,3.58,Suntrust Park,5,-5
2019-08-21,2019,KC,BAL,1,8,-120,1.5,-230,10.5,-120,100,110,-1.5,200,5.73,Camden Yards,9,-7
2019-08-21,2019,PHI,BOS,5,2,150,1.5,-120,12.5,-105,-115,-160,-1.5,100,5.0,Fenway Park,7,3
2019-08-21,2019,SF,CHC,11,12,220,1.5,100,9.0,-105,-115,-250,-1.5,-120,2.81,Wrigley Field,23,-1
2019-08-21,2019,SD,CIN,2,4,150,1.5,-140,8.5,-115,-105,-160,-1.5,120,3.4,Great American Ballpark,6,-2
2019-08-21,2019,NYM,CLE,4,3,-150,-1.5,135,9.0,-105,-115,140,1.5,-155,5.4,Citi Field,7,1
2019-08-21,2019,ARI,COL,2,7,-178,-1.5,115,10.0,-105,-115,164,1.5,-135,6.4,Chase Field,9,-5
2019-08-21,2019,MIN,CWS,0,4,-170,-1.5,105,8.5,-110,-110,160,1.5,-125,5.35,Target Field,4,-4
2019-08-21,2019,HOU,DET,1,2,-550,-1.5,-230,8.5,100,-120,425,1.5,200,7.19,Minute Maid Park,3,-1
2019-08-21,2019,DET,HOU,2,1,425,1.5,200,8.5,100,-120,-550,-1.5,-230,1.62,Minute Maid Park,3,1
2019-08-21,2019,BAL,KC,8,1,110,-1.5,200,10.5,-120,100,-120,1.5,-230,5.0,Camden Yards,9,7
2019-08-21,2019,TEX,LAA,8,7,-118,-1.5,140,10.5,-110,-110,108,1.5,-160,5.68,Rangers Ballpark,15,1
2019-08-21,2019,TOR,LAD,1,2,320,1.5,160,8.5,-120,100,-380,-1.5,-180,2.02,Dodger Stadium,3,-1
2019-08-21,2019,ATL,MIA,5,0,-180,-1.5,100,9.5,100,-120,165,1.5,-120,6.11,Suntrust Park,5,5
2019-08-21,2019,STL,MIL,3,5,-102,-1.5,185,8.5,-125,105,-108,1.5,-210,4.29,Busch Stadium,8,-2
2019-08-21,2019,CWS,MIN,4,0,160,1.5,-125,8.5,-110,-110,-170,-1.5,105,3.27,Target Field,4,4
2019-08-21,2019,CLE,NYM,3,4,140,1.5,-155,9.0,-105,-115,-150,-1.5,135,3.75,Citi Field,7,-1
2019-08-21,2019,OAK,NYY,6,4,-122,-1.5,150,10.0,-110,-110,112,1.5,-170,5.5,Oakland Coliseum,10,2
2019-08-21,2019,NYY,OAK,4,6,112,1.5,-170,10.0,-110,-110,-122,-1.5,150,4.72,Oakland Coliseum,10,-2
2019-08-21,2019,BOS,PHI,2,5,-160,-1.5,100,12.5,-105,-115,150,1.5,-120,7.69,Fenway Park,7,-3
2019-08-21,2019,WSH,PIT,11,1,-137,-1.5,110,9.0,100,-120,127,1.5,-130,5.2,PNC Park,12,10
2019-08-21,2019,CIN,SD,4,2,-160,-1.5,120,8.5,-115,-105,150,1.5,-140,5.23,Great American Ballpark,6,2
2019-08-21,2019,TB,SEA,7,6,-320,-1.5,-145,8.0,-120,100,280,1.5,125,6.1,Tropicana Field,13,1
2019-08-21,2019,CHC,SF,12,11,-250,-1.5,-120,9.0,-105,-115,220,1.5,100,6.43,Wrigley Field,23,1
2019-08-21,2019,MIL,STL,5,3,-108,1.5,-210,8.5,-125,105,-102,-1.5,185,4.41,Busch Stadium,8,2
2019-08-21,2019,SEA,TB,6,7,280,1.5,125,8.0,-120,100,-320,-1.5,-145,2.11,Tropicana Field,13,-1
2019-08-21,2019,LAA,TEX,7,8,108,1.5,-160,10.5,-110,-110,-118,-1.5,140,5.05,Rangers Ballpark,15,-1
2019-08-21,2019,LAD,TOR,2,1,-380,-1.5,-180,8.5,-120,100,320,1.5,160,6.73,Dodger Stadium,3,1
2019-08-21,2019,PIT,WSH,1,11,127,1.5,-130,9.0,100,-120,-137,-1.5,110,3.96,PNC Park,12,-10
2019-08-22,2019,MIA,ATL,2,3,245,1.5,120,9.0,-115,-105,-280,-1.5,-140,2.61,Suntrust Park,5,-1
2019-08-22,2019,TB,BAL,5,2,-210,-1.5,-145,10.0,-105,-115,190,1.5,125,6.77,Camden Yards,7,3
2019-08-22,2019,SF,CHC,0,1,170,1.5,-135,7.5,-115,-105,-185,-1.5,115,2.78,Wrigley Field,1,-1
2019-08-22,2019,NYM,CLE,2,0,-125,-1.5,160,8.5,-105,-115,115,1.5,-180,4.72,Citi Field,2,2
2019-08-22,2019,STL,COL,6,5,-128,-1.5,170,8.0,-105,-115,118,1.5,-190,4.49,Busch Stadium,11,1
2019-08-22,2019,TEX,CWS,1,6,-116,-1.5,130,10.5,-115,-105,106,1.5,-150,5.64,Guaranteed Rate Field,7,-5
2019-08-22,2019,HOU,DET,6,3,-550,-1.5,-230,8.0,-120,100,425,1.5,200,6.77,Minute Maid Park,9,3
2019-08-22,2019,DET,HOU,3,6,425,1.5,200,8.0,-120,100,-550,-1.5,-230,1.52,Minute Maid Park,9,-3
2019-08-22,2019,TOR,LAD,2,3,210,1.5,105,9.5,100,-120,-240,-1.5,-125,3.06,Dodger Stadium,5,-1
2019-08-22,2019,ATL,MIA,3,2,-280,-1.5,-140,9.0,-115,-105,245,1.5,120,6.63,Suntrust Park,5,1
2019-08-22,2019,CLE,NYM,0,2,115,1.5,-180,8.5,-105,-115,-125,-1.5,160,3.95,Citi Field,2,-2
2019-08-22,2019,OAK,NYY,5,3,110,1.5,-145,9.5,-105,-115,-120,-1.5,125,4.52,Oakland Coliseum,8,2
2019-08-22,2019,NYY,OAK,3,5,-120,-1.5,125,9.5,-105,-115,110,1.5,-145,5.18,Oakland Coliseum,8,-2
2019-08-22,2019,WSH,PIT,7,1,-205,-1.5,-135,9.0,-110,-110,185,1.5,115,6.05,PNC Park,8,6
2019-08-22,2019,CHC,SF,1,0,-185,-1.5,115,7.5,-115,-105,170,1.5,-135,4.87,Wrigley Field,1,1
2019-08-22,2019,COL,STL,5,6,118,1.5,-190,8.0,-105,-115,-128,-1.5,170,3.67,Busch Stadium,11,-1
2019-08-22,2019,BAL,TB,2,5,190,1.5,125,10.0,-105,-115,-210,-1.5,-145,3.45,Camden Yards,7,-3
2019-08-22,2019,CWS,TEX,6,1,106,1.5,-150,10.5,-115,-105,-116,-1.5,130,5.1,Guaranteed Rate Field,7,5
2019-08-22,2019,LAD,TOR,3,2,-240,-1.5,-125,9.5,100,-120,210,1.5,105,6.71,Dodger Stadium,5,1
2019-08-22,2019,PIT,WSH,1,7,185,1.5,115,9.0,-110,-110,-205,-1.5,-135,3.16,PNC Park,8,-6
2019-08-23,2019,MIL,ARI,6,1,-148,-1.5,125,10.0,105,-125,138,1.5,-145,5.97,Miller Park,7,5
2019-08-23,2019,NYM,ATL,1,2,-176,-1.5,115,7.5,-115,-105,163,1.5,-135,4.78,Citi Field,3,-1
2019-08-23,2019,TB,BAL,7,1,-200,-1.5,-135,10.5,-105,-115,180,1.5,115,7.0,Camden Yards,8,6
2019-08-23,2019,SD,BOS,0,11,107,1.5,-155,8.0,-115,-105,-117,-1.5,135,3.86,PETCO Park,11,-11
2019-08-23,2019,WSH,CHC,9,3,117,1.5,-175,8.5,-125,105,-127,-1.5,155,3.92,Wrigley Field,12,6
2019-08-23,2019,PIT,CIN,3,2,-115,-1.5,170,9.0,100,-120,105,1.5,-190,4.81,PNC Park,5,1
2019-08-23,2019,KC,CLE,1,4,175,1.5,-125,9.0,-105,-115,-190,-1.5,105,3.27,Progressive Field,5,-3
2019-08-23,2019,STL,COL,8,3,-250,-1.5,-125,8.0,-115,-105,220,1.5,105,5.71,Busch Stadium,11,5
2019-08-23,2019,TEX,CWS,3,8,-138,-1.5,115,8.5,-120,100,128,1.5,-135,4.93,Guaranteed Rate Field,11,-5
2019-08-23,2019,MIN,DET,6,9,-330,-1.5,-170,9.5,-105,-115,285,1.5,150,7.29,Target Field,15,-3
2019-08-23,2019,LAA,HOU,4,5,220,1.5,115,9.5,-105,-115,-250,-1.5,-135,2.97,Minute Maid Park,9,-1
2019-08-23,2019,CLE,KC,4,1,-190,-1.5,105,9.0,-105,-115,175,1.5,-125,5.9,Progressive Field,5,3
2019-08-23,2019,HOU,LAA,5,4,-250,-1.5,-135,9.5,-105,-115,220,1.5,115,6.79,Minute Maid Park,9,1
2019-08-23,2019,NYY,LAD,10,2,135,1.5,-155,8.5,-105,-115,-145,-1.5,135,3.62,Dodger Stadium,12,8
2019-08-23,2019,PHI,MIA,11,19,-160,-1.5,-115,9.0,-105,-115,150,1.5,-105,5.54,Marlins Park,30,-8
2019-08-23,2019,ARI,MIL,1,6,138,1.5,-145,10.0,105,-125,-148,-1.5,125,4.2,Miller Park,7,-5
2019-08-23,2019,DET,MIN,9,6,285,1.5,150,9.5,-105,-115,-330,-1.5,-170,2.47,Target Field,15,3
2019-08-23,2019,ATL,NYM,2,1,163,1.5,-135,7.5,-115,-105,-176,-1.5,115,2.85,Citi Field,3,1
2019-08-23,2019,LAD,NYY,2,10,-145,-1.5,135,8.5,-105,-115,135,1.5,-155,5.03,Dodger Stadium,12,-8
2019-08-23,2019,MIA,PHI,19,11,150,1.5,-105,9.0,-105,-115,-160,-1.5,-115,3.6,Marlins Park,30,8
2019-08-23,2019,CIN,PIT,2,3,105,1.5,-190,9.0,100,-120,-115,-1.5,170,4.39,PNC Park,5,-1
2019-08-23,2019,BOS,SD,11,0,-117,-1.5,135,8.0,-115,-105,107,1.5,-155,4.31,PETCO Park,11,11
2019-08-23,2019,TOR,SEA,4,7,-102,-1.5,140,9.5,-115,-105,-108,1.5,-160,4.8,T-Mobile Park,11,-3
2019-08-23,2019,COL,STL,3,8,220,1.5,105,8.0,-115,-105,-250,-1.5,-125,2.5,Busch Stadium,11,-5
2019-08-23,2019,BAL,TB,1,7,180,1.5,115,10.5,-105,-115,-200,-1.5,-135,3.75,Camden Yards,8,-6
2019-08-23,2019,CWS,TEX,8,3,128,1.5,-135,8.5,-120,100,-138,-1.5,115,3.73,Guaranteed Rate Field,11,5
2019-08-23,2019,SEA,TOR,7,4,-108,1.5,-160,9.5,-115,-105,-102,-1.5,140,4.93,T-Mobile Park,11,3
2019-08-23,2019,CHC,WSH,3,9,-127,-1.5,155,8.5,-125,105,117,1.5,-175,4.76,Wrigley Field,12,-6
2019-08-24,2019,MIL,ARI,4,0,-128,-1.5,160,8.5,-115,-105,118,1.5,-180,4.77,Miller Park,4,4
2019-08-24,2019,NYM,ATL,5,9,-108,-1.5,180,8.0,-115,-105,-102,1.5,-205,4.15,Citi Field,14,-4
2019-08-24,2019,TB,BAL,1,7,-185,-1.5,-120,9.5,-115,-105,170,1.5,100,6.17,Camden Yards,8,-6
2019-08-24,2019,SD,BOS,4,5,110,1.5,-150,9.0,100,-120,-120,-1.5,130,4.29,PETCO Park,9,-1
2019-08-24,2019,WSH,CHC,7,2,155,1.5,-140,9.0,-120,100,-165,-1.5,120,3.53,Wrigley Field,9,5
2019-08-24,2019,PIT,CIN,14,0,-102,1.5,-165,8.5,-115,-105,-108,-1.5,145,4.29,PNC Park,14,14
2019-08-24,2019,KC,CLE,2,4,300,1.5,145,9.0,-110,-110,-350,-1.5,-165,2.25,Progressive Field,6,-2
2019-08-24,2019,STL,COL,6,0,-185,-1.5,105,9.0,-105,-115,170,1.5,-125,5.84,Busch Stadium,6,6
2019-08-24,2019,TEX,CWS,4,0,120,1.5,-160,9.5,-105,-115,-130,-1.5,140,4.32,Guaranteed Rate Field,4,4
2019-08-24,2019,MIN,DET,8,5,-350,-1.5,-170,10.0,-115,-105,300,1.5,150,7.78,Target Field,13,3
2019-08-24,2019,LAA,HOU,2,5,175,1.5,-110,10.5,-115,-105,-190,-1.5,-110,3.82,Minute Maid Park,7,-3
2019-08-24,2019,CLE,KC,4,2,-350,-1.5,-165,9.0,-110,-110,300,1.5,145,7.0,Progressive Field,6,2
2019-08-24,2019,HOU,LAA,5,2,-190,-1.5,-110,10.5,-115,-105,175,1.5,-110,6.88,Minute Maid Park,7,3
2019-08-24,2019,NYY,LAD,1,2,126,1.5,-155,9.5,-115,-105,-136,-1.5,135,4.2,Dodger Stadium,3,-1
2019-08-24,2019,PHI,MIA,9,3,-132,-1.5,120,9.0,100,-120,122,1.5,-140,5.12,Marlins Park,12,6
2019-08-24,2019,ARI,MIL,0,4,118,1.5,-180,8.5,-115,-105,-128,-1.5,160,3.9,Miller Park,4,-4
2019-08-24,2019,DET,MIN,5,8,300,1.5,150,10.0,-115,-105,-350,-1.5,-170,2.5,Target Field,13,-3
2019-08-24,2019,ATL,NYM,9,5,-102,1.5,-205,8.0,-115,-105,-108,-1.5,180,4.04,Citi Field,14,4
2019-08-24,2019,LAD,NYY,2,1,-136,-1.5,135,9.5,-115,-105,126,1.5,-155,5.47,Dodger Stadium,3,1
2019-08-24,2019,SF,OAK,10,5,135,1.5,-155,8.5,-115,-105,-145,-1.5,135,3.62,Oakland Coliseum,15,5
2019-08-24,2019,MIA,PHI,3,9,122,1.5,-140,9.0,100,-120,-132,-1.5,120,4.05,Marlins Park,12,-6
2019-08-24,2019,CIN,PIT,0,14,-108,-1.5,145,8.5,-115,-105,-102,1.5,-165,4.41,PNC Park,14,-14
2019-08-24,2019,BOS,SD,5,4,-120,-1.5,130,9.0,100,-120,110,1.5,-150,4.91,PETCO Park,9,1
2019-08-24,2019,TOR,SEA,7,5,102,1.5,-185,9.5,-120,100,-112,-1.5,165,4.7,T-Mobile Park,12,2
2019-08-24,2019,OAK,SF,5,10,-145,-1.5,135,8.5,-115,-105,135,1.5,-155,5.03,Oakland Coliseum,15,-5
2019-08-24,2019,COL,STL,0,6,170,1.5,-125,9.0,-105,-115,-185,-1.5,105,3.33,Busch Stadium,6,-6
2019-08-24,2019,BAL,TB,7,1,170,1.5,100,9.5,-115,-105,-185,-1.5,-120,3.52,Camden Yards,8,6
2019-08-24,2019,CWS,TEX,0,4,-130,-1.5,140,9.5,-105,-115,120,1.5,-160,5.37,Guaranteed Rate Field,4,-4
2019-08-24,2019,SEA,TOR,5,7,-112,-1.5,165,9.5,-120,100,102,1.5,-185,5.02,T-Mobile Park,12,-2
2019-08-24,2019,CHC,WSH,2,7,-165,-1.5,120,9.0,-120,100,155,1.5,-140,5.6,Wrigley Field,9,-5
2019-08-25,2019,MIL,ARI,2,5,-115,-1.5,170,9.0,-115,-105,105,1.5,-190,4.81,Miller Park,7,-3
2019-08-25,2019,NYM,ATL,1,2,-106,-1.5,185,8.5,-115,-105,-104,1.5,-210,4.37,Citi Field,3,-1
2019-08-25,2019,TB,BAL,3,8,-165,-1.5,-115,9.5,-115,-105,155,1.5,-105,5.92,Camden Yards,11,-5
2019-08-25,2019,SD,BOS,3,1,-112,-1.5,175,9.5,100,-120,102,1.5,-200,5.02,PETCO Park,4,2
2019-08-25,2019,WSH,CHC,7,5,-127,-1.5,120,8.5,-110,-110,117,1.5,-140,4.76,Wrigley Field,12,2
2019-08-25,2019,PIT,CIN,9,8,124,1.5,-135,8.5,-120,100,-134,-1.5,115,3.79,PNC Park,17,1
2019-08-25,2019,KC,CLE,9,8,310,1.5,145,9.0,-115,-105,-360,-1.5,-165,2.2,Progressive Field,17,1
2019-08-25,2019,STL,COL,11,4,-180,-1.5,110,9.0,-110,-110,165,1.5,-130,5.79,Busch Stadium,15,7
2019-08-25,2019,TEX,CWS,0,2,112,1.5,-175,9.0,-120,100,-122,-1.5,155,4.25,Guaranteed Rate Field,2,-2
2019-08-25,2019,MIN,DET,7,4,-210,-1.5,-115,9.0,-115,-105,190,1.5,-105,6.1,Target Field,11,3
2019-08-25,2019,LAA,HOU,2,11,170,1.5,-115,10.0,-120,100,-185,-1.5,-105,3.7,Minute Maid Park,13,-9
2019-08-25,2019,CLE,KC,8,9,-360,-1.5,-165,9.0,-115,-105,310,1.5,145,7.04,Progressive Field,17,-1
2019-08-25,2019,HOU,LAA,11,2,-185,-1.5,-105,10.0,-120,100,170,1.5,-115,6.49,Minute Maid Park,13,9
2019-08-25,2019,NYY,LAD,5,1,142,1.5,-155,8.5,-125,105,-152,-1.5,135,3.51,Dodger Stadium,6,4
2019-08-25,2019,PHI,MIA,2,3,-198,-1.5,-120,8.0,-110,-110,179,1.5,100,5.32,Marlins Park,5,-1
2019-08-25,2019,ARI,MIL,5,2,105,1.5,-190,9.0,-115,-105,-115,-1.5,170,4.39,Miller Park,7,3
2019-08-25,2019,DET,MIN,4,7,190,1.5,-105,9.0,-115,-105,-210,-1.5,-115,3.1,Target Field,11,-3
2019-08-25,2019,ATL,NYM,2,1,-104,1.5,-210,8.5,-115,-105,-106,-1.5,185,4.33,Citi Field,3,1
2019-08-25,2019,LAD,NYY,1,5,-152,-1.5,135,8.5,-125,105,142,1.5,-155,5.13,Dodger Stadium,6,-4
2019-08-25,2019,SF,OAK,5,4,153,1.5,-140,9.5,-110,-110,-163,-1.5,120,3.75,Oakland Coliseum,9,1
2019-08-25,2019,MIA,PHI,3,2,179,1.5,100,8.0,-110,-110,-198,-1.5,-120,2.87,Marlins Park,5,1
2019-08-25,2019,CIN,PIT,8,9,-134,-1.5,115,8.5,-120,100,124,1.5,-135,4.87,PNC Park,17,-1
2019-08-25,2019,BOS,SD,1,3,102,1.5,-200,9.5,100,-120,-112,-1.5,175,4.7,PETCO Park,4,-2
2019-08-25,2019,TOR,SEA,1,3,136,1.5,-155,9.5,-110,-110,-146,-1.5,135,4.03,T-Mobile Park,4,-2
2019-08-25,2019,OAK,SF,4,5,-163,-1.5,120,9.5,-110,-110,153,1.5,-140,5.89,Oakland Coliseum,9,-1
2019-08-25,2019,COL,STL,4,11,165,1.5,-130,9.0,-110,-110,-180,-1.5,110,3.4,Busch Stadium,15,-7
2019-08-25,2019,BAL,TB,8,3,155,1.5,-105,9.5,-115,-105,-165,-1.5,-115,3.73,Camden Yards,11,5
2019-08-25,2019,CWS,TEX,2,0,-122,-1.5,155,9.0,-120,100,112,1.5,-175,4.95,Guaranteed Rate Field,2,2
2019-08-25,2019,SEA,TOR,3,1,-146,-1.5,135,9.5,-110,-110,136,1.5,-155,5.64,T-Mobile Park,4,2
2019-08-25,2019,CHC,WSH,5,7,117,1.5,-140,8.5,-110,-110,-127,-1.5,120,3.92,Wrigley Field,12,-2
2019-08-26,2019,SF,ARI,4,6,-105,1.5,-175,8.5,-115,-105,-105,-1.5,155,4.35,AT&T Park,10,-2
2019-08-26,2019,COL,ATL,3,1,140,1.5,-105,13.5,-115,-105,-150,-1.5,-115,5.63,Coors Field,4,2
2019-08-26,2019,MIA,CIN,3,6,145,1.5,-125,7.5,105,-125,-155,-1.5,105,3.06,Marlins Park,9,-3
2019-08-26,2019,ATL,COL,1,3,-150,-1.5,-115,13.5,-115,-105,140,1.5,-105,8.1,Coors Field,4,-2
2019-08-26,2019,OAK,KC,19,4,-154,-1.5,-105,9.0,-115,-105,144,1.5,-115,5.46,Kauffman Stadium,23,15
2019-08-26,2019,SD,LAD,4,3,135,1.5,-120,8.5,-125,105,-145,-1.5,100,3.62,PETCO Park,7,1
2019-08-26,2019,CIN,MIA,6,3,-155,-1.5,105,7.5,105,-125,145,1.5,-125,4.56,Marlins Park,9,3
2019-08-26,2019,STL,MIL,12,2,128,1.5,-155,10.0,100,-120,-138,-1.5,135,4.39,Miller Park,14,10
2019-08-26,2019,SEA,NYY,4,5,160,1.5,105,9.5,-120,100,-170,-1.5,-125,3.65,T-Mobile Park,9,-1
2019-08-26,2019,KC,OAK,4,19,144,1.5,-115,9.0,-115,-105,-154,-1.5,-105,3.69,Kauffman Stadium,23,-15
2019-08-26,2019,PIT,PHI,5,6,132,1.5,-165,9.0,-105,-115,-142,-1.5,145,3.88,Citizens Bank Park,11,-1
2019-08-26,2019,PHI,PIT,6,5,-142,-1.5,145,9.0,-105,-115,132,1.5,-165,5.28,Citizens Bank Park,11,1
2019-08-26,2019,LAD,SD,3,4,-145,-1.5,100,8.5,-125,105,135,1.5,-120,5.03,PETCO Park,7,-1
2019-08-26,2019,NYY,SEA,5,4,-170,-1.5,-125,9.5,-120,100,160,1.5,105,5.98,T-Mobile Park,9,1
2019-08-26,2019,ARI,SF,6,4,-105,-1.5,155,8.5,-115,-105,-105,1.5,-175,4.35,AT&T Park,10,2
2019-08-26,2019,MIL,STL,2,12,-138,-1.5,135,10.0,100,-120,128,1.5,-155,5.8,Miller Park,14,-10
2019-08-27,2019,SF,ARI,2,3,-129,-1.5,160,8.5,100,-120,119,1.5,-180,4.79,AT&T Park,5,-1
2019-08-27,2019,TOR,ATL,3,1,170,1.5,110,9.5,-105,-115,-185,-1.5,-130,3.52,Rogers Centre,4,2
2019-08-27,2019,WSH,BAL,0,2,-350,-1.5,-160,9.5,-110,-110,300,1.5,140,7.39,Nationals Park,2,-2
2019-08-27,2019,COL,BOS,6,10,135,1.5,-110,13.5,100,-120,-145,-1.5,-110,5.74,Coors Field,16,-4
2019-08-27,2019,NYM,CHC,2,5,-102,1.5,-170,8.5,-105,-115,-108,-1.5,150,4.29,Citi Field,7,-3
2019-08-27,2019,MIA,CIN,5,8,150,1.5,-130,7.0,-115,-105,-160,-1.5,110,2.8,Marlins Park,13,-3
2019-08-27,2019,DET,CLE,1,10,145,1.5,-110,9.5,-115,-105,-155,-1.5,-110,3.88,Comerica Park,11,-9
2019-08-27,2019,BOS,COL,10,6,-145,-1.5,-110,13.5,100,-120,135,1.5,-110,7.99,Coors Field,16,4
2019-08-27,2019,MIN,CWS,3,1,-110,-1.5,140,9.0,-120,100,100,1.5,-160,4.71,Guaranteed Rate Field,4,2
2019-08-27,2019,CLE,DET,10,1,-155,-1.5,-110,9.5,-115,-105,145,1.5,-110,5.77,Comerica Park,11,9
2019-08-27,2019,TB,HOU,1,15,176,1.5,-135,7.5,-120,100,-192,-1.5,115,2.72,Minute Maid Park,16,-14
2019-08-27,2019,OAK,KC,2,1,-210,-1.5,-140,10.0,100,-120,190,1.5,120,6.77,Kauffman Stadium,3,1
2019-08-27,2019,TEX,LAA,2,5,150,1.5,-155,8.0,-120,100,-160,-1.5,135,3.2,Angel Stadium,7,-3
2019-08-27,2019,SD,LAD,0,9,175,1.5,-105,8.0,-110,-110,-190,-1.5,-115,2.91,PETCO Park,9,-9
2019-08-27,2019,CIN,MIA,8,5,-160,-1.5,110,7.0,-115,-105,150,1.5,-130,4.31,Marlins Park,13,3
2019-08-27,2019,STL,MIL,6,3,125,1.5,-155,9.5,-105,-115,-135,-1.5,135,4.22,Miller Park,9,3
2019-08-27,2019,CWS,MIN,1,3,100,1.5,-160,9.0,-120,100,-110,-1.5,140,4.5,Guaranteed Rate Field,4,-2
2019-08-27,2019,CHC,NYM,5,2,-108,-1.5,150,8.5,-105,-115,-102,1.5,-170,4.41,Citi Field,7,3
2019-08-27,2019,SEA,NYY,0,7,164,1.5,-105,9.5,-115,-105,-178,-1.5,-115,3.6,T-Mobile Park,7,-7
2019-08-27,2019,KC,OAK,1,2,190,1.5,120,10.0,100,-120,-210,-1.5,-140,3.45,Kauffman Stadium,3,-1
2019-08-27,2019,PIT,PHI,5,4,130,1.5,-155,10.0,-110,-110,-140,-1.5,135,4.35,Citizens Bank Park,9,1
2019-08-27,2019,PHI,PIT,4,5,-140,-1.5,135,10.0,-110,-110,130,1.5,-155,5.83,Citizens Bank Park,9,-1
2019-08-27,2019,LAD,SD,9,0,-190,-1.5,-115,8.0,-110,-110,175,1.5,-105,5.24,PETCO Park,9,9
2019-08-27,2019,NYY,SEA,7,0,-178,-1.5,-115,9.5,-115,-105,164,1.5,-105,6.08,T-Mobile Park,7,7
2019-08-27,2019,ARI,SF,3,2,119,1.5,-180,8.5,100,-120,-129,-1.5,160,3.88,AT&T Park,5,1
2019-08-27,2019,MIL,STL,3,6,-135,-1.5,135,9.5,-105,-115,125,1.5,-155,5.46,Miller Park,9,-3
2019-08-27,2019,HOU,TB,15,1,-192,-1.5,115,7.5,-120,100,176,1.5,-135,4.93,Minute Maid Park,16,14
2019-08-27,2019,LAA,TEX,5,2,-160,-1.5,135,8.0,-120,100,150,1.5,-155,4.92,Angel Stadium,7,3
2019-08-27,2019,ATL,TOR,1,3,-185,-1.5,-130,9.5,-105,-115,170,1.5,110,6.17,Rogers Centre,4,-2
2019-08-27,2019,BAL,WSH,2,0,300,1.5,140,9.5,-110,-110,-350,-1.5,-160,2.38,Nationals Park,2,2
2019-08-28,2019,TOR,ATL,4,9,116,1.5,-140,10.0,-105,-115,-126,-1.5,120,4.63,Rogers Centre,13,-5
2019-08-28,2019,WSH,BAL,8,4,-400,-1.5,-185,9.0,-115,-105,330,1.5,165,7.2,Nationals Park,12,4
2019-08-28,2019,COL,BOS,4,7,170,1.5,120,13.5,-115,-105,-185,-1.5,-140,5.0,Coors Field,11,-3
2019-08-28,2019,NYM,CHC,7,10,-119,-1.5,170,7.5,105,-125,109,1.5,-190,4.08,Citi Field,17,-3
2019-08-28,2019,MIA,CIN,0,5,144,1.5,-130,8.0,-110,-110,-154,-1.5,110,3.28,Marlins Park,5,-5
2019-08-28,2019,DET,CLE,2,4,205,1.5,135,9.5,-110,-110,-230,-1.5,-155,3.11,Comerica Park,6,-2
2019-08-28,2019,BOS,COL,7,4,-185,-1.5,-140,13.5,-115,-105,170,1.5,120,8.76,Coors Field,11,3
2019-08-28,2019,MIN,CWS,8,2,-200,-1.5,-140,10.5,-115,-105,180,1.5,120,7.0,Guaranteed Rate Field,10,6
2019-08-28,2019,CLE,DET,4,2,-230,-1.5,-155,9.5,-110,-110,205,1.5,135,6.62,Comerica Park,6,2
2019-08-28,2019,TB,HOU,6,8,205,1.5,-110,8.0,-110,-110,-230,-1.5,-110,2.62,Minute Maid Park,14,-2
2019-08-28,2019,OAK,KC,4,6,-162,-1.5,-115,9.0,-115,-105,152,1.5,-105,5.56,Kauffman Stadium,10,-2
2019-08-28,2019,TEX,LAA,3,0,149,1.5,-135,9.5,-105,-115,-159,-1.5,115,3.82,Angel Stadium,3,3
2019-08-28,2019,SD,LAD,4,6,165,1.5,-105,9.0,-105,-115,-180,-1.5,-115,3.4,PETCO Park,10,-2
2019-08-28,2019,CIN,MIA,5,0,-154,-1.5,110,8.0,-110,-110,144,1.5,-130,4.85,Marlins Park,5,5
2019-08-28,2019,STL,MIL,1,4,-125,-1.5,120,9.0,-105,-115,115,1.5,-140,5.0,Miller Park,5,-3
2019-08-28,2019,CWS,MIN,2,8,180,1.5,120,10.5,-115,-105,-200,-1.5,-140,3.75,Guaranteed Rate Field,10,-6
2019-08-28,2019,CHC,NYM,10,7,109,1.5,-190,7.5,105,-125,-119,-1.5,170,3.59,Citi Field,17,3
2019-08-28,2019,SEA,NYY,3,7,230,1.5,140,9.5,100,-120,-260,-1.5,-160,2.88,T-Mobile Park,10,-4
2019-08-28,2019,KC,OAK,6,4,152,1.5,-105,9.0,-115,-105,-162,-1.5,-115,3.57,Kauffman Stadium,10,2
2019-08-28,2019,PIT,PHI,3,12,136,1.5,-145,9.5,-115,-105,-146,-1.5,125,4.03,Citizens Bank Park,15,-9
2019-08-28,2019,PHI,PIT,12,3,-146,-1.5,125,9.5,-115,-105,136,1.5,-145,5.64,Citizens Bank Park,15,9
2019-08-28,2019,LAD,SD,6,4,-180,-1.5,-115,9.0,-105,-115,165,1.5,-105,5.79,PETCO Park,10,2
2019-08-28,2019,NYY,SEA,7,3,-260,-1.5,-160,9.5,100,-120,230,1.5,140,6.86,T-Mobile Park,10,4
2019-08-28,2019,MIL,STL,4,1,115,1.5,-140,9.0,-105,-115,-125,-1.5,120,4.19,Miller Park,5,3
2019-08-28,2019,HOU,TB,8,6,-230,-1.5,-110,8.0,-110,-110,205,1.5,-110,5.58,Minute Maid Park,14,2
2019-08-28,2019,LAA,TEX,0,3,-159,-1.5,115,9.5,-105,-115,149,1.5,-135,5.83,Angel Stadium,3,-3
2019-08-28,2019,ATL,TOR,9,4,-126,-1.5,120,10.0,-105,-115,116,1.5,-140,5.58,Rogers Centre,13,5
2019-08-28,2019,BAL,WSH,4,8,330,1.5,165,9.0,-115,-105,-400,-1.5,-185,2.09,Nationals Park,12,-4
2019-08-29,2019,LAD,ARI,5,11,-200,-1.5,-130,9.5,100,-120,180,1.5,110,6.33,Chase Field,16,-6
2019-08-29,2019,NYM,CHC,1,4,-185,-1.5,115,7.5,100,-120,170,1.5,-135,4.87,Citi Field,5,-3
2019-08-29,2019,MIA,CIN,4,3,150,1.5,-110,9.0,100,-120,-160,-1.5,-110,3.6,Marlins Park,7,1
2019-08-29,2019,DET,CLE,0,2,245,1.5,155,8.5,-105,-115,-280,-1.5,-175,2.46,Comerica Park,2,-2
2019-08-29,2019,PIT,COL,11,8,-108,1.5,-175,14.5,-120,100,-102,-1.5,155,7.53,Coors Field,19,3
2019-08-29,2019,MIN,CWS,10,5,-176,-1.5,-130,10.5,-105,-115,163,1.5,110,6.7,Guaranteed Rate Field,15,5
2019-08-29,2019,CLE,DET,2,0,-280,-1.5,-175,8.5,-105,-115,245,1.5,155,6.26,Comerica Park,2,2
2019-08-29,2019,TB,HOU,9,8,205,1.5,110,9.0,-120,100,-230,-1.5,-130,2.95,Minute Maid Park,17,1
2019-08-29,2019,OAK,KC,9,8,-240,-1.5,-145,10.5,-115,-105,210,1.5,125,7.41,Kauffman Stadium,17,1
2019-08-29,2019,ARI,LAD,11,5,180,1.5,110,9.5,100,-120,-200,-1.5,-130,3.39,Chase Field,16,6
2019-08-29,2019,CIN,MIA,3,4,-160,-1.5,-110,9.0,100,-120,150,1.5,-110,5.54,Marlins Park,7,-1
2019-08-29,2019,CWS,MIN,5,10,163,1.5,110,10.5,-105,-115,-176,-1.5,-130,3.99,Guaranteed Rate Field,15,-5
2019-08-29,2019,CHC,NYM,4,1,170,1.5,-135,7.5,100,-120,-185,-1.5,115,2.78,Citi Field,5,3
2019-08-29,2019,KC,OAK,8,9,210,1.5,125,10.5,-115,-105,-240,-1.5,-145,3.39,Kauffman Stadium,17,-1
2019-08-29,2019,COL,PIT,8,11,-102,-1.5,155,14.5,-120,100,-108,1.5,-175,7.32,Coors Field,19,-3
2019-08-29,2019,SF,SD,3,5,105,1.5,-160,8.0,-110,-110,-115,-1.5,140,3.9,AT&T Park,8,-2
2019-08-29,2019,TEX,SEA,3,5,-176,-1.5,100,10.5,-120,100,163,1.5,-120,6.7,Rangers Ballpark,8,-2
2019-08-29,2019,SD,SF,5,3,-115,-1.5,140,8.0,-110,-110,105,1.5,-160,4.28,AT&T Park,8,2
2019-08-29,2019,HOU,TB,8,9,-230,-1.5,-130,9.0,-120,100,205,1.5,110,6.27,Minute Maid Park,17,-1
2019-08-29,2019,SEA,TEX,5,3,163,1.5,-120,10.5,-120,100,-176,-1.5,100,3.99,Rangers Ballpark,8,2
2019-08-30,2019,LAD,ARI,4,5,-118,-1.5,130,9.0,-120,100,108,1.5,-150,4.87,Chase Field,9,-1
2019-08-30,2019,CWS,ATL,7,10,190,1.5,-110,9.5,-105,-115,-210,-1.5,-110,3.28,Suntrust Park,17,-3
2019-08-30,2019,KC,BAL,2,14,-108,-1.5,160,10.0,-105,-115,-102,1.5,-180,5.19,Kauffman Stadium,16,-12
2019-08-30,2019,LAA,BOS,6,7,113,1.5,-140,10.5,-105,-115,-123,-1.5,120,4.93,Angel Stadium,13,-1
2019-08-30,2019,MIL,CHC,1,7,116,1.5,-170,8.0,-115,-105,-126,-1.5,150,3.7,Wrigley Field,8,-6
2019-08-30,2019,TB,CLE,4,0,122,1.5,-135,8.0,-115,-105,-132,-1.5,115,3.6,Tropicana Field,4,4
2019-08-30,2019,PIT,COL,9,4,123,1.5,-145,14.5,-105,-115,-133,-1.5,125,6.5,Coors Field,13,5
2019-08-30,2019,ATL,CWS,10,7,-210,-1.5,-110,9.5,-105,-115,190,1.5,-110,6.44,Suntrust Park,17,3
2019-08-30,2019,MIN,DET,13,5,-280,-1.5,-180,10.0,-115,-105,245,1.5,160,7.37,Comerica Park,18,8
2019-08-30,2019,TOR,HOU,4,7,180,1.5,120,10.5,-105,-115,-200,-1.5,-140,3.75,Rogers Centre,11,-3
2019-08-30,2019,BAL,KC,14,2,-102,1.5,-180,10.0,-105,-115,-108,-1.5,160,5.05,Kauffman Stadium,16,12
2019-08-30,2019,BOS,LAA,7,6,-123,-1.5,120,10.5,-105,-115,113,1.5,-140,5.79,Angel Stadium,13,1
2019-08-30,2019,ARI,LAD,5,4,108,1.5,-150,9.0,-120,100,-118,-1.5,130,4.33,Chase Field,9,1
2019-08-30,2019,WSH,MIA,7,6,-260,-1.5,-140,10.0,-105,-115,230,1.5,120,7.22,Nationals Park,13,1
2019-08-30,2019,CHC,MIL,7,1,-126,-1.5,150,8.0,-115,-105,116,1.5,-170,4.46,Wrigley Field,8,6
2019-08-30,2019,DET,MIN,5,13,245,1.5,160,10.0,-115,-105,-280,-1.5,-180,2.9,Comerica Park,18,-8
2019-08-30,2019,PHI,NYM,5,11,-148,-1.5,135,9.0,-105,-115,138,1.5,-155,5.37,Citizens Bank Park,16,-6
2019-08-30,2019,OAK,NYY,8,2,124,1.5,-155,11.0,-115,-105,-134,-1.5,135,4.91,Yankee Stadium,10,6
2019-08-30,2019,NYY,OAK,2,8,-134,-1.5,135,11.0,-115,-105,124,1.5,-155,6.3,Yankee Stadium,10,-6
2019-08-30,2019,NYM,PHI,11,5,138,1.5,-155,9.0,-105,-115,-148,-1.5,135,3.78,Citizens Bank Park,16,6
2019-08-30,2019,COL,PIT,4,9,-133,-1.5,125,14.5,-105,-115,123,1.5,-145,8.28,Coors Field,13,-5
2019-08-30,2019,SF,SD,8,3,-127,-1.5,170,7.5,-110,-110,117,1.5,-190,4.2,AT&T Park,11,5
2019-08-30,2019,TEX,SEA,6,3,-112,-1.5,140,10.5,-105,-115,102,1.5,-160,5.55,Rangers Ballpark,9,3
2019-08-30,2019,SD,SF,3,8,117,1.5,-190,7.5,-110,-110,-127,-1.5,170,3.46,AT&T Park,11,-5
2019-08-30,2019,CLE,TB,0,4,-132,-1.5,115,8.0,-115,-105,122,1.5,-135,4.55,Tropicana Field,4,-4
2019-08-30,2019,SEA,TEX,3,6,102,1.5,-160,10.5,-105,-115,-112,-1.5,140,5.2,Rangers Ballpark,9,-3
2019-08-30,2019,HOU,TOR,7,4,-200,-1.5,-140,10.5,-105,-115,180,1.5,120,7.0,Rogers Centre,11,3
2019-08-30,2019,MIA,WSH,6,7,230,1.5,120,10.0,-105,-115,-260,-1.5,-140,3.03,Nationals Park,13,-1
2019-08-31,2019,LAD,ARI,5,6,-142,-1.5,110,8.5,100,-120,132,1.5,-130,4.99,Chase Field,11,-1
2019-08-31,2019,CWS,ATL,5,11,190,1.5,-115,9.0,-115,-105,-210,-1.5,-105,3.1,Suntrust Park,16,-6
2019-08-31,2019,KC,BAL,7,5,106,1.5,-150,9.5,-110,-110,-116,-1.5,130,4.61,Kauffman Stadium,12,2
2019-08-31,2019,LAA,BOS,10,4,-102,-1.5,175,10.5,-120,100,-108,1.5,-195,5.3,Angel Stadium,14,6
2019-08-31,2019,MIL,CHC,2,0,159,1.5,-140,8.5,-110,-110,-169,-1.5,120,3.28,Wrigley Field,2,2
2019-08-31,2019,STL,CIN,10,6,-130,-1.5,150,8.5,-105,-115,120,1.5,-170,4.8,Busch Stadium,16,4
2019-08-31,2019,STL,CIN,3,2,100,1.5,-160,8.0,-115,-105,-110,-1.5,140,4.0,Busch Stadium,5,1
2019-08-31,2019,TB,CLE,9,6,-128,-1.5,165,8.5,-105,-115,118,1.5,-185,4.77,Tropicana Field,15,3
2019-08-31,2019,PIT,COL,11,4,-130,-1.5,110,13.5,-105,-115,120,1.5,-130,7.63,Coors Field,15,7
2019-08-31,2019,ATL,CWS,11,5,-210,-1.5,-105,9.0,-115,-105,190,1.5,-115,6.1,Suntrust Park,16,6
2019-08-31,2019,MIN,DET,7,10,-155,-1.5,-105,9.5,-105,-115,145,1.5,-115,5.77,Comerica Park,17,-3
2019-08-31,2019,TOR,HOU,6,4,157,1.5,-110,10.5,100,-120,-167,-1.5,-110,4.09,Rogers Centre,10,2
2019-08-31,2019,BAL,KC,5,7,-116,-1.5,130,9.5,-110,-110,106,1.5,-150,5.1,Kauffman Stadium,12,-2
2019-08-31,2019,BOS,LAA,4,10,-108,1.5,-195,10.5,-120,100,-102,-1.5,175,5.45,Angel Stadium,14,-6
2019-08-31,2019,ARI,LAD,6,5,132,1.5,-130,8.5,100,-120,-142,-1.5,110,3.66,Chase Field,11,1
2019-08-31,2019,WSH,MIA,7,0,-320,-1.5,-150,8.5,-110,-110,280,1.5,130,6.48,Nationals Park,7,7
2019-08-31,2019,CHC,MIL,0,2,-169,-1.5,120,8.5,-110,-110,159,1.5,-140,5.34,Wrigley Field,2,-2
2019-08-31,2019,DET,MIN,10,7,145,1.5,-115,9.5,-105,-115,-155,-1.5,-105,3.88,Comerica Park,17,3
2019-08-31,2019,PHI,NYM,3,6,106,1.5,-155,9.5,-120,100,-116,-1.5,135,4.61,Citizens Bank Park,9,-3
2019-08-31,2019,OAK,NYY,3,4,185,1.5,-105,11.0,-105,-115,-205,-1.5,-115,3.86,Yankee Stadium,7,-1
2019-08-31,2019,NYY,OAK,4,3,-205,-1.5,-115,11.0,-105,-115,185,1.5,-105,7.39,Yankee Stadium,7,1
2019-08-31,2019,NYM,PHI,6,3,-116,-1.5,135,9.5,-120,100,106,1.5,-155,5.1,Citizens Bank Park,9,3
2019-08-31,2019,COL,PIT,4,11,120,1.5,-130,13.5,-105,-115,-130,-1.5,110,6.14,Coors Field,15,-7
2019-08-31,2019,SF,SD,1,4,-112,1.5,-175,8.5,-105,-115,102,-1.5,155,4.49,AT&T Park,5,-3
2019-08-31,2019,TEX,SEA,3,2,-130,-1.5,135,10.0,-120,100,120,1.5,-155,5.65,Rangers Ballpark,5,1
2019-08-31,2019,SD,SF,4,1,102,-1.5,155,8.5,-105,-115,-112,1.5,-175,4.21,AT&T Park,5,3
2019-08-31,2019,CIN,STL,6,10,120,1.5,-170,8.5,-105,-115,-130,-1.5,150,3.86,Busch Stadium,16,-4
2019-08-31,2019,CIN,STL,2,3,-110,-1.5,140,8.0,-115,-105,100,1.5,-160,4.19,Busch Stadium,5,-1
2019-08-31,2019,CLE,TB,6,9,118,1.5,-185,8.5,-105,-115,-128,-1.5,165,3.9,Tropicana Field,15,-3
2019-08-31,2019,SEA,TEX,2,3,120,1.5,-155,10.0,-120,100,-130,-1.5,135,4.55,Rangers Ballpark,5,-1
2019-08-31,2019,HOU,TOR,4,6,-167,-1.5,-110,10.5,100,-120,157,1.5,-110,6.57,Rogers Centre,10,-2
2019-08-31,2019,MIA,WSH,0,7,280,1.5,130,8.5,-110,-110,-320,-1.5,-150,2.24,Nationals Park,7,-7
2019-09-01,2019,LAD,ARI,4,3,-162,-1.5,100,9.5,-105,-115,152,1.5,-120,5.87,Chase Field,7,1
2019-09-01,2019,CWS,ATL,3,5,126,1.5,-170,8.5,-115,-105,-136,-1.5,150,3.76,Suntrust Park,8,-2
2019-09-01,2019,KC,BAL,6,4,-140,-1.5,135,9.5,100,-120,130,1.5,-155,5.54,Kauffman Stadium,10,2
2019-09-01,2019,LAA,BOS,3,4,100,1.5,-160,9.5,100,-120,-110,-1.5,140,4.75,Angel Stadium,7,-1
2019-09-01,2019,MIL,CHC,4,0,127,1.5,-160,9.5,-105,-115,-137,-1.5,140,4.19,Wrigley Field,4,4
2019-09-01,2019,STL,CIN,4,3,-160,-1.5,130,8.5,-105,-115,150,1.5,-150,5.23,Busch Stadium,7,1
2019-09-01,2019,STL,CIN,3,5,100,-1.5,195,7.5,-105,-115,-110,1.5,-220,3.75,Busch Stadium,8,-2
2019-09-01,2019,TB,CLE,8,2,-196,-1.5,100,8.0,-115,-105,178,1.5,-120,5.3,Tropicana Field,10,6
2019-09-01,2019,PIT,COL,6,2,108,1.5,-170,13.5,-115,-105,-118,-1.5,150,6.49,Coors Field,8,4
2019-09-01,2019,ATL,CWS,5,3,-136,-1.5,150,8.5,-115,-105,126,1.5,-170,4.9,Suntrust Park,8,2
2019-09-01,2019,MIN,DET,8,3,-200,-1.5,-130,9.5,-115,-105,180,1.5,110,6.33,Comerica Park,11,5
2019-09-01,2019,TOR,HOU,0,2,250,1.5,155,9.0,-110,-110,-290,-1.5,-175,2.57,Rogers Centre,2,-2
2019-09-01,2019,BAL,KC,4,6,130,1.5,-155,9.5,100,-120,-140,-1.5,135,4.13,Kauffman Stadium,10,-2
2019-09-01,2019,BOS,LAA,4,3,-110,-1.5,140,9.5,100,-120,100,1.5,-160,4.98,Angel Stadium,7,1
2019-09-01,2019,ARI,LAD,3,4,152,1.5,-120,9.5,-105,-115,-162,-1.5,100,3.77,Chase Field,7,-1
2019-09-01,2019,WSH,MIA,9,3,-310,-1.5,-145,9.0,100,-120,270,1.5,125,6.8,Nationals Park,12,6
2019-09-01,2019,CHC,MIL,0,4,-137,-1.5,140,9.5,-105,-115,127,1.5,-160,5.49,Wrigley Field,4,-4
2019-09-01,2019,DET,MIN,3,8,180,1.5,110,9.5,-115,-105,-200,-1.5,-130,3.39,Comerica Park,11,-5
2019-09-01,2019,PHI,NYM,5,2,100,1.5,-160,9.5,-120,100,-110,-1.5,140,4.75,Citizens Bank Park,7,3
2019-09-01,2019,OAK,NYY,4,5,110,1.5,-165,11.0,-105,-115,-120,-1.5,145,5.24,Yankee Stadium,9,-1
2019-09-01,2019,NYY,OAK,5,4,-120,-1.5,145,11.0,-105,-115,110,1.5,-165,6.0,Yankee Stadium,9,1
2019-09-01,2019,NYM,PHI,2,5,-110,-1.5,140,9.5,-120,100,100,1.5,-160,4.98,Citizens Bank Park,7,-3
2019-09-01,2019,COL,PIT,2,6,-118,-1.5,150,13.5,-115,-105,108,1.5,-170,7.31,Coors Field,8,-4
2019-09-01,2019,SF,SD,4,8,-122,-1.5,165,8.0,-125,105,112,1.5,-185,4.4,AT&T Park,12,-4
2019-09-01,2019,TEX,SEA,3,11,-127,-1.5,145,10.0,-115,-105,117,1.5,-165,5.59,Rangers Ballpark,14,-8
2019-09-01,2019,SD,SF,8,4,112,1.5,-185,8.0,-125,105,-122,-1.5,165,3.77,AT&T Park,12,4
2019-09-01,2019,CIN,STL,3,4,150,1.5,-150,8.5,-105,-115,-160,-1.5,130,3.4,Busch Stadium,7,-1
2019-09-01,2019,CIN,STL,5,3,-110,1.5,-220,7.5,-105,-115,100,-1.5,195,3.93,Busch Stadium,8,2
2019-09-01,2019,CLE,TB,2,8,178,1.5,-120,8.0,-115,-105,-196,-1.5,100,2.88,Tropicana Field,10,-6
2019-09-01,2019,SEA,TEX,11,3,117,1.5,-165,10.0,-115,-105,-127,-1.5,145,4.61,Rangers Ballpark,14,8
2019-09-01,2019,HOU,TOR,2,0,-290,-1.5,-175,9.0,-110,-110,250,1.5,155,6.69,Rogers Centre,2,2
2019-09-01,2019,MIA,WSH,3,9,270,1.5,125,9.0,100,-120,-310,-1.5,-145,2.43,Nationals Park,12,-6
2019-09-02,2019,SD,ARI,7,14,117,1.5,-180,9.0,100,-120,-127,-1.5,160,4.15,Chase Field,21,-7
2019-09-02,2019,TOR,ATL,3,6,245,1.5,115,9.5,-120,100,-280,-1.5,-135,2.75,Suntrust Park,9,-3
2019-09-02,2019,TB,BAL,5,4,-290,-1.5,-150,8.5,-120,100,250,1.5,130,6.32,Tropicana Field,9,1
2019-09-02,2019,SEA,CHC,1,5,260,1.5,115,9.0,-120,100,-300,-1.5,-135,2.5,Wrigley Field,6,-4
2019-09-02,2019,PHI,CIN,7,1,126,1.5,-160,10.0,-115,-105,-136,-1.5,140,4.42,Great American Ballpark,8,6
2019-09-02,2019,CWS,CLE,3,11,205,1.5,110,10.0,-110,-110,-230,-1.5,-130,3.28,Progressive Field,14,-8
2019-09-02,2019,LAD,COL,16,9,-350,-1.5,-175,9.0,-110,-110,300,1.5,155,7.0,Dodger Stadium,25,7
2019-09-02,2019,CLE,CWS,11,3,-230,-1.5,-130,10.0,-110,-110,205,1.5,110,6.97,Progressive Field,14,8
2019-09-02,2019,MIN,DET,4,3,-215,-1.5,-145,10.0,-110,-110,195,1.5,125,6.83,Comerica Park,7,1
2019-09-02,2019,MIL,HOU,2,3,163,1.5,-110,8.5,-120,100,-176,-1.5,-110,3.23,Miller Park,5,-1
2019-09-02,2019,COL,LAD,9,16,300,1.5,155,9.0,-110,-110,-350,-1.5,-175,2.25,Dodger Stadium,25,-7
2019-09-02,2019,HOU,MIL,3,2,-176,-1.5,-110,8.5,-120,100,163,1.5,-110,5.42,Miller Park,5,1
2019-09-02,2019,DET,MIN,3,4,195,1.5,125,10.0,-110,-110,-215,-1.5,-145,3.39,Comerica Park,7,-1
2019-09-02,2019,WSH,NYM,3,7,100,-1.5,185,10.0,-110,-110,-110,1.5,-210,5.0,Nationals Park,10,-4
2019-09-02,2019,TEX,NYY,7,0,190,1.5,-110,9.5,-105,-115,-210,-1.5,-110,3.28,Yankee Stadium,7,7
2019-09-02,2019,CIN,PHI,1,7,-136,-1.5,140,10.0,-115,-105,126,1.5,-160,5.76,Great American Ballpark,8,-6
2019-09-02,2019,ARI,SD,14,7,-127,-1.5,160,9.0,100,-120,117,1.5,-180,5.04,Chase Field,21,7
2019-09-02,2019,CHC,SEA,5,1,-300,-1.5,-135,9.0,-120,100,260,1.5,115,6.75,Wrigley Field,6,4
2019-09-02,2019,STL,SF,3,1,-190,-1.5,100,9.0,100,-120,175,1.5,-120,5.9,Busch Stadium,4,2
2019-09-02,2019,SF,STL,1,3,175,1.5,-120,9.0,100,-120,-190,-1.5,100,3.27,Busch Stadium,4,-2
2019-09-02,2019,BAL,TB,4,5,250,1.5,130,8.5,-120,100,-290,-1.5,-150,2.43,Tropicana Field,9,-1
2019-09-02,2019,NYY,TEX,0,7,-210,-1.5,-110,9.5,-105,-115,190,1.5,-110,6.44,Yankee Stadium,7,-7
2019-09-02,2019,ATL,TOR,6,3,-280,-1.5,-135,9.5,-120,100,245,1.5,115,7.0,Suntrust Park,9,3
2019-09-02,2019,NYM,WSH,7,3,-110,1.5,-210,10.0,-110,-110,100,-1.5,185,5.24,Nationals Park,10,4
2019-09-03,2019,SD,ARI,1,2,140,1.5,-145,9.5,-115,-105,-150,-1.5,125,3.96,Chase Field,3,-1
2019-09-03,2019,TOR,ATL,2,7,180,1.5,-115,10.5,-115,-105,-200,-1.5,-105,3.75,Suntrust Park,9,-5
2019-09-03,2019,TB,BAL,2,4,-280,-1.5,-150,9.5,-115,-105,245,1.5,130,7.0,Tropicana Field,6,-2
2019-09-03,2019,TB,BAL,2,0,-270,-1.5,-145,9.5,-115,-105,240,1.5,125,6.93,Tropicana Field,2,2
2019-09-03,2019,MIN,BOS,6,5,130,1.5,-145,11.5,-110,-110,-140,-1.5,125,5.0,Fenway Park,11,1
2019-09-03,2019,SEA,CHC,1,6,220,1.5,120,10.5,-110,-110,-250,-1.5,-140,3.28,Wrigley Field,7,-5
2019-09-03,2019,PHI,CIN,6,2,-110,1.5,-205,10.5,-105,-115,100,-1.5,180,5.5,Great American Ballpark,8,4
2019-09-03,2019,CWS,CLE,6,5,280,1.5,145,9.0,-115,-105,-320,-1.5,-165,2.37,Progressive Field,11,1
2019-09-03,2019,LAD,COL,5,3,-300,-1.5,-155,10.5,-105,-115,260,1.5,135,7.88,Dodger Stadium,8,2
2019-09-03,2019,CLE,CWS,5,6,-320,-1.5,-165,9.0,-115,-105,280,1.5,145,6.86,Progressive Field,11,-1
2019-09-03,2019,KC,DET,6,5,-145,-1.5,130,9.5,100,-120,135,1.5,-150,5.62,Kauffman Stadium,11,1
2019-09-03,2019,MIL,HOU,4,2,140,1.5,-115,9.5,-105,-115,-150,-1.5,-105,3.96,Miller Park,6,2
2019-09-03,2019,DET,KC,5,6,135,1.5,-150,9.5,100,-120,-145,-1.5,130,4.04,Kauffman Stadium,11,-1
2019-09-03,2019,OAK,LAA,7,5,-165,-1.5,110,9.5,-115,-105,155,1.5,-130,5.92,Oakland Coliseum,12,2
2019-09-03,2019,COL,LAD,3,5,260,1.5,135,10.5,-105,-115,-300,-1.5,-155,2.92,Dodger Stadium,8,-2
2019-09-03,2019,PIT,MIA,4,5,-168,-1.5,120,9.0,-105,-115,158,1.5,-140,5.64,PNC Park,9,-1
2019-09-03,2019,HOU,MIL,2,4,-150,-1.5,-105,9.5,-105,-115,140,1.5,-115,5.7,Miller Park,6,-2
2019-09-03,2019,BOS,MIN,5,6,-140,-1.5,125,11.5,-110,-110,130,1.5,-145,6.71,Fenway Park,11,-1
2019-09-03,2019,WSH,NYM,11,10,-115,-1.5,175,7.5,-110,-110,105,1.5,-200,4.01,Nationals Park,21,1
2019-09-03,2019,TEX,NYY,1,10,280,1.5,140,10.0,100,-120,-320,-1.5,-160,2.63,Yankee Stadium,11,-9
2019-09-03,2019,LAA,OAK,5,7,155,1.5,-130,9.5,-115,-105,-165,-1.5,110,3.73,Oakland Coliseum,12,-2
2019-09-03,2019,CIN,PHI,2,6,100,-1.5,180,10.5,-105,-115,-110,1.5,-205,5.25,Great American Ballpark,8,-4
2019-09-03,2019,MIA,PIT,5,4,158,1.5,-140,9.0,-105,-115,-168,-1.5,120,3.49,PNC Park,9,1
2019-09-03,2019,ARI,SD,2,1,-150,-1.5,125,9.5,-115,-105,140,1.5,-145,5.7,Chase Field,3,1
2019-09-03,2019,CHC,SEA,6,1,-250,-1.5,-140,10.5,-110,-110,220,1.5,120,7.5,Wrigley Field,7,5
2019-09-03,2019,STL,SF,1,0,-290,-1.5,-140,8.5,-105,-115,250,1.5,120,6.32,Busch Stadium,1,1
2019-09-03,2019,SF,STL,0,1,250,1.5,120,8.5,-105,-115,-290,-1.5,-140,2.43,Busch Stadium,1,-1
2019-09-03,2019,BAL,TB,4,2,245,1.5,130,9.5,-115,-105,-280,-1.5,-150,2.75,Tropicana Field,6,2
2019-09-03,2019,BAL,TB,0,2,240,1.5,125,9.5,-115,-105,-270,-1.5,-145,2.79,Tropicana Field,2,-2
2019-09-03,2019,NYY,TEX,10,1,-320,-1.5,-160,10.0,100,-120,280,1.5,140,7.62,Yankee Stadium,11,9
2019-09-03,2019,ATL,TOR,7,2,-200,-1.5,-105,10.5,-115,-105,180,1.5,-115,7.0,Suntrust Park,9,5
2019-09-03,2019,NYM,WSH,10,11,105,1.5,-200,7.5,-110,-110,-115,-1.5,175,3.66,Nationals Park,21,-1
2019-09-04,2019,SD,ARI,1,4,128,1.5,-170,8.0,-110,-110,-138,-1.5,150,3.51,Chase Field,5,-3
2019-09-04,2019,MIN,BOS,2,6,142,1.5,-135,11.0,-115,-105,-152,-1.5,115,4.55,Fenway Park,8,-4
2019-09-04,2019,PHI,CIN,5,8,-152,-1.5,100,9.0,-105,-115,142,1.5,-120,5.43,Great American Ballpark,13,-3
2019-09-04,2019,CWS,CLE,6,8,250,1.5,125,8.5,-105,-115,-290,-1.5,-145,2.43,Progressive Field,14,-2
2019-09-04,2019,LAD,COL,7,3,-300,-1.5,-150,9.5,-110,-110,260,1.5,130,7.13,Dodger Stadium,10,4
2019-09-04,2019,CLE,CWS,8,6,-290,-1.5,-145,8.5,-105,-115,250,1.5,125,6.32,Progressive Field,14,2
2019-09-04,2019,KC,DET,5,4,-220,-1.5,-115,9.5,-110,-110,200,1.5,-105,6.53,Kauffman Stadium,9,1
2019-09-04,2019,DET,KC,4,5,200,1.5,-105,9.5,-110,-110,-220,-1.5,-115,3.17,Kauffman Stadium,9,-1
2019-09-04,2019,OAK,LAA,4,0,-158,-1.5,115,9.5,-105,-115,148,1.5,-135,5.82,Oakland Coliseum,4,4
2019-09-04,2019,COL,LAD,3,7,260,1.5,130,9.5,-110,-110,-300,-1.5,-150,2.64,Dodger Stadium,10,-4
2019-09-04,2019,PIT,MIA,6,5,-172,-1.5,120,9.0,-115,-105,161,1.5,-140,5.69,PNC Park,11,1
2019-09-04,2019,BOS,MIN,6,2,-152,-1.5,115,11.0,-115,-105,142,1.5,-135,6.63,Fenway Park,8,4
2019-09-04,2019,WSH,NYM,4,8,-110,-1.5,165,10.0,-110,-110,100,1.5,-185,5.24,Nationals Park,12,-4
2019-09-04,2019,TEX,NYY,1,4,150,1.5,-135,9.0,-115,-105,-160,-1.5,115,3.6,Yankee Stadium,5,-3
2019-09-04,2019,LAA,OAK,0,4,148,1.5,-135,9.5,-105,-115,-158,-1.5,115,3.83,Oakland Coliseum,4,-4
2019-09-04,2019,CIN,PHI,8,5,142,1.5,-120,9.0,-105,-115,-152,-1.5,100,3.72,Great American Ballpark,13,3
2019-09-04,2019,MIA,PIT,5,6,161,1.5,-140,9.0,-115,-105,-172,-1.5,120,3.45,PNC Park,11,-1
2019-09-04,2019,ARI,SD,4,1,-138,-1.5,150,8.0,-110,-110,128,1.5,-170,4.64,Chase Field,5,3
2019-09-04,2019,STL,SF,8,9,-130,-1.5,155,8.5,100,-120,120,1.5,-175,4.8,Busch Stadium,17,-1
2019-09-04,2019,SF,STL,9,8,120,1.5,-175,8.5,100,-120,-130,-1.5,155,3.86,Busch Stadium,17,1
2019-09-04,2019,NYY,TEX,4,1,-160,-1.5,115,9.0,-115,-105,150,1.5,-135,5.54,Yankee Stadium,5,3
2019-09-04,2019,NYM,WSH,8,4,100,1.5,-185,10.0,-110,-110,-110,-1.5,165,5.0,Nationals Park,12,4
2019-09-05,2019,WSH,ATL,2,4,-109,-1.5,145,9.0,-120,100,-101,1.5,-165,4.69,Suntrust Park,6,-2
2019-09-05,2019,TEX,BAL,3,1,114,1.5,-170,9.5,100,-120,-124,-1.5,150,4.44,Camden Yards,4,2
2019-09-05,2019,MIN,BOS,2,1,130,1.5,-145,11.5,100,-120,-140,-1.5,125,5.0,Fenway Park,3,1
2019-09-05,2019,MIL,CHC,5,10,110,1.5,-150,9.5,100,-120,-120,-1.5,130,4.52,Miller Park,15,-5
2019-09-05,2019,PHI,CIN,3,4,134,1.5,-150,9.0,-115,-105,-144,-1.5,130,3.85,Great American Ballpark,7,-1
2019-09-05,2019,CWS,CLE,7,1,165,1.5,-125,9.5,100,-120,-180,-1.5,105,3.58,Progressive Field,8,6
2019-09-05,2019,CLE,CWS,1,7,-180,-1.5,105,9.5,100,-120,165,1.5,-125,6.11,Progressive Field,8,-6
2019-09-05,2019,KC,DET,4,6,-110,1.5,-175,9.5,-115,-105,100,-1.5,155,4.98,Kauffman Stadium,10,-2
2019-09-05,2019,SEA,HOU,9,11,230,1.5,115,9.0,-120,100,-260,-1.5,-135,2.73,Minute Maid Park,20,-2
2019-09-05,2019,DET,KC,6,4,100,-1.5,155,9.5,-115,-105,-110,1.5,-175,4.75,Kauffman Stadium,10,2
2019-09-05,2019,OAK,LAA,10,6,-160,-1.5,110,10.5,-105,-115,150,1.5,-130,6.46,Oakland Coliseum,16,4
2019-09-05,2019,PIT,MIA,7,10,-145,-1.5,140,9.0,-120,100,135,1.5,-160,5.33,PNC Park,17,-3
2019-09-05,2019,CHC,MIL,10,5,-120,-1.5,130,9.5,100,-120,110,1.5,-150,5.18,Miller Park,15,5
2019-09-05,2019,BOS,MIN,1,2,-140,-1.5,125,11.5,100,-120,130,1.5,-145,6.71,Fenway Park,3,-1
2019-09-05,2019,LAA,OAK,6,10,150,1.5,-130,10.5,-105,-115,-160,-1.5,110,4.2,Oakland Coliseum,16,-4
2019-09-05,2019,CIN,PHI,4,3,-144,-1.5,130,9.0,-115,-105,134,1.5,-150,5.31,Great American Ballpark,7,1
2019-09-05,2019,MIA,PIT,10,7,135,1.5,-160,9.0,-120,100,-145,-1.5,140,3.83,PNC Park,17,3
2019-09-05,2019,HOU,SEA,11,9,-260,-1.5,-135,9.0,-120,100,230,1.5,115,6.5,Minute Maid Park,20,2
2019-09-05,2019,STL,SF,10,0,-190,-1.5,100,8.5,-105,-115,175,1.5,-120,5.57,Busch Stadium,10,10
2019-09-05,2019,SF,STL,0,10,175,1.5,-120,8.5,-105,-115,-190,-1.5,100,3.09,Busch Stadium,10,-10
2019-09-05,2019,TOR,TB,4,6,160,1.5,-120,9.0,-105,-115,-170,-1.5,100,3.46,Tropicana Field,10,-2
2019-09-05,2019,BAL,TEX,1,3,-124,-1.5,150,9.5,100,-120,114,1.5,-170,5.26,Camden Yards,4,-2
2019-09-05,2019,TB,TOR,6,4,-170,-1.5,100,9.0,-105,-115,160,1.5,-120,5.67,Tropicana Field,10,2
2019-09-05,2019,ATL,WSH,4,2,-101,1.5,-165,9.0,-120,100,-109,-1.5,145,4.52,Suntrust Park,6,2
2019-09-06,2019,CIN,ARI,5,7,108,1.5,-150,9.5,100,-120,-118,-1.5,130,4.57,Great American Ballpark,12,-2
2019-09-06,2019,WSH,ATL,3,4,-105,-1.5,145,9.0,-120,100,-105,1.5,-165,4.61,Suntrust Park,7,-1
2019-09-06,2019,TEX,BAL,7,6,122,1.5,-170,9.0,-110,-110,-132,-1.5,150,4.05,Camden Yards,13,1
2019-09-06,2019,NYY,BOS,1,6,-125,-1.5,120,11.0,100,-120,115,1.5,-140,6.11,Fenway Park,7,-5
2019-09-06,2019,MIL,CHC,7,1,102,1.5,-160,9.5,-120,100,-112,-1.5,140,4.7,Miller Park,8,6
2019-09-06,2019,ARI,CIN,7,5,-118,-1.5,130,9.5,100,-120,108,1.5,-150,5.14,Great American Ballpark,12,2
2019-09-06,2019,MIN,CLE,2,6,-167,-1.5,100,10.5,-105,-115,157,1.5,-120,6.57,Target Field,8,-4
2019-09-06,2019,SD,COL,2,3,-168,-1.5,115,9.0,-110,-110,158,1.5,-135,5.64,PETCO Park,5,-1
2019-09-06,2019,LAA,CWS,5,4,139,1.5,-145,9.0,-120,100,-149,-1.5,125,3.77,Guaranteed Rate Field,9,1
2019-09-06,2019,OAK,DET,4,5,-320,-1.5,-145,9.0,-105,-115,280,1.5,125,6.86,Oakland Coliseum,9,-1
2019-09-06,2019,SEA,HOU,4,7,210,1.5,110,10.0,100,-120,-240,-1.5,-130,3.23,Minute Maid Park,11,-3
2019-09-06,2019,MIA,KC,0,3,-120,-1.5,165,8.5,-105,-115,110,1.5,-185,4.64,Marlins Park,3,-3
2019-09-06,2019,CWS,LAA,4,5,-149,-1.5,125,9.0,-120,100,139,1.5,-145,5.39,Guaranteed Rate Field,9,-1
2019-09-06,2019,SF,LAD,5,4,270,1.5,130,8.5,-115,-105,-310,-1.5,-150,2.3,Dodger Stadium,9,1
2019-09-06,2019,KC,MIA,3,0,110,1.5,-185,8.5,-105,-115,-120,-1.5,165,4.05,Marlins Park,3,3
2019-09-06,2019,CHC,MIL,1,7,-112,-1.5,140,9.5,-120,100,102,1.5,-160,5.02,Miller Park,8,-6
2019-09-06,2019,CLE,MIN,6,2,157,1.5,-120,10.5,-105,-115,-167,-1.5,100,4.09,Target Field,8,4
2019-09-06,2019,PHI,NYM,4,5,142,1.5,-150,8.5,-105,-115,-152,-1.5,130,3.51,Citi Field,9,-1
2019-09-06,2019,BOS,NYY,6,1,115,1.5,-140,11.0,100,-120,-125,-1.5,120,5.12,Fenway Park,7,5
2019-09-06,2019,DET,OAK,5,4,280,1.5,125,9.0,-105,-115,-320,-1.5,-145,2.37,Oakland Coliseum,9,1
2019-09-06,2019,NYM,PHI,5,4,-152,-1.5,130,8.5,-105,-115,142,1.5,-150,5.13,Citi Field,9,1
2019-09-06,2019,STL,PIT,4,9,-160,-1.5,-105,9.5,-105,-115,150,1.5,-115,5.85,PNC Park,13,-5
2019-09-06,2019,COL,SD,3,2,158,1.5,-135,9.0,-110,-110,-168,-1.5,115,3.49,PETCO Park,5,1
2019-09-06,2019,HOU,SEA,7,4,-240,-1.5,-130,10.0,100,-120,210,1.5,110,7.06,Minute Maid Park,11,3
2019-09-06,2019,LAD,SF,4,5,-310,-1.5,-150,8.5,-115,-105,270,1.5,130,6.43,Dodger Stadium,9,-1
2019-09-06,2019,PIT,STL,9,4,150,1.5,-115,9.5,-105,-115,-160,-1.5,-105,3.8,PNC Park,13,5
2019-09-06,2019,TOR,TB,0,5,160,1.5,-135,8.5,-105,-115,-170,-1.5,115,3.27,Tropicana Field,5,-5
2019-09-06,2019,BAL,TEX,6,7,-132,-1.5,150,9.0,-110,-110,122,1.5,-170,5.12,Camden Yards,13,-1
2019-09-06,2019,TB,TOR,5,0,-170,-1.5,115,8.5,-105,-115,160,1.5,-135,5.35,Tropicana Field,5,5
2019-09-06,2019,ATL,WSH,4,3,-105,1.5,-165,9.0,-120,100,-105,-1.5,145,4.61,Suntrust Park,7,1
2019-09-07,2019,CIN,ARI,0,2,-155,-1.5,125,8.5,-120,100,145,1.5,-145,5.17,Great American Ballpark,2,-2
2019-09-07,2019,WSH,ATL,4,5,120,1.5,-165,10.0,-115,-105,-130,-1.5,145,4.55,Suntrust Park,9,-1
2019-09-07,2019,TEX,BAL,9,4,-105,-1.5,140,9.5,-110,-110,-105,1.5,-160,4.87,Camden Yards,13,5
2019-09-07,2019,NYY,BOS,5,1,-120,-1.5,120,11.5,-105,-115,110,1.5,-140,6.27,Fenway Park,6,4
2019-09-07,2019,MIL,CHC,3,2,112,1.5,-145,9.0,-120,100,-122,-1.5,125,4.25,Miller Park,5,1
2019-09-07,2019,ARI,CIN,2,0,145,1.5,-145,8.5,-120,100,-155,-1.5,125,3.47,Great American Ballpark,2,2
2019-09-07,2019,MIN,CLE,5,3,-135,-1.5,130,9.5,-105,-115,125,1.5,-150,5.46,Target Field,8,2
2019-09-07,2019,SD,COL,3,0,-158,-1.5,120,8.5,-120,100,148,1.5,-140,5.21,PETCO Park,3,3
2019-09-07,2019,LAA,CWS,8,7,-140,-1.5,105,9.5,100,-120,130,1.5,-125,5.54,Guaranteed Rate Field,15,1
2019-09-07,2019,OAK,DET,10,2,-320,-1.5,-155,9.0,105,-125,280,1.5,135,6.86,Oakland Coliseum,12,8
2019-09-07,2019,SEA,HOU,1,2,350,1.5,175,9.0,-105,-115,-420,-1.5,-200,2.0,Minute Maid Park,3,-1
2019-09-07,2019,MIA,KC,2,7,-106,-1.5,185,8.5,-105,-115,-104,1.5,-210,4.37,Marlins Park,9,-5
2019-09-07,2019,CWS,LAA,7,8,130,1.5,-125,9.5,100,-120,-140,-1.5,105,4.13,Guaranteed Rate Field,15,-1
2019-09-07,2019,SF,LAD,1,0,210,1.5,100,9.5,-105,-115,-240,-1.5,-120,3.06,Dodger Stadium,1,1
2019-09-07,2019,KC,MIA,7,2,-104,1.5,-210,8.5,-105,-115,-106,-1.5,185,4.33,Marlins Park,9,5
2019-09-07,2019,CHC,MIL,2,3,-122,-1.5,125,9.0,-120,100,112,1.5,-145,4.95,Miller Park,5,-1
2019-09-07,2019,CLE,MIN,3,5,125,1.5,-150,9.5,-105,-115,-135,-1.5,130,4.22,Target Field,8,-2
2019-09-07,2019,PHI,NYM,5,0,146,1.5,-145,8.5,-120,100,-156,-1.5,125,3.46,Citi Field,5,5
2019-09-07,2019,BOS,NYY,1,5,110,1.5,-140,11.5,-105,-115,-120,-1.5,120,5.48,Fenway Park,6,-4
2019-09-07,2019,DET,OAK,2,10,280,1.5,135,9.0,105,-125,-320,-1.5,-155,2.37,Oakland Coliseum,12,-8
2019-09-07,2019,NYM,PHI,0,5,-156,-1.5,125,8.5,-120,100,146,1.5,-145,5.18,Citi Field,5,-5
2019-09-07,2019,STL,PIT,10,1,-145,-1.5,105,9.5,-105,-115,135,1.5,-125,5.62,PNC Park,11,9
2019-09-07,2019,COL,SD,0,3,148,1.5,-140,8.5,-120,100,-158,-1.5,120,3.43,PETCO Park,3,-3
2019-09-07,2019,HOU,SEA,2,1,-420,-1.5,-200,9.0,-105,-115,350,1.5,175,7.27,Minute Maid Park,3,1
2019-09-07,2019,LAD,SF,0,1,-240,-1.5,-120,9.5,-105,-115,210,1.5,100,6.71,Dodger Stadium,1,-1
2019-09-07,2019,PIT,STL,1,10,135,1.5,-125,9.5,-105,-115,-145,-1.5,105,4.04,PNC Park,11,-9
2019-09-07,2019,TOR,TB,3,5,230,1.5,100,8.0,-120,100,-260,-1.5,-120,2.42,Tropicana Field,8,-2
2019-09-07,2019,BAL,TEX,4,9,-105,1.5,-160,9.5,-110,-110,-105,-1.5,140,4.87,Camden Yards,13,-5
2019-09-07,2019,TB,TOR,5,3,-260,-1.5,-120,8.0,-120,100,230,1.5,100,5.78,Tropicana Field,8,2
2019-09-07,2019,ATL,WSH,5,4,-130,-1.5,145,10.0,-115,-105,120,1.5,-165,5.65,Suntrust Park,9,1
2019-09-08,2019,CIN,ARI,4,3,-126,-1.5,150,9.0,-120,100,116,1.5,-170,5.02,Great American Ballpark,7,1
2019-09-08,2019,WSH,ATL,9,4,-118,-1.5,125,8.5,-110,-110,108,1.5,-145,4.6,Suntrust Park,13,5
2019-09-08,2019,TEX,BAL,10,4,-135,-1.5,115,9.0,-115,-105,125,1.5,-135,5.17,Camden Yards,14,6
2019-09-08,2019,NYY,BOS,10,5,-117,-1.5,125,11.0,-105,-115,107,1.5,-145,5.93,Fenway Park,15,5
2019-09-08,2019,MIL,CHC,8,5,-128,-1.5,155,9.0,-110,-110,118,1.5,-175,5.05,Miller Park,13,3
2019-09-08,2019,ARI,CIN,3,4,116,1.5,-170,9.0,-120,100,-126,-1.5,150,4.17,Great American Ballpark,7,-1
2019-09-08,2019,MIN,CLE,2,5,140,1.5,-120,8.5,-115,-105,-150,-1.5,100,3.54,Target Field,7,-3
2019-09-08,2019,SD,COL,2,1,-141,-1.5,145,9.0,-110,-110,131,1.5,-165,5.27,PETCO Park,3,1
2019-09-08,2019,LAA,CWS,1,5,-110,-1.5,135,9.5,100,-120,100,1.5,-155,4.98,Guaranteed Rate Field,6,-4
2019-09-08,2019,OAK,DET,3,1,-320,-1.5,-145,9.0,-105,-115,280,1.5,125,6.86,Oakland Coliseum,4,2
2019-09-08,2019,SEA,HOU,1,21,350,1.5,185,9.0,100,-120,-420,-1.5,-210,2.0,Minute Maid Park,22,-20
2019-09-08,2019,MIA,KC,9,0,-101,1.5,-175,8.5,-115,-105,-109,-1.5,155,4.27,Marlins Park,9,9
2019-09-08,2019,CWS,LAA,5,1,100,1.5,-155,9.5,100,-120,-110,-1.5,135,4.75,Guaranteed Rate Field,6,4
2019-09-08,2019,SF,LAD,0,5,210,1.5,-105,8.5,-115,-105,-240,-1.5,-115,2.74,Dodger Stadium,5,-5
2019-09-08,2019,KC,MIA,0,9,-109,-1.5,155,8.5,-115,-105,-101,1.5,-175,4.43,Marlins Park,9,-9
2019-09-08,2019,CHC,MIL,5,8,118,1.5,-175,9.0,-110,-110,-128,-1.5,155,4.13,Miller Park,13,-3
2019-09-08,2019,CLE,MIN,5,2,-150,-1.5,100,8.5,-115,-105,140,1.5,-120,5.1,Target Field,7,3
2019-09-08,2019,PHI,NYM,10,7,175,1.5,-125,8.5,-105,-115,-190,-1.5,105,3.09,Citi Field,17,3
2019-09-08,2019,BOS,NYY,5,10,107,1.5,-145,11.0,-105,-115,-117,-1.5,125,5.31,Fenway Park,15,-5
2019-09-08,2019,DET,OAK,1,3,280,1.5,125,9.0,-105,-115,-320,-1.5,-145,2.37,Oakland Coliseum,4,-2
2019-09-08,2019,NYM,PHI,7,10,-190,-1.5,105,8.5,-105,-115,175,1.5,-125,5.57,Citi Field,17,-3
2019-09-08,2019,STL,PIT,2,0,-215,-1.5,-125,8.5,-115,-105,195,1.5,105,5.8,PNC Park,2,2
2019-09-08,2019,COL,SD,1,2,131,1.5,-165,9.0,-110,-110,-141,-1.5,145,3.9,PETCO Park,3,-1
2019-09-08,2019,HOU,SEA,21,1,-420,-1.5,-210,9.0,100,-120,350,1.5,185,7.27,Minute Maid Park,22,20
2019-09-08,2019,LAD,SF,5,0,-240,-1.5,-115,8.5,-115,-105,210,1.5,-105,6.0,Dodger Stadium,5,5
2019-09-08,2019,PIT,STL,0,2,195,1.5,105,8.5,-115,-105,-215,-1.5,-125,2.88,PNC Park,2,-2
2019-09-08,2019,TOR,TB,3,8,190,1.5,-115,8.5,100,-120,-210,-1.5,-105,2.93,Tropicana Field,11,-5
2019-09-08,2019,BAL,TEX,4,10,125,1.5,-135,9.0,-115,-105,-135,-1.5,115,4.0,Camden Yards,14,-6
2019-09-08,2019,TB,TOR,8,3,-210,-1.5,-105,8.5,100,-120,190,1.5,-115,5.76,Tropicana Field,11,5
2019-09-08,2019,ATL,WSH,4,9,108,1.5,-145,8.5,-110,-110,-118,-1.5,125,4.09,Suntrust Park,13,-5
2019-09-09,2019,NYM,ARI,3,1,-240,-1.5,-110,7.5,-120,100,210,1.5,-110,5.29,Citi Field,4,2
2019-09-09,2019,PHI,ATL,2,7,-137,-1.5,145,9.0,-110,-110,127,1.5,-165,5.2,Citizens Bank Park,9,-5
2019-09-09,2019,NYY,BOS,5,0,-112,-1.5,135,9.5,-120,100,102,1.5,-155,5.02,Fenway Park,5,5
2019-09-09,2019,SD,CHC,2,10,140,1.5,-125,8.0,-120,100,-150,-1.5,105,3.33,PETCO Park,12,-8
2019-09-09,2019,LAA,CLE,2,6,178,1.5,105,8.5,-115,-105,-196,-1.5,-125,3.06,Angel Stadium,8,-4
2019-09-09,2019,OAK,HOU,0,15,175,1.5,-115,9.5,-110,-110,-190,-1.5,-105,3.45,Minute Maid Park,15,-15
2019-09-09,2019,CLE,LAA,6,2,-196,-1.5,-125,8.5,-115,-105,178,1.5,105,5.63,Angel Stadium,8,4
2019-09-09,2019,MIL,MIA,8,3,-215,-1.5,-125,9.0,100,-120,195,1.5,105,6.14,Marlins Park,11,5
2019-09-09,2019,MIA,MIL,3,8,195,1.5,105,9.0,100,-120,-215,-1.5,-125,3.05,Marlins Park,11,-5
2019-09-09,2019,ARI,NYM,1,3,210,1.5,-110,7.5,-120,100,-240,-1.5,-110,2.42,Citi Field,4,-2
2019-09-09,2019,BOS,NYY,0,5,102,1.5,-155,9.5,-120,100,-112,-1.5,135,4.7,Fenway Park,5,-5
2019-09-09,2019,HOU,OAK,15,0,-190,-1.5,-105,9.5,-110,-110,175,1.5,-115,6.22,Minute Maid Park,15,15
2019-09-09,2019,ATL,PHI,7,2,127,1.5,-165,9.0,-110,-110,-137,-1.5,145,3.96,Citizens Bank Park,9,5
2019-09-09,2019,SF,PIT,4,6,-174,-1.5,120,7.5,100,-120,162,1.5,-140,4.76,AT&T Park,10,-2
2019-09-09,2019,CHC,SD,10,2,-150,-1.5,105,8.0,-120,100,140,1.5,-125,4.8,PETCO Park,12,8
2019-09-09,2019,PIT,SF,6,4,162,1.5,-140,7.5,100,-120,-174,-1.5,120,2.86,AT&T Park,10,2
2019-09-10,2019,NYM,ARI,3,2,-118,-1.5,175,7.5,-115,-105,108,1.5,-200,4.06,Citi Field,5,1
2019-09-10,2019,PHI,ATL,6,5,163,1.5,-105,10.5,-115,-105,-176,-1.5,-115,3.99,Citizens Bank Park,11,1
2019-09-10,2019,LAD,BAL,7,3,-350,-1.5,-215,10.0,-120,100,300,1.5,190,7.78,Camden Yards,10,4
2019-09-10,2019,TOR,BOS,4,3,135,1.5,-120,10.0,-115,-105,-145,-1.5,100,4.26,Rogers Centre,7,1
2019-09-10,2019,SD,CHC,9,8,163,1.5,-115,9.0,-105,-115,-176,-1.5,-105,3.42,PETCO Park,17,1
2019-09-10,2019,SEA,CIN,4,3,110,1.5,-145,9.0,-110,-110,-120,-1.5,125,4.29,T-Mobile Park,7,1
2019-09-10,2019,LAA,CLE,0,8,140,1.5,-125,10.0,-115,-105,-150,-1.5,105,4.17,Angel Stadium,8,-8
2019-09-10,2019,STL,COL,1,2,-160,-1.5,-120,13.5,-120,100,150,1.5,100,8.31,Coors Field,3,-1
2019-09-10,2019,KC,CWS,3,7,108,1.5,-170,9.5,-115,-105,-118,-1.5,150,4.57,Guaranteed Rate Field,10,-4
2019-09-10,2019,NYY,DET,11,12,-310,-1.5,-200,10.5,-105,-115,270,1.5,175,7.94,Comerica Park,23,-1
2019-09-10,2019,OAK,HOU,21,7,146,1.5,-140,10.0,-115,-105,-156,-1.5,120,4.07,Minute Maid Park,28,14
2019-09-10,2019,CWS,KC,7,3,-118,-1.5,150,9.5,-115,-105,108,1.5,-170,5.14,Guaranteed Rate Field,10,4
2019-09-10,2019,CLE,LAA,8,0,-150,-1.5,105,10.0,-115,-105,140,1.5,-125,6.0,Angel Stadium,8,8
2019-09-10,2019,BAL,LAD,3,7,300,1.5,190,10.0,-120,100,-350,-1.5,-215,2.5,Camden Yards,10,-4
2019-09-10,2019,MIL,MIA,4,3,-170,-1.5,-110,8.5,-115,-105,160,1.5,-110,5.35,Marlins Park,7,1
2019-09-10,2019,MIA,MIL,3,4,160,1.5,-110,8.5,-115,-105,-170,-1.5,-110,3.27,Marlins Park,7,-1
2019-09-10,2019,WSH,MIN,0,5,130,1.5,-155,10.5,-110,-110,-140,-1.5,135,4.57,Target Field,5,-5
2019-09-10,2019,ARI,NYM,2,3,108,1.5,-200,7.5,-115,-105,-118,-1.5,175,3.61,Citi Field,5,-1
2019-09-10,2019,DET,NYY,12,11,270,1.5,175,10.5,-105,-115,-310,-1.5,-200,2.84,Comerica Park,23,1
2019-09-10,2019,HOU,OAK,7,21,-156,-1.5,120,10.0,-115,-105,146,1.5,-140,6.09,Minute Maid Park,28,-14
2019-09-10,2019,ATL,PHI,5,6,-176,-1.5,-115,10.5,-115,-105,163,1.5,-105,6.7,Citizens Bank Park,11,-1
2019-09-10,2019,SF,PIT,5,4,-119,-1.5,165,8.5,-110,-110,109,1.5,-185,4.62,AT&T Park,9,1
2019-09-10,2019,CHC,SD,8,9,-176,-1.5,-105,9.0,-105,-115,163,1.5,-115,5.74,PETCO Park,17,-1
2019-09-10,2019,CIN,SEA,3,4,-120,-1.5,125,9.0,-110,-110,110,1.5,-145,4.91,T-Mobile Park,7,-1
2019-09-10,2019,PIT,SF,4,5,109,1.5,-185,8.5,-110,-110,-119,-1.5,165,4.07,AT&T Park,9,-1
2019-09-10,2019,COL,STL,2,1,150,1.5,100,13.5,-120,100,-160,-1.5,-120,5.4,Coors Field,3,1
2019-09-10,2019,TEX,TB,3,5,124,1.5,-135,9.0,-115,-105,-134,-1.5,115,4.02,Rangers Ballpark,8,-2
2019-09-10,2019,TB,TEX,5,3,-134,-1.5,115,9.0,-115,-105,124,1.5,-135,5.15,Rangers Ballpark,8,2
2019-09-10,2019,BOS,TOR,3,4,-145,-1.5,100,10.0,-115,-105,135,1.5,-120,5.92,Rogers Centre,7,-1
2019-09-10,2019,MIN,WSH,5,0,-140,-1.5,135,10.5,-110,-110,130,1.5,-155,6.13,Target Field,5,5
2019-09-11,2019,NYM,ARI,9,0,-115,-1.5,170,9.0,-105,-115,105,1.5,-190,4.81,Citi Field,9,9
2019-09-11,2019,PHI,ATL,1,3,137,1.5,-130,9.5,-120,100,-147,-1.5,110,4.01,Citizens Bank Park,4,-2
2019-09-11,2019,LAD,BAL,3,7,-220,-1.5,-145,9.5,-115,-105,200,1.5,125,6.53,Camden Yards,10,-4
2019-09-11,2019,TOR,BOS,8,0,120,1.5,-135,11.0,-105,-115,-130,-1.5,115,5.0,Rogers Centre,8,8
2019-09-11,2019,SD,CHC,4,0,-110,1.5,-180,8.0,-120,100,100,-1.5,160,4.19,PETCO Park,4,4
2019-09-11,2019,SEA,CIN,5,3,140,1.5,-125,8.0,-120,100,-150,-1.5,105,3.33,T-Mobile Park,8,2
2019-09-11,2019,LAA,CLE,3,4,142,1.5,-120,10.0,-110,-110,-152,-1.5,100,4.13,Angel Stadium,7,-1
2019-09-11,2019,STL,COL,1,2,-180,-1.5,-135,13.5,-105,-115,165,1.5,115,8.68,Coors Field,3,-1
2019-09-11,2019,KC,CWS,8,6,144,1.5,-135,10.0,-115,-105,-154,-1.5,115,4.1,Guaranteed Rate Field,14,2
2019-09-11,2019,OAK,HOU,5,3,138,1.5,-140,11.0,-105,-115,-148,-1.5,120,4.62,Minute Maid Park,8,2
2019-09-11,2019,CWS,KC,6,8,-154,-1.5,115,10.0,-115,-105,144,1.5,-135,6.06,Guaranteed Rate Field,14,-2
2019-09-11,2019,CLE,LAA,4,3,-152,-1.5,100,10.0,-110,-110,142,1.5,-120,6.03,Angel Stadium,7,1
2019-09-11,2019,BAL,LAD,7,3,200,1.5,125,9.5,-115,-105,-220,-1.5,-145,3.17,Camden Yards,10,4
2019-09-11,2019,MIL,MIA,7,5,-132,-1.5,115,8.0,-115,-105,122,1.5,-135,4.55,Marlins Park,12,2
2019-09-11,2019,MIA,MIL,5,7,122,1.5,-135,8.0,-115,-105,-132,-1.5,115,3.6,Marlins Park,12,-2
2019-09-11,2019,WSH,MIN,6,2,-148,-1.5,100,9.5,-110,-110,138,1.5,-120,5.67,Target Field,8,4
2019-09-11,2019,ARI,NYM,0,9,105,1.5,-190,9.0,-105,-115,-115,-1.5,170,4.39,Citi Field,9,-9
2019-09-11,2019,HOU,OAK,3,5,-148,-1.5,120,11.0,-105,-115,138,1.5,-140,6.56,Minute Maid Park,8,-2
2019-09-11,2019,ATL,PHI,3,1,-147,-1.5,110,9.5,-120,100,137,1.5,-130,5.65,Citizens Bank Park,4,2
2019-09-11,2019,SF,PIT,3,6,-143,-1.5,135,9.0,-105,-115,133,1.5,-155,5.3,AT&T Park,9,-3
2019-09-11,2019,CHC,SD,0,4,100,-1.5,160,8.0,-120,100,-110,1.5,-180,4.0,PETCO Park,4,-4
2019-09-11,2019,CIN,SEA,3,5,-150,-1.5,105,8.0,-120,100,140,1.5,-125,4.8,T-Mobile Park,8,-2
2019-09-11,2019,PIT,SF,6,3,133,1.5,-155,9.0,-105,-115,-143,-1.5,135,3.86,AT&T Park,9,3
2019-09-11,2019,COL,STL,2,1,165,1.5,115,13.5,-105,-115,-180,-1.5,-135,5.09,Coors Field,3,1
2019-09-11,2019,TEX,TB,10,9,140,1.5,-115,11.0,-105,-115,-150,-1.5,-105,4.58,Rangers Ballpark,19,1
2019-09-11,2019,TB,TEX,9,10,-150,-1.5,-105,11.0,-105,-115,140,1.5,-115,6.6,Rangers Ballpark,19,-1
2019-09-11,2019,BOS,TOR,0,8,-130,-1.5,115,11.0,-105,-115,120,1.5,-135,6.22,Rogers Centre,8,-8
2019-09-11,2019,MIN,WSH,2,6,138,1.5,-120,9.5,-110,-110,-148,-1.5,100,3.99,Target Field,8,-4
2019-09-12,2019,NYM,ARI,11,1,-147,-1.5,145,8.0,-105,-115,137,1.5,-165,4.76,Citi Field,12,10
2019-09-12,2019,PHI,ATL,9,5,110,1.5,-150,9.5,-115,-105,-120,-1.5,130,4.52,Citizens Bank Park,14,4
2019-09-12,2019,LAD,BAL,4,2,-220,-1.5,-150,10.0,-115,-105,200,1.5,130,6.88,Camden Yards,6,2
2019-09-12,2019,TOR,BOS,4,7,122,1.5,-135,10.5,-115,-105,-132,-1.5,115,4.73,Rogers Centre,11,-3
2019-09-12,2019,SD,CHC,1,4,144,1.5,-125,8.0,-115,-105,-154,-1.5,105,3.28,PETCO Park,5,-3
2019-09-12,2019,SEA,CIN,5,11,110,1.5,-155,9.0,-115,-105,-120,-1.5,135,4.29,T-Mobile Park,16,-6
2019-09-12,2019,STL,COL,10,3,-185,-1.5,-135,12.0,-110,-110,170,1.5,115,7.79,Coors Field,13,7
2019-09-12,2019,KC,CWS,6,3,180,1.5,-120,8.5,-105,-115,-200,-1.5,100,3.04,Guaranteed Rate Field,9,3
2019-09-12,2019,NYY,DET,10,4,-220,-1.5,-145,9.5,-115,-105,200,1.5,125,6.53,Comerica Park,14,6
2019-09-12,2019,NYY,DET,6,4,-270,-1.5,-175,10.5,-120,100,240,1.5,155,7.66,Comerica Park,10,2
2019-09-12,2019,OAK,HOU,3,2,250,1.5,125,9.0,-105,-115,-290,-1.5,-145,2.57,Minute Maid Park,5,1
2019-09-12,2019,CWS,KC,3,6,-200,-1.5,100,8.5,-105,-115,180,1.5,-120,5.67,Guaranteed Rate Field,9,-3
2019-09-12,2019,BAL,LAD,2,4,200,1.5,130,10.0,-115,-105,-220,-1.5,-150,3.33,Camden Yards,6,-2
2019-09-12,2019,MIL,MIA,3,2,-135,-1.5,115,8.0,-120,100,125,1.5,-135,4.6,Marlins Park,5,1
2019-09-12,2019,MIA,MIL,2,3,125,1.5,-135,8.0,-120,100,-135,-1.5,115,3.56,Marlins Park,5,-1
2019-09-12,2019,WSH,MIN,12,6,-132,-1.5,125,9.5,100,-120,122,1.5,-145,5.41,Target Field,18,6
2019-09-12,2019,ARI,NYM,1,11,137,1.5,-165,8.0,-105,-115,-147,-1.5,145,3.38,Citi Field,12,-10
2019-09-12,2019,DET,NYY,4,10,200,1.5,125,9.5,-115,-105,-220,-1.5,-145,3.17,Comerica Park,14,-6
2019-09-12,2019,DET,NYY,4,6,240,1.5,155,10.5,-120,100,-270,-1.5,-175,3.09,Comerica Park,10,-2
2019-09-12,2019,HOU,OAK,2,3,-290,-1.5,-145,9.0,-105,-115,250,1.5,125,6.69,Minute Maid Park,5,-1
2019-09-12,2019,ATL,PHI,5,9,-120,-1.5,130,9.5,-115,-105,110,1.5,-150,5.18,Citizens Bank Park,14,-4
2019-09-12,2019,SF,PIT,2,4,-112,-1.5,175,8.5,105,-125,102,1.5,-200,4.49,AT&T Park,6,-2
2019-09-12,2019,CHC,SD,4,1,-154,-1.5,105,8.0,-115,-105,144,1.5,-125,4.85,PETCO Park,5,3
2019-09-12,2019,CIN,SEA,11,5,-120,-1.5,135,9.0,-115,-105,110,1.5,-155,4.91,T-Mobile Park,16,6
2019-09-12,2019,PIT,SF,4,2,102,1.5,-200,8.5,105,-125,-112,-1.5,175,4.21,AT&T Park,6,2
2019-09-12,2019,COL,STL,3,10,170,1.5,115,12.0,-110,-110,-185,-1.5,-135,4.44,Coors Field,13,-7
2019-09-12,2019,TEX,TB,6,4,146,1.5,-120,10.5,100,-120,-156,-1.5,100,4.27,Rangers Ballpark,10,2
2019-09-12,2019,TB,TEX,4,6,-156,-1.5,100,10.5,100,-120,146,1.5,-120,6.4,Rangers Ballpark,10,-2
2019-09-12,2019,BOS,TOR,7,4,-132,-1.5,115,10.5,-115,-105,122,1.5,-135,5.97,Rogers Centre,11,3
2019-09-12,2019,MIN,WSH,6,12,122,1.5,-145,9.5,100,-120,-132,-1.5,125,4.28,Target Field,18,-6
2019-09-13,2019,CIN,ARI,4,3,-113,-1.5,140,8.5,-120,100,103,1.5,-160,4.51,Chase Field,7,1
2019-09-13,2019,WSH,ATL,0,5,-150,-1.5,135,8.5,-110,-110,140,1.5,-155,5.1,Nationals Park,5,-5
2019-09-13,2019,DET,BAL,2,6,-113,-1.5,175,9.5,-120,100,103,1.5,-195,5.04,Comerica Park,8,-4
2019-09-13,2019,PIT,CHC,8,17,180,1.5,-105,11.0,-115,-105,-200,-1.5,-115,3.93,Wrigley Field,25,-9
2019-09-13,2019,ARI,CIN,3,4,103,1.5,-160,8.5,-120,100,-113,-1.5,140,4.19,Chase Field,7,-1
2019-09-13,2019,SD,COL,8,10,-120,-1.5,120,12.5,-110,-110,110,1.5,-140,6.82,Coors Field,18,-2
2019-09-13,2019,SEA,CWS,7,9,-130,-1.5,145,9.5,-110,-110,120,1.5,-165,5.37,T-Mobile Park,16,-2
2019-09-13,2019,BAL,DET,6,2,103,1.5,-195,9.5,-120,100,-113,-1.5,175,4.68,Comerica Park,8,4
2019-09-13,2019,KC,HOU,1,4,320,1.5,175,8.5,-120,100,-380,-1.5,-200,2.02,Kauffman Stadium,5,-3
2019-09-13,2019,HOU,KC,4,1,-380,-1.5,-200,8.5,-120,100,320,1.5,175,6.73,Kauffman Stadium,5,3
2019-09-13,2019,TB,LAA,11,4,-150,-1.5,105,8.0,-115,-105,140,1.5,-125,4.8,Angel Stadium,15,7
2019-09-13,2019,NYM,LAD,2,9,122,1.5,-145,7.5,-120,100,-132,-1.5,125,3.38,Citi Field,11,-7
2019-09-13,2019,SF,MIA,1,0,-160,-1.5,130,8.0,-120,100,150,1.5,-150,4.92,AT&T Park,1,1
2019-09-13,2019,STL,MIL,10,0,-128,-1.5,155,8.0,-115,-105,118,1.5,-175,4.49,Busch Stadium,10,10
2019-09-13,2019,LAD,NYM,9,2,-132,-1.5,125,7.5,-120,100,122,1.5,-145,4.27,Citi Field,11,7
2019-09-13,2019,TOR,NYY,6,5,175,1.5,115,10.0,-115,-105,-190,-1.5,-135,3.64,Rogers Centre,11,1
2019-09-13,2019,TEX,OAK,9,14,165,1.5,105,11.0,-125,105,-180,-1.5,-125,4.15,Rangers Ballpark,23,-5
2019-09-13,2019,CHC,PIT,17,8,-200,-1.5,-115,11.0,-115,-105,180,1.5,-105,7.33,Wrigley Field,25,9
2019-09-13,2019,COL,SD,10,8,110,1.5,-140,12.5,-110,-110,-120,-1.5,120,5.95,Coors Field,18,2
2019-09-13,2019,CWS,SEA,9,7,120,1.5,-165,9.5,-110,-110,-130,-1.5,145,4.32,T-Mobile Park,16,2
2019-09-13,2019,MIA,SF,0,1,150,1.5,-150,8.0,-120,100,-160,-1.5,130,3.2,AT&T Park,1,-1
2019-09-13,2019,MIL,STL,0,10,118,1.5,-175,8.0,-115,-105,-128,-1.5,155,3.67,Busch Stadium,10,-10
2019-09-13,2019,LAA,TB,4,11,140,1.5,-125,8.0,-115,-105,-150,-1.5,105,3.33,Angel Stadium,15,-7
2019-09-13,2019,OAK,TEX,14,9,-180,-1.5,-125,11.0,-125,105,165,1.5,105,7.07,Rangers Ballpark,23,5
2019-09-13,2019,NYY,TOR,5,6,-190,-1.5,-135,10.0,-115,-105,175,1.5,115,6.55,Rogers Centre,11,-1
2019-09-13,2019,ATL,WSH,5,0,140,1.5,-155,8.5,-110,-110,-150,-1.5,135,3.54,Nationals Park,5,5
2019-09-14,2019,CIN,ARI,0,1,116,1.5,-180,8.5,-120,100,-126,-1.5,160,3.94,Chase Field,1,-1
2019-09-14,2019,WSH,ATL,1,10,-107,-1.5,175,10.5,-110,-110,-103,1.5,-200,5.43,Nationals Park,11,-9
2019-09-14,2019,DET,BAL,8,4,-112,-1.5,175,9.5,100,-120,102,1.5,-200,5.02,Comerica Park,12,4
2019-09-14,2019,PHI,BOS,1,2,-120,-1.5,165,8.5,-105,-115,110,1.5,-185,4.64,Citizens Bank Park,3,-1
2019-09-14,2019,PIT,CHC,1,14,245,1.5,130,10.5,-105,-115,-280,-1.5,-150,3.04,Wrigley Field,15,-13
2019-09-14,2019,ARI,CIN,1,0,-126,-1.5,160,8.5,-120,100,116,1.5,-180,4.74,Chase Field,1,1
2019-09-14,2019,MIN,CLE,2,0,175,1.5,-115,9.0,-120,100,-190,-1.5,-105,3.27,Progressive Field,2,2
2019-09-14,2019,MIN,CLE,9,5,128,1.5,-160,9.5,-110,-110,-138,-1.5,140,4.17,Progressive Field,14,4
2019-09-14,2019,SD,COL,10,11,-104,1.5,-185,13.5,-105,-115,-106,-1.5,165,6.88,Coors Field,21,-1
2019-09-14,2019,SEA,CWS,2,1,-104,-1.5,170,9.5,100,-120,-106,1.5,-190,4.84,T-Mobile Park,3,1
2019-09-14,2019,BAL,DET,4,8,102,1.5,-200,9.5,100,-120,-112,-1.5,175,4.7,Comerica Park,12,-4
2019-09-14,2019,KC,HOU,1,6,290,1.5,175,10.0,-115,-105,-340,-1.5,-200,2.56,Kauffman Stadium,7,-5
2019-09-14,2019,HOU,KC,6,1,-340,-1.5,-200,10.0,-115,-105,290,1.5,175,7.73,Kauffman Stadium,7,5
2019-09-14,2019,TB,LAA,3,1,-190,-1.5,-125,9.0,-110,-110,175,1.5,105,5.9,Angel Stadium,4,2
2019-09-14,2019,NYM,LAD,3,0,-140,-1.5,150,7.5,-105,-115,130,1.5,-170,4.38,Citi Field,3,3
2019-09-14,2019,SF,MIA,2,4,-250,-1.5,-120,8.0,-110,-110,220,1.5,100,5.71,AT&T Park,6,-2
2019-09-14,2019,STL,MIL,2,5,-215,-1.5,-105,7.5,-120,100,195,1.5,-115,5.12,Busch Stadium,7,-3
2019-09-14,2019,CLE,MIN,0,2,-190,-1.5,-105,9.0,-120,100,175,1.5,-115,5.9,Progressive Field,2,-2
2019-09-14,2019,CLE,MIN,5,9,-138,-1.5,140,9.5,-110,-110,128,1.5,-160,5.51,Progressive Field,14,-4
2019-09-14,2019,LAD,NYM,0,3,130,1.5,-170,7.5,-105,-115,-140,-1.5,150,3.26,Citi Field,3,-3
2019-09-14,2019,TOR,NYY,3,13,200,1.5,130,9.5,-115,-105,-220,-1.5,-150,3.17,Rogers Centre,16,-10
2019-09-14,2019,TEX,OAK,6,8,113,1.5,-140,11.0,-105,-115,-123,-1.5,120,5.16,Rangers Ballpark,14,-2
2019-09-14,2019,BOS,PHI,2,1,110,1.5,-185,8.5,-105,-115,-120,-1.5,165,4.05,Citizens Bank Park,3,1
2019-09-14,2019,CHC,PIT,14,1,-280,-1.5,-150,10.5,-105,-115,245,1.5,130,7.74,Wrigley Field,15,13
2019-09-14,2019,COL,SD,11,10,-106,-1.5,165,13.5,-105,-115,-104,1.5,-185,6.95,Coors Field,21,1
2019-09-14,2019,CWS,SEA,1,2,-106,1.5,-190,9.5,100,-120,-104,-1.5,170,4.89,T-Mobile Park,3,-1
2019-09-14,2019,MIA,SF,4,2,220,1.5,100,8.0,-110,-110,-250,-1.5,-120,2.5,AT&T Park,6,2
2019-09-14,2019,MIL,STL,5,2,195,1.5,-115,7.5,-120,100,-215,-1.5,-105,2.54,Busch Stadium,7,3
2019-09-14,2019,LAA,TB,1,3,175,1.5,105,9.0,-110,-110,-190,-1.5,-125,3.27,Angel Stadium,4,-2
2019-09-14,2019,OAK,TEX,8,6,-123,-1.5,120,11.0,-105,-115,113,1.5,-140,6.07,Rangers Ballpark,14,2
2019-09-14,2019,NYY,TOR,13,3,-220,-1.5,-150,9.5,-115,-105,200,1.5,130,6.53,Rogers Centre,16,10
2019-09-14,2019,ATL,WSH,10,1,-103,1.5,-200,10.5,-110,-110,-107,-1.5,175,5.33,Nationals Park,11,9
2019-09-15,2019,CIN,ARI,3,1,148,1.5,-150,8.0,-105,-115,-158,-1.5,130,3.23,Chase Field,4,2
2019-09-15,2019,WSH,ATL,7,0,106,1.5,-155,10.0,-120,100,-116,-1.5,135,4.85,Nationals Park,7,7
2019-09-15,2019,DET,BAL,2,8,136,1.5,-120,10.0,-120,100,-146,-1.5,100,4.24,Comerica Park,10,-6
2019-09-15,2019,PHI,BOS,3,6,-104,1.5,-160,10.5,-110,-110,-106,-1.5,140,5.35,Citizens Bank Park,9,-3
2019-09-15,2019,PIT,CHC,6,16,220,1.5,115,11.5,-105,-115,-250,-1.5,-135,3.59,Wrigley Field,22,-10
2019-09-15,2019,ARI,CIN,1,3,-158,-1.5,130,8.0,-105,-115,148,1.5,-150,4.9,Chase Field,4,-2
2019-09-15,2019,MIN,CLE,5,7,180,1.5,-115,9.0,-115,-105,-200,-1.5,-105,3.21,Progressive Field,12,-2
2019-09-15,2019,SD,COL,5,10,-110,1.5,-185,13.5,-105,-115,100,-1.5,165,7.07,Coors Field,15,-5
2019-09-15,2019,SEA,CWS,11,10,-117,-1.5,165,9.0,100,-120,107,1.5,-185,4.85,T-Mobile Park,21,1
2019-09-15,2019,BAL,DET,8,2,-146,-1.5,100,10.0,-120,100,136,1.5,-120,5.93,Comerica Park,10,6
2019-09-15,2019,KC,HOU,3,12,195,1.5,125,10.5,-110,-110,-215,-1.5,-145,3.56,Kauffman Stadium,15,-9
2019-09-15,2019,HOU,KC,12,3,-215,-1.5,-145,10.5,-110,-110,195,1.5,125,7.17,Kauffman Stadium,15,9
2019-09-15,2019,TB,LAA,4,6,-176,-1.5,-110,9.0,-110,-110,163,1.5,-110,5.74,Angel Stadium,10,-2
2019-09-15,2019,NYM,LAD,2,3,132,1.5,-130,8.0,-120,100,-142,-1.5,110,3.45,Citi Field,5,-1
2019-09-15,2019,SF,MIA,2,1,-160,-1.5,135,8.0,-110,-110,150,1.5,-155,4.92,AT&T Park,3,1
2019-09-15,2019,STL,MIL,6,7,-139,-1.5,140,9.0,-105,-115,129,1.5,-160,5.23,Busch Stadium,13,-1
2019-09-15,2019,CLE,MIN,7,5,-200,-1.5,-105,9.0,-115,-105,180,1.5,-115,6.0,Progressive Field,12,2
2019-09-15,2019,LAD,NYM,3,2,-142,-1.5,110,8.0,-120,100,132,1.5,-130,4.69,Citi Field,5,1
2019-09-15,2019,TOR,NYY,6,4,195,1.5,125,10.0,-120,100,-215,-1.5,-145,3.39,Rogers Centre,10,2
2019-09-15,2019,TEX,OAK,1,6,180,1.5,125,11.5,-105,-115,-200,-1.5,-145,4.11,Rangers Ballpark,7,-5
2019-09-15,2019,BOS,PHI,6,3,-106,-1.5,140,10.5,-110,-110,-104,1.5,-160,5.4,Citizens Bank Park,9,3
2019-09-15,2019,CHC,PIT,16,6,-250,-1.5,-135,11.5,-105,-115,220,1.5,115,8.21,Wrigley Field,22,10
2019-09-15,2019,COL,SD,10,5,100,-1.5,165,13.5,-105,-115,-110,1.5,-185,6.75,Coors Field,15,5
2019-09-15,2019,CWS,SEA,10,11,107,1.5,-185,9.0,100,-120,-117,-1.5,165,4.35,T-Mobile Park,21,-1
2019-09-15,2019,MIA,SF,1,2,150,1.5,-155,8.0,-110,-110,-160,-1.5,135,3.2,AT&T Park,3,-1
2019-09-15,2019,MIL,STL,7,6,129,1.5,-160,9.0,-105,-115,-139,-1.5,140,3.93,Busch Stadium,13,1
2019-09-15,2019,LAA,TB,6,4,163,1.5,-110,9.0,-110,-110,-176,-1.5,-110,3.42,Angel Stadium,10,2
2019-09-15,2019,OAK,TEX,6,1,-200,-1.5,-145,11.5,-105,-115,180,1.5,125,7.67,Rangers Ballpark,7,5
2019-09-15,2019,NYY,TOR,4,6,-215,-1.5,-145,10.0,-120,100,195,1.5,125,6.83,Rogers Centre,10,-2
2019-09-15,2019,ATL,WSH,0,7,-116,-1.5,135,10.0,-120,100,106,1.5,-155,5.37,Nationals Park,7,-7
2019-09-16,2019,MIA,ARI,5,7,185,1.5,-120,9.0,100,-120,-205,-1.5,100,3.16,Chase Field,12,-2
2019-09-16,2019,DET,BAL,5,2,135,1.5,-125,9.0,-115,-105,-145,-1.5,105,3.83,Comerica Park,7,3
2019-09-16,2019,CIN,CHC,2,8,158,1.5,-135,8.5,-120,100,-168,-1.5,115,3.29,Wrigley Field,10,-6
2019-09-16,2019,CHC,CIN,8,2,-168,-1.5,115,8.5,-120,100,158,1.5,-135,5.33,Wrigley Field,10,6
2019-09-16,2019,NYM,COL,4,9,-160,-1.5,-120,14.0,100,-120,150,1.5,100,8.62,Coors Field,13,-5
2019-09-16,2019,MIN,CWS,5,3,-240,-1.5,-130,9.5,-110,-110,210,1.5,110,6.71,Target Field,8,2
2019-09-16,2019,BAL,DET,2,5,-145,-1.5,105,9.0,-115,-105,135,1.5,-125,5.33,Comerica Park,7,-3
2019-09-16,2019,OAK,KC,5,6,-310,-1.5,-155,10.0,-105,-115,270,1.5,135,7.56,Oakland Coliseum,11,-1
2019-09-16,2019,ARI,MIA,7,5,-205,-1.5,100,9.0,100,-120,185,1.5,-120,6.05,Chase Field,12,2
2019-09-16,2019,SD,MIL,1,5,138,1.5,-140,9.0,-120,100,-148,-1.5,120,3.78,Miller Park,6,-4
2019-09-16,2019,CWS,MIN,3,5,210,1.5,110,9.5,-110,-110,-240,-1.5,-130,3.06,Target Field,8,-2
2019-09-16,2019,COL,NYM,9,4,150,1.5,100,14.0,100,-120,-160,-1.5,-120,5.6,Coors Field,13,5
2019-09-16,2019,KC,OAK,6,5,270,1.5,135,10.0,-105,-115,-310,-1.5,-155,2.7,Oakland Coliseum,11,1
2019-09-16,2019,MIL,SD,5,1,-148,-1.5,120,9.0,-120,100,138,1.5,-140,5.37,Miller Park,6,4
2019-09-16,2019,WSH,STL,2,4,-140,-1.5,120,8.0,-120,100,130,1.5,-140,4.67,Busch Stadium,6,-2
2019-09-16,2019,STL,WSH,4,2,130,1.5,-140,8.0,-120,100,-140,-1.5,120,3.48,Busch Stadium,6,2
2019-09-17,2019,MIA,ARI,12,6,158,1.5,-140,9.5,100,-120,-168,-1.5,120,3.68,Chase Field,18,6
2019-09-17,2019,PHI,ATL,5,4,170,1.5,-120,10.0,-115,-105,-185,-1.5,100,3.7,Suntrust Park,9,1
2019-09-17,2019,TOR,BAL,8,5,-136,-1.5,105,10.0,-110,-110,126,1.5,-125,5.76,Camden Yards,13,3
2019-09-17,2019,SF,BOS,7,6,185,1.5,-110,10.0,-110,-110,-205,-1.5,-110,3.51,Fenway Park,13,1
2019-09-17,2019,CIN,CHC,4,2,145,1.5,-160,7.5,-105,-115,-155,-1.5,140,3.06,Wrigley Field,6,2
2019-09-17,2019,CHC,CIN,2,4,-155,-1.5,140,7.5,-105,-115,145,1.5,-160,4.56,Wrigley Field,6,-2
2019-09-17,2019,DET,CLE,2,7,250,1.5,120,10.0,-105,-115,-290,-1.5,-140,2.86,Progressive Field,9,-5
2019-09-17,2019,NYM,COL,6,1,-152,-1.5,-115,14.0,-110,-110,142,1.5,-105,8.44,Coors Field,7,5
2019-09-17,2019,MIN,CWS,9,8,-205,-1.5,-115,11.0,-115,-105,185,1.5,-105,7.39,Target Field,17,1
2019-09-17,2019,CLE,DET,7,2,-290,-1.5,-140,10.0,-105,-115,250,1.5,120,7.44,Progressive Field,9,5
2019-09-17,2019,TEX,HOU,1,4,300,1.5,145,8.0,-110,-110,-350,-1.5,-165,2.0,Minute Maid Park,5,-3
2019-09-17,2019,OAK,KC,2,1,-260,-1.5,-135,9.5,-110,-110,230,1.5,115,6.86,Oakland Coliseum,3,1
2019-09-17,2019,NYY,LAA,8,0,-360,-1.5,-170,9.0,-110,-110,310,1.5,150,7.04,Yankee Stadium,8,8
2019-09-17,2019,TB,LAD,5,7,107,1.5,-185,8.0,-110,-110,-117,-1.5,165,3.86,Dodger Stadium,12,-2
2019-09-17,2019,ARI,MIA,6,12,-168,-1.5,120,9.5,100,-120,158,1.5,-140,5.96,Chase Field,18,-6
2019-09-17,2019,SD,MIL,1,3,125,1.5,-170,8.5,105,-125,-135,-1.5,150,3.78,Miller Park,4,-2
2019-09-17,2019,CWS,MIN,8,9,185,1.5,-105,11.0,-115,-105,-205,-1.5,-115,3.86,Target Field,17,-1
2019-09-17,2019,COL,NYM,1,6,142,1.5,-105,14.0,-110,-110,-152,-1.5,-115,5.79,Coors Field,7,-5
2019-09-17,2019,LAA,NYY,0,8,310,1.5,150,9.0,-110,-110,-360,-1.5,-170,2.2,Yankee Stadium,8,-8
2019-09-17,2019,KC,OAK,1,2,230,1.5,115,9.5,-110,-110,-260,-1.5,-135,2.88,Oakland Coliseum,3,-1
2019-09-17,2019,ATL,PHI,4,5,-185,-1.5,100,10.0,-115,-105,170,1.5,-120,6.49,Suntrust Park,9,-1
2019-09-17,2019,SEA,PIT,6,0,108,1.5,-185,8.5,-115,-105,-118,-1.5,165,4.09,PNC Park,6,6
2019-09-17,2019,MIL,SD,3,1,-135,-1.5,150,8.5,105,-125,125,1.5,-170,4.88,Miller Park,4,2
2019-09-17,2019,PIT,SEA,0,6,-118,-1.5,165,8.5,-115,-105,108,1.5,-185,4.6,PNC Park,6,-6
2019-09-17,2019,BOS,SF,6,7,-205,-1.5,-110,10.0,-110,-110,185,1.5,-110,6.72,Fenway Park,13,-1
2019-09-17,2019,WSH,STL,6,2,106,1.5,-205,8.0,-120,100,-116,-1.5,180,3.88,Busch Stadium,8,4
2019-09-17,2019,LAD,TB,7,5,-117,-1.5,165,8.0,-110,-110,107,1.5,-185,4.31,Dodger Stadium,12,2
2019-09-17,2019,HOU,TEX,4,1,-350,-1.5,-165,8.0,-110,-110,300,1.5,145,6.22,Minute Maid Park,5,3
2019-09-17,2019,BAL,TOR,5,8,126,1.5,-125,10.0,-110,-110,-136,-1.5,105,4.42,Camden Yards,13,-3
2019-09-17,2019,STL,WSH,2,6,-116,-1.5,180,8.0,-120,100,106,1.5,-205,4.3,Busch Stadium,8,-4
2019-09-18,2019,MIA,ARI,4,5,142,1.5,-150,9.0,100,-120,-152,-1.5,130,3.72,Chase Field,9,-1
2019-09-18,2019,PHI,ATL,4,1,144,1.5,-145,10.5,-115,-105,-154,-1.5,125,4.3,Suntrust Park,5,3
2019-09-18,2019,TOR,BAL,11,10,-108,1.5,-200,9.5,-125,105,-102,-1.5,175,4.93,Camden Yards,21,1
2019-09-18,2019,SF,BOS,11,3,150,1.5,-140,9.5,-110,-110,-160,-1.5,120,3.8,Fenway Park,14,8
2019-09-18,2019,CIN,CHC,3,2,150,1.5,-140,9.5,-115,-105,-160,-1.5,120,3.8,Wrigley Field,5,1
2019-09-18,2019,CHC,CIN,2,3,-160,-1.5,120,9.5,-115,-105,150,1.5,-140,5.85,Wrigley Field,5,-1
2019-09-18,2019,DET,CLE,1,2,260,1.5,125,9.0,-110,-110,-300,-1.5,-145,2.5,Progressive Field,3,-1
2019-09-18,2019,NYM,COL,7,4,-165,-1.5,-115,13.0,100,-120,155,1.5,-105,8.09,Coors Field,11,3
2019-09-18,2019,MIN,CWS,1,3,-270,-1.5,-140,10.5,-120,100,240,1.5,120,7.66,Target Field,4,-2
2019-09-18,2019,CLE,DET,2,1,-300,-1.5,-145,9.0,-110,-110,260,1.5,125,6.75,Progressive Field,3,1
2019-09-18,2019,TEX,HOU,2,3,400,1.5,180,9.0,100,-120,-500,-1.5,-205,1.8,Minute Maid Park,5,-1
2019-09-18,2019,OAK,KC,1,0,-270,-1.5,-145,9.5,-125,105,240,1.5,125,6.93,Oakland Coliseum,1,1
2019-09-18,2019,NYY,LAA,2,3,-280,-1.5,-150,10.0,-105,-115,245,1.5,130,7.37,Yankee Stadium,5,-1
2019-09-18,2019,TB,LAD,8,7,120,1.5,-175,9.0,-105,-115,-130,-1.5,155,4.09,Dodger Stadium,15,1
2019-09-18,2019,ARI,MIA,5,4,-152,-1.5,130,9.0,100,-120,142,1.5,-150,5.43,Chase Field,9,1
2019-09-18,2019,SD,MIL,2,1,150,1.5,-145,8.5,-110,-110,-160,-1.5,125,3.4,Miller Park,3,1
2019-09-18,2019,CWS,MIN,3,1,240,1.5,120,10.5,-120,100,-270,-1.5,-140,3.09,Target Field,4,2
2019-09-18,2019,COL,NYM,4,7,155,1.5,-105,13.0,100,-120,-165,-1.5,-115,5.1,Coors Field,11,-3
2019-09-18,2019,LAA,NYY,3,2,245,1.5,130,10.0,-105,-115,-280,-1.5,-150,2.9,Yankee Stadium,5,1
2019-09-18,2019,KC,OAK,0,1,240,1.5,125,9.5,-125,105,-270,-1.5,-145,2.79,Oakland Coliseum,1,-1
2019-09-18,2019,ATL,PHI,1,4,-154,-1.5,125,10.5,-115,-105,144,1.5,-145,6.37,Suntrust Park,5,-3
2019-09-18,2019,SEA,PIT,4,1,-106,1.5,-200,9.0,-115,-105,-104,-1.5,175,4.63,PNC Park,5,3
2019-09-18,2019,MIL,SD,1,2,-160,-1.5,125,8.5,-110,-110,150,1.5,-145,5.23,Miller Park,3,-1
2019-09-18,2019,PIT,SEA,1,4,-104,-1.5,175,9.0,-115,-105,-106,1.5,-200,4.59,PNC Park,5,-3
2019-09-18,2019,BOS,SF,3,11,-160,-1.5,120,9.5,-110,-110,150,1.5,-140,5.85,Fenway Park,14,-8
2019-09-18,2019,WSH,STL,1,5,-157,-1.5,105,7.5,-125,105,147,1.5,-125,4.58,Busch Stadium,6,-4
2019-09-18,2019,LAD,TB,7,8,-130,-1.5,155,9.0,-105,-115,120,1.5,-175,5.09,Dodger Stadium,15,-1
2019-09-18,2019,HOU,TEX,3,2,-500,-1.5,-205,9.0,100,-120,400,1.5,180,7.5,Minute Maid Park,5,1
2019-09-18,2019,BAL,TOR,10,11,-102,-1.5,175,9.5,-125,105,-108,1.5,-200,4.8,Camden Yards,21,-1
2019-09-18,2019,STL,WSH,5,1,147,1.5,-125,7.5,-125,105,-157,-1.5,105,3.04,Busch Stadium,6,4
2019-09-19,2019,PHI,ATL,4,5,130,1.5,-160,8.0,-110,-110,-140,-1.5,140,3.48,Suntrust Park,9,-1
2019-09-19,2019,TOR,BAL,8,4,-128,-1.5,115,10.5,-105,-115,118,1.5,-135,5.89,Camden Yards,12,4
2019-09-19,2019,SF,BOS,4,5,137,1.5,-150,8.5,100,-120,-147,-1.5,130,3.59,Fenway Park,9,-1
2019-09-19,2019,STL,CHC,5,4,-105,-1.5,160,7.5,-110,-110,-105,1.5,-180,3.84,Wrigley Field,9,1
2019-09-19,2019,DET,CLE,0,7,350,1.5,155,8.5,-105,-115,-420,-1.5,-175,1.89,Progressive Field,7,-7
2019-09-19,2019,CLE,DET,7,0,-420,-1.5,-175,8.5,-105,-115,350,1.5,155,6.87,Progressive Field,7,7
2019-09-19,2019,MIN,KC,8,5,-250,-1.5,-145,10.5,-105,-115,220,1.5,125,7.5,Target Field,13,3
2019-09-19,2019,NYY,LAA,9,1,-230,-1.5,-120,9.0,-115,-105,205,1.5,100,6.27,Yankee Stadium,10,8
2019-09-19,2019,SD,MIL,1,5,162,1.5,-135,8.5,-105,-115,-174,-1.5,115,3.24,Miller Park,6,-4
2019-09-19,2019,KC,MIN,5,8,220,1.5,125,10.5,-105,-115,-250,-1.5,-145,3.28,Target Field,13,-3
2019-09-19,2019,LAA,NYY,1,9,205,1.5,100,9.0,-115,-105,-230,-1.5,-120,2.95,Yankee Stadium,10,-8
2019-09-19,2019,ATL,PHI,5,4,-140,-1.5,140,8.0,-110,-110,130,1.5,-160,4.67,Suntrust Park,9,1
2019-09-19,2019,SEA,PIT,6,5,125,1.5,-165,8.5,-110,-110,-135,-1.5,145,3.78,PNC Park,11,1
2019-09-19,2019,MIL,SD,5,1,-174,-1.5,115,8.5,-105,-115,162,1.5,-135,5.4,Miller Park,6,4
2019-09-19,2019,PIT,SEA,5,6,-135,-1.5,145,8.5,-110,-110,125,1.5,-165,4.88,PNC Park,11,-1
2019-09-19,2019,BOS,SF,5,4,-147,-1.5,130,8.5,100,-120,137,1.5,-150,5.06,Fenway Park,9,1
2019-09-19,2019,CHC,STL,4,5,-105,1.5,-180,7.5,-110,-110,-105,-1.5,160,3.84,Wrigley Field,9,-1
2019-09-19,2019,BAL,TOR,4,8,118,1.5,-135,10.5,-105,-115,-128,-1.5,115,4.82,Camden Yards,12,-4
2019-09-20,2019,SD,ARI,0,9,-110,-1.5,180,8.0,-110,-110,100,1.5,-205,4.19,PETCO Park,9,-9
2019-09-20,2019,SF,ATL,0,6,200,1.5,-105,9.5,100,-120,-220,-1.5,-115,3.17,Suntrust Park,6,-6
2019-09-20,2019,SEA,BAL,3,5,-110,-1.5,135,10.5,-115,-105,100,1.5,-155,5.5,Camden Yards,8,-2
2019-09-20,2019,TB,BOS,5,4,-174,-1.5,115,8.5,-105,-115,162,1.5,-135,5.4,Tropicana Field,9,1
2019-09-20,2019,STL,CHC,2,1,120,1.5,-175,10.0,-115,-105,-130,-1.5,155,4.55,Wrigley Field,3,1
2019-09-20,2019,NYM,CIN,8,1,-170,-1.5,100,7.5,-120,100,160,1.5,-120,4.72,Great American Ballpark,9,7
2019-09-20,2019,PHI,CLE,2,5,175,1.5,-125,9.0,-115,-105,-190,-1.5,105,3.27,Progressive Field,7,-3
2019-09-20,2019,LAD,COL,12,5,-400,-1.5,-190,8.5,-105,-115,330,1.5,170,6.8,Dodger Stadium,17,7
2019-09-20,2019,DET,CWS,1,10,127,1.5,-135,9.0,-115,-105,-137,-1.5,115,3.96,Comerica Park,11,-9
2019-09-20,2019,CWS,DET,10,1,-137,-1.5,115,9.0,-115,-105,127,1.5,-135,5.2,Comerica Park,11,9
2019-09-20,2019,LAA,HOU,4,6,310,1.5,155,9.0,-115,-105,-360,-1.5,-175,2.2,Minute Maid Park,10,-2
2019-09-20,2019,MIN,KC,4,3,-280,-1.5,-150,10.5,-115,-105,245,1.5,130,7.74,Target Field,7,1
2019-09-20,2019,HOU,LAA,6,4,-360,-1.5,-175,9.0,-115,-105,310,1.5,155,7.04,Minute Maid Park,10,2
2019-09-20,2019,COL,LAD,5,12,330,1.5,170,8.5,-105,-115,-400,-1.5,-190,1.98,Dodger Stadium,17,-7
2019-09-20,2019,WSH,MIA,6,4,-240,-1.5,-140,9.0,-105,-115,210,1.5,120,6.35,Marlins Park,10,2
2019-09-20,2019,PIT,MIL,1,10,185,1.5,-115,9.0,-115,-105,-205,-1.5,-105,3.16,Miller Park,11,-9
2019-09-20,2019,KC,MIN,3,4,245,1.5,130,10.5,-115,-105,-280,-1.5,-150,3.04,Target Field,7,-1
2019-09-20,2019,CIN,NYM,1,8,160,1.5,-120,7.5,-120,100,-170,-1.5,100,2.88,Great American Ballpark,9,-7
2019-09-20,2019,TOR,NYY,4,3,165,1.5,-120,9.5,-115,-105,-180,-1.5,100,3.58,Yankee Stadium,7,1
2019-09-20,2019,TEX,OAK,0,8,175,1.5,-120,8.5,-115,-105,-190,-1.5,100,3.09,Oakland Coliseum,8,-8
2019-09-20,2019,CLE,PHI,5,2,-190,-1.5,105,9.0,-115,-105,175,1.5,-125,5.9,Progressive Field,7,3
2019-09-20,2019,MIL,PIT,10,1,-205,-1.5,-105,9.0,-115,-105,185,1.5,-115,6.05,Miller Park,11,9
2019-09-20,2019,ARI,SD,9,0,100,1.5,-205,8.0,-110,-110,-110,-1.5,180,4.0,PETCO Park,9,9
2019-09-20,2019,BAL,SEA,5,3,100,1.5,-155,10.5,-115,-105,-110,-1.5,135,5.25,Camden Yards,8,2
2019-09-20,2019,ATL,SF,6,0,-220,-1.5,-115,9.5,100,-120,200,1.5,-105,6.53,Suntrust Park,6,6
2019-09-20,2019,CHC,STL,1,2,-130,-1.5,155,10.0,-115,-105,120,1.5,-175,5.65,Wrigley Field,3,-1
2019-09-20,2019,BOS,TB,4,5,162,1.5,-135,8.5,-105,-115,-174,-1.5,115,3.24,Tropicana Field,9,-1
2019-09-20,2019,OAK,TEX,8,0,-190,-1.5,100,8.5,-115,-105,175,1.5,-120,5.57,Oakland Coliseum,8,8
2019-09-20,2019,NYY,TOR,3,4,-180,-1.5,100,9.5,-115,-105,165,1.5,-120,6.11,Yankee Stadium,7,-1
2019-09-20,2019,MIA,WSH,4,6,210,1.5,120,9.0,-105,-115,-240,-1.5,-140,2.9,Marlins Park,10,-2
2019-09-21,2019,SD,ARI,2,4,111,1.5,-150,8.0,-115,-105,-121,-1.5,130,3.79,PETCO Park,6,-2
2019-09-21,2019,SF,ATL,1,8,135,1.5,-160,8.0,-115,-105,-145,-1.5,140,3.4,Suntrust Park,9,-7
2019-09-21,2019,SEA,BAL,7,6,-108,1.5,-200,10.5,100,-120,-102,-1.5,175,5.45,Camden Yards,13,1
2019-09-21,2019,TB,BOS,5,4,-200,-1.5,-105,8.5,-120,100,180,1.5,-115,5.67,Tropicana Field,9,1
2019-09-21,2019,STL,CHC,9,8,125,1.5,-140,12.0,105,-125,-135,-1.5,120,5.33,Wrigley Field,17,1
2019-09-21,2019,NYM,CIN,2,3,-150,-1.5,110,9.5,-110,-110,140,1.5,-130,5.7,Great American Ballpark,5,-1
2019-09-21,2019,PHI,CLE,9,4,140,1.5,-135,11.0,-105,-115,-150,-1.5,115,4.58,Progressive Field,13,5
2019-09-21,2019,LAD,COL,2,4,-420,-1.5,-180,8.5,100,-120,350,1.5,160,6.87,Dodger Stadium,6,-2
2019-09-21,2019,DET,CWS,3,5,118,1.5,-135,9.5,-105,-115,-128,-1.5,115,4.36,Comerica Park,8,-2
2019-09-21,2019,CWS,DET,5,3,-128,-1.5,115,9.5,-105,-115,118,1.5,-135,5.33,Comerica Park,8,2
2019-09-21,2019,LAA,HOU,8,4,260,1.5,125,9.5,-120,100,-300,-1.5,-145,2.64,Minute Maid Park,12,4
2019-09-21,2019,MIN,KC,5,12,-340,-1.5,-175,10.5,-110,-110,290,1.5,155,8.11,Target Field,17,-7
2019-09-21,2019,HOU,LAA,4,8,-300,-1.5,-145,9.5,-120,100,260,1.5,125,7.13,Minute Maid Park,12,-4
2019-09-21,2019,COL,LAD,4,2,350,1.5,160,8.5,100,-120,-420,-1.5,-180,1.89,Dodger Stadium,6,2
2019-09-21,2019,WSH,MIA,10,4,-350,-1.5,-200,8.0,-110,-110,300,1.5,175,6.22,Marlins Park,14,6
2019-09-21,2019,PIT,MIL,1,10,220,1.5,115,9.5,-105,-115,-250,-1.5,-135,2.97,Miller Park,11,-9
2019-09-21,2019,KC,MIN,12,5,290,1.5,155,10.5,-110,-110,-340,-1.5,-175,2.69,Target Field,17,7
2019-09-21,2019,CIN,NYM,3,2,140,1.5,-130,9.5,-110,-110,-150,-1.5,110,3.96,Great American Ballpark,5,1
2019-09-21,2019,TOR,NYY,2,7,300,1.5,140,9.0,-115,-105,-350,-1.5,-160,2.25,Yankee Stadium,9,-5
2019-09-21,2019,TEX,OAK,3,12,280,1.5,135,8.5,-110,-110,-320,-1.5,-155,2.24,Oakland Coliseum,15,-9
2019-09-21,2019,CLE,PHI,4,9,-150,-1.5,115,11.0,-105,-115,140,1.5,-135,6.6,Progressive Field,13,-5
2019-09-21,2019,MIL,PIT,10,1,-250,-1.5,-135,9.5,-105,-115,220,1.5,115,6.79,Miller Park,11,9
2019-09-21,2019,ARI,SD,4,2,-121,-1.5,130,8.0,-115,-105,111,1.5,-150,4.38,PETCO Park,6,2
2019-09-21,2019,BAL,SEA,6,7,-102,-1.5,175,10.5,100,-120,-108,1.5,-200,5.3,Camden Yards,13,-1
2019-09-21,2019,ATL,SF,8,1,-145,-1.5,140,8.0,-115,-105,135,1.5,-160,4.73,Suntrust Park,9,7
2019-09-21,2019,CHC,STL,8,9,-135,-1.5,120,12.0,105,-125,125,1.5,-140,6.89,Wrigley Field,17,-1
2019-09-21,2019,BOS,TB,4,5,180,1.5,-115,8.5,-120,100,-200,-1.5,-105,3.04,Tropicana Field,9,-1
2019-09-21,2019,OAK,TEX,12,3,-320,-1.5,-155,8.5,-110,-110,280,1.5,135,6.48,Oakland Coliseum,15,9
2019-09-21,2019,NYY,TOR,7,2,-350,-1.5,-160,9.0,-115,-105,300,1.5,140,7.0,Yankee Stadium,9,5
2019-09-21,2019,MIA,WSH,4,10,300,1.5,175,8.0,-110,-110,-350,-1.5,-200,2.0,Marlins Park,14,-6
2019-09-22,2019,SD,ARI,6,4,110,1.5,-155,8.0,-115,-105,-120,-1.5,135,3.81,PETCO Park,10,2
2019-09-22,2019,SF,ATL,4,1,180,1.5,-120,9.0,-115,-105,-200,-1.5,100,3.21,Suntrust Park,5,3
2019-09-22,2019,SEA,BAL,1,2,111,1.5,-180,9.5,-105,-115,-121,-1.5,160,4.5,Camden Yards,3,-1
2019-09-22,2019,TB,BOS,4,7,-157,-1.5,125,8.5,-120,100,147,1.5,-145,5.19,Tropicana Field,11,-3
2019-09-22,2019,STL,CHC,3,2,161,1.5,-115,12.5,105,-125,-172,-1.5,-105,4.79,Wrigley Field,5,1
2019-09-22,2019,NYM,CIN,6,3,-138,-1.5,110,9.0,-110,-110,128,1.5,-130,5.22,Great American Ballpark,9,3
2019-09-22,2019,PHI,CLE,1,10,117,1.5,-160,10.5,-115,-105,-127,-1.5,140,4.84,Progressive Field,11,-9
2019-09-22,2019,LAD,COL,7,4,-360,-1.5,-160,9.0,-105,-115,310,1.5,140,7.04,Dodger Stadium,11,3
2019-09-22,2019,DET,CWS,6,3,-105,-1.5,180,9.0,-125,105,-105,1.5,-205,4.61,Comerica Park,9,3
2019-09-22,2019,CWS,DET,3,6,-105,1.5,-205,9.0,-125,105,-105,-1.5,180,4.61,Comerica Park,9,-3
2019-09-22,2019,LAA,HOU,5,13,425,1.5,195,9.0,-105,-115,-550,-1.5,-220,1.71,Minute Maid Park,18,-8
2019-09-22,2019,MIN,KC,12,8,-230,-1.5,-120,10.5,-120,100,205,1.5,100,7.32,Target Field,20,4
2019-09-22,2019,HOU,LAA,13,5,-550,-1.5,-220,9.0,-105,-115,425,1.5,195,7.62,Minute Maid Park,18,8
2019-09-22,2019,COL,LAD,4,7,310,1.5,140,9.0,-105,-115,-360,-1.5,-160,2.2,Dodger Stadium,11,-3
2019-09-22,2019,WSH,MIA,3,5,-190,-1.5,-120,8.5,-115,-105,175,1.5,100,5.57,Marlins Park,8,-2
2019-09-22,2019,PIT,MIL,3,4,245,1.5,115,8.5,-115,-105,-280,-1.5,-135,2.46,Miller Park,7,-1
2019-09-22,2019,KC,MIN,8,12,205,1.5,100,10.5,-120,100,-230,-1.5,-120,3.44,Target Field,20,-4
2019-09-22,2019,CIN,NYM,3,6,128,1.5,-130,9.0,-110,-110,-138,-1.5,110,3.95,Great American Ballpark,9,-3
2019-09-22,2019,TOR,NYY,3,8,270,1.5,125,9.5,-105,-115,-310,-1.5,-145,2.57,Yankee Stadium,11,-5
2019-09-22,2019,TEX,OAK,8,3,159,1.5,-130,8.5,-105,-115,-169,-1.5,110,3.28,Oakland Coliseum,11,5
2019-09-22,2019,CLE,PHI,10,1,-127,-1.5,140,10.5,-115,-105,117,1.5,-160,5.87,Progressive Field,11,9
2019-09-22,2019,MIL,PIT,4,3,-280,-1.5,-135,8.5,-115,-105,245,1.5,115,6.26,Miller Park,7,1
2019-09-22,2019,ARI,SD,4,6,-120,-1.5,135,8.0,-115,-105,110,1.5,-155,4.36,PETCO Park,10,-2
2019-09-22,2019,BAL,SEA,2,1,-121,-1.5,160,9.5,-105,-115,111,1.5,-180,5.2,Camden Yards,3,1
2019-09-22,2019,ATL,SF,1,4,-200,-1.5,100,9.0,-115,-105,180,1.5,-120,6.0,Suntrust Park,5,-3
2019-09-22,2019,CHC,STL,2,3,-172,-1.5,-105,12.5,105,-125,161,1.5,-115,7.9,Wrigley Field,5,-1
2019-09-22,2019,BOS,TB,7,4,147,1.5,-145,8.5,-120,100,-157,-1.5,125,3.44,Tropicana Field,11,3
2019-09-22,2019,OAK,TEX,3,8,-169,-1.5,110,8.5,-105,-115,159,1.5,-130,5.34,Oakland Coliseum,11,-5
2019-09-22,2019,NYY,TOR,8,3,-310,-1.5,-145,9.5,-105,-115,270,1.5,125,7.18,Yankee Stadium,11,5
2019-09-22,2019,MIA,WSH,5,3,175,1.5,100,8.5,-115,-105,-190,-1.5,-120,3.09,Marlins Park,8,2
2019-09-23,2019,STL,ARI,9,7,-135,-1.5,120,8.5,-115,-105,125,1.5,-140,4.88,Chase Field,16,2
2019-09-23,2019,TOR,BAL,11,10,-170,-1.5,105,10.0,-110,-110,160,1.5,-125,6.3,Rogers Centre,21,1
2019-09-23,2019,TB,BOS,7,4,-200,-1.5,100,8.5,100,-120,180,1.5,-120,5.67,Tropicana Field,11,3
2019-09-23,2019,NYM,MIA,4,8,-260,-1.5,-130,8.5,-130,110,230,1.5,110,6.14,Citi Field,12,-4
2019-09-23,2019,MIA,NYM,8,4,230,1.5,110,8.5,-130,110,-260,-1.5,-130,2.58,Citi Field,12,4
2019-09-23,2019,WSH,PHI,7,2,-210,-1.5,-110,9.0,-120,100,190,1.5,-110,6.1,Nationals Park,9,5
2019-09-23,2019,ARI,STL,7,9,125,1.5,-140,8.5,-115,-105,-135,-1.5,120,3.78,Chase Field,16,-2
2019-09-23,2019,BOS,TB,4,7,180,1.5,-120,8.5,100,-120,-200,-1.5,100,3.04,Tropicana Field,11,-3
2019-09-23,2019,BAL,TOR,10,11,160,1.5,-125,10.0,-110,-110,-170,-1.5,105,3.85,Rogers Centre,21,-1
2019-09-23,2019,PHI,WSH,2,7,190,1.5,-110,9.0,-120,100,-210,-1.5,-110,3.1,Nationals Park,9,-5
2019-09-24,2019,STL,ARI,2,3,-200,-1.5,-120,8.5,-105,-115,180,1.5,100,5.67,Chase Field,5,-1
2019-09-24,2019,KC,ATL,9,6,150,1.5,-115,9.5,-110,-110,-160,-1.5,-105,3.8,Kauffman Stadium,15,3
2019-09-24,2019,TOR,BAL,4,11,-112,-1.5,170,10.0,100,-120,102,1.5,-190,5.28,Rogers Centre,15,-7
2019-09-24,2019,TEX,BOS,10,12,200,1.5,125,10.5,-120,100,-220,-1.5,-145,3.5,Rangers Ballpark,22,-2
2019-09-24,2019,PIT,CHC,9,2,175,1.5,-105,8.5,-120,100,-190,-1.5,-115,3.09,PNC Park,11,7
2019-09-24,2019,MIL,CIN,4,2,100,1.5,-200,8.5,100,-120,-110,-1.5,175,4.25,Great American Ballpark,6,2
2019-09-24,2019,CWS,CLE,0,11,260,1.5,160,9.0,-120,100,-300,-1.5,-180,2.5,Guaranteed Rate Field,11,-11
2019-09-24,2019,SF,COL,5,8,-180,-1.5,110,8.5,100,-120,165,1.5,-130,5.46,AT&T Park,13,-3
2019-09-24,2019,CLE,CWS,11,0,-300,-1.5,-180,9.0,-120,100,260,1.5,160,6.75,Guaranteed Rate Field,11,11
2019-09-24,2019,MIN,DET,4,2,-240,-1.5,-145,9.0,-120,100,210,1.5,125,6.35,Comerica Park,6,2
2019-09-24,2019,SEA,HOU,0,3,375,1.5,200,8.5,-115,-105,-450,-1.5,-230,1.79,T-Mobile Park,3,-3
2019-09-24,2019,ATL,KC,6,9,-160,-1.5,-105,9.5,-110,-110,150,1.5,-115,5.85,Kauffman Stadium,15,-3
2019-09-24,2019,OAK,LAA,2,3,-250,-1.5,-150,9.5,-110,-110,220,1.5,130,6.79,Angel Stadium,5,-1
2019-09-24,2019,SD,LAD,3,6,200,1.5,115,9.0,-115,-105,-220,-1.5,-135,3.0,PETCO Park,9,-3
2019-09-24,2019,NYM,MIA,5,4,-300,-1.5,-140,8.0,-105,-115,260,1.5,120,6.0,Citi Field,9,1
2019-09-24,2019,CIN,MIL,2,4,-110,-1.5,175,8.5,100,-120,100,1.5,-200,4.45,Great American Ballpark,6,-2
2019-09-24,2019,DET,MIN,2,4,210,1.5,125,9.0,-120,100,-240,-1.5,-145,2.9,Comerica Park,6,-2
2019-09-24,2019,MIA,NYM,4,5,260,1.5,120,8.0,-105,-115,-300,-1.5,-140,2.22,Citi Field,9,-1
2019-09-24,2019,TB,NYY,2,1,-123,-1.5,160,9.0,-110,-110,113,1.5,-180,4.96,Tropicana Field,3,1
2019-09-24,2019,LAA,OAK,3,2,220,1.5,130,9.5,-110,-110,-250,-1.5,-150,2.97,Angel Stadium,5,1
2019-09-24,2019,WSH,PHI,4,1,-155,-1.5,120,10.5,-130,110,145,1.5,-140,6.38,Nationals Park,5,3
2019-09-24,2019,WSH,PHI,6,5,-220,-1.5,-110,7.5,-120,100,200,1.5,-110,5.16,Nationals Park,11,1
2019-09-24,2019,CHC,PIT,2,9,-190,-1.5,-115,8.5,-120,100,175,1.5,-105,5.57,PNC Park,11,-7
2019-09-24,2019,LAD,SD,6,3,-220,-1.5,-135,9.0,-115,-105,200,1.5,115,6.19,PETCO Park,9,3
2019-09-24,2019,HOU,SEA,3,0,-450,-1.5,-230,8.5,-115,-105,375,1.5,200,6.95,T-Mobile Park,3,3
2019-09-24,2019,COL,SF,8,5,165,1.5,-130,8.5,100,-120,-180,-1.5,110,3.21,AT&T Park,13,3
2019-09-24,2019,ARI,STL,3,2,180,1.5,100,8.5,-105,-115,-200,-1.5,-120,3.04,Chase Field,5,1
2019-09-24,2019,NYY,TB,1,2,113,1.5,-180,9.0,-110,-110,-123,-1.5,160,4.23,Tropicana Field,3,-1
2019-09-24,2019,BOS,TEX,12,10,-220,-1.5,-145,10.5,-120,100,200,1.5,125,7.22,Rangers Ballpark,22,2
2019-09-24,2019,BAL,TOR,11,4,102,1.5,-190,10.0,100,-120,-112,-1.5,170,4.95,Rogers Centre,15,7
2019-09-24,2019,PHI,WSH,1,4,145,1.5,-140,10.5,-130,110,-155,-1.5,120,4.29,Nationals Park,5,-3
2019-09-24,2019,PHI,WSH,5,6,200,1.5,-110,7.5,-120,100,-220,-1.5,-110,2.5,Nationals Park,11,-1
2019-09-25,2019,STL,ARI,7,9,103,-1.5,160,8.5,-125,105,-113,1.5,-180,4.19,Chase Field,16,-2
2019-09-25,2019,KC,ATL,2,10,125,1.5,-135,9.5,-115,-105,-135,-1.5,115,4.22,Kauffman Stadium,12,-8
2019-09-25,2019,TOR,BAL,3,2,-148,-1.5,120,11.0,-105,-115,138,1.5,-140,6.56,Rogers Centre,5,1
2019-09-25,2019,TEX,BOS,3,10,112,1.5,-130,11.5,-120,100,-122,-1.5,110,5.42,Rangers Ballpark,13,-7
2019-09-25,2019,PIT,CHC,4,2,190,1.5,110,9.5,-105,-115,-210,-1.5,-130,3.28,PNC Park,6,2
2019-09-25,2019,MIL,CIN,9,2,-138,-1.5,105,9.0,-120,100,128,1.5,-125,5.22,Great American Ballpark,11,7
2019-09-25,2019,CWS,CLE,8,3,290,1.5,175,9.5,-115,-105,-340,-1.5,-200,2.44,Guaranteed Rate Field,11,5
2019-09-25,2019,SF,COL,2,1,-160,-1.5,120,8.5,-110,-110,150,1.5,-140,5.23,AT&T Park,3,1
2019-09-25,2019,CLE,CWS,3,8,-340,-1.5,-200,9.5,-115,-105,290,1.5,175,7.34,Guaranteed Rate Field,11,-5
2019-09-25,2019,MIN,DET,5,1,-196,-1.5,-125,9.5,-115,-105,178,1.5,105,6.29,Comerica Park,6,4
2019-09-25,2019,SEA,HOU,0,3,270,1.5,170,9.0,-125,105,-310,-1.5,-190,2.43,T-Mobile Park,3,-3
2019-09-25,2019,ATL,KC,10,2,-135,-1.5,115,9.5,-115,-105,125,1.5,-135,5.46,Kauffman Stadium,12,8
2019-09-25,2019,OAK,LAA,3,2,-230,-1.5,-145,8.5,-120,100,205,1.5,125,5.92,Angel Stadium,5,1
2019-09-25,2019,SD,LAD,4,6,163,1.5,-105,8.5,-110,-110,-176,-1.5,-115,3.23,PETCO Park,10,-2
2019-09-25,2019,NYM,MIA,10,3,-500,-1.5,-200,7.5,-110,-110,400,1.5,175,6.25,Citi Field,13,7
2019-09-25,2019,CIN,MIL,2,9,128,1.5,-125,9.0,-120,100,-138,-1.5,105,3.95,Great American Ballpark,11,-7
2019-09-25,2019,DET,MIN,1,5,178,1.5,105,9.5,-115,-105,-196,-1.5,-125,3.42,Comerica Park,6,-4
2019-09-25,2019,MIA,NYM,3,10,400,1.5,175,7.5,-110,-110,-500,-1.5,-200,1.5,Citi Field,13,-7
2019-09-25,2019,TB,NYY,4,0,-145,-1.5,130,8.0,-120,-100,135,1.5,-150,4.73,Tropicana Field,4,4
2019-09-25,2019,LAA,OAK,2,3,205,1.5,125,8.5,-120,100,-230,-1.5,-145,2.79,Angel Stadium,5,-1
2019-09-25,2019,WSH,PHI,5,2,-160,-1.5,115,10.0,100,-120,150,1.5,-135,6.15,Nationals Park,7,3
2019-09-25,2019,CHC,PIT,2,4,-210,-1.5,-130,9.5,-105,-115,190,1.5,110,6.44,PNC Park,6,-2
2019-09-25,2019,LAD,SD,6,4,-176,-1.5,-115,8.5,-110,-110,163,1.5,-105,5.42,PETCO Park,10,2
2019-09-25,2019,HOU,SEA,3,0,-310,-1.5,-190,9.0,-125,105,270,1.5,170,6.8,T-Mobile Park,3,3
2019-09-25,2019,COL,SF,1,2,150,1.5,-140,8.5,-110,-110,-160,-1.5,120,3.4,AT&T Park,3,-1
2019-09-25,2019,ARI,STL,9,7,-113,1.5,-180,8.5,-125,105,103,-1.5,160,4.51,Chase Field,16,2
2019-09-25,2019,NYY,TB,0,4,135,1.5,-150,8.0,-120,-100,-145,-1.5,130,3.4,Tropicana Field,4,-4
2019-09-25,2019,BOS,TEX,10,3,-122,-1.5,110,11.5,-120,100,112,1.5,-130,6.32,Rangers Ballpark,13,7
2019-09-25,2019,BAL,TOR,2,3,138,1.5,-140,11.0,-105,-115,-148,-1.5,120,4.62,Rogers Centre,5,-1
2019-09-25,2019,PHI,WSH,2,5,150,1.5,-135,10.0,100,-120,-160,-1.5,115,4.0,Nationals Park,7,-3
2019-09-26,2019,TEX,BOS,7,5,-126,-1.5,145,10.0,-115,-105,116,1.5,-165,5.58,Rangers Ballpark,12,2
2019-09-26,2019,PIT,CHC,9,5,-106,1.5,-170,8.0,100,-120,-104,-1.5,150,4.12,PNC Park,14,4
2019-09-26,2019,MIL,CIN,5,3,106,1.5,-185,8.0,-110,-110,-116,-1.5,165,3.88,Great American Ballpark,8,2
2019-09-26,2019,CWS,CLE,8,0,163,1.5,100,9.0,-115,-105,-176,-1.5,-120,3.42,Guaranteed Rate Field,8,8
2019-09-26,2019,SF,COL,8,3,-122,-1.5,170,8.5,-105,-115,112,1.5,-190,4.67,AT&T Park,11,5
2019-09-26,2019,CLE,CWS,0,8,-176,-1.5,-120,9.0,-115,-105,163,1.5,100,5.74,Guaranteed Rate Field,8,-8
2019-09-26,2019,MIN,DET,10,4,-133,-1.5,115,9.0,-120,100,123,1.5,-135,5.14,Comerica Park,14,6
2019-09-26,2019,LAA,HOU,4,3,175,1.5,110,9.0,-120,100,-190,-1.5,-130,3.27,Angel Stadium,7,1
2019-09-26,2019,HOU,LAA,3,4,-190,-1.5,-130,9.0,-120,100,175,1.5,110,5.9,Angel Stadium,7,-1
2019-09-26,2019,SD,LAD,0,1,175,1.5,105,8.0,-110,-110,-190,-1.5,-125,2.91,PETCO Park,1,-1
2019-09-26,2019,NYM,MIA,2,4,-270,-1.5,-135,8.0,-105,-115,240,1.5,115,5.84,Citi Field,6,-2
2019-09-26,2019,CIN,MIL,3,5,-116,-1.5,165,8.0,-110,-110,106,1.5,-185,4.3,Great American Ballpark,8,-2
2019-09-26,2019,DET,MIN,4,10,123,1.5,-135,9.0,-120,100,-133,-1.5,115,4.04,Comerica Park,14,-6
2019-09-26,2019,MIA,NYM,4,2,240,1.5,115,8.0,-105,-115,-270,-1.5,-135,2.35,Citi Field,6,2
2019-09-26,2019,SEA,OAK,1,3,210,1.5,120,9.0,100,-120,-240,-1.5,-140,2.9,T-Mobile Park,4,-2
2019-09-26,2019,WSH,PHI,6,3,-270,-1.5,-130,9.0,-115,-105,240,1.5,110,6.57,Nationals Park,9,3
2019-09-26,2019,CHC,PIT,5,9,-104,-1.5,150,8.0,100,-120,-106,1.5,-170,4.08,PNC Park,14,-4
2019-09-26,2019,LAD,SD,1,0,-190,-1.5,-125,8.0,-110,-110,175,1.5,105,5.24,PETCO Park,1,1
2019-09-26,2019,OAK,SEA,3,1,-240,-1.5,-140,9.0,100,-120,210,1.5,120,6.35,T-Mobile Park,4,2
2019-09-26,2019,COL,SF,3,8,112,1.5,-190,8.5,-105,-115,-122,-1.5,170,4.01,AT&T Park,11,-5
2019-09-26,2019,BOS,TEX,5,7,116,1.5,-165,10.0,-115,-105,-126,-1.5,145,4.63,Rangers Ballpark,12,-2
2019-09-26,2019,PHI,WSH,3,6,240,1.5,110,9.0,-115,-105,-270,-1.5,-130,2.65,Nationals Park,9,-3
2019-09-27,2019,SD,ARI,3,6,117,1.5,-165,9.0,-120,100,-127,-1.5,145,4.15,Chase Field,9,-3
2019-09-27,2019,NYM,ATL,4,2,-105,-1.5,185,8.0,-120,100,-105,1.5,-210,4.1,Citi Field,6,2
2019-09-27,2019,BOS,BAL,1,4,-200,-1.5,-115,10.5,-110,-110,180,1.5,-105,7.0,Fenway Park,5,-3
2019-09-27,2019,BAL,BOS,4,1,180,1.5,-105,10.5,-110,-110,-200,-1.5,-115,3.75,Fenway Park,5,3
2019-09-27,2019,STL,CHC,2,8,-205,-1.5,-115,8.5,100,-120,185,1.5,-105,5.71,Busch Stadium,10,-6
2019-09-27,2019,PIT,CIN,6,5,145,1.5,-120,8.5,-105,-115,-155,-1.5,100,3.47,PNC Park,11,1
2019-09-27,2019,WSH,CLE,8,2,-140,-1.5,135,9.5,-120,100,130,1.5,-155,5.54,Nationals Park,10,6
2019-09-27,2019,MIL,COL,7,11,-152,-1.5,-110,12.5,-120,100,142,1.5,-110,7.54,Coors Field,18,-4
2019-09-27,2019,LAA,HOU,0,4,190,1.5,120,9.5,-105,-115,-210,-1.5,-140,3.28,Angel Stadium,4,-4
2019-09-27,2019,MIN,KC,6,2,-240,-1.5,-150,10.0,-115,-105,210,1.5,130,7.06,Kauffman Stadium,8,4
2019-09-27,2019,HOU,LAA,4,0,-210,-1.5,-140,9.5,-105,-115,190,1.5,120,6.44,Angel Stadium,4,4
2019-09-27,2019,SF,LAD,2,9,180,1.5,110,7.5,-110,-110,-200,-1.5,-130,2.68,AT&T Park,11,-7
2019-09-27,2019,PHI,MIA,5,4,-185,-1.5,110,9.0,-115,-105,170,1.5,-130,5.84,Citizens Bank Park,9,1
2019-09-27,2019,COL,MIL,11,7,142,1.5,-110,12.5,-120,100,-152,-1.5,-110,5.17,Coors Field,18,4
2019-09-27,2019,KC,MIN,2,6,210,1.5,130,10.0,-115,-105,-240,-1.5,-150,3.23,Kauffman Stadium,8,-4
2019-09-27,2019,ATL,NYM,2,4,-105,1.5,-210,8.0,-120,100,-105,-1.5,185,4.1,Citi Field,6,-2
2019-09-27,2019,TEX,NYY,7,14,245,1.5,155,10.5,-125,105,-280,-1.5,-175,3.04,Rangers Ballpark,21,-7
2019-09-27,2019,SEA,OAK,4,3,180,1.5,115,9.0,-110,-110,-200,-1.5,-135,3.21,T-Mobile Park,7,1
2019-09-27,2019,MIA,PHI,4,5,170,1.5,-130,9.0,-115,-105,-185,-1.5,110,3.33,Citizens Bank Park,9,-1
2019-09-27,2019,CIN,PIT,5,6,-155,-1.5,100,8.5,-105,-115,145,1.5,-120,5.17,PNC Park,11,-1
2019-09-27,2019,ARI,SD,6,3,-127,-1.5,145,9.0,-120,100,117,1.5,-165,5.04,Chase Field,9,3
2019-09-27,2019,OAK,SEA,3,4,-200,-1.5,-135,9.0,-110,-110,180,1.5,115,6.0,T-Mobile Park,7,-1
2019-09-27,2019,LAD,SF,9,2,-200,-1.5,-130,7.5,-110,-110,180,1.5,110,5.0,AT&T Park,11,7
2019-09-27,2019,CHC,STL,8,2,185,1.5,-105,8.5,100,-120,-205,-1.5,-115,2.98,Busch Stadium,10,6
2019-09-27,2019,TOR,TB,2,6,205,1.5,130,9.5,-105,-115,-230,-1.5,-150,3.11,Rogers Centre,8,-4
2019-09-27,2019,NYY,TEX,14,7,-280,-1.5,-175,10.5,-125,105,245,1.5,155,7.74,Rangers Ballpark,21,7
2019-09-27,2019,TB,TOR,6,2,-230,-1.5,-150,9.5,-105,-115,205,1.5,130,6.62,Rogers Centre,8,4
2019-09-27,2019,CLE,WSH,2,8,130,1.5,-155,9.5,-120,100,-140,-1.5,135,4.13,Nationals Park,10,-6
2019-09-28,2019,SD,ARI,5,6,140,1.5,-150,9.0,-120,100,-150,-1.5,130,3.75,Chase Field,11,-1
2019-09-28,2019,NYM,ATL,3,0,-110,-1.5,185,8.5,-120,100,100,1.5,-210,4.45,Citi Field,3,3
2019-09-28,2019,BOS,BAL,4,9,-152,-1.5,120,10.0,-120,100,142,1.5,-140,6.03,Fenway Park,13,-5
2019-09-28,2019,BAL,BOS,9,4,142,1.5,-140,10.0,-120,100,-152,-1.5,120,4.13,Fenway Park,13,5
2019-09-28,2019,STL,CHC,6,8,-190,-1.5,100,8.5,-115,-105,175,1.5,-120,5.57,Busch Stadium,14,-2
2019-09-28,2019,PIT,CIN,2,4,128,1.5,-135,9.0,-105,-115,-138,-1.5,115,3.95,PNC Park,6,-2
2019-09-28,2019,WSH,CLE,10,7,-270,-1.5,-130,9.0,-120,100,240,1.5,110,6.57,Nationals Park,17,3
2019-09-28,2019,MIL,COL,2,3,-160,-1.5,-115,13.0,-120,100,150,1.5,-105,8.0,Coors Field,5,-1
2019-09-28,2019,DET,CWS,1,7,112,1.5,-170,9.0,-115,-105,-122,-1.5,150,4.25,Guaranteed Rate Field,8,-6
2019-09-28,2019,DET,CWS,4,3,148,1.5,-140,9.5,-105,-115,-158,-1.5,120,3.83,Guaranteed Rate Field,7,1
2019-09-28,2019,CWS,DET,7,1,-122,-1.5,150,9.0,-115,-105,112,1.5,-170,4.95,Guaranteed Rate Field,8,6
2019-09-28,2019,CWS,DET,3,4,-158,-1.5,120,9.5,-105,-115,148,1.5,-140,5.82,Guaranteed Rate Field,7,-1
2019-09-28,2019,LAA,HOU,3,6,360,1.5,210,9.0,-105,-115,-430,-1.5,-240,1.96,Angel Stadium,9,-3
2019-09-28,2019,MIN,KC,4,3,-185,-1.5,-120,10.5,100,-120,170,1.5,100,6.82,Kauffman Stadium,7,1
2019-09-28,2019,HOU,LAA,6,3,-430,-1.5,-240,9.0,-105,-115,360,1.5,210,7.3,Angel Stadium,9,3
2019-09-28,2019,SF,LAD,0,2,185,1.5,115,8.5,-110,-110,-205,-1.5,-135,2.98,AT&T Park,2,-2
2019-09-28,2019,PHI,MIA,9,3,-180,-1.5,110,9.0,-105,-115,165,1.5,-130,5.79,Citizens Bank Park,12,6
2019-09-28,2019,COL,MIL,3,2,150,1.5,-105,13.0,-120,100,-160,-1.5,-115,5.2,Coors Field,5,1
2019-09-28,2019,KC,MIN,3,4,170,1.5,100,10.5,100,-120,-185,-1.5,-120,3.89,Kauffman Stadium,7,-1
2019-09-28,2019,ATL,NYM,0,3,100,1.5,-210,8.5,-120,100,-110,-1.5,185,4.25,Citi Field,3,-3
2019-09-28,2019,TEX,NYY,9,4,245,1.5,165,11.0,-105,-115,-280,-1.5,-185,3.19,Rangers Ballpark,13,5
2019-09-28,2019,SEA,OAK,0,1,165,1.5,100,9.0,-105,-115,-180,-1.5,-120,3.4,T-Mobile Park,1,-1
2019-09-28,2019,MIA,PHI,3,9,165,1.5,-130,9.0,-105,-115,-180,-1.5,110,3.4,Citizens Bank Park,12,-6
2019-09-28,2019,CIN,PIT,4,2,-138,-1.5,115,9.0,-105,-115,128,1.5,-135,5.22,PNC Park,6,2
2019-09-28,2019,ARI,SD,6,5,-150,-1.5,130,9.0,-120,100,140,1.5,-150,5.4,Chase Field,11,1
2019-09-28,2019,OAK,SEA,1,0,-180,-1.5,-120,9.0,-105,-115,165,1.5,100,5.79,T-Mobile Park,1,1
2019-09-28,2019,LAD,SF,2,0,-205,-1.5,-135,8.5,-110,-110,185,1.5,115,5.71,AT&T Park,2,2
2019-09-28,2019,CHC,STL,8,6,175,1.5,-120,8.5,-115,-105,-190,-1.5,100,3.09,Busch Stadium,14,2
2019-09-28,2019,TOR,TB,4,1,175,1.5,110,9.0,-120,100,-190,-1.5,-130,3.27,Rogers Centre,5,3
2019-09-28,2019,NYY,TEX,4,9,-280,-1.5,-185,11.0,-105,-115,245,1.5,165,8.11,Rangers Ballpark,13,-5
2019-09-28,2019,TB,TOR,1,4,-190,-1.5,-130,9.0,-120,100,175,1.5,110,5.9,Rogers Centre,5,-3
2019-09-28,2019,CLE,WSH,7,10,240,1.5,110,9.0,-120,100,-270,-1.5,-130,2.65,Nationals Park,17,-3
2019-09-29,2019,SD,ARI,0,1,120,1.5,-165,9.5,-115,-105,-130,-1.5,145,4.32,Chase Field,1,-1
2019-09-29,2019,NYM,ATL,7,6,-115,-1.5,175,8.0,-105,-115,105,1.5,-200,4.28,Citi Field,13,1
2019-09-29,2019,BOS,BAL,5,4,-300,-1.5,-150,10.0,-115,-105,260,1.5,130,7.5,Fenway Park,9,1
2019-09-29,2019,BAL,BOS,4,5,260,1.5,130,10.0,-115,-105,-300,-1.5,-150,2.78,Fenway Park,9,-1
2019-09-29,2019,STL,CHC,9,0,-300,-1.5,-140,8.5,105,-125,260,1.5,120,6.38,Busch Stadium,9,9
2019-09-29,2019,PIT,CIN,1,3,105,1.5,-155,8.5,-115,-105,-115,-1.5,135,4.15,PNC Park,4,-2
2019-09-29,2019,WSH,CLE,8,2,155,1.5,-110,8.5,-115,-105,-165,-1.5,-110,3.33,Nationals Park,10,6
2019-09-29,2019,MIL,COL,3,4,-185,-1.5,-135,13.0,110,-130,170,1.5,115,8.44,Coors Field,7,-1
2019-09-29,2019,DET,CWS,3,5,140,1.5,-145,9.5,-115,-105,-150,-1.5,125,3.96,Guaranteed Rate Field,8,-2
2019-09-29,2019,CWS,DET,5,3,-150,-1.5,125,9.5,-115,-105,140,1.5,-145,5.7,Guaranteed Rate Field,8,2
2019-09-29,2019,LAA,HOU,5,8,340,1.5,200,8.5,-125,105,-410,-1.5,-230,1.93,Angel Stadium,13,-3
2019-09-29,2019,MIN,KC,4,5,-135,-1.5,120,10.5,-110,-110,125,1.5,-140,6.03,Kauffman Stadium,9,-1
2019-09-29,2019,HOU,LAA,8,5,-410,-1.5,-230,8.5,-125,105,340,1.5,200,6.83,Angel Stadium,13,3
2019-09-29,2019,SF,LAD,0,9,155,1.5,-125,8.5,-115,-105,-165,-1.5,105,3.33,AT&T Park,9,-9
2019-09-29,2019,PHI,MIA,3,4,-165,-1.5,110,9.0,-115,-105,155,1.5,-130,5.6,Citizens Bank Park,7,-1
2019-09-29,2019,COL,MIL,4,3,170,1.5,115,13.0,110,-130,-185,-1.5,-135,4.81,Coors Field,7,1
2019-09-29,2019,KC,MIN,5,4,125,1.5,-140,10.5,-110,-110,-135,-1.5,120,4.67,Kauffman Stadium,9,1
2019-09-29,2019,ATL,NYM,6,7,105,1.5,-200,8.0,-105,-115,-115,-1.5,175,3.9,Citi Field,13,-1
2019-09-29,2019,TEX,NYY,6,1,129,1.5,-115,10.5,-115,-105,-139,-1.5,-105,4.59,Rangers Ballpark,7,5
2019-09-29,2019,SEA,OAK,3,1,130,1.5,-125,9.0,-105,-115,-140,-1.5,105,3.91,T-Mobile Park,4,2
2019-09-29,2019,MIA,PHI,4,3,155,1.5,-130,9.0,-115,-105,-165,-1.5,110,3.53,Citizens Bank Park,7,1
2019-09-29,2019,CIN,PIT,3,1,-115,-1.5,135,8.5,-115,-105,105,1.5,-155,4.55,PNC Park,4,2
2019-09-29,2019,ARI,SD,1,0,-130,-1.5,145,9.5,-115,-105,120,1.5,-165,5.37,Chase Field,1,1
2019-09-29,2019,OAK,SEA,1,3,-140,-1.5,105,9.0,-105,-115,130,1.5,-125,5.25,T-Mobile Park,4,-2
2019-09-29,2019,LAD,SF,9,0,-165,-1.5,105,8.5,-115,-105,155,1.5,-125,5.29,AT&T Park,9,9
2019-09-29,2019,CHC,STL,0,9,260,1.5,120,8.5,105,-125,-300,-1.5,-140,2.36,Busch Stadium,9,-9
2019-09-29,2019,TOR,TB,8,3,195,1.5,120,9.0,100,-120,-215,-1.5,-140,3.05,Rogers Centre,11,5
2019-09-29,2019,NYY,TEX,1,6,-139,-1.5,-105,10.5,-115,-105,129,1.5,-115,6.11,Rangers Ballpark,7,-5
2019-09-29,2019,TB,TOR,3,8,-215,-1.5,-140,9.0,100,-120,195,1.5,120,6.14,Rogers Centre,11,-5
2019-09-29,2019,CLE,WSH,2,8,-165,-1.5,-110,8.5,-115,-105,155,1.5,-110,5.29,Nationals Park,10,-6
2020-07-23,2020,SF,LAD,1,8,250,1.5,150,9.0,-120,100,-290,-1.5,-170,2.57,Dodger Stadium,9,-7
2020-07-23,2020,WSH,NYY,1,4,160,1.5,-105,7.5,-115,-105,-170,-1.5,-115,2.88,Nationals Park,5,-3
2020-07-23,2020,LAD,SF,8,1,-290,-1.5,-170,9.0,-120,100,250,1.5,150,6.69,Dodger Stadium,9,7
2020-07-23,2020,NYY,WSH,4,1,-170,-1.5,-115,7.5,-115,-105,160,1.5,-105,4.72,Nationals Park,5,3
2020-07-24,2020,SD,ARI,7,2,-140,-1.5,145,8.0,-115,-105,130,1.5,-165,4.67,PETCO Park,9,5
2020-07-24,2020,NYM,ATL,1,0,-167,-1.5,135,7.5,-120,100,157,1.5,-155,4.69,Citi Field,1,1
2020-07-24,2020,BOS,BAL,13,2,-215,-1.5,-120,10.0,105,-125,195,1.5,100,6.83,Fenway Park,15,11
2020-07-24,2020,BAL,BOS,2,13,195,1.5,100,10.0,105,-125,-215,-1.5,-120,3.39,Fenway Park,15,-11
2020-07-24,2020,MIL,CHC,0,3,105,1.5,-190,8.5,-120,100,-115,-1.5,170,4.15,Wrigley Field,3,-3
2020-07-24,2020,DET,CIN,1,7,163,1.5,-125,9.0,-105,-115,-176,-1.5,105,3.42,Great American Ballpark,8,-6
2020-07-24,2020,KC,CLE,0,2,205,1.5,105,9.0,100,-120,-225,-1.5,-125,2.95,Progressive Field,2,-2
2020-07-24,2020,TEX,COL,1,0,-105,-1.5,175,9.0,-105,-115,-105,1.5,-200,4.61,Globe Life Field,1,1
2020-07-24,2020,MIN,CWS,10,5,-117,-1.5,135,9.0,-110,-110,107,1.5,-155,4.85,Guaranteed Rate Field,15,5
2020-07-24,2020,CIN,DET,7,1,-176,-1.5,105,9.0,-105,-115,163,1.5,-125,5.74,Great American Ballpark,8,6
2020-07-24,2020,SEA,HOU,2,8,250,1.5,135,8.5,-120,100,-290,-1.5,-155,2.43,Minute Maid Park,10,-6
2020-07-24,2020,CLE,KC,2,0,-225,-1.5,-125,9.0,100,-120,205,1.5,105,6.23,Progressive Field,2,2
2020-07-24,2020,OAK,LAA,7,3,-146,-1.5,140,8.5,100,-120,136,1.5,-160,5.04,Oakland Coliseum,10,4
2020-07-24,2020,SF,LAD,1,9,285,1.5,145,9.0,-120,100,-330,-1.5,-165,2.34,Dodger Stadium,10,-8
2020-07-24,2020,PHI,MIA,2,5,-205,-1.5,-110,9.0,-105,-115,185,1.5,-110,6.05,Citizens Bank Park,7,-3
2020-07-24,2020,CHC,MIL,3,0,-115,-1.5,170,8.5,-120,100,105,1.5,-190,4.55,Wrigley Field,3,3
2020-07-24,2020,CWS,MIN,5,10,107,1.5,-155,9.0,-110,-110,-117,-1.5,135,4.35,Guaranteed Rate Field,15,-5
2020-07-24,2020,ATL,NYM,0,1,157,1.5,-155,7.5,-120,100,-167,-1.5,135,2.92,Citi Field,1,-1
2020-07-24,2020,LAA,OAK,3,7,136,1.5,-160,8.5,100,-120,-146,-1.5,140,3.6,Oakland Coliseum,10,-4
2020-07-24,2020,MIA,PHI,5,2,185,1.5,-110,9.0,-105,-115,-205,-1.5,-110,3.16,Citizens Bank Park,7,3
2020-07-24,2020,STL,PIT,5,4,-180,-1.5,105,8.0,-105,-115,165,1.5,-125,5.14,Busch Stadium,9,1
2020-07-24,2020,ARI,SD,2,7,130,1.5,-165,8.0,-115,-105,-140,-1.5,145,3.48,PETCO Park,9,-5
2020-07-24,2020,HOU,SEA,8,2,-290,-1.5,-155,8.5,-120,100,250,1.5,135,6.32,Minute Maid Park,10,6
2020-07-24,2020,LAD,SF,9,1,-330,-1.5,-165,9.0,-120,100,285,1.5,145,6.91,Dodger Stadium,10,8
2020-07-24,2020,PIT,STL,4,5,165,1.5,-125,8.0,-105,-115,-180,-1.5,105,3.02,Busch Stadium,9,-1
2020-07-24,2020,TOR,TB,6,4,135,1.5,-160,7.5,-100,-120,-145,-1.5,140,3.19,Tropicana Field,10,2
2020-07-24,2020,COL,TEX,0,1,-105,1.5,-200,9.0,-105,-115,-105,-1.5,175,4.61,Globe Life Field,1,-1
2020-07-24,2020,TB,TOR,4,6,-145,-1.5,140,7.5,-100,-120,135,1.5,-160,4.44,Tropicana Field,10,-2
2020-07-25,2020,SD,ARI,5,1,-128,-1.5,160,8.0,-115,-105,118,1.5,-180,4.49,PETCO Park,6,4
2020-07-25,2020,NYM,ATL,3,5,106,-1.5,210,9.0,100,-120,-116,1.5,-240,4.37,Citi Field,8,-2
2020-07-25,2020,BOS,BAL,2,7,-200,-1.5,-115,10.5,-105,-115,180,1.5,-105,7.0,Fenway Park,9,-5
2020-07-25,2020,BAL,BOS,7,2,180,1.5,-105,10.5,-105,-115,-200,-1.5,-115,3.75,Fenway Park,9,5
2020-07-25,2020,MIL,CHC,8,3,140,1.5,-150,9.5,-110,-110,-150,-1.5,130,3.96,Wrigley Field,11,5
2020-07-25,2020,DET,CIN,6,4,245,1.5,135,9.0,-125,105,-280,-1.5,-155,2.61,Great American Ballpark,10,2
2020-07-25,2020,KC,CLE,3,2,230,1.5,115,9.0,-105,-115,-260,-1.5,-135,2.73,Progressive Field,5,1
2020-07-25,2020,TEX,COL,2,3,-120,-1.5,155,8.5,-115,-105,110,1.5,-175,4.64,Globe Life Field,5,-1
2020-07-25,2020,MIN,CWS,3,10,-110,-1.5,135,10.0,-115,-105,100,1.5,-155,5.24,Guaranteed Rate Field,13,-7
2020-07-25,2020,CIN,DET,4,6,-280,-1.5,-155,9.0,-125,105,245,1.5,135,6.63,Great American Ballpark,10,-2
2020-07-25,2020,SEA,HOU,2,7,260,1.5,135,9.5,-110,-110,-300,-1.5,-155,2.64,Minute Maid Park,9,-5
2020-07-25,2020,CLE,KC,2,3,-260,-1.5,-135,9.0,-105,-115,230,1.5,115,6.5,Progressive Field,5,-1
2020-07-25,2020,OAK,LAA,1,4,-124,-1.5,160,8.5,100,-120,114,1.5,-180,4.71,Oakland Coliseum,5,-3
2020-07-25,2020,SF,LAD,5,4,320,1.5,165,9.5,-110,-110,-380,-1.5,-185,2.26,Dodger Stadium,9,1
2020-07-25,2020,PHI,MIA,7,1,-185,-1.5,110,9.0,-120,100,170,1.5,-130,5.84,Citizens Bank Park,8,6
2020-07-25,2020,CHC,MIL,3,8,-150,-1.5,130,9.5,-110,-110,140,1.5,-150,5.7,Wrigley Field,11,-5
2020-07-25,2020,CWS,MIN,10,3,100,1.5,-155,10.0,-115,-105,-110,-1.5,135,5.0,Guaranteed Rate Field,13,7
2020-07-25,2020,ATL,NYM,5,3,-116,1.5,-240,9.0,100,-120,106,-1.5,210,4.83,Citi Field,8,2
2020-07-25,2020,WSH,NYY,9,2,200,1.5,125,10.0,100,-120,-220,-1.5,-145,3.33,Nationals Park,11,7
2020-07-25,2020,LAA,OAK,4,1,114,1.5,-180,8.5,100,-120,-124,-1.5,160,3.97,Oakland Coliseum,5,3
2020-07-25,2020,MIA,PHI,1,7,170,1.5,-130,9.0,-120,100,-185,-1.5,110,3.33,Citizens Bank Park,8,-6
2020-07-25,2020,STL,PIT,9,1,-151,-1.5,130,9.0,-115,-105,141,1.5,-150,5.41,Busch Stadium,10,8
2020-07-25,2020,ARI,SD,1,5,118,1.5,-180,8.0,-115,-105,-128,-1.5,160,3.67,PETCO Park,6,-4
2020-07-25,2020,HOU,SEA,7,2,-300,-1.5,-155,9.5,-110,-110,260,1.5,135,7.13,Minute Maid Park,9,5
2020-07-25,2020,LAD,SF,4,5,-380,-1.5,-185,9.5,-110,-110,320,1.5,165,7.52,Dodger Stadium,9,-1
2020-07-25,2020,PIT,STL,1,9,141,1.5,-150,9.0,-115,-105,-151,-1.5,130,3.73,Busch Stadium,10,-8
2020-07-25,2020,TOR,TB,1,4,135,1.5,-160,8.5,105,-125,-145,-1.5,140,3.62,Tropicana Field,5,-3
2020-07-25,2020,COL,TEX,3,2,110,1.5,-175,8.5,-115,-105,-120,-1.5,155,4.05,Globe Life Field,5,1
2020-07-25,2020,TB,TOR,4,1,-145,-1.5,140,8.5,105,-125,135,1.5,-160,5.03,Tropicana Field,5,3
2020-07-25,2020,NYY,WSH,2,9,-220,-1.5,-145,10.0,100,-120,200,1.5,125,6.88,Nationals Park,11,-7
2020-07-26,2020,SD,ARI,3,4,-125,-1.5,150,8.0,100,-120,115,1.5,-170,4.44,PETCO Park,7,-1
2020-07-26,2020,NYM,ATL,1,14,-105,1.5,-165,9.5,100,-120,-105,-1.5,145,4.87,Citi Field,15,-13
2020-07-26,2020,BOS,BAL,4,7,-196,-1.5,-110,11.0,-110,-110,178,1.5,-110,7.28,Fenway Park,11,-3
2020-07-26,2020,BAL,BOS,7,4,178,1.5,-110,11.0,-110,-110,-196,-1.5,-110,3.96,Fenway Park,11,3
2020-07-26,2020,MIL,CHC,1,9,-105,1.5,-200,11.5,-125,105,-105,-1.5,175,5.89,Wrigley Field,10,-8
2020-07-26,2020,DET,CIN,3,2,177,1.5,-115,9.5,110,-130,-194,-1.5,-105,3.43,Great American Ballpark,5,1
2020-07-26,2020,KC,CLE,2,9,200,1.5,-110,9.0,100,-120,-220,-1.5,-110,3.0,Progressive Field,11,-7
2020-07-26,2020,TEX,COL,2,5,-140,-1.5,130,8.5,-115,-105,130,1.5,-150,4.96,Globe Life Field,7,-3
2020-07-26,2020,MIN,CWS,14,2,-150,-1.5,-105,10.0,-120,100,140,1.5,-115,6.0,Guaranteed Rate Field,16,12
2020-07-26,2020,CIN,DET,2,3,-194,-1.5,-105,9.5,110,-130,177,1.5,-115,6.27,Great American Ballpark,5,-1
2020-07-26,2020,SEA,HOU,7,6,235,1.5,130,9.0,-115,-105,-265,-1.5,-150,2.69,Minute Maid Park,13,1
2020-07-26,2020,CLE,KC,9,2,-220,-1.5,-110,9.0,100,-120,200,1.5,-110,6.19,Progressive Field,11,7
2020-07-26,2020,OAK,LAA,6,4,-110,1.5,-170,9.0,-105,-115,100,-1.5,150,4.71,Oakland Coliseum,10,2
2020-07-26,2020,SF,LAD,3,1,270,1.5,145,9.0,-110,-110,-310,-1.5,-165,2.43,Dodger Stadium,4,2
2020-07-26,2020,PHI,MIA,6,11,-205,-1.5,-115,9.5,-120,100,185,1.5,-105,6.39,Citizens Bank Park,17,-5
2020-07-26,2020,CHC,MIL,9,1,-105,-1.5,175,11.5,-125,105,-105,1.5,-200,5.89,Wrigley Field,10,8
2020-07-26,2020,CWS,MIN,2,14,140,1.5,-115,10.0,-120,100,-150,-1.5,-105,4.17,Guaranteed Rate Field,16,-12
2020-07-26,2020,ATL,NYM,14,1,-105,-1.5,145,9.5,100,-120,-105,1.5,-165,4.87,Citi Field,15,13
2020-07-26,2020,WSH,NYY,2,3,110,1.5,-150,10.0,100,-120,-120,-1.5,130,4.76,Nationals Park,5,-1
2020-07-26,2020,LAA,OAK,4,6,100,-1.5,150,9.0,-105,-115,-110,1.5,-170,4.5,Oakland Coliseum,10,-2
2020-07-26,2020,MIA,PHI,11,6,185,1.5,-105,9.5,-120,100,-205,-1.5,-115,3.33,Citizens Bank Park,17,5
2020-07-26,2020,STL,PIT,1,5,-140,-1.5,125,9.0,-105,-115,130,1.5,-145,5.25,Busch Stadium,6,-4
2020-07-26,2020,ARI,SD,4,3,115,1.5,-170,8.0,100,-120,-125,-1.5,150,3.72,PETCO Park,7,1
2020-07-26,2020,HOU,SEA,6,7,-265,-1.5,-150,9.0,-115,-105,235,1.5,130,6.53,Minute Maid Park,13,-1
2020-07-26,2020,LAD,SF,1,3,-310,-1.5,-165,9.0,-110,-110,270,1.5,145,6.8,Dodger Stadium,4,-2
2020-07-26,2020,PIT,STL,5,1,130,1.5,-145,9.0,-105,-115,-140,-1.5,125,3.91,Busch Stadium,6,4
2020-07-26,2020,TOR,TB,5,6,170,1.5,-120,8.0,-105,-115,-185,-1.5,100,2.96,Tropicana Field,11,-1
2020-07-26,2020,COL,TEX,5,2,130,1.5,-150,8.5,-115,-105,-140,-1.5,130,3.7,Globe Life Field,7,3
2020-07-26,2020,TB,TOR,6,5,-185,-1.5,100,8.0,-105,-115,170,1.5,-120,5.19,Tropicana Field,11,1
2020-07-26,2020,NYY,WSH,3,2,-120,-1.5,130,10.0,100,-120,110,1.5,-150,5.45,Nationals Park,5,1
2020-07-27,2020,SD,ARI,6,2,-117,-1.5,160,8.5,100,-120,107,1.5,-180,4.58,PETCO Park,8,4
2020-07-27,2020,TB,ATL,14,5,-140,-1.5,145,8.0,-110,-110,130,1.5,-165,4.67,Tropicana Field,19,9
2020-07-27,2020,NYM,BOS,7,4,-113,-1.5,130,11.5,-110,-110,103,1.5,-150,6.1,Fenway Park,11,3
2020-07-27,2020,CIN,CHC,7,8,105,1.5,-155,10.0,-120,100,-115,-1.5,135,4.88,Great American Ballpark,15,-1
2020-07-27,2020,CHC,CIN,8,7,-115,-1.5,135,10.0,-120,100,105,1.5,-155,5.35,Great American Ballpark,15,1
2020-07-27,2020,KC,DET,14,6,107,1.5,-175,9.5,-120,100,-117,-1.5,155,4.59,Comerica Park,20,8
2020-07-27,2020,SEA,HOU,5,8,210,1.5,115,9.0,-115,-105,-240,-1.5,-135,2.9,Minute Maid Park,13,-3
2020-07-27,2020,DET,KC,6,14,-117,-1.5,155,9.5,-120,100,107,1.5,-175,5.12,Comerica Park,20,-8
2020-07-27,2020,OAK,LAA,3,0,-120,-1.5,145,9.0,-105,-115,110,1.5,-165,4.91,Oakland Coliseum,3,3
2020-07-27,2020,PIT,MIL,5,6,158,1.5,-110,9.5,-110,-110,-168,-1.5,-110,3.68,PNC Park,11,-1
2020-07-27,2020,BOS,NYM,4,7,103,1.5,-150,11.5,-110,-110,-113,-1.5,130,5.67,Fenway Park,11,-3
2020-07-27,2020,LAA,OAK,0,3,110,1.5,-165,9.0,-105,-115,-120,-1.5,145,4.29,Oakland Coliseum,3,-3
2020-07-27,2020,MIL,PIT,6,5,-168,-1.5,-110,9.5,-110,-110,158,1.5,-110,5.96,PNC Park,11,1
2020-07-27,2020,ARI,SD,2,6,107,1.5,-180,8.5,100,-120,-117,-1.5,160,4.11,PETCO Park,8,-4
2020-07-27,2020,HOU,SEA,8,5,-240,-1.5,-135,9.0,-115,-105,210,1.5,115,6.35,Minute Maid Park,13,3
2020-07-27,2020,ATL,TB,5,14,130,1.5,-165,8.0,-110,-110,-140,-1.5,145,3.48,Tropicana Field,19,-9
2020-07-27,2020,WSH,TOR,1,4,-120,-1.5,145,10.5,100,-120,110,1.5,-165,5.73,Nationals Park,5,-3
2020-07-27,2020,TOR,WSH,4,1,110,1.5,-165,10.5,100,-120,-120,-1.5,145,5.0,Nationals Park,5,3
2020-07-28,2020,TEX,ARI,1,4,-104,-1.5,175,9.0,-110,-110,-106,1.5,-200,4.59,Globe Life Field,5,-3
2020-07-28,2020,TB,ATL,5,2,-130,-1.5,140,8.5,-110,-110,120,1.5,-160,4.8,Tropicana Field,7,3
2020-07-28,2020,NYM,BOS,8,3,-112,-1.5,130,11.5,-120,100,102,1.5,-150,6.08,Fenway Park,11,5
2020-07-28,2020,CIN,CHC,5,8,-129,-1.5,150,10.5,-110,-110,119,1.5,-170,5.91,Great American Ballpark,13,-3
2020-07-28,2020,CHC,CIN,8,5,119,1.5,-170,10.5,-110,-110,-129,-1.5,150,4.79,Great American Ballpark,13,3
2020-07-28,2020,CWS,CLE,3,4,119,1.5,-170,9.0,-120,100,-129,-1.5,150,4.11,Progressive Field,7,-1
2020-07-28,2020,CWS,CLE,3,5,118,1.5,-165,10.5,-115,-105,-128,-1.5,145,4.82,Progressive Field,8,-2
2020-07-28,2020,OAK,COL,3,8,-158,-1.5,115,9.5,-105,-115,148,1.5,-135,5.82,Oakland Coliseum,11,-5
2020-07-28,2020,CLE,CWS,4,3,-129,-1.5,150,9.0,-120,100,119,1.5,-170,5.07,Progressive Field,7,1
2020-07-28,2020,CLE,CWS,5,3,-128,-1.5,145,10.5,-115,-105,118,1.5,-165,5.89,Progressive Field,8,2
2020-07-28,2020,KC,DET,3,4,-105,1.5,-185,10.5,-110,-110,-105,-1.5,165,5.38,Comerica Park,7,-1
2020-07-28,2020,LAD,HOU,5,2,-144,-1.5,100,10.0,-105,-115,134,1.5,-120,5.9,Minute Maid Park,7,3
2020-07-28,2020,DET,KC,4,3,-105,-1.5,165,10.5,-110,-110,-105,1.5,-185,5.38,Comerica Park,7,1
2020-07-28,2020,SEA,LAA,2,10,170,1.5,-120,9.0,-110,-110,-185,-1.5,100,3.33,Angel Stadium,12,-8
2020-07-28,2020,HOU,LAD,2,5,134,1.5,-120,10.0,-105,-115,-144,-1.5,100,4.27,Minute Maid Park,7,-3
2020-07-28,2020,PIT,MIL,8,6,165,1.5,100,10.0,-110,-110,-180,-1.5,-120,3.77,PNC Park,14,2
2020-07-28,2020,STL,MIN,3,6,132,1.5,-150,10.5,-110,-110,-142,-1.5,130,4.53,Target Field,9,-3
2020-07-28,2020,BOS,NYM,3,8,102,1.5,-150,11.5,-120,100,-112,-1.5,130,5.69,Fenway Park,11,-5
2020-07-28,2020,COL,OAK,8,3,148,1.5,-135,9.5,-105,-115,-158,-1.5,115,3.83,Oakland Coliseum,11,5
2020-07-28,2020,MIL,PIT,6,8,-180,-1.5,-120,10.0,-110,-110,165,1.5,100,6.43,PNC Park,14,-2
2020-07-28,2020,SF,SD,3,5,138,1.5,-130,9.0,-105,-115,-148,-1.5,110,3.78,AT&T Park,8,-2
2020-07-28,2020,LAA,SEA,10,2,-185,-1.5,100,9.0,-110,-110,170,1.5,-120,5.84,Angel Stadium,12,8
2020-07-28,2020,SD,SF,5,3,-148,-1.5,110,9.0,-105,-115,138,1.5,-130,5.37,AT&T Park,8,2
2020-07-28,2020,MIN,STL,6,3,-142,-1.5,130,10.5,-110,-110,132,1.5,-150,6.16,Target Field,9,3
2020-07-28,2020,ATL,TB,2,5,120,1.5,-160,8.5,-110,-110,-130,-1.5,140,3.86,Tropicana Field,7,-3
2020-07-28,2020,ARI,TEX,4,1,-106,1.5,-200,9.0,-110,-110,-104,-1.5,175,4.63,Globe Life Field,5,3
2020-07-28,2020,WSH,TOR,1,5,-139,-1.5,130,10.0,105,-125,129,1.5,-150,5.82,Nationals Park,6,-4
2020-07-28,2020,TOR,WSH,5,1,129,1.5,-150,10.0,105,-125,-139,-1.5,130,4.37,Nationals Park,6,4
2020-07-29,2020,TEX,ARI,7,4,-120,-1.5,165,8.0,-105,-115,110,1.5,-185,4.36,Globe Life Field,11,3
2020-07-29,2020,TB,ATL,4,7,115,1.5,-175,8.5,100,-120,-125,-1.5,155,3.95,Suntrust Park,11,-3
2020-07-29,2020,NYY,BAL,9,3,-360,-1.5,-230,9.0,-115,-105,310,1.5,200,7.04,Camden Yards,12,6
2020-07-29,2020,NYM,BOS,5,6,-200,-1.5,100,7.5,-110,-110,180,1.5,-120,5.0,Citi Field,11,-1
2020-07-29,2020,CIN,CHC,12,7,-110,-1.5,170,9.0,-130,110,100,1.5,-190,4.71,Great American Ballpark,19,5
2020-07-29,2020,CHC,CIN,7,12,100,1.5,-190,9.0,-130,110,-110,-1.5,170,4.5,Great American Ballpark,19,-5
2020-07-29,2020,CWS,CLE,4,0,-114,-1.5,135,9.5,100,-120,104,1.5,-155,5.06,Progressive Field,4,4
2020-07-29,2020,OAK,COL,1,5,-137,-1.5,135,8.0,-105,-115,127,1.5,-155,4.62,Oakland Coliseum,6,-4
2020-07-29,2020,CLE,CWS,0,4,104,1.5,-155,9.5,100,-120,-114,-1.5,135,4.66,Progressive Field,4,-4
2020-07-29,2020,KC,DET,4,5,110,1.5,-180,9.5,-115,-105,-120,-1.5,160,4.52,Comerica Park,9,-1
2020-07-29,2020,LAD,HOU,4,2,-140,-1.5,100,10.0,-105,-115,130,1.5,-120,5.83,Minute Maid Park,6,2
2020-07-29,2020,DET,KC,5,4,-120,-1.5,160,9.5,-115,-105,110,1.5,-180,5.18,Comerica Park,9,1
2020-07-29,2020,SEA,LAA,10,7,240,1.5,115,9.0,100,-120,-270,-1.5,-135,2.65,Angel Stadium,17,3
2020-07-29,2020,HOU,LAD,2,4,130,1.5,-120,10.0,-105,-115,-140,-1.5,100,4.35,Minute Maid Park,6,-2
2020-07-29,2020,PIT,MIL,0,3,133,1.5,-125,8.5,-125,105,-143,-1.5,105,3.65,PNC Park,3,-3
2020-07-29,2020,STL,MIN,0,3,146,1.5,-135,10.0,-105,-115,-156,-1.5,115,4.07,Target Field,3,-3
2020-07-29,2020,BOS,NYM,6,5,180,1.5,-120,7.5,-110,-110,-200,-1.5,100,2.68,Citi Field,11,1
2020-07-29,2020,BAL,NYY,3,9,310,1.5,200,9.0,-115,-105,-360,-1.5,-230,2.2,Camden Yards,12,-6
2020-07-29,2020,COL,OAK,5,1,127,1.5,-155,8.0,-105,-115,-137,-1.5,135,3.52,Oakland Coliseum,6,4
2020-07-29,2020,MIL,PIT,3,0,-143,-1.5,105,8.5,-125,105,133,1.5,-125,5.0,PNC Park,3,3
2020-07-29,2020,SF,SD,7,6,165,1.5,-105,7.5,-110,-110,-180,-1.5,-115,2.83,AT&T Park,13,1
2020-07-29,2020,LAA,SEA,7,10,-270,-1.5,-135,9.0,100,-120,240,1.5,115,6.57,Angel Stadium,17,-3
2020-07-29,2020,SD,SF,6,7,-180,-1.5,-115,7.5,-110,-110,165,1.5,-105,4.82,AT&T Park,13,-1
2020-07-29,2020,MIN,STL,3,0,-156,-1.5,115,10.0,-105,-115,146,1.5,-135,6.09,Target Field,3,3
2020-07-29,2020,ATL,TB,7,4,-125,-1.5,155,8.5,100,-120,115,1.5,-175,4.72,Suntrust Park,11,3
2020-07-29,2020,ARI,TEX,4,7,110,1.5,-185,8.0,-105,-115,-120,-1.5,165,3.81,Globe Life Field,11,-3
2020-07-29,2020,WSH,TOR,4,0,-174,-1.5,-110,8.5,-125,105,162,1.5,-110,5.4,Nationals Park,4,4
2020-07-29,2020,TOR,WSH,0,4,162,1.5,-110,8.5,-125,105,-174,-1.5,-110,3.24,Nationals Park,4,-4
2020-07-30,2020,LAD,ARI,6,3,-157,-1.5,-105,9.5,-110,-110,147,1.5,-115,5.8,Chase Field,9,3
2020-07-30,2020,TB,ATL,1,2,139,1.5,-150,9.0,100,-120,-149,-1.5,130,3.77,Suntrust Park,3,-1
2020-07-30,2020,NYY,BAL,8,6,-240,-1.5,-165,11.0,100,-120,210,1.5,145,7.76,Camden Yards,14,2
2020-07-30,2020,NYM,BOS,2,4,-162,-1.5,110,9.5,-115,-105,152,1.5,-130,5.87,Citi Field,6,-2
2020-07-30,2020,MIN,CLE,0,2,-123,-1.5,165,8.5,-105,-115,113,1.5,-185,4.69,Target Field,2,-2
2020-07-30,2020,KC,DET,5,3,-149,-1.5,-110,9.5,-115,-105,139,1.5,-110,5.68,Comerica Park,8,2
2020-07-30,2020,DET,KC,3,5,139,1.5,-110,9.5,-115,-105,-149,-1.5,-110,3.97,Comerica Park,8,-2
2020-07-30,2020,SEA,LAA,8,5,163,1.5,-135,9.0,100,-120,-175,-1.5,115,3.42,Angel Stadium,13,3
2020-07-30,2020,ARI,LAD,3,6,147,1.5,-115,9.5,-110,-110,-157,-1.5,-105,3.85,Chase Field,9,-3
2020-07-30,2020,CLE,MIN,2,0,113,1.5,-185,8.5,-105,-115,-123,-1.5,165,3.99,Target Field,2,2
2020-07-30,2020,BOS,NYM,4,2,152,1.5,-130,9.5,-115,-105,-162,-1.5,110,3.77,Citi Field,6,2
2020-07-30,2020,BAL,NYY,6,8,210,1.5,145,11.0,100,-120,-240,-1.5,-165,3.55,Camden Yards,14,-2
2020-07-30,2020,SF,SD,7,12,150,1.5,-110,8.0,-105,-115,-160,-1.5,-110,3.2,AT&T Park,19,-5
2020-07-30,2020,LAA,SEA,5,8,-175,-1.5,115,9.0,100,-120,163,1.5,-135,5.73,Angel Stadium,13,-3
2020-07-30,2020,SD,SF,12,7,-160,-1.5,-110,8.0,-105,-115,150,1.5,-110,4.92,AT&T Park,19,5
2020-07-30,2020,ATL,TB,2,1,-149,-1.5,130,9.0,100,-120,139,1.5,-150,5.39,Suntrust Park,3,1
2020-07-30,2020,WSH,TOR,6,4,140,1.5,-140,9.5,-115,-105,-150,-1.5,120,3.96,Nationals Park,10,2
2020-07-30,2020,TOR,WSH,4,6,-150,-1.5,120,9.5,-115,-105,140,1.5,-140,5.7,Nationals Park,10,-2
2020-07-31,2020,LAD,ARI,3,5,-122,-1.5,115,9.5,-105,-115,112,1.5,-135,5.22,Chase Field,8,-2
2020-07-31,2020,NYM,ATL,10,11,117,1.5,-160,10.5,-115,-105,-127,-1.5,140,4.84,Suntrust Park,21,-1
2020-07-31,2020,TB,BAL,3,6,-188,-1.5,-125,8.5,-105,-115,173,1.5,105,5.55,Camden Yards,9,-3
2020-07-31,2020,NYY,BOS,5,1,-180,-1.5,-110,10.5,100,-120,165,1.5,-110,6.75,Yankee Stadium,6,4
2020-07-31,2020,PIT,CHC,3,6,180,1.5,-120,8.5,-115,-105,-200,-1.5,100,3.04,Wrigley Field,9,-3
2020-07-31,2020,DET,CIN,7,2,160,1.5,-105,8.5,-110,-110,-170,-1.5,-115,3.27,Comerica Park,9,5
2020-07-31,2020,MIN,CLE,4,1,104,1.5,-155,9.0,-115,-105,-114,-1.5,135,4.41,Target Field,5,3
2020-07-31,2020,SD,COL,8,7,-108,1.5,-190,11.5,-115,-105,-102,-1.5,170,5.97,Coors Field,15,1
2020-07-31,2020,KC,CWS,2,3,150,1.5,-105,9.5,100,-120,-160,-1.5,-115,3.8,Kauffman Stadium,5,-1
2020-07-31,2020,CIN,DET,2,7,-170,-1.5,-115,8.5,-110,-110,160,1.5,-105,5.35,Comerica Park,9,-5
2020-07-31,2020,LAA,HOU,6,9,165,1.5,105,9.5,-105,-115,-180,-1.5,-125,3.58,Angel Stadium,15,-3
2020-07-31,2020,CWS,KC,3,2,-160,-1.5,-115,9.5,100,-120,150,1.5,-105,5.85,Kauffman Stadium,5,1
2020-07-31,2020,HOU,LAA,9,6,-180,-1.5,-125,9.5,-105,-115,165,1.5,105,6.11,Angel Stadium,15,3
2020-07-31,2020,ARI,LAD,5,3,112,1.5,-135,9.5,-105,-115,-122,-1.5,115,4.48,Chase Field,8,2
2020-07-31,2020,CLE,MIN,1,4,-114,-1.5,135,9.0,-115,-105,104,1.5,-155,4.79,Target Field,5,-3
2020-07-31,2020,ATL,NYM,11,10,-127,-1.5,140,10.5,-115,-105,117,1.5,-160,5.87,Suntrust Park,21,1
2020-07-31,2020,BOS,NYY,1,5,165,1.5,-110,10.5,100,-120,-180,-1.5,-110,3.96,Yankee Stadium,6,-4
2020-07-31,2020,SEA,OAK,5,3,177,1.5,110,9.5,100,-120,-194,-1.5,-130,3.43,T-Mobile Park,8,2
2020-07-31,2020,CHC,PIT,6,3,-200,-1.5,100,8.5,-115,-105,180,1.5,-120,5.67,Wrigley Field,9,3
2020-07-31,2020,COL,SD,7,8,-102,-1.5,170,11.5,-115,-105,-108,1.5,-190,5.81,Coors Field,15,-1
2020-07-31,2020,OAK,SEA,3,5,-194,-1.5,-130,9.5,100,-120,177,1.5,110,6.27,T-Mobile Park,8,-2
2020-07-31,2020,TEX,SF,2,9,-122,-1.5,125,8.0,-115,-105,112,1.5,-145,4.4,AT&T Park,11,-7
2020-07-31,2020,BAL,TB,6,3,173,1.5,105,8.5,-105,-115,-188,-1.5,-125,3.11,Camden Yards,9,3
2020-07-31,2020,SF,TEX,9,2,112,1.5,-145,8.0,-115,-105,-122,-1.5,125,3.77,AT&T Park,11,7
2020-08-01,2020,LAD,ARI,11,2,-155,-1.5,-115,9.5,-110,-110,145,1.5,-105,5.77,Chase Field,13,9
2020-08-01,2020,NYM,ATL,1,7,103,1.5,-185,10.5,-110,-110,-113,-1.5,165,5.17,Suntrust Park,8,-6
2020-08-01,2020,TB,BAL,4,5,-240,-1.5,-150,9.0,100,-120,210,1.5,130,6.35,Camden Yards,9,-1
2020-08-01,2020,NYY,BOS,5,2,-185,-1.5,-110,10.0,-115,-105,170,1.5,-110,6.49,Yankee Stadium,7,3
2020-08-01,2020,PIT,CHC,3,4,165,1.5,-120,9.0,-125,105,-180,-1.5,100,3.4,Wrigley Field,7,-1
2020-08-01,2020,MIN,CLE,3,0,-126,-1.5,145,8.5,-115,-105,116,1.5,-165,4.74,Target Field,3,3
2020-08-01,2020,SD,COL,1,6,-110,-1.5,120,12.5,-120,100,100,1.5,-140,6.55,Coors Field,7,-5
2020-08-01,2020,KC,CWS,5,11,125,1.5,-130,10.5,105,-125,-135,-1.5,110,4.67,Kauffman Stadium,16,-6
2020-08-01,2020,LAA,HOU,5,4,135,1.5,-120,9.0,-115,-105,-145,-1.5,100,3.83,Angel Stadium,9,1
2020-08-01,2020,CWS,KC,11,5,-135,-1.5,110,10.5,105,-125,125,1.5,-130,6.03,Kauffman Stadium,16,6
2020-08-01,2020,HOU,LAA,4,5,-145,-1.5,100,9.0,-115,-105,135,1.5,-120,5.33,Angel Stadium,9,-1
2020-08-01,2020,ARI,LAD,2,11,145,1.5,-105,9.5,-110,-110,-155,-1.5,-115,3.88,Chase Field,13,-9
2020-08-01,2020,CLE,MIN,0,3,116,1.5,-165,8.5,-115,-105,-126,-1.5,145,3.94,Target Field,3,-3
2020-08-01,2020,ATL,NYM,7,1,-113,-1.5,165,10.5,-110,-110,103,1.5,-185,5.57,Suntrust Park,8,6
2020-08-01,2020,BOS,NYY,2,5,170,1.5,-110,10.0,-115,-105,-185,-1.5,-110,3.7,Yankee Stadium,7,-3
2020-08-01,2020,SEA,OAK,2,3,138,1.5,-120,9.5,-110,-110,-148,-1.5,100,3.99,T-Mobile Park,5,-1
2020-08-01,2020,CHC,PIT,4,3,-180,-1.5,100,9.0,-125,105,165,1.5,-120,5.79,Wrigley Field,7,1
2020-08-01,2020,COL,SD,6,1,100,1.5,-140,12.5,-120,100,-110,-1.5,120,6.25,Coors Field,7,5
2020-08-01,2020,OAK,SEA,3,2,-148,-1.5,100,9.5,-110,-110,138,1.5,-120,5.67,T-Mobile Park,5,1
2020-08-01,2020,TEX,SF,3,7,113,-1.5,180,8.5,-115,-105,-123,1.5,-205,3.99,AT&T Park,10,-4
2020-08-01,2020,BAL,TB,5,4,210,1.5,130,9.0,100,-120,-240,-1.5,-150,2.9,Camden Yards,9,1
2020-08-01,2020,SF,TEX,7,3,-123,1.5,-205,8.5,-115,-105,113,-1.5,180,4.69,AT&T Park,10,4
2020-08-02,2020,LAD,ARI,3,0,-185,-1.5,-125,9.0,-115,-105,170,1.5,105,5.84,Chase Field,3,3
2020-08-02,2020,NYM,ATL,0,4,105,1.5,-170,11.0,-105,-115,-115,-1.5,150,5.37,Suntrust Park,4,-4
2020-08-02,2020,TB,BAL,1,5,-200,-1.5,-135,9.5,-105,-115,180,1.5,115,6.33,Camden Yards,6,-4
2020-08-02,2020,NYY,BOS,9,7,-220,-1.5,-130,10.5,-115,-105,200,1.5,110,7.22,Yankee Stadium,16,2
2020-08-02,2020,PIT,CHC,1,2,165,1.5,-125,9.0,-110,-110,-180,-1.5,105,3.4,Wrigley Field,3,-1
2020-08-02,2020,DET,CIN,3,4,140,1.5,-135,7.5,-110,-110,-150,-1.5,115,3.13,Comerica Park,7,-1
2020-08-02,2020,DET,CIN,0,4,163,1.5,-120,7.0,-110,-110,-176,-1.5,100,2.66,Comerica Park,4,-4
2020-08-02,2020,MIN,CLE,3,1,-114,-1.5,155,9.0,-120,100,104,1.5,-175,4.79,Target Field,4,2
2020-08-02,2020,SD,COL,6,9,-117,-1.5,120,13.0,-105,-115,107,1.5,-140,7.01,Coors Field,15,-3
2020-08-02,2020,KC,CWS,2,9,110,1.5,-145,9.5,-105,-115,-120,-1.5,125,4.52,Kauffman Stadium,11,-7
2020-08-02,2020,CIN,DET,4,3,-150,-1.5,115,7.5,-110,-110,140,1.5,-135,4.5,Comerica Park,7,1
2020-08-02,2020,CIN,DET,4,0,-176,-1.5,100,7.0,-110,-110,163,1.5,-120,4.46,Comerica Park,4,4
2020-08-02,2020,LAA,HOU,5,6,135,1.5,-120,10.0,-120,100,-145,-1.5,100,4.26,Angel Stadium,11,-1
2020-08-02,2020,CWS,KC,9,2,-120,-1.5,125,9.5,-105,-115,110,1.5,-145,5.18,Kauffman Stadium,11,7
2020-08-02,2020,HOU,LAA,6,5,-145,-1.5,100,10.0,-120,100,135,1.5,-120,5.92,Angel Stadium,11,1
2020-08-02,2020,ARI,LAD,0,3,170,1.5,105,9.0,-115,-105,-185,-1.5,-125,3.33,Chase Field,3,-3
2020-08-02,2020,CLE,MIN,1,3,104,1.5,-175,9.0,-120,100,-114,-1.5,155,4.41,Target Field,4,-2
2020-08-02,2020,ATL,NYM,4,0,-115,-1.5,150,11.0,-105,-115,105,1.5,-170,5.88,Suntrust Park,4,4
2020-08-02,2020,BOS,NYY,7,9,200,1.5,110,10.5,-115,-105,-220,-1.5,-130,3.5,Yankee Stadium,16,-2
2020-08-02,2020,SEA,OAK,2,3,150,1.5,-110,9.0,-105,-115,-160,-1.5,-110,3.6,T-Mobile Park,5,-1
2020-08-02,2020,CHC,PIT,2,1,-180,-1.5,105,9.0,-110,-110,165,1.5,-125,5.79,Wrigley Field,3,1
2020-08-02,2020,COL,SD,9,6,107,1.5,-140,13.0,-105,-115,-117,-1.5,120,6.28,Coors Field,15,3
2020-08-02,2020,OAK,SEA,3,2,-160,-1.5,-110,9.0,-105,-115,150,1.5,-110,5.54,T-Mobile Park,5,1
2020-08-02,2020,TEX,SF,9,5,100,1.5,-200,9.0,-110,-110,-110,-1.5,175,4.5,AT&T Park,14,4
2020-08-02,2020,BAL,TB,5,1,180,1.5,115,9.5,-105,-115,-200,-1.5,-135,3.39,Camden Yards,6,4
2020-08-02,2020,SF,TEX,5,9,-110,-1.5,175,9.0,-110,-110,100,1.5,-200,4.71,AT&T Park,14,-4
2020-08-03,2020,NYM,ATL,7,2,-126,-1.5,130,8.0,-105,-115,116,1.5,-150,4.46,Suntrust Park,9,5
2020-08-03,2020,KC,CHC,0,2,139,1.5,-150,8.0,-105,-115,-149,-1.5,130,3.35,Wrigley Field,2,-2
2020-08-03,2020,CLE,CIN,2,3,144,1.5,-150,8.0,-115,-105,-154,-1.5,130,3.28,Great American Ballpark,5,-1
2020-08-03,2020,CIN,CLE,3,2,-154,-1.5,130,8.0,-115,-105,144,1.5,-150,4.85,Great American Ballpark,5,1
2020-08-03,2020,SF,COL,6,7,115,1.5,-145,13.5,-105,-115,-125,-1.5,125,6.28,Coors Field,13,-1
2020-08-03,2020,MIL,CWS,4,6,-116,-1.5,165,9.5,-120,100,106,1.5,-185,5.1,Miller Park,10,-2
2020-08-03,2020,CHC,KC,2,0,-149,-1.5,130,8.0,-105,-115,139,1.5,-150,4.79,Wrigley Field,2,2
2020-08-03,2020,SD,LAD,5,4,123,1.5,-145,8.0,-105,-115,-133,-1.5,125,3.59,PETCO Park,9,1
2020-08-03,2020,CWS,MIL,6,4,106,1.5,-185,9.5,-120,100,-116,-1.5,165,4.61,Miller Park,10,2
2020-08-03,2020,PIT,MIN,4,5,180,1.5,-105,9.5,100,-120,-200,-1.5,-115,3.39,Target Field,9,-1
2020-08-03,2020,ATL,NYM,2,7,116,1.5,-150,8.0,-105,-115,-126,-1.5,130,3.7,Suntrust Park,9,-5
2020-08-03,2020,PHI,NYY,3,6,245,1.5,120,9.0,-115,-105,-280,-1.5,-140,2.61,Yankee Stadium,9,-3
2020-08-03,2020,SEA,OAK,1,11,170,1.5,100,9.0,100,-120,-185,-1.5,-120,3.33,T-Mobile Park,12,-10
2020-08-03,2020,NYY,PHI,6,3,-280,-1.5,-140,9.0,-115,-105,245,1.5,120,6.63,Yankee Stadium,9,3
2020-08-03,2020,MIN,PIT,5,4,-200,-1.5,-115,9.5,100,-120,180,1.5,-105,6.33,Target Field,9,1
2020-08-03,2020,LAD,SD,4,5,-133,-1.5,125,8.0,-105,-115,123,1.5,-145,4.57,PETCO Park,9,-1
2020-08-03,2020,OAK,SEA,11,1,-185,-1.5,-120,9.0,100,-120,170,1.5,100,5.84,T-Mobile Park,12,10
2020-08-03,2020,COL,SF,7,6,-125,-1.5,125,13.5,-105,-115,115,1.5,-145,7.5,Coors Field,13,1
2020-08-04,2020,HOU,ARI,8,2,-130,-1.5,110,9.5,100,-120,120,1.5,-130,5.37,Chase Field,10,6
2020-08-04,2020,TOR,ATL,1,10,163,1.5,-135,8.5,-115,-105,-176,-1.5,115,3.23,Suntrust Park,11,-9
2020-08-04,2020,MIA,BAL,4,0,105,1.5,-180,9.0,100,-120,-115,-1.5,160,4.39,Camden Yards,4,4
2020-08-04,2020,TB,BOS,5,1,-135,-1.5,145,8.0,-105,-115,125,1.5,-165,4.6,Tropicana Field,6,4
2020-08-04,2020,KC,CHC,4,5,195,1.5,-110,8.0,100,-120,-215,-1.5,-110,2.71,Wrigley Field,9,-1
2020-08-04,2020,CLE,CIN,4,2,-160,-1.5,-105,8.0,-115,-105,150,1.5,-115,4.92,Great American Ballpark,6,2
2020-08-04,2020,CIN,CLE,2,4,150,1.5,-115,8.0,-115,-105,-160,-1.5,-105,3.2,Great American Ballpark,6,-2
2020-08-04,2020,SF,COL,2,5,160,1.5,-115,11.0,-120,100,-170,-1.5,-105,4.23,Coors Field,7,-3
2020-08-04,2020,MIL,CWS,2,3,-124,-1.5,150,8.0,-120,100,114,1.5,-170,4.43,Miller Park,5,-1
2020-08-04,2020,ARI,HOU,2,8,120,1.5,-130,9.5,100,-120,-130,-1.5,110,4.32,Chase Field,10,-6
2020-08-04,2020,CHC,KC,5,4,-215,-1.5,-110,8.0,100,-120,195,1.5,-110,5.46,Wrigley Field,9,1
2020-08-04,2020,SEA,LAA,3,5,170,1.5,100,9.0,-110,-110,-185,-1.5,-120,3.33,T-Mobile Park,8,-2
2020-08-04,2020,SD,LAD,2,5,106,1.5,-155,8.0,-110,-110,-116,-1.5,135,3.88,PETCO Park,7,-3
2020-08-04,2020,BAL,MIA,0,4,-115,-1.5,160,9.0,100,-120,105,1.5,-180,4.81,Camden Yards,4,-4
2020-08-04,2020,CWS,MIL,3,2,114,1.5,-170,8.0,-120,100,-124,-1.5,150,3.74,Miller Park,5,1
2020-08-04,2020,PIT,MIN,3,7,177,1.5,-115,8.5,-120,100,-194,-1.5,-105,3.07,Target Field,10,-4
2020-08-04,2020,WSH,NYM,5,3,-160,-1.5,125,8.5,-120,100,150,1.5,-145,5.23,Nationals Park,8,2
2020-08-04,2020,TEX,OAK,1,5,150,1.5,-145,7.5,105,-125,-160,-1.5,125,3.0,Oakland Coliseum,6,-4
2020-08-04,2020,MIN,PIT,7,3,-194,-1.5,-105,8.5,-120,100,177,1.5,-115,5.61,Target Field,10,4
2020-08-04,2020,LAD,SD,5,2,-116,-1.5,135,8.0,-110,-110,106,1.5,-155,4.3,PETCO Park,7,3
2020-08-04,2020,LAA,SEA,5,3,-185,-1.5,-120,9.0,-110,-110,170,1.5,100,5.84,T-Mobile Park,8,2
2020-08-04,2020,COL,SF,5,2,-170,-1.5,-105,11.0,-120,100,160,1.5,-115,6.93,Coors Field,7,3
2020-08-04,2020,BOS,TB,1,5,125,1.5,-165,8.0,-105,-115,-135,-1.5,145,3.56,Tropicana Field,6,-4
2020-08-04,2020,OAK,TEX,5,1,-160,-1.5,125,7.5,105,-125,150,1.5,-145,4.62,Oakland Coliseum,6,4
2020-08-04,2020,ATL,TOR,10,1,-176,-1.5,115,8.5,-115,-105,163,1.5,-135,5.42,Suntrust Park,11,9
2020-08-04,2020,NYM,WSH,3,5,150,1.5,-145,8.5,-120,100,-160,-1.5,125,3.4,Nationals Park,8,-2
2020-08-05,2020,HOU,ARI,7,14,-145,-1.5,110,9.5,100,-120,135,1.5,-130,5.62,Chase Field,21,-7
2020-08-05,2020,TOR,ATL,2,1,108,1.5,-175,9.0,-115,-105,-118,-1.5,155,4.33,Suntrust Park,3,1
2020-08-05,2020,MIA,BAL,1,0,104,1.5,-215,7.0,-120,100,-114,-1.5,190,3.43,Camden Yards,1,1
2020-08-05,2020,MIA,BAL,2,1,-110,-1.5,210,7.5,100,-120,100,1.5,-240,3.93,Camden Yards,3,1
2020-08-05,2020,TB,BOS,0,5,-140,-1.5,125,8.5,-105,-115,130,1.5,-145,4.96,Tropicana Field,5,-5
2020-08-05,2020,KC,CHC,1,6,179,1.5,110,9.0,-105,-115,-198,-1.5,-130,3.23,Kauffman Stadium,7,-5
2020-08-05,2020,CLE,CIN,2,0,-162,-1.5,110,8.5,-115,-105,152,1.5,-130,5.26,Progressive Field,2,2
2020-08-05,2020,CIN,CLE,0,2,152,1.5,-130,8.5,-115,-105,-162,-1.5,110,3.37,Progressive Field,2,-2
2020-08-05,2020,SF,COL,4,3,158,1.5,-115,11.5,-105,-115,-168,-1.5,-105,4.46,Coors Field,7,1
2020-08-05,2020,MIL,CWS,1,0,122,1.5,-165,8.5,-110,-110,-132,-1.5,145,3.83,Guaranteed Rate Field,1,1
2020-08-05,2020,ARI,HOU,14,7,135,1.5,-130,9.5,100,-120,-145,-1.5,110,4.04,Chase Field,21,7
2020-08-05,2020,CHC,KC,6,1,-198,-1.5,-130,9.0,-105,-115,179,1.5,110,5.98,Kauffman Stadium,7,5
2020-08-05,2020,SEA,LAA,7,6,109,1.5,-150,9.0,-105,-115,-119,-1.5,130,4.31,T-Mobile Park,13,1
2020-08-05,2020,SD,LAD,6,7,115,1.5,-145,8.0,-115,-105,-125,-1.5,125,3.72,PETCO Park,13,-1
2020-08-05,2020,BAL,MIA,0,1,-114,-1.5,190,7.0,-120,100,104,1.5,-215,3.73,Camden Yards,1,-1
2020-08-05,2020,BAL,MIA,1,2,100,1.5,-240,7.5,100,-120,-110,-1.5,210,3.75,Camden Yards,3,-1
2020-08-05,2020,CWS,MIL,0,1,-132,-1.5,145,8.5,-110,-110,122,1.5,-165,4.84,Guaranteed Rate Field,1,-1
2020-08-05,2020,PIT,MIN,2,5,153,1.5,-105,9.5,-105,-115,-163,-1.5,-115,3.75,PNC Park,7,-3
2020-08-05,2020,WSH,NYM,1,3,-215,-1.5,-110,8.5,-120,100,195,1.5,-110,5.8,Nationals Park,4,-2
2020-08-05,2020,PHI,NYY,11,7,105,1.5,-220,7.5,100,-120,-115,-1.5,195,3.66,Citizens Bank Park,18,4
2020-08-05,2020,PHI,NYY,1,3,130,1.5,-155,7.5,100,-120,-140,-1.5,135,3.26,Citizens Bank Park,4,-2
2020-08-05,2020,TEX,OAK,4,6,153,1.5,-135,8.0,-115,-105,-163,-1.5,115,3.16,Oakland Coliseum,10,-2
2020-08-05,2020,NYY,PHI,7,11,-115,-1.5,195,7.5,100,-120,105,1.5,-220,4.01,Citizens Bank Park,18,-4
2020-08-05,2020,NYY,PHI,3,1,-140,-1.5,135,7.5,100,-120,130,1.5,-155,4.38,Citizens Bank Park,4,2
2020-08-05,2020,MIN,PIT,5,2,-163,-1.5,-115,9.5,-105,-115,153,1.5,-105,5.89,PNC Park,7,3
2020-08-05,2020,LAD,SD,7,6,-125,-1.5,125,8.0,-115,-105,115,1.5,-145,4.44,PETCO Park,13,1
2020-08-05,2020,LAA,SEA,6,7,-119,-1.5,130,9.0,-105,-115,109,1.5,-150,4.89,T-Mobile Park,13,-1
2020-08-05,2020,COL,SF,3,4,-168,-1.5,-105,11.5,-105,-115,158,1.5,-115,7.21,Coors Field,7,-1
2020-08-05,2020,BOS,TB,5,0,130,1.5,-145,8.5,-105,-115,-140,-1.5,125,3.7,Tropicana Field,5,5
2020-08-05,2020,OAK,TEX,6,4,-163,-1.5,115,8.0,-115,-105,153,1.5,-135,4.96,Oakland Coliseum,10,2
2020-08-05,2020,ATL,TOR,1,2,-118,-1.5,155,9.0,-115,-105,108,1.5,-175,4.87,Suntrust Park,3,-1
2020-08-05,2020,NYM,WSH,3,1,195,1.5,-110,8.5,-120,100,-215,-1.5,-110,2.88,Nationals Park,4,2
2020-08-06,2020,HOU,ARI,4,5,105,-1.5,150,9.0,-120,100,-115,1.5,-170,4.39,Chase Field,9,-1
2020-08-06,2020,TOR,ATL,3,4,110,1.5,-175,9.0,-120,100,-120,-1.5,155,4.29,Suntrust Park,7,-1
2020-08-06,2020,MIA,BAL,8,7,-118,-1.5,160,8.5,-110,-110,108,1.5,-180,4.6,Camden Yards,15,1
2020-08-06,2020,KC,CHC,13,2,155,1.5,100,9.5,100,-120,-165,-1.5,-120,3.73,Kauffman Stadium,15,11
2020-08-06,2020,CLE,CIN,13,0,-113,-1.5,175,7.0,-115,-105,103,1.5,-200,3.71,Progressive Field,13,13
2020-08-06,2020,CIN,CLE,0,13,103,1.5,-200,7.0,-115,-105,-113,-1.5,175,3.45,Progressive Field,13,-13
2020-08-06,2020,SF,COL,4,6,152,1.5,-120,11.5,-105,-115,-162,-1.5,100,4.56,Coors Field,10,-2
2020-08-06,2020,MIL,CWS,8,3,100,1.5,-190,9.0,-115,-105,-110,-1.5,170,4.5,Guaranteed Rate Field,11,5
2020-08-06,2020,ARI,HOU,5,4,-115,1.5,-170,9.0,-120,100,105,-1.5,150,4.81,Chase Field,9,1
2020-08-06,2020,CHC,KC,2,13,-165,-1.5,-120,9.5,100,-120,155,1.5,100,5.92,Kauffman Stadium,15,-11
2020-08-06,2020,SEA,LAA,1,6,145,1.5,-110,8.5,-110,-110,-155,-1.5,-110,3.47,T-Mobile Park,7,-5
2020-08-06,2020,BAL,MIA,7,8,108,1.5,-180,8.5,-110,-110,-118,-1.5,160,4.09,Camden Yards,15,-1
2020-08-06,2020,CWS,MIL,3,8,-110,-1.5,170,9.0,-115,-105,100,1.5,-190,4.71,Guaranteed Rate Field,11,-5
2020-08-06,2020,PIT,MIN,6,5,195,1.5,115,8.5,-110,-110,-215,-1.5,-135,2.88,PNC Park,11,1
2020-08-06,2020,PHI,NYY,5,4,126,1.5,-130,9.5,100,-120,-136,-1.5,110,4.2,Citizens Bank Park,9,1
2020-08-06,2020,TEX,OAK,4,6,150,1.5,-135,9.0,100,-120,-160,-1.5,115,3.6,Oakland Coliseum,10,-2
2020-08-06,2020,NYY,PHI,4,5,-136,-1.5,110,9.5,100,-120,126,1.5,-130,5.47,Citizens Bank Park,9,-1
2020-08-06,2020,MIN,PIT,5,6,-215,-1.5,-135,8.5,-110,-110,195,1.5,115,5.8,PNC Park,11,-1
2020-08-06,2020,LAA,SEA,6,1,-155,-1.5,-110,8.5,-110,-110,145,1.5,-110,5.17,T-Mobile Park,7,5
2020-08-06,2020,COL,SF,6,4,-162,-1.5,100,11.5,-105,-115,152,1.5,-120,7.11,Coors Field,10,2
2020-08-06,2020,OAK,TEX,6,4,-160,-1.5,115,9.0,100,-120,150,1.5,-135,5.54,Oakland Coliseum,10,2
2020-08-06,2020,ATL,TOR,4,3,-120,-1.5,155,9.0,-120,100,110,1.5,-175,4.91,Suntrust Park,7,1
2020-08-07,2020,SD,ARI,3,0,-121,-1.5,155,8.5,-105,-115,111,1.5,-175,4.65,PETCO Park,3,3
2020-08-07,2020,WSH,BAL,0,11,-178,-1.5,105,9.0,-120,100,164,1.5,-125,5.76,Nationals Park,11,-11
2020-08-07,2020,TOR,BOS,3,5,-107,1.5,-180,10.5,-110,-110,-103,-1.5,160,5.43,Fenway Park,8,-2
2020-08-07,2020,MIL,CIN,3,8,-104,1.5,-165,8.0,-120,100,-106,-1.5,145,4.08,Miller Park,11,-5
2020-08-07,2020,CWS,CLE,2,0,123,1.5,-135,8.5,-105,-115,-133,-1.5,115,3.81,Guaranteed Rate Field,2,2
2020-08-07,2020,SEA,COL,4,8,-123,-1.5,165,8.5,-120,100,113,1.5,-185,4.69,T-Mobile Park,12,-4
2020-08-07,2020,CLE,CWS,0,2,-133,-1.5,115,8.5,-105,-115,123,1.5,-135,4.85,Guaranteed Rate Field,2,-2
2020-08-07,2020,PIT,DET,13,17,-103,1.5,-170,8.5,-105,-115,-107,-1.5,150,4.31,PNC Park,30,-4
2020-08-07,2020,OAK,HOU,3,2,-122,-1.5,160,8.5,100,-120,112,1.5,-180,4.67,Oakland Coliseum,5,1
2020-08-07,2020,MIN,KC,2,3,-135,-1.5,105,9.5,-105,-115,125,1.5,-125,5.46,Kauffman Stadium,5,-1
2020-08-07,2020,TEX,LAA,4,3,161,1.5,100,9.0,-115,-105,-172,-1.5,-120,3.45,Globe Life Field,7,1
2020-08-07,2020,SF,LAD,2,7,245,1.5,110,9.0,100,-120,-275,-1.5,-130,2.61,Dodger Stadium,9,-5
2020-08-07,2020,NYM,MIA,3,4,-190,-1.5,100,9.0,-115,-105,175,1.5,-120,5.9,Citi Field,7,-1
2020-08-07,2020,CIN,MIL,8,3,-106,-1.5,145,8.0,-120,100,-104,1.5,-165,4.12,Miller Park,11,5
2020-08-07,2020,KC,MIN,3,2,125,1.5,-125,9.5,-105,-115,-135,-1.5,105,4.22,Kauffman Stadium,5,1
2020-08-07,2020,MIA,NYM,4,3,175,1.5,-120,9.0,-115,-105,-190,-1.5,100,3.27,Citi Field,7,1
2020-08-07,2020,TB,NYY,1,0,-105,-1.5,175,8.0,-115,-105,-105,1.5,-200,4.1,Tropicana Field,1,1
2020-08-07,2020,HOU,OAK,2,3,112,1.5,-180,8.5,100,-120,-122,-1.5,160,4.01,Oakland Coliseum,5,-1
2020-08-07,2020,DET,PIT,17,13,-107,-1.5,150,8.5,-105,-115,-103,1.5,-170,4.39,PNC Park,30,4
2020-08-07,2020,ARI,SD,0,3,111,1.5,-175,8.5,-105,-115,-121,-1.5,155,4.03,PETCO Park,3,-3
2020-08-07,2020,COL,SEA,8,4,113,1.5,-185,8.5,-120,100,-123,-1.5,165,3.99,T-Mobile Park,12,4
2020-08-07,2020,LAD,SF,7,2,-275,-1.5,-130,9.0,100,-120,245,1.5,110,6.6,Dodger Stadium,9,5
2020-08-07,2020,NYY,TB,0,1,-105,1.5,-200,8.0,-115,-105,-105,-1.5,175,4.1,Tropicana Field,1,-1
2020-08-07,2020,LAA,TEX,3,4,-172,-1.5,-120,9.0,-115,-105,161,1.5,100,5.69,Globe Life Field,7,-1
2020-08-07,2020,BOS,TOR,5,3,-103,-1.5,160,10.5,-110,-110,-107,1.5,-180,5.33,Fenway Park,8,2
2020-08-07,2020,BAL,WSH,11,0,164,1.5,-125,9.0,-120,100,-178,-1.5,105,3.41,Nationals Park,11,11
2020-08-08,2020,SD,ARI,2,3,-180,-1.5,105,7.5,100,-120,165,1.5,-125,4.82,PETCO Park,5,-1
2020-08-08,2020,PHI,ATL,5,0,-114,-1.5,175,10.0,-110,-110,104,1.5,-200,5.33,Citizens Bank Park,5,5
2020-08-08,2020,WSH,BAL,3,5,-185,-1.5,100,9.5,-105,-115,170,1.5,-120,6.17,Nationals Park,8,-2
2020-08-08,2020,TOR,BOS,2,1,115,1.5,-165,10.5,-115,-105,-125,-1.5,145,4.88,Fenway Park,3,1
2020-08-08,2020,MIL,CIN,1,4,-116,-1.5,170,9.0,-120,100,106,1.5,-190,4.83,Miller Park,5,-3
2020-08-08,2020,CWS,CLE,1,7,122,1.5,-135,8.5,-115,-105,-132,-1.5,115,3.83,Guaranteed Rate Field,8,-6
2020-08-08,2020,SEA,COL,0,5,-114,-1.5,165,9.5,-105,-115,104,1.5,-185,5.06,T-Mobile Park,5,-5
2020-08-08,2020,CLE,CWS,7,1,-132,-1.5,115,8.5,-115,-105,122,1.5,-135,4.84,Guaranteed Rate Field,8,6
2020-08-08,2020,PIT,DET,5,11,-132,-1.5,150,9.5,-105,-115,122,1.5,-170,5.41,PNC Park,16,-6
2020-08-08,2020,OAK,HOU,3,1,-174,-1.5,115,8.5,-115,-105,162,1.5,-135,5.4,Oakland Coliseum,4,2
2020-08-08,2020,MIN,KC,6,9,-153,-1.5,-105,9.5,-110,-110,143,1.5,-115,5.75,Kauffman Stadium,15,-3
2020-08-08,2020,TEX,LAA,2,0,126,1.5,-135,9.0,-110,-110,-136,-1.5,115,3.98,Globe Life Field,2,2
2020-08-08,2020,SF,LAD,5,4,270,1.5,135,8.0,-120,100,-310,-1.5,-155,2.16,Dodger Stadium,9,1
2020-08-08,2020,NYM,MIA,8,4,-165,-1.5,120,9.0,100,-120,155,1.5,-140,5.6,Citi Field,12,4
2020-08-08,2020,CIN,MIL,4,1,106,1.5,-190,9.0,-120,100,-116,-1.5,170,4.37,Miller Park,5,3
2020-08-08,2020,KC,MIN,9,6,143,1.5,-115,9.5,-110,-110,-153,-1.5,-105,3.91,Kauffman Stadium,15,3
2020-08-08,2020,MIA,NYM,4,8,155,1.5,-140,9.0,100,-120,-165,-1.5,120,3.53,Citi Field,12,-4
2020-08-08,2020,TB,NYY,4,8,136,1.5,-155,5.5,115,-135,-146,-1.5,135,2.33,Tropicana Field,12,-4
2020-08-08,2020,TB,NYY,5,3,115,1.5,-170,7.0,-105,-115,-125,-1.5,150,3.26,Tropicana Field,8,2
2020-08-08,2020,HOU,OAK,1,3,162,1.5,-135,8.5,-115,-105,-174,-1.5,115,3.24,Oakland Coliseum,4,-2
2020-08-08,2020,ATL,PHI,0,5,104,1.5,-200,10.0,-110,-110,-114,-1.5,175,4.9,Citizens Bank Park,5,-5
2020-08-08,2020,DET,PIT,11,5,122,1.5,-170,9.5,-105,-115,-132,-1.5,150,4.28,PNC Park,16,6
2020-08-08,2020,ARI,SD,3,2,165,1.5,-125,7.5,100,-120,-180,-1.5,105,2.83,PETCO Park,5,1
2020-08-08,2020,COL,SEA,5,0,104,1.5,-185,9.5,-105,-115,-114,-1.5,165,4.66,T-Mobile Park,5,5
2020-08-08,2020,LAD,SF,4,5,-310,-1.5,-155,8.0,-120,100,270,1.5,135,6.05,Dodger Stadium,9,-1
2020-08-08,2020,NYY,TB,8,4,-146,-1.5,135,5.5,115,-135,136,1.5,-155,3.26,Tropicana Field,12,4
2020-08-08,2020,NYY,TB,3,5,-125,-1.5,150,7.0,-105,-115,115,1.5,-170,3.89,Tropicana Field,8,-2
2020-08-08,2020,LAA,TEX,0,2,-136,-1.5,115,9.0,-110,-110,126,1.5,-135,5.19,Globe Life Field,2,-2
2020-08-08,2020,BOS,TOR,1,2,-125,-1.5,145,10.5,-115,-105,115,1.5,-165,5.83,Fenway Park,3,-1
2020-08-08,2020,BAL,WSH,5,3,170,1.5,-120,9.5,-105,-115,-185,-1.5,100,3.52,Nationals Park,8,2
2020-08-09,2020,SD,ARI,9,5,-180,-1.5,105,8.0,-115,-105,165,1.5,-125,5.14,PETCO Park,14,4
2020-08-09,2020,PHI,ATL,2,5,-102,1.5,-185,7.5,-110,-110,-108,-1.5,165,3.79,Citizens Bank Park,7,-3
2020-08-09,2020,PHI,ATL,0,8,135,1.5,-150,6.5,-120,100,-145,-1.5,130,2.77,Citizens Bank Park,8,-8
2020-08-09,2020,WSH,BAL,2,6,-220,-1.5,-110,8.5,-115,-105,200,1.5,-110,5.84,Nationals Park,8,-4
2020-08-09,2020,TOR,BOS,3,5,145,1.5,-140,10.0,-115,-105,-155,-1.5,120,4.08,Fenway Park,8,-2
2020-08-09,2020,MIL,CIN,9,3,-117,-1.5,180,7.0,-110,-110,107,1.5,-205,3.77,Miller Park,12,6
2020-08-09,2020,CWS,CLE,4,5,150,1.5,-110,7.5,100,-120,-160,-1.5,-110,3.0,Guaranteed Rate Field,9,-1
2020-08-09,2020,SEA,COL,5,3,137,1.5,-120,8.0,-110,-110,-147,-1.5,100,3.38,T-Mobile Park,8,2
2020-08-09,2020,CLE,CWS,5,4,-160,-1.5,-110,7.5,100,-120,150,1.5,-110,4.62,Guaranteed Rate Field,9,1
2020-08-09,2020,PIT,DET,1,2,130,1.5,-130,9.0,-105,-115,-140,-1.5,110,3.91,PNC Park,3,-1
2020-08-09,2020,OAK,HOU,7,2,-148,-1.5,130,8.0,-110,-110,138,1.5,-150,4.77,Oakland Coliseum,9,5
2020-08-09,2020,MIN,KC,2,4,-155,-1.5,-105,9.5,-115,-105,145,1.5,-115,5.77,Kauffman Stadium,6,-2
2020-08-09,2020,TEX,LAA,7,3,104,1.5,-160,7.5,-115,-105,-114,-1.5,140,3.68,Globe Life Field,10,4
2020-08-09,2020,SF,LAD,2,6,220,1.5,110,8.5,100,-120,-250,-1.5,-130,2.66,Dodger Stadium,8,-4
2020-08-09,2020,NYM,MIA,4,2,-245,-1.5,-115,7.5,100,-120,215,1.5,-105,5.33,Citi Field,6,2
2020-08-09,2020,CIN,MIL,3,9,107,1.5,-205,7.0,-110,-110,-117,-1.5,180,3.38,Miller Park,12,-6
2020-08-09,2020,KC,MIN,4,2,145,1.5,-115,9.5,-115,-105,-155,-1.5,-105,3.88,Kauffman Stadium,6,2
2020-08-09,2020,MIA,NYM,2,4,215,1.5,-105,7.5,100,-120,-245,-1.5,-115,2.38,Citi Field,6,-2
2020-08-09,2020,TB,NYY,4,3,-110,-1.5,180,8.5,-110,-110,100,1.5,-205,4.45,Tropicana Field,7,1
2020-08-09,2020,HOU,OAK,2,7,138,1.5,-150,8.0,-110,-110,-148,-1.5,130,3.36,Oakland Coliseum,9,-5
2020-08-09,2020,ATL,PHI,5,2,-108,-1.5,165,7.5,-110,-110,-102,1.5,-185,3.89,Citizens Bank Park,7,3
2020-08-09,2020,ATL,PHI,8,0,-145,-1.5,130,6.5,-120,100,135,1.5,-150,3.85,Citizens Bank Park,8,8
2020-08-09,2020,DET,PIT,2,1,-140,-1.5,110,9.0,-105,-115,130,1.5,-130,5.25,PNC Park,3,1
2020-08-09,2020,ARI,SD,5,9,165,1.5,-125,8.0,-115,-105,-180,-1.5,105,3.02,PETCO Park,14,-4
2020-08-09,2020,COL,SEA,3,5,-147,-1.5,100,8.0,-110,-110,137,1.5,-120,4.76,T-Mobile Park,8,-2
2020-08-09,2020,LAD,SF,6,2,-250,-1.5,-130,8.5,100,-120,220,1.5,110,6.07,Dodger Stadium,8,4
2020-08-09,2020,NYY,TB,3,4,100,1.5,-205,8.5,-110,-110,-110,-1.5,180,4.25,Tropicana Field,7,-1
2020-08-09,2020,LAA,TEX,3,7,-114,-1.5,140,7.5,-115,-105,104,1.5,-160,4.0,Globe Life Field,10,-4
2020-08-09,2020,BOS,TOR,5,3,-155,-1.5,120,10.0,-115,-105,145,1.5,-140,6.08,Fenway Park,8,2
2020-08-09,2020,BAL,WSH,6,2,200,1.5,-110,8.5,-115,-105,-220,-1.5,-110,2.83,Nationals Park,8,4
2020-08-10,2020,COL,ARI,8,12,-127,-1.5,135,11.5,-115,-105,117,1.5,-155,6.43,Coors Field,20,-4
2020-08-10,2020,PHI,ATL,13,8,-140,-1.5,135,9.0,100,-120,130,1.5,-155,5.25,Citizens Bank Park,21,5
2020-08-10,2020,TB,BOS,8,7,-125,-1.5,120,9.5,-105,-115,115,1.5,-140,5.28,Fenway Park,15,1
2020-08-10,2020,ARI,COL,12,8,117,1.5,-155,11.5,-115,-105,-127,-1.5,135,5.3,Coors Field,20,4
2020-08-10,2020,DET,CWS,5,1,120,1.5,-130,9.0,-120,100,-130,-1.5,110,4.09,Comerica Park,6,4
2020-08-10,2020,CWS,DET,1,5,-130,-1.5,110,9.0,-120,100,120,1.5,-130,5.09,Comerica Park,6,-4
2020-08-10,2020,SF,HOU,4,6,190,1.5,-120,9.0,100,-120,-210,-1.5,100,3.1,Minute Maid Park,10,-2
2020-08-10,2020,OAK,LAA,9,10,-122,-1.5,125,9.5,105,-125,112,1.5,-145,5.22,Angel Stadium,19,-1
2020-08-10,2020,SD,LAD,2,1,185,1.5,-115,8.5,-115,-105,-205,-1.5,-105,2.98,Dodger Stadium,3,1
2020-08-10,2020,MIN,MIL,4,2,100,-1.5,160,8.5,-120,100,-110,1.5,-180,4.25,Miller Park,6,2
2020-08-10,2020,MIL,MIN,2,4,-110,1.5,-180,8.5,-120,100,100,-1.5,160,4.45,Miller Park,6,-2
2020-08-10,2020,WSH,NYM,16,4,-120,-1.5,135,8.5,-120,100,110,1.5,-155,4.64,Citi Field,20,12
2020-08-10,2020,LAA,OAK,10,9,112,1.5,-145,9.5,105,-125,-122,-1.5,125,4.48,Angel Stadium,19,1
2020-08-10,2020,ATL,PHI,8,13,130,1.5,-155,9.0,100,-120,-140,-1.5,135,3.91,Citizens Bank Park,21,-5
2020-08-10,2020,LAD,SD,1,2,-205,-1.5,-105,8.5,-115,-105,185,1.5,-115,5.71,Dodger Stadium,3,-1
2020-08-10,2020,TEX,SEA,2,10,-180,-1.5,105,9.0,-110,-110,165,1.5,-125,5.79,Globe Life Field,12,-8
2020-08-10,2020,HOU,SF,6,4,-210,-1.5,100,9.0,100,-120,190,1.5,-120,6.1,Minute Maid Park,10,2
2020-08-10,2020,BOS,TB,7,8,115,1.5,-140,9.5,-105,-115,-125,-1.5,120,4.42,Fenway Park,15,-1
2020-08-10,2020,SEA,TEX,10,2,165,1.5,-125,9.0,-110,-110,-180,-1.5,105,3.4,Globe Life Field,12,8
2020-08-10,2020,NYM,WSH,4,16,110,1.5,-155,8.5,-120,100,-120,-1.5,135,4.05,Citi Field,20,-12
2020-08-11,2020,COL,ARI,8,7,104,-1.5,175,11.0,-120,100,-114,1.5,-200,5.39,Coors Field,15,1
2020-08-11,2020,NYY,ATL,9,6,-137,-1.5,130,9.5,-105,-115,127,1.5,-150,5.49,Yankee Stadium,15,3
2020-08-11,2020,PHI,BAL,9,10,-180,-1.5,110,8.5,-115,-105,165,1.5,-130,5.46,Citizens Bank Park,19,-1
2020-08-11,2020,TB,BOS,8,2,-113,-1.5,140,10.0,-120,100,103,1.5,-160,5.31,Fenway Park,10,6
2020-08-11,2020,CLE,CHC,1,7,-102,1.5,-170,9.0,-115,-105,-108,-1.5,150,4.54,Progressive Field,8,-6
2020-08-11,2020,KC,CIN,5,6,161,1.5,-125,8.5,-120,100,-172,-1.5,105,3.26,Great American Ballpark,11,-1
2020-08-11,2020,CHC,CLE,7,1,-108,-1.5,150,9.0,-115,-105,-102,1.5,-170,4.67,Progressive Field,8,6
2020-08-11,2020,ARI,COL,7,8,-114,1.5,-200,11.0,-120,100,104,-1.5,175,5.86,Coors Field,15,-1
2020-08-11,2020,DET,CWS,4,8,112,1.5,-145,9.0,-120,100,-122,-1.5,125,4.25,Comerica Park,12,-4
2020-08-11,2020,CWS,DET,8,4,-122,-1.5,125,9.0,-120,100,112,1.5,-145,4.95,Comerica Park,12,4
2020-08-11,2020,SF,HOU,7,6,157,1.5,-125,9.0,-120,100,-167,-1.5,105,3.5,Minute Maid Park,13,1
2020-08-11,2020,CIN,KC,6,5,-172,-1.5,105,8.5,-120,100,161,1.5,-125,5.38,Great American Ballpark,11,1
2020-08-11,2020,OAK,LAA,0,6,145,1.5,-150,9.0,-110,-110,-155,-1.5,130,3.67,Angel Stadium,6,-6
2020-08-11,2020,SD,LAD,6,2,148,1.5,-140,8.5,-105,-115,-158,-1.5,120,3.43,Dodger Stadium,8,4
2020-08-11,2020,TOR,MIA,5,4,-154,-1.5,125,8.0,-120,100,144,1.5,-145,4.85,Sahlen Field,9,1
2020-08-11,2020,MIN,MIL,4,6,104,1.5,-200,9.0,-115,-105,-114,-1.5,175,4.41,Miller Park,10,-2
2020-08-11,2020,MIL,MIN,6,4,-114,-1.5,175,9.0,-115,-105,104,1.5,-200,4.79,Miller Park,10,2
2020-08-11,2020,WSH,NYM,2,1,-155,-1.5,-115,8.5,-115,-105,145,1.5,-105,5.17,Citi Field,3,1
2020-08-11,2020,ATL,NYY,6,9,127,1.5,-150,9.5,-105,-115,-137,-1.5,130,4.19,Yankee Stadium,15,-3
2020-08-11,2020,LAA,OAK,6,0,-155,-1.5,130,9.0,-110,-110,145,1.5,-150,5.47,Angel Stadium,6,6
2020-08-11,2020,BAL,PHI,10,9,165,1.5,-130,8.5,-115,-105,-180,-1.5,110,3.21,Citizens Bank Park,19,1
2020-08-11,2020,LAD,SD,2,6,-158,-1.5,120,8.5,-105,-115,148,1.5,-140,5.21,Dodger Stadium,8,-4
2020-08-11,2020,TEX,SEA,4,2,-130,-1.5,140,8.5,-105,-115,120,1.5,-160,4.8,Globe Life Field,6,2
2020-08-11,2020,HOU,SF,6,7,-167,-1.5,105,9.0,-120,100,157,1.5,-125,5.63,Minute Maid Park,13,-1
2020-08-11,2020,BOS,TB,2,8,103,1.5,-160,10.0,-120,100,-113,-1.5,140,4.93,Fenway Park,10,-6
2020-08-11,2020,SEA,TEX,2,4,120,1.5,-160,8.5,-105,-115,-130,-1.5,140,3.86,Globe Life Field,6,-2
2020-08-11,2020,MIA,TOR,4,5,144,1.5,-145,8.0,-120,100,-154,-1.5,125,3.28,Sahlen Field,9,-1
2020-08-11,2020,NYM,WSH,1,2,145,1.5,-105,8.5,-115,-105,-155,-1.5,-115,3.47,Citi Field,3,-1
2020-08-12,2020,COL,ARI,7,13,-101,-1.5,170,12.5,-105,-115,-109,1.5,-190,6.28,Coors Field,20,-6
2020-08-12,2020,NYY,ATL,6,3,-165,-1.5,115,9.0,-115,-105,155,1.5,-135,5.6,Yankee Stadium,9,3
2020-08-12,2020,PHI,BAL,4,5,-185,-1.5,-105,10.0,100,-120,170,1.5,-115,6.49,Citizens Bank Park,9,-1
2020-08-12,2020,TB,BOS,9,5,-143,-1.5,105,9.0,-120,100,133,1.5,-125,5.3,Fenway Park,14,4
2020-08-12,2020,CLE,CHC,2,7,-120,-1.5,170,7.5,-120,100,110,1.5,-190,4.09,Progressive Field,9,-5
2020-08-12,2020,KC,CIN,5,4,105,1.5,-180,9.5,-115,-105,-115,-1.5,160,4.63,Great American Ballpark,9,1
2020-08-12,2020,CHC,CLE,7,2,110,1.5,-190,7.5,-120,100,-120,-1.5,170,3.57,Progressive Field,9,5
2020-08-12,2020,ARI,COL,13,7,-109,1.5,-190,12.5,-105,-115,-101,-1.5,170,6.52,Coors Field,20,6
2020-08-12,2020,DET,CWS,5,7,123,1.5,-130,9.0,-110,-110,-133,-1.5,110,4.04,Comerica Park,12,-2
2020-08-12,2020,CWS,DET,7,5,-133,-1.5,110,9.0,-110,-110,123,1.5,-130,5.14,Comerica Park,12,2
2020-08-12,2020,SF,HOU,1,5,177,1.5,-115,9.0,100,-120,-194,-1.5,-105,3.25,Minute Maid Park,6,-4
2020-08-12,2020,CIN,KC,4,5,-115,-1.5,160,9.5,-115,-105,105,1.5,-180,5.08,Great American Ballpark,9,-1
2020-08-12,2020,OAK,LAA,8,4,-109,-1.5,140,9.5,-105,-115,-101,1.5,-160,4.95,Angel Stadium,12,4
2020-08-12,2020,SD,LAD,0,6,158,1.5,-135,9.5,-110,-110,-168,-1.5,115,3.68,Dodger Stadium,6,-6
2020-08-12,2020,TOR,MIA,11,14,-158,-1.5,115,8.5,-110,-110,148,1.5,-135,5.21,Sahlen Field,25,-3
2020-08-12,2020,MIN,MIL,12,2,-135,-1.5,115,9.0,-120,100,125,1.5,-135,5.17,Miller Park,14,10
2020-08-12,2020,MIL,MIN,2,12,125,1.5,-135,9.0,-120,100,-135,-1.5,115,4.0,Miller Park,14,-10
2020-08-12,2020,WSH,NYM,6,11,117,-1.5,175,9.5,-110,-110,-127,1.5,-200,4.38,Citi Field,17,-5
2020-08-12,2020,ATL,NYY,3,6,155,1.5,-135,9.0,-115,-105,-165,-1.5,115,3.53,Yankee Stadium,9,-3
2020-08-12,2020,LAA,OAK,4,8,-101,1.5,-160,9.5,-105,-115,-109,-1.5,140,4.77,Angel Stadium,12,-4
2020-08-12,2020,BAL,PHI,5,4,170,1.5,-115,10.0,100,-120,-185,-1.5,-105,3.7,Citizens Bank Park,9,1
2020-08-12,2020,LAD,SD,6,0,-168,-1.5,115,9.5,-110,-110,158,1.5,-135,5.96,Dodger Stadium,6,6
2020-08-12,2020,TEX,SEA,7,4,-118,-1.5,155,8.5,-115,-105,108,1.5,-175,4.6,Globe Life Field,11,3
2020-08-12,2020,HOU,SF,5,1,-194,-1.5,-105,9.0,100,-120,177,1.5,-115,5.94,Minute Maid Park,6,4
2020-08-12,2020,BOS,TB,5,9,133,1.5,-125,9.0,-120,100,-143,-1.5,105,3.86,Fenway Park,14,-4
2020-08-12,2020,SEA,TEX,4,7,108,1.5,-175,8.5,-115,-105,-118,-1.5,155,4.09,Globe Life Field,11,-3
2020-08-12,2020,MIA,TOR,14,11,148,1.5,-135,8.5,-110,-110,-158,-1.5,115,3.43,Sahlen Field,25,3
2020-08-12,2020,NYM,WSH,11,6,-127,1.5,-200,9.5,-110,-110,117,-1.5,175,5.31,Citi Field,17,5
2020-08-13,2020,PHI,BAL,4,11,-200,-1.5,-110,9.5,-105,-115,180,1.5,-110,6.33,Citizens Bank Park,15,-7
2020-08-13,2020,TB,BOS,17,8,-159,-1.5,-105,9.0,-115,-105,149,1.5,-115,5.53,Fenway Park,25,9
2020-08-13,2020,MIL,CHC,2,4,155,1.5,-125,8.5,100,-120,-165,-1.5,105,3.33,Wrigley Field,6,-2
2020-08-13,2020,PIT,CIN,9,6,157,1.5,-130,9.0,100,-120,-167,-1.5,110,3.5,Great American Ballpark,15,3
2020-08-13,2020,SD,LAD,2,11,137,1.5,-150,8.0,-115,-105,-147,-1.5,130,3.38,Dodger Stadium,13,-9
2020-08-13,2020,CHC,MIL,4,2,-165,-1.5,105,8.5,100,-120,155,1.5,-125,5.29,Wrigley Field,6,2
2020-08-13,2020,WSH,NYM,2,8,117,1.5,-185,8.5,-120,100,-127,-1.5,165,3.92,Citi Field,10,-6
2020-08-13,2020,BAL,PHI,11,4,180,1.5,-110,9.5,-105,-115,-200,-1.5,-110,3.39,Citizens Bank Park,15,7
2020-08-13,2020,CIN,PIT,6,9,-167,-1.5,110,9.0,100,-120,157,1.5,-130,5.63,Great American Ballpark,15,-3
2020-08-13,2020,LAD,SD,11,2,-147,-1.5,130,8.0,-115,-105,137,1.5,-150,4.76,Dodger Stadium,13,9
2020-08-13,2020,BOS,TB,8,17,149,1.5,-115,9.0,-115,-105,-159,-1.5,-105,3.61,Fenway Park,25,-9
2020-08-13,2020,NYM,WSH,8,2,-127,-1.5,165,8.5,-120,100,117,1.5,-185,4.76,Citi Field,10,6
2020-08-14,2020,SD,ARI,1,5,-148,-1.5,115,9.0,-105,-115,138,1.5,-135,5.37,Chase Field,6,-4
2020-08-14,2020,MIA,ATL,8,2,-106,1.5,-175,8.5,-120,100,-104,-1.5,155,4.37,Marlins Park,10,6
2020-08-14,2020,WSH,BAL,15,3,-162,-1.5,-115,9.0,-105,-115,152,1.5,-105,5.56,Camden Yards,18,12
2020-08-14,2020,NYY,BOS,10,3,-300,-1.5,-150,9.0,100,-120,260,1.5,130,6.75,Yankee Stadium,13,7
2020-08-14,2020,MIL,CHC,4,3,-125,-1.5,135,8.0,-120,100,115,1.5,-155,4.44,Wrigley Field,7,1
2020-08-14,2020,PIT,CIN,1,8,185,1.5,-115,8.0,-120,100,-205,-1.5,-105,2.81,Great American Ballpark,9,-7
2020-08-14,2020,DET,CLE,5,10,180,1.5,110,8.5,-115,-105,-200,-1.5,-130,3.04,Comerica Park,15,-5
2020-08-14,2020,TEX,COL,3,2,-129,-1.5,105,12.5,-120,100,119,1.5,-125,7.04,Coors Field,5,1
2020-08-14,2020,CLE,DET,10,5,-200,-1.5,-130,8.5,-115,-105,180,1.5,110,5.67,Comerica Park,15,5
2020-08-14,2020,SEA,HOU,1,11,220,1.5,110,9.5,100,-120,-250,-1.5,-130,2.97,Minute Maid Park,12,-10
2020-08-14,2020,LAD,LAA,7,4,-168,-1.5,-115,9.0,-120,100,158,1.5,-105,5.64,Angel Stadium,11,3
2020-08-14,2020,LAA,LAD,4,7,158,1.5,-105,9.0,-120,100,-168,-1.5,-115,3.49,Angel Stadium,11,-3
2020-08-14,2020,ATL,MIA,2,8,-104,-1.5,155,8.5,-120,100,-106,1.5,-175,4.33,Marlins Park,10,-6
2020-08-14,2020,CHC,MIL,3,4,115,1.5,-155,8.0,-120,100,-125,-1.5,135,3.72,Wrigley Field,7,-1
2020-08-14,2020,PHI,NYM,6,5,-125,1.5,-215,10.0,-105,-115,115,-1.5,190,5.56,Citizens Bank Park,11,1
2020-08-14,2020,BOS,NYY,3,10,260,1.5,130,9.0,100,-120,-300,-1.5,-150,2.5,Yankee Stadium,13,-7
2020-08-14,2020,SF,OAK,7,8,180,1.5,100,8.5,-115,-105,-200,-1.5,-120,3.04,AT&T Park,15,-1
2020-08-14,2020,NYM,PHI,5,6,115,-1.5,190,10.0,-105,-115,-125,1.5,-215,4.65,Citizens Bank Park,11,-1
2020-08-14,2020,CIN,PIT,8,1,-205,-1.5,-105,8.0,-120,100,185,1.5,-115,5.38,Great American Ballpark,9,7
2020-08-14,2020,ARI,SD,5,1,138,1.5,-135,9.0,-105,-115,-148,-1.5,115,3.78,Chase Field,6,4
2020-08-14,2020,HOU,SEA,11,1,-250,-1.5,-130,9.5,100,-120,220,1.5,110,6.79,Minute Maid Park,12,10
2020-08-14,2020,OAK,SF,8,7,-200,-1.5,-120,8.5,-115,-105,180,1.5,100,5.67,AT&T Park,15,1
2020-08-14,2020,TOR,TB,12,4,130,1.5,-120,10.5,-115,-105,-140,-1.5,100,4.57,Sahlen Field,16,8
2020-08-14,2020,COL,TEX,2,3,119,1.5,-125,12.5,-120,100,-129,-1.5,105,5.71,Coors Field,5,-1
2020-08-14,2020,TB,TOR,4,12,-140,-1.5,100,10.5,-115,-105,130,1.5,-120,6.13,Sahlen Field,16,-8
2020-08-14,2020,BAL,WSH,3,15,152,1.5,-105,9.0,-105,-115,-162,-1.5,-115,3.57,Camden Yards,18,-12
2020-08-15,2020,SD,ARI,6,7,-112,-1.5,130,10.0,-115,-105,102,1.5,-150,5.28,Chase Field,13,-1
2020-08-15,2020,MIA,ATL,1,2,180,1.5,115,8.5,-105,-115,-200,-1.5,-135,3.04,Marlins Park,3,-1
2020-08-15,2020,WSH,BAL,3,7,-174,-1.5,-120,9.0,-120,100,162,1.5,100,5.72,Camden Yards,10,-4
2020-08-15,2020,NYY,BOS,11,5,-155,-1.5,115,9.0,-120,100,145,1.5,-135,5.47,Yankee Stadium,16,6
2020-08-15,2020,MIL,CHC,6,5,-107,-1.5,145,9.5,-120,100,-103,1.5,-165,4.91,Wrigley Field,11,1
2020-08-15,2020,DET,CLE,1,3,165,1.5,-105,7.5,100,-120,-180,-1.5,-115,2.83,Comerica Park,4,-2
2020-08-15,2020,TEX,COL,6,4,160,1.5,-120,11.5,-110,-110,-170,-1.5,100,4.42,Coors Field,10,2
2020-08-15,2020,STL,CWS,5,1,145,1.5,-170,7.0,-115,-105,-155,-1.5,150,2.86,Guaranteed Rate Field,6,4
2020-08-15,2020,STL,CWS,6,3,132,1.5,-160,7.5,-115,-105,-142,-1.5,140,3.23,Guaranteed Rate Field,9,3
2020-08-15,2020,CLE,DET,3,1,-180,-1.5,-115,7.5,100,-120,165,1.5,-105,4.82,Comerica Park,4,2
2020-08-15,2020,SEA,HOU,1,2,205,1.5,115,10.0,-110,-110,-230,-1.5,-135,3.28,Minute Maid Park,3,-1
2020-08-15,2020,MIN,KC,4,2,-185,-1.5,125,7.5,-115,-105,170,1.5,-145,4.87,Target Field,6,2
2020-08-15,2020,MIN,KC,2,4,-180,-1.5,115,7.5,-130,110,165,1.5,-135,4.82,Target Field,6,-2
2020-08-15,2020,LAD,LAA,6,5,-145,-1.5,105,9.5,-105,-115,135,1.5,-125,5.62,Angel Stadium,11,1
2020-08-15,2020,LAA,LAD,5,6,135,1.5,-125,9.5,-105,-115,-145,-1.5,105,4.04,Angel Stadium,11,-1
2020-08-15,2020,ATL,MIA,2,1,-200,-1.5,-135,8.5,-105,-115,180,1.5,115,5.67,Marlins Park,3,1
2020-08-15,2020,CHC,MIL,5,6,-103,1.5,-165,9.5,-120,100,-107,-1.5,145,4.82,Wrigley Field,11,-1
2020-08-15,2020,KC,MIN,2,4,170,1.5,-145,7.5,-115,-105,-185,-1.5,125,2.78,Target Field,6,-2
2020-08-15,2020,KC,MIN,4,2,165,1.5,-135,7.5,-130,110,-180,-1.5,115,2.83,Target Field,6,2
2020-08-15,2020,PHI,NYM,6,2,-165,-1.5,110,9.0,-105,-115,155,1.5,-130,5.6,Citizens Bank Park,8,4
2020-08-15,2020,BOS,NYY,5,11,145,1.5,-135,9.0,-120,100,-155,-1.5,115,3.67,Yankee Stadium,16,-6
2020-08-15,2020,SF,OAK,6,7,103,1.5,-170,8.5,-120,100,-113,-1.5,150,4.19,AT&T Park,13,-1
2020-08-15,2020,NYM,PHI,2,6,155,1.5,-130,9.0,-105,-115,-165,-1.5,110,3.53,Citizens Bank Park,8,-4
2020-08-15,2020,ARI,SD,7,6,102,1.5,-150,10.0,-115,-105,-112,-1.5,130,4.95,Chase Field,13,1
2020-08-15,2020,HOU,SEA,2,1,-230,-1.5,-135,10.0,-110,-110,205,1.5,115,6.97,Minute Maid Park,3,1
2020-08-15,2020,OAK,SF,7,6,-113,-1.5,150,8.5,-120,100,103,1.5,-170,4.51,AT&T Park,13,1
2020-08-15,2020,CWS,STL,1,5,-155,-1.5,150,7.0,-115,-105,145,1.5,-170,4.25,Guaranteed Rate Field,6,-4
2020-08-15,2020,CWS,STL,3,6,-142,-1.5,140,7.5,-115,-105,132,1.5,-160,4.4,Guaranteed Rate Field,9,-3
2020-08-15,2020,TOR,TB,2,3,-105,-1.5,165,10.5,-110,-110,105,1.5,-160,5.38,Sahlen Field,5,-1
2020-08-15,2020,COL,TEX,4,6,-170,-1.5,100,11.5,-110,-110,160,1.5,-120,7.24,Coors Field,10,-2
2020-08-15,2020,TB,TOR,3,2,105,1.5,-160,10.5,-110,-110,-105,-1.5,165,5.12,Sahlen Field,5,1
2020-08-15,2020,BAL,WSH,7,3,162,1.5,100,9.0,-120,100,-174,-1.5,-120,3.44,Camden Yards,10,4
2020-08-16,2020,SD,ARI,4,5,-117,-1.5,130,9.5,-105,-115,107,1.5,-150,5.12,Chase Field,9,-1
2020-08-16,2020,MIA,ATL,0,4,115,1.5,-155,9.0,100,-120,-125,-1.5,135,4.19,Marlins Park,4,-4
2020-08-16,2020,WSH,BAL,6,5,-174,-1.5,-110,8.0,-110,-110,162,1.5,-110,5.08,Camden Yards,11,1
2020-08-16,2020,NYY,BOS,4,2,-157,-1.5,110,10.5,-110,-110,147,1.5,-130,6.41,Yankee Stadium,6,2
2020-08-16,2020,MIL,CHC,6,5,113,1.5,-175,9.0,100,-120,-123,-1.5,155,4.23,Wrigley Field,11,1
2020-08-16,2020,DET,CLE,5,8,125,1.5,-125,9.0,-120,100,-135,-1.5,105,4.0,Comerica Park,13,-3
2020-08-16,2020,TEX,COL,6,10,128,1.5,-145,12.5,-110,-110,-138,-1.5,125,5.48,Coors Field,16,-4
2020-08-16,2020,STL,CWS,2,7,135,1.5,-145,9.5,-105,-115,-145,-1.5,125,4.04,Guaranteed Rate Field,9,-5
2020-08-16,2020,CLE,DET,8,5,-135,-1.5,105,9.0,-120,100,125,1.5,-125,5.17,Comerica Park,13,3
2020-08-16,2020,SEA,HOU,2,3,200,1.5,100,9.0,-120,100,-220,-1.5,-120,3.0,Minute Maid Park,5,-1
2020-08-16,2020,MIN,KC,4,2,-176,-1.5,100,9.5,-110,-110,163,1.5,-120,6.06,Target Field,6,2
2020-08-16,2020,LAD,LAA,8,3,-190,-1.5,-130,10.0,-110,-110,175,1.5,110,6.55,Angel Stadium,11,5
2020-08-16,2020,LAA,LAD,3,8,175,1.5,110,10.0,-110,-110,-190,-1.5,-130,3.64,Angel Stadium,11,-5
2020-08-16,2020,ATL,MIA,4,0,-125,-1.5,135,9.0,100,-120,115,1.5,-155,5.0,Marlins Park,4,4
2020-08-16,2020,CHC,MIL,5,6,-123,-1.5,155,9.0,100,-120,113,1.5,-175,4.96,Wrigley Field,11,-1
2020-08-16,2020,KC,MIN,2,4,163,1.5,-120,9.5,-110,-110,-176,-1.5,100,3.61,Target Field,6,-2
2020-08-16,2020,PHI,NYM,6,2,-142,-1.5,125,9.0,100,-120,132,1.5,-145,5.28,Citizens Bank Park,8,4
2020-08-16,2020,BOS,NYY,2,4,147,1.5,-130,10.5,-110,-110,-157,-1.5,110,4.25,Yankee Stadium,6,-2
2020-08-16,2020,SF,OAK,3,15,112,1.5,-150,9.5,-110,-110,-122,-1.5,130,4.48,AT&T Park,18,-12
2020-08-16,2020,NYM,PHI,2,6,132,1.5,-145,9.0,100,-120,-142,-1.5,125,3.88,Citizens Bank Park,8,-4
2020-08-16,2020,ARI,SD,5,4,107,1.5,-150,9.5,-105,-115,-117,-1.5,130,4.59,Chase Field,9,1
2020-08-16,2020,HOU,SEA,3,2,-220,-1.5,-120,9.0,-120,100,200,1.5,100,6.19,Minute Maid Park,5,1
2020-08-16,2020,OAK,SF,15,3,-122,-1.5,130,9.5,-110,-110,112,1.5,-150,5.22,AT&T Park,18,12
2020-08-16,2020,CWS,STL,7,2,-145,-1.5,125,9.5,-105,-115,135,1.5,-145,5.62,Guaranteed Rate Field,9,5
2020-08-16,2020,TOR,TB,5,7,107,1.5,-165,7.5,-110,-110,-117,-1.5,145,3.62,Sahlen Field,12,-2
2020-08-16,2020,COL,TEX,10,6,-138,-1.5,125,12.5,-110,-110,128,1.5,-145,7.25,Coors Field,16,4
2020-08-16,2020,TB,TOR,7,5,-117,-1.5,145,7.5,-110,-110,107,1.5,-165,4.04,Sahlen Field,12,2
2020-08-16,2020,BAL,WSH,5,6,162,1.5,-110,8.0,-110,-110,-174,-1.5,-110,3.05,Camden Yards,11,-1
2020-08-17,2020,OAK,ARI,3,4,102,-1.5,160,9.0,-105,-115,-112,1.5,-180,4.46,Chase Field,7,-1
2020-08-17,2020,WSH,ATL,6,7,150,1.5,-140,10.5,-110,-110,-160,-1.5,120,4.2,Suntrust Park,13,-1
2020-08-17,2020,TOR,BAL,7,2,-130,-1.5,120,8.5,-130,110,120,1.5,-140,4.8,Camden Yards,9,5
2020-08-17,2020,NYY,BOS,6,3,-155,-1.5,125,10.0,100,-120,145,1.5,-145,6.08,Yankee Stadium,9,3
2020-08-17,2020,STL,CHC,3,1,150,1.5,-155,6.5,-105,-115,-160,-1.5,135,2.6,Wrigley Field,4,2
2020-08-17,2020,STL,CHC,4,5,108,1.5,-180,7.0,-125,105,-118,-1.5,160,3.37,Wrigley Field,9,-1
2020-08-17,2020,HOU,COL,2,1,-155,-1.5,120,9.5,-110,-110,145,1.5,-140,5.77,Minute Maid Park,3,1
2020-08-17,2020,DET,CWS,2,7,155,1.5,-130,9.5,-110,-110,-165,-1.5,110,3.73,Guaranteed Rate Field,9,-5
2020-08-17,2020,CWS,DET,7,2,-165,-1.5,110,9.5,-110,-110,155,1.5,-130,5.92,Guaranteed Rate Field,9,5
2020-08-17,2020,COL,HOU,1,2,145,1.5,-140,9.5,-110,-110,-155,-1.5,120,3.88,Minute Maid Park,3,-1
2020-08-17,2020,MIN,KC,4,1,-170,-1.5,115,9.5,-105,-115,160,1.5,-135,5.98,Target Field,5,3
2020-08-17,2020,SF,LAA,6,7,161,1.5,-125,10.0,100,-120,-172,-1.5,105,3.83,Angel Stadium,13,-1
2020-08-17,2020,SEA,LAD,9,11,275,1.5,155,10.0,-110,-110,-315,-1.5,-175,2.67,Dodger Stadium,20,-2
2020-08-17,2020,NYM,MIA,11,4,-155,-1.5,-105,9.0,-130,110,145,1.5,-115,5.47,Marlins Park,15,7
2020-08-17,2020,KC,MIN,1,4,160,1.5,-135,9.5,-105,-115,-170,-1.5,115,3.65,Target Field,5,-3
2020-08-17,2020,MIA,NYM,4,11,145,1.5,-115,9.0,-130,110,-155,-1.5,-105,3.67,Marlins Park,15,-7
2020-08-17,2020,BOS,NYY,3,6,145,1.5,-145,10.0,100,-120,-155,-1.5,125,4.08,Yankee Stadium,9,-3
2020-08-17,2020,ARI,OAK,4,3,-112,1.5,-180,9.0,-105,-115,102,-1.5,160,4.75,Chase Field,7,1
2020-08-17,2020,TEX,SD,4,14,130,1.5,-125,9.0,-110,-110,-140,-1.5,105,3.91,Globe Life Field,18,-10
2020-08-17,2020,LAD,SEA,11,9,-315,-1.5,-175,10.0,-110,-110,275,1.5,155,7.59,Dodger Stadium,20,2
2020-08-17,2020,LAA,SF,7,6,-172,-1.5,105,10.0,100,-120,161,1.5,-125,6.32,Angel Stadium,13,1
2020-08-17,2020,CHC,STL,1,3,-160,-1.5,135,6.5,-105,-115,150,1.5,-155,4.0,Wrigley Field,4,-2
2020-08-17,2020,CHC,STL,5,4,-118,-1.5,160,7.0,-125,105,108,1.5,-180,3.79,Wrigley Field,9,1
2020-08-17,2020,SD,TEX,14,4,-140,-1.5,105,9.0,-110,-110,130,1.5,-125,5.25,Globe Life Field,18,10
2020-08-17,2020,BAL,TOR,2,7,120,1.5,-140,8.5,-130,110,-130,-1.5,120,3.86,Camden Yards,9,-5
2020-08-17,2020,ATL,WSH,7,6,-160,-1.5,120,10.5,-110,-110,150,1.5,-140,6.46,Suntrust Park,13,1
2020-08-18,2020,OAK,ARI,1,10,-149,-1.5,-105,9.0,-115,-105,139,1.5,-115,5.39,Chase Field,11,-9
2020-08-18,2020,WSH,ATL,8,5,118,1.5,-165,9.5,-110,-110,-128,-1.5,145,4.36,Suntrust Park,13,3
2020-08-18,2020,TOR,BAL,8,7,-120,-1.5,120,10.0,100,-120,110,1.5,-140,5.45,Camden Yards,15,1
2020-08-18,2020,PHI,BOS,13,6,-130,-1.5,110,11.0,-105,-115,120,1.5,-130,6.22,Fenway Park,19,7
2020-08-18,2020,STL,CHC,3,6,163,1.5,-125,7.5,-110,-110,-176,-1.5,105,2.85,Wrigley Field,9,-3
2020-08-18,2020,PIT,CLE,3,6,170,1.5,100,9.0,-105,-115,-185,-1.5,-120,3.33,PNC Park,9,-3
2020-08-18,2020,HOU,COL,2,1,-190,-1.5,100,8.5,-105,-115,175,1.5,-120,5.57,Minute Maid Park,3,1
2020-08-18,2020,DET,CWS,4,10,152,1.5,-135,9.0,-110,-110,-162,-1.5,115,3.57,Guaranteed Rate Field,14,-6
2020-08-18,2020,CWS,DET,10,4,-162,-1.5,115,9.0,-110,-110,152,1.5,-135,5.56,Guaranteed Rate Field,14,6
2020-08-18,2020,COL,HOU,1,2,175,1.5,-120,8.5,-105,-115,-190,-1.5,100,3.09,Minute Maid Park,3,-1
2020-08-18,2020,SF,LAA,8,2,210,1.5,105,9.5,-105,-115,-240,-1.5,-125,3.06,Angel Stadium,10,6
2020-08-18,2020,SEA,LAD,1,2,210,1.5,110,9.5,-105,-115,-240,-1.5,-130,3.06,Dodger Stadium,3,-1
2020-08-18,2020,NYM,MIA,8,3,-155,-1.5,-110,10.0,-105,-115,145,1.5,-110,6.08,Marlins Park,11,5
2020-08-18,2020,MIN,MIL,4,3,-145,-1.5,130,9.0,105,-125,135,1.5,-150,5.33,Target Field,7,1
2020-08-18,2020,MIL,MIN,3,4,135,1.5,-150,9.0,105,-125,-145,-1.5,130,3.83,Target Field,7,-1
2020-08-18,2020,MIA,NYM,3,8,145,1.5,-110,10.0,-105,-115,-155,-1.5,-110,4.08,Marlins Park,11,-5
2020-08-18,2020,TB,NYY,6,3,-123,-1.5,130,8.5,-115,-105,113,1.5,-150,4.69,Yankee Stadium,9,3
2020-08-18,2020,ARI,OAK,10,1,139,1.5,-115,9.0,-115,-105,-149,-1.5,-105,3.77,Chase Field,11,9
2020-08-18,2020,BOS,PHI,6,13,120,1.5,-130,11.0,-105,-115,-130,-1.5,110,5.0,Fenway Park,19,-7
2020-08-18,2020,CLE,PIT,6,3,-185,-1.5,-120,9.0,-105,-115,170,1.5,100,5.84,PNC Park,9,3
2020-08-18,2020,TEX,SD,4,6,106,1.5,-150,9.0,105,-125,-116,-1.5,130,4.37,Globe Life Field,10,-2
2020-08-18,2020,LAD,SEA,2,1,-240,-1.5,-130,9.5,-105,-115,210,1.5,110,6.71,Dodger Stadium,3,1
2020-08-18,2020,LAA,SF,2,8,-240,-1.5,-125,9.5,-105,-115,210,1.5,105,6.71,Angel Stadium,10,-6
2020-08-18,2020,CHC,STL,6,3,-176,-1.5,105,7.5,-110,-110,163,1.5,-125,4.78,Wrigley Field,9,3
2020-08-18,2020,NYY,TB,3,6,113,1.5,-150,8.5,-115,-105,-123,-1.5,130,3.99,Yankee Stadium,9,-3
2020-08-18,2020,SD,TEX,6,4,-116,-1.5,130,9.0,105,-125,106,1.5,-150,4.83,Globe Life Field,10,2
2020-08-18,2020,BAL,TOR,7,8,110,1.5,-140,10.0,100,-120,-120,-1.5,120,4.76,Camden Yards,15,-1
2020-08-18,2020,ATL,WSH,5,8,-128,-1.5,145,9.5,-110,-110,118,1.5,-165,5.33,Suntrust Park,13,-3
2020-08-19,2020,OAK,ARI,4,1,-160,-1.5,115,8.5,-105,-115,150,1.5,-135,5.23,Oakland Coliseum,5,3
2020-08-19,2020,TOR,BAL,5,2,109,1.5,-185,9.5,-120,100,-119,-1.5,165,4.55,Camden Yards,7,3
2020-08-19,2020,PHI,BOS,3,6,-166,-1.5,-120,10.5,-120,100,156,1.5,100,6.55,Fenway Park,9,-3
2020-08-19,2020,STL,CHC,9,3,-132,-1.5,150,6.0,100,-120,122,1.5,-170,3.41,Wrigley Field,12,6
2020-08-19,2020,STL,CHC,2,4,115,1.5,-170,7.5,-115,-105,-125,-1.5,150,3.49,Wrigley Field,6,-2
2020-08-19,2020,KC,CIN,4,0,133,1.5,-150,6.5,-115,-105,-143,-1.5,130,2.79,Kauffman Stadium,4,4
2020-08-19,2020,KC,CIN,0,5,185,1.5,-110,6.5,100,-120,-205,-1.5,-110,2.28,Kauffman Stadium,5,-5
2020-08-19,2020,PIT,CLE,1,6,170,1.5,105,9.0,-115,-105,-185,-1.5,-125,3.33,PNC Park,7,-5
2020-08-19,2020,HOU,COL,13,6,-143,-1.5,-110,12.5,100,-120,133,1.5,-110,7.36,Coors Field,19,7
2020-08-19,2020,DET,CWS,3,5,144,1.5,-150,9.0,-120,100,-154,-1.5,130,3.69,Guaranteed Rate Field,8,-2
2020-08-19,2020,CWS,DET,5,3,-154,-1.5,130,9.0,-120,100,144,1.5,-150,5.46,Guaranteed Rate Field,8,2
2020-08-19,2020,COL,HOU,6,13,133,1.5,-110,12.5,100,-120,-143,-1.5,-110,5.36,Coors Field,19,-7
2020-08-19,2020,CIN,KC,0,4,-143,-1.5,130,6.5,-115,-105,133,1.5,-150,3.83,Kauffman Stadium,4,-4
2020-08-19,2020,CIN,KC,5,0,-205,-1.5,-110,6.5,100,-120,185,1.5,-110,4.37,Kauffman Stadium,5,5
2020-08-19,2020,SF,LAA,7,2,135,1.5,-140,9.0,-110,-110,-145,-1.5,120,3.83,AT&T Park,9,5
2020-08-19,2020,SEA,LAD,6,4,210,1.5,130,9.0,-110,-110,-240,-1.5,-150,2.9,T-Mobile Park,10,2
2020-08-19,2020,NYM,MIA,5,3,-210,-1.5,-120,7.5,100,-120,190,1.5,100,5.08,Marlins Park,8,2
2020-08-19,2020,MIN,MIL,3,9,-153,-1.5,120,9.5,105,-125,143,1.5,-140,5.75,Target Field,12,-6
2020-08-19,2020,MIL,MIN,9,3,143,1.5,-140,9.5,105,-125,-153,-1.5,120,3.91,Target Field,12,6
2020-08-19,2020,MIA,NYM,3,5,190,1.5,100,7.5,100,-120,-210,-1.5,-120,2.59,Marlins Park,8,-2
2020-08-19,2020,TB,NYY,4,2,167,1.5,-130,8.0,-120,100,-182,-1.5,110,3.0,Yankee Stadium,6,2
2020-08-19,2020,ARI,OAK,1,4,150,1.5,-135,8.5,-105,-115,-160,-1.5,115,3.4,Oakland Coliseum,5,-3
2020-08-19,2020,BOS,PHI,6,3,156,1.5,100,10.5,-120,100,-166,-1.5,-120,4.1,Fenway Park,9,3
2020-08-19,2020,CLE,PIT,6,1,-185,-1.5,-125,9.0,-115,-105,170,1.5,105,5.84,PNC Park,7,5
2020-08-19,2020,TEX,SD,3,6,126,1.5,-175,8.0,-105,-115,-136,-1.5,155,3.54,PETCO Park,9,-3
2020-08-19,2020,LAD,SEA,4,6,-240,-1.5,-150,9.0,-110,-110,210,1.5,130,6.35,T-Mobile Park,10,-2
2020-08-19,2020,LAA,SF,2,7,-145,-1.5,120,9.0,-110,-110,135,1.5,-140,5.33,AT&T Park,9,-5
2020-08-19,2020,CHC,STL,3,9,122,1.5,-170,6.0,100,-120,-132,-1.5,150,2.7,Wrigley Field,12,-6
2020-08-19,2020,CHC,STL,4,2,-125,-1.5,150,7.5,-115,-105,115,1.5,-170,4.17,Wrigley Field,6,2
2020-08-19,2020,NYY,TB,2,4,-182,-1.5,110,8.0,-120,100,167,1.5,-130,5.16,Yankee Stadium,6,-2
2020-08-19,2020,SD,TEX,6,3,-136,-1.5,155,8.0,-105,-115,126,1.5,-175,4.61,PETCO Park,9,3
2020-08-19,2020,BAL,TOR,2,5,-119,-1.5,165,9.5,-120,100,109,1.5,-185,5.16,Camden Yards,7,-3
2020-08-20,2020,OAK,ARI,5,1,-158,-1.5,120,9.0,100,-120,148,1.5,-140,5.51,Oakland Coliseum,6,4
2020-08-20,2020,BOS,BAL,7,1,-145,-1.5,100,9.5,-110,-110,135,1.5,-120,5.62,Camden Yards,8,6
2020-08-20,2020,BAL,BOS,1,7,135,1.5,-120,9.5,-110,-110,-145,-1.5,100,4.04,Camden Yards,8,-6
2020-08-20,2020,STL,CIN,5,4,120,1.5,-135,8.0,-120,100,-130,-1.5,115,3.64,Busch Stadium,9,1
2020-08-20,2020,PIT,CLE,0,2,245,1.5,155,7.5,-120,100,-280,-1.5,-175,2.17,PNC Park,2,-2
2020-08-20,2020,HOU,COL,10,8,114,1.5,-165,11.5,-105,-115,-124,-1.5,145,5.37,Coors Field,18,2
2020-08-20,2020,DET,CWS,0,9,150,1.5,-145,8.5,100,-120,-160,-1.5,125,3.4,Guaranteed Rate Field,9,-9
2020-08-20,2020,CWS,DET,9,0,-160,-1.5,125,8.5,100,-120,150,1.5,-145,5.23,Guaranteed Rate Field,9,9
2020-08-20,2020,COL,HOU,8,10,-124,-1.5,145,11.5,-105,-115,114,1.5,-165,6.37,Coors Field,18,-2
2020-08-20,2020,SF,LAA,10,5,-125,-1.5,150,9.0,-110,-110,115,1.5,-170,5.0,AT&T Park,15,5
2020-08-20,2020,SEA,LAD,1,6,285,1.5,165,8.5,100,-120,-330,-1.5,-185,2.21,T-Mobile Park,7,-5
2020-08-20,2020,MIN,MIL,7,1,-105,-1.5,175,8.5,-110,-110,-105,1.5,-200,4.35,Target Field,8,6
2020-08-20,2020,MIL,MIN,1,7,-105,1.5,-200,8.5,-110,-110,-105,-1.5,175,4.35,Target Field,8,-6
2020-08-20,2020,TB,NYY,10,5,129,1.5,-155,9.0,-125,105,-139,-1.5,135,3.93,Yankee Stadium,15,5
2020-08-20,2020,ARI,OAK,1,5,148,1.5,-140,9.0,100,-120,-158,-1.5,120,3.63,Oakland Coliseum,6,-4
2020-08-20,2020,TOR,PHI,3,2,105,-1.5,200,8.5,-105,-115,-115,1.5,-230,4.15,Sahlen Field,5,1
2020-08-20,2020,TOR,PHI,9,8,103,-1.5,185,8.5,-105,-115,-113,1.5,-210,4.19,Sahlen Field,17,1
2020-08-20,2020,CLE,PIT,2,0,-280,-1.5,-175,7.5,-120,100,245,1.5,155,5.53,PNC Park,2,2
2020-08-20,2020,TEX,SD,7,8,180,1.5,-115,8.0,-120,100,-200,-1.5,-105,2.86,PETCO Park,15,-1
2020-08-20,2020,LAD,SEA,6,1,-330,-1.5,-185,8.5,100,-120,285,1.5,165,6.52,T-Mobile Park,7,5
2020-08-20,2020,LAA,SF,5,10,115,1.5,-170,9.0,-110,-110,-125,-1.5,150,4.19,AT&T Park,15,-5
2020-08-20,2020,CIN,STL,4,5,-130,-1.5,115,8.0,-120,100,120,1.5,-135,4.52,Busch Stadium,9,-1
2020-08-20,2020,NYY,TB,5,10,-139,-1.5,135,9.0,-125,105,129,1.5,-155,5.23,Yankee Stadium,15,-5
2020-08-20,2020,SD,TEX,8,7,-200,-1.5,-105,8.0,-120,100,180,1.5,-115,5.33,PETCO Park,15,1
2020-08-20,2020,PHI,TOR,2,3,-115,1.5,-230,8.5,-105,-115,105,-1.5,200,4.55,Sahlen Field,5,-1
2020-08-20,2020,PHI,TOR,8,9,-113,1.5,-210,8.5,-105,-115,103,-1.5,185,4.51,Sahlen Field,17,-1
2020-08-21,2020,SF,ARI,6,2,105,1.5,-155,9.5,-105,-115,-115,-1.5,135,4.63,AT&T Park,8,4
2020-08-21,2020,PHI,ATL,2,11,104,-1.5,180,8.0,100,-120,-114,1.5,-205,3.92,Suntrust Park,13,-9
2020-08-21,2020,BOS,BAL,8,5,-120,-1.5,130,10.0,100,-120,110,1.5,-150,5.45,Camden Yards,13,3
2020-08-21,2020,BAL,BOS,5,8,110,1.5,-150,10.0,100,-120,-120,-1.5,130,4.76,Camden Yards,13,-3
2020-08-21,2020,CWS,CHC,10,1,-109,-1.5,145,9.5,-105,-115,-101,1.5,-165,4.95,Wrigley Field,11,9
2020-08-21,2020,STL,CIN,2,4,-115,1.5,-180,9.0,-115,-105,105,-1.5,160,4.81,Busch Stadium,6,-2
2020-08-21,2020,DET,CLE,10,5,180,1.5,-110,9.5,-110,-110,-200,-1.5,-110,3.39,Progressive Field,15,5
2020-08-21,2020,LAD,COL,5,1,-230,-1.5,-115,9.5,100,-120,205,1.5,-105,6.62,Dodger Stadium,6,4
2020-08-21,2020,CHC,CWS,1,10,-101,1.5,-165,9.5,-105,-115,-109,-1.5,145,4.77,Wrigley Field,11,-9
2020-08-21,2020,CLE,DET,5,10,-200,-1.5,-110,9.5,-110,-110,180,1.5,-110,6.33,Progressive Field,15,-5
2020-08-21,2020,SD,HOU,4,3,-116,-1.5,165,9.0,100,-120,106,1.5,-185,4.83,PETCO Park,7,1
2020-08-21,2020,MIN,KC,2,7,-138,-1.5,110,9.0,100,-120,128,1.5,-130,5.22,Kauffman Stadium,9,-5
2020-08-21,2020,OAK,LAA,5,3,101,1.5,-170,9.5,-110,-110,-111,-1.5,150,4.73,Oakland Coliseum,8,2
2020-08-21,2020,COL,LAD,1,5,205,1.5,-105,9.5,100,-120,-230,-1.5,-115,3.11,Dodger Stadium,6,-4
2020-08-21,2020,WSH,MIA,2,3,-196,-1.5,-105,8.5,-120,100,178,1.5,-115,5.63,Nationals Park,5,-1
2020-08-21,2020,PIT,MIL,7,2,128,1.5,-125,8.5,-120,100,-138,-1.5,105,3.73,PNC Park,9,5
2020-08-21,2020,KC,MIN,7,2,128,1.5,-130,9.0,100,-120,-138,-1.5,110,3.95,Kauffman Stadium,9,5
2020-08-21,2020,LAA,OAK,3,5,-111,-1.5,150,9.5,-110,-110,101,1.5,-170,5.0,Oakland Coliseum,8,-2
2020-08-21,2020,ATL,PHI,11,2,-114,1.5,-205,8.0,100,-120,104,-1.5,180,4.26,Suntrust Park,13,9
2020-08-21,2020,MIL,PIT,2,7,-138,-1.5,105,8.5,-120,100,128,1.5,-125,4.93,PNC Park,9,-5
2020-08-21,2020,HOU,SD,3,4,106,1.5,-185,9.0,100,-120,-116,-1.5,165,4.37,PETCO Park,7,-1
2020-08-21,2020,TEX,SEA,4,7,-120,-1.5,130,8.5,-120,100,110,1.5,-150,4.64,T-Mobile Park,11,-3
2020-08-21,2020,ARI,SF,2,6,-115,-1.5,135,9.5,-105,-115,105,1.5,-155,5.08,AT&T Park,8,-4
2020-08-21,2020,CIN,STL,4,2,105,-1.5,160,9.0,-115,-105,-115,1.5,-180,4.39,Busch Stadium,6,2
2020-08-21,2020,TOR,TB,6,5,143,1.5,-145,8.5,-115,-105,-153,-1.5,125,3.5,Tropicana Field,11,1
2020-08-21,2020,SEA,TEX,7,4,110,1.5,-150,8.5,-120,100,-120,-1.5,130,4.05,T-Mobile Park,11,3
2020-08-21,2020,TB,TOR,5,6,-153,-1.5,125,8.5,-115,-105,143,1.5,-145,5.14,Tropicana Field,11,-1
2020-08-21,2020,MIA,WSH,3,2,178,1.5,-115,8.5,-120,100,-196,-1.5,-105,3.06,Nationals Park,5,1
2020-08-22,2020,SF,ARI,5,1,150,1.5,-115,8.5,-115,-105,-160,-1.5,-105,3.4,AT&T Park,6,4
2020-08-22,2020,PHI,ATL,5,6,-113,-1.5,135,9.0,-120,100,103,1.5,-155,4.77,Suntrust Park,11,-1
2020-08-22,2020,BOS,BAL,4,5,-113,-1.5,135,10.0,-110,-110,103,1.5,-155,5.31,Camden Yards,9,-1
2020-08-22,2020,BAL,BOS,5,4,103,1.5,-155,10.0,-110,-110,-113,-1.5,135,4.93,Camden Yards,9,1
2020-08-22,2020,CWS,CHC,7,4,165,1.5,-105,10.5,-110,-110,-180,-1.5,-115,3.96,Wrigley Field,11,3
2020-08-22,2020,STL,CIN,3,0,-136,-1.5,140,9.5,100,-120,126,1.5,-160,5.47,Busch Stadium,3,3
2020-08-22,2020,DET,CLE,1,6,155,1.5,-135,9.5,100,-120,-165,-1.5,115,3.73,Progressive Field,7,-5
2020-08-22,2020,LAD,COL,4,3,-220,-1.5,-110,8.5,-110,-110,200,1.5,-110,5.84,Dodger Stadium,7,1
2020-08-22,2020,CHC,CWS,4,7,-180,-1.5,-115,10.5,-110,-110,165,1.5,-105,6.75,Wrigley Field,11,-3
2020-08-22,2020,CLE,DET,6,1,-165,-1.5,115,9.5,100,-120,155,1.5,-135,5.92,Progressive Field,7,5
2020-08-22,2020,SD,HOU,13,2,-120,-1.5,160,9.5,-120,100,110,1.5,-180,5.18,PETCO Park,15,11
2020-08-22,2020,MIN,KC,7,2,-148,-1.5,-105,9.5,-115,-105,138,1.5,-115,5.67,Kauffman Stadium,9,5
2020-08-22,2020,OAK,LAA,3,4,-147,-1.5,135,9.5,-115,-105,137,1.5,-155,5.65,Oakland Coliseum,7,-1
2020-08-22,2020,COL,LAD,3,4,200,1.5,-110,8.5,-110,-110,-220,-1.5,-110,2.83,Dodger Stadium,7,-1
2020-08-22,2020,WSH,MIA,5,4,-260,-1.5,-110,6.5,-115,-105,230,1.5,-110,4.69,Nationals Park,9,1
2020-08-22,2020,WSH,MIA,3,5,-130,-1.5,135,7.5,100,-120,120,1.5,-155,4.24,Nationals Park,8,-2
2020-08-22,2020,PIT,MIL,12,5,150,1.5,-115,9.5,-105,-115,-160,-1.5,-105,3.8,PNC Park,17,7
2020-08-22,2020,KC,MIN,2,7,138,1.5,-115,9.5,-115,-105,-148,-1.5,-105,3.99,Kauffman Stadium,9,-5
2020-08-22,2020,LAA,OAK,4,3,137,1.5,-155,9.5,-115,-105,-147,-1.5,135,4.01,Oakland Coliseum,7,1
2020-08-22,2020,ATL,PHI,6,5,103,1.5,-155,9.0,-120,100,-113,-1.5,135,4.43,Suntrust Park,11,1
2020-08-22,2020,MIL,PIT,5,12,-160,-1.5,-105,9.5,-105,-115,150,1.5,-115,5.85,PNC Park,17,-7
2020-08-22,2020,HOU,SD,2,13,110,1.5,-180,9.5,-120,100,-120,-1.5,160,4.52,PETCO Park,15,-11
2020-08-22,2020,TEX,SEA,1,10,127,1.5,-155,8.5,-120,100,-137,-1.5,135,3.74,T-Mobile Park,11,-9
2020-08-22,2020,ARI,SF,1,5,-160,-1.5,-105,8.5,-115,-105,150,1.5,-115,5.23,AT&T Park,6,-4
2020-08-22,2020,CIN,STL,0,3,126,1.5,-160,9.5,100,-120,-136,-1.5,140,4.2,Busch Stadium,3,-3
2020-08-22,2020,TOR,TB,1,2,-115,-1.5,135,8.5,-120,100,105,1.5,-155,4.55,Tropicana Field,3,-1
2020-08-22,2020,SEA,TEX,10,1,-137,-1.5,135,8.5,-120,100,127,1.5,-155,4.91,T-Mobile Park,11,9
2020-08-22,2020,TB,TOR,2,1,105,1.5,-155,8.5,-120,100,-115,-1.5,135,4.15,Tropicana Field,3,1
2020-08-22,2020,MIA,WSH,4,5,230,1.5,-110,6.5,-115,-105,-260,-1.5,-110,1.97,Nationals Park,9,-1
2020-08-22,2020,MIA,WSH,5,3,120,1.5,-155,7.5,100,-120,-130,-1.5,135,3.41,Nationals Park,8,2
2020-08-23,2020,SF,ARI,6,1,108,1.5,-155,9.0,-110,-110,-118,-1.5,135,4.33,AT&T Park,7,5
2020-08-23,2020,PHI,ATL,5,4,100,1.5,-200,9.5,-115,-105,-110,-1.5,175,4.75,Suntrust Park,9,1
2020-08-23,2020,BOS,BAL,4,5,-122,-1.5,125,10.5,-115,-105,112,1.5,-145,5.77,Camden Yards,9,-1
2020-08-23,2020,BAL,BOS,5,4,112,1.5,-145,10.5,-115,-105,-122,-1.5,125,4.95,Camden Yards,9,1
2020-08-23,2020,CWS,CHC,1,2,163,1.5,-120,10.0,-110,-110,-176,-1.5,100,3.8,Wrigley Field,3,-1
2020-08-23,2020,STL,CIN,6,2,-115,1.5,-180,9.0,-120,100,105,-1.5,160,4.81,Busch Stadium,8,4
2020-08-23,2020,DET,CLE,7,4,230,1.5,115,8.5,-115,-105,-260,-1.5,-135,2.58,Progressive Field,11,3
2020-08-23,2020,LAD,COL,11,3,-250,-1.5,-120,9.0,-105,-115,220,1.5,100,6.43,Dodger Stadium,14,8
2020-08-23,2020,CHC,CWS,2,1,-176,-1.5,100,10.0,-110,-110,163,1.5,-120,6.38,Wrigley Field,3,1
2020-08-23,2020,CLE,DET,4,7,-260,-1.5,-135,8.5,-115,-105,230,1.5,115,6.14,Progressive Field,11,-3
2020-08-23,2020,SD,HOU,5,3,108,1.5,-160,8.5,-115,-105,-118,-1.5,140,4.09,PETCO Park,8,2
2020-08-23,2020,MIN,KC,5,4,-140,-1.5,100,10.0,-105,-115,130,1.5,-120,5.83,Kauffman Stadium,9,1
2020-08-23,2020,OAK,LAA,5,4,-140,-1.5,145,8.5,-115,-105,130,1.5,-165,4.96,Oakland Coliseum,9,1
2020-08-23,2020,COL,LAD,3,11,220,1.5,100,9.0,-105,-115,-250,-1.5,-120,2.81,Dodger Stadium,14,-8
2020-08-23,2020,WSH,MIA,9,3,-148,-1.5,130,10.5,-115,-105,138,1.5,-150,6.27,Nationals Park,12,6
2020-08-23,2020,PIT,MIL,5,4,165,1.5,100,9.0,-115,-105,-180,-1.5,-120,3.4,PNC Park,9,1
2020-08-23,2020,KC,MIN,4,5,130,1.5,-120,10.0,-105,-115,-140,-1.5,100,4.35,Kauffman Stadium,9,-1
2020-08-23,2020,LAA,OAK,4,5,130,1.5,-165,8.5,-115,-105,-140,-1.5,145,3.7,Oakland Coliseum,9,-1
2020-08-23,2020,ATL,PHI,4,5,-110,-1.5,175,9.5,-115,-105,100,1.5,-200,4.98,Suntrust Park,9,-1
2020-08-23,2020,MIL,PIT,4,5,-180,-1.5,-120,9.0,-115,-105,165,1.5,100,5.79,PNC Park,9,-1
2020-08-23,2020,HOU,SD,3,5,-118,-1.5,140,8.5,-115,-105,108,1.5,-160,4.6,PETCO Park,8,-2
2020-08-23,2020,TEX,SEA,1,4,-125,-1.5,125,9.0,100,-120,115,1.5,-145,5.0,T-Mobile Park,5,-3
2020-08-23,2020,ARI,SF,1,6,-118,-1.5,135,9.0,-110,-110,108,1.5,-155,4.87,AT&T Park,7,-5
2020-08-23,2020,CIN,STL,2,6,105,-1.5,160,9.0,-120,100,-115,1.5,-180,4.39,Busch Stadium,8,-4
2020-08-23,2020,TOR,TB,4,5,132,1.5,-155,9.0,100,-120,-142,-1.5,135,3.88,Tropicana Field,9,-1
2020-08-23,2020,SEA,TEX,4,1,115,1.5,-145,9.0,100,-120,-125,-1.5,125,4.19,T-Mobile Park,5,3
2020-08-23,2020,TB,TOR,5,4,-142,-1.5,135,9.0,100,-120,132,1.5,-155,5.28,Tropicana Field,9,1
2020-08-23,2020,MIA,WSH,3,9,138,1.5,-150,10.5,-115,-105,-148,-1.5,130,4.41,Nationals Park,12,-6
2020-08-24,2020,COL,ARI,3,2,130,1.5,-150,10.0,-120,100,-140,-1.5,130,4.35,Chase Field,5,1
2020-08-24,2020,DET,CHC,3,9,112,1.5,-140,9.5,-115,-105,-122,-1.5,120,4.48,Comerica Park,12,-6
2020-08-24,2020,MIL,CIN,4,2,137,1.5,-130,8.5,-110,-110,-147,-1.5,110,3.59,Miller Park,6,2
2020-08-24,2020,MIN,CLE,3,2,-123,-1.5,130,8.5,-115,-105,113,1.5,-150,4.69,Progressive Field,5,1
2020-08-24,2020,ARI,COL,2,3,-140,-1.5,130,10.0,-120,100,130,1.5,-150,5.83,Chase Field,5,-1
2020-08-24,2020,CHC,DET,9,3,-122,-1.5,120,9.5,-115,-105,112,1.5,-140,5.22,Comerica Park,12,6
2020-08-24,2020,LAA,HOU,4,11,150,1.5,-130,9.5,100,-120,-160,-1.5,110,3.8,Minute Maid Park,15,-7
2020-08-24,2020,STL,KC,9,3,-174,-1.5,115,8.0,-105,-115,162,1.5,-135,5.08,Busch Stadium,12,6
2020-08-24,2020,HOU,LAA,11,4,-160,-1.5,110,9.5,100,-120,150,1.5,-130,5.85,Minute Maid Park,15,7
2020-08-24,2020,WSH,MIA,8,11,-112,-1.5,165,9.0,-110,-110,102,1.5,-185,4.75,Nationals Park,19,-3
2020-08-24,2020,CIN,MIL,2,4,-147,-1.5,110,8.5,-110,-110,137,1.5,-130,5.06,Miller Park,6,-2
2020-08-24,2020,CLE,MIN,2,3,113,1.5,-150,8.5,-115,-105,-123,-1.5,130,3.99,Progressive Field,5,-1
2020-08-24,2020,TEX,OAK,3,2,135,1.5,-135,7.5,100,-120,-145,-1.5,115,3.19,Globe Life Field,5,1
2020-08-24,2020,KC,STL,3,9,162,1.5,-135,8.0,-105,-115,-174,-1.5,115,3.05,Busch Stadium,12,-6
2020-08-24,2020,TOR,TB,6,4,200,1.5,-110,8.0,-120,100,-220,-1.5,-110,2.67,Tropicana Field,10,2
2020-08-24,2020,OAK,TEX,2,3,-145,-1.5,115,7.5,100,-120,135,1.5,-135,4.44,Globe Life Field,5,-1
2020-08-24,2020,TB,TOR,4,6,-220,-1.5,-110,8.0,-120,100,200,1.5,-110,5.5,Tropicana Field,10,-2
2020-08-24,2020,MIA,WSH,11,8,102,1.5,-185,9.0,-110,-110,-112,-1.5,165,4.46,Nationals Park,19,3
2020-08-25,2020,COL,ARI,5,4,-111,1.5,-215,9.5,100,-120,101,-1.5,190,5.0,Chase Field,9,1
2020-08-25,2020,TB,BAL,4,2,-210,-1.5,-105,8.0,100,-120,190,1.5,-115,5.42,Tropicana Field,6,2
2020-08-25,2020,TOR,BOS,7,9,-118,-1.5,140,11.5,-115,-105,108,1.5,-160,6.22,Sahlen Field,16,-2
2020-08-25,2020,DET,CHC,7,1,126,1.5,-130,9.5,-105,-115,-136,-1.5,110,4.2,Comerica Park,8,6
2020-08-25,2020,MIL,CIN,3,2,-113,-1.5,175,8.0,-115,-105,103,1.5,-200,4.24,Miller Park,5,1
2020-08-25,2020,MIN,CLE,2,4,160,1.5,-140,8.0,100,-120,-170,-1.5,120,3.08,Progressive Field,6,-2
2020-08-25,2020,ARI,COL,4,5,101,-1.5,190,9.5,100,-120,-111,1.5,-215,4.73,Chase Field,9,-1
2020-08-25,2020,PIT,CWS,0,4,220,1.5,110,8.5,-120,100,-250,-1.5,-130,2.66,Guaranteed Rate Field,4,-4
2020-08-25,2020,CHC,DET,1,7,-136,-1.5,110,9.5,-105,-115,126,1.5,-130,5.47,Comerica Park,8,-6
2020-08-25,2020,LAA,HOU,3,6,132,1.5,-155,7.5,-120,100,-142,-1.5,135,3.23,Minute Maid Park,9,-3
2020-08-25,2020,LAA,HOU,12,5,130,1.5,-160,8.0,-120,100,-140,-1.5,140,3.48,Minute Maid Park,17,7
2020-08-25,2020,STL,KC,4,5,-188,-1.5,-105,9.0,-115,-105,173,1.5,-115,5.88,Busch Stadium,9,-1
2020-08-25,2020,HOU,LAA,6,3,-142,-1.5,135,7.5,-120,100,132,1.5,-155,4.4,Minute Maid Park,9,3
2020-08-25,2020,HOU,LAA,5,12,-140,-1.5,140,8.0,-120,100,130,1.5,-160,4.67,Minute Maid Park,17,-7
2020-08-25,2020,SF,LAD,10,8,185,1.5,110,9.0,-105,-115,-205,-1.5,-130,3.16,AT&T Park,18,2
2020-08-25,2020,NYM,MIA,0,4,-190,-1.5,110,7.5,-120,100,175,1.5,-130,4.91,Citi Field,4,-4
2020-08-25,2020,NYM,MIA,0,3,-190,-1.5,-105,7.5,-105,-115,175,1.5,-115,4.91,Citi Field,3,-3
2020-08-25,2020,CIN,MIL,2,3,103,1.5,-200,8.0,-115,-105,-113,-1.5,175,3.94,Miller Park,5,-1
2020-08-25,2020,CLE,MIN,4,2,-170,-1.5,120,8.0,100,-120,160,1.5,-140,5.04,Progressive Field,6,2
2020-08-25,2020,MIA,NYM,4,0,175,1.5,-130,7.5,-120,100,-190,-1.5,110,2.73,Citi Field,4,4
2020-08-25,2020,MIA,NYM,3,0,175,1.5,-115,7.5,-105,-115,-190,-1.5,-105,2.73,Citi Field,3,3
2020-08-25,2020,TEX,OAK,3,10,145,1.5,-110,8.5,-115,-105,-155,-1.5,-110,3.47,Globe Life Field,13,-7
2020-08-25,2020,WSH,PHI,3,8,112,1.5,-140,11.0,-105,-115,-122,-1.5,120,5.19,Nationals Park,11,-5
2020-08-25,2020,CWS,PIT,4,0,-250,-1.5,-130,8.5,-120,100,220,1.5,110,6.07,Guaranteed Rate Field,4,4
2020-08-25,2020,SEA,SD,8,3,180,1.5,-120,8.0,-115,-105,-200,-1.5,100,2.86,PETCO Park,11,5
2020-08-25,2020,SD,SEA,3,8,-200,-1.5,100,8.0,-115,-105,180,1.5,-120,5.33,PETCO Park,11,-5
2020-08-25,2020,LAD,SF,8,10,-205,-1.5,-130,9.0,-105,-115,185,1.5,110,6.05,AT&T Park,18,-2
2020-08-25,2020,KC,STL,5,4,173,1.5,-115,9.0,-115,-105,-188,-1.5,-105,3.3,Busch Stadium,9,1
2020-08-25,2020,BAL,TB,2,4,190,1.5,-115,8.0,100,-120,-210,-1.5,-105,2.76,Tropicana Field,6,-2
2020-08-25,2020,OAK,TEX,10,3,-155,-1.5,-110,8.5,-115,-105,145,1.5,-110,5.17,Globe Life Field,13,7
2020-08-25,2020,BOS,TOR,9,7,108,1.5,-160,11.5,-115,-105,-118,-1.5,140,5.53,Sahlen Field,16,2
2020-08-25,2020,PHI,WSH,8,3,-122,-1.5,120,11.0,-105,-115,112,1.5,-140,6.05,Nationals Park,11,5
2020-08-26,2020,COL,ARI,8,7,120,1.5,-165,10.5,-105,-115,-130,-1.5,145,4.77,Chase Field,15,1
2020-08-26,2020,NYY,ATL,1,5,-169,-1.5,110,6.5,100,-120,159,1.5,-130,4.08,Suntrust Park,6,-4
2020-08-26,2020,NYY,ATL,1,2,122,1.5,-190,6.5,105,-125,-132,-1.5,170,2.93,Suntrust Park,3,-1
2020-08-26,2020,TB,BAL,4,3,-163,-1.5,110,8.5,-120,100,153,1.5,-130,5.27,Tropicana Field,7,1
2020-08-26,2020,TOR,BOS,9,1,-118,-1.5,144,11.5,-110,-110,108,1.5,-164,6.22,Sahlen Field,10,8
2020-08-26,2020,DET,CHC,7,6,130,1.5,-115,10.0,-130,110,-140,-1.5,-105,4.35,Comerica Park,13,1
2020-08-26,2020,MIN,CLE,3,6,-105,1.5,-205,9.0,-105,-115,-105,-1.5,180,4.61,Progressive Field,9,-3
2020-08-26,2020,ARI,COL,7,8,-130,-1.5,145,10.5,-105,-115,120,1.5,-165,5.93,Chase Field,15,-1
2020-08-26,2020,PIT,CWS,3,10,195,1.5,-105,9.0,-105,-115,-215,-1.5,-115,3.05,Guaranteed Rate Field,13,-7
2020-08-26,2020,CHC,DET,6,7,-140,-1.5,-105,10.0,-130,110,130,1.5,-115,5.83,Comerica Park,13,-1
2020-08-26,2020,STL,KC,6,5,-165,-1.5,110,9.0,-120,100,155,1.5,-130,5.6,Busch Stadium,11,1
2020-08-26,2020,NYM,MIA,5,4,-270,-1.5,-120,7.5,-115,-105,240,1.5,100,5.47,Citi Field,9,1
2020-08-26,2020,CLE,MIN,6,3,-105,-1.5,180,9.0,-105,-115,-105,1.5,-205,4.61,Progressive Field,9,3
2020-08-26,2020,MIA,NYM,4,5,240,1.5,100,7.5,-115,-105,-270,-1.5,-120,2.21,Citi Field,9,-1
2020-08-26,2020,ATL,NYY,5,1,159,1.5,-130,6.5,100,-120,-169,-1.5,110,2.51,Suntrust Park,6,4
2020-08-26,2020,ATL,NYY,2,1,-132,-1.5,170,6.5,105,-125,122,1.5,-190,3.7,Suntrust Park,3,1
2020-08-26,2020,TEX,OAK,1,3,123,1.5,-120,10.0,-110,-110,-133,-1.5,100,4.48,Globe Life Field,4,-2
2020-08-26,2020,WSH,PHI,2,3,114,1.5,-155,8.5,-115,-105,-124,-1.5,135,3.97,Nationals Park,5,-1
2020-08-26,2020,CWS,PIT,10,3,-215,-1.5,-115,9.0,-105,-115,195,1.5,-105,6.14,Guaranteed Rate Field,13,7
2020-08-26,2020,KC,STL,5,6,155,1.5,-130,9.0,-120,100,-165,-1.5,110,3.53,Busch Stadium,11,-1
2020-08-26,2020,BAL,TB,3,4,153,1.5,-130,8.5,-120,100,-163,-1.5,110,3.36,Tropicana Field,7,-1
2020-08-26,2020,OAK,TEX,3,1,-133,-1.5,100,10.0,-110,-110,123,1.5,-120,5.71,Globe Life Field,4,2
2020-08-26,2020,BOS,TOR,1,9,108,1.5,-164,11.5,-110,-110,-118,-1.5,144,5.53,Sahlen Field,10,-8
2020-08-26,2020,PHI,WSH,3,2,-124,-1.5,135,8.5,-115,-105,114,1.5,-155,4.71,Nationals Park,5,1
2020-08-27,2020,MIL,CIN,1,6,115,1.5,-165,6.5,105,-125,-125,-1.5,145,3.02,Miller Park,7,-5
2020-08-27,2020,MIL,CIN,0,6,-162,-1.5,130,7.0,-120,100,152,1.5,-150,4.33,Miller Park,6,-6
2020-08-27,2020,SF,LAD,0,7,215,1.5,120,6.5,100,-120,-245,-1.5,-140,2.06,AT&T Park,7,-7
2020-08-27,2020,SF,LAD,0,2,148,1.5,-130,6.5,-120,100,-158,-1.5,110,2.62,AT&T Park,2,-2
2020-08-27,2020,CIN,MIL,6,1,-125,-1.5,145,6.5,105,-125,115,1.5,-165,3.61,Miller Park,7,5
2020-08-27,2020,CIN,MIL,6,0,152,1.5,-150,7.0,-120,100,-162,-1.5,130,2.78,Miller Park,6,6
2020-08-27,2020,STL,PIT,3,4,-154,-1.5,145,6.5,-120,100,144,1.5,-165,3.94,Busch Stadium,7,-1
2020-08-27,2020,STL,PIT,0,2,-170,-1.5,125,7.0,-130,110,160,1.5,-145,4.41,Busch Stadium,2,-2
2020-08-27,2020,SEA,SD,7,10,225,1.5,-110,6.0,-120,100,-255,-1.5,-110,1.85,PETCO Park,17,-3
2020-08-27,2020,SEA,SD,8,3,175,1.5,-140,6.5,-115,-105,-190,-1.5,120,2.36,PETCO Park,11,5
2020-08-27,2020,SD,SEA,10,7,-255,-1.5,-110,6.0,-120,100,225,1.5,-110,4.31,PETCO Park,17,3
2020-08-27,2020,SD,SEA,3,8,-190,-1.5,120,6.5,-115,-105,175,1.5,-140,4.26,PETCO Park,11,-5
2020-08-27,2020,LAD,SF,7,0,-245,-1.5,-140,6.5,100,-120,215,1.5,120,4.62,AT&T Park,7,7
2020-08-27,2020,LAD,SF,2,0,-158,-1.5,110,6.5,-120,100,148,1.5,-130,3.98,AT&T Park,2,2
2020-08-27,2020,PIT,STL,4,3,144,1.5,-165,6.5,-120,100,-154,-1.5,145,2.66,Busch Stadium,7,1
2020-08-27,2020,PIT,STL,2,0,160,1.5,-145,7.0,-130,110,-170,-1.5,125,2.69,Busch Stadium,2,2
2020-08-28,2020,SF,ARI,4,7,173,1.5,-125,9.0,-110,-110,-188,-1.5,105,3.3,Chase Field,11,-3
2020-08-28,2020,PHI,ATL,7,4,-140,-1.5,140,9.5,-105,-115,130,1.5,-160,5.54,Citizens Bank Park,11,3
2020-08-28,2020,TOR,BAL,5,4,-205,-1.5,-110,9.5,105,-125,185,1.5,-110,6.39,Sahlen Field,9,1
2020-08-28,2020,WSH,BOS,10,2,-152,-1.5,-110,9.0,-115,-105,142,1.5,-110,5.43,Fenway Park,12,8
2020-08-28,2020,CIN,CHC,6,5,134,1.5,-125,9.0,-115,-105,-144,-1.5,105,3.85,Great American Ballpark,11,1
2020-08-28,2020,CHC,CIN,5,6,-144,-1.5,105,9.0,-115,-105,134,1.5,-125,5.31,Great American Ballpark,11,-1
2020-08-28,2020,STL,CLE,2,14,120,1.5,-140,8.5,-110,-110,-130,-1.5,120,3.86,Busch Stadium,16,-12
2020-08-28,2020,SD,COL,10,4,100,-1.5,135,11.5,-105,-115,-110,1.5,-155,5.75,Coors Field,14,6
2020-08-28,2020,KC,CWS,5,6,130,1.5,-150,10.0,-105,-115,-140,-1.5,130,4.35,Guaranteed Rate Field,11,-1
2020-08-28,2020,CWS,KC,6,5,-140,-1.5,130,10.0,-105,-115,130,1.5,-150,5.83,Guaranteed Rate Field,11,1
2020-08-28,2020,SEA,LAA,2,3,185,1.5,-110,9.0,-120,100,-205,-1.5,-110,3.16,Angel Stadium,5,-1
2020-08-28,2020,TEX,LAD,6,2,200,1.5,130,9.0,-105,-115,-220,-1.5,-150,3.0,Globe Life Field,8,4
2020-08-28,2020,TB,MIA,2,0,-128,-1.5,130,8.0,-120,100,118,1.5,-150,4.49,Marlins Park,2,2
2020-08-28,2020,PIT,MIL,1,9,190,1.5,-115,9.0,-110,-110,-210,-1.5,-105,3.1,Miller Park,10,-8
2020-08-28,2020,NYY,NYM,4,6,-130,-1.5,155,8.0,100,-120,120,1.5,-175,4.52,Yankee Stadium,10,-2
2020-08-28,2020,NYY,NYM,3,4,-130,-1.5,140,7.5,-110,-110,120,1.5,-160,4.24,Yankee Stadium,7,-1
2020-08-28,2020,NYM,NYY,6,4,120,1.5,-175,8.0,100,-120,-130,-1.5,155,3.64,Yankee Stadium,10,2
2020-08-28,2020,NYM,NYY,4,3,120,1.5,-160,7.5,-110,-110,-130,-1.5,140,3.41,Yankee Stadium,7,1
2020-08-28,2020,ATL,PHI,4,7,130,1.5,-160,9.5,-105,-115,-140,-1.5,140,4.13,Citizens Bank Park,11,-3
2020-08-28,2020,MIL,PIT,9,1,-210,-1.5,-105,9.0,-110,-110,190,1.5,-115,6.1,Miller Park,10,8
2020-08-28,2020,COL,SD,4,10,-110,1.5,-155,11.5,-105,-115,100,-1.5,135,6.02,Coors Field,14,-6
2020-08-28,2020,LAA,SEA,3,2,-205,-1.5,-110,9.0,-120,100,185,1.5,-110,6.05,Angel Stadium,5,1
2020-08-28,2020,ARI,SF,7,4,-188,-1.5,105,9.0,-110,-110,173,1.5,-125,5.88,Chase Field,11,3
2020-08-28,2020,CLE,STL,14,2,-130,-1.5,120,8.5,-110,-110,120,1.5,-140,4.8,Busch Stadium,16,12
2020-08-28,2020,MIA,TB,0,2,118,1.5,-150,8.0,-120,100,-128,-1.5,130,3.67,Marlins Park,2,-2
2020-08-28,2020,LAD,TEX,2,6,-220,-1.5,-150,9.0,-105,-115,200,1.5,130,6.19,Globe Life Field,8,-4
2020-08-28,2020,BAL,TOR,4,5,185,1.5,-110,9.5,105,-125,-205,-1.5,-110,3.33,Sahlen Field,9,-1
2020-08-28,2020,BOS,WSH,2,10,142,1.5,-110,9.0,-115,-105,-152,-1.5,-110,3.72,Fenway Park,12,-8
2020-08-29,2020,SF,ARI,5,2,146,1.5,-150,9.5,-120,100,-156,-1.5,130,3.86,Chase Field,7,3
2020-08-29,2020,PHI,ATL,4,1,-119,-1.5,160,10.5,-105,-115,109,1.5,-180,5.71,Citizens Bank Park,5,3
2020-08-29,2020,TOR,BAL,5,0,-150,-1.5,120,10.0,-105,-115,140,1.5,-140,6.0,Sahlen Field,5,5
2020-08-29,2020,WSH,BOS,3,5,-112,-1.5,120,11.5,100,-120,102,1.5,-140,6.08,Fenway Park,8,-2
2020-08-29,2020,CIN,CHC,0,3,-101,-1.5,220,6.0,100,-120,-109,1.5,-250,3.01,Great American Ballpark,3,-3
2020-08-29,2020,CIN,CHC,6,5,-118,-1.5,185,7.5,-105,-115,108,1.5,-210,4.06,Great American Ballpark,11,1
2020-08-29,2020,CHC,CIN,3,0,-109,1.5,-250,6.0,100,-120,-101,-1.5,220,3.13,Great American Ballpark,3,3
2020-08-29,2020,CHC,CIN,5,6,108,1.5,-210,7.5,-105,-115,-118,-1.5,185,3.61,Great American Ballpark,11,-1
2020-08-29,2020,STL,CLE,1,2,-133,-1.5,160,7.5,100,-120,123,1.5,-180,4.28,Busch Stadium,3,-1
2020-08-29,2020,SD,COL,3,4,-110,-1.5,130,13.0,-105,-115,100,1.5,-150,6.81,Coors Field,7,-1
2020-08-29,2020,KC,CWS,9,6,146,1.5,-140,10.0,-115,-105,-156,-1.5,120,4.07,Guaranteed Rate Field,15,3
2020-08-29,2020,MIN,DET,2,8,-148,-1.5,125,7.0,105,-125,138,1.5,-145,4.18,Comerica Park,10,-6
2020-08-29,2020,MIN,DET,2,4,-149,-1.5,115,7.0,-115,-105,139,1.5,-135,4.19,Comerica Park,6,-2
2020-08-29,2020,OAK,HOU,2,4,100,1.5,-205,7.0,100,-120,-110,-1.5,180,3.5,Minute Maid Park,6,-2
2020-08-29,2020,OAK,HOU,3,6,119,1.5,-180,6.5,100,-120,-129,-1.5,160,2.97,Minute Maid Park,9,-3
2020-08-29,2020,CWS,KC,6,9,-156,-1.5,120,10.0,-115,-105,146,1.5,-140,6.09,Guaranteed Rate Field,15,-3
2020-08-29,2020,SEA,LAA,3,16,170,1.5,-120,9.0,-110,-110,-185,-1.5,100,3.33,Angel Stadium,19,-13
2020-08-29,2020,TEX,LAD,4,7,145,1.5,-120,8.5,-120,100,-155,-1.5,100,3.47,Globe Life Field,11,-3
2020-08-29,2020,TB,MIA,4,0,104,-1.5,155,8.0,-115,-105,-114,1.5,-175,3.92,Marlins Park,4,4
2020-08-29,2020,PIT,MIL,6,7,175,1.5,-120,9.0,-110,-110,-190,-1.5,100,3.27,Miller Park,13,-1
2020-08-29,2020,DET,MIN,8,2,138,1.5,-145,7.0,105,-125,-148,-1.5,125,2.94,Comerica Park,10,6
2020-08-29,2020,DET,MIN,4,2,139,1.5,-135,7.0,-115,-105,-149,-1.5,115,2.93,Comerica Park,6,2
2020-08-29,2020,NYY,NYM,2,1,-105,-1.5,170,10.0,-115,-105,-105,1.5,-190,5.12,Yankee Stadium,3,1
2020-08-29,2020,NYM,NYY,1,2,-105,1.5,-190,10.0,-115,-105,-105,-1.5,170,5.12,Yankee Stadium,3,-1
2020-08-29,2020,HOU,OAK,4,2,-110,-1.5,180,7.0,100,-120,100,1.5,-205,3.67,Minute Maid Park,6,2
2020-08-29,2020,HOU,OAK,6,3,-129,-1.5,160,6.5,100,-120,119,1.5,-180,3.66,Minute Maid Park,9,3
2020-08-29,2020,ATL,PHI,1,4,109,1.5,-180,10.5,-105,-115,-119,-1.5,160,5.02,Citizens Bank Park,5,-3
2020-08-29,2020,MIL,PIT,7,6,-190,-1.5,100,9.0,-110,-110,175,1.5,-120,5.9,Miller Park,13,1
2020-08-29,2020,COL,SD,4,3,100,1.5,-150,13.0,-105,-115,-110,-1.5,130,6.5,Coors Field,7,1
2020-08-29,2020,LAA,SEA,16,3,-185,-1.5,100,9.0,-110,-110,170,1.5,-120,5.84,Angel Stadium,19,13
2020-08-29,2020,ARI,SF,2,5,-156,-1.5,130,9.5,-120,100,146,1.5,-150,5.79,Chase Field,7,-3
2020-08-29,2020,CLE,STL,2,1,123,1.5,-180,7.5,100,-120,-133,-1.5,160,3.36,Busch Stadium,3,1
2020-08-29,2020,MIA,TB,0,4,-114,1.5,-175,8.0,-115,-105,104,-1.5,155,4.26,Marlins Park,4,-4
2020-08-29,2020,LAD,TEX,7,4,-155,-1.5,100,8.5,-120,100,145,1.5,-120,5.17,Globe Life Field,11,3
2020-08-29,2020,BAL,TOR,0,5,140,1.5,-140,10.0,-105,-115,-150,-1.5,120,4.17,Sahlen Field,5,-5
2020-08-29,2020,BOS,WSH,5,3,102,1.5,-140,11.5,100,-120,-112,-1.5,120,5.69,Fenway Park,8,2
2020-08-30,2020,SF,ARI,4,1,110,1.5,-175,9.5,100,-120,-120,-1.5,155,4.52,Chase Field,5,3
2020-08-30,2020,PHI,ATL,10,12,104,-1.5,200,9.0,-120,100,-114,1.5,-230,4.41,Citizens Bank Park,22,-2
2020-08-30,2020,TOR,BAL,6,5,-145,-1.5,115,10.0,-115,-105,135,1.5,-135,5.92,Sahlen Field,11,1
2020-08-30,2020,WSH,BOS,5,9,102,-1.5,140,11.0,-120,100,-112,1.5,-160,5.45,Fenway Park,14,-4
2020-08-30,2020,CIN,CHC,1,10,-162,-1.5,120,9.0,-105,-115,152,1.5,-140,5.56,Great American Ballpark,11,-9
2020-08-30,2020,CHC,CIN,10,1,152,1.5,-140,9.0,-105,-115,-162,-1.5,120,3.57,Great American Ballpark,11,9
2020-08-30,2020,STL,CLE,7,2,110,1.5,-155,8.0,-105,-115,-120,-1.5,135,3.81,Busch Stadium,9,5
2020-08-30,2020,SD,COL,13,2,-165,-1.5,-115,13.0,-115,-105,155,1.5,-105,8.09,Coors Field,15,11
2020-08-30,2020,KC,CWS,2,5,161,1.5,-130,9.5,-105,-115,-172,-1.5,110,3.64,Guaranteed Rate Field,7,-3
2020-08-30,2020,MIN,DET,2,3,-210,-1.5,-135,8.5,-110,-110,190,1.5,115,5.76,Comerica Park,5,-1
2020-08-30,2020,CWS,KC,5,2,-172,-1.5,110,9.5,-105,-115,161,1.5,-130,6.01,Guaranteed Rate Field,7,3
2020-08-30,2020,SEA,LAA,2,1,180,1.5,-110,10.0,-110,-110,-200,-1.5,-110,3.57,Angel Stadium,3,1
2020-08-30,2020,TEX,LAD,2,7,200,1.5,120,9.0,-120,100,-220,-1.5,-140,3.0,Globe Life Field,9,-5
2020-08-30,2020,TB,MIA,12,7,-170,-1.5,100,7.0,-110,-110,160,1.5,-120,4.41,Marlins Park,19,5
2020-08-30,2020,PIT,MIL,5,1,240,1.5,105,8.0,-115,-105,-270,-1.5,-125,2.35,Miller Park,6,4
2020-08-30,2020,DET,MIN,3,2,190,1.5,115,8.5,-110,-110,-210,-1.5,-135,2.93,Comerica Park,5,1
2020-08-30,2020,NYY,NYM,8,7,101,1.5,-180,8.0,-110,-110,-111,-1.5,160,3.98,Yankee Stadium,15,1
2020-08-30,2020,NYY,NYM,5,2,135,1.5,-175,7.0,-125,105,-145,-1.5,155,2.98,Yankee Stadium,7,3
2020-08-30,2020,NYM,NYY,7,8,-111,-1.5,160,8.0,-110,-110,101,1.5,-180,4.21,Yankee Stadium,15,-1
2020-08-30,2020,NYM,NYY,2,5,-145,-1.5,155,7.0,-125,105,135,1.5,-175,4.14,Yankee Stadium,7,-3
2020-08-30,2020,ATL,PHI,12,10,-114,1.5,-230,9.0,-120,100,104,-1.5,200,4.79,Citizens Bank Park,22,2
2020-08-30,2020,MIL,PIT,1,5,-270,-1.5,-125,8.0,-115,-105,240,1.5,105,5.84,Miller Park,6,-4
2020-08-30,2020,COL,SD,2,13,155,1.5,-105,13.0,-115,-105,-165,-1.5,-115,5.1,Coors Field,15,-11
2020-08-30,2020,LAA,SEA,1,2,-200,-1.5,-110,10.0,-110,-110,180,1.5,-110,6.67,Angel Stadium,3,-1
2020-08-30,2020,ARI,SF,1,4,-120,-1.5,155,9.5,100,-120,110,1.5,-175,5.18,Chase Field,5,-3
2020-08-30,2020,CLE,STL,2,7,-120,-1.5,135,8.0,-105,-115,110,1.5,-155,4.36,Busch Stadium,9,-5
2020-08-30,2020,MIA,TB,7,12,160,1.5,-120,7.0,-110,-110,-170,-1.5,100,2.69,Marlins Park,19,-5
2020-08-30,2020,LAD,TEX,7,2,-220,-1.5,-140,9.0,-120,100,200,1.5,120,6.19,Globe Life Field,9,5
2020-08-30,2020,BAL,TOR,5,6,135,1.5,-135,10.0,-115,-105,-145,-1.5,115,4.26,Sahlen Field,11,-1
2020-08-30,2020,BOS,WSH,9,5,-112,1.5,-160,11.0,-120,100,102,-1.5,140,5.81,Fenway Park,14,4
2020-08-31,2020,BOS,ATL,3,6,178,1.5,110,9.0,-120,100,-196,-1.5,-130,3.24,Fenway Park,9,-3
2020-08-31,2020,TOR,BAL,3,4,-161,-1.5,105,10.0,-110,-110,151,1.5,-125,6.17,Sahlen Field,7,-1
2020-08-31,2020,ATL,BOS,6,3,-196,-1.5,-130,9.0,-120,100,178,1.5,110,5.96,Fenway Park,9,3
2020-08-31,2020,STL,CIN,7,5,100,1.5,-200,9.5,-110,-110,-110,-1.5,175,4.75,Great American Ballpark,12,2
2020-08-31,2020,KC,CLE,2,1,210,1.5,125,7.5,-105,-115,-240,-1.5,-145,2.42,Kauffman Stadium,3,1
2020-08-31,2020,SD,COL,6,0,102,-1.5,160,12.0,-120,100,-112,1.5,-180,5.94,Coors Field,6,6
2020-08-31,2020,MIN,CWS,5,8,102,1.5,-160,8.5,-115,-105,-112,-1.5,140,4.21,Target Field,13,-3
2020-08-31,2020,CLE,KC,1,2,-240,-1.5,-145,7.5,-105,-115,210,1.5,125,5.29,Kauffman Stadium,3,-1
2020-08-31,2020,SEA,LAA,2,1,140,1.5,-150,9.0,-110,-110,-150,-1.5,130,3.75,Angel Stadium,3,1
2020-08-31,2020,NYM,MIA,3,5,-270,-1.5,-135,7.5,-110,-110,240,1.5,115,5.47,Citi Field,8,-2
2020-08-31,2020,PIT,MIL,5,6,180,1.5,-115,8.5,-120,100,-200,-1.5,-105,3.04,Miller Park,11,-1
2020-08-31,2020,CWS,MIN,8,5,-112,-1.5,140,8.5,-115,-105,102,1.5,-160,4.49,Target Field,13,3
2020-08-31,2020,MIA,NYM,5,3,240,1.5,115,7.5,-110,-110,-270,-1.5,-135,2.21,Citi Field,8,2
2020-08-31,2020,TB,NYY,5,3,136,1.5,-155,7.5,100,-120,-146,-1.5,135,3.18,Yankee Stadium,8,2
2020-08-31,2020,WSH,PHI,6,8,128,1.5,-155,10.5,-110,-110,-138,-1.5,135,4.61,Citizens Bank Park,14,-2
2020-08-31,2020,MIL,PIT,6,5,-200,-1.5,-105,8.5,-120,100,180,1.5,-115,5.67,Miller Park,11,1
2020-08-31,2020,COL,SD,0,6,-112,1.5,-180,12.0,-120,100,102,-1.5,160,6.34,Coors Field,6,-6
2020-08-31,2020,LAA,SEA,1,2,-150,-1.5,130,9.0,-110,-110,140,1.5,-150,5.4,Angel Stadium,3,-1
2020-08-31,2020,CIN,STL,5,7,-110,-1.5,175,9.5,-110,-110,100,1.5,-200,4.98,Great American Ballpark,12,-2
2020-08-31,2020,NYY,TB,3,5,-146,-1.5,135,7.5,100,-120,136,1.5,-155,4.45,Yankee Stadium,8,-2
2020-08-31,2020,BAL,TOR,4,3,151,1.5,-125,10.0,-110,-110,-161,-1.5,105,3.98,Sahlen Field,7,1
2020-08-31,2020,PHI,WSH,8,6,-138,-1.5,135,10.5,-110,-110,128,1.5,-155,6.09,Citizens Bank Park,14,2
2020-09-01,2020,LAD,ARI,6,3,-220,-1.5,-120,8.5,-115,-105,200,1.5,100,5.84,Dodger Stadium,9,3
2020-09-01,2020,BOS,ATL,3,10,158,1.5,100,9.5,-110,-110,-168,-1.5,-120,3.68,Fenway Park,13,-7
2020-09-01,2020,NYM,BAL,5,9,-132,-1.5,110,10.5,100,-120,122,1.5,-130,5.97,Camden Yards,14,-4
2020-09-01,2020,ATL,BOS,10,3,-168,-1.5,-120,9.5,-110,-110,158,1.5,100,5.96,Fenway Park,13,7
2020-09-01,2020,PIT,CHC,7,8,153,1.5,-105,9.5,-120,100,-163,-1.5,-115,3.75,PNC Park,15,-1
2020-09-01,2020,STL,CIN,16,2,154,1.5,-135,9.0,-105,-115,-164,-1.5,115,3.54,Great American Ballpark,18,14
2020-09-01,2020,KC,CLE,1,10,180,1.5,115,9.0,-120,100,-200,-1.5,-135,3.21,Kauffman Stadium,11,-9
2020-09-01,2020,SF,COL,23,5,-110,1.5,-190,11.5,-110,-110,100,-1.5,170,6.02,Coors Field,28,18
2020-09-01,2020,MIN,CWS,3,2,-109,1.5,-170,9.0,-110,-110,-101,-1.5,150,4.69,Target Field,5,1
2020-09-01,2020,MIL,DET,1,12,-190,-1.5,100,9.5,-115,-105,175,1.5,-120,6.22,Miller Park,13,-11
2020-09-01,2020,TEX,HOU,6,5,230,1.5,115,8.5,-120,100,-260,-1.5,-135,2.58,Minute Maid Park,11,1
2020-09-01,2020,CLE,KC,10,1,-200,-1.5,-135,9.0,-120,100,180,1.5,115,6.0,Kauffman Stadium,11,9
2020-09-01,2020,ARI,LAD,3,6,200,1.5,100,8.5,-115,-105,-220,-1.5,-120,2.83,Dodger Stadium,9,-3
2020-09-01,2020,TOR,MIA,2,3,112,1.5,-180,8.5,-105,-115,-122,-1.5,160,4.01,Marlins Park,5,-1
2020-09-01,2020,DET,MIL,12,1,175,1.5,-120,9.5,-115,-105,-190,-1.5,100,3.45,Miller Park,13,11
2020-09-01,2020,CWS,MIN,2,3,-101,-1.5,150,9.0,-110,-110,-109,1.5,-170,4.52,Target Field,5,-1
2020-09-01,2020,BAL,NYM,9,5,122,1.5,-130,10.5,100,-120,-132,-1.5,110,4.73,Camden Yards,14,4
2020-09-01,2020,TB,NYY,3,5,139,1.5,-150,9.0,-115,-105,-149,-1.5,130,3.77,Yankee Stadium,8,-2
2020-09-01,2020,WSH,PHI,0,6,138,1.5,-155,8.5,-115,-105,-148,-1.5,135,3.57,Citizens Bank Park,6,-6
2020-09-01,2020,CHC,PIT,8,7,-163,-1.5,-115,9.5,-120,100,153,1.5,-105,5.89,PNC Park,15,1
2020-09-01,2020,COL,SF,5,23,100,-1.5,170,11.5,-110,-110,-110,1.5,-190,5.75,Coors Field,28,-18
2020-09-01,2020,CIN,STL,2,16,-164,-1.5,115,9.0,-105,-115,154,1.5,-135,5.59,Great American Ballpark,18,-14
2020-09-01,2020,NYY,TB,5,3,-149,-1.5,130,9.0,-115,-105,139,1.5,-150,5.39,Yankee Stadium,8,2
2020-09-01,2020,HOU,TEX,5,6,-260,-1.5,-135,8.5,-120,100,230,1.5,115,6.14,Minute Maid Park,11,-1
2020-09-01,2020,MIA,TOR,3,2,-122,-1.5,160,8.5,-105,-115,112,1.5,-180,4.67,Marlins Park,5,1
2020-09-01,2020,PHI,WSH,6,0,-148,-1.5,135,8.5,-115,-105,138,1.5,-155,5.07,Citizens Bank Park,6,6
2020-09-02,2020,LAD,ARI,3,2,-200,-1.5,100,8.0,-110,-110,180,1.5,-120,5.33,Dodger Stadium,5,1
2020-09-02,2020,BOS,ATL,5,7,137,1.5,-115,11.0,-120,100,-147,-1.5,-105,4.64,Fenway Park,12,-2
2020-09-02,2020,NYM,BAL,9,4,-142,-1.5,100,10.0,-110,-110,132,1.5,-120,5.87,Camden Yards,13,5
2020-09-02,2020,ATL,BOS,7,5,-147,-1.5,-105,11.0,-120,100,137,1.5,-115,6.55,Fenway Park,12,2
2020-09-02,2020,PIT,CHC,2,8,160,1.5,-110,9.0,-115,-105,-170,-1.5,-110,3.46,PNC Park,10,-6
2020-09-02,2020,STL,CIN,3,4,135,1.5,-155,10.0,-115,-105,-145,-1.5,135,4.26,Great American Ballpark,7,-1
2020-09-02,2020,KC,CLE,0,5,150,1.5,-110,9.0,100,-120,-160,-1.5,-110,3.6,Kauffman Stadium,5,-5
2020-09-02,2020,SF,COL,6,9,108,1.5,-165,11.5,-115,-105,-118,-1.5,145,5.53,Coors Field,15,-3
2020-09-02,2020,MIN,CWS,8,1,-157,-1.5,120,9.5,-105,-115,147,1.5,-140,5.8,Target Field,9,7
2020-09-02,2020,MIL,DET,8,5,-172,-1.5,115,9.0,-110,-110,161,1.5,-135,5.69,Miller Park,13,3
2020-09-02,2020,TEX,HOU,1,2,165,1.5,-115,9.0,-110,-110,-180,-1.5,-105,3.4,Minute Maid Park,3,-1
2020-09-02,2020,CLE,KC,5,0,-160,-1.5,-110,9.0,100,-120,150,1.5,-110,5.54,Kauffman Stadium,5,5
2020-09-02,2020,SD,LAA,11,4,-190,-1.5,-130,9.0,-120,100,175,1.5,110,5.9,Angel Stadium,15,7
2020-09-02,2020,ARI,LAD,2,3,180,1.5,-120,8.0,-110,-110,-200,-1.5,100,2.86,Dodger Stadium,5,-1
2020-09-02,2020,TOR,MIA,2,1,-112,-1.5,150,7.0,-120,100,102,1.5,-170,3.7,Marlins Park,3,1
2020-09-02,2020,DET,MIL,5,8,161,1.5,-135,9.0,-110,-110,-172,-1.5,115,3.45,Miller Park,13,-3
2020-09-02,2020,CWS,MIN,1,8,147,1.5,-140,9.5,-105,-115,-157,-1.5,120,3.85,Target Field,9,-7
2020-09-02,2020,BAL,NYM,4,9,132,1.5,-120,10.0,-110,-110,-142,-1.5,100,4.31,Camden Yards,13,-5
2020-09-02,2020,TB,NYY,5,2,118,1.5,-175,9.0,100,-120,-128,-1.5,155,4.13,Yankee Stadium,7,3
2020-09-02,2020,WSH,PHI,0,3,-117,-1.5,135,8.5,-105,-115,107,1.5,-155,4.58,Citizens Bank Park,3,-3
2020-09-02,2020,CHC,PIT,8,2,-170,-1.5,-110,9.0,-115,-105,160,1.5,-110,5.67,PNC Park,10,6
2020-09-02,2020,LAA,SD,4,11,175,1.5,110,9.0,-120,100,-190,-1.5,-130,3.27,Angel Stadium,15,-7
2020-09-02,2020,COL,SF,9,6,-118,-1.5,145,11.5,-115,-105,108,1.5,-165,6.22,Coors Field,15,3
2020-09-02,2020,CIN,STL,4,3,-145,-1.5,135,10.0,-115,-105,135,1.5,-155,5.92,Great American Ballpark,7,1
2020-09-02,2020,NYY,TB,2,5,-128,-1.5,155,9.0,100,-120,118,1.5,-175,5.05,Yankee Stadium,7,-3
2020-09-02,2020,HOU,TEX,2,1,-180,-1.5,-105,9.0,-110,-110,165,1.5,-115,5.79,Minute Maid Park,3,1
2020-09-02,2020,MIA,TOR,1,2,102,1.5,-170,7.0,-120,100,-112,-1.5,150,3.47,Marlins Park,3,-1
2020-09-02,2020,PHI,WSH,3,0,107,1.5,-155,8.5,-105,-115,-117,-1.5,135,4.11,Citizens Bank Park,3,3
2020-09-03,2020,LAD,ARI,5,1,-300,-1.5,-145,8.5,-110,-110,260,1.5,125,6.38,Dodger Stadium,6,4
2020-09-03,2020,TOR,BOS,6,2,-120,-1.5,125,10.5,-105,-115,110,1.5,-145,5.73,Fenway Park,8,4
2020-09-03,2020,PIT,CHC,6,2,145,1.5,-115,10.0,-105,-115,-155,-1.5,-105,4.08,PNC Park,8,4
2020-09-03,2020,KC,CWS,6,11,125,1.5,-130,9.5,105,-125,-135,-1.5,110,4.22,Kauffman Stadium,17,-5
2020-09-03,2020,TEX,HOU,4,8,150,1.5,-140,7.5,100,-120,-160,-1.5,120,3.0,Minute Maid Park,12,-4
2020-09-03,2020,CWS,KC,11,6,-135,-1.5,110,9.5,105,-125,125,1.5,-130,5.46,Kauffman Stadium,17,5
2020-09-03,2020,SD,LAA,0,2,-138,-1.5,105,8.5,-120,100,128,1.5,-125,4.93,Angel Stadium,2,-2
2020-09-03,2020,ARI,LAD,1,5,260,1.5,125,8.5,-110,-110,-300,-1.5,-145,2.36,Dodger Stadium,6,-4
2020-09-03,2020,NYY,NYM,7,9,105,-1.5,155,9.0,-120,100,-115,1.5,-175,4.39,Citi Field,16,-2
2020-09-03,2020,NYM,NYY,9,7,-115,1.5,-175,9.0,-120,100,105,-1.5,155,4.81,Citi Field,16,2
2020-09-03,2020,WSH,PHI,5,6,162,1.5,-125,10.5,-110,-110,-174,-1.5,105,4.01,Citizens Bank Park,11,-1
2020-09-03,2020,CHC,PIT,2,6,-155,-1.5,-105,10.0,-105,-115,145,1.5,-115,6.08,PNC Park,8,-4
2020-09-03,2020,LAA,SD,2,0,128,1.5,-125,8.5,-120,100,-138,-1.5,105,3.73,Angel Stadium,2,2
2020-09-03,2020,HOU,TEX,8,4,-160,-1.5,120,7.5,100,-120,150,1.5,-140,4.62,Minute Maid Park,12,4
2020-09-03,2020,BOS,TOR,2,6,110,1.5,-145,10.5,-105,-115,-120,-1.5,125,5.0,Fenway Park,8,-4
2020-09-03,2020,PHI,WSH,6,5,-174,-1.5,105,10.5,-110,-110,162,1.5,-125,6.67,Citizens Bank Park,11,1
2020-09-04,2020,SF,ARI,5,6,-150,-1.5,145,9.0,-105,-115,140,1.5,-165,5.4,AT&T Park,11,-1
2020-09-04,2020,WSH,ATL,1,7,155,1.5,-150,8.0,-120,100,-165,-1.5,130,3.14,Suntrust Park,8,-6
2020-09-04,2020,WSH,ATL,10,9,165,1.5,-135,8.5,100,-120,-180,-1.5,115,3.21,Suntrust Park,19,1
2020-09-04,2020,NYY,BAL,6,5,-148,-1.5,120,8.0,100,-120,138,1.5,-140,4.77,Camden Yards,11,1
2020-09-04,2020,NYY,BAL,3,6,-170,-1.5,110,7.5,-115,-105,160,1.5,-130,4.72,Camden Yards,9,-3
2020-09-04,2020,TOR,BOS,8,7,-112,-1.5,145,8.5,-115,-105,102,1.5,-165,4.49,Fenway Park,15,1
2020-09-04,2020,TOR,BOS,2,3,-140,-1.5,150,8.5,105,-125,130,1.5,-170,4.96,Fenway Park,5,-1
2020-09-04,2020,STL,CHC,1,4,130,1.5,-160,8.0,-115,-105,-140,-1.5,140,3.48,Wrigley Field,5,-3
2020-09-04,2020,PIT,CIN,2,4,170,1.5,-110,6.5,-105,-115,-185,-1.5,-110,2.41,PNC Park,6,-2
2020-09-04,2020,PIT,CIN,4,3,180,1.5,-135,6.0,-130,110,-200,-1.5,115,2.14,PNC Park,7,1
2020-09-04,2020,MIL,CLE,7,1,130,1.5,-160,7.5,-115,-105,-140,-1.5,140,3.26,Progressive Field,8,6
2020-09-04,2020,LAD,COL,10,6,-250,-1.5,-140,9.0,-110,-110,220,1.5,120,6.43,Dodger Stadium,16,4
2020-09-04,2020,KC,CWS,4,7,150,1.5,-110,9.0,-115,-105,-160,-1.5,-110,3.6,Kauffman Stadium,11,-3
2020-09-04,2020,MIN,DET,2,0,-161,-1.5,125,6.5,-120,100,151,1.5,-145,4.01,Target Field,2,2
2020-09-04,2020,MIN,DET,3,2,-152,-1.5,125,7.0,105,-125,142,1.5,-145,4.22,Target Field,5,1
2020-09-04,2020,LAA,HOU,6,5,105,1.5,-155,8.5,-115,-105,-115,-1.5,135,4.15,Angel Stadium,11,1
2020-09-04,2020,CWS,KC,7,4,-160,-1.5,-110,9.0,-115,-105,150,1.5,-110,5.54,Kauffman Stadium,11,3
2020-09-04,2020,HOU,LAA,5,6,-115,-1.5,135,8.5,-115,-105,105,1.5,-155,4.55,Angel Stadium,11,-1
2020-09-04,2020,COL,LAD,6,10,220,1.5,120,9.0,-110,-110,-250,-1.5,-140,2.81,Dodger Stadium,16,-4
2020-09-04,2020,TB,MIA,5,4,-130,-1.5,155,7.5,-115,-105,120,1.5,-175,4.24,Tropicana Field,9,1
2020-09-04,2020,CLE,MIL,1,7,-140,-1.5,140,7.5,-115,-105,130,1.5,-160,4.38,Progressive Field,8,-6
2020-09-04,2020,DET,MIN,0,2,151,1.5,-145,6.5,-120,100,-161,-1.5,125,2.59,Target Field,2,-2
2020-09-04,2020,DET,MIN,2,3,142,1.5,-145,7.0,105,-125,-152,-1.5,125,2.89,Target Field,5,-1
2020-09-04,2020,PHI,NYM,5,3,125,1.5,-155,10.0,-120,100,-135,-1.5,135,4.44,Citi Field,8,2
2020-09-04,2020,BAL,NYY,5,6,138,1.5,-140,8.0,100,-120,-148,-1.5,120,3.36,Camden Yards,11,-1
2020-09-04,2020,BAL,NYY,6,3,160,1.5,-130,7.5,-115,-105,-170,-1.5,110,2.88,Camden Yards,9,3
2020-09-04,2020,SD,OAK,7,0,135,1.5,-160,8.0,-110,-110,-145,-1.5,140,3.4,Oakland Coliseum,7,7
2020-09-04,2020,NYM,PHI,3,5,-135,-1.5,135,10.0,-120,100,125,1.5,-155,5.74,Citi Field,8,-2
2020-09-04,2020,CIN,PIT,4,2,-185,-1.5,-110,6.5,-105,-115,170,1.5,-110,4.22,PNC Park,6,2
2020-09-04,2020,CIN,PIT,3,4,-200,-1.5,115,6.0,-130,110,180,1.5,-135,4.0,PNC Park,7,-1
2020-09-04,2020,OAK,SD,0,7,-145,-1.5,140,8.0,-110,-110,135,1.5,-160,4.73,Oakland Coliseum,7,-7
2020-09-04,2020,TEX,SEA,3,6,115,1.5,-180,8.5,-115,-105,-125,-1.5,160,3.95,T-Mobile Park,9,-3
2020-09-04,2020,ARI,SF,6,5,140,1.5,-165,9.0,-105,-115,-150,-1.5,145,3.75,AT&T Park,11,1
2020-09-04,2020,CHC,STL,4,1,-140,-1.5,140,8.0,-115,-105,130,1.5,-160,4.67,Wrigley Field,5,3
2020-09-04,2020,MIA,TB,4,5,120,1.5,-175,7.5,-115,-105,-130,-1.5,155,3.41,Tropicana Field,9,-1
2020-09-04,2020,SEA,TEX,6,3,-125,-1.5,160,8.5,-115,-105,115,1.5,-180,4.72,T-Mobile Park,9,3
2020-09-04,2020,BOS,TOR,7,8,102,1.5,-165,8.5,-115,-105,-112,-1.5,145,4.21,Fenway Park,15,-1
2020-09-04,2020,BOS,TOR,3,2,130,1.5,-170,8.5,105,-125,-140,-1.5,150,3.7,Fenway Park,5,1
2020-09-04,2020,ATL,WSH,7,1,-165,-1.5,130,8.0,-120,100,155,1.5,-150,4.98,Suntrust Park,8,6
2020-09-04,2020,ATL,WSH,9,10,-180,-1.5,115,8.5,100,-120,165,1.5,-135,5.46,Suntrust Park,19,-1
2020-09-05,2020,SF,ARI,4,3,-138,-1.5,150,9.5,-110,-110,128,1.5,-170,5.51,AT&T Park,7,1
2020-09-05,2020,WSH,ATL,10,4,240,1.5,125,9.5,-105,-115,-270,-1.5,-145,2.79,Suntrust Park,14,6
2020-09-05,2020,NYY,BAL,1,6,-240,-1.5,-145,9.0,105,-125,210,1.5,125,6.35,Camden Yards,7,-5
2020-09-05,2020,TOR,BOS,8,9,-125,-1.5,105,10.5,-115,-105,115,1.5,-125,5.83,Fenway Park,17,-1
2020-09-05,2020,STL,CHC,4,2,103,1.5,-230,6.0,-115,-105,-113,-1.5,200,2.96,Wrigley Field,6,2
2020-09-05,2020,STL,CHC,5,1,-102,-1.5,190,7.0,100,-120,-108,1.5,-215,3.53,Wrigley Field,6,4
2020-09-05,2020,PIT,CIN,2,6,112,1.5,-145,9.5,-110,-110,-122,-1.5,125,4.48,PNC Park,8,-4
2020-09-05,2020,MIL,CLE,3,4,104,1.5,-190,7.5,-105,-115,-114,-1.5,170,3.68,Progressive Field,7,-1
2020-09-05,2020,LAD,COL,2,5,-176,-1.5,100,9.0,-120,100,163,1.5,-120,5.74,Dodger Stadium,7,-3
2020-09-05,2020,KC,CWS,3,5,205,1.5,135,9.5,100,-120,-230,-1.5,-155,3.11,Kauffman Stadium,8,-2
2020-09-05,2020,MIN,DET,4,3,-280,-1.5,-135,8.5,-110,-110,245,1.5,115,6.26,Target Field,7,1
2020-09-05,2020,LAA,HOU,10,9,-107,-1.5,180,7.5,-125,105,-103,1.5,-205,3.88,Angel Stadium,19,1
2020-09-05,2020,LAA,HOU,7,6,154,1.5,-150,7.5,-120,-100,-164,-1.5,130,2.95,Angel Stadium,13,1
2020-09-05,2020,CWS,KC,5,3,-230,-1.5,-155,9.5,100,-120,205,1.5,135,6.62,Kauffman Stadium,8,2
2020-09-05,2020,HOU,LAA,9,10,-103,1.5,-205,7.5,-125,105,-107,-1.5,180,3.81,Angel Stadium,19,-1
2020-09-05,2020,HOU,LAA,6,7,-164,-1.5,130,7.5,-120,-100,154,1.5,-150,4.66,Angel Stadium,13,-1
2020-09-05,2020,COL,LAD,5,2,163,1.5,-120,9.0,-120,100,-176,-1.5,100,3.42,Dodger Stadium,7,3
2020-09-05,2020,TB,MIA,3,7,-210,-1.5,-120,7.5,-115,-105,190,1.5,100,5.08,Tropicana Field,10,-4
2020-09-05,2020,CLE,MIL,4,3,-114,-1.5,170,7.5,-105,-115,104,1.5,-190,4.0,Progressive Field,7,1
2020-09-05,2020,DET,MIN,3,4,245,1.5,115,8.5,-110,-110,-280,-1.5,-135,2.46,Target Field,7,-1
2020-09-05,2020,PHI,NYM,1,5,145,1.5,-140,9.0,-110,-110,-155,-1.5,120,3.67,Citi Field,6,-4
2020-09-05,2020,BAL,NYY,6,1,210,1.5,125,9.0,105,-125,-240,-1.5,-145,2.9,Camden Yards,7,5
2020-09-05,2020,SD,OAK,4,8,102,1.5,-200,9.0,-105,-115,-112,-1.5,175,4.46,Oakland Coliseum,12,-4
2020-09-05,2020,NYM,PHI,5,1,-155,-1.5,120,9.0,-110,-110,145,1.5,-140,5.47,Citi Field,6,4
2020-09-05,2020,CIN,PIT,6,2,-122,-1.5,125,9.5,-110,-110,112,1.5,-145,5.22,PNC Park,8,4
2020-09-05,2020,OAK,SD,8,4,-112,-1.5,175,9.0,-105,-115,102,1.5,-200,4.75,Oakland Coliseum,12,4
2020-09-05,2020,TEX,SEA,3,5,129,1.5,-150,8.0,-115,-105,-139,-1.5,130,3.49,T-Mobile Park,8,-2
2020-09-05,2020,ARI,SF,3,4,128,1.5,-170,9.5,-110,-110,-138,-1.5,150,4.17,AT&T Park,7,-1
2020-09-05,2020,CHC,STL,2,4,-113,-1.5,200,6.0,-115,-105,103,1.5,-230,3.18,Wrigley Field,6,-2
2020-09-05,2020,CHC,STL,1,5,-108,1.5,-215,7.0,100,-120,-102,-1.5,190,3.63,Wrigley Field,6,-4
2020-09-05,2020,MIA,TB,7,3,190,1.5,100,7.5,-115,-105,-210,-1.5,-120,2.59,Tropicana Field,10,4
2020-09-05,2020,SEA,TEX,5,3,-139,-1.5,130,8.0,-115,-105,129,1.5,-150,4.65,T-Mobile Park,8,2
2020-09-05,2020,BOS,TOR,9,8,115,1.5,-125,10.5,-115,-105,-125,-1.5,105,4.88,Fenway Park,17,1
2020-09-05,2020,ATL,WSH,4,10,-270,-1.5,-145,9.5,-105,-115,240,1.5,125,6.93,Suntrust Park,14,-6
2020-09-06,2020,SF,ARI,4,2,-150,-1.5,130,9.0,-125,105,140,1.5,-150,5.4,AT&T Park,6,2
2020-09-06,2020,WSH,ATL,3,10,127,1.5,-160,9.5,-110,-110,-137,-1.5,140,4.19,Suntrust Park,13,-7
2020-09-06,2020,NYY,BAL,1,5,-200,-1.5,-135,9.0,-115,-105,180,1.5,115,6.0,Camden Yards,6,-4
2020-09-06,2020,TOR,BOS,10,8,-120,-1.5,115,11.0,-110,-110,110,1.5,-135,6.0,Fenway Park,18,2
2020-09-06,2020,STL,CHC,7,3,-102,-1.5,140,12.5,-115,-105,-108,1.5,-160,6.31,Wrigley Field,10,4
2020-09-06,2020,PIT,CIN,3,2,145,1.5,-110,9.0,-115,-105,-155,-1.5,-110,3.67,PNC Park,5,1
2020-09-06,2020,MIL,CLE,1,4,230,1.5,100,7.0,-125,105,-260,-1.5,-120,2.12,Progressive Field,5,-3
2020-09-06,2020,LAD,COL,6,7,-270,-1.5,-145,9.5,-115,-105,240,1.5,125,6.93,Dodger Stadium,13,-1
2020-09-06,2020,KC,CWS,2,8,190,1.5,125,11.0,100,-120,-210,-1.5,-145,3.79,Kauffman Stadium,10,-6
2020-09-06,2020,MIN,DET,8,10,-185,-1.5,-105,9.0,-110,-110,170,1.5,-115,5.84,Target Field,18,-2
2020-09-06,2020,LAA,HOU,9,5,160,1.5,-110,9.5,-120,100,-170,-1.5,-110,3.65,Angel Stadium,14,4
2020-09-06,2020,CWS,KC,8,2,-210,-1.5,-145,11.0,100,-120,190,1.5,125,7.45,Kauffman Stadium,10,6
2020-09-06,2020,HOU,LAA,5,9,-170,-1.5,-110,9.5,-120,100,160,1.5,-110,5.98,Angel Stadium,14,-4
2020-09-06,2020,COL,LAD,7,6,240,1.5,125,9.5,-115,-105,-270,-1.5,-145,2.79,Dodger Stadium,13,1
2020-09-06,2020,TB,MIA,5,4,-220,-1.5,-110,7.0,-120,100,200,1.5,-110,4.81,Tropicana Field,9,1
2020-09-06,2020,CLE,MIL,4,1,-260,-1.5,-120,7.0,-125,105,230,1.5,100,5.06,Progressive Field,5,3
2020-09-06,2020,DET,MIN,10,8,170,1.5,-115,9.0,-110,-110,-185,-1.5,-105,3.33,Target Field,18,2
2020-09-06,2020,PHI,NYM,1,14,147,1.5,-155,7.5,-115,-105,-157,-1.5,135,3.04,Citi Field,15,-13
2020-09-06,2020,BAL,NYY,5,1,180,1.5,115,9.0,-115,-105,-200,-1.5,-135,3.21,Camden Yards,6,4
2020-09-06,2020,SD,OAK,5,3,-107,-1.5,145,10.5,-115,-105,-103,1.5,-165,5.43,Oakland Coliseum,8,2
2020-09-06,2020,NYM,PHI,14,1,-157,-1.5,135,7.5,-115,-105,147,1.5,-155,4.58,Citi Field,15,13
2020-09-06,2020,CIN,PIT,2,3,-155,-1.5,-110,9.0,-115,-105,145,1.5,-110,5.47,PNC Park,5,-1
2020-09-06,2020,OAK,SD,3,5,-103,1.5,-165,10.5,-115,-105,-107,-1.5,145,5.33,Oakland Coliseum,8,-2
2020-09-06,2020,TEX,SEA,3,4,115,1.5,-160,9.0,-110,-110,-125,-1.5,140,4.19,T-Mobile Park,7,-1
2020-09-06,2020,ARI,SF,2,4,140,1.5,-150,9.0,-125,105,-150,-1.5,130,3.75,AT&T Park,6,-2
2020-09-06,2020,CHC,STL,3,7,-108,1.5,-160,12.5,-115,-105,-102,-1.5,140,6.49,Wrigley Field,10,-4
2020-09-06,2020,MIA,TB,4,5,200,1.5,-110,7.0,-120,100,-220,-1.5,-110,2.33,Tropicana Field,9,-1
2020-09-06,2020,SEA,TEX,4,3,-125,-1.5,140,9.0,-110,-110,115,1.5,-160,5.0,T-Mobile Park,7,1
2020-09-06,2020,BOS,TOR,8,10,110,1.5,-135,11.0,-110,-110,-120,-1.5,115,5.24,Fenway Park,18,-2
2020-09-06,2020,ATL,WSH,10,3,-137,-1.5,140,9.5,-110,-110,127,1.5,-160,5.49,Suntrust Park,13,7
2020-09-07,2020,SF,ARI,4,2,-110,-1.5,185,7.5,-105,-115,100,1.5,-210,3.93,AT&T Park,6,2
2020-09-07,2020,MIA,ATL,5,4,200,1.5,100,9.0,-120,100,-220,-1.5,-120,3.0,Suntrust Park,9,1
2020-09-07,2020,STL,CHC,1,5,167,1.5,-130,7.5,-120,100,-182,-1.5,110,2.81,Wrigley Field,6,-4
2020-09-07,2020,KC,CLE,2,5,190,1.5,-110,8.0,-110,-110,-210,-1.5,-110,2.76,Progressive Field,7,-3
2020-09-07,2020,SD,COL,1,0,-185,-1.5,110,8.5,-110,-110,170,1.5,-130,5.52,PETCO Park,1,1
2020-09-07,2020,MIN,DET,6,2,-200,-1.5,-110,8.5,-120,100,180,1.5,-110,5.67,Target Field,8,4
2020-09-07,2020,OAK,HOU,6,0,-130,-1.5,145,9.0,-115,-105,120,1.5,-165,5.09,Oakland Coliseum,6,6
2020-09-07,2020,CLE,KC,5,2,-210,-1.5,-110,8.0,-110,-110,190,1.5,-110,5.42,Progressive Field,7,3
2020-09-07,2020,ATL,MIA,4,5,-220,-1.5,-120,9.0,-120,100,200,1.5,100,6.19,Suntrust Park,9,-1
2020-09-07,2020,DET,MIN,2,6,180,1.5,-110,8.5,-120,100,-200,-1.5,-110,3.04,Target Field,8,-4
2020-09-07,2020,PHI,NYM,9,8,-125,-1.5,130,9.5,-110,-110,115,1.5,-150,5.28,Citi Field,17,1
2020-09-07,2020,TOR,NYY,12,7,-125,-1.5,145,9.0,-105,-115,115,1.5,-165,5.0,Sahlen Field,19,5
2020-09-07,2020,HOU,OAK,0,6,120,1.5,-165,9.0,-115,-105,-130,-1.5,145,4.09,Oakland Coliseum,6,-6
2020-09-07,2020,NYM,PHI,8,9,115,1.5,-150,9.5,-110,-110,-125,-1.5,130,4.42,Citi Field,17,-1
2020-09-07,2020,COL,SD,0,1,170,1.5,-130,8.5,-110,-110,-185,-1.5,110,3.15,PETCO Park,1,-1
2020-09-07,2020,TEX,SEA,4,8,140,1.5,-155,8.0,-115,-105,-150,-1.5,135,3.33,T-Mobile Park,12,-4
2020-09-07,2020,ARI,SF,2,4,100,1.5,-210,7.5,-105,-115,-110,-1.5,185,3.75,AT&T Park,6,-2
2020-09-07,2020,CHC,STL,5,1,-182,-1.5,110,7.5,-120,100,167,1.5,-130,4.84,Wrigley Field,6,4
2020-09-07,2020,WSH,TB,6,1,-110,-1.5,175,8.0,-105,-115,100,1.5,-200,4.19,Nationals Park,7,5
2020-09-07,2020,SEA,TEX,8,4,-150,-1.5,135,8.0,-115,-105,140,1.5,-155,4.8,T-Mobile Park,12,4
2020-09-07,2020,NYY,TOR,7,12,115,1.5,-165,9.0,-105,-115,-125,-1.5,145,4.19,Sahlen Field,19,-5
2020-09-07,2020,TB,WSH,1,6,100,1.5,-200,8.0,-105,-115,-110,-1.5,175,4.0,Nationals Park,7,-5
2020-09-08,2020,LAD,ARI,10,9,-255,-1.5,-150,9.5,100,-120,225,1.5,130,6.82,Chase Field,19,1
2020-09-08,2020,MIA,ATL,8,0,107,1.5,-185,9.0,-120,100,-117,-1.5,165,4.35,Suntrust Park,8,8
2020-09-08,2020,NYM,BAL,2,11,-180,-1.5,110,9.0,-115,-105,165,1.5,-130,5.79,Citi Field,13,-9
2020-09-08,2020,PHI,BOS,6,5,-185,-1.5,120,7.5,-110,-110,170,1.5,-140,4.87,Citizens Bank Park,11,1
2020-09-08,2020,PHI,BOS,2,5,-160,-1.5,125,8.0,100,-120,150,1.5,-145,4.92,Citizens Bank Park,7,-3
2020-09-08,2020,CIN,CHC,0,3,-107,-1.5,155,7.5,-120,100,-103,1.5,-175,3.88,Wrigley Field,3,-3
2020-09-08,2020,CHC,CIN,3,0,-103,1.5,-175,7.5,-120,100,-107,-1.5,155,3.81,Wrigley Field,3,3
2020-09-08,2020,KC,CLE,8,6,185,1.5,-110,8.5,-105,-115,-205,-1.5,-110,2.98,Progressive Field,14,2
2020-09-08,2020,SD,COL,14,5,-240,-1.5,-125,8.5,-120,100,210,1.5,105,6.0,PETCO Park,19,9
2020-09-08,2020,PIT,CWS,5,4,124,1.5,-130,9.5,-105,-115,-134,-1.5,110,4.24,PNC Park,9,1
2020-09-08,2020,MIL,DET,3,8,-148,-1.5,110,9.0,-110,-110,138,1.5,-130,5.37,Comerica Park,11,-5
2020-09-08,2020,OAK,HOU,4,2,118,1.5,-200,6.5,-115,-105,-128,-1.5,175,2.98,Oakland Coliseum,6,2
2020-09-08,2020,OAK,HOU,4,5,-146,-1.5,145,8.0,-105,-115,136,1.5,-165,4.75,Oakland Coliseum,9,-1
2020-09-08,2020,CLE,KC,6,8,-205,-1.5,-110,8.5,-105,-115,185,1.5,-110,5.71,Progressive Field,14,-2
2020-09-08,2020,TEX,LAA,7,1,118,1.5,-145,8.0,-110,-110,-128,-1.5,125,3.67,Globe Life Field,8,6
2020-09-08,2020,ARI,LAD,9,10,225,1.5,130,9.5,100,-120,-255,-1.5,-150,2.92,Chase Field,19,-1
2020-09-08,2020,ATL,MIA,0,8,-117,-1.5,165,9.0,-120,100,107,1.5,-185,4.85,Suntrust Park,8,-8
2020-09-08,2020,DET,MIL,8,3,138,1.5,-130,9.0,-110,-110,-148,-1.5,110,3.78,Comerica Park,11,5
2020-09-08,2020,STL,MIN,3,7,115,1.5,-165,6.5,-115,-105,-125,-1.5,145,3.02,Busch Stadium,10,-4
2020-09-08,2020,STL,MIN,6,4,124,1.5,-145,7.0,-115,-105,-134,-1.5,125,3.13,Busch Stadium,10,2
2020-09-08,2020,BAL,NYM,11,2,165,1.5,-130,9.0,-115,-105,-180,-1.5,110,3.4,Citi Field,13,9
2020-09-08,2020,TOR,NYY,2,1,-101,-1.5,175,10.0,-120,100,-109,1.5,-200,5.02,Sahlen Field,3,1
2020-09-08,2020,HOU,OAK,2,4,-128,-1.5,175,6.5,-115,-105,118,1.5,-200,3.65,Oakland Coliseum,6,-2
2020-09-08,2020,HOU,OAK,5,4,136,1.5,-165,8.0,-105,-115,-146,-1.5,145,3.39,Oakland Coliseum,9,1
2020-09-08,2020,BOS,PHI,5,6,170,1.5,-140,7.5,-110,-110,-185,-1.5,120,2.78,Citizens Bank Park,11,-1
2020-09-08,2020,BOS,PHI,5,2,150,1.5,-145,8.0,100,-120,-160,-1.5,125,3.2,Citizens Bank Park,7,3
2020-09-08,2020,CWS,PIT,4,5,-134,-1.5,110,9.5,-105,-115,124,1.5,-130,5.44,PNC Park,9,-1
2020-09-08,2020,COL,SD,5,14,210,1.5,105,8.5,-120,100,-240,-1.5,-125,2.74,PETCO Park,19,-9
2020-09-08,2020,SF,SEA,6,5,-160,-1.5,130,9.0,-110,-110,150,1.5,-150,5.54,AT&T Park,11,1
2020-09-08,2020,SEA,SF,5,6,150,1.5,-150,9.0,-110,-110,-160,-1.5,130,3.6,AT&T Park,11,-1
2020-09-08,2020,MIN,STL,7,3,-125,-1.5,145,6.5,-115,-105,115,1.5,-165,3.61,Busch Stadium,10,4
2020-09-08,2020,MIN,STL,4,6,-134,-1.5,125,7.0,-115,-105,124,1.5,-145,4.01,Busch Stadium,10,-2
2020-09-08,2020,WSH,TB,5,3,138,1.5,-105,9.5,-115,-105,-148,-1.5,-115,3.99,Nationals Park,8,2
2020-09-08,2020,LAA,TEX,1,7,-128,-1.5,125,8.0,-110,-110,118,1.5,-145,4.49,Globe Life Field,8,-6
2020-09-08,2020,NYY,TOR,1,2,-109,1.5,-200,10.0,-120,100,-101,-1.5,175,5.22,Sahlen Field,3,-1
2020-09-08,2020,TB,WSH,3,5,-148,-1.5,-115,9.5,-115,-105,138,1.5,-105,5.67,Nationals Park,8,-2
2020-09-09,2020,LAD,ARI,6,4,-310,-1.5,-180,9.0,-120,100,270,1.5,160,6.8,Chase Field,10,2
2020-09-09,2020,MIA,ATL,9,29,128,1.5,-170,9.0,100,-120,-138,-1.5,150,3.95,Suntrust Park,38,-20
2020-09-09,2020,NYM,BAL,7,6,-194,-1.5,100,9.5,100,-120,177,1.5,-120,6.27,Citi Field,13,1
2020-09-09,2020,CIN,CHC,3,0,140,1.5,-160,6.5,100,-120,-150,-1.5,140,2.71,Wrigley Field,3,3
2020-09-09,2020,CHC,CIN,0,3,-150,-1.5,140,6.5,100,-120,140,1.5,-160,3.9,Wrigley Field,3,-3
2020-09-09,2020,KC,CLE,3,0,190,1.5,-115,8.0,100,-120,-210,-1.5,-105,2.76,Progressive Field,3,3
2020-09-09,2020,SD,COL,5,3,-174,-1.5,105,9.0,-115,-105,162,1.5,-125,5.72,PETCO Park,8,2
2020-09-09,2020,PIT,CWS,1,8,143,1.5,-115,9.0,-105,-115,-153,-1.5,-105,3.7,PNC Park,9,-7
2020-09-09,2020,MIL,DET,19,0,-152,-1.5,105,7.5,-105,-115,142,1.5,-125,4.52,Comerica Park,19,19
2020-09-09,2020,OAK,HOU,3,2,-180,-1.5,105,9.0,100,-120,165,1.5,-125,5.79,Oakland Coliseum,5,1
2020-09-09,2020,CLE,KC,0,3,-210,-1.5,-105,8.0,100,-120,190,1.5,-115,5.42,Progressive Field,3,-3
2020-09-09,2020,TEX,LAA,7,3,106,1.5,-150,9.5,105,-125,-116,-1.5,130,4.61,Globe Life Field,10,4
2020-09-09,2020,ARI,LAD,4,6,270,1.5,160,9.0,-120,100,-310,-1.5,-180,2.43,Chase Field,10,-2
2020-09-09,2020,ATL,MIA,29,9,-138,-1.5,150,9.0,100,-120,128,1.5,-170,5.22,Suntrust Park,38,20
2020-09-09,2020,DET,MIL,0,19,142,1.5,-125,7.5,-105,-115,-152,-1.5,105,3.1,Comerica Park,19,-19
2020-09-09,2020,BAL,NYM,6,7,177,1.5,-120,9.5,100,-120,-194,-1.5,100,3.43,Citi Field,13,-1
2020-09-09,2020,TOR,NYY,2,7,137,1.5,-130,10.0,-105,-115,-147,-1.5,110,4.22,Sahlen Field,9,-5
2020-09-09,2020,HOU,OAK,2,3,165,1.5,-125,9.0,100,-120,-180,-1.5,105,3.4,Oakland Coliseum,5,-1
2020-09-09,2020,CWS,PIT,8,1,-153,-1.5,-105,9.0,-105,-115,143,1.5,-115,5.44,PNC Park,9,7
2020-09-09,2020,COL,SD,3,5,162,1.5,-125,9.0,-115,-105,-174,-1.5,105,3.44,PETCO Park,8,-2
2020-09-09,2020,SF,SEA,10,1,-135,-1.5,150,9.0,-110,-110,125,1.5,-170,5.17,AT&T Park,11,9
2020-09-09,2020,SEA,SF,1,10,125,1.5,-170,9.0,-110,-110,-135,-1.5,150,4.0,AT&T Park,11,-9
2020-09-09,2020,LAA,TEX,3,7,-116,-1.5,130,9.5,105,-125,106,1.5,-150,5.1,Globe Life Field,10,-4
2020-09-09,2020,NYY,TOR,7,2,-147,-1.5,110,10.0,-105,-115,137,1.5,-130,5.95,Sahlen Field,9,5
2020-09-10,2020,LAD,ARI,2,5,-240,-1.5,-150,9.5,-120,100,210,1.5,130,6.71,Chase Field,7,-3
2020-09-10,2020,WSH,ATL,6,7,136,1.5,-120,11.0,100,-120,-146,-1.5,100,4.66,Nationals Park,13,-1
2020-09-10,2020,TB,BOS,3,4,-198,-1.5,-105,9.5,-100,-120,179,1.5,-115,6.31,Tropicana Field,7,-1
2020-09-10,2020,CIN,CHC,5,8,-125,-1.5,145,7.5,100,-120,115,1.5,-165,4.17,Wrigley Field,13,-3
2020-09-10,2020,CHC,CIN,8,5,115,1.5,-165,7.5,100,-120,-125,-1.5,145,3.49,Wrigley Field,13,3
2020-09-10,2020,KC,CLE,11,1,200,1.5,-105,7.5,-110,-110,-220,-1.5,-115,2.5,Progressive Field,12,10
2020-09-10,2020,STL,DET,12,2,-230,-1.5,100,5.5,100,-120,205,1.5,-120,3.83,Busch Stadium,14,10
2020-09-10,2020,STL,DET,3,6,-190,-1.5,115,7.0,100,-120,175,1.5,-135,4.59,Busch Stadium,9,-3
2020-09-10,2020,OAK,HOU,3,1,-147,-1.5,135,9.0,100,-120,137,1.5,-155,5.36,Oakland Coliseum,4,2
2020-09-10,2020,CLE,KC,1,11,-220,-1.5,-115,7.5,-110,-110,200,1.5,-105,5.16,Progressive Field,12,-10
2020-09-10,2020,TEX,LAA,2,6,149,1.5,-110,8.5,-110,-110,-159,-1.5,-110,3.41,Globe Life Field,8,-4
2020-09-10,2020,ARI,LAD,5,2,210,1.5,130,9.5,-120,100,-240,-1.5,-150,3.06,Chase Field,7,3
2020-09-10,2020,PHI,MIA,6,7,-105,-1.5,155,8.5,-120,100,-105,1.5,-175,4.35,Marlins Park,13,-1
2020-09-10,2020,HOU,OAK,1,3,137,1.5,-155,9.0,100,-120,-147,-1.5,135,3.8,Oakland Coliseum,4,-2
2020-09-10,2020,MIA,PHI,7,6,-105,1.5,-175,8.5,-120,100,-105,-1.5,155,4.35,Marlins Park,13,1
2020-09-10,2020,SF,SD,1,6,165,1.5,-120,9.0,-115,-105,-180,-1.5,100,3.4,PETCO Park,7,-5
2020-09-10,2020,SD,SF,6,1,-180,-1.5,100,9.0,-115,-105,165,1.5,-120,5.79,PETCO Park,7,5
2020-09-10,2020,DET,STL,2,12,205,1.5,-120,5.5,100,-120,-230,-1.5,100,1.8,Busch Stadium,14,-10
2020-09-10,2020,DET,STL,6,3,175,1.5,-135,7.0,100,-120,-190,-1.5,115,2.55,Busch Stadium,9,3
2020-09-10,2020,BOS,TB,4,3,179,1.5,-115,9.5,-100,-120,-198,-1.5,-105,3.41,Tropicana Field,7,1
2020-09-10,2020,LAA,TEX,6,2,-159,-1.5,-110,8.5,-110,-110,149,1.5,-110,5.22,Globe Life Field,8,4
2020-09-10,2020,ATL,WSH,7,6,-146,-1.5,100,11.0,100,-120,136,1.5,-120,6.53,Nationals Park,13,1
2020-09-11,2020,SEA,ARI,3,4,-110,-1.5,145,9.5,100,-120,100,1.5,-165,4.98,Chase Field,7,-1
2020-09-11,2020,WSH,ATL,8,7,145,1.5,-110,11.0,-110,-110,-155,-1.5,-110,4.49,Nationals Park,15,1
2020-09-11,2020,NYY,BAL,6,0,-250,-1.5,-115,6.5,100,-120,220,1.5,-105,4.64,Yankee Stadium,6,6
2020-09-11,2020,NYY,BAL,10,1,-190,-1.5,120,6.5,-110,-110,175,1.5,-140,4.26,Yankee Stadium,11,9
2020-09-11,2020,TB,BOS,11,1,-270,-1.5,-140,8.5,-110,-110,240,1.5,120,6.2,Tropicana Field,12,10
2020-09-11,2020,MIL,CHC,1,0,-166,-1.5,115,9.0,-115,-105,156,1.5,-135,5.62,Miller Park,1,1
2020-09-11,2020,STL,CIN,1,3,102,1.5,-165,7.5,100,-120,-112,-1.5,145,3.71,Busch Stadium,4,-2
2020-09-11,2020,MIN,CLE,3,1,105,-1.5,220,6.5,-110,-110,-115,1.5,-250,3.17,Target Field,4,2
2020-09-11,2020,LAA,COL,4,8,124,1.5,-150,12.0,-105,-115,-134,-1.5,130,5.36,Coors Field,12,-4
2020-09-11,2020,DET,CWS,3,4,225,1.5,110,8.0,-105,-115,-255,-1.5,-130,2.46,Guaranteed Rate Field,7,-1
2020-09-11,2020,CWS,DET,4,3,-255,-1.5,-130,8.0,-105,-115,225,1.5,110,5.75,Guaranteed Rate Field,7,1
2020-09-11,2020,PIT,KC,3,4,128,1.5,-160,8.5,-115,-105,-138,-1.5,140,3.73,Kauffman Stadium,7,-1
2020-09-11,2020,COL,LAA,8,4,-134,-1.5,130,12.0,-105,-115,124,1.5,-150,6.87,Coors Field,12,4
2020-09-11,2020,PHI,MIA,11,0,-160,-1.5,135,6.0,105,-125,150,1.5,-155,3.69,Marlins Park,11,11
2020-09-11,2020,PHI,MIA,3,5,-120,-1.5,160,7.0,-130,110,110,1.5,-180,3.82,Marlins Park,8,-2
2020-09-11,2020,CHC,MIL,0,1,156,1.5,-135,9.0,-115,-105,-166,-1.5,115,3.52,Miller Park,1,-1
2020-09-11,2020,CLE,MIN,1,3,-115,1.5,-250,6.5,-110,-110,105,-1.5,220,3.48,Target Field,4,-2
2020-09-11,2020,TOR,NYM,1,18,195,1.5,120,8.5,-120,100,-215,-1.5,-140,2.88,Sahlen Field,19,-17
2020-09-11,2020,BAL,NYY,0,6,220,1.5,-105,6.5,100,-120,-250,-1.5,-115,2.03,Yankee Stadium,6,-6
2020-09-11,2020,BAL,NYY,1,10,175,1.5,-140,6.5,-110,-110,-190,-1.5,120,2.36,Yankee Stadium,11,-9
2020-09-11,2020,TEX,OAK,6,10,163,1.5,100,9.5,-110,-110,-176,-1.5,-120,3.61,Globe Life Field,16,-4
2020-09-11,2020,MIA,PHI,0,11,150,1.5,-155,6.0,105,-125,-160,-1.5,135,2.4,Marlins Park,11,-11
2020-09-11,2020,MIA,PHI,5,3,110,1.5,-180,7.0,-130,110,-120,-1.5,160,3.33,Marlins Park,8,2
2020-09-11,2020,KC,PIT,4,3,-138,-1.5,140,8.5,-115,-105,128,1.5,-160,4.93,Kauffman Stadium,7,1
2020-09-11,2020,ARI,SEA,4,3,100,1.5,-165,9.5,100,-120,-110,-1.5,145,4.75,Chase Field,7,1
2020-09-11,2020,CIN,STL,3,1,-112,-1.5,145,7.5,100,-120,102,1.5,-165,3.96,Busch Stadium,4,2
2020-09-11,2020,BOS,TB,1,11,240,1.5,120,8.5,-110,-110,-270,-1.5,-140,2.5,Tropicana Field,12,-10
2020-09-11,2020,OAK,TEX,10,6,-176,-1.5,-120,9.5,-110,-110,163,1.5,100,6.06,Globe Life Field,16,4
2020-09-11,2020,NYM,TOR,18,1,-215,-1.5,-140,8.5,-120,100,195,1.5,120,5.8,Sahlen Field,19,17
2020-09-11,2020,ATL,WSH,7,8,-155,-1.5,-110,11.0,-110,-110,145,1.5,-110,6.69,Nationals Park,15,-1
2020-09-12,2020,SEA,ARI,7,3,141,1.5,-150,8.5,-120,100,-151,-1.5,130,3.53,Chase Field,10,4
2020-09-12,2020,WSH,ATL,1,2,135,1.5,-125,9.0,-120,100,-145,-1.5,105,3.83,Nationals Park,3,-1
2020-09-12,2020,NYY,BAL,2,1,-185,-1.5,-105,9.0,-105,-115,170,1.5,-115,5.84,Yankee Stadium,3,1
2020-09-12,2020,TB,BOS,5,4,-210,-1.5,-105,7.5,-110,-110,190,1.5,-115,5.08,Tropicana Field,9,1
2020-09-12,2020,MIL,CHC,2,4,-104,1.5,-165,9.0,-100,-120,-106,-1.5,145,4.59,Miller Park,6,-2
2020-09-12,2020,STL,CIN,7,1,-128,-1.5,145,8.0,-105,-115,118,1.5,-165,4.49,Busch Stadium,8,6
2020-09-12,2020,MIN,CLE,8,4,100,1.5,-165,8.0,-115,-105,-110,-1.5,145,4.0,Target Field,12,4
2020-09-12,2020,LAA,COL,5,2,125,1.5,-145,12.0,-115,-105,-135,-1.5,125,5.33,Coors Field,7,3
2020-09-12,2020,DET,CWS,0,14,175,1.5,-105,10.5,-110,-110,-190,-1.5,-115,3.82,Guaranteed Rate Field,14,-14
2020-09-12,2020,CWS,DET,14,0,-190,-1.5,-115,10.5,-110,-110,175,1.5,-105,6.88,Guaranteed Rate Field,14,14
2020-09-12,2020,LAD,HOU,5,7,-155,-1.5,120,9.5,100,-120,145,1.5,-140,5.77,Dodger Stadium,12,-2
2020-09-12,2020,PIT,KC,4,7,102,1.5,-190,9.5,-110,-110,-112,-1.5,170,4.7,Kauffman Stadium,11,-3
2020-09-12,2020,COL,LAA,2,5,-135,-1.5,125,12.0,-115,-105,125,1.5,-145,6.89,Coors Field,7,-3
2020-09-12,2020,HOU,LAD,7,5,145,1.5,-140,9.5,100,-120,-155,-1.5,120,3.88,Dodger Stadium,12,2
2020-09-12,2020,PHI,MIA,12,6,-120,-1.5,130,9.5,-105,-115,110,1.5,-150,5.18,Marlins Park,18,6
2020-09-12,2020,CHC,MIL,4,2,-106,-1.5,145,9.0,-100,-120,-104,1.5,-165,4.63,Miller Park,6,2
2020-09-12,2020,CLE,MIN,4,8,-110,-1.5,145,8.0,-115,-105,100,1.5,-165,4.19,Target Field,12,-4
2020-09-12,2020,TOR,NYM,3,2,151,1.5,-110,10.0,-105,-115,-161,-1.5,-110,3.98,Sahlen Field,5,1
2020-09-12,2020,BAL,NYY,1,2,170,1.5,-115,9.0,-105,-115,-185,-1.5,-105,3.33,Yankee Stadium,3,-1
2020-09-12,2020,TEX,OAK,5,2,178,1.5,100,7.5,100,-120,-196,-1.5,-120,2.7,Globe Life Field,7,3
2020-09-12,2020,TEX,OAK,1,10,190,1.5,-105,7.0,100,-120,-210,-1.5,-115,2.41,Globe Life Field,11,-9
2020-09-12,2020,MIA,PHI,6,12,110,1.5,-150,9.5,-105,-115,-120,-1.5,130,4.52,Marlins Park,18,-6
2020-09-12,2020,KC,PIT,7,4,-112,-1.5,170,9.5,-110,-110,102,1.5,-190,5.02,Kauffman Stadium,11,3
2020-09-12,2020,ARI,SEA,3,7,-151,-1.5,130,8.5,-120,100,141,1.5,-150,5.11,Chase Field,10,-4
2020-09-12,2020,CIN,STL,1,7,118,1.5,-165,8.0,-105,-115,-128,-1.5,145,3.67,Busch Stadium,8,-6
2020-09-12,2020,BOS,TB,4,5,190,1.5,-115,7.5,-110,-110,-210,-1.5,-105,2.59,Tropicana Field,9,-1
2020-09-12,2020,OAK,TEX,2,5,-196,-1.5,-120,7.5,100,-120,178,1.5,100,4.97,Globe Life Field,7,-3
2020-09-12,2020,OAK,TEX,10,1,-210,-1.5,-115,7.0,100,-120,190,1.5,-105,4.74,Globe Life Field,11,9
2020-09-12,2020,NYM,TOR,2,3,-161,-1.5,-110,10.0,-105,-115,151,1.5,-110,6.17,Sahlen Field,5,-1
2020-09-12,2020,ATL,WSH,2,1,-145,-1.5,105,9.0,-120,100,135,1.5,-125,5.33,Nationals Park,3,1
2020-09-13,2020,SEA,ARI,7,3,140,1.5,-145,9.0,-115,-105,-150,-1.5,125,3.75,Chase Field,10,4
2020-09-13,2020,WSH,ATL,4,8,-165,-1.5,115,9.0,-125,105,155,1.5,-135,5.6,Nationals Park,12,-4
2020-09-13,2020,NYY,BAL,3,1,-170,-1.5,110,9.5,-120,100,160,1.5,-130,5.98,Yankee Stadium,4,2
2020-09-13,2020,TB,BOS,3,6,-200,-1.5,100,8.0,-110,-110,180,1.5,-120,5.33,Tropicana Field,9,-3
2020-09-13,2020,MIL,CHC,0,12,-124,-1.5,150,9.5,-110,-110,114,1.5,-170,5.26,Miller Park,12,-12
2020-09-13,2020,STL,CIN,5,10,-105,1.5,-170,8.0,-120,100,-105,-1.5,150,4.1,Busch Stadium,15,-5
2020-09-13,2020,MIN,CLE,7,5,-135,-1.5,140,8.0,-120,100,125,1.5,-160,4.6,Target Field,12,2
2020-09-13,2020,LAA,COL,5,3,-155,-1.5,-110,12.5,-120,100,145,1.5,-110,7.6,Coors Field,8,2
2020-09-13,2020,DET,CWS,2,5,160,1.5,-135,9.5,-110,-110,-170,-1.5,115,3.65,Guaranteed Rate Field,7,-3
2020-09-13,2020,CWS,DET,5,2,-170,-1.5,115,9.5,-110,-110,160,1.5,-135,5.98,Guaranteed Rate Field,7,3
2020-09-13,2020,LAD,HOU,8,1,-137,-1.5,145,9.0,-115,-105,127,1.5,-165,5.2,Dodger Stadium,9,7
2020-09-13,2020,PIT,KC,0,11,122,1.5,-155,8.5,-120,100,-132,-1.5,135,3.83,Kauffman Stadium,11,-11
2020-09-13,2020,COL,LAA,3,5,145,1.5,-110,12.5,-120,100,-155,-1.5,-110,5.1,Coors Field,8,-2
2020-09-13,2020,HOU,LAD,1,8,127,1.5,-165,9.0,-115,-105,-137,-1.5,145,3.96,Dodger Stadium,9,-7
2020-09-13,2020,PHI,MIA,1,2,155,1.5,-160,6.5,-105,-115,-165,-1.5,140,2.55,Marlins Park,3,-1
2020-09-13,2020,PHI,MIA,1,8,-150,-1.5,130,7.0,-105,-115,140,1.5,-150,4.2,Marlins Park,9,-7
2020-09-13,2020,CHC,MIL,12,0,114,1.5,-170,9.5,-110,-110,-124,-1.5,150,4.44,Miller Park,12,12
2020-09-13,2020,CLE,MIN,5,7,125,1.5,-160,8.0,-120,100,-135,-1.5,140,3.56,Target Field,12,-2
2020-09-13,2020,TOR,NYM,7,3,-154,-1.5,115,9.5,100,-120,144,1.5,-135,5.76,Sahlen Field,10,4
2020-09-13,2020,BAL,NYY,1,3,160,1.5,-130,9.5,-120,100,-170,-1.5,110,3.65,Yankee Stadium,4,-2
2020-09-13,2020,TEX,OAK,6,3,130,1.5,-135,8.0,-110,-110,-140,-1.5,115,3.48,Globe Life Field,9,3
2020-09-13,2020,MIA,PHI,2,1,-165,-1.5,140,6.5,-105,-115,155,1.5,-160,4.05,Marlins Park,3,1
2020-09-13,2020,MIA,PHI,8,1,140,1.5,-150,7.0,-105,-115,-150,-1.5,130,2.92,Marlins Park,9,7
2020-09-13,2020,KC,PIT,11,0,-132,-1.5,135,8.5,-120,100,122,1.5,-155,4.84,Kauffman Stadium,11,11
2020-09-13,2020,SF,SD,0,6,162,1.5,-150,6.0,-120,100,-174,-1.5,130,2.29,PETCO Park,6,-6
2020-09-13,2020,SF,SD,1,3,150,1.5,-160,6.5,-120,100,-160,-1.5,140,2.6,PETCO Park,4,-2
2020-09-13,2020,ARI,SEA,3,7,-150,-1.5,125,9.0,-115,-105,140,1.5,-145,5.4,Chase Field,10,-4
2020-09-13,2020,SD,SF,6,0,-174,-1.5,130,6.0,-120,100,162,1.5,-150,3.81,PETCO Park,6,6
2020-09-13,2020,SD,SF,3,1,-160,-1.5,140,6.5,-120,100,150,1.5,-160,4.0,PETCO Park,4,2
2020-09-13,2020,CIN,STL,10,5,-105,-1.5,150,8.0,-120,100,-105,1.5,-170,4.1,Busch Stadium,15,5
2020-09-13,2020,BOS,TB,6,3,180,1.5,-120,8.0,-110,-110,-200,-1.5,100,2.86,Tropicana Field,9,3
2020-09-13,2020,OAK,TEX,3,6,-140,-1.5,115,8.0,-110,-110,130,1.5,-135,4.67,Globe Life Field,9,-3
2020-09-13,2020,NYM,TOR,3,7,144,1.5,-135,9.5,100,-120,-154,-1.5,115,3.89,Sahlen Field,10,-4
2020-09-13,2020,ATL,WSH,8,4,155,1.5,-135,9.0,-125,105,-165,-1.5,115,3.53,Nationals Park,12,4
2020-09-14,2020,BAL,ATL,14,1,154,1.5,100,10.0,-125,105,-164,-1.5,-120,3.94,Camden Yards,15,13
2020-09-14,2020,ATL,BAL,1,14,-164,-1.5,-120,10.0,-125,105,154,1.5,100,6.21,Camden Yards,15,-13
2020-09-14,2020,PIT,CIN,1,3,225,1.5,-110,6.0,100,-120,-255,-1.5,-110,1.85,Great American Ballpark,4,-2
2020-09-14,2020,PIT,CIN,4,9,138,1.5,-155,7.5,-105,-115,-148,-1.5,135,3.15,Great American Ballpark,13,-5
2020-09-14,2020,MIN,CWS,1,3,-136,-1.5,115,9.0,-120,100,126,1.5,-135,5.19,Guaranteed Rate Field,4,-2
2020-09-14,2020,SD,LAD,7,2,130,1.5,-135,7.5,-115,-105,-140,-1.5,115,3.26,PETCO Park,9,5
2020-09-14,2020,PHI,MIA,2,6,109,1.5,-180,8.5,-105,-115,-119,-1.5,160,4.07,Marlins Park,8,-4
2020-09-14,2020,STL,MIL,1,2,104,1.5,-220,6.5,-115,-105,-114,-1.5,195,3.19,Miller Park,3,-1
2020-09-14,2020,STL,MIL,3,2,180,1.5,-125,6.5,-105,-115,-200,-1.5,105,2.32,Miller Park,5,1
2020-09-14,2020,CWS,MIN,3,1,126,1.5,-135,9.0,-120,100,-136,-1.5,115,3.98,Guaranteed Rate Field,4,2
2020-09-14,2020,SEA,OAK,6,5,142,1.5,-150,6.0,110,-130,-152,-1.5,130,2.48,T-Mobile Park,11,1
2020-09-14,2020,SEA,OAK,0,9,160,1.5,-125,7.0,-125,105,-170,-1.5,105,2.69,T-Mobile Park,9,-9
2020-09-14,2020,MIA,PHI,6,2,-119,-1.5,160,8.5,-105,-115,109,1.5,-180,4.62,Marlins Park,8,4
2020-09-14,2020,CIN,PIT,3,1,-255,-1.5,-110,6.0,100,-120,225,1.5,-110,4.31,Great American Ballpark,4,2
2020-09-14,2020,CIN,PIT,9,4,-148,-1.5,135,7.5,-105,-115,138,1.5,-155,4.48,Great American Ballpark,13,5
2020-09-14,2020,LAD,SD,2,7,-140,-1.5,115,7.5,-115,-105,130,1.5,-135,4.38,PETCO Park,9,-5
2020-09-14,2020,OAK,SEA,5,6,-152,-1.5,130,6.0,110,-130,142,1.5,-150,3.62,T-Mobile Park,11,-1
2020-09-14,2020,OAK,SEA,9,0,-170,-1.5,105,7.0,-125,105,160,1.5,-125,4.41,T-Mobile Park,9,9
2020-09-14,2020,MIL,STL,2,1,-114,-1.5,195,6.5,-115,-105,104,1.5,-220,3.46,Miller Park,3,1
2020-09-14,2020,MIL,STL,2,3,-200,-1.5,105,6.5,-105,-115,180,1.5,-125,4.33,Miller Park,5,-1
2020-09-15,2020,LAA,ARI,8,9,-145,-1.5,130,10.0,-120,100,135,1.5,-150,5.92,Angel Stadium,17,-1
2020-09-15,2020,BAL,ATL,1,5,160,1.5,-105,10.5,100,-120,-170,-1.5,-115,4.04,Camden Yards,6,-4
2020-09-15,2020,ATL,BAL,5,1,-170,-1.5,-115,10.5,100,-120,160,1.5,-105,6.61,Camden Yards,6,4
2020-09-15,2020,MIA,BOS,0,2,-158,-1.5,115,9.0,-120,100,148,1.5,-135,5.51,Marlins Park,2,-2
2020-09-15,2020,CLE,CHC,5,6,144,1.5,-145,8.0,-120,100,-154,-1.5,125,3.28,Wrigley Field,11,-1
2020-09-15,2020,PIT,CIN,1,4,126,1.5,-160,9.0,-110,-110,-136,-1.5,140,3.98,Great American Ballpark,5,-3
2020-09-15,2020,CHC,CLE,6,5,-154,-1.5,125,8.0,-120,100,144,1.5,-145,4.85,Wrigley Field,11,1
2020-09-15,2020,OAK,COL,1,3,-132,-1.5,100,12.0,-105,-115,122,1.5,-120,6.83,Coors Field,4,-2
2020-09-15,2020,MIN,CWS,2,6,114,1.5,-175,9.0,-110,-110,-124,-1.5,155,4.21,Guaranteed Rate Field,8,-4
2020-09-15,2020,KC,DET,0,6,105,-1.5,155,8.5,-120,100,-115,1.5,-175,4.15,Comerica Park,6,-6
2020-09-15,2020,TEX,HOU,1,4,178,1.5,-110,9.0,-115,-105,-196,-1.5,-110,3.24,Minute Maid Park,5,-3
2020-09-15,2020,DET,KC,6,0,-115,1.5,-175,8.5,-120,100,105,-1.5,155,4.55,Comerica Park,6,6
2020-09-15,2020,ARI,LAA,9,8,135,1.5,-150,10.0,-120,100,-145,-1.5,130,4.26,Angel Stadium,17,1
2020-09-15,2020,SD,LAD,1,3,118,1.5,-145,8.5,-130,110,-128,-1.5,125,3.9,PETCO Park,4,-2
2020-09-15,2020,BOS,MIA,2,0,148,1.5,-135,9.0,-120,100,-158,-1.5,115,3.63,Marlins Park,2,2
2020-09-15,2020,STL,MIL,3,18,-133,-1.5,125,8.5,-115,-105,123,1.5,-145,4.85,Miller Park,21,-15
2020-09-15,2020,CWS,MIN,6,2,-124,-1.5,155,9.0,-110,-110,114,1.5,-175,4.98,Guaranteed Rate Field,8,4
2020-09-15,2020,PHI,NYM,4,1,107,1.5,-155,9.5,-120,100,-117,-1.5,135,4.59,Citizens Bank Park,5,3
2020-09-15,2020,TOR,NYY,6,20,150,1.5,-135,9.0,-115,-105,-160,-1.5,115,3.6,Yankee Stadium,26,-14
2020-09-15,2020,COL,OAK,3,1,122,1.5,-120,12.0,-105,-115,-132,-1.5,100,5.41,Coors Field,4,2
2020-09-15,2020,NYM,PHI,1,4,-117,-1.5,135,9.5,-120,100,107,1.5,-155,5.12,Citizens Bank Park,5,-3
2020-09-15,2020,CIN,PIT,4,1,-136,-1.5,140,9.0,-110,-110,126,1.5,-160,5.19,Great American Ballpark,5,3
2020-09-15,2020,LAD,SD,3,1,-128,-1.5,125,8.5,-130,110,118,1.5,-145,4.77,PETCO Park,4,2
2020-09-15,2020,MIL,STL,18,3,123,1.5,-145,8.5,-115,-105,-133,-1.5,125,3.81,Miller Park,21,15
2020-09-15,2020,WSH,TB,1,6,163,1.5,-120,9.0,-105,-115,-176,-1.5,100,3.42,Tropicana Field,7,-5
2020-09-15,2020,HOU,TEX,4,1,-196,-1.5,-110,9.0,-115,-105,178,1.5,-110,5.96,Minute Maid Park,5,3
2020-09-15,2020,NYY,TOR,20,6,-160,-1.5,115,9.0,-115,-105,150,1.5,-135,5.54,Yankee Stadium,26,14
2020-09-15,2020,TB,WSH,6,1,-176,-1.5,100,9.0,-105,-115,163,1.5,-120,5.74,Tropicana Field,7,5
2020-09-16,2020,LAA,ARI,6,9,-190,-1.5,100,9.0,100,-120,175,1.5,-120,5.9,Angel Stadium,15,-3
2020-09-16,2020,BAL,ATL,5,1,165,1.5,100,10.0,-115,-105,-180,-1.5,-120,3.77,Camden Yards,6,4
2020-09-16,2020,ATL,BAL,1,5,-180,-1.5,-120,10.0,-115,-105,165,1.5,100,6.43,Camden Yards,6,-4
2020-09-16,2020,MIA,BOS,8,4,-125,-1.5,145,9.0,105,-125,115,1.5,-165,5.0,Marlins Park,12,4
2020-09-16,2020,CLE,CHC,2,3,-107,-1.5,140,8.0,-115,-105,-103,1.5,-160,4.14,Wrigley Field,5,-1
2020-09-16,2020,PIT,CIN,0,1,220,1.5,100,8.0,-115,-105,-250,-1.5,-120,2.5,Great American Ballpark,1,-1
2020-09-16,2020,CHC,CLE,3,2,-103,1.5,-160,8.0,-115,-105,-107,-1.5,140,4.06,Wrigley Field,5,1
2020-09-16,2020,OAK,COL,3,1,115,1.5,-175,11.5,-110,-110,-125,-1.5,155,5.35,Coors Field,4,2
2020-09-16,2020,MIN,CWS,5,1,143,1.5,-145,8.5,-120,100,-153,-1.5,125,3.5,Guaranteed Rate Field,6,4
2020-09-16,2020,KC,DET,4,0,-114,-1.5,135,9.0,100,-120,104,1.5,-155,4.79,Comerica Park,4,4
2020-09-16,2020,TEX,HOU,1,0,205,1.5,100,9.0,-105,-115,-230,-1.5,-120,2.95,Minute Maid Park,1,1
2020-09-16,2020,DET,KC,0,4,104,1.5,-155,9.0,100,-120,-114,-1.5,135,4.41,Comerica Park,4,-4
2020-09-16,2020,ARI,LAA,9,6,175,1.5,-120,9.0,100,-120,-190,-1.5,100,3.27,Angel Stadium,15,3
2020-09-16,2020,SD,LAD,5,7,104,1.5,-160,9.0,-115,-105,-114,-1.5,140,4.41,PETCO Park,12,-2
2020-09-16,2020,BOS,MIA,4,8,115,1.5,-165,9.0,105,-125,-125,-1.5,145,4.19,Marlins Park,12,-4
2020-09-16,2020,STL,MIL,4,2,140,1.5,-180,6.0,105,-125,-150,-1.5,160,2.5,Miller Park,6,2
2020-09-16,2020,STL,MIL,0,6,160,1.5,-145,7.0,100,-120,-170,-1.5,125,2.69,Miller Park,6,-6
2020-09-16,2020,CWS,MIN,1,5,-153,-1.5,125,8.5,-120,100,143,1.5,-145,5.14,Guaranteed Rate Field,6,-4
2020-09-16,2020,PHI,NYM,4,5,163,1.5,-115,7.5,-105,-115,-176,-1.5,-105,2.85,Citizens Bank Park,9,-1
2020-09-16,2020,TOR,NYY,2,13,240,1.5,115,8.5,-125,105,-270,-1.5,-135,2.5,Yankee Stadium,15,-11
2020-09-16,2020,COL,OAK,1,3,-125,-1.5,155,11.5,-110,-110,115,1.5,-175,6.39,Coors Field,4,-2
2020-09-16,2020,NYM,PHI,5,4,-176,-1.5,-105,7.5,-105,-115,163,1.5,-115,4.78,Citizens Bank Park,9,1
2020-09-16,2020,CIN,PIT,1,0,-250,-1.5,-120,8.0,-115,-105,220,1.5,100,5.71,Great American Ballpark,1,1
2020-09-16,2020,LAD,SD,7,5,-114,-1.5,140,9.0,-115,-105,104,1.5,-160,4.79,PETCO Park,12,2
2020-09-16,2020,SF,SEA,9,3,-152,-1.5,100,8.5,-120,100,142,1.5,-120,5.13,AT&T Park,12,6
2020-09-16,2020,SEA,SF,3,9,142,1.5,-120,8.5,-120,100,-152,-1.5,100,3.51,AT&T Park,12,-6
2020-09-16,2020,MIL,STL,2,4,-150,-1.5,160,6.0,105,-125,140,1.5,-180,3.6,Miller Park,6,-2
2020-09-16,2020,MIL,STL,6,0,-170,-1.5,125,7.0,100,-120,160,1.5,-145,4.41,Miller Park,6,6
2020-09-16,2020,WSH,TB,4,2,164,1.5,-120,9.0,-115,-105,-178,-1.5,100,3.41,Tropicana Field,6,2
2020-09-16,2020,HOU,TEX,0,1,-230,-1.5,-120,9.0,-105,-115,205,1.5,100,6.27,Minute Maid Park,1,-1
2020-09-16,2020,NYY,TOR,13,2,-270,-1.5,-135,8.5,-125,105,240,1.5,115,6.2,Yankee Stadium,15,11
2020-09-16,2020,TB,WSH,2,4,-178,-1.5,100,9.0,-115,-105,164,1.5,-120,5.76,Tropicana Field,6,-2
2020-09-17,2020,LAA,ARI,7,3,-165,-1.5,110,10.0,100,-120,155,1.5,-130,6.23,Angel Stadium,10,4
2020-09-17,2020,TB,BAL,3,1,-180,-1.5,105,6.0,105,-125,165,1.5,-125,3.86,Camden Yards,4,2
2020-09-17,2020,TB,BAL,10,6,-172,-1.5,120,7.5,100,-120,161,1.5,-140,4.74,Camden Yards,16,4
2020-09-17,2020,MIA,BOS,3,5,-102,-1.5,180,9.5,-105,-115,-108,1.5,-205,4.8,Marlins Park,8,-2
2020-09-17,2020,DET,CLE,3,10,240,1.5,130,7.0,-115,-105,-270,-1.5,-150,2.06,Comerica Park,13,-7
2020-09-17,2020,LAD,COL,9,3,-157,-1.5,-115,12.0,-110,-110,147,1.5,-105,7.33,Coors Field,12,6
2020-09-17,2020,MIN,CWS,3,4,-161,-1.5,-110,8.5,-125,105,151,1.5,-110,5.24,Guaranteed Rate Field,7,-1
2020-09-17,2020,CLE,DET,10,3,-270,-1.5,-150,7.0,-115,-105,240,1.5,130,5.11,Comerica Park,13,7
2020-09-17,2020,TEX,HOU,1,2,220,1.5,110,9.0,-110,-110,-250,-1.5,-130,2.81,Minute Maid Park,3,-1
2020-09-17,2020,ARI,LAA,3,7,155,1.5,-130,10.0,100,-120,-165,-1.5,110,3.92,Angel Stadium,10,-4
2020-09-17,2020,COL,LAD,3,9,147,1.5,-105,12.0,-110,-110,-157,-1.5,-115,4.86,Coors Field,12,-6
2020-09-17,2020,BOS,MIA,5,3,-108,1.5,-205,9.5,-105,-115,-102,-1.5,180,4.93,Marlins Park,8,2
2020-09-17,2020,CWS,MIN,4,3,151,1.5,-110,8.5,-125,105,-161,-1.5,-110,3.39,Guaranteed Rate Field,7,1
2020-09-17,2020,PHI,NYM,6,10,-115,-1.5,165,8.0,-105,-115,105,1.5,-185,4.28,Citizens Bank Park,16,-4
2020-09-17,2020,TOR,NYY,7,10,200,1.5,105,9.5,-110,-110,-220,-1.5,-125,3.17,Yankee Stadium,17,-3
2020-09-17,2020,NYM,PHI,10,6,105,1.5,-185,8.0,-105,-115,-115,-1.5,165,3.9,Citizens Bank Park,16,4
2020-09-17,2020,STL,PIT,1,5,-152,-1.5,100,8.5,-115,-105,142,1.5,-120,5.13,PNC Park,6,-4
2020-09-17,2020,SF,SEA,6,4,-124,-1.5,125,9.0,-125,105,114,1.5,-145,4.98,AT&T Park,10,2
2020-09-17,2020,SEA,SF,4,6,114,1.5,-145,9.0,-125,105,-124,-1.5,125,4.21,AT&T Park,10,-2
2020-09-17,2020,PIT,STL,5,1,142,1.5,-120,8.5,-115,-105,-152,-1.5,100,3.51,PNC Park,6,4
2020-09-17,2020,BAL,TB,1,3,165,1.5,-125,6.0,105,-125,-180,-1.5,105,2.26,Camden Yards,4,-2
2020-09-17,2020,BAL,TB,6,10,161,1.5,-140,7.5,100,-120,-172,-1.5,120,2.87,Camden Yards,16,-4
2020-09-17,2020,HOU,TEX,2,1,-250,-1.5,-130,9.0,-110,-110,220,1.5,110,6.43,Minute Maid Park,3,1
2020-09-17,2020,NYY,TOR,10,7,-220,-1.5,-125,9.5,-110,-110,200,1.5,105,6.53,Yankee Stadium,17,3
2020-09-18,2020,HOU,ARI,3,6,-142,-1.5,-165,7.5,-115,-105,165,1.5,100,4.4,Minute Maid Park,9,-3
2020-09-18,2020,NYM,ATL,2,15,220,1.5,145,8.5,-120,100,-172,-1.5,-110,2.66,Citi Field,17,-13
2020-09-18,2020,TB,BAL,2,1,-190,-1.5,-120,8.5,100,-120,210,1.5,145,5.57,Camden Yards,3,1
2020-09-18,2020,NYY,BOS,6,5,-190,-1.5,-110,10.5,-110,-110,148,1.5,-140,6.88,Fenway Park,11,1
2020-09-18,2020,MIN,CHC,0,1,113,1.5,-165,7.0,-120,100,-116,-1.5,185,3.29,Wrigley Field,1,-1
2020-09-18,2020,CWS,CIN,1,7,-155,-1.5,130,9.5,100,-120,161,1.5,-130,5.77,Great American Ballpark,8,-6
2020-09-18,2020,DET,CLE,0,1,105,1.5,-205,8.5,-105,-115,-125,-1.5,200,4.15,Comerica Park,1,-1
2020-09-18,2020,LAD,COL,15,6,-152,-1.5,145,13.0,-120,100,123,1.5,-145,7.84,Coors Field,21,9
2020-09-18,2020,CIN,CWS,7,1,161,1.5,-130,9.5,100,-120,-155,-1.5,130,3.64,Great American Ballpark,8,6
2020-09-18,2020,CLE,DET,1,0,-125,-1.5,200,8.5,-105,-115,105,1.5,-205,4.72,Comerica Park,1,1
2020-09-18,2020,ARI,HOU,6,3,165,1.5,100,7.5,-115,-105,-142,-1.5,-165,2.83,Minute Maid Park,9,3
2020-09-18,2020,MIL,KC,9,5,-180,-1.5,120,8.5,-120,100,158,1.5,-120,5.46,Miller Park,14,4
2020-09-18,2020,TEX,LAA,2,6,-126,-1.5,165,9.5,100,-120,143,1.5,-155,5.3,Angel Stadium,8,-4
2020-09-18,2020,COL,LAD,6,15,123,1.5,-145,13.0,-120,100,-152,-1.5,145,5.83,Coors Field,21,-9
2020-09-18,2020,WSH,MIA,5,0,-115,-1.5,180,6.5,-115,-105,175,1.5,-110,3.48,Marlins Park,5,5
2020-09-18,2020,WSH,MIA,3,14,170,1.5,-105,7.0,-120,100,-176,-1.5,-120,2.59,Marlins Park,17,-11
2020-09-18,2020,KC,MIL,5,9,158,1.5,-120,8.5,-120,100,-180,-1.5,120,3.29,Miller Park,14,-4
2020-09-18,2020,CHC,MIN,1,0,-116,-1.5,185,7.0,-120,100,113,1.5,-165,3.76,Wrigley Field,1,1
2020-09-18,2020,ATL,NYM,15,2,-172,-1.5,-110,8.5,-120,100,220,1.5,145,5.38,Citi Field,17,13
2020-09-18,2020,BOS,NYY,5,6,148,1.5,-140,10.5,-110,-110,-190,-1.5,-110,4.23,Fenway Park,11,-1
2020-09-18,2020,SF,OAK,0,6,-153,-1.5,135,8.5,-110,-110,140,1.5,-110,5.14,Oakland Coliseum,6,-6
2020-09-18,2020,TOR,PHI,0,7,-185,-1.5,-115,6.5,-120,100,175,1.5,121,4.22,Citizens Bank Park,7,-7
2020-09-18,2020,TOR,PHI,7,8,-115,-1.5,200,7.0,-120,100,140,1.5,-175,3.74,Citizens Bank Park,15,-1
2020-09-18,2020,STL,PIT,6,5,-125,-1.5,190,6.5,-120,100,145,1.5,-150,3.61,PNC Park,11,1
2020-09-18,2020,STL,PIT,7,2,-111,-1.5,200,7.0,105,-125,128,1.5,-150,3.32,PNC Park,9,5
2020-09-18,2020,SEA,SD,1,6,118,1.5,-170,8.5,-115,-105,-130,-1.5,130,3.9,PETCO Park,7,-5
2020-09-18,2020,SD,SEA,6,1,-130,-1.5,130,8.5,-115,-105,118,1.5,-170,4.8,PETCO Park,7,5
2020-09-18,2020,OAK,SF,6,0,140,1.5,-110,8.5,-110,-110,-153,-1.5,135,3.54,Oakland Coliseum,6,6
2020-09-18,2020,PIT,STL,5,6,145,1.5,-150,6.5,-120,100,-125,-1.5,190,2.65,PNC Park,11,-1
2020-09-18,2020,PIT,STL,2,7,128,1.5,-150,7.0,105,-125,-111,-1.5,200,3.07,PNC Park,9,-5
2020-09-18,2020,BAL,TB,1,2,210,1.5,145,8.5,100,-120,-190,-1.5,-120,2.74,Camden Yards,3,-1
2020-09-18,2020,LAA,TEX,6,2,143,1.5,-155,9.5,100,-120,-126,-1.5,165,3.91,Angel Stadium,8,4
2020-09-18,2020,PHI,TOR,7,0,175,1.5,121,6.5,-120,100,-185,-1.5,-115,2.36,Citizens Bank Park,7,7
2020-09-18,2020,PHI,TOR,8,7,140,1.5,-175,7.0,-120,100,-115,-1.5,200,2.92,Citizens Bank Park,15,1
2020-09-18,2020,MIA,WSH,0,5,175,1.5,-110,6.5,-115,-105,-115,-1.5,180,2.36,Marlins Park,5,-5
2020-09-18,2020,MIA,WSH,14,3,-176,-1.5,-120,7.0,-120,100,170,1.5,-105,4.46,Marlins Park,17,11
2020-09-19,2020,HOU,ARI,3,2,-166,-1.5,110,9.5,-105,-115,156,1.5,-130,5.93,Minute Maid Park,5,1
2020-09-19,2020,NYM,ATL,7,2,139,1.5,-120,9.0,-105,-115,-149,-1.5,100,3.77,Citi Field,9,5
2020-09-19,2020,TB,BAL,3,1,-220,-1.5,-135,8.0,-120,100,163,1.5,100,5.5,Camden Yards,4,2
2020-09-19,2020,NYY,BOS,8,0,-205,-1.5,-145,10.5,100,-120,185,1.5,125,7.06,Fenway Park,8,8
2020-09-19,2020,MIN,CHC,8,1,-123,-1.5,130,8.0,-115,-105,113,1.5,-150,4.41,Wrigley Field,9,7
2020-09-19,2020,CWS,CIN,5,0,-170,-1.5,110,8.0,-110,-110,160,1.5,-130,5.04,Great American Ballpark,5,5
2020-09-19,2020,DET,CLE,5,2,148,1.5,-110,8.0,100,-120,-158,-1.5,-110,3.23,Comerica Park,7,3
2020-09-19,2020,LAD,COL,6,1,-280,-1.5,-180,12.0,-115,-105,245,1.5,160,8.84,Coors Field,7,5
2020-09-19,2020,CIN,CWS,0,5,160,1.5,-130,8.0,-110,-110,-170,-1.5,110,3.08,Great American Ballpark,5,-5
2020-09-19,2020,CLE,DET,2,5,-158,-1.5,-110,8.0,100,-120,148,1.5,-110,4.9,Comerica Park,7,-3
2020-09-19,2020,ARI,HOU,2,3,156,1.5,-130,9.5,-105,-115,-166,-1.5,110,3.71,Minute Maid Park,5,-1
2020-09-19,2020,MIL,KC,5,0,-200,-1.5,-105,7.5,-120,100,180,1.5,-115,5.0,Miller Park,5,5
2020-09-19,2020,TEX,LAA,3,4,145,1.5,-150,7.5,105,-125,-155,-1.5,130,3.06,Angel Stadium,7,-1
2020-09-19,2020,COL,LAD,1,6,245,1.5,160,12.0,-115,-105,-280,-1.5,-180,3.48,Coors Field,7,-5
2020-09-19,2020,WSH,MIA,3,7,113,1.5,-180,7.5,-120,100,-123,-1.5,160,3.52,Marlins Park,10,-4
2020-09-19,2020,KC,MIL,0,5,180,1.5,-115,7.5,-120,100,-200,-1.5,-105,2.68,Miller Park,5,-5
2020-09-19,2020,CHC,MIN,1,8,113,1.5,-150,8.0,-115,-105,-123,-1.5,130,3.76,Wrigley Field,9,-7
2020-09-19,2020,ATL,NYM,2,7,-149,-1.5,100,9.0,-105,-115,139,1.5,-120,5.39,Citi Field,9,-5
2020-09-19,2020,BOS,NYY,0,8,185,1.5,125,10.5,100,-120,-205,-1.5,-145,3.68,Fenway Park,8,-8
2020-09-19,2020,SF,OAK,0,6,-106,1.5,-230,8.0,100,-120,-102,-1.5,200,4.12,Oakland Coliseum,6,-6
2020-09-19,2020,TOR,PHI,1,3,-200,-1.5,-125,8.0,-110,-110,180,1.5,105,5.33,Citizens Bank Park,4,-2
2020-09-19,2020,STL,PIT,5,4,-164,-1.5,-105,8.0,-125,105,154,1.5,-115,4.97,PNC Park,9,1
2020-09-19,2020,SEA,SD,4,1,150,1.5,-115,8.5,-120,100,-160,-1.5,-105,3.4,PETCO Park,5,3
2020-09-19,2020,SD,SEA,1,4,-160,-1.5,-105,8.5,-120,100,150,1.5,-115,5.23,PETCO Park,5,-3
2020-09-19,2020,OAK,SF,6,0,-102,-1.5,200,8.0,100,-120,-106,1.5,-230,4.04,Oakland Coliseum,6,6
2020-09-19,2020,PIT,STL,4,5,154,1.5,-115,8.0,-125,105,-164,-1.5,-105,3.15,PNC Park,9,-1
2020-09-19,2020,BAL,TB,1,3,163,1.5,100,8.0,-120,100,-220,-1.5,-135,3.04,Camden Yards,4,-2
2020-09-19,2020,LAA,TEX,4,3,-155,-1.5,130,7.5,105,-125,145,1.5,-150,4.56,Angel Stadium,7,1
2020-09-19,2020,PHI,TOR,3,1,180,1.5,105,8.0,-110,-110,-200,-1.5,-125,2.86,Citizens Bank Park,4,2
2020-09-19,2020,MIA,WSH,7,3,-123,-1.5,160,7.5,-120,100,113,1.5,-180,4.14,Marlins Park,10,4
2020-09-20,2020,HOU,ARI,3,2,-200,-1.5,100,9.5,105,-125,180,1.5,-120,6.33,Minute Maid Park,5,1
2020-09-20,2020,NYM,ATL,0,7,-118,-1.5,160,9.5,100,-120,108,1.5,-180,5.14,Citi Field,7,-7
2020-09-20,2020,TB,BAL,1,2,-152,-1.5,100,8.5,100,-120,142,1.5,-120,5.13,Camden Yards,3,-1
2020-09-20,2020,NYY,BOS,2,10,-196,-1.5,-130,9.0,-115,-105,178,1.5,110,5.96,Fenway Park,12,-8
2020-09-20,2020,MIN,CHC,4,0,143,1.5,-155,7.5,100,-120,-153,-1.5,135,3.09,Wrigley Field,4,4
2020-09-20,2020,CWS,CIN,3,7,120,1.5,-180,9.5,-105,-115,-130,-1.5,160,4.32,Great American Ballpark,10,-4
2020-09-20,2020,DET,CLE,4,7,177,1.5,-105,7.5,100,-120,-194,-1.5,-115,2.71,Comerica Park,11,-3
2020-09-20,2020,LAD,COL,3,6,-200,-1.5,-140,12.0,-110,-110,180,1.5,120,8.0,Coors Field,9,-3
2020-09-20,2020,CIN,CWS,7,3,-130,-1.5,160,9.5,-105,-115,120,1.5,-180,5.37,Great American Ballpark,10,4
2020-09-20,2020,CLE,DET,7,4,-194,-1.5,-115,7.5,100,-120,177,1.5,-105,4.95,Comerica Park,11,3
2020-09-20,2020,ARI,HOU,2,3,180,1.5,-120,9.5,105,-125,-200,-1.5,100,3.39,Minute Maid Park,5,-1
2020-09-20,2020,MIL,KC,5,3,-155,-1.5,125,8.5,-105,-115,145,1.5,-145,5.17,Miller Park,8,2
2020-09-20,2020,TEX,LAA,7,2,140,1.5,-150,10.0,-120,100,-150,-1.5,130,4.17,Angel Stadium,9,5
2020-09-20,2020,COL,LAD,6,3,180,1.5,120,12.0,-110,-110,-200,-1.5,-140,4.29,Coors Field,9,3
2020-09-20,2020,WSH,MIA,1,2,-140,-1.5,145,6.0,100,-120,130,1.5,-165,3.5,Marlins Park,3,-1
2020-09-20,2020,WSH,MIA,15,0,125,1.5,-175,7.0,-120,100,-135,-1.5,155,3.11,Marlins Park,15,15
2020-09-20,2020,KC,MIL,3,5,145,1.5,-145,8.5,-105,-115,-155,-1.5,125,3.47,Miller Park,8,-2
2020-09-20,2020,CHC,MIN,0,4,-153,-1.5,135,7.5,100,-120,143,1.5,-155,4.54,Wrigley Field,4,-4
2020-09-20,2020,ATL,NYM,7,0,108,1.5,-180,9.5,100,-120,-118,-1.5,160,4.57,Citi Field,7,7
2020-09-20,2020,BOS,NYY,10,2,178,1.5,110,9.0,-115,-105,-196,-1.5,-130,3.24,Fenway Park,12,8
2020-09-20,2020,SF,OAK,14,2,162,1.5,-140,9.0,-110,-110,-174,-1.5,120,3.44,Oakland Coliseum,16,12
2020-09-20,2020,TOR,PHI,6,3,-110,1.5,-210,9.5,-105,-115,100,-1.5,185,4.98,Citizens Bank Park,9,3
2020-09-20,2020,STL,PIT,2,1,-160,-1.5,100,7.5,-105,-115,150,1.5,-120,4.62,PNC Park,3,1
2020-09-20,2020,SEA,SD,4,7,245,1.5,145,8.5,-120,100,-280,-1.5,-165,2.46,PETCO Park,11,-3
2020-09-20,2020,SD,SEA,7,4,-280,-1.5,-165,8.5,-120,100,245,1.5,145,6.26,PETCO Park,11,3
2020-09-20,2020,OAK,SF,2,14,-174,-1.5,120,9.0,-110,-110,162,1.5,-140,5.72,Oakland Coliseum,16,-12
2020-09-20,2020,PIT,STL,1,2,150,1.5,-120,7.5,-105,-115,-160,-1.5,100,3.0,PNC Park,3,-1
2020-09-20,2020,BAL,TB,2,1,142,1.5,-120,8.5,100,-120,-152,-1.5,100,3.51,Camden Yards,3,1
2020-09-20,2020,LAA,TEX,2,7,-150,-1.5,130,10.0,-120,100,140,1.5,-150,6.0,Angel Stadium,9,-5
2020-09-20,2020,PHI,TOR,3,6,100,-1.5,185,9.5,-105,-115,-110,1.5,-210,4.75,Citizens Bank Park,9,-3
2020-09-20,2020,MIA,WSH,2,1,130,1.5,-165,6.0,100,-120,-140,-1.5,145,2.61,Marlins Park,3,1
2020-09-20,2020,MIA,WSH,0,15,-135,-1.5,155,7.0,-120,100,125,1.5,-175,4.02,Marlins Park,15,-15
2020-09-21,2020,MIA,ATL,4,5,151,1.5,-130,9.5,-115,-105,-161,-1.5,110,3.78,Suntrust Park,9,-1
2020-09-21,2020,PIT,CHC,0,5,136,1.5,-130,8.5,-110,-110,-146,-1.5,110,3.6,PNC Park,5,-5
2020-09-21,2020,MIL,CIN,3,6,114,1.5,-185,7.0,-115,-105,-124,-1.5,165,3.27,Great American Ballpark,9,-3
2020-09-21,2020,CWS,CLE,4,7,-101,1.5,-190,8.0,-120,100,-109,-1.5,170,4.02,Progressive Field,11,-3
2020-09-21,2020,SF,COL,2,7,-118,-1.5,160,8.0,-105,-115,108,1.5,-180,4.33,AT&T Park,9,-5
2020-09-21,2020,CLE,CWS,7,4,-109,-1.5,170,8.0,-120,100,-101,1.5,-190,4.17,Progressive Field,11,3
2020-09-21,2020,SEA,HOU,6,1,114,1.5,-145,8.0,-120,100,-124,-1.5,125,3.74,T-Mobile Park,7,5
2020-09-21,2020,STL,KC,1,4,-185,-1.5,-125,9.0,-110,-110,170,1.5,105,5.84,Kauffman Stadium,5,-3
2020-09-21,2020,TEX,LAA,5,8,190,1.5,-110,8.5,-120,100,-210,-1.5,-110,2.93,Angel Stadium,13,-3
2020-09-21,2020,ATL,MIA,5,4,-161,-1.5,110,9.5,-115,-105,151,1.5,-130,5.86,Suntrust Park,9,1
2020-09-21,2020,CIN,MIL,6,3,-124,-1.5,165,7.0,-115,-105,114,1.5,-185,3.88,Great American Ballpark,9,3
2020-09-21,2020,TB,NYM,2,1,165,1.5,-135,7.0,100,-120,-180,-1.5,115,2.64,Citi Field,3,1
2020-09-21,2020,TOR,NYY,11,5,133,1.5,-125,11.0,100,-120,-143,-1.5,105,4.72,Sahlen Field,16,6
2020-09-21,2020,WSH,PHI,5,1,145,1.5,-115,8.5,-110,-110,-155,-1.5,-105,3.47,Nationals Park,6,4
2020-09-21,2020,CHC,PIT,5,0,-146,-1.5,110,8.5,-110,-110,136,1.5,-130,5.04,PNC Park,5,5
2020-09-21,2020,HOU,SEA,1,6,-124,-1.5,125,8.0,-120,100,114,1.5,-145,4.43,T-Mobile Park,7,-5
2020-09-21,2020,COL,SF,7,2,108,1.5,-180,8.0,-105,-115,-118,-1.5,160,3.85,AT&T Park,9,5
2020-09-21,2020,KC,STL,4,1,170,1.5,105,9.0,-110,-110,-185,-1.5,-125,3.33,Kauffman Stadium,5,3
2020-09-21,2020,NYM,TB,1,2,-180,-1.5,115,7.0,100,-120,165,1.5,-135,4.5,Citi Field,3,-1
2020-09-21,2020,LAA,TEX,8,5,-210,-1.5,-110,8.5,-120,100,190,1.5,-110,5.76,Angel Stadium,13,3
2020-09-21,2020,NYY,TOR,5,11,-143,-1.5,105,11.0,100,-120,133,1.5,-125,6.47,Sahlen Field,16,-6
2020-09-21,2020,PHI,WSH,1,5,-155,-1.5,-105,8.5,-110,-110,145,1.5,-115,5.17,Nationals Park,6,-4
2020-09-22,2020,TEX,ARI,0,7,147,1.5,-145,9.5,-110,-110,-157,-1.5,125,3.85,Chase Field,7,-7
2020-09-22,2020,MIA,ATL,1,11,150,1.5,-135,10.5,-105,-115,-160,-1.5,115,4.2,Suntrust Park,12,-10
2020-09-22,2020,BOS,BAL,8,3,-111,-1.5,160,9.5,-105,-115,101,1.5,-180,5.0,Fenway Park,11,5
2020-09-22,2020,BAL,BOS,3,8,101,1.5,-180,9.5,-105,-115,-111,-1.5,160,4.73,Fenway Park,11,-5
2020-09-22,2020,PIT,CHC,3,2,145,1.5,-120,8.5,-110,-110,-155,-1.5,100,3.47,PNC Park,5,1
2020-09-22,2020,MIL,CIN,3,2,142,1.5,-150,9.0,100,-120,-152,-1.5,130,3.72,Great American Ballpark,5,1
2020-09-22,2020,CWS,CLE,3,5,112,1.5,-175,9.5,100,-120,-122,-1.5,155,4.48,Progressive Field,8,-2
2020-09-22,2020,SF,COL,5,2,-160,-1.5,135,7.5,-115,-105,150,1.5,-155,4.62,AT&T Park,7,3
2020-09-22,2020,CLE,CWS,5,3,-122,-1.5,155,9.5,100,-120,112,1.5,-175,5.22,Progressive Field,8,2
2020-09-22,2020,MIN,DET,5,4,-180,-1.5,105,9.0,-105,-115,165,1.5,-125,5.79,Target Field,9,1
2020-09-22,2020,SEA,HOU,1,6,178,1.5,100,9.0,-105,-115,-196,-1.5,-120,3.24,T-Mobile Park,7,-5
2020-09-22,2020,STL,KC,5,0,-103,-1.5,150,8.5,-110,-110,-107,1.5,-170,4.31,Kauffman Stadium,5,5
2020-09-22,2020,SD,LAA,2,4,-159,-1.5,115,9.0,-105,-115,149,1.5,-135,5.53,PETCO Park,6,-2
2020-09-22,2020,OAK,LAD,2,7,163,1.5,-130,9.0,-105,-115,-176,-1.5,110,3.42,Dodger Stadium,9,-5
2020-09-22,2020,ATL,MIA,11,1,-160,-1.5,115,10.5,-105,-115,150,1.5,-135,6.46,Suntrust Park,12,10
2020-09-22,2020,CIN,MIL,2,3,-152,-1.5,130,9.0,100,-120,142,1.5,-150,5.43,Great American Ballpark,5,-1
2020-09-22,2020,DET,MIN,4,5,165,1.5,-125,9.0,-105,-115,-180,-1.5,105,3.4,Target Field,9,-1
2020-09-22,2020,TB,NYM,2,5,-135,-1.5,125,7.5,-105,-115,125,1.5,-145,4.31,Citi Field,7,-3
2020-09-22,2020,TOR,NYY,1,12,240,1.5,155,9.5,-105,-115,-270,-1.5,-175,2.79,Sahlen Field,13,-11
2020-09-22,2020,LAD,OAK,7,2,-176,-1.5,110,9.0,-105,-115,163,1.5,-130,5.74,Dodger Stadium,9,5
2020-09-22,2020,WSH,PHI,5,1,180,1.5,-110,6.5,-115,-105,-200,-1.5,-110,2.32,Nationals Park,6,4
2020-09-22,2020,WSH,PHI,8,7,117,1.5,-160,8.0,-125,105,-127,-1.5,140,3.69,Nationals Park,15,1
2020-09-22,2020,CHC,PIT,2,3,-155,-1.5,100,8.5,-110,-110,145,1.5,-120,5.17,PNC Park,5,-1
2020-09-22,2020,LAA,SD,4,2,149,1.5,-135,9.0,-105,-115,-159,-1.5,115,3.61,PETCO Park,6,2
2020-09-22,2020,HOU,SEA,6,1,-196,-1.5,-120,9.0,-105,-115,178,1.5,100,5.96,T-Mobile Park,7,5
2020-09-22,2020,COL,SF,2,5,150,1.5,-155,7.5,-115,-105,-160,-1.5,135,3.0,AT&T Park,7,-3
2020-09-22,2020,KC,STL,0,5,-107,1.5,-170,8.5,-110,-110,-103,-1.5,150,4.39,Kauffman Stadium,5,-5
2020-09-22,2020,NYM,TB,5,2,125,1.5,-145,7.5,-105,-115,-135,-1.5,125,3.33,Citi Field,7,3
2020-09-22,2020,ARI,TEX,7,0,-157,-1.5,125,9.5,-110,-110,147,1.5,-145,5.8,Chase Field,7,7
2020-09-22,2020,NYY,TOR,12,1,-270,-1.5,-175,9.5,-105,-115,240,1.5,155,6.93,Sahlen Field,13,11
2020-09-22,2020,PHI,WSH,1,5,-200,-1.5,-110,6.5,-115,-105,180,1.5,-110,4.33,Nationals Park,6,-4
2020-09-22,2020,PHI,WSH,7,8,-127,-1.5,140,8.0,-125,105,117,1.5,-160,4.48,Nationals Park,15,-1
2020-09-23,2020,TEX,ARI,3,7,139,1.5,-145,9.0,-120,100,-149,-1.5,125,3.77,Chase Field,10,-4
2020-09-23,2020,MIA,ATL,4,9,158,1.5,-145,8.0,-115,-105,-168,-1.5,125,3.1,Suntrust Park,13,-5
2020-09-23,2020,BOS,BAL,9,1,-165,-1.5,120,9.0,-105,-115,155,1.5,-140,5.6,Fenway Park,10,8
2020-09-23,2020,BAL,BOS,1,9,155,1.5,-140,9.0,-105,-115,-165,-1.5,120,3.53,Fenway Park,10,-8
2020-09-23,2020,PIT,CHC,2,1,210,1.5,130,8.5,-115,-105,-240,-1.5,-150,2.74,PNC Park,3,1
2020-09-23,2020,MIL,CIN,1,6,158,1.5,-140,8.5,-115,-105,-168,-1.5,120,3.29,Great American Ballpark,7,-5
2020-09-23,2020,CWS,CLE,2,3,154,1.5,-155,6.5,-120,100,-164,-1.5,135,2.56,Progressive Field,5,-1
2020-09-23,2020,SF,COL,7,2,-185,-1.5,105,9.0,-125,105,170,1.5,-125,5.84,AT&T Park,9,5
2020-09-23,2020,CLE,CWS,3,2,-164,-1.5,135,6.5,-120,100,154,1.5,-155,4.04,Progressive Field,5,1
2020-09-23,2020,MIN,DET,7,6,-330,-1.5,-150,8.0,-120,100,285,1.5,130,6.14,Target Field,13,1
2020-09-23,2020,SEA,HOU,3,2,185,1.5,105,8.5,-105,-115,-205,-1.5,-125,2.98,T-Mobile Park,5,1
2020-09-23,2020,STL,KC,3,12,-127,-1.5,125,9.0,100,-120,117,1.5,-145,5.04,Kauffman Stadium,15,-9
2020-09-23,2020,SD,LAA,2,5,-162,-1.5,115,8.5,-110,-110,152,1.5,-135,5.26,PETCO Park,7,-3
2020-09-23,2020,OAK,LAD,6,4,154,1.5,-140,8.5,-125,105,-164,-1.5,120,3.35,Dodger Stadium,10,2
2020-09-23,2020,ATL,MIA,9,4,-168,-1.5,125,8.0,-115,-105,158,1.5,-145,5.01,Suntrust Park,13,5
2020-09-23,2020,CIN,MIL,6,1,-168,-1.5,120,8.5,-115,-105,158,1.5,-140,5.33,Great American Ballpark,7,5
2020-09-23,2020,DET,MIN,6,7,285,1.5,130,8.0,-120,100,-330,-1.5,-150,2.08,Target Field,13,-1
2020-09-23,2020,TB,NYM,8,5,-145,-1.5,105,8.5,-105,-115,135,1.5,-125,5.03,Citi Field,13,3
2020-09-23,2020,TOR,NYY,14,1,195,1.5,130,10.5,-120,100,-215,-1.5,-150,3.56,Sahlen Field,15,13
2020-09-23,2020,LAD,OAK,4,6,-164,-1.5,120,8.5,-125,105,154,1.5,-140,5.28,Dodger Stadium,10,-2
2020-09-23,2020,WSH,PHI,3,12,150,1.5,-110,9.5,100,-120,-160,-1.5,-110,3.8,Nationals Park,15,-9
2020-09-23,2020,CHC,PIT,1,2,-240,-1.5,-150,8.5,-115,-105,210,1.5,130,6.0,PNC Park,3,-1
2020-09-23,2020,LAA,SD,5,2,152,1.5,-135,8.5,-110,-110,-162,-1.5,115,3.37,PETCO Park,7,3
2020-09-23,2020,HOU,SEA,2,3,-205,-1.5,-125,8.5,-105,-115,185,1.5,105,5.71,T-Mobile Park,5,-1
2020-09-23,2020,COL,SF,2,7,170,1.5,-125,9.0,-125,105,-185,-1.5,105,3.33,AT&T Park,9,-5
2020-09-23,2020,KC,STL,12,3,117,1.5,-145,9.0,100,-120,-127,-1.5,125,4.15,Kauffman Stadium,15,9
2020-09-23,2020,NYM,TB,5,8,135,1.5,-125,8.5,-105,-115,-145,-1.5,105,3.62,Citi Field,13,-3
2020-09-23,2020,ARI,TEX,7,3,-149,-1.5,125,9.0,-120,100,139,1.5,-145,5.39,Chase Field,10,4
2020-09-23,2020,NYY,TOR,1,14,-215,-1.5,-150,10.5,-120,100,195,1.5,130,7.17,Sahlen Field,15,-13
2020-09-23,2020,PHI,WSH,12,3,-160,-1.5,-110,9.5,100,-120,150,1.5,-110,5.85,Nationals Park,15,9
2020-09-24,2020,MIA,ATL,4,2,154,1.5,-140,9.0,-105,-115,-164,-1.5,120,3.54,Suntrust Park,6,2
2020-09-24,2020,BOS,BAL,1,13,-155,-1.5,115,9.5,-110,-110,145,1.5,-135,5.77,Fenway Park,14,-12
2020-09-24,2020,BAL,BOS,13,1,145,1.5,-135,9.5,-110,-110,-155,-1.5,115,3.88,Fenway Park,14,12
2020-09-24,2020,PIT,CHC,7,0,147,1.5,-105,9.0,-105,-115,-157,-1.5,-115,3.64,PNC Park,7,7
2020-09-24,2020,CWS,CLE,4,5,120,1.5,-185,7.5,-110,-110,-130,-1.5,165,3.41,Progressive Field,9,-1
2020-09-24,2020,SF,COL,4,5,-240,-1.5,-125,9.0,100,-120,210,1.5,105,6.35,AT&T Park,9,-1
2020-09-24,2020,CLE,CWS,5,4,-130,-1.5,165,7.5,-110,-110,120,1.5,-185,4.24,Progressive Field,9,1
2020-09-24,2020,KC,DET,8,7,-156,-1.5,120,9.0,-105,-115,146,1.5,-140,5.48,Kauffman Stadium,15,1
2020-09-24,2020,TEX,HOU,4,12,109,1.5,-150,8.0,-115,-105,-119,-1.5,130,3.83,Globe Life Field,16,-8
2020-09-24,2020,DET,KC,7,8,146,1.5,-140,9.0,-105,-115,-156,-1.5,120,3.66,Kauffman Stadium,15,-1
2020-09-24,2020,OAK,LAD,1,5,200,1.5,-105,9.0,-115,-105,-220,-1.5,-115,3.0,Dodger Stadium,6,-4
2020-09-24,2020,ATL,MIA,2,4,-164,-1.5,120,9.0,-105,-115,154,1.5,-140,5.59,Suntrust Park,6,-2
2020-09-24,2020,STL,MIL,4,2,130,1.5,-140,7.0,-115,-105,-140,-1.5,120,3.04,Busch Stadium,6,2
2020-09-24,2020,WSH,NYM,2,3,-128,-1.5,155,9.0,-105,-115,118,1.5,-175,5.05,Nationals Park,5,-1
2020-09-24,2020,TOR,NYY,4,1,103,-1.5,185,9.5,100,-120,-113,1.5,-210,4.68,Sahlen Field,5,3
2020-09-24,2020,LAD,OAK,5,1,-220,-1.5,-115,9.0,-115,-105,200,1.5,-105,6.19,Dodger Stadium,6,4
2020-09-24,2020,CHC,PIT,0,7,-157,-1.5,-115,9.0,-105,-115,147,1.5,-105,5.5,PNC Park,7,-7
2020-09-24,2020,COL,SF,5,4,210,1.5,105,9.0,100,-120,-240,-1.5,-125,2.9,AT&T Park,9,1
2020-09-24,2020,MIL,STL,2,4,-140,-1.5,120,7.0,-115,-105,130,1.5,-140,4.08,Busch Stadium,6,-2
2020-09-24,2020,HOU,TEX,12,4,-119,-1.5,130,8.0,-115,-105,109,1.5,-150,4.35,Globe Life Field,16,8
2020-09-24,2020,NYY,TOR,1,4,-113,1.5,-210,9.5,100,-120,103,-1.5,185,5.04,Sahlen Field,5,-3
2020-09-24,2020,NYM,WSH,3,2,118,1.5,-175,9.0,-105,-115,-128,-1.5,155,4.13,Nationals Park,5,1
2020-09-25,2020,COL,ARI,0,4,156,1.5,-160,6.0,100,-120,-166,-1.5,140,2.34,Chase Field,4,-4
2020-09-25,2020,COL,ARI,5,11,125,1.5,-175,7.5,100,-120,-135,-1.5,155,3.33,Chase Field,16,-6
2020-09-25,2020,BOS,ATL,7,8,156,1.5,-130,9.5,-115,-105,-166,-1.5,110,3.71,Suntrust Park,15,-1
2020-09-25,2020,TOR,BAL,10,5,-164,-1.5,115,9.5,-115,-105,154,1.5,-135,5.9,Sahlen Field,15,5
2020-09-25,2020,ATL,BOS,8,7,-166,-1.5,110,9.5,-115,-105,156,1.5,-130,5.93,Suntrust Park,15,1
2020-09-25,2020,CWS,CHC,0,10,156,1.5,-110,8.0,-120,100,-166,-1.5,-110,3.13,Guaranteed Rate Field,10,-10
2020-09-25,2020,MIN,CIN,2,7,-154,-1.5,130,8.5,-105,-115,144,1.5,-150,5.15,Target Field,9,-5
2020-09-25,2020,PIT,CLE,3,4,210,1.5,100,7.5,-115,-105,-240,-1.5,-120,2.42,Progressive Field,7,-1
2020-09-25,2020,ARI,COL,4,0,-166,-1.5,140,6.0,100,-120,156,1.5,-160,3.74,Chase Field,4,4
2020-09-25,2020,ARI,COL,11,5,-135,-1.5,155,7.5,100,-120,125,1.5,-175,4.31,Chase Field,16,6
2020-09-25,2020,CHC,CWS,10,0,-166,-1.5,-110,8.0,-120,100,156,1.5,-110,4.99,Guaranteed Rate Field,10,10
2020-09-25,2020,KC,DET,3,2,-150,-1.5,120,8.5,-110,-110,140,1.5,-140,5.1,Kauffman Stadium,5,1
2020-09-25,2020,TEX,HOU,5,4,155,1.5,100,9.0,-105,-115,-165,-1.5,-120,3.53,Globe Life Field,9,1
2020-09-25,2020,DET,KC,2,3,140,1.5,-140,8.5,-110,-110,-150,-1.5,120,3.54,Kauffman Stadium,5,-1
2020-09-25,2020,LAD,LAA,9,5,-210,-1.5,-105,8.0,-115,-105,190,1.5,-115,5.42,Dodger Stadium,14,4
2020-09-25,2020,LAA,LAD,5,9,190,1.5,-115,8.0,-115,-105,-210,-1.5,-105,2.76,Dodger Stadium,14,-4
2020-09-25,2020,NYY,MIA,3,4,-180,-1.5,100,9.5,100,-120,165,1.5,-120,6.11,Yankee Stadium,7,-1
2020-09-25,2020,STL,MIL,0,3,-110,-1.5,170,6.0,100,-120,100,1.5,-190,3.14,Busch Stadium,3,-3
2020-09-25,2020,STL,MIL,9,1,-105,1.5,-210,6.5,-115,-105,-105,-1.5,175,3.33,Busch Stadium,10,8
2020-09-25,2020,CIN,MIN,7,2,144,1.5,-150,8.5,-105,-115,-154,-1.5,130,3.48,Target Field,9,5
2020-09-25,2020,MIA,NYY,4,3,165,1.5,-120,9.5,100,-120,-180,-1.5,100,3.58,Yankee Stadium,7,1
2020-09-25,2020,SEA,OAK,1,3,190,1.5,-110,7.5,-115,-105,-210,-1.5,-110,2.59,Oakland Coliseum,4,-2
2020-09-25,2020,TB,PHI,6,4,-125,-1.5,155,8.5,-105,-115,115,1.5,-175,4.72,Tropicana Field,10,2
2020-09-25,2020,CLE,PIT,4,3,-240,-1.5,-120,7.5,-115,-105,210,1.5,100,5.29,Progressive Field,7,1
2020-09-25,2020,SF,SD,5,4,140,1.5,-150,6.5,-115,-105,-150,-1.5,130,2.71,AT&T Park,9,1
2020-09-25,2020,SF,SD,5,6,190,1.5,-130,6.5,-105,-115,-210,-1.5,110,2.24,AT&T Park,11,-1
2020-09-25,2020,OAK,SEA,3,1,-210,-1.5,-110,7.5,-115,-105,190,1.5,-110,5.08,Oakland Coliseum,4,2
2020-09-25,2020,SD,SF,4,5,-150,-1.5,130,6.5,-115,-105,140,1.5,-150,3.9,AT&T Park,9,-1
2020-09-25,2020,SD,SF,6,5,-210,-1.5,110,6.5,-105,-115,190,1.5,-130,4.4,AT&T Park,11,1
2020-09-25,2020,MIL,STL,3,0,100,1.5,-190,6.0,100,-120,-110,-1.5,170,3.0,Busch Stadium,3,3
2020-09-25,2020,MIL,STL,1,9,-105,-1.5,175,6.5,-115,-105,-105,1.5,-210,3.33,Busch Stadium,10,-8
2020-09-25,2020,PHI,TB,4,6,115,1.5,-175,8.5,-105,-115,-125,-1.5,155,3.95,Tropicana Field,10,-2
2020-09-25,2020,HOU,TEX,4,5,-165,-1.5,-120,9.0,-105,-115,155,1.5,100,5.6,Globe Life Field,9,-1
2020-09-25,2020,BAL,TOR,5,10,154,1.5,-135,9.5,-115,-105,-164,-1.5,115,3.74,Sahlen Field,15,-5
2020-09-26,2020,COL,ARI,10,3,-105,1.5,-190,9.0,-115,-105,-105,-1.5,170,4.61,Chase Field,13,7
2020-09-26,2020,BOS,ATL,8,2,140,1.5,-150,9.5,100,-120,-150,-1.5,130,3.96,Suntrust Park,10,6
2020-09-26,2020,TOR,BAL,5,2,-119,-1.5,150,9.0,-120,100,109,1.5,-170,4.89,Sahlen Field,7,3
2020-09-26,2020,ATL,BOS,2,8,-150,-1.5,130,9.5,100,-120,140,1.5,-150,5.7,Suntrust Park,10,-6
2020-09-26,2020,CWS,CHC,9,5,-152,-1.5,120,9.5,100,-120,142,1.5,-140,5.73,Guaranteed Rate Field,14,4
2020-09-26,2020,MIN,CIN,7,3,-120,-1.5,160,7.5,-115,-105,110,1.5,-180,4.09,Target Field,10,4
2020-09-26,2020,PIT,CLE,8,0,150,1.5,-140,8.0,-115,-105,-160,-1.5,120,3.2,Progressive Field,8,8
2020-09-26,2020,ARI,COL,3,10,-105,-1.5,170,9.0,-115,-105,-105,1.5,-190,4.61,Chase Field,13,-7
2020-09-26,2020,CHC,CWS,5,9,142,1.5,-140,9.5,100,-120,-152,-1.5,120,3.93,Guaranteed Rate Field,14,-4
2020-09-26,2020,KC,DET,3,4,-125,-1.5,145,9.5,-115,-105,115,1.5,-165,5.28,Kauffman Stadium,7,-1
2020-09-26,2020,TEX,HOU,6,1,128,1.5,-125,9.0,105,-125,-138,-1.5,105,3.95,Globe Life Field,7,5
2020-09-26,2020,DET,KC,4,3,115,1.5,-165,9.5,-115,-105,-125,-1.5,145,4.42,Kauffman Stadium,7,1
2020-09-26,2020,LAD,LAA,7,6,-300,-1.5,-155,9.0,-110,-110,260,1.5,135,6.75,Dodger Stadium,13,1
2020-09-26,2020,LAA,LAD,6,7,260,1.5,135,9.0,-110,-110,-300,-1.5,-155,2.5,Dodger Stadium,13,-1
2020-09-26,2020,NYY,MIA,11,4,-230,-1.5,-125,9.5,-105,-115,205,1.5,105,6.62,Yankee Stadium,15,7
2020-09-26,2020,STL,MIL,0,3,107,1.5,-160,7.5,-115,-105,-117,-1.5,140,3.62,Busch Stadium,3,-3
2020-09-26,2020,CIN,MIN,3,7,110,1.5,-180,7.5,-115,-105,-120,-1.5,160,3.57,Target Field,10,-4
2020-09-26,2020,WSH,NYM,4,3,121,1.5,-175,5.0,105,-125,-131,-1.5,155,2.26,Nationals Park,7,1
2020-09-26,2020,WSH,NYM,5,3,120,1.5,-155,7.0,-105,-115,-130,-1.5,135,3.18,Nationals Park,8,2
2020-09-26,2020,MIA,NYY,4,11,205,1.5,105,9.5,-105,-115,-230,-1.5,-125,3.11,Yankee Stadium,15,-7
2020-09-26,2020,SEA,OAK,5,1,134,1.5,-180,6.0,-110,-110,-144,-1.5,160,2.56,Oakland Coliseum,6,4
2020-09-26,2020,SEA,OAK,12,3,128,1.5,-150,7.0,-110,-110,-138,-1.5,130,3.07,Oakland Coliseum,15,9
2020-09-26,2020,TB,PHI,4,3,-102,1.5,-165,7.5,-115,-105,-108,-1.5,145,3.79,Tropicana Field,7,1
2020-09-26,2020,CLE,PIT,0,8,-160,-1.5,120,8.0,-115,-105,150,1.5,-140,4.92,Progressive Field,8,-8
2020-09-26,2020,SF,SD,2,6,120,1.5,-140,9.0,-110,-110,-130,-1.5,120,4.09,AT&T Park,8,-4
2020-09-26,2020,OAK,SEA,1,5,-144,-1.5,160,6.0,-110,-110,134,1.5,-180,3.54,Oakland Coliseum,6,-4
2020-09-26,2020,OAK,SEA,3,12,-138,-1.5,130,7.0,-110,-110,128,1.5,-150,4.06,Oakland Coliseum,15,-9
2020-09-26,2020,SD,SF,6,2,-130,-1.5,120,9.0,-110,-110,120,1.5,-140,5.09,AT&T Park,8,4
2020-09-26,2020,MIL,STL,3,0,-117,-1.5,140,7.5,-115,-105,107,1.5,-160,4.04,Busch Stadium,3,3
2020-09-26,2020,PHI,TB,3,4,-108,-1.5,145,7.5,-115,-105,-102,1.5,-165,3.89,Tropicana Field,7,-1
2020-09-26,2020,HOU,TEX,1,6,-138,-1.5,105,9.0,105,-125,128,1.5,-125,5.22,Globe Life Field,7,-5
2020-09-26,2020,BAL,TOR,2,5,109,1.5,-170,9.0,-120,100,-119,-1.5,150,4.31,Sahlen Field,7,-3
2020-09-26,2020,NYM,WSH,3,4,-131,-1.5,155,5.0,105,-125,121,1.5,-175,2.84,Nationals Park,7,-1
2020-09-26,2020,NYM,WSH,3,5,-130,-1.5,135,7.0,-105,-115,120,1.5,-155,3.96,Nationals Park,8,-2
2020-09-27,2020,COL,ARI,3,11,-102,-1.5,150,9.0,-110,-110,-108,1.5,-170,4.54,Chase Field,14,-8
2020-09-27,2020,BOS,ATL,9,1,133,1.5,-155,9.5,-110,-110,-143,-1.5,135,4.08,Suntrust Park,10,8
2020-09-27,2020,TOR,BAL,5,7,-126,-1.5,145,10.0,-110,-110,116,1.5,-165,5.58,Sahlen Field,12,-2
2020-09-27,2020,ATL,BOS,1,9,-143,-1.5,135,9.5,-110,-110,133,1.5,-155,5.59,Suntrust Park,10,-8
2020-09-27,2020,CWS,CHC,8,10,-150,-1.5,125,9.0,-110,-110,140,1.5,-145,5.4,Guaranteed Rate Field,18,-2
2020-09-27,2020,MIN,CIN,3,5,-125,-1.5,160,8.0,100,-120,115,1.5,-180,4.44,Target Field,8,-2
2020-09-27,2020,PIT,CLE,6,8,136,1.5,-145,8.0,-110,-110,-146,-1.5,125,3.39,Progressive Field,14,-2
2020-09-27,2020,ARI,COL,11,3,-108,1.5,-170,9.0,-110,-110,-102,-1.5,150,4.67,Chase Field,14,8
2020-09-27,2020,CHC,CWS,10,8,140,1.5,-145,9.0,-110,-110,-150,-1.5,125,3.75,Guaranteed Rate Field,18,2
2020-09-27,2020,KC,DET,3,1,-170,-1.5,115,8.0,105,-125,160,1.5,-135,5.04,Kauffman Stadium,4,2
2020-09-27,2020,TEX,HOU,8,4,114,1.5,-150,9.5,-105,-115,-124,-1.5,130,4.44,Globe Life Field,12,4
2020-09-27,2020,DET,KC,1,3,160,1.5,-135,8.0,105,-125,-170,-1.5,115,3.08,Kauffman Stadium,4,-2
2020-09-27,2020,LAD,LAA,5,0,-210,-1.5,-110,8.5,-110,-110,190,1.5,-110,5.76,Dodger Stadium,5,5
2020-09-27,2020,LAA,LAD,0,5,190,1.5,-110,8.5,-110,-110,-210,-1.5,-110,2.93,Dodger Stadium,5,-5
2020-09-27,2020,NYY,MIA,0,5,-174,-1.5,-105,9.5,-115,-105,162,1.5,-115,6.03,Yankee Stadium,5,-5
2020-09-27,2020,STL,MIL,5,2,-105,1.5,-165,8.0,-120,100,-105,-1.5,145,4.1,Busch Stadium,7,3
2020-09-27,2020,CIN,MIN,5,3,115,1.5,-180,8.0,100,-120,-125,-1.5,160,3.72,Target Field,8,2
2020-09-27,2020,WSH,NYM,15,5,118,1.5,-140,8.5,-120,100,-128,-1.5,120,3.9,Nationals Park,20,10
2020-09-27,2020,MIA,NYY,5,0,162,1.5,-115,9.5,-115,-105,-174,-1.5,-105,3.63,Yankee Stadium,5,5
2020-09-27,2020,SEA,OAK,2,6,113,1.5,-180,8.0,-110,-110,-123,-1.5,160,3.76,Oakland Coliseum,8,-4
2020-09-27,2020,TB,PHI,5,0,135,1.5,-130,7.5,-105,-115,-145,-1.5,110,3.19,Tropicana Field,5,5
2020-09-27,2020,CLE,PIT,8,6,-146,-1.5,125,8.0,-110,-110,136,1.5,-145,4.75,Progressive Field,14,2
2020-09-27,2020,SF,SD,4,5,-119,-1.5,150,8.5,-120,100,109,1.5,-170,4.62,AT&T Park,9,-1
2020-09-27,2020,OAK,SEA,6,2,-123,-1.5,160,8.0,-110,-110,113,1.5,-180,4.41,Oakland Coliseum,8,4
2020-09-27,2020,SD,SF,5,4,109,1.5,-170,8.5,-120,100,-119,-1.5,150,4.07,AT&T Park,9,1
2020-09-27,2020,MIL,STL,2,5,-105,-1.5,145,8.0,-120,100,-105,1.5,-165,4.1,Busch Stadium,7,-3
2020-09-27,2020,PHI,TB,0,5,-145,-1.5,110,7.5,-105,-115,135,1.5,-130,4.44,Tropicana Field,5,-5
2020-09-27,2020,HOU,TEX,4,8,-124,-1.5,130,9.5,-105,-115,114,1.5,-150,5.26,Globe Life Field,12,-4
2020-09-27,2020,BAL,TOR,7,5,116,1.5,-165,10.0,-110,-110,-126,-1.5,145,4.63,Sahlen Field,12,2
2020-09-27,2020,NYM,WSH,5,15,-128,-1.5,120,8.5,-120,100,118,1.5,-140,4.77,Nationals Park,20,-10
2021-04-01,2021,SD,ARI,8,7,-230,-1.5,-120,8.5,100,-120,205,1.5,100,5.92,PETCO Park,15,1
2021-04-01,2021,PHI,ATL,3,2,-127,-1.5,170,7.5,100,-120,117,1.5,-190,4.2,Citizens Bank Park,5,1
2021-04-01,2021,PIT,CHC,5,3,190,1.5,-120,6.5,-115,-105,-210,-1.5,100,2.24,Wrigley Field,8,2
2021-04-01,2021,STL,CIN,11,6,112,1.5,-200,7.0,-120,100,-122,-1.5,175,3.3,Great American Ballpark,17,5
2021-04-01,2021,DET,CLE,3,2,165,1.5,-105,7.5,100,-120,-180,-1.5,-115,2.83,Comerica Park,5,1
2021-04-01,2021,LAD,COL,5,8,-215,-1.5,-145,10.5,-115,-105,195,1.5,125,7.17,Coors Field,13,-3
2021-04-01,2021,LAA,CWS,4,3,108,1.5,-155,8.0,-110,-110,-118,-1.5,135,3.85,Angel Stadium,7,1
2021-04-01,2021,CLE,DET,2,3,-180,-1.5,-115,7.5,100,-120,165,1.5,-105,4.82,Comerica Park,5,-1
2021-04-01,2021,OAK,HOU,1,8,-108,-1.5,185,8.0,-120,100,-102,1.5,-210,4.15,Oakland Coliseum,9,-7
2021-04-01,2021,TEX,KC,10,14,140,1.5,-145,8.5,100,-120,-150,-1.5,125,3.54,Kauffman Stadium,24,-4
2021-04-01,2021,CWS,LAA,3,4,-118,-1.5,135,8.0,-110,-110,108,1.5,-155,4.33,Angel Stadium,7,-1
2021-04-01,2021,COL,LAD,8,5,195,1.5,125,10.5,-115,-105,-215,-1.5,-145,3.56,Coors Field,13,3
2021-04-01,2021,TB,MIA,1,0,-150,-1.5,110,7.0,-120,100,140,1.5,-130,4.2,Marlins Park,1,1
2021-04-01,2021,MIN,MIL,5,6,-101,1.5,-200,7.5,-105,-115,-109,-1.5,175,3.77,Miller Park,11,-1
2021-04-01,2021,MIL,MIN,6,5,-109,-1.5,175,7.5,-105,-115,-101,1.5,-200,3.91,Miller Park,11,1
2021-04-01,2021,TOR,NYY,3,2,170,1.5,-120,8.0,100,-120,-185,-1.5,100,2.96,Yankee Stadium,5,1
2021-04-01,2021,HOU,OAK,8,1,-102,1.5,-210,8.0,-120,100,-108,-1.5,185,4.04,Oakland Coliseum,9,7
2021-04-01,2021,ATL,PHI,2,3,117,1.5,-190,7.5,100,-120,-127,-1.5,170,3.46,Citizens Bank Park,5,-1
2021-04-01,2021,CHC,PIT,3,5,-210,-1.5,100,6.5,-115,-105,190,1.5,-120,4.4,Wrigley Field,8,-2
2021-04-01,2021,ARI,SD,7,8,205,1.5,100,8.5,100,-120,-230,-1.5,-120,2.79,PETCO Park,15,-1
2021-04-01,2021,SF,SEA,7,8,-118,-1.5,130,8.0,-105,-115,108,1.5,-150,4.33,T-Mobile Park,15,-1
2021-04-01,2021,SEA,SF,8,7,108,1.5,-150,8.0,-105,-115,-118,-1.5,130,3.85,T-Mobile Park,15,1
2021-04-01,2021,CIN,STL,6,11,-122,-1.5,175,7.0,-120,100,112,1.5,-200,3.85,Great American Ballpark,17,-5
2021-04-01,2021,MIA,TB,0,1,140,1.5,-130,7.0,-120,100,-150,-1.5,110,2.92,Marlins Park,1,-1
2021-04-01,2021,KC,TEX,14,10,-150,-1.5,125,8.5,100,-120,140,1.5,-145,5.1,Kauffman Stadium,24,4
2021-04-01,2021,NYY,TOR,2,3,-185,-1.5,100,8.0,100,-120,170,1.5,-120,5.19,Yankee Stadium,5,-1
2021-04-02,2021,SD,ARI,4,2,-210,-1.5,-110,8.0,-105,-115,190,1.5,-110,5.42,PETCO Park,6,2
2021-04-02,2021,BOS,BAL,0,3,-172,-1.5,105,9.0,-110,-110,161,1.5,-125,5.69,Fenway Park,3,-3
2021-04-02,2021,BAL,BOS,3,0,161,1.5,-125,9.0,-110,-110,-172,-1.5,105,3.45,Fenway Park,3,3
2021-04-02,2021,LAD,COL,11,6,-240,-1.5,-165,12.0,-105,-115,210,1.5,145,8.47,Coors Field,17,5
2021-04-02,2021,LAA,CWS,8,12,-119,-1.5,170,8.5,-115,-105,109,1.5,-190,4.62,Angel Stadium,20,-4
2021-04-02,2021,OAK,HOU,5,9,-124,-1.5,155,8.5,-105,-115,114,1.5,-175,4.71,Oakland Coliseum,14,-4
2021-04-02,2021,CWS,LAA,12,8,109,1.5,-190,8.5,-115,-105,-119,-1.5,170,4.07,Angel Stadium,20,4
2021-04-02,2021,COL,LAD,6,11,210,1.5,145,12.0,-105,-115,-240,-1.5,-165,3.87,Coors Field,17,-5
2021-04-02,2021,TB,MIA,6,4,-101,1.5,-220,7.5,105,-125,-109,-1.5,195,3.77,Marlins Park,10,2
2021-04-02,2021,HOU,OAK,9,5,114,1.5,-175,8.5,-105,-115,-124,-1.5,155,3.97,Oakland Coliseum,14,4
2021-04-02,2021,ARI,SD,2,4,190,1.5,-110,8.0,-105,-115,-210,-1.5,-110,2.76,PETCO Park,6,-2
2021-04-02,2021,SF,SEA,6,3,104,1.5,-185,8.5,-105,-115,-114,-1.5,165,4.17,T-Mobile Park,9,3
2021-04-02,2021,SEA,SF,3,6,-114,-1.5,165,8.5,-105,-115,104,1.5,-185,4.53,T-Mobile Park,9,-3
2021-04-02,2021,MIA,TB,4,6,-109,-1.5,195,7.5,105,-125,-101,1.5,-220,3.91,Marlins Park,10,-2
2021-04-03,2021,SD,ARI,7,0,-210,-1.5,-110,8.5,-115,-105,190,1.5,-110,5.76,PETCO Park,7,7
2021-04-03,2021,PHI,ATL,4,0,102,1.5,-165,7.5,-120,100,-112,-1.5,145,3.71,Citizens Bank Park,4,4
2021-04-03,2021,BOS,BAL,2,4,-166,-1.5,105,10.0,-105,-115,156,1.5,-125,6.24,Fenway Park,6,-2
2021-04-03,2021,BAL,BOS,4,2,156,1.5,-125,10.0,-105,-115,-166,-1.5,105,3.91,Fenway Park,6,2
2021-04-03,2021,PIT,CHC,1,5,149,1.5,-140,11.0,-115,-105,-159,-1.5,120,4.42,Wrigley Field,6,-4
2021-04-03,2021,STL,CIN,6,9,108,1.5,-180,9.0,-105,-115,-118,-1.5,160,4.33,Great American Ballpark,15,-3
2021-04-03,2021,DET,CLE,5,2,142,1.5,-120,8.0,-115,-105,-152,-1.5,100,3.31,Comerica Park,7,3
2021-04-03,2021,LAD,COL,6,5,-220,-1.5,-150,11.5,-115,-105,200,1.5,130,7.91,Coors Field,11,1
2021-04-03,2021,LAA,CWS,5,3,105,1.5,-150,9.0,-110,-110,-115,-1.5,130,4.39,Angel Stadium,8,2
2021-04-03,2021,CLE,DET,2,5,-152,-1.5,100,8.0,-115,-105,142,1.5,-120,4.83,Comerica Park,7,-3
2021-04-03,2021,OAK,HOU,1,9,118,1.5,-140,9.0,100,-120,-128,-1.5,120,4.13,Oakland Coliseum,10,-8
2021-04-03,2021,TEX,KC,4,11,152,1.5,-130,9.0,-120,100,-162,-1.5,110,3.57,Kauffman Stadium,15,-7
2021-04-03,2021,CWS,LAA,3,5,-115,-1.5,130,9.0,-110,-110,105,1.5,-150,4.81,Angel Stadium,8,-2
2021-04-03,2021,COL,LAD,5,6,200,1.5,130,11.5,-115,-105,-220,-1.5,-150,3.83,Coors Field,11,-1
2021-04-03,2021,TB,MIA,7,12,-106,-1.5,145,7.5,-120,100,-104,1.5,-165,3.86,Marlins Park,19,-5
2021-04-03,2021,MIN,MIL,2,0,120,1.5,-180,7.5,100,-120,-130,-1.5,160,3.41,Miller Park,2,2
2021-04-03,2021,MIL,MIN,0,2,-130,-1.5,160,7.5,100,-120,120,1.5,-180,4.24,Miller Park,2,-2
2021-04-03,2021,TOR,NYY,3,5,152,1.5,-125,9.0,-125,105,-162,-1.5,105,3.57,Yankee Stadium,8,-2
2021-04-03,2021,HOU,OAK,9,1,-128,-1.5,120,9.0,100,-120,118,1.5,-140,5.05,Oakland Coliseum,10,8
2021-04-03,2021,ATL,PHI,0,4,-112,-1.5,145,7.5,-120,100,102,1.5,-165,3.96,Citizens Bank Park,4,-4
2021-04-03,2021,CHC,PIT,5,1,-159,-1.5,120,11.0,-115,-105,149,1.5,-140,6.75,Wrigley Field,6,4
2021-04-03,2021,ARI,SD,0,7,190,1.5,-110,8.5,-115,-105,-210,-1.5,-110,2.93,PETCO Park,7,-7
2021-04-03,2021,SF,SEA,0,4,-115,-1.5,135,9.0,100,-120,105,1.5,-155,4.81,T-Mobile Park,4,-4
2021-04-03,2021,SEA,SF,4,0,105,1.5,-155,9.0,100,-120,-115,-1.5,135,4.39,T-Mobile Park,4,4
2021-04-03,2021,CIN,STL,9,6,-118,-1.5,160,9.0,-105,-115,108,1.5,-180,4.87,Great American Ballpark,15,3
2021-04-03,2021,MIA,TB,12,7,-104,1.5,-165,7.5,-120,100,-106,-1.5,145,3.82,Marlins Park,19,5
2021-04-03,2021,KC,TEX,11,4,-162,-1.5,110,9.0,-120,100,152,1.5,-130,5.56,Kauffman Stadium,15,7
2021-04-03,2021,NYY,TOR,5,3,-162,-1.5,105,9.0,-125,105,152,1.5,-125,5.56,Yankee Stadium,8,2
2021-04-04,2021,SD,ARI,1,3,-200,-1.5,-110,9.0,-110,-110,180,1.5,-110,6.0,PETCO Park,4,-2
2021-04-04,2021,PHI,ATL,2,1,102,1.5,-160,8.5,-110,-110,-112,-1.5,140,4.21,Citizens Bank Park,3,1
2021-04-04,2021,BOS,BAL,3,11,-170,-1.5,105,9.5,-110,-110,160,1.5,-125,5.98,Fenway Park,14,-8
2021-04-04,2021,BAL,BOS,11,3,160,1.5,-125,9.5,-110,-110,-170,-1.5,105,3.65,Fenway Park,14,8
2021-04-04,2021,PIT,CHC,3,4,171,1.5,-125,8.5,-105,-115,-186,-1.5,105,3.14,Wrigley Field,7,-1
2021-04-04,2021,STL,CIN,1,12,-112,-1.5,140,9.5,-120,100,102,1.5,-160,5.02,Great American Ballpark,13,-11
2021-04-04,2021,DET,CLE,3,9,120,1.5,-140,8.0,100,-120,-130,-1.5,120,3.64,Comerica Park,12,-6
2021-04-04,2021,LAD,COL,4,2,-210,-1.5,-140,12.0,-105,-115,190,1.5,120,8.13,Coors Field,6,2
2021-04-04,2021,LAA,CWS,7,4,-124,-1.5,150,9.5,100,-120,114,1.5,-170,5.26,Angel Stadium,11,3
2021-04-04,2021,CLE,DET,9,3,-130,-1.5,120,8.0,100,-120,120,1.5,-140,4.52,Comerica Park,12,6
2021-04-04,2021,OAK,HOU,2,9,-116,-1.5,170,8.5,-110,-110,106,1.5,-190,4.56,Oakland Coliseum,11,-7
2021-04-04,2021,TEX,KC,7,3,150,1.5,-130,10.0,-110,-110,-160,-1.5,110,4.0,Kauffman Stadium,10,4
2021-04-04,2021,CWS,LAA,4,7,114,1.5,-170,9.5,100,-120,-124,-1.5,150,4.44,Angel Stadium,11,-3
2021-04-04,2021,COL,LAD,2,4,190,1.5,120,12.0,-105,-115,-210,-1.5,-140,4.14,Coors Field,6,-2
2021-04-04,2021,MIN,MIL,8,2,-105,-1.5,155,8.0,-115,-105,-105,1.5,-175,4.1,Miller Park,10,6
2021-04-04,2021,MIL,MIN,2,8,-105,1.5,-175,8.0,-115,-105,-105,-1.5,155,4.1,Miller Park,10,-6
2021-04-04,2021,TOR,NYY,3,1,164,1.5,-120,9.5,-110,-110,-178,-1.5,100,3.6,Yankee Stadium,4,2
2021-04-04,2021,HOU,OAK,9,2,106,1.5,-190,8.5,-110,-110,-116,-1.5,170,4.13,Oakland Coliseum,11,7
2021-04-04,2021,ATL,PHI,1,2,-112,-1.5,140,8.5,-110,-110,102,1.5,-160,4.49,Citizens Bank Park,3,-1
2021-04-04,2021,CHC,PIT,4,3,-186,-1.5,105,8.5,-105,-115,171,1.5,-125,5.53,Wrigley Field,7,1
2021-04-04,2021,ARI,SD,3,1,180,1.5,-110,9.0,-110,-110,-200,-1.5,-110,3.21,PETCO Park,4,2
2021-04-04,2021,CIN,STL,12,1,102,1.5,-160,9.5,-120,100,-112,-1.5,140,4.7,Great American Ballpark,13,11
2021-04-04,2021,KC,TEX,3,7,-160,-1.5,110,10.0,-110,-110,150,1.5,-130,6.15,Kauffman Stadium,10,-4
2021-04-04,2021,NYY,TOR,1,3,-178,-1.5,100,9.5,-110,-110,164,1.5,-120,6.08,Yankee Stadium,4,-2
2021-04-05,2021,NYY,BAL,7,0,-230,-1.5,-125,10.0,100,-120,205,1.5,105,6.97,Yankee Stadium,7,7
2021-04-05,2021,TB,BOS,2,11,-113,-1.5,140,9.5,-110,-110,103,1.5,-160,5.04,Fenway Park,13,-9
2021-04-05,2021,MIL,CHC,3,5,100,1.5,-190,9.5,-110,-110,-110,-1.5,170,4.75,Wrigley Field,8,-2
2021-04-05,2021,PIT,CIN,3,5,141,1.5,-145,9.0,-110,-110,-151,-1.5,125,3.73,Great American Ballpark,8,-2
2021-04-05,2021,KC,CLE,3,0,115,1.5,-180,9.0,-105,-115,-125,-1.5,160,4.19,Progressive Field,3,3
2021-04-05,2021,SEA,CWS,0,6,113,1.5,-150,8.0,-115,-105,-123,-1.5,130,3.76,T-Mobile Park,6,-6
2021-04-05,2021,MIN,DET,15,6,-152,-1.5,-105,9.0,-105,-115,142,1.5,-115,5.43,Comerica Park,21,9
2021-04-05,2021,LAA,HOU,7,6,-115,-1.5,165,10.0,-105,-115,105,1.5,-185,5.35,Angel Stadium,13,1
2021-04-05,2021,CLE,KC,0,3,-125,-1.5,160,9.0,-105,-115,115,1.5,-180,5.0,Progressive Field,3,-3
2021-04-05,2021,HOU,LAA,6,7,105,1.5,-185,10.0,-105,-115,-115,-1.5,165,4.88,Angel Stadium,13,-1
2021-04-05,2021,OAK,LAD,3,10,145,1.5,-110,8.5,-120,100,-155,-1.5,-110,3.47,Oakland Coliseum,13,-7
2021-04-05,2021,STL,MIA,4,1,106,1.5,-190,8.0,-120,100,-116,-1.5,170,3.88,Marlins Park,5,3
2021-04-05,2021,CHC,MIL,5,3,-110,-1.5,170,9.5,-110,-110,100,1.5,-190,4.98,Wrigley Field,8,2
2021-04-05,2021,DET,MIN,6,15,142,1.5,-115,9.0,-105,-115,-152,-1.5,-105,3.72,Comerica Park,21,-9
2021-04-05,2021,PHI,NYM,5,3,173,1.5,100,7.5,-105,-115,-188,-1.5,-120,2.75,Citizens Bank Park,8,2
2021-04-05,2021,BAL,NYY,0,7,205,1.5,105,10.0,100,-120,-230,-1.5,-125,3.28,Yankee Stadium,7,-7
2021-04-05,2021,LAD,OAK,10,3,-155,-1.5,-110,8.5,-120,100,145,1.5,-110,5.17,Oakland Coliseum,13,7
2021-04-05,2021,NYM,PHI,3,5,-188,-1.5,-120,7.5,-105,-115,173,1.5,100,4.9,Citizens Bank Park,8,-2
2021-04-05,2021,CIN,PIT,5,3,-151,-1.5,125,9.0,-110,-110,141,1.5,-145,5.41,Great American Ballpark,8,2
2021-04-05,2021,SF,SD,3,2,132,1.5,-160,8.0,-110,-110,-142,-1.5,140,3.45,PETCO Park,5,1
2021-04-05,2021,CWS,SEA,6,0,-123,-1.5,130,8.0,-115,-105,113,1.5,-150,4.41,T-Mobile Park,6,6
2021-04-05,2021,SD,SF,2,3,-142,-1.5,140,8.0,-110,-110,132,1.5,-160,4.69,PETCO Park,5,-1
2021-04-05,2021,MIA,STL,1,4,-116,-1.5,170,8.0,-120,100,106,1.5,-190,4.3,Marlins Park,5,-3
2021-04-05,2021,BOS,TB,11,2,103,1.5,-160,9.5,-110,-110,-113,-1.5,140,4.68,Fenway Park,13,9
2021-04-05,2021,TOR,TEX,6,2,-145,-1.5,100,9.5,100,-120,135,1.5,-120,5.62,Globe Life Field,8,4
2021-04-05,2021,TEX,TOR,2,6,135,1.5,-120,9.5,100,-120,-145,-1.5,100,4.04,Globe Life Field,8,-4
2021-04-06,2021,COL,ARI,8,10,-123,-1.5,145,10.5,100,-120,113,1.5,-165,5.79,Coors Field,18,-2
2021-04-06,2021,WSH,ATL,6,5,-116,-1.5,170,7.5,-115,-105,106,1.5,-190,4.03,Nationals Park,11,1
2021-04-06,2021,NYY,BAL,7,2,-280,-1.5,-150,8.0,-110,-110,245,1.5,130,5.89,Yankee Stadium,9,5
2021-04-06,2021,TB,BOS,5,6,-155,-1.5,100,9.0,100,-120,145,1.5,-120,5.47,Fenway Park,11,-1
2021-04-06,2021,MIL,CHC,4,0,103,1.5,-190,9.0,-115,-105,-113,-1.5,170,4.43,Wrigley Field,4,4
2021-04-06,2021,PIT,CIN,1,14,145,1.5,-145,9.0,-115,-105,-155,-1.5,125,3.67,Great American Ballpark,15,-13
2021-04-06,2021,ARI,COL,10,8,113,1.5,-165,10.5,100,-120,-123,-1.5,145,4.93,Coors Field,18,2
2021-04-06,2021,SEA,CWS,4,10,140,1.5,-125,7.0,-105,-115,-150,-1.5,105,2.92,T-Mobile Park,14,-6
2021-04-06,2021,MIN,DET,3,4,-140,-1.5,110,9.0,-115,-105,130,1.5,-130,5.25,Comerica Park,7,-1
2021-04-06,2021,LAA,HOU,2,4,-108,-1.5,170,9.0,105,-125,-102,1.5,-190,4.67,Angel Stadium,6,-2
2021-04-06,2021,HOU,LAA,4,2,-102,1.5,-190,9.0,105,-125,-108,-1.5,170,4.54,Angel Stadium,6,2
2021-04-06,2021,OAK,LAD,1,5,158,1.5,-105,8.5,-105,-115,-168,-1.5,-115,3.29,Oakland Coliseum,6,-4
2021-04-06,2021,STL,MIA,4,2,117,1.5,-185,7.5,-105,-115,-127,-1.5,165,3.46,Marlins Park,6,2
2021-04-06,2021,CHC,MIL,0,4,-113,-1.5,170,9.0,-115,-105,103,1.5,-190,4.77,Wrigley Field,4,-4
2021-04-06,2021,DET,MIN,4,3,130,1.5,-130,9.0,-115,-105,-140,-1.5,110,3.91,Comerica Park,7,1
2021-04-06,2021,PHI,NYM,4,8,113,1.5,-145,9.0,-110,-110,-123,-1.5,125,4.23,Citizens Bank Park,12,-4
2021-04-06,2021,BAL,NYY,2,7,245,1.5,130,8.0,-110,-110,-280,-1.5,-150,2.32,Yankee Stadium,9,-5
2021-04-06,2021,LAD,OAK,5,1,-168,-1.5,-115,8.5,-105,-115,158,1.5,-105,5.33,Oakland Coliseum,6,4
2021-04-06,2021,NYM,PHI,8,4,-123,-1.5,125,9.0,-110,-110,113,1.5,-145,4.96,Citizens Bank Park,12,4
2021-04-06,2021,CIN,PIT,14,1,-155,-1.5,125,9.0,-115,-105,145,1.5,-145,5.47,Great American Ballpark,15,13
2021-04-06,2021,SF,SD,1,3,170,1.5,-120,8.0,-105,-115,-185,-1.5,100,2.96,PETCO Park,4,-2
2021-04-06,2021,CWS,SEA,10,4,-150,-1.5,105,7.0,-105,-115,140,1.5,-125,4.2,T-Mobile Park,14,6
2021-04-06,2021,SD,SF,3,1,-185,-1.5,100,8.0,-105,-115,170,1.5,-120,5.19,PETCO Park,4,2
2021-04-06,2021,MIA,STL,2,4,-127,-1.5,165,7.5,-105,-115,117,1.5,-185,4.2,Marlins Park,6,-2
2021-04-06,2021,BOS,TB,6,5,145,1.5,-120,9.0,100,-120,-155,-1.5,100,3.67,Fenway Park,11,1
2021-04-06,2021,TOR,TEX,4,7,-137,-1.5,110,9.5,-115,-105,127,1.5,-130,5.49,Globe Life Field,11,-3
2021-04-06,2021,TEX,TOR,7,4,127,1.5,-130,9.5,-115,-105,-137,-1.5,110,4.19,Globe Life Field,11,3
2021-04-06,2021,ATL,WSH,5,6,106,1.5,-190,7.5,-115,-105,-116,-1.5,170,3.64,Nationals Park,11,-1
2021-04-07,2021,COL,ARI,8,0,108,1.5,-145,11.5,-120,100,-118,-1.5,125,5.53,Coors Field,8,8
2021-04-07,2021,WSH,ATL,6,7,160,1.5,-125,6.5,-125,105,-170,-1.5,105,2.5,Nationals Park,13,-1
2021-04-07,2021,WSH,ATL,0,2,-132,-1.5,160,6.5,-120,100,122,1.5,-180,3.7,Nationals Park,2,-2
2021-04-07,2021,NYY,BAL,3,4,-190,-1.5,-105,9.0,100,-120,175,1.5,-115,5.9,Yankee Stadium,7,-1
2021-04-07,2021,TB,BOS,2,9,102,1.5,-190,8.5,-110,-110,-112,-1.5,170,4.21,Fenway Park,11,-7
2021-04-07,2021,MIL,CHC,4,2,-108,1.5,-210,9.0,-105,-115,-102,-1.5,185,4.67,Wrigley Field,6,2
2021-04-07,2021,PIT,CIN,4,11,180,1.5,-115,8.0,-120,100,-200,-1.5,-105,2.86,Great American Ballpark,15,-7
2021-04-07,2021,KC,CLE,2,4,170,1.5,-120,8.0,-105,-115,-185,-1.5,100,2.96,Progressive Field,6,-2
2021-04-07,2021,ARI,COL,0,8,-118,-1.5,125,11.5,-120,100,108,1.5,-145,6.22,Coors Field,8,-8
2021-04-07,2021,SEA,CWS,8,4,132,1.5,-125,8.5,100,-120,-142,-1.5,105,3.66,T-Mobile Park,12,4
2021-04-07,2021,MIN,DET,3,2,-170,-1.5,-110,8.5,-105,-115,160,1.5,-110,5.35,Comerica Park,5,1
2021-04-07,2021,CLE,KC,4,2,-185,-1.5,100,8.0,-105,-115,170,1.5,-120,5.19,Progressive Field,6,2
2021-04-07,2021,OAK,LAD,4,3,155,1.5,-105,8.0,-110,-110,-165,-1.5,-115,3.14,Oakland Coliseum,7,1
2021-04-07,2021,STL,MIA,7,0,-115,-1.5,150,7.0,-120,100,105,1.5,-170,3.74,Marlins Park,7,7
2021-04-07,2021,CHC,MIL,2,4,-102,-1.5,185,9.0,-105,-115,-108,1.5,-210,4.54,Wrigley Field,6,-2
2021-04-07,2021,DET,MIN,2,3,160,1.5,-110,8.5,-105,-115,-170,-1.5,-110,3.27,Comerica Park,5,-1
2021-04-07,2021,PHI,NYM,8,2,-164,-1.5,110,8.0,-120,100,154,1.5,-130,4.97,Citizens Bank Park,10,6
2021-04-07,2021,BAL,NYY,4,3,175,1.5,-115,9.0,100,-120,-190,-1.5,-105,3.27,Yankee Stadium,7,1
2021-04-07,2021,LAD,OAK,3,4,-165,-1.5,-115,8.0,-110,-110,155,1.5,-105,4.98,Oakland Coliseum,7,-1
2021-04-07,2021,NYM,PHI,2,8,154,1.5,-130,8.0,-120,100,-164,-1.5,110,3.15,Citizens Bank Park,10,-6
2021-04-07,2021,CIN,PIT,11,4,-200,-1.5,-105,8.0,-120,100,180,1.5,-115,5.33,Great American Ballpark,15,7
2021-04-07,2021,SF,SD,3,2,138,1.5,-155,7.5,100,-120,-148,-1.5,135,3.15,PETCO Park,5,1
2021-04-07,2021,CWS,SEA,4,8,-142,-1.5,105,8.5,100,-120,132,1.5,-125,4.99,T-Mobile Park,12,-4
2021-04-07,2021,SD,SF,2,3,-148,-1.5,135,7.5,100,-120,138,1.5,-155,4.48,PETCO Park,5,-1
2021-04-07,2021,MIA,STL,0,7,105,1.5,-170,7.0,-120,100,-115,-1.5,150,3.41,Marlins Park,7,-7
2021-04-07,2021,BOS,TB,9,2,-112,-1.5,170,8.5,-110,-110,102,1.5,-190,4.49,Fenway Park,11,7
2021-04-07,2021,TOR,TEX,1,2,-185,-1.5,-130,8.5,-115,-105,170,1.5,110,5.52,Globe Life Field,3,-1
2021-04-07,2021,TEX,TOR,2,1,170,1.5,110,8.5,-115,-105,-185,-1.5,-130,3.15,Globe Life Field,3,1
2021-04-07,2021,ATL,WSH,7,6,-170,-1.5,105,6.5,-125,105,160,1.5,-125,4.09,Nationals Park,13,1
2021-04-07,2021,ATL,WSH,2,0,122,1.5,-180,6.5,-120,100,-132,-1.5,160,2.93,Nationals Park,2,2
2021-04-08,2021,COL,ARI,7,3,-127,-1.5,140,11.0,-115,-105,117,1.5,-160,6.15,Coors Field,10,4
2021-04-08,2021,BOS,BAL,7,3,-148,-1.5,105,9.0,-110,-110,138,1.5,-125,5.37,Camden Yards,10,4
2021-04-08,2021,BAL,BOS,3,7,138,1.5,-125,9.0,-110,-110,-148,-1.5,105,3.78,Camden Yards,10,-4
2021-04-08,2021,PIT,CHC,2,4,140,1.5,-125,8.5,-110,-110,-150,-1.5,105,3.54,PNC Park,6,-2
2021-04-08,2021,ARI,COL,3,7,117,1.5,-160,11.0,-115,-105,-127,-1.5,140,5.07,Coors Field,10,-4
2021-04-08,2021,KC,CWS,0,6,155,1.5,-140,8.0,-120,100,-165,-1.5,120,3.14,Guaranteed Rate Field,6,-6
2021-04-08,2021,OAK,HOU,2,6,156,1.5,-120,10.0,-115,-105,-166,-1.5,100,3.91,Minute Maid Park,8,-4
2021-04-08,2021,CWS,KC,6,0,-165,-1.5,120,8.0,-120,100,155,1.5,-140,4.98,Guaranteed Rate Field,6,6
2021-04-08,2021,TOR,LAA,5,7,-109,-1.5,165,10.0,-120,100,-101,1.5,-185,5.22,TD Ballpark,12,-2
2021-04-08,2021,NYM,MIA,3,2,-180,-1.5,100,8.5,-120,100,165,1.5,-120,5.46,Citi Field,5,1
2021-04-08,2021,STL,MIL,3,1,130,1.5,-145,7.5,105,-125,-140,-1.5,125,3.26,Busch Stadium,4,2
2021-04-08,2021,SEA,MIN,2,10,196,1.5,-105,8.0,-110,-110,-216,-1.5,-115,2.7,Target Field,12,-8
2021-04-08,2021,MIA,NYM,2,3,165,1.5,-120,8.5,-120,100,-180,-1.5,100,3.21,Citi Field,5,-1
2021-04-08,2021,HOU,OAK,6,2,-166,-1.5,100,10.0,-115,-105,156,1.5,-120,6.24,Minute Maid Park,8,4
2021-04-08,2021,CHC,PIT,4,2,-150,-1.5,105,8.5,-110,-110,140,1.5,-125,5.1,PNC Park,6,2
2021-04-08,2021,MIN,SEA,10,2,-216,-1.5,-115,8.0,-110,-110,196,1.5,-105,5.47,Target Field,12,8
2021-04-08,2021,MIL,STL,1,3,-140,-1.5,125,7.5,105,-125,130,1.5,-145,4.38,Busch Stadium,4,-2
2021-04-08,2021,LAA,TOR,7,5,-101,1.5,-185,10.0,-120,100,-109,-1.5,165,5.02,TD Ballpark,12,2
2021-04-09,2021,CIN,ARI,6,5,-143,-1.5,100,9.5,100,-120,133,1.5,-120,5.59,Chase Field,11,1
2021-04-09,2021,PHI,ATL,1,8,115,1.5,-180,7.5,-115,-105,-125,-1.5,160,3.49,Suntrust Park,9,-7
2021-04-09,2021,ARI,CIN,5,6,133,1.5,-120,9.5,100,-120,-143,-1.5,100,4.08,Chase Field,11,-1
2021-04-09,2021,DET,CLE,1,4,170,1.5,-125,9.5,-105,-115,-185,-1.5,105,3.52,Progressive Field,5,-3
2021-04-09,2021,SF,COL,3,1,-151,-1.5,125,8.5,-110,-110,141,1.5,-145,5.11,AT&T Park,4,2
2021-04-09,2021,CLE,DET,4,1,-185,-1.5,105,9.5,-105,-115,170,1.5,-125,6.17,Progressive Field,5,3
2021-04-09,2021,OAK,HOU,6,2,161,1.5,-130,8.5,-120,100,-172,-1.5,110,3.26,Minute Maid Park,8,4
2021-04-09,2021,TOR,LAA,1,7,115,1.5,-135,11.0,100,-120,-125,-1.5,115,5.12,TD Ballpark,8,-6
2021-04-09,2021,WSH,LAD,0,1,245,1.5,125,8.5,-115,-105,-280,-1.5,-145,2.46,Dodger Stadium,1,-1
2021-04-09,2021,TB,NYY,10,5,119,1.5,-140,8.0,-115,-105,-129,-1.5,120,3.65,Tropicana Field,15,5
2021-04-09,2021,HOU,OAK,2,6,-172,-1.5,110,8.5,-120,100,161,1.5,-130,5.38,Minute Maid Park,8,-4
2021-04-09,2021,ATL,PHI,8,1,-125,-1.5,160,7.5,-115,-105,115,1.5,-180,4.17,Suntrust Park,9,7
2021-04-09,2021,TEX,SD,0,3,172,1.5,105,9.0,-110,-110,-187,-1.5,-125,3.31,Globe Life Field,3,-3
2021-04-09,2021,COL,SF,1,3,141,1.5,-145,8.5,-110,-110,-151,-1.5,125,3.53,AT&T Park,4,-2
2021-04-09,2021,NYY,TB,5,10,-129,-1.5,120,8.0,-115,-105,119,1.5,-140,4.51,Tropicana Field,15,-5
2021-04-09,2021,SD,TEX,3,0,-187,-1.5,-125,9.0,-110,-110,172,1.5,105,5.86,Globe Life Field,3,3
2021-04-09,2021,LAA,TOR,7,1,-125,-1.5,115,11.0,100,-120,115,1.5,-135,6.11,TD Ballpark,8,6
2021-04-09,2021,LAD,WSH,1,0,-280,-1.5,-145,8.5,-115,-105,245,1.5,125,6.26,Dodger Stadium,1,1
2021-04-10,2021,CIN,ARI,3,8,-122,-1.5,130,9.5,-110,-110,112,1.5,-150,5.22,Chase Field,11,-5
2021-04-10,2021,PHI,ATL,4,5,124,1.5,-165,8.0,-115,-105,-134,-1.5,145,3.57,Suntrust Park,9,-1
2021-04-10,2021,BOS,BAL,6,4,-127,-1.5,120,9.5,-105,-115,117,1.5,-140,5.31,Camden Yards,10,2
2021-04-10,2021,BAL,BOS,4,6,117,1.5,-140,9.5,-105,-115,-127,-1.5,120,4.38,Camden Yards,10,-2
2021-04-10,2021,PIT,CHC,8,2,147,1.5,-120,8.5,-110,-110,-157,-1.5,100,3.44,PNC Park,10,6
2021-04-10,2021,ARI,CIN,8,3,112,1.5,-150,9.5,-110,-110,-122,-1.5,130,4.48,Chase Field,11,5
2021-04-10,2021,DET,CLE,3,11,150,1.5,-140,8.5,100,-120,-160,-1.5,120,3.4,Progressive Field,14,-8
2021-04-10,2021,SF,COL,4,3,-170,-1.5,120,8.5,-110,-110,160,1.5,-140,5.35,AT&T Park,7,1
2021-04-10,2021,CLE,DET,11,3,-160,-1.5,120,8.5,100,-120,150,1.5,-140,5.23,Progressive Field,14,8
2021-04-10,2021,OAK,HOU,7,3,141,1.5,-135,9.0,100,-120,-151,-1.5,115,3.73,Minute Maid Park,10,4
2021-04-10,2021,TOR,LAA,15,1,-109,-1.5,165,10.5,-110,-110,-101,1.5,-185,5.48,TD Ballpark,16,14
2021-04-10,2021,WSH,LAD,5,9,157,1.5,-145,7.5,-105,-115,-167,-1.5,125,2.92,Dodger Stadium,14,-4
2021-04-10,2021,NYM,MIA,0,3,-270,-1.5,-125,6.5,-120,100,240,1.5,105,4.74,Citi Field,3,-3
2021-04-10,2021,STL,MIL,5,9,-112,-1.5,175,8.0,100,-120,102,1.5,-200,4.23,Busch Stadium,14,-4
2021-04-10,2021,SEA,MIN,4,3,170,1.5,-120,8.0,-105,-115,-185,-1.5,100,2.96,Target Field,7,1
2021-04-10,2021,MIA,NYM,3,0,240,1.5,105,6.5,-120,100,-270,-1.5,-125,1.91,Citi Field,3,3
2021-04-10,2021,TB,NYY,4,0,128,1.5,-135,9.5,100,-120,-138,-1.5,115,4.17,Tropicana Field,4,4
2021-04-10,2021,HOU,OAK,3,7,-151,-1.5,115,9.0,100,-120,141,1.5,-135,5.41,Minute Maid Park,10,-4
2021-04-10,2021,ATL,PHI,5,4,-134,-1.5,145,8.0,-115,-105,124,1.5,-165,4.58,Suntrust Park,9,1
2021-04-10,2021,CHC,PIT,2,8,-157,-1.5,100,8.5,-110,-110,147,1.5,-120,5.19,PNC Park,10,-6
2021-04-10,2021,TEX,SD,4,7,143,1.5,-120,9.0,100,-120,-153,-1.5,100,3.7,Globe Life Field,11,-3
2021-04-10,2021,MIN,SEA,3,4,-185,-1.5,100,8.0,-105,-115,170,1.5,-120,5.19,Target Field,7,-1
2021-04-10,2021,COL,SF,3,4,160,1.5,-140,8.5,-110,-110,-170,-1.5,120,3.27,AT&T Park,7,-1
2021-04-10,2021,MIL,STL,9,5,102,1.5,-200,8.0,100,-120,-112,-1.5,175,3.96,Busch Stadium,14,4
2021-04-10,2021,NYY,TB,0,4,-138,-1.5,115,9.5,100,-120,128,1.5,-135,5.51,Tropicana Field,4,-4
2021-04-10,2021,SD,TEX,7,4,-153,-1.5,100,9.0,100,-120,143,1.5,-120,5.44,Globe Life Field,11,3
2021-04-10,2021,LAA,TOR,1,15,-101,1.5,-185,10.5,-110,-110,-109,-1.5,165,5.28,TD Ballpark,16,-14
2021-04-10,2021,LAD,WSH,9,5,-167,-1.5,125,7.5,-105,-115,157,1.5,-145,4.69,Dodger Stadium,14,4
2021-04-11,2021,CIN,ARI,0,7,-108,-1.5,140,9.0,-120,100,-102,1.5,-160,4.67,Chase Field,7,-7
2021-04-11,2021,PHI,ATL,7,6,153,1.5,-140,9.0,-120,100,-163,-1.5,120,3.56,Suntrust Park,13,1
2021-04-11,2021,BOS,BAL,14,9,-140,-1.5,110,9.5,-115,-105,130,1.5,-130,5.54,Camden Yards,23,5
2021-04-11,2021,BAL,BOS,9,14,130,1.5,-130,9.5,-115,-105,-140,-1.5,110,4.13,Camden Yards,23,-5
2021-04-11,2021,PIT,CHC,7,1,122,1.5,-135,8.0,-120,100,-132,-1.5,115,3.6,PNC Park,8,6
2021-04-11,2021,ARI,CIN,7,0,-102,1.5,-160,9.0,-120,100,-108,-1.5,140,4.54,Chase Field,7,7
2021-04-11,2021,DET,CLE,2,5,150,1.5,-130,9.5,-105,-115,-160,-1.5,110,3.8,Progressive Field,7,-3
2021-04-11,2021,SF,COL,4,0,-125,-1.5,170,7.5,-105,-115,115,1.5,-190,4.17,AT&T Park,4,4
2021-04-11,2021,KC,CWS,4,3,102,1.5,-190,8.5,-110,-110,-112,-1.5,170,4.21,Guaranteed Rate Field,7,1
2021-04-11,2021,CLE,DET,5,2,-160,-1.5,110,9.5,-105,-115,150,1.5,-130,5.85,Progressive Field,7,3
2021-04-11,2021,CWS,KC,3,4,-112,-1.5,170,8.5,-110,-110,102,1.5,-190,4.49,Guaranteed Rate Field,7,-1
2021-04-11,2021,WSH,LAD,0,3,140,1.5,-155,7.5,100,-120,-150,-1.5,135,3.13,Dodger Stadium,3,-3
2021-04-11,2021,NYM,MIA,6,5,-160,1.5,130,8.5,-110,-110,140,-1.5,150,5.23,Citi Field,11,1
2021-04-11,2021,STL,MIL,3,9,-130,-1.5,155,8.5,-110,-110,120,1.5,-175,4.8,Busch Stadium,12,-6
2021-04-11,2021,SEA,MIN,8,6,165,1.5,-125,8.5,100,-120,-180,-1.5,105,3.21,Target Field,14,2
2021-04-11,2021,MIA,NYM,5,6,140,-1.5,150,8.5,-110,-110,-160,1.5,130,3.54,Citi Field,11,-1
2021-04-11,2021,TB,NYY,4,8,128,1.5,-130,8.5,-105,-115,-138,-1.5,110,3.73,Tropicana Field,12,-4
2021-04-11,2021,ATL,PHI,6,7,-163,-1.5,120,9.0,-120,100,153,1.5,-140,5.58,Suntrust Park,13,-1
2021-04-11,2021,CHC,PIT,1,7,-132,-1.5,115,8.0,-120,100,122,1.5,-135,4.55,PNC Park,8,-6
2021-04-11,2021,TEX,SD,0,2,150,1.5,-110,9.0,-105,-115,-160,-1.5,-110,3.6,Globe Life Field,2,-2
2021-04-11,2021,MIN,SEA,6,8,-180,-1.5,105,8.5,100,-120,165,1.5,-125,5.46,Target Field,14,-2
2021-04-11,2021,COL,SF,0,4,115,1.5,-190,7.5,-105,-115,-125,-1.5,170,3.49,AT&T Park,4,-4
2021-04-11,2021,MIL,STL,9,3,120,1.5,-175,8.5,-110,-110,-130,-1.5,155,3.86,Busch Stadium,12,6
2021-04-11,2021,NYY,TB,8,4,-138,-1.5,110,8.5,-105,-115,128,1.5,-130,4.93,Tropicana Field,12,4
2021-04-11,2021,SD,TEX,2,0,-160,-1.5,-110,9.0,-105,-115,150,1.5,-110,5.54,Globe Life Field,2,2
2021-04-11,2021,LAD,WSH,3,0,-150,-1.5,135,7.5,100,-120,140,1.5,-155,4.5,Dodger Stadium,3,3
2021-04-12,2021,OAK,ARI,9,5,-125,-1.5,120,9.5,-110,-110,115,1.5,-140,5.28,Chase Field,14,4
2021-04-12,2021,MIA,ATL,5,3,124,1.5,-170,8.5,100,-120,-134,-1.5,150,3.79,Suntrust Park,8,2
2021-04-12,2021,MIL,CHC,6,3,-126,-1.5,145,8.5,100,-120,116,1.5,-165,4.74,Miller Park,9,3
2021-04-12,2021,SF,CIN,0,3,-111,-1.5,175,8.5,-110,-110,101,1.5,-200,4.47,AT&T Park,3,-3
2021-04-12,2021,CWS,CLE,4,3,-125,-1.5,155,8.5,100,-120,115,1.5,-175,4.72,Guaranteed Rate Field,7,1
2021-04-12,2021,CLE,CWS,3,4,115,1.5,-175,8.5,100,-120,-125,-1.5,155,3.95,Guaranteed Rate Field,7,-1
2021-04-12,2021,HOU,DET,2,6,-250,-1.5,-140,9.0,100,-120,220,1.5,120,6.43,Minute Maid Park,8,-4
2021-04-12,2021,DET,HOU,6,2,220,1.5,120,9.0,100,-120,-250,-1.5,-140,2.81,Minute Maid Park,8,4
2021-04-12,2021,LAA,KC,10,3,-111,-1.5,135,9.0,100,-120,101,1.5,-155,4.73,Kauffman Stadium,13,7
2021-04-12,2021,KC,LAA,3,10,101,1.5,-155,9.0,100,-120,-111,-1.5,135,4.48,Kauffman Stadium,13,-7
2021-04-12,2021,ATL,MIA,3,5,-134,-1.5,150,8.5,100,-120,124,1.5,-170,4.87,Suntrust Park,8,-2
2021-04-12,2021,CHC,MIL,3,6,116,1.5,-165,8.5,100,-120,-126,-1.5,145,3.94,Miller Park,9,-3
2021-04-12,2021,TOR,NYY,1,3,176,1.5,105,9.0,-110,-110,-192,-1.5,-125,3.26,TD Ballpark,4,-2
2021-04-12,2021,ARI,OAK,5,9,115,1.5,-140,9.5,-110,-110,-125,-1.5,120,4.42,Chase Field,14,-4
2021-04-12,2021,SD,PIT,6,2,-196,-1.5,-130,7.5,-105,-115,178,1.5,110,4.97,PNC Park,8,4
2021-04-12,2021,PIT,SD,2,6,178,1.5,110,7.5,-105,-115,-196,-1.5,-130,2.7,PNC Park,8,-4
2021-04-12,2021,CIN,SF,3,0,101,1.5,-200,8.5,-110,-110,-111,-1.5,175,4.23,AT&T Park,3,3
2021-04-12,2021,WSH,STL,5,2,128,1.5,-160,8.5,-120,100,-138,-1.5,140,3.73,Busch Stadium,7,3
2021-04-12,2021,TEX,TB,0,1,185,1.5,-125,7.0,-120,100,-205,-1.5,105,2.46,Tropicana Field,1,-1
2021-04-12,2021,TB,TEX,1,0,-205,-1.5,105,7.0,-120,100,185,1.5,-125,4.7,Tropicana Field,1,1
2021-04-12,2021,NYY,TOR,3,1,-192,-1.5,-125,9.0,-110,-110,176,1.5,105,5.92,TD Ballpark,4,2
2021-04-12,2021,STL,WSH,2,5,-138,-1.5,140,8.5,-120,100,128,1.5,-160,4.93,Busch Stadium,7,-3
2021-04-13,2021,OAK,ARI,7,5,-105,-1.5,145,8.5,-105,-115,-105,1.5,-165,4.35,Chase Field,12,2
2021-04-13,2021,MIA,ATL,14,8,148,1.5,-135,7.5,-115,-105,-158,-1.5,115,3.02,Suntrust Park,22,6
2021-04-13,2021,SEA,BAL,4,3,126,1.5,-185,6.0,-115,-105,-136,-1.5,165,2.65,Camden Yards,7,1
2021-04-13,2021,SEA,BAL,6,7,120,1.5,-185,7.0,100,-120,-130,-1.5,165,3.18,Camden Yards,13,-1
2021-04-13,2021,MIN,BOS,2,4,-122,-1.5,160,9.0,100,-120,112,1.5,-180,4.95,Target Field,6,-2
2021-04-13,2021,MIL,CHC,2,3,-143,-1.5,150,7.5,-110,-110,133,1.5,-170,4.41,Miller Park,5,-1
2021-04-13,2021,SF,CIN,7,6,-109,-1.5,195,7.5,100,-120,-101,1.5,-220,3.91,AT&T Park,13,1
2021-04-13,2021,CWS,CLE,0,2,-113,-1.5,175,6.5,-115,-105,103,1.5,-200,3.45,Guaranteed Rate Field,2,-2
2021-04-13,2021,LAD,COL,7,0,-320,-1.5,-150,8.0,100,-120,280,1.5,130,6.1,Dodger Stadium,7,7
2021-04-13,2021,CLE,CWS,2,0,103,1.5,-200,6.5,-115,-105,-113,-1.5,175,3.2,Guaranteed Rate Field,2,2
2021-04-13,2021,HOU,DET,2,8,-176,-1.5,105,9.5,100,-120,163,1.5,-125,6.06,Minute Maid Park,10,-6
2021-04-13,2021,DET,HOU,8,2,163,1.5,-125,9.5,100,-120,-176,-1.5,105,3.61,Minute Maid Park,10,6
2021-04-13,2021,LAA,KC,2,3,-132,-1.5,120,8.5,-110,-110,122,1.5,-140,4.84,Kauffman Stadium,5,-1
2021-04-13,2021,KC,LAA,3,2,122,1.5,-140,8.5,-110,-110,-132,-1.5,120,3.83,Kauffman Stadium,5,1
2021-04-13,2021,COL,LAD,0,7,280,1.5,130,8.0,100,-120,-320,-1.5,-150,2.11,Dodger Stadium,7,-7
2021-04-13,2021,ATL,MIA,8,14,-158,-1.5,115,7.5,-115,-105,148,1.5,-135,4.59,Suntrust Park,22,-6
2021-04-13,2021,CHC,MIL,3,2,133,1.5,-170,7.5,-110,-110,-143,-1.5,150,3.22,Miller Park,5,1
2021-04-13,2021,BOS,MIN,4,2,112,1.5,-180,9.0,100,-120,-122,-1.5,160,4.25,Target Field,6,2
2021-04-13,2021,PHI,NYM,3,4,140,1.5,-175,6.5,-135,115,-150,-1.5,155,2.71,Citi Field,7,-1
2021-04-13,2021,PHI,NYM,0,4,-119,-1.5,165,5.5,-110,-110,109,1.5,-185,2.99,Citi Field,4,-4
2021-04-13,2021,TOR,NYY,7,3,-113,-1.5,165,9.0,100,-120,103,1.5,-185,4.77,TD Ballpark,10,4
2021-04-13,2021,ARI,OAK,5,7,-105,1.5,-165,8.5,-105,-115,-105,-1.5,145,4.35,Chase Field,12,-2
2021-04-13,2021,NYM,PHI,4,3,-150,-1.5,155,6.5,-135,115,140,1.5,-175,3.9,Citi Field,7,1
2021-04-13,2021,NYM,PHI,4,0,109,1.5,-185,5.5,-110,-110,-119,-1.5,165,2.63,Citi Field,4,4
2021-04-13,2021,SD,PIT,4,8,-240,-1.5,-145,8.0,100,-120,210,1.5,125,5.65,PNC Park,12,-4
2021-04-13,2021,PIT,SD,8,4,210,1.5,125,8.0,100,-120,-240,-1.5,-145,2.58,PNC Park,12,4
2021-04-13,2021,BAL,SEA,3,4,-136,-1.5,165,6.0,-115,-105,126,1.5,-185,3.46,Camden Yards,7,-1
2021-04-13,2021,BAL,SEA,7,6,-130,-1.5,165,7.0,100,-120,120,1.5,-185,3.96,Camden Yards,13,1
2021-04-13,2021,CIN,SF,6,7,-101,1.5,-220,7.5,100,-120,-109,-1.5,195,3.77,AT&T Park,13,-1
2021-04-13,2021,WSH,STL,3,14,-106,1.5,-220,7.0,-115,-105,-104,-1.5,195,3.6,Busch Stadium,17,-11
2021-04-13,2021,TEX,TB,8,3,153,1.5,-135,8.0,100,-120,-163,-1.5,115,3.16,Tropicana Field,11,5
2021-04-13,2021,TB,TEX,3,8,-163,-1.5,115,8.0,100,-120,153,1.5,-135,4.96,Tropicana Field,11,-5
2021-04-13,2021,NYY,TOR,3,7,103,1.5,-185,9.0,100,-120,-113,-1.5,165,4.43,TD Ballpark,10,-4
2021-04-13,2021,STL,WSH,14,3,-104,-1.5,195,7.0,-115,-105,-106,1.5,-220,3.57,Busch Stadium,17,11
2021-04-14,2021,MIA,ATL,6,5,220,1.5,105,8.5,-110,-110,-250,-1.5,-125,2.66,Suntrust Park,11,1
2021-04-14,2021,MIN,BOS,2,3,-130,-1.5,185,6.0,100,-120,120,1.5,-210,3.39,Target Field,5,-1
2021-04-14,2021,MIN,BOS,1,7,-145,-1.5,160,6.0,-115,-105,135,1.5,-180,3.55,Target Field,8,-6
2021-04-14,2021,MIL,CHC,7,0,-174,-1.5,120,7.5,105,-125,162,1.5,-140,4.76,Miller Park,7,7
2021-04-14,2021,SF,CIN,3,0,108,1.5,-160,8.5,100,-120,-118,-1.5,140,4.09,AT&T Park,3,3
2021-04-14,2021,CWS,CLE,8,0,-111,-1.5,180,7.5,100,-120,101,1.5,-205,3.95,Guaranteed Rate Field,8,8
2021-04-14,2021,LAD,COL,4,2,-255,-1.5,-125,7.5,-120,100,225,1.5,105,5.39,Dodger Stadium,6,2
2021-04-14,2021,CLE,CWS,0,8,101,1.5,-205,7.5,100,-120,-111,-1.5,180,3.73,Guaranteed Rate Field,8,-8
2021-04-14,2021,HOU,DET,4,6,-183,-1.5,100,8.0,-110,-110,168,1.5,-120,5.17,Minute Maid Park,10,-2
2021-04-14,2021,DET,HOU,6,4,168,1.5,-120,8.0,-110,-110,-183,-1.5,100,2.99,Minute Maid Park,10,2
2021-04-14,2021,LAA,KC,1,6,-126,-1.5,120,8.5,-120,100,116,1.5,-140,4.74,Kauffman Stadium,7,-5
2021-04-14,2021,KC,LAA,6,1,116,1.5,-140,8.5,-120,100,-126,-1.5,120,3.94,Kauffman Stadium,7,5
2021-04-14,2021,COL,LAD,2,4,225,1.5,105,7.5,-120,100,-255,-1.5,-125,2.31,Dodger Stadium,6,-2
2021-04-14,2021,ATL,MIA,5,6,-250,-1.5,-125,8.5,-110,-110,220,1.5,105,6.07,Suntrust Park,11,-1
2021-04-14,2021,CHC,MIL,0,7,162,1.5,-140,7.5,105,-125,-174,-1.5,120,2.86,Miller Park,7,-7
2021-04-14,2021,BOS,MIN,3,2,120,1.5,-210,6.0,100,-120,-130,-1.5,185,2.73,Target Field,5,1
2021-04-14,2021,BOS,MIN,7,1,135,1.5,-180,6.0,-115,-105,-145,-1.5,160,2.55,Target Field,8,6
2021-04-14,2021,PHI,NYM,1,5,-114,-1.5,140,8.0,-115,-105,104,1.5,-160,4.26,Citi Field,6,-4
2021-04-14,2021,TOR,NYY,5,4,130,1.5,-125,10.5,100,-120,-140,-1.5,105,4.57,TD Ballpark,9,1
2021-04-14,2021,NYM,PHI,5,1,104,1.5,-160,8.0,-115,-105,-114,-1.5,140,3.92,Citi Field,6,4
2021-04-14,2021,SD,PIT,1,5,-192,-1.5,-125,7.5,-110,-110,176,1.5,105,4.93,PNC Park,6,-4
2021-04-14,2021,PIT,SD,5,1,176,1.5,105,7.5,-110,-110,-192,-1.5,-125,2.72,PNC Park,6,4
2021-04-14,2021,CIN,SF,0,3,-118,-1.5,140,8.5,100,-120,108,1.5,-160,4.6,AT&T Park,3,-3
2021-04-14,2021,WSH,STL,6,0,106,1.5,-185,8.5,-105,-115,-116,-1.5,165,4.13,Busch Stadium,6,6
2021-04-14,2021,TEX,TB,5,1,174,1.5,-115,8.0,-120,100,-189,-1.5,-105,2.92,Tropicana Field,6,4
2021-04-14,2021,TB,TEX,1,5,-189,-1.5,-105,8.0,-120,100,174,1.5,-115,5.23,Tropicana Field,6,-4
2021-04-14,2021,NYY,TOR,4,5,-140,-1.5,105,10.5,100,-120,130,1.5,-125,6.13,TD Ballpark,9,-1
2021-04-14,2021,STL,WSH,0,6,-116,-1.5,165,8.5,-105,-115,106,1.5,-185,4.56,Busch Stadium,6,-6
2021-04-15,2021,WSH,ARI,6,11,-172,-1.5,110,8.5,-115,-105,161,1.5,-130,5.38,Nationals Park,17,-5
2021-04-15,2021,MIA,ATL,6,7,147,1.5,-140,8.0,-110,-110,-157,-1.5,120,3.24,Suntrust Park,13,-1
2021-04-15,2021,SEA,BAL,4,2,-108,-1.5,155,7.0,-120,100,-102,1.5,-175,3.63,Camden Yards,6,2
2021-04-15,2021,SEA,BAL,2,1,125,1.5,-170,7.0,-125,105,-135,-1.5,150,3.11,Camden Yards,3,1
2021-04-15,2021,MIN,BOS,4,3,-135,-1.5,140,8.5,-115,-105,125,1.5,-160,4.88,Target Field,7,1
2021-04-15,2021,CWS,CLE,2,4,-155,-1.5,130,7.5,100,-120,145,1.5,-150,4.56,Guaranteed Rate Field,6,-2
2021-04-15,2021,LAD,COL,7,5,-270,-1.5,-125,7.5,-110,-110,240,1.5,105,5.47,Dodger Stadium,12,2
2021-04-15,2021,CLE,CWS,4,2,145,1.5,-150,7.5,100,-120,-155,-1.5,130,3.06,Guaranteed Rate Field,6,2
2021-04-15,2021,OAK,DET,8,4,-176,-1.5,110,8.5,-105,-115,163,1.5,-130,5.42,Oakland Coliseum,12,4
2021-04-15,2021,TOR,KC,5,7,105,1.5,-185,9.0,-105,-115,-115,-1.5,165,4.39,Kauffman Stadium,12,-2
2021-04-15,2021,COL,LAD,5,7,240,1.5,105,7.5,-110,-110,-270,-1.5,-125,2.21,Dodger Stadium,12,-2
2021-04-15,2021,ATL,MIA,7,6,-157,-1.5,120,8.0,-110,-110,147,1.5,-140,4.89,Suntrust Park,13,1
2021-04-15,2021,BOS,MIN,3,4,125,1.5,-160,8.5,-115,-105,-135,-1.5,140,3.78,Target Field,7,-1
2021-04-15,2021,DET,OAK,4,8,163,1.5,-130,8.5,-105,-115,-176,-1.5,110,3.23,Oakland Coliseum,12,-4
2021-04-15,2021,SD,PIT,8,3,-145,-1.5,110,7.5,100,-120,135,1.5,-130,4.44,PNC Park,11,5
2021-04-15,2021,PIT,SD,3,8,135,1.5,-130,7.5,100,-120,-145,-1.5,110,3.19,PNC Park,11,-5
2021-04-15,2021,BAL,SEA,2,4,-102,1.5,-175,7.0,-120,100,-108,-1.5,155,3.53,Camden Yards,6,-2
2021-04-15,2021,BAL,SEA,1,2,-135,-1.5,150,7.0,-125,105,125,1.5,-170,4.02,Camden Yards,3,-1
2021-04-15,2021,TEX,TB,6,4,165,1.5,-125,8.0,-115,-105,-180,-1.5,105,3.02,Tropicana Field,10,2
2021-04-15,2021,TB,TEX,4,6,-180,-1.5,105,8.0,-115,-105,165,1.5,-125,5.14,Tropicana Field,10,-2
2021-04-15,2021,KC,TOR,7,5,-115,-1.5,165,9.0,-105,-115,105,1.5,-185,4.81,Kauffman Stadium,12,2
2021-04-15,2021,ARI,WSH,11,6,161,1.5,-130,8.5,-115,-105,-172,-1.5,110,3.26,Nationals Park,17,5
2021-04-16,2021,WSH,ARI,1,0,-192,-1.5,100,8.5,-105,-115,176,1.5,-120,5.59,Nationals Park,1,1
2021-04-16,2021,CHC,ATL,2,5,-110,-1.5,185,8.0,-115,-105,100,1.5,-210,4.19,Wrigley Field,7,-3
2021-04-16,2021,TEX,BAL,2,5,-119,-1.5,155,8.5,-125,105,109,1.5,-175,4.62,Globe Life Field,7,-3
2021-04-16,2021,ATL,CHC,5,2,100,1.5,-210,8.0,-115,-105,-110,-1.5,185,4.0,Wrigley Field,7,3
2021-04-16,2021,CLE,CIN,3,10,107,1.5,-190,9.0,-115,-105,-117,-1.5,170,4.35,Great American Ballpark,13,-7
2021-04-16,2021,CIN,CLE,10,3,-117,-1.5,170,9.0,-115,-105,107,1.5,-190,4.85,Great American Ballpark,13,7
2021-04-16,2021,OAK,DET,3,0,-185,-1.5,110,8.5,-110,-110,170,1.5,-130,5.52,Oakland Coliseum,3,3
2021-04-16,2021,SEA,HOU,6,5,-102,1.5,-160,8.0,-110,-110,-108,-1.5,140,4.04,T-Mobile Park,11,1
2021-04-16,2021,MIN,LAA,3,10,116,1.5,-170,9.0,-110,-110,-126,-1.5,150,4.17,Angel Stadium,13,-7
2021-04-16,2021,SD,LAD,6,11,137,1.5,-125,8.0,-105,-115,-147,-1.5,105,3.38,PETCO Park,17,-5
2021-04-16,2021,SF,MIA,1,4,-130,-1.5,120,8.5,-105,-115,120,1.5,-140,4.8,Marlins Park,5,-3
2021-04-16,2021,PIT,MIL,6,1,131,1.5,-165,8.0,-105,-115,-141,-1.5,145,3.46,Miller Park,7,5
2021-04-16,2021,LAA,MIN,10,3,-126,-1.5,150,9.0,-110,-110,116,1.5,-170,5.02,Angel Stadium,13,7
2021-04-16,2021,TB,NYY,8,2,149,1.5,-135,9.5,105,-125,-159,-1.5,115,3.82,Yankee Stadium,10,6
2021-04-16,2021,DET,OAK,0,3,170,1.5,-130,8.5,-110,-110,-185,-1.5,110,3.15,Oakland Coliseum,3,-3
2021-04-16,2021,STL,PHI,2,9,134,1.5,-155,8.0,-115,-105,-144,-1.5,135,3.42,Citizens Bank Park,11,-7
2021-04-16,2021,MIL,PIT,1,6,-141,-1.5,145,8.0,-105,-115,131,1.5,-165,4.68,Miller Park,7,-5
2021-04-16,2021,LAD,SD,11,6,-147,-1.5,105,8.0,-105,-115,137,1.5,-125,4.76,PETCO Park,17,5
2021-04-16,2021,HOU,SEA,5,6,-108,-1.5,140,8.0,-110,-110,-102,1.5,-160,4.15,T-Mobile Park,11,-1
2021-04-16,2021,MIA,SF,4,1,120,1.5,-140,8.5,-105,-115,-130,-1.5,120,3.86,Marlins Park,5,3
2021-04-16,2021,PHI,STL,9,2,-144,-1.5,135,8.0,-115,-105,134,1.5,-155,4.72,Citizens Bank Park,11,7
2021-04-16,2021,NYY,TB,2,8,-159,-1.5,115,9.5,105,-125,149,1.5,-135,5.83,Yankee Stadium,10,-6
2021-04-16,2021,BAL,TEX,5,2,109,1.5,-175,8.5,-125,105,-119,-1.5,155,4.07,Globe Life Field,7,3
2021-04-16,2021,ARI,WSH,0,1,176,1.5,-120,8.5,-105,-115,-192,-1.5,100,3.08,Nationals Park,1,-1
2021-04-17,2021,WSH,ARI,6,2,-113,-1.5,175,8.5,-120,100,103,1.5,-200,4.51,Nationals Park,8,4
2021-04-17,2021,CHC,ATL,13,4,101,1.5,-165,7.5,-115,-105,-111,-1.5,145,3.73,Wrigley Field,17,9
2021-04-17,2021,TEX,BAL,1,6,-135,-1.5,145,8.5,100,-120,125,1.5,-165,4.88,Globe Life Field,7,-5
2021-04-17,2021,CWS,BOS,4,7,117,1.5,-170,9.0,-105,-115,-127,-1.5,150,4.15,Fenway Park,11,-3
2021-04-17,2021,ATL,CHC,4,13,-111,-1.5,145,7.5,-115,-105,101,1.5,-165,3.95,Wrigley Field,17,-9
2021-04-17,2021,CLE,CIN,2,3,127,1.5,-165,8.0,-115,-105,-137,-1.5,145,3.52,Great American Ballpark,5,-1
2021-04-17,2021,CIN,CLE,3,2,-137,-1.5,145,8.0,-115,-105,127,1.5,-165,4.62,Great American Ballpark,5,1
2021-04-17,2021,NYM,COL,4,3,-280,-1.5,-150,6.5,-125,105,245,1.5,130,4.79,Coors Field,7,1
2021-04-17,2021,NYM,COL,2,7,-118,-1.5,135,8.0,-110,-110,108,1.5,-155,4.33,Coors Field,9,-5
2021-04-17,2021,BOS,CWS,7,4,-127,-1.5,150,9.0,-105,-115,117,1.5,-170,5.04,Fenway Park,11,3
2021-04-17,2021,OAK,DET,7,0,-128,-1.5,145,9.0,-115,-105,118,1.5,-165,5.05,Oakland Coliseum,7,7
2021-04-17,2021,SEA,HOU,0,1,118,1.5,-135,8.5,-110,-110,-128,-1.5,115,3.9,T-Mobile Park,1,-1
2021-04-17,2021,TOR,KC,5,1,-105,-1.5,165,6.5,-105,-115,-105,1.5,-185,3.33,Kauffman Stadium,6,4
2021-04-17,2021,TOR,KC,2,3,-115,-1.5,150,7.5,-110,-110,105,1.5,-170,4.01,Kauffman Stadium,5,-1
2021-04-17,2021,SD,LAD,0,2,106,1.5,-165,7.0,-120,100,-116,-1.5,145,3.4,PETCO Park,2,-2
2021-04-17,2021,SF,MIA,6,7,120,1.5,-180,7.5,-105,-115,-130,-1.5,160,3.41,Marlins Park,13,-1
2021-04-17,2021,PIT,MIL,1,7,119,1.5,-165,8.0,-115,-105,-129,-1.5,145,3.65,Miller Park,8,-6
2021-04-17,2021,COL,NYM,3,4,245,1.5,130,6.5,-125,105,-280,-1.5,-150,1.88,Coors Field,7,-1
2021-04-17,2021,COL,NYM,7,2,108,1.5,-155,8.0,-110,-110,-118,-1.5,135,3.85,Coors Field,9,5
2021-04-17,2021,TB,NYY,6,3,-105,-1.5,150,7.5,-110,-110,-105,1.5,-170,3.84,Yankee Stadium,9,3
2021-04-17,2021,DET,OAK,0,7,118,1.5,-165,9.0,-115,-105,-128,-1.5,145,4.13,Oakland Coliseum,7,-7
2021-04-17,2021,STL,PHI,9,4,-102,1.5,-205,8.5,100,-120,-108,-1.5,180,4.29,Citizens Bank Park,13,5
2021-04-17,2021,MIL,PIT,7,1,-129,-1.5,145,8.0,-115,-105,119,1.5,-165,4.51,Miller Park,8,6
2021-04-17,2021,LAD,SD,2,0,-116,-1.5,145,7.0,-120,100,106,1.5,-165,3.76,PETCO Park,2,2
2021-04-17,2021,HOU,SEA,1,0,-128,-1.5,115,8.5,-110,-110,118,1.5,-135,4.77,T-Mobile Park,1,1
2021-04-17,2021,MIA,SF,7,6,-130,-1.5,160,7.5,-105,-115,120,1.5,-180,4.24,Marlins Park,13,1
2021-04-17,2021,PHI,STL,4,9,-108,-1.5,180,8.5,100,-120,-102,1.5,-205,4.41,Citizens Bank Park,13,-5
2021-04-17,2021,NYY,TB,3,6,-105,1.5,-170,7.5,-110,-110,-105,-1.5,150,3.84,Yankee Stadium,9,-3
2021-04-17,2021,BAL,TEX,6,1,125,1.5,-165,8.5,100,-120,-135,-1.5,145,3.78,Globe Life Field,7,5
2021-04-17,2021,KC,TOR,1,5,-105,1.5,-185,6.5,-105,-115,-105,-1.5,165,3.33,Kauffman Stadium,6,-4
2021-04-17,2021,KC,TOR,3,2,105,1.5,-170,7.5,-110,-110,-115,-1.5,150,3.66,Kauffman Stadium,5,1
2021-04-17,2021,ARI,WSH,2,6,103,1.5,-200,8.5,-120,100,-113,-1.5,175,4.19,Nationals Park,8,-4
2021-04-18,2021,WSH,ARI,2,5,-142,-1.5,135,9.5,100,-120,132,1.5,-155,5.57,Nationals Park,7,-3
2021-04-18,2021,CHC,ATL,4,13,-140,-1.5,135,9.0,100,-120,130,1.5,-155,5.25,Wrigley Field,17,-9
2021-04-18,2021,TEX,BAL,1,0,100,1.5,-180,8.0,100,-120,-110,-1.5,160,4.0,Globe Life Field,1,1
2021-04-18,2021,CWS,BOS,3,2,-102,1.5,-205,7.0,-115,-105,-108,-1.5,180,3.53,Fenway Park,5,1
2021-04-18,2021,CWS,BOS,5,1,-115,-1.5,145,7.0,-120,100,105,1.5,-165,3.74,Fenway Park,6,4
2021-04-18,2021,ATL,CHC,13,4,130,1.5,-155,9.0,100,-120,-140,-1.5,135,3.91,Wrigley Field,17,9
2021-04-18,2021,CLE,CIN,6,3,-155,-1.5,105,7.0,-120,100,145,1.5,-125,4.25,Great American Ballpark,9,3
2021-04-18,2021,CIN,CLE,3,6,145,1.5,-125,7.0,-120,100,-155,-1.5,105,2.86,Great American Ballpark,9,-3
2021-04-18,2021,NYM,COL,2,1,-180,-1.5,-125,11.0,-110,-110,165,1.5,105,7.07,Coors Field,3,1
2021-04-18,2021,BOS,CWS,2,3,-108,-1.5,180,7.0,-115,-105,-102,1.5,-205,3.63,Fenway Park,5,-1
2021-04-18,2021,BOS,CWS,1,5,105,1.5,-165,7.0,-120,100,-115,-1.5,145,3.41,Fenway Park,6,-4
2021-04-18,2021,OAK,DET,3,2,-150,-1.5,130,8.5,-120,100,140,1.5,-150,5.1,Oakland Coliseum,5,1
2021-04-18,2021,SEA,HOU,7,2,112,1.5,-150,9.0,-110,-110,-122,-1.5,130,4.25,T-Mobile Park,9,5
2021-04-18,2021,TOR,KC,0,2,102,1.5,-200,8.5,100,-120,-112,-1.5,175,4.21,Kauffman Stadium,2,-2
2021-04-18,2021,SD,LAD,5,2,115,1.5,-155,7.5,-110,-110,-125,-1.5,135,3.49,PETCO Park,7,3
2021-04-18,2021,SF,MIA,1,0,128,1.5,-165,8.0,-110,-110,-138,-1.5,145,3.51,Marlins Park,1,1
2021-04-18,2021,PIT,MIL,6,5,180,1.5,-125,7.5,-110,-110,-200,-1.5,105,2.68,Miller Park,11,1
2021-04-18,2021,COL,NYM,1,2,165,1.5,105,11.0,-110,-110,-180,-1.5,-125,4.15,Coors Field,3,-1
2021-04-18,2021,TB,NYY,4,2,220,1.5,105,7.5,-115,-105,-250,-1.5,-125,2.34,Yankee Stadium,6,2
2021-04-18,2021,DET,OAK,2,3,140,1.5,-150,8.5,-120,100,-150,-1.5,130,3.54,Oakland Coliseum,5,-1
2021-04-18,2021,STL,PHI,0,2,163,1.5,-135,8.0,-105,-115,-176,-1.5,115,3.04,Citizens Bank Park,2,-2
2021-04-18,2021,MIL,PIT,5,6,-200,-1.5,105,7.5,-110,-110,180,1.5,-125,5.0,Miller Park,11,-1
2021-04-18,2021,LAD,SD,2,5,-125,-1.5,135,7.5,-110,-110,115,1.5,-155,4.17,PETCO Park,7,-3
2021-04-18,2021,HOU,SEA,2,7,-122,-1.5,130,9.0,-110,-110,112,1.5,-150,4.95,T-Mobile Park,9,-5
2021-04-18,2021,MIA,SF,0,1,-138,-1.5,145,8.0,-110,-110,128,1.5,-165,4.64,Marlins Park,1,-1
2021-04-18,2021,PHI,STL,2,0,-176,-1.5,115,8.0,-105,-115,163,1.5,-135,5.1,Citizens Bank Park,2,2
2021-04-18,2021,NYY,TB,2,4,-250,-1.5,-125,7.5,-115,-105,220,1.5,105,5.36,Yankee Stadium,6,-2
2021-04-18,2021,BAL,TEX,0,1,-110,-1.5,160,8.0,100,-120,100,1.5,-180,4.19,Globe Life Field,1,-1
2021-04-18,2021,KC,TOR,2,0,-112,-1.5,175,8.5,100,-120,102,1.5,-200,4.49,Kauffman Stadium,2,2
2021-04-18,2021,ARI,WSH,5,2,132,1.5,-155,9.5,100,-120,-142,-1.5,135,4.09,Nationals Park,7,3
2021-04-19,2021,CWS,BOS,4,11,-115,-1.5,140,7.5,-120,100,105,1.5,-160,4.01,Fenway Park,15,-7
2021-04-19,2021,BOS,CWS,11,4,105,1.5,-160,7.5,-120,100,-115,-1.5,140,3.66,Fenway Park,15,7
2021-04-19,2021,TB,KC,4,1,-102,1.5,-210,7.5,-110,-110,-108,-1.5,185,3.79,Kauffman Stadium,5,3
2021-04-19,2021,TEX,LAA,6,4,200,1.5,-115,8.5,-115,-105,-220,-1.5,-105,2.83,Angel Stadium,10,2
2021-04-19,2021,SEA,LAD,4,3,178,1.5,105,8.5,100,-120,-196,-1.5,-125,3.06,T-Mobile Park,7,1
2021-04-19,2021,SD,MIL,1,3,-165,-1.5,140,6.5,-115,-105,155,1.5,-160,4.05,PETCO Park,4,-2
2021-04-19,2021,SF,PHI,2,0,-105,-1.5,150,8.5,-105,-115,-105,1.5,-170,4.35,Citizens Bank Park,2,2
2021-04-19,2021,MIL,SD,3,1,155,1.5,-160,6.5,-115,-105,-165,-1.5,140,2.55,PETCO Park,4,2
2021-04-19,2021,LAD,SEA,3,4,-196,-1.5,-125,8.5,100,-120,178,1.5,105,5.63,T-Mobile Park,7,-1
2021-04-19,2021,PHI,SF,0,2,-105,1.5,-170,8.5,-105,-115,-105,-1.5,150,4.35,Citizens Bank Park,2,-2
2021-04-19,2021,WSH,STL,5,12,-102,1.5,-170,8.0,-115,-105,-108,-1.5,150,4.04,Nationals Park,17,-7
2021-04-19,2021,KC,TB,1,4,-108,-1.5,185,7.5,-110,-110,-102,1.5,-210,3.89,Kauffman Stadium,5,-3
2021-04-19,2021,LAA,TEX,4,6,-220,-1.5,-105,8.5,-115,-105,200,1.5,-115,5.84,Angel Stadium,10,-2
2021-04-19,2021,STL,WSH,12,5,-108,-1.5,150,8.0,-115,-105,-102,1.5,-170,4.15,Nationals Park,17,7
2021-04-20,2021,CIN,ARI,4,5,-142,-1.5,145,7.5,-105,-115,132,1.5,-165,4.4,Great American Ballpark,9,-1
2021-04-20,2021,NYY,ATL,3,1,-118,-1.5,160,8.5,-115,-105,108,1.5,-180,4.6,Yankee Stadium,4,2
2021-04-20,2021,MIA,BAL,5,7,-118,-1.5,160,8.5,-105,-115,108,1.5,-180,4.6,Marlins Park,12,-2
2021-04-20,2021,TOR,BOS,2,4,-107,-1.5,155,8.0,-120,100,-103,1.5,-175,4.14,Fenway Park,6,-2
2021-04-20,2021,NYM,CHC,1,3,-125,-1.5,135,7.5,-115,-105,115,1.5,-155,4.17,Wrigley Field,4,-2
2021-04-20,2021,ARI,CIN,5,4,132,1.5,-165,7.5,-105,-115,-142,-1.5,145,3.23,Great American Ballpark,9,1
2021-04-20,2021,CWS,CLE,8,5,-108,-1.5,150,7.0,-115,-105,-102,1.5,-170,3.63,Progressive Field,13,3
2021-04-20,2021,HOU,COL,2,6,-112,-1.5,135,10.0,-120,100,102,1.5,-155,5.28,Coors Field,8,-4
2021-04-20,2021,CLE,CWS,5,8,-102,1.5,-170,7.0,-115,-105,-108,-1.5,150,3.53,Progressive Field,13,-3
2021-04-20,2021,COL,HOU,6,2,102,1.5,-155,10.0,-120,100,-112,-1.5,135,4.95,Coors Field,8,4
2021-04-20,2021,TB,KC,14,7,-105,1.5,-215,8.0,-105,-115,-105,-1.5,190,4.1,Kauffman Stadium,21,7
2021-04-20,2021,TEX,LAA,2,6,169,1.5,-120,8.5,-120,100,-184,-1.5,100,3.16,Angel Stadium,8,-4
2021-04-20,2021,SEA,LAD,0,1,175,1.5,100,8.0,-120,100,-190,-1.5,-120,2.91,T-Mobile Park,1,-1
2021-04-20,2021,BAL,MIA,7,5,108,1.5,-180,8.5,-105,-115,-118,-1.5,160,4.09,Marlins Park,12,2
2021-04-20,2021,SD,MIL,0,6,102,1.5,-190,6.5,-115,-105,-112,-1.5,170,3.22,PETCO Park,6,-6
2021-04-20,2021,OAK,MIN,7,0,-115,-1.5,170,6.5,-115,-105,105,1.5,-190,3.48,Oakland Coliseum,7,7
2021-04-20,2021,OAK,MIN,1,0,106,1.5,-180,5.5,-120,100,-116,-1.5,160,2.67,Oakland Coliseum,1,1
2021-04-20,2021,CHC,NYM,3,1,115,1.5,-155,7.5,-115,-105,-125,-1.5,135,3.49,Wrigley Field,4,2
2021-04-20,2021,ATL,NYY,1,3,108,1.5,-180,8.5,-115,-105,-118,-1.5,160,4.09,Yankee Stadium,4,-2
2021-04-20,2021,MIN,OAK,0,7,105,1.5,-190,6.5,-115,-105,-115,-1.5,170,3.17,Oakland Coliseum,7,-7
2021-04-20,2021,MIN,OAK,0,1,-116,-1.5,160,5.5,-120,100,106,1.5,-180,2.95,Oakland Coliseum,1,-1
2021-04-20,2021,SF,PHI,10,7,135,1.5,-155,8.5,-105,-115,-145,-1.5,135,3.62,Citizens Bank Park,17,3
2021-04-20,2021,MIL,SD,6,0,-112,-1.5,170,6.5,-115,-105,102,1.5,-190,3.43,PETCO Park,6,6
2021-04-20,2021,LAD,SEA,1,0,-190,-1.5,-120,8.0,-120,100,175,1.5,100,5.24,T-Mobile Park,1,1
2021-04-20,2021,PHI,SF,7,10,-145,-1.5,135,8.5,-105,-115,135,1.5,-155,5.03,Citizens Bank Park,17,-3
2021-04-20,2021,WSH,STL,3,2,-111,-1.5,170,9.0,-105,-115,101,1.5,-190,4.73,Nationals Park,5,1
2021-04-20,2021,KC,TB,7,14,-105,-1.5,190,8.0,-105,-115,-105,1.5,-215,4.1,Kauffman Stadium,21,-7
2021-04-20,2021,LAA,TEX,6,2,-184,-1.5,100,8.5,-120,100,169,1.5,-120,5.51,Angel Stadium,8,4
2021-04-20,2021,BOS,TOR,4,2,-103,1.5,-175,8.0,-120,100,-107,-1.5,155,4.06,Fenway Park,6,2
2021-04-20,2021,STL,WSH,2,3,101,1.5,-190,9.0,-105,-115,-111,-1.5,170,4.48,Nationals Park,5,-1
2021-04-21,2021,CIN,ARI,5,8,-168,-1.5,115,8.0,-105,-115,158,1.5,-135,5.01,Great American Ballpark,13,-3
2021-04-21,2021,NYY,ATL,1,4,-140,-1.5,135,9.0,-105,-115,130,1.5,-155,5.25,Yankee Stadium,5,-3
2021-04-21,2021,MIA,BAL,3,0,-155,-1.5,135,7.5,100,-120,145,1.5,-155,4.56,Marlins Park,3,3
2021-04-21,2021,TOR,BOS,6,3,118,1.5,-165,9.5,-115,-105,-128,-1.5,145,4.36,Fenway Park,9,3
2021-04-21,2021,NYM,CHC,4,16,-123,-1.5,140,7.5,-110,-110,113,1.5,-160,4.14,Wrigley Field,20,-12
2021-04-21,2021,ARI,CIN,8,5,158,1.5,-135,8.0,-105,-115,-168,-1.5,115,3.1,Great American Ballpark,13,3
2021-04-21,2021,HOU,COL,3,6,-140,-1.5,100,10.0,-105,-115,130,1.5,-120,5.83,Coors Field,9,-3
2021-04-21,2021,PIT,DET,3,2,113,1.5,-210,6.0,-115,-105,-123,-1.5,185,2.82,Comerica Park,5,1
2021-04-21,2021,PIT,DET,2,5,123,1.5,-190,6.5,-110,-110,-133,-1.5,170,2.91,Comerica Park,7,-3
2021-04-21,2021,COL,HOU,6,3,130,1.5,-120,10.0,-105,-115,-140,-1.5,100,4.35,Coors Field,9,3
2021-04-21,2021,TB,KC,8,9,-110,-1.5,155,8.0,100,-120,100,1.5,-175,4.19,Kauffman Stadium,17,-1
2021-04-21,2021,TEX,LAA,7,4,161,1.5,-130,9.0,-110,-110,-172,-1.5,110,3.45,Angel Stadium,11,3
2021-04-21,2021,BAL,MIA,0,3,145,1.5,-155,7.5,100,-120,-155,-1.5,135,3.06,Marlins Park,3,-3
2021-04-21,2021,SD,MIL,2,4,-196,-1.5,115,7.5,100,-120,178,1.5,-135,4.97,PETCO Park,6,-2
2021-04-21,2021,OAK,MIN,13,12,-112,-1.5,185,7.5,-115,-105,102,1.5,-210,3.96,Oakland Coliseum,25,1
2021-04-21,2021,CHC,NYM,16,4,113,1.5,-160,7.5,-110,-110,-123,-1.5,140,3.52,Wrigley Field,20,12
2021-04-21,2021,ATL,NYY,4,1,130,1.5,-155,9.0,-105,-115,-140,-1.5,135,3.91,Yankee Stadium,5,3
2021-04-21,2021,MIN,OAK,12,13,102,1.5,-210,7.5,-115,-105,-112,-1.5,185,3.71,Oakland Coliseum,25,-1
2021-04-21,2021,SF,PHI,5,6,110,1.5,-185,8.0,-110,-110,-120,-1.5,165,3.81,Citizens Bank Park,11,-1
2021-04-21,2021,DET,PIT,2,3,-123,-1.5,185,6.0,-115,-105,113,1.5,-210,3.31,Comerica Park,5,-1
2021-04-21,2021,DET,PIT,5,2,-133,-1.5,170,6.5,-110,-110,123,1.5,-190,3.71,Comerica Park,7,3
2021-04-21,2021,MIL,SD,4,2,178,1.5,-135,7.5,100,-120,-196,-1.5,115,2.7,PETCO Park,6,2
2021-04-21,2021,PHI,SF,6,5,-120,-1.5,165,8.0,-110,-110,110,1.5,-185,4.36,Citizens Bank Park,11,1
2021-04-21,2021,WSH,STL,1,0,-159,-1.5,120,7.5,-115,-105,149,1.5,-140,4.6,Nationals Park,1,1
2021-04-21,2021,KC,TB,9,8,100,1.5,-175,8.0,100,-120,-110,-1.5,155,4.0,Kauffman Stadium,17,1
2021-04-21,2021,LAA,TEX,4,7,-172,-1.5,110,9.0,-110,-110,161,1.5,-130,5.69,Angel Stadium,11,-3
2021-04-21,2021,BOS,TOR,3,6,-128,-1.5,145,9.5,-115,-105,118,1.5,-165,5.33,Fenway Park,9,-3
2021-04-21,2021,STL,WSH,0,1,149,1.5,-140,7.5,-115,-105,-159,-1.5,120,3.01,Nationals Park,1,-1
2021-04-22,2021,CIN,ARI,11,14,-142,-1.5,140,8.5,-120,100,132,1.5,-160,4.99,Great American Ballpark,25,-3
2021-04-22,2021,SEA,BOS,7,3,154,1.5,-130,9.5,100,-120,-164,-1.5,110,3.74,Fenway Park,10,4
2021-04-22,2021,NYM,CHC,3,4,100,1.5,-210,9.5,-110,-110,-110,-1.5,185,4.75,Wrigley Field,7,-1
2021-04-22,2021,ARI,CIN,14,11,132,1.5,-160,8.5,-120,100,-142,-1.5,140,3.66,Great American Ballpark,25,3
2021-04-22,2021,NYY,CLE,6,3,102,1.5,-200,8.0,-110,-110,-112,-1.5,175,3.96,Progressive Field,9,3
2021-04-22,2021,PIT,DET,4,2,105,1.5,-190,8.5,-105,-115,-115,-1.5,170,4.15,Comerica Park,6,2
2021-04-22,2021,LAA,HOU,2,8,114,1.5,-175,9.0,-110,-110,-124,-1.5,155,4.21,Minute Maid Park,10,-6
2021-04-22,2021,HOU,LAA,8,2,-124,-1.5,155,9.0,-110,-110,114,1.5,-175,4.98,Minute Maid Park,10,6
2021-04-22,2021,SD,LAD,3,2,159,1.5,-140,7.5,-115,-105,-169,-1.5,120,2.9,Dodger Stadium,5,1
2021-04-22,2021,SF,MIA,3,0,-140,-1.5,145,8.0,-110,-110,130,1.5,-165,4.67,AT&T Park,3,3
2021-04-22,2021,CHC,NYM,4,3,-110,-1.5,185,9.5,-110,-110,100,1.5,-210,4.98,Wrigley Field,7,1
2021-04-22,2021,CLE,NYY,3,6,-112,-1.5,175,8.0,-110,-110,102,1.5,-200,4.23,Progressive Field,9,-3
2021-04-22,2021,DET,PIT,2,4,-115,-1.5,170,8.5,-105,-115,105,1.5,-190,4.55,Comerica Park,6,-2
2021-04-22,2021,LAD,SD,2,3,-169,-1.5,120,7.5,-115,-105,159,1.5,-140,4.71,Dodger Stadium,5,-1
2021-04-22,2021,BOS,SEA,3,7,-164,-1.5,110,9.5,100,-120,154,1.5,-130,5.9,Fenway Park,10,-4
2021-04-22,2021,MIA,SF,0,3,130,1.5,-165,8.0,-110,-110,-140,-1.5,145,3.48,AT&T Park,3,-3
2021-04-23,2021,ATL,ARI,5,4,-155,-1.5,125,8.5,-120,100,145,1.5,-145,5.17,Suntrust Park,9,1
2021-04-23,2021,ARI,ATL,4,5,145,1.5,-145,8.5,-120,100,-155,-1.5,125,3.47,Suntrust Park,9,-1
2021-04-23,2021,OAK,BAL,3,1,-127,-1.5,115,9.0,-120,100,117,1.5,-135,5.04,Camden Yards,4,2
2021-04-23,2021,SEA,BOS,5,6,131,1.5,-155,9.0,-120,100,-141,-1.5,135,3.9,Fenway Park,11,-1
2021-04-23,2021,MIL,CHC,2,15,148,1.5,-145,9.0,-115,-105,-158,-1.5,125,3.63,Wrigley Field,17,-13
2021-04-23,2021,STL,CIN,5,4,-104,1.5,-175,8.0,-105,-115,-106,-1.5,155,4.08,Busch Stadium,9,1
2021-04-23,2021,NYY,CLE,5,3,-154,-1.5,-105,8.5,-105,-115,144,1.5,-115,5.15,Progressive Field,8,2
2021-04-23,2021,PHI,COL,4,5,113,1.5,-170,10.5,-115,-105,-123,-1.5,150,4.93,Coors Field,9,-1
2021-04-23,2021,TEX,CWS,7,9,129,1.5,-155,8.0,-110,-110,-139,-1.5,135,3.49,Guaranteed Rate Field,16,-2
2021-04-23,2021,KC,DET,6,2,-110,-1.5,140,8.5,100,-120,100,1.5,-160,4.45,Comerica Park,8,4
2021-04-23,2021,LAA,HOU,4,5,150,1.5,-140,8.0,-110,-110,-160,-1.5,120,3.2,Minute Maid Park,9,-1
2021-04-23,2021,DET,KC,2,6,100,1.5,-160,8.5,100,-120,-110,-1.5,140,4.25,Comerica Park,8,-4
2021-04-23,2021,HOU,LAA,5,4,-160,-1.5,120,8.0,-110,-110,150,1.5,-140,4.92,Minute Maid Park,9,1
2021-04-23,2021,SD,LAD,6,1,136,1.5,-170,6.5,-120,100,-146,-1.5,150,2.75,Dodger Stadium,7,5
2021-04-23,2021,SF,MIA,5,3,-134,-1.5,160,7.0,-115,-105,124,1.5,-180,4.01,AT&T Park,8,2
2021-04-23,2021,CHC,MIL,15,2,-158,-1.5,125,9.0,-115,-105,148,1.5,-145,5.51,Wrigley Field,17,13
2021-04-23,2021,PIT,MIN,0,2,143,1.5,-145,8.0,-105,-115,-153,-1.5,125,3.29,Target Field,2,-2
2021-04-23,2021,WSH,NYM,0,6,260,1.5,110,7.0,-105,-115,-300,-1.5,-130,1.94,Citi Field,6,-6
2021-04-23,2021,CLE,NYY,3,5,144,1.5,-115,8.5,-105,-115,-154,-1.5,-105,3.48,Progressive Field,8,-2
2021-04-23,2021,BAL,OAK,1,3,117,1.5,-135,9.0,-120,100,-127,-1.5,115,4.15,Camden Yards,4,-2
2021-04-23,2021,COL,PHI,5,4,-123,-1.5,150,10.5,-115,-105,113,1.5,-170,5.79,Coors Field,9,1
2021-04-23,2021,MIN,PIT,2,0,-153,-1.5,125,8.0,-105,-115,143,1.5,-145,4.84,Target Field,2,2
2021-04-23,2021,LAD,SD,1,6,-146,-1.5,150,6.5,-120,100,136,1.5,-170,3.86,Dodger Stadium,7,-5
2021-04-23,2021,BOS,SEA,6,5,-141,-1.5,135,9.0,-120,100,131,1.5,-155,5.27,Fenway Park,11,1
2021-04-23,2021,MIA,SF,3,5,124,1.5,-180,7.0,-115,-105,-134,-1.5,160,3.13,AT&T Park,8,-2
2021-04-23,2021,CIN,STL,4,5,-106,-1.5,155,8.0,-105,-115,-104,1.5,-175,4.12,Busch Stadium,9,-1
2021-04-23,2021,TOR,TB,5,3,151,1.5,-155,7.0,-110,-110,-161,-1.5,135,2.79,Tropicana Field,8,2
2021-04-23,2021,CWS,TEX,9,7,-139,-1.5,135,8.0,-110,-110,129,1.5,-155,4.65,Guaranteed Rate Field,16,2
2021-04-23,2021,TB,TOR,3,5,-161,-1.5,135,7.0,-110,-110,151,1.5,-155,4.32,Tropicana Field,8,-2
2021-04-23,2021,NYM,WSH,6,0,-300,-1.5,-130,7.0,-105,-115,260,1.5,110,5.25,Citi Field,6,6
2021-04-24,2021,OAK,BAL,7,2,-158,-1.5,-110,9.0,-125,105,148,1.5,-110,5.51,Camden Yards,9,5
2021-04-24,2021,SEA,BOS,8,2,177,1.5,-110,9.0,-115,-105,-194,-1.5,-110,3.25,Fenway Park,10,6
2021-04-24,2021,MIL,CHC,4,3,-105,1.5,-215,7.5,-115,-105,-105,-1.5,190,3.84,Wrigley Field,7,1
2021-04-24,2021,STL,CIN,2,0,-110,-1.5,175,8.5,-105,-115,100,1.5,-200,4.45,Busch Stadium,2,2
2021-04-24,2021,NYY,CLE,2,1,-120,-1.5,155,6.5,100,-120,110,1.5,-175,3.55,Progressive Field,3,1
2021-04-24,2021,PHI,COL,7,5,-174,-1.5,-125,10.0,-115,-105,162,1.5,105,6.35,Coors Field,12,2
2021-04-24,2021,TEX,CWS,1,2,160,1.5,-140,7.5,-115,-105,-170,-1.5,120,2.88,Guaranteed Rate Field,3,-1
2021-04-24,2021,KC,DET,2,1,-114,-1.5,140,8.0,-105,-115,104,1.5,-160,4.26,Comerica Park,3,1
2021-04-24,2021,LAA,HOU,2,16,137,1.5,-150,8.5,-120,100,-147,-1.5,130,3.59,Minute Maid Park,18,-14
2021-04-24,2021,DET,KC,1,2,104,1.5,-160,8.0,-105,-115,-114,-1.5,140,3.92,Comerica Park,3,-1
2021-04-24,2021,HOU,LAA,16,2,-147,-1.5,130,8.5,-120,100,137,1.5,-150,5.06,Minute Maid Park,18,14
2021-04-24,2021,SD,LAD,4,5,136,1.5,-170,7.0,-105,-115,-146,-1.5,150,2.97,Dodger Stadium,9,-1
2021-04-24,2021,SF,MIA,2,5,-147,-1.5,145,7.0,100,-120,137,1.5,-165,4.17,AT&T Park,7,-3
2021-04-24,2021,CHC,MIL,3,4,-105,-1.5,190,7.5,-115,-105,-105,1.5,-215,3.84,Wrigley Field,7,-1
2021-04-24,2021,PIT,MIN,6,2,190,1.5,-110,8.0,-105,-115,-210,-1.5,-110,2.76,Target Field,8,4
2021-04-24,2021,WSH,NYM,7,1,171,1.5,-125,8.0,-120,100,-186,-1.5,105,2.95,Citi Field,8,6
2021-04-24,2021,CLE,NYY,1,2,110,1.5,-175,6.5,100,-120,-120,-1.5,155,3.1,Progressive Field,3,-1
2021-04-24,2021,BAL,OAK,2,7,148,1.5,-110,9.0,-125,105,-158,-1.5,-110,3.63,Camden Yards,9,-5
2021-04-24,2021,COL,PHI,5,7,162,1.5,105,10.0,-115,-105,-174,-1.5,-125,3.82,Coors Field,12,-2
2021-04-24,2021,MIN,PIT,2,6,-210,-1.5,-110,8.0,-105,-115,190,1.5,-110,5.42,Target Field,8,-4
2021-04-24,2021,LAD,SD,5,4,-146,-1.5,150,7.0,-105,-115,136,1.5,-170,4.15,Dodger Stadium,9,1
2021-04-24,2021,BOS,SEA,2,8,-194,-1.5,-110,9.0,-115,-105,177,1.5,-110,5.94,Fenway Park,10,-6
2021-04-24,2021,MIA,SF,5,2,137,1.5,-165,7.0,100,-120,-147,-1.5,145,2.95,AT&T Park,7,3
2021-04-24,2021,CIN,STL,0,2,100,1.5,-200,8.5,-105,-115,-110,-1.5,175,4.25,Busch Stadium,2,-2
2021-04-24,2021,TOR,TB,3,5,127,1.5,-170,8.5,-110,-110,-137,-1.5,150,3.74,Tropicana Field,8,-2
2021-04-24,2021,CWS,TEX,2,1,-170,-1.5,120,7.5,-115,-105,160,1.5,-140,4.72,Guaranteed Rate Field,3,1
2021-04-24,2021,TB,TOR,5,3,-137,-1.5,150,8.5,-110,-110,127,1.5,-170,4.91,Tropicana Field,8,2
2021-04-24,2021,NYM,WSH,1,7,-186,-1.5,105,8.0,-120,100,171,1.5,-125,5.2,Citi Field,8,-6
2021-04-25,2021,ATL,ARI,0,5,-129,-1.5,175,6.5,-115,-105,119,1.5,-200,3.66,Suntrust Park,5,-5
2021-04-25,2021,ATL,ARI,0,7,-185,-1.5,120,6.5,-130,110,170,1.5,-140,4.22,Suntrust Park,7,-7
2021-04-25,2021,ARI,ATL,5,0,119,1.5,-200,6.5,-115,-105,-129,-1.5,175,2.97,Suntrust Park,5,5
2021-04-25,2021,ARI,ATL,7,0,170,1.5,-140,6.5,-130,110,-185,-1.5,120,2.41,Suntrust Park,7,7
2021-04-25,2021,OAK,BAL,1,8,-123,-1.5,130,8.0,-115,-105,113,1.5,-150,4.41,Camden Yards,9,-7
2021-04-25,2021,SEA,BOS,3,5,175,1.5,-115,8.5,-105,-115,-190,-1.5,-105,3.09,Fenway Park,8,-2
2021-04-25,2021,MIL,CHC,6,0,-132,-1.5,135,6.5,-120,100,122,1.5,-155,3.7,Wrigley Field,6,6
2021-04-25,2021,STL,CIN,5,2,-125,-1.5,170,7.0,-105,-115,115,1.5,-190,3.89,Busch Stadium,7,3
2021-04-25,2021,NYY,CLE,3,7,-126,-1.5,130,8.0,-105,-115,116,1.5,-150,4.46,Progressive Field,10,-4
2021-04-25,2021,PHI,COL,2,12,100,1.5,-185,11.5,-105,-115,-110,-1.5,165,5.75,Coors Field,14,-10
2021-04-25,2021,TEX,CWS,4,8,165,1.5,-130,7.5,-115,-105,-180,-1.5,110,2.83,Guaranteed Rate Field,12,-4
2021-04-25,2021,KC,DET,4,0,-115,-1.5,140,8.5,-110,-110,105,1.5,-160,4.55,Comerica Park,4,4
2021-04-25,2021,LAA,HOU,4,2,128,1.5,-170,8.0,-110,-110,-138,-1.5,150,3.51,Minute Maid Park,6,2
2021-04-25,2021,DET,KC,0,4,105,1.5,-160,8.5,-110,-110,-115,-1.5,140,4.15,Comerica Park,4,-4
2021-04-25,2021,HOU,LAA,2,4,-138,-1.5,150,8.0,-110,-110,128,1.5,-170,4.64,Minute Maid Park,6,-2
2021-04-25,2021,SD,LAD,8,7,114,1.5,-200,7.0,-125,105,-124,-1.5,175,3.27,Dodger Stadium,15,1
2021-04-25,2021,SF,MIA,4,3,-156,-1.5,130,8.0,-115,-105,146,1.5,-150,4.88,AT&T Park,7,1
2021-04-25,2021,CHC,MIL,0,6,122,1.5,-155,6.5,-120,100,-132,-1.5,135,2.93,Wrigley Field,6,-6
2021-04-25,2021,PIT,MIN,6,2,170,1.5,-120,8.5,-115,-105,-185,-1.5,100,3.15,Target Field,8,4
2021-04-25,2021,WSH,NYM,0,4,135,1.5,-160,7.5,100,-120,-145,-1.5,140,3.19,Citi Field,4,-4
2021-04-25,2021,CLE,NYY,7,3,116,1.5,-150,8.0,-105,-115,-126,-1.5,130,3.7,Progressive Field,10,4
2021-04-25,2021,BAL,OAK,8,1,113,1.5,-150,8.0,-115,-105,-123,-1.5,130,3.76,Camden Yards,9,7
2021-04-25,2021,COL,PHI,12,2,-110,-1.5,165,11.5,-105,-115,100,1.5,-185,6.02,Coors Field,14,10
2021-04-25,2021,MIN,PIT,2,6,-185,-1.5,100,8.5,-115,-105,170,1.5,-120,5.52,Target Field,8,-4
2021-04-25,2021,LAD,SD,7,8,-124,-1.5,175,7.0,-125,105,114,1.5,-200,3.88,Dodger Stadium,15,-1
2021-04-25,2021,BOS,SEA,5,3,-190,-1.5,-105,8.5,-105,-115,175,1.5,-115,5.57,Fenway Park,8,2
2021-04-25,2021,MIA,SF,3,4,146,1.5,-150,8.0,-115,-105,-156,-1.5,130,3.25,AT&T Park,7,-1
2021-04-25,2021,CIN,STL,2,5,115,1.5,-190,7.0,-105,-115,-125,-1.5,170,3.26,Busch Stadium,7,-3
2021-04-25,2021,TOR,TB,1,0,-116,-1.5,140,7.5,-115,-105,106,1.5,-160,4.03,Tropicana Field,1,1
2021-04-25,2021,CWS,TEX,8,4,-180,-1.5,110,7.5,-115,-105,165,1.5,-130,4.82,Guaranteed Rate Field,12,4
2021-04-25,2021,TB,TOR,0,1,106,1.5,-160,7.5,-115,-105,-116,-1.5,140,3.64,Tropicana Field,1,-1
2021-04-25,2021,NYM,WSH,4,0,-145,-1.5,140,7.5,100,-120,135,1.5,-160,4.44,Citi Field,4,4
2021-04-26,2021,CHC,ATL,7,8,179,1.5,-125,8.5,-115,-105,-198,-1.5,105,3.05,Suntrust Park,15,-1
2021-04-26,2021,NYY,BAL,2,4,-160,-1.5,-110,9.0,-120,100,150,1.5,-110,5.54,Camden Yards,6,-2
2021-04-26,2021,ATL,CHC,8,7,-198,-1.5,105,8.5,-115,-105,179,1.5,-125,5.65,Suntrust Park,15,1
2021-04-26,2021,LAD,CIN,3,5,-185,-1.5,115,7.5,-110,-110,170,1.5,-135,4.87,Dodger Stadium,8,-2
2021-04-26,2021,MIN,CLE,3,5,-119,-1.5,135,7.0,-120,100,109,1.5,-155,3.8,Progressive Field,8,-2
2021-04-26,2021,SF,COL,12,0,-165,-1.5,125,7.5,-110,-110,155,1.5,-145,4.67,AT&T Park,12,12
2021-04-26,2021,KC,DET,3,2,-105,-1.5,155,8.5,100,-120,-105,1.5,-175,4.35,Comerica Park,5,1
2021-04-26,2021,SEA,HOU,2,5,164,1.5,-130,9.0,105,-125,-177,-1.5,110,3.41,Minute Maid Park,7,-3
2021-04-26,2021,DET,KC,2,3,-105,1.5,-175,8.5,100,-120,-105,-1.5,155,4.35,Comerica Park,5,-1
2021-04-26,2021,TEX,LAA,4,9,150,1.5,-115,9.0,100,-120,-160,-1.5,-105,3.6,Globe Life Field,13,-5
2021-04-26,2021,CIN,LAD,5,3,170,1.5,-135,7.5,-110,-110,-185,-1.5,115,2.78,Dodger Stadium,8,2
2021-04-26,2021,MIL,MIA,0,8,-163,-1.5,135,6.5,-110,-110,153,1.5,-155,4.03,Miller Park,8,-8
2021-04-26,2021,MIA,MIL,8,0,153,1.5,-155,6.5,-110,-110,-163,-1.5,135,2.57,Miller Park,8,8
2021-04-26,2021,CLE,MIN,5,3,109,1.5,-155,7.0,-120,100,-119,-1.5,135,3.35,Progressive Field,8,2
2021-04-26,2021,BAL,NYY,4,2,150,1.5,-110,9.0,-120,100,-160,-1.5,-110,3.6,Camden Yards,6,2
2021-04-26,2021,TB,OAK,1,2,-102,1.5,-165,8.5,100,-120,-108,-1.5,145,4.29,Tropicana Field,3,-1
2021-04-26,2021,STL,PHI,1,2,-103,1.5,-170,8.0,-115,-105,-107,-1.5,150,4.06,Busch Stadium,3,-1
2021-04-26,2021,HOU,SEA,5,2,-177,-1.5,110,9.0,105,-125,164,1.5,-130,5.75,Minute Maid Park,7,3
2021-04-26,2021,COL,SF,0,12,155,1.5,-145,7.5,-110,-110,-165,-1.5,125,2.94,AT&T Park,12,-12
2021-04-26,2021,PHI,STL,2,1,-107,-1.5,150,8.0,-115,-105,-103,1.5,-170,4.14,Busch Stadium,3,1
2021-04-26,2021,OAK,TB,2,1,-108,-1.5,145,8.5,100,-120,-102,1.5,-165,4.41,Tropicana Field,3,1
2021-04-26,2021,LAA,TEX,9,4,-160,-1.5,-105,9.0,100,-120,150,1.5,-115,5.54,Globe Life Field,13,5
2021-04-27,2021,SD,ARI,1,5,-148,-1.5,100,9.5,100,-120,138,1.5,-120,5.67,Chase Field,6,-4
2021-04-27,2021,CHC,ATL,0,5,150,1.5,-140,8.5,-110,-110,-160,-1.5,120,3.4,Suntrust Park,5,-5
2021-04-27,2021,NYY,BAL,5,1,-176,-1.5,-130,9.0,-120,100,163,1.5,110,5.74,Camden Yards,6,4
2021-04-27,2021,NYM,BOS,1,2,-146,-1.5,135,8.5,-120,100,136,1.5,-155,5.04,Citi Field,3,-1
2021-04-27,2021,ATL,CHC,5,0,-160,-1.5,120,8.5,-110,-110,150,1.5,-140,5.23,Suntrust Park,5,5
2021-04-27,2021,LAD,CIN,5,6,-260,-1.5,-125,7.5,100,-120,230,1.5,105,5.42,Dodger Stadium,11,-1
2021-04-27,2021,MIN,CLE,4,7,-113,-1.5,145,7.5,-120,100,103,1.5,-165,3.98,Progressive Field,11,-3
2021-04-27,2021,SF,COL,5,7,-165,-1.5,120,7.5,-120,100,155,1.5,-140,4.67,AT&T Park,12,-2
2021-04-27,2021,DET,CWS,5,2,215,1.5,105,7.5,-110,-110,-245,-1.5,-125,2.38,Guaranteed Rate Field,7,3
2021-04-27,2021,CWS,DET,2,5,-245,-1.5,-125,7.5,-110,-110,215,1.5,105,5.33,Guaranteed Rate Field,7,-3
2021-04-27,2021,SEA,HOU,0,2,175,1.5,-115,8.5,-120,100,-190,-1.5,-105,3.09,Minute Maid Park,2,-2
2021-04-27,2021,PIT,KC,2,1,-113,-1.5,185,8.0,-105,-115,103,1.5,-210,4.24,PNC Park,3,1
2021-04-27,2021,TEX,LAA,6,1,142,1.5,-115,9.0,-115,-105,-152,-1.5,-105,3.72,Globe Life Field,7,5
2021-04-27,2021,CIN,LAD,6,5,230,1.5,105,7.5,100,-120,-260,-1.5,-125,2.27,Dodger Stadium,11,1
2021-04-27,2021,MIL,MIA,5,4,-145,-1.5,145,8.0,-110,-110,135,1.5,-165,4.73,Miller Park,9,1
2021-04-27,2021,MIA,MIL,4,5,135,1.5,-165,8.0,-110,-110,-145,-1.5,145,3.4,Miller Park,9,-1
2021-04-27,2021,CLE,MIN,7,4,103,1.5,-165,7.5,-120,100,-113,-1.5,145,3.69,Progressive Field,11,3
2021-04-27,2021,BOS,NYM,2,1,136,1.5,-155,8.5,-120,100,-146,-1.5,135,3.6,Citi Field,3,1
2021-04-27,2021,BAL,NYY,1,5,163,1.5,110,9.0,-120,100,-176,-1.5,-130,3.42,Camden Yards,6,-4
2021-04-27,2021,TB,OAK,4,3,-112,-1.5,185,8.5,-105,-115,102,1.5,-210,4.49,Tropicana Field,7,1
2021-04-27,2021,STL,PHI,5,2,-101,1.5,-175,8.0,-120,100,-109,-1.5,155,4.02,Busch Stadium,7,3
2021-04-27,2021,KC,PIT,1,2,103,1.5,-210,8.0,-105,-115,-113,-1.5,185,3.94,PNC Park,3,-1
2021-04-27,2021,ARI,SD,5,1,138,1.5,-120,9.5,100,-120,-148,-1.5,100,3.99,Chase Field,6,4
2021-04-27,2021,HOU,SEA,2,0,-190,-1.5,-105,8.5,-120,100,175,1.5,-115,5.57,Minute Maid Park,2,2
2021-04-27,2021,COL,SF,7,5,155,1.5,-140,7.5,-120,100,-165,-1.5,120,2.94,AT&T Park,12,2
2021-04-27,2021,PHI,STL,2,5,-109,-1.5,155,8.0,-120,100,-101,1.5,-175,4.17,Busch Stadium,7,-3
2021-04-27,2021,OAK,TB,3,4,102,1.5,-210,8.5,-105,-115,-112,-1.5,185,4.21,Tropicana Field,7,-1
2021-04-27,2021,LAA,TEX,1,6,-152,-1.5,-105,9.0,-115,-105,142,1.5,-115,5.43,Globe Life Field,7,-5
2021-04-27,2021,WSH,TOR,5,9,-117,-1.5,135,8.5,-110,-110,107,1.5,-155,4.58,TD Ballpark,14,-4
2021-04-27,2021,TOR,WSH,9,5,107,1.5,-155,8.5,-110,-110,-117,-1.5,135,4.11,TD Ballpark,14,4
2021-04-28,2021,SD,ARI,12,3,-156,-1.5,100,9.0,-110,-110,146,1.5,-120,5.48,Chase Field,15,9
2021-04-28,2021,CHC,ATL,0,10,123,1.5,-170,9.0,100,-120,-133,-1.5,150,4.04,Suntrust Park,10,-10
2021-04-28,2021,NYY,BAL,7,0,-147,-1.5,100,10.0,-110,-110,137,1.5,-120,5.95,Camden Yards,7,7
2021-04-28,2021,NYM,BOS,0,1,-270,-1.5,-125,7.0,100,-120,240,1.5,105,5.11,Citi Field,1,-1
2021-04-28,2021,ATL,CHC,10,0,-133,-1.5,150,9.0,100,-120,123,1.5,-170,5.14,Suntrust Park,10,10
2021-04-28,2021,LAD,CIN,8,0,-210,-1.5,100,7.5,-120,100,190,1.5,-120,5.08,Dodger Stadium,8,8
2021-04-28,2021,MIN,CLE,10,2,-122,-1.5,125,8.5,-115,-105,112,1.5,-145,4.67,Progressive Field,12,8
2021-04-28,2021,SF,COL,7,3,-142,-1.5,160,7.0,-120,100,132,1.5,-180,4.11,AT&T Park,10,4
2021-04-28,2021,SEA,HOU,5,7,190,1.5,-110,8.5,-115,-105,-210,-1.5,-110,2.93,Minute Maid Park,12,-2
2021-04-28,2021,PIT,KC,6,9,115,1.5,-155,8.0,-120,100,-125,-1.5,135,3.72,PNC Park,15,-3
2021-04-28,2021,TEX,LAA,3,4,115,1.5,-145,9.0,-105,-115,-125,-1.5,125,4.19,Globe Life Field,7,-1
2021-04-28,2021,CIN,LAD,0,8,190,1.5,-120,7.5,-120,100,-210,-1.5,100,2.59,Dodger Stadium,8,-8
2021-04-28,2021,MIL,MIA,2,6,103,1.5,-160,8.0,-110,-110,-113,-1.5,140,3.94,Miller Park,8,-4
2021-04-28,2021,MIA,MIL,6,2,-113,-1.5,140,8.0,-110,-110,103,1.5,-160,4.24,Miller Park,8,4
2021-04-28,2021,CLE,MIN,2,10,112,1.5,-145,8.5,-115,-105,-122,-1.5,125,4.01,Progressive Field,12,-8
2021-04-28,2021,BOS,NYM,1,0,240,1.5,105,7.0,100,-120,-270,-1.5,-125,2.06,Citi Field,1,1
2021-04-28,2021,BAL,NYY,0,7,137,1.5,-120,10.0,-110,-110,-147,-1.5,100,4.22,Camden Yards,7,-7
2021-04-28,2021,TB,OAK,2,0,-170,-1.5,125,7.5,100,-120,160,1.5,-145,4.72,Tropicana Field,2,2
2021-04-28,2021,STL,PHI,3,5,-105,-1.5,175,8.5,-120,100,-105,1.5,-200,4.35,Busch Stadium,8,-2
2021-04-28,2021,KC,PIT,9,6,-125,-1.5,135,8.0,-120,100,115,1.5,-155,4.44,PNC Park,15,3
2021-04-28,2021,ARI,SD,3,12,146,1.5,-120,9.0,-110,-110,-156,-1.5,100,3.66,Chase Field,15,-9
2021-04-28,2021,HOU,SEA,7,5,-210,-1.5,-110,8.5,-115,-105,190,1.5,-110,5.76,Minute Maid Park,12,2
2021-04-28,2021,COL,SF,3,7,132,1.5,-180,7.0,-120,100,-142,-1.5,160,3.02,AT&T Park,10,-4
2021-04-28,2021,PHI,STL,5,3,-105,1.5,-200,8.5,-120,100,-105,-1.5,175,4.35,Busch Stadium,8,2
2021-04-28,2021,OAK,TB,0,2,160,1.5,-145,7.5,100,-120,-170,-1.5,125,2.88,Tropicana Field,2,-2
2021-04-28,2021,LAA,TEX,4,3,-125,-1.5,125,9.0,-105,-115,115,1.5,-145,5.0,Globe Life Field,7,1
2021-04-28,2021,WSH,TOR,8,2,163,1.5,-125,9.5,100,-120,-176,-1.5,105,3.61,TD Ballpark,10,6
2021-04-28,2021,TOR,WSH,2,8,-176,-1.5,105,9.5,100,-120,163,1.5,-125,6.06,TD Ballpark,10,-6
2021-04-29,2021,COL,ARI,3,5,118,1.5,-185,9.0,-115,-105,-128,-1.5,165,4.13,Chase Field,8,-2
2021-04-29,2021,CHC,ATL,9,3,120,1.5,-165,9.5,100,-120,-130,-1.5,145,4.32,Suntrust Park,12,6
2021-04-29,2021,NYY,BAL,3,4,-180,-1.5,-130,9.5,-115,-105,165,1.5,110,6.11,Camden Yards,7,-1
2021-04-29,2021,TEX,BOS,4,1,-101,1.5,-160,8.5,-115,-105,-109,-1.5,140,4.27,Globe Life Field,5,3
2021-04-29,2021,ATL,CHC,3,9,-130,-1.5,145,9.5,100,-120,120,1.5,-165,5.37,Suntrust Park,12,-6
2021-04-29,2021,ARI,COL,5,3,-128,-1.5,165,9.0,-115,-105,118,1.5,-185,5.05,Chase Field,8,2
2021-04-29,2021,DET,CWS,1,3,180,1.5,-135,6.0,100,-120,-200,-1.5,115,2.14,Guaranteed Rate Field,4,-2
2021-04-29,2021,DET,CWS,0,11,136,1.5,-165,6.0,-120,100,-146,-1.5,145,2.54,Guaranteed Rate Field,11,-11
2021-04-29,2021,CWS,DET,3,1,-200,-1.5,115,6.0,100,-120,180,1.5,-135,4.0,Guaranteed Rate Field,4,2
2021-04-29,2021,CWS,DET,11,0,-146,-1.5,145,6.0,-120,100,136,1.5,-165,3.56,Guaranteed Rate Field,11,11
2021-04-29,2021,SEA,HOU,1,0,150,1.5,-135,9.0,-115,-105,-160,-1.5,115,3.6,Minute Maid Park,1,1
2021-04-29,2021,MIL,LAD,2,1,180,1.5,105,7.5,100,-120,-200,-1.5,-125,2.68,Miller Park,3,1
2021-04-29,2021,LAD,MIL,1,2,-200,-1.5,-125,7.5,100,-120,180,1.5,105,5.0,Miller Park,3,-1
2021-04-29,2021,BAL,NYY,4,3,165,1.5,110,9.5,-115,-105,-180,-1.5,-130,3.58,Camden Yards,7,1
2021-04-29,2021,TB,OAK,2,3,-112,1.5,-180,7.5,-120,100,102,-1.5,160,3.96,Tropicana Field,5,-1
2021-04-29,2021,STL,PHI,4,3,107,1.5,-165,7.0,-105,-115,-117,-1.5,145,3.38,Busch Stadium,7,1
2021-04-29,2021,HOU,SEA,0,1,-160,-1.5,115,9.0,-115,-105,150,1.5,-135,5.54,Minute Maid Park,1,-1
2021-04-29,2021,PHI,STL,3,4,-117,-1.5,145,7.0,-105,-115,107,1.5,-165,3.77,Busch Stadium,7,-1
2021-04-29,2021,OAK,TB,3,2,102,-1.5,160,7.5,-120,100,-112,1.5,-180,3.71,Tropicana Field,5,1
2021-04-29,2021,BOS,TEX,1,4,-109,-1.5,140,8.5,-115,-105,-101,1.5,-160,4.43,Globe Life Field,5,-3
2021-04-30,2021,COL,ARI,2,7,115,1.5,-175,8.5,-110,-110,-125,-1.5,155,3.95,Chase Field,9,-5
2021-04-30,2021,TOR,ATL,13,5,-120,-1.5,155,9.5,-115,-105,110,1.5,-175,5.18,TD Ballpark,18,8
2021-04-30,2021,OAK,BAL,2,3,-129,-1.5,155,8.0,-110,-110,119,1.5,-175,4.51,Oakland Coliseum,5,-1
2021-04-30,2021,TEX,BOS,1,6,145,1.5,-115,8.5,-110,-110,-155,-1.5,-105,3.47,Globe Life Field,7,-5
2021-04-30,2021,CIN,CHC,8,6,-120,-1.5,155,8.5,-120,100,110,1.5,-175,4.64,Great American Ballpark,14,2
2021-04-30,2021,CHC,CIN,6,8,110,1.5,-175,8.5,-120,100,-120,-1.5,155,4.05,Great American Ballpark,14,-2
2021-04-30,2021,CWS,CLE,3,5,128,1.5,-145,7.0,105,-125,-138,-1.5,125,3.07,Guaranteed Rate Field,8,-2
2021-04-30,2021,ARI,COL,7,2,-125,-1.5,155,8.5,-110,-110,115,1.5,-175,4.72,Chase Field,9,5
2021-04-30,2021,CLE,CWS,5,3,-138,-1.5,125,7.0,105,-125,128,1.5,-145,4.06,Guaranteed Rate Field,8,2
2021-04-30,2021,NYY,DET,10,0,-400,-1.5,-190,7.5,-120,100,330,1.5,170,6.0,Yankee Stadium,10,10
2021-04-30,2021,TB,HOU,2,9,116,1.5,-145,8.0,100,-120,-126,-1.5,125,3.7,Tropicana Field,11,-7
2021-04-30,2021,MIN,KC,9,1,-140,-1.5,140,8.5,100,-120,130,1.5,-160,4.96,Target Field,10,8
2021-04-30,2021,SEA,LAA,7,4,138,1.5,-130,8.5,105,-125,-148,-1.5,110,3.57,T-Mobile Park,11,3
2021-04-30,2021,MIL,LAD,3,1,-108,1.5,-175,8.0,-120,100,-102,-1.5,155,4.15,Miller Park,4,2
2021-04-30,2021,WSH,MIA,2,1,115,1.5,-155,8.5,-110,-110,-125,-1.5,135,3.95,Nationals Park,3,1
2021-04-30,2021,LAD,MIL,1,3,-102,-1.5,155,8.0,-120,100,-108,1.5,-175,4.04,Miller Park,4,-2
2021-04-30,2021,KC,MIN,1,9,130,1.5,-160,8.5,100,-120,-140,-1.5,140,3.7,Target Field,10,-8
2021-04-30,2021,PHI,NYM,2,1,150,1.5,-110,8.5,-115,-105,-160,-1.5,-110,3.4,Citizens Bank Park,3,1
2021-04-30,2021,DET,NYY,0,10,330,1.5,170,7.5,-120,100,-400,-1.5,-190,1.74,Yankee Stadium,10,-10
2021-04-30,2021,BAL,OAK,3,2,119,1.5,-175,8.0,-110,-110,-129,-1.5,155,3.65,Oakland Coliseum,5,1
2021-04-30,2021,NYM,PHI,1,2,-160,-1.5,-110,8.5,-115,-105,150,1.5,-110,5.23,Citizens Bank Park,3,-1
2021-04-30,2021,STL,PIT,7,3,106,1.5,-205,8.0,100,-120,-116,-1.5,180,3.88,PNC Park,10,4
2021-04-30,2021,SF,SD,2,3,178,1.5,-130,7.5,-110,-110,-196,-1.5,110,2.7,PETCO Park,5,-1
2021-04-30,2021,LAA,SEA,4,7,-148,-1.5,110,8.5,105,-125,138,1.5,-130,5.07,T-Mobile Park,11,-3
2021-04-30,2021,SD,SF,3,2,-196,-1.5,110,7.5,-110,-110,178,1.5,-130,4.97,PETCO Park,5,1
2021-04-30,2021,PIT,STL,3,7,-116,-1.5,180,8.0,100,-120,106,1.5,-205,4.3,PNC Park,10,-4
2021-04-30,2021,HOU,TB,9,2,-126,-1.5,125,8.0,100,-120,116,1.5,-145,4.46,Tropicana Field,11,7
2021-04-30,2021,BOS,TEX,6,1,-155,-1.5,-105,8.5,-110,-110,145,1.5,-115,5.17,Globe Life Field,7,5
2021-04-30,2021,ATL,TOR,5,13,110,1.5,-175,9.5,-115,-105,-120,-1.5,155,4.52,TD Ballpark,18,-8
2021-04-30,2021,MIA,WSH,1,2,-125,-1.5,135,8.5,-110,-110,115,1.5,-155,4.72,Nationals Park,3,-1
2021-05-01,2021,COL,ARI,14,6,161,1.5,-140,8.5,-110,-110,-172,-1.5,120,3.26,Chase Field,20,8
2021-05-01,2021,TOR,ATL,6,5,128,1.5,-125,10.5,-110,-110,-138,-1.5,105,4.61,TD Ballpark,11,1
2021-05-01,2021,OAK,BAL,4,8,-185,-1.5,105,8.0,-120,100,170,1.5,-125,5.19,Oakland Coliseum,12,-4
2021-05-01,2021,TEX,BOS,8,6,162,1.5,100,8.5,-115,-105,-174,-1.5,-120,3.24,Globe Life Field,14,2
2021-05-01,2021,CIN,CHC,2,3,-155,-1.5,120,8.5,-115,-105,145,1.5,-140,5.17,Great American Ballpark,5,-1
2021-05-01,2021,CHC,CIN,3,2,145,1.5,-140,8.5,-115,-105,-155,-1.5,120,3.47,Great American Ballpark,5,1
2021-05-01,2021,CWS,CLE,7,3,-162,-1.5,115,8.0,-110,-110,152,1.5,-135,4.95,Guaranteed Rate Field,10,4
2021-05-01,2021,ARI,COL,6,14,-172,-1.5,120,8.5,-110,-110,161,1.5,-140,5.38,Chase Field,20,-8
2021-05-01,2021,CLE,CWS,3,7,152,1.5,-135,8.0,-110,-110,-162,-1.5,115,3.17,Guaranteed Rate Field,10,-4
2021-05-01,2021,NYY,DET,6,4,-215,-1.5,-115,8.5,-110,-110,195,1.5,-105,5.8,Yankee Stadium,10,2
2021-05-01,2021,TB,HOU,1,3,-101,1.5,-165,7.5,-115,-105,-109,-1.5,145,3.77,Tropicana Field,4,-2
2021-05-01,2021,MIN,KC,3,11,-144,-1.5,130,8.0,-115,-105,134,1.5,-150,4.72,Target Field,14,-8
2021-05-01,2021,SEA,LAA,5,10,126,1.5,-140,8.5,-115,-105,-136,-1.5,120,3.76,T-Mobile Park,15,-5
2021-05-01,2021,MIL,LAD,6,5,115,1.5,-155,7.0,-115,-105,-125,-1.5,135,3.26,Miller Park,11,1
2021-05-01,2021,WSH,MIA,7,2,-147,-1.5,135,7.5,-120,100,137,1.5,-155,4.46,Nationals Park,9,5
2021-05-01,2021,LAD,MIL,5,6,-125,-1.5,135,7.0,-115,-105,115,1.5,-155,3.89,Miller Park,11,-1
2021-05-01,2021,KC,MIN,11,3,134,1.5,-150,8.0,-115,-105,-144,-1.5,130,3.42,Target Field,14,8
2021-05-01,2021,PHI,NYM,4,5,-107,-1.5,175,8.0,-110,-110,-103,1.5,-200,4.14,Citizens Bank Park,9,-1
2021-05-01,2021,DET,NYY,4,6,195,1.5,-105,8.5,-110,-110,-215,-1.5,-115,2.88,Yankee Stadium,10,-2
2021-05-01,2021,BAL,OAK,8,4,170,1.5,-125,8.0,-120,100,-185,-1.5,105,2.96,Oakland Coliseum,12,4
2021-05-01,2021,NYM,PHI,5,4,-103,1.5,-200,8.0,-110,-110,-107,-1.5,175,4.06,Citizens Bank Park,9,1
2021-05-01,2021,STL,PIT,12,5,-150,-1.5,105,7.0,-120,100,140,1.5,-125,4.2,PNC Park,17,7
2021-05-01,2021,SF,SD,2,6,162,1.5,-140,7.0,-120,100,-174,-1.5,120,2.67,PETCO Park,8,-4
2021-05-01,2021,LAA,SEA,10,5,-136,-1.5,120,8.5,-115,-105,126,1.5,-140,4.9,T-Mobile Park,15,5
2021-05-01,2021,SD,SF,6,2,-174,-1.5,120,7.0,-120,100,162,1.5,-140,4.45,PETCO Park,8,4
2021-05-01,2021,PIT,STL,5,12,140,1.5,-125,7.0,-120,100,-150,-1.5,105,2.92,PNC Park,17,-7
2021-05-01,2021,HOU,TB,3,1,-109,-1.5,145,7.5,-115,-105,-101,1.5,-165,3.91,Tropicana Field,4,2
2021-05-01,2021,BOS,TEX,6,8,-174,-1.5,-120,8.5,-115,-105,162,1.5,100,5.4,Globe Life Field,14,-2
2021-05-01,2021,ATL,TOR,5,6,-138,-1.5,105,10.5,-110,-110,128,1.5,-125,6.09,TD Ballpark,11,-1
2021-05-01,2021,MIA,WSH,2,7,137,1.5,-155,7.5,-120,100,-147,-1.5,135,3.16,Nationals Park,9,-5
2021-05-02,2021,COL,ARI,4,8,132,1.5,-160,9.0,-120,100,-142,-1.5,140,3.88,Chase Field,12,-4
2021-05-02,2021,TOR,ATL,7,2,115,1.5,-140,10.5,-115,-105,-125,-1.5,120,4.88,TD Ballpark,9,5
2021-05-02,2021,OAK,BAL,7,5,-200,-1.5,-105,8.5,-110,-110,180,1.5,-115,5.67,Oakland Coliseum,12,2
2021-05-02,2021,TEX,BOS,5,3,110,1.5,-150,9.0,-105,-115,-120,-1.5,130,4.29,Globe Life Field,8,2
2021-05-02,2021,CIN,CHC,13,12,-162,-1.5,120,9.0,100,-120,152,1.5,-140,5.56,Great American Ballpark,25,1
2021-05-02,2021,CHC,CIN,12,13,152,1.5,-140,9.0,100,-120,-162,-1.5,120,3.57,Great American Ballpark,25,-1
2021-05-02,2021,CWS,CLE,0,5,-158,-1.5,125,7.5,-115,-105,148,1.5,-145,4.59,Guaranteed Rate Field,5,-5
2021-05-02,2021,ARI,COL,8,4,-142,-1.5,140,9.0,-120,100,132,1.5,-160,5.28,Chase Field,12,4
2021-05-02,2021,CLE,CWS,5,0,148,1.5,-145,7.5,-115,-105,-158,-1.5,125,3.02,Guaranteed Rate Field,5,5
2021-05-02,2021,NYY,DET,2,0,-240,-1.5,-125,8.0,-120,100,210,1.5,105,5.65,Yankee Stadium,2,2
2021-05-02,2021,TB,HOU,5,4,115,1.5,-150,8.0,-115,-105,-125,-1.5,130,3.72,Tropicana Field,9,1
2021-05-02,2021,MIN,KC,13,4,-210,-1.5,-110,8.5,-120,100,190,1.5,-110,5.76,Target Field,17,9
2021-05-02,2021,SEA,LAA,2,0,144,1.5,-120,8.5,-110,-110,-154,-1.5,100,3.48,T-Mobile Park,2,2
2021-05-02,2021,MIL,LAD,4,16,180,1.5,105,8.0,-110,-110,-200,-1.5,-125,2.86,Miller Park,20,-12
2021-05-02,2021,WSH,MIA,3,1,-153,-1.5,145,7.0,100,-120,143,1.5,-165,4.23,Nationals Park,4,2
2021-05-02,2021,LAD,MIL,16,4,-200,-1.5,-125,8.0,-110,-110,180,1.5,105,5.33,Miller Park,20,12
2021-05-02,2021,KC,MIN,4,13,190,1.5,-110,8.5,-120,100,-210,-1.5,-110,2.93,Target Field,17,-9
2021-05-02,2021,PHI,NYM,7,8,-125,-1.5,165,8.0,-125,105,115,1.5,-185,4.44,Citizens Bank Park,15,-1
2021-05-02,2021,DET,NYY,0,2,210,1.5,105,8.0,-120,100,-240,-1.5,-125,2.58,Yankee Stadium,2,-2
2021-05-02,2021,BAL,OAK,5,7,180,1.5,-115,8.5,-110,-110,-200,-1.5,-105,3.04,Oakland Coliseum,12,-2
2021-05-02,2021,NYM,PHI,8,7,115,1.5,-185,8.0,-125,105,-125,-1.5,165,3.72,Citizens Bank Park,15,1
2021-05-02,2021,STL,PIT,3,0,-130,-1.5,135,8.0,-110,-110,120,1.5,-155,4.52,PNC Park,3,3
2021-05-02,2021,SF,SD,7,1,165,1.5,-135,7.0,-120,100,-180,-1.5,115,2.64,PETCO Park,8,6
2021-05-02,2021,LAA,SEA,0,2,-154,-1.5,100,8.5,-110,-110,144,1.5,-120,5.15,T-Mobile Park,2,-2
2021-05-02,2021,SD,SF,1,7,-180,-1.5,115,7.0,-120,100,165,1.5,-135,4.5,PETCO Park,8,-6
2021-05-02,2021,PIT,STL,0,3,120,1.5,-155,8.0,-110,-110,-130,-1.5,135,3.64,PNC Park,3,-3
2021-05-02,2021,HOU,TB,4,5,-125,-1.5,130,8.0,-115,-105,115,1.5,-150,4.44,Tropicana Field,9,-1
2021-05-02,2021,BOS,TEX,3,5,-120,-1.5,130,9.0,-105,-115,110,1.5,-150,4.91,Globe Life Field,8,-2
2021-05-02,2021,ATL,TOR,2,7,-125,-1.5,120,10.5,-115,-105,115,1.5,-140,5.83,TD Ballpark,9,-5
2021-05-02,2021,MIA,WSH,1,3,143,1.5,-165,7.0,100,-120,-153,-1.5,145,2.88,Nationals Park,4,-2
2021-05-03,2021,SEA,BAL,3,5,-125,-1.5,150,8.5,100,-120,115,1.5,-170,4.72,T-Mobile Park,8,-2
2021-05-03,2021,KC,CLE,6,8,102,1.5,-165,8.5,-110,-110,-112,-1.5,145,4.21,Kauffman Stadium,14,-2
2021-05-03,2021,CLE,KC,8,6,-112,-1.5,145,8.5,-110,-110,102,1.5,-165,4.49,Kauffman Stadium,14,2
2021-05-03,2021,TB,LAA,7,3,-148,-1.5,110,7.5,-110,-110,138,1.5,-130,4.48,Angel Stadium,10,4
2021-05-03,2021,PHI,MIL,4,3,100,-1.5,195,9.0,100,-120,-110,1.5,-220,4.5,Citizens Bank Park,7,1
2021-05-03,2021,TEX,MIN,5,6,163,1.5,-130,8.5,100,-120,-176,-1.5,110,3.23,Target Field,11,-1
2021-05-03,2021,STL,NYM,6,5,-130,-1.5,155,8.5,100,-120,120,1.5,-175,4.8,Busch Stadium,11,1
2021-05-03,2021,TOR,OAK,4,5,110,1.5,-190,8.5,-110,-110,-120,-1.5,170,4.05,Oakland Coliseum,9,-1
2021-05-03,2021,MIL,PHI,3,4,-110,1.5,-220,9.0,100,-120,100,-1.5,195,4.71,Citizens Bank Park,7,-1
2021-05-03,2021,SD,PIT,2,0,-178,-1.5,110,9.0,-115,-105,164,1.5,-130,5.76,PETCO Park,2,2
2021-05-03,2021,PIT,SD,0,2,164,1.5,-130,9.0,-115,-105,-178,-1.5,110,3.41,PETCO Park,2,-2
2021-05-03,2021,BAL,SEA,5,3,115,1.5,-170,8.5,100,-120,-125,-1.5,150,3.95,T-Mobile Park,8,2
2021-05-03,2021,NYM,STL,5,6,120,1.5,-175,8.5,100,-120,-130,-1.5,155,3.86,Busch Stadium,11,-1
2021-05-03,2021,LAA,TB,3,7,138,1.5,-130,7.5,-110,-110,-148,-1.5,110,3.15,Angel Stadium,10,-4
2021-05-03,2021,MIN,TEX,6,5,-176,-1.5,110,8.5,100,-120,163,1.5,-130,5.42,Target Field,11,1
2021-05-03,2021,OAK,TOR,5,4,-120,-1.5,170,8.5,-110,-110,110,1.5,-190,4.64,Oakland Coliseum,9,1
2021-05-04,2021,MIA,ARI,9,3,-145,-1.5,145,8.0,100,-120,135,1.5,-165,4.73,Marlins Park,12,6
2021-05-04,2021,WSH,ATL,1,6,114,1.5,-140,9.0,100,-120,-124,-1.5,120,4.21,Nationals Park,7,-5
2021-05-04,2021,SEA,BAL,5,2,-121,-1.5,160,8.5,-115,-105,111,1.5,-180,4.65,T-Mobile Park,7,3
2021-05-04,2021,DET,BOS,7,11,160,1.5,-130,9.0,-120,100,-170,-1.5,110,3.46,Fenway Park,18,-4
2021-05-04,2021,LAD,CHC,1,7,-170,-1.5,100,5.0,-120,100,160,1.5,-120,3.15,Wrigley Field,8,-6
2021-05-04,2021,LAD,CHC,3,4,-230,-1.5,-120,5.5,-120,100,205,1.5,-120,3.83,Wrigley Field,7,-1
2021-05-04,2021,CWS,CIN,9,0,101,1.5,-200,9.0,-120,100,-111,-1.5,175,4.48,Great American Ballpark,9,9
2021-05-04,2021,KC,CLE,3,7,-137,-1.5,140,9.5,100,-120,127,1.5,-160,5.49,Kauffman Stadium,10,-4
2021-05-04,2021,SF,COL,12,4,115,1.5,-190,7.5,-110,-110,-125,-1.5,170,3.49,Coors Field,16,8
2021-05-04,2021,SF,COL,6,8,-153,-1.5,110,8.0,-120,100,143,1.5,-130,4.84,Coors Field,14,-2
2021-05-04,2021,CIN,CWS,0,9,-111,-1.5,175,9.0,-120,100,101,1.5,-200,4.73,Great American Ballpark,9,-9
2021-05-04,2021,BOS,DET,11,7,-170,-1.5,110,9.0,-120,100,160,1.5,-130,5.67,Fenway Park,18,4
2021-05-04,2021,NYY,HOU,7,3,-115,-1.5,165,8.5,-120,100,105,1.5,-185,4.55,Yankee Stadium,10,4
2021-05-04,2021,CLE,KC,7,3,127,1.5,-160,9.5,100,-120,-137,-1.5,140,4.19,Kauffman Stadium,10,4
2021-05-04,2021,TB,LAA,8,3,103,1.5,-190,8.5,-120,100,-113,-1.5,170,4.19,Angel Stadium,11,5
2021-05-04,2021,CHC,LAD,7,1,160,1.5,-120,5.0,-120,100,-170,-1.5,100,1.92,Wrigley Field,8,6
2021-05-04,2021,CHC,LAD,4,3,205,1.5,-120,5.5,-120,100,-230,-1.5,-120,1.8,Wrigley Field,7,1
2021-05-04,2021,ARI,MIA,3,9,135,1.5,-165,8.0,100,-120,-145,-1.5,145,3.4,Marlins Park,12,-6
2021-05-04,2021,PHI,MIL,6,5,-165,-1.5,125,7.5,-115,-105,155,1.5,-145,4.67,Citizens Bank Park,11,1
2021-05-04,2021,TEX,MIN,6,3,145,1.5,-135,8.5,-105,-115,-155,-1.5,115,3.47,Target Field,9,3
2021-05-04,2021,HOU,NYY,3,7,105,1.5,-185,8.5,-120,100,-115,-1.5,165,4.15,Yankee Stadium,10,-4
2021-05-04,2021,TOR,OAK,1,4,110,1.5,-180,8.5,-120,100,-120,-1.5,160,4.05,Oakland Coliseum,5,-3
2021-05-04,2021,MIL,PHI,5,6,155,1.5,-145,7.5,-115,-105,-165,-1.5,125,2.94,Citizens Bank Park,11,-1
2021-05-04,2021,SD,PIT,1,2,-245,-1.5,-115,8.0,100,-120,215,1.5,-105,5.68,PETCO Park,3,-1
2021-05-04,2021,PIT,SD,2,1,215,1.5,-105,8.0,100,-120,-245,-1.5,-115,2.54,PETCO Park,3,1
2021-05-04,2021,BAL,SEA,2,5,111,1.5,-180,8.5,-115,-105,-121,-1.5,160,4.03,T-Mobile Park,7,-3
2021-05-04,2021,COL,SF,4,12,-125,-1.5,170,7.5,-110,-110,115,1.5,-190,4.17,Coors Field,16,-8
2021-05-04,2021,COL,SF,8,6,143,1.5,-130,8.0,-120,100,-153,-1.5,110,3.29,Coors Field,14,2
2021-05-04,2021,LAA,TB,3,8,-113,-1.5,170,8.5,-120,100,103,1.5,-190,4.51,Angel Stadium,11,-5
2021-05-04,2021,MIN,TEX,3,6,-155,-1.5,115,8.5,-105,-115,145,1.5,-135,5.17,Target Field,9,-3
2021-05-04,2021,OAK,TOR,4,1,-120,-1.5,160,8.5,-120,100,110,1.5,-180,4.64,Oakland Coliseum,5,3
2021-05-04,2021,ATL,WSH,6,1,-124,-1.5,120,9.0,100,-120,114,1.5,-140,4.98,Nationals Park,7,5
2021-05-05,2021,MIA,ARI,8,0,-111,-1.5,170,8.0,-105,-115,101,1.5,-190,4.21,Marlins Park,8,8
2021-05-05,2021,WSH,ATL,3,5,121,1.5,-150,9.0,-105,-115,-131,-1.5,130,4.07,Nationals Park,8,-2
2021-05-05,2021,SEA,BAL,0,6,-112,-1.5,175,7.5,-105,-115,102,1.5,-200,3.96,T-Mobile Park,6,-6
2021-05-05,2021,DET,BOS,6,5,164,1.5,-125,9.0,100,-120,-178,-1.5,105,3.41,Fenway Park,11,1
2021-05-05,2021,LAD,CHC,5,6,-159,-1.5,100,7.5,100,-120,149,1.5,-120,4.6,Wrigley Field,11,-1
2021-05-05,2021,CWS,CIN,0,1,116,1.5,-185,8.0,100,-120,-126,-1.5,165,3.7,Great American Ballpark,1,-1
2021-05-05,2021,KC,CLE,4,5,144,1.5,-125,7.0,-120,100,-154,-1.5,105,2.87,Kauffman Stadium,9,-1
2021-05-05,2021,SF,COL,5,6,102,1.5,-185,10.0,-105,-115,-112,-1.5,165,4.95,Coors Field,11,-1
2021-05-05,2021,CIN,CWS,1,0,-126,-1.5,165,8.0,100,-120,116,1.5,-185,4.46,Great American Ballpark,1,1
2021-05-05,2021,BOS,DET,5,6,-178,-1.5,105,9.0,100,-120,164,1.5,-125,5.76,Fenway Park,11,-1
2021-05-05,2021,NYY,HOU,6,3,-131,-1.5,145,9.5,100,-120,121,1.5,-165,5.39,Yankee Stadium,9,3
2021-05-05,2021,CLE,KC,5,4,-154,-1.5,105,7.0,-120,100,144,1.5,-125,4.24,Kauffman Stadium,9,1
2021-05-05,2021,TB,LAA,3,1,-104,1.5,-200,8.5,-105,-115,-106,-1.5,175,4.33,Angel Stadium,4,2
2021-05-05,2021,CHC,LAD,6,5,149,1.5,-120,7.5,100,-120,-159,-1.5,100,3.01,Wrigley Field,11,1
2021-05-05,2021,ARI,MIA,0,8,101,1.5,-190,8.0,-105,-115,-111,-1.5,170,3.98,Marlins Park,8,-8
2021-05-05,2021,PHI,MIL,5,4,122,1.5,-140,7.5,-115,-105,-132,-1.5,120,3.38,Citizens Bank Park,9,1
2021-05-05,2021,TEX,MIN,3,1,163,1.5,-130,8.5,-115,-105,-176,-1.5,110,3.23,Target Field,4,2
2021-05-05,2021,STL,NYM,4,1,106,1.5,-175,6.0,105,-125,-116,-1.5,155,2.91,Busch Stadium,5,3
2021-05-05,2021,STL,NYM,2,7,-115,-1.5,175,6.5,100,-120,105,1.5,-200,3.48,Busch Stadium,9,-5
2021-05-05,2021,HOU,NYY,3,6,121,1.5,-165,9.5,100,-120,-131,-1.5,145,4.3,Yankee Stadium,9,-3
2021-05-05,2021,TOR,OAK,9,4,122,1.5,-170,8.0,100,-120,-132,-1.5,150,3.6,Oakland Coliseum,13,5
2021-05-05,2021,MIL,PHI,4,5,-132,-1.5,120,7.5,-115,-105,122,1.5,-140,4.27,Citizens Bank Park,9,-1
2021-05-05,2021,SD,PIT,4,2,-222,-1.5,110,6.5,-110,-110,202,1.5,-130,4.48,PETCO Park,6,2
2021-05-05,2021,PIT,SD,2,4,202,1.5,-130,6.5,-110,-110,-222,-1.5,110,2.15,PETCO Park,6,-2
2021-05-05,2021,BAL,SEA,6,0,102,1.5,-200,7.5,-105,-115,-112,-1.5,175,3.71,T-Mobile Park,6,6
2021-05-05,2021,COL,SF,6,5,-112,-1.5,165,10.0,-105,-115,102,1.5,-185,5.28,Coors Field,11,1
2021-05-05,2021,NYM,STL,1,4,-116,-1.5,155,6.0,105,-125,106,1.5,-175,3.22,Busch Stadium,5,-3
2021-05-05,2021,NYM,STL,7,2,105,1.5,-200,6.5,100,-120,-115,-1.5,175,3.17,Busch Stadium,9,5
2021-05-05,2021,LAA,TB,1,3,-106,-1.5,175,8.5,-105,-115,-104,1.5,-200,4.37,Angel Stadium,4,-2
2021-05-05,2021,MIN,TEX,1,3,-176,-1.5,110,8.5,-115,-105,163,1.5,-130,5.42,Target Field,4,-2
2021-05-05,2021,OAK,TOR,4,9,-132,-1.5,150,8.0,100,-120,122,1.5,-170,4.55,Oakland Coliseum,13,-5
2021-05-05,2021,ATL,WSH,5,3,-131,-1.5,130,9.0,-105,-115,121,1.5,-150,5.1,Nationals Park,8,2
2021-05-06,2021,MIA,ARI,3,1,-137,-1.5,150,7.5,100,-120,127,1.5,-170,4.34,Marlins Park,4,2
2021-05-06,2021,WSH,ATL,2,3,103,1.5,-160,9.0,100,-120,-113,-1.5,140,4.43,Nationals Park,5,-1
2021-05-06,2021,DET,BOS,9,12,177,1.5,-120,8.0,-120,100,-194,-1.5,100,2.89,Fenway Park,21,-3
2021-05-06,2021,KC,CLE,0,4,-133,-1.5,145,8.0,-115,-105,123,1.5,-165,4.57,Kauffman Stadium,4,-4
2021-05-06,2021,BOS,DET,12,9,-194,-1.5,100,8.0,-120,100,177,1.5,-120,5.28,Fenway Park,21,3
2021-05-06,2021,NYY,HOU,4,7,-190,-1.5,105,7.5,-105,-115,175,1.5,-125,4.91,Yankee Stadium,11,-3
2021-05-06,2021,CLE,KC,4,0,123,1.5,-165,8.0,-115,-105,-133,-1.5,145,3.59,Kauffman Stadium,4,4
2021-05-06,2021,TB,LAA,8,3,134,1.5,-165,8.0,-115,-105,-144,-1.5,145,3.42,Angel Stadium,11,5
2021-05-06,2021,ARI,MIA,1,3,127,1.5,-170,7.5,100,-120,-137,-1.5,150,3.3,Marlins Park,4,-2
2021-05-06,2021,PHI,MIL,2,0,109,1.5,-165,6.5,-105,-115,-119,-1.5,145,3.11,Citizens Bank Park,2,2
2021-05-06,2021,TEX,MIN,4,3,162,1.5,-135,8.5,100,-120,-174,-1.5,115,3.24,Target Field,7,1
2021-05-06,2021,STL,NYM,1,4,-102,1.5,-170,8.0,-115,-105,-108,-1.5,150,4.04,Busch Stadium,5,-3
2021-05-06,2021,HOU,NYY,7,4,175,1.5,-125,7.5,-105,-115,-190,-1.5,105,2.73,Yankee Stadium,11,3
2021-05-06,2021,TOR,OAK,10,4,-130,-1.5,120,8.5,-110,-110,120,1.5,-140,4.8,Oakland Coliseum,14,6
2021-05-06,2021,MIL,PHI,0,2,-119,-1.5,145,6.5,-105,-115,109,1.5,-165,3.53,Citizens Bank Park,2,-2
2021-05-06,2021,NYM,STL,4,1,-108,-1.5,150,8.0,-115,-105,-102,1.5,-170,4.15,Busch Stadium,5,3
2021-05-06,2021,LAA,TB,3,8,-144,-1.5,145,8.0,-115,-105,134,1.5,-165,4.72,Angel Stadium,11,-5
2021-05-06,2021,MIN,TEX,3,4,-174,-1.5,115,8.5,100,-120,162,1.5,-135,5.4,Target Field,7,-1
2021-05-06,2021,OAK,TOR,4,10,120,1.5,-140,8.5,-110,-110,-130,-1.5,120,3.86,Oakland Coliseum,14,-6
2021-05-06,2021,ATL,WSH,3,2,-113,-1.5,140,9.0,100,-120,103,1.5,-160,4.77,Nationals Park,5,1
2021-05-07,2021,NYM,ARI,5,4,-128,-1.5,175,7.0,-6,-14,118,1.5,-200,3.93,Citi Field,9,1
2021-05-07,2021,PHI,ATL,12,2,132,1.5,-160,8.0,-105,-115,-142,-1.5,140,3.45,Suntrust Park,14,10
2021-05-07,2021,BOS,BAL,6,2,-152,-1.5,-105,8.5,-115,-105,142,1.5,-115,5.13,Camden Yards,8,4
2021-05-07,2021,BAL,BOS,2,6,142,1.5,-115,8.5,-115,-105,-152,-1.5,-105,3.51,Camden Yards,8,-4
2021-05-07,2021,PIT,CHC,2,3,138,1.5,-160,7.5,-115,-105,-148,-1.5,140,3.15,Wrigley Field,5,-1
2021-05-07,2021,CLE,CIN,0,3,-139,-1.5,150,8.0,-120,100,129,1.5,-170,4.65,Progressive Field,3,-3
2021-05-07,2021,CIN,CLE,3,0,129,1.5,-170,8.0,-120,100,-139,-1.5,150,3.49,Progressive Field,3,3
2021-05-07,2021,STL,COL,5,0,-210,-1.5,-105,7.5,100,-120,190,1.5,-115,5.08,Busch Stadium,5,5
2021-05-07,2021,KC,CWS,0,3,134,1.5,-125,8.5,-105,-115,-144,-1.5,105,3.63,Kauffman Stadium,3,-3
2021-05-07,2021,MIN,DET,7,3,-146,-1.5,105,9.0,100,-120,136,1.5,-125,5.34,Comerica Park,10,4
2021-05-07,2021,TOR,HOU,4,10,131,1.5,-155,9.0,-120,100,-141,-1.5,135,3.9,Minute Maid Park,14,-6
2021-05-07,2021,CWS,KC,3,0,-144,-1.5,105,8.5,-105,-115,134,1.5,-125,5.02,Kauffman Stadium,3,3
2021-05-07,2021,LAD,LAA,2,9,-166,-1.5,-110,8.5,-115,-105,156,1.5,-110,5.3,Angel Stadium,11,-7
2021-05-07,2021,LAA,LAD,9,2,156,1.5,-110,8.5,-115,-105,-166,-1.5,-110,3.32,Angel Stadium,11,7
2021-05-07,2021,MIL,MIA,1,6,118,1.5,-185,6.5,-120,100,-128,-1.5,165,2.98,Marlins Park,7,-5
2021-05-07,2021,MIA,MIL,6,1,-128,-1.5,165,6.5,-120,100,118,1.5,-185,3.65,Marlins Park,7,5
2021-05-07,2021,DET,MIN,3,7,136,1.5,-125,9.0,100,-120,-146,-1.5,105,3.81,Comerica Park,10,-4
2021-05-07,2021,ARI,NYM,4,5,118,1.5,-200,7.0,-6,-14,-128,-1.5,175,3.21,Citi Field,9,-1
2021-05-07,2021,WSH,NYY,11,4,160,1.5,-130,8.5,-120,100,-170,-1.5,110,3.27,Yankee Stadium,15,7
2021-05-07,2021,TB,OAK,1,2,117,1.5,-175,7.5,-105,-115,-127,-1.5,155,3.46,Oakland Coliseum,3,-1
2021-05-07,2021,ATL,PHI,2,12,-142,-1.5,140,8.0,-105,-115,132,1.5,-160,4.69,Suntrust Park,14,-10
2021-05-07,2021,CHC,PIT,3,2,-148,-1.5,140,7.5,-115,-105,138,1.5,-160,4.48,Wrigley Field,5,1
2021-05-07,2021,SF,SD,5,4,132,1.5,-135,7.5,100,-120,-142,-1.5,115,3.23,AT&T Park,9,1
2021-05-07,2021,TEX,SEA,4,5,-119,-1.5,175,8.5,-115,-105,109,1.5,-200,4.62,Globe Life Field,9,-1
2021-05-07,2021,SD,SF,4,5,-142,-1.5,115,7.5,100,-120,132,1.5,-135,4.4,AT&T Park,9,-1
2021-05-07,2021,COL,STL,0,5,190,1.5,-115,7.5,100,-120,-210,-1.5,-105,2.59,Busch Stadium,5,-5
2021-05-07,2021,OAK,TB,2,1,-127,-1.5,155,7.5,-105,-115,117,1.5,-175,4.2,Oakland Coliseum,3,1
2021-05-07,2021,SEA,TEX,5,4,109,1.5,-200,8.5,-115,-105,-119,-1.5,175,4.07,Globe Life Field,9,1
2021-05-07,2021,HOU,TOR,10,4,-141,-1.5,135,9.0,-120,100,131,1.5,-155,5.27,Minute Maid Park,14,6
2021-05-07,2021,NYY,WSH,4,11,-170,-1.5,110,8.5,-120,100,160,1.5,-130,5.35,Yankee Stadium,15,-7
2021-05-08,2021,NYM,ARI,4,2,-145,-1.5,140,8.0,-110,-110,135,1.5,-160,4.73,Citi Field,6,2
2021-05-08,2021,PHI,ATL,7,8,147,1.5,-140,9.0,100,-120,-157,-1.5,120,3.64,Suntrust Park,15,-1
2021-05-08,2021,BOS,BAL,11,6,-134,-1.5,110,9.0,-115,-105,124,1.5,-130,5.15,Camden Yards,17,5
2021-05-08,2021,BAL,BOS,6,11,124,1.5,-130,9.0,-115,-105,-134,-1.5,110,4.02,Camden Yards,17,-5
2021-05-08,2021,PIT,CHC,2,3,175,1.5,-125,8.0,-105,-115,-190,-1.5,105,2.91,Wrigley Field,5,-1
2021-05-08,2021,CLE,CIN,9,2,-111,-1.5,175,8.0,100,-120,101,1.5,-200,4.21,Progressive Field,11,7
2021-05-08,2021,CIN,CLE,2,9,101,1.5,-200,8.0,100,-120,-111,-1.5,175,3.98,Progressive Field,11,-7
2021-05-08,2021,STL,COL,9,8,-185,-1.5,105,7.5,105,-125,170,1.5,-125,4.87,Busch Stadium,17,1
2021-05-08,2021,KC,CWS,1,9,156,1.5,-110,9.0,-120,100,-166,-1.5,-110,3.52,Kauffman Stadium,10,-8
2021-05-08,2021,MIN,DET,3,7,-180,-1.5,-120,7.5,-115,-105,165,1.5,100,4.82,Comerica Park,10,-4
2021-05-08,2021,TOR,HOU,8,4,130,1.5,-165,9.0,-120,100,-140,-1.5,145,3.91,Minute Maid Park,12,4
2021-05-08,2021,CWS,KC,9,1,-166,-1.5,-110,9.0,-120,100,156,1.5,-110,5.62,Kauffman Stadium,10,8
2021-05-08,2021,LAD,LAA,14,11,-143,-1.5,115,8.0,-120,100,133,1.5,-135,4.71,Angel Stadium,25,3
2021-05-08,2021,LAA,LAD,11,14,133,1.5,-135,8.0,-120,100,-143,-1.5,115,3.43,Angel Stadium,25,-3
2021-05-08,2021,MIL,MIA,6,2,-115,-1.5,140,8.0,100,-120,105,1.5,-160,4.28,Marlins Park,8,4
2021-05-08,2021,MIA,MIL,2,6,105,1.5,-160,8.0,100,-120,-115,-1.5,140,3.9,Marlins Park,8,-4
2021-05-08,2021,DET,MIN,7,3,165,1.5,100,7.5,-115,-105,-180,-1.5,-120,2.83,Comerica Park,10,4
2021-05-08,2021,ARI,NYM,2,4,135,1.5,-160,8.0,-110,-110,-145,-1.5,140,3.4,Citi Field,6,-2
2021-05-08,2021,WSH,NYY,3,4,102,1.5,-190,8.0,-105,-115,-112,-1.5,170,3.96,Yankee Stadium,7,-1
2021-05-08,2021,TB,OAK,3,6,-125,-1.5,130,7.5,105,-125,115,1.5,-150,4.17,Oakland Coliseum,9,-3
2021-05-08,2021,ATL,PHI,8,7,-157,-1.5,120,9.0,100,-120,147,1.5,-140,5.5,Suntrust Park,15,1
2021-05-08,2021,CHC,PIT,3,2,-190,-1.5,105,8.0,-105,-115,175,1.5,-125,5.24,Wrigley Field,5,1
2021-05-08,2021,SF,SD,7,1,123,1.5,-150,7.0,-125,105,-133,-1.5,130,3.14,AT&T Park,8,6
2021-05-08,2021,TEX,SEA,9,8,-108,-1.5,175,9.5,-115,-105,-102,1.5,-200,4.93,Globe Life Field,17,1
2021-05-08,2021,SD,SF,1,7,-133,-1.5,130,7.0,-125,105,123,1.5,-150,4.0,AT&T Park,8,-6
2021-05-08,2021,COL,STL,8,9,170,1.5,-125,7.5,105,-125,-185,-1.5,105,2.78,Busch Stadium,17,-1
2021-05-08,2021,OAK,TB,6,3,115,1.5,-150,7.5,105,-125,-125,-1.5,130,3.49,Oakland Coliseum,9,3
2021-05-08,2021,SEA,TEX,8,9,-102,1.5,-200,9.5,-115,-105,-108,-1.5,175,4.8,Globe Life Field,17,-1
2021-05-08,2021,HOU,TOR,4,8,-140,-1.5,145,9.0,-120,100,130,1.5,-165,5.25,Minute Maid Park,12,-4
2021-05-08,2021,NYY,WSH,4,3,-112,-1.5,170,8.0,-105,-115,102,1.5,-190,4.23,Yankee Stadium,7,1
2021-05-09,2021,NYM,ARI,4,2,-310,-1.5,-135,7.0,105,-125,270,1.5,115,5.29,Citi Field,6,2
2021-05-09,2021,PHI,ATL,1,6,-105,-1.5,150,7.5,-115,-105,-105,1.5,-170,3.84,Suntrust Park,7,-5
2021-05-09,2021,BOS,BAL,4,3,-130,-1.5,120,9.0,-110,-110,120,1.5,-140,5.09,Camden Yards,7,1
2021-05-09,2021,BAL,BOS,3,4,120,1.5,-140,9.0,-110,-110,-130,-1.5,120,4.09,Camden Yards,7,-1
2021-05-09,2021,PIT,CHC,6,5,149,1.5,-170,6.0,-115,-105,-159,-1.5,150,2.41,Wrigley Field,11,1
2021-05-09,2021,STL,COL,2,0,-146,-1.5,155,7.0,-105,-115,136,1.5,-175,4.15,Busch Stadium,2,2
2021-05-09,2021,KC,CWS,3,9,132,1.5,-130,7.5,100,-120,-142,-1.5,110,3.23,Kauffman Stadium,12,-6
2021-05-09,2021,TOR,HOU,4,7,140,1.5,-140,9.0,-110,-110,-150,-1.5,120,3.75,Minute Maid Park,11,-3
2021-05-09,2021,CWS,KC,9,3,-142,-1.5,110,7.5,100,-120,132,1.5,-130,4.4,Kauffman Stadium,12,6
2021-05-09,2021,LAD,LAA,1,2,-180,-1.5,-120,8.5,-120,100,165,1.5,100,5.46,Angel Stadium,3,-1
2021-05-09,2021,LAA,LAD,2,1,165,1.5,100,8.5,-120,100,-180,-1.5,-120,3.21,Angel Stadium,3,1
2021-05-09,2021,MIL,MIA,2,1,127,1.5,-180,7.0,100,-120,-137,-1.5,160,3.08,Marlins Park,3,1
2021-05-09,2021,MIA,MIL,1,2,-137,-1.5,160,7.0,100,-120,127,1.5,-180,4.05,Marlins Park,3,-1
2021-05-09,2021,ARI,NYM,2,4,270,1.5,115,7.0,105,-125,-310,-1.5,-135,1.89,Citi Field,6,-2
2021-05-09,2021,WSH,NYY,2,3,140,1.5,-150,9.0,-120,100,-150,-1.5,130,3.75,Yankee Stadium,5,-1
2021-05-09,2021,TB,OAK,4,3,110,1.5,-185,7.5,-110,-110,-120,-1.5,165,3.57,Oakland Coliseum,7,1
2021-05-09,2021,ATL,PHI,6,1,-105,1.5,-170,7.5,-115,-105,-105,-1.5,150,3.84,Suntrust Park,7,5
2021-05-09,2021,CHC,PIT,5,6,-159,-1.5,150,6.0,-115,-105,149,1.5,-170,3.68,Wrigley Field,11,-1
2021-05-09,2021,SF,SD,1,11,120,1.5,-145,8.0,-120,100,-130,-1.5,125,3.64,AT&T Park,12,-10
2021-05-09,2021,TEX,SEA,10,2,-130,-1.5,155,8.0,-120,100,120,1.5,-175,4.52,Globe Life Field,12,8
2021-05-09,2021,SD,SF,11,1,-130,-1.5,125,8.0,-120,100,120,1.5,-145,4.52,AT&T Park,12,10
2021-05-09,2021,COL,STL,0,2,136,1.5,-175,7.0,-105,-115,-146,-1.5,155,2.97,Busch Stadium,2,-2
2021-05-09,2021,OAK,TB,3,4,-120,-1.5,165,7.5,-110,-110,110,1.5,-185,4.09,Oakland Coliseum,7,-1
2021-05-09,2021,SEA,TEX,2,10,120,1.5,-175,8.0,-120,100,-130,-1.5,155,3.64,Globe Life Field,12,-8
2021-05-09,2021,HOU,TOR,7,4,-150,-1.5,120,9.0,-110,-110,140,1.5,-140,5.4,Minute Maid Park,11,3
2021-05-09,2021,NYY,WSH,3,2,-150,-1.5,130,9.0,-120,100,140,1.5,-150,5.4,Yankee Stadium,5,1
2021-05-10,2021,MIA,ARI,2,5,108,1.5,-190,9.0,-110,-110,-118,-1.5,170,4.33,Chase Field,7,-3
2021-05-10,2021,BOS,BAL,1,4,-132,-1.5,115,9.0,-120,100,122,1.5,-135,5.12,Camden Yards,5,-3
2021-05-10,2021,BAL,BOS,4,1,122,1.5,-135,9.0,-120,100,-132,-1.5,115,4.05,Camden Yards,5,3
2021-05-10,2021,PIT,CIN,1,14,145,1.5,-125,7.5,-115,-105,-155,-1.5,105,3.06,PNC Park,15,-13
2021-05-10,2021,LAA,HOU,5,4,165,1.5,-115,9.5,-115,-105,-180,-1.5,-105,3.58,Minute Maid Park,9,1
2021-05-10,2021,HOU,LAA,4,5,-180,-1.5,-105,9.5,-115,-105,165,1.5,-115,6.11,Minute Maid Park,9,-1
2021-05-10,2021,ARI,MIA,5,2,-118,-1.5,170,9.0,-110,-110,108,1.5,-190,4.87,Chase Field,7,3
2021-05-10,2021,CIN,PIT,14,1,-155,-1.5,105,7.5,-115,-105,145,1.5,-125,4.56,PNC Park,15,13
2021-05-10,2021,TEX,SF,1,3,128,1.5,-180,7.0,-125,105,-138,-1.5,160,3.07,AT&T Park,4,-2
2021-05-10,2021,SF,TEX,3,1,-138,-1.5,160,7.0,-125,105,128,1.5,-180,4.06,AT&T Park,4,2
2021-05-11,2021,MIA,ARI,3,11,101,1.5,-200,8.0,-110,-110,-111,-1.5,175,3.98,Chase Field,14,-8
2021-05-11,2021,TOR,ATL,5,3,-107,-1.5,145,9.5,-105,-115,-103,1.5,-165,4.91,Suntrust Park,8,2
2021-05-11,2021,NYM,BAL,3,2,-156,-1.5,150,6.5,-110,-110,146,1.5,-170,3.96,Citi Field,5,1
2021-05-11,2021,OAK,BOS,3,2,110,1.5,-175,8.5,-120,100,-120,-1.5,155,4.05,Fenway Park,5,1
2021-05-11,2021,CLE,CHC,3,2,-185,-1.5,125,7.0,100,-120,170,1.5,-145,4.54,Progressive Field,5,1
2021-05-11,2021,PIT,CIN,7,2,-118,-1.5,165,7.5,-115,-105,108,1.5,-185,4.06,PNC Park,9,5
2021-05-11,2021,CHC,CLE,2,3,170,1.5,-145,7.0,100,-120,-185,-1.5,125,2.59,Progressive Field,5,-1
2021-05-11,2021,SD,COL,8,1,-163,-1.5,-110,9.5,100,-120,153,1.5,-110,5.89,Coors Field,9,7
2021-05-11,2021,MIN,CWS,3,9,102,1.5,-200,7.5,-110,-110,-112,-1.5,175,3.71,Guaranteed Rate Field,12,-6
2021-05-11,2021,KC,DET,7,8,-129,-1.5,130,8.0,-105,-115,119,1.5,-150,4.51,Comerica Park,15,-1
2021-05-11,2021,LAA,HOU,1,5,138,1.5,-160,8.5,-125,105,-148,-1.5,140,3.57,Minute Maid Park,6,-4
2021-05-11,2021,DET,KC,8,7,119,1.5,-150,8.0,-105,-115,-129,-1.5,130,3.65,Comerica Park,15,1
2021-05-11,2021,HOU,LAA,5,1,-148,-1.5,140,8.5,-125,105,138,1.5,-160,5.07,Minute Maid Park,6,4
2021-05-11,2021,SEA,LAD,4,6,210,1.5,-105,7.0,-120,100,-240,-1.5,-115,2.26,Dodger Stadium,10,-2
2021-05-11,2021,ARI,MIA,11,3,-111,-1.5,175,8.0,-110,-110,101,1.5,-200,4.21,Chase Field,14,8
2021-05-11,2021,STL,MIL,6,1,115,1.5,-190,7.0,-110,-110,-125,-1.5,170,3.26,Miller Park,7,5
2021-05-11,2021,CWS,MIN,9,3,-112,-1.5,175,7.5,-110,-110,102,1.5,-200,3.96,Guaranteed Rate Field,12,6
2021-05-11,2021,BAL,NYM,2,3,146,1.5,-170,6.5,-110,-110,-156,-1.5,150,2.64,Citi Field,5,-1
2021-05-11,2021,TB,NYY,1,3,109,1.5,-150,8.0,-110,-110,-119,-1.5,130,3.83,Tropicana Field,4,-2
2021-05-11,2021,BOS,OAK,2,3,-120,-1.5,155,8.5,-120,100,110,1.5,-175,4.64,Fenway Park,5,-1
2021-05-11,2021,WSH,PHI,2,6,-120,-1.5,170,9.0,-115,-105,110,1.5,-190,4.91,Nationals Park,8,-4
2021-05-11,2021,CIN,PIT,2,7,108,1.5,-185,7.5,-115,-105,-118,-1.5,165,3.61,PNC Park,9,-5
2021-05-11,2021,COL,SD,1,8,153,1.5,-110,9.5,100,-120,-163,-1.5,-110,3.75,Coors Field,9,-7
2021-05-11,2021,LAD,SEA,6,4,-240,-1.5,-115,7.0,-120,100,210,1.5,-105,4.94,Dodger Stadium,10,2
2021-05-11,2021,TEX,SF,2,4,135,1.5,-165,8.0,-120,100,-145,-1.5,145,3.4,AT&T Park,6,-2
2021-05-11,2021,MIL,STL,1,6,-125,-1.5,170,7.0,-110,-110,115,1.5,-190,3.89,Miller Park,7,-5
2021-05-11,2021,NYY,TB,3,1,-119,-1.5,130,8.0,-110,-110,109,1.5,-150,4.35,Tropicana Field,4,2
2021-05-11,2021,SF,TEX,4,2,-145,-1.5,145,8.0,-120,100,135,1.5,-165,4.73,AT&T Park,6,2
2021-05-11,2021,ATL,TOR,3,5,-103,1.5,-165,9.5,-105,-115,-107,-1.5,145,4.82,Suntrust Park,8,-2
2021-05-11,2021,PHI,WSH,6,2,110,1.5,-190,9.0,-115,-105,-120,-1.5,170,4.29,Nationals Park,8,4
2021-05-12,2021,MIA,ARI,3,2,115,1.5,-175,9.0,-115,-105,-125,-1.5,155,4.19,Chase Field,5,1
2021-05-12,2021,TOR,ATL,4,1,100,1.5,-210,7.5,-115,-105,-110,-1.5,185,3.75,Suntrust Park,5,3
2021-05-12,2021,NYM,BAL,7,1,-172,-1.5,105,7.0,-120,100,161,1.5,-125,4.43,Citi Field,8,6
2021-05-12,2021,OAK,BOS,4,1,136,1.5,-140,9.5,-110,-110,-146,-1.5,120,4.03,Fenway Park,5,3
2021-05-12,2021,CLE,CHC,2,1,-130,-1.5,150,8.5,100,-120,120,1.5,-170,4.8,Progressive Field,3,1
2021-05-12,2021,PIT,CIN,1,5,157,1.5,-115,7.0,-125,105,-167,-1.5,-105,2.72,PNC Park,6,-4
2021-05-12,2021,CHC,CLE,1,2,120,1.5,-170,8.5,100,-120,-130,-1.5,150,3.86,Progressive Field,3,-1
2021-05-12,2021,SD,COL,5,3,-148,-1.5,115,6.5,-115,-105,138,1.5,-135,3.88,Coors Field,8,2
2021-05-12,2021,SD,COL,2,3,-156,-1.5,105,7.5,100,-120,146,1.5,-125,4.57,Coors Field,5,-1
2021-05-12,2021,MIN,CWS,8,13,120,1.5,-175,8.0,-115,-105,-130,-1.5,155,3.64,Guaranteed Rate Field,21,-5
2021-05-12,2021,KC,DET,2,4,-150,-1.5,110,8.0,-115,-105,140,1.5,-130,4.8,Comerica Park,6,-2
2021-05-12,2021,LAA,HOU,1,9,150,1.5,-150,8.5,-105,-115,-160,-1.5,130,3.4,Minute Maid Park,10,-8
2021-05-12,2021,DET,KC,4,2,140,1.5,-130,8.0,-115,-105,-150,-1.5,110,3.33,Comerica Park,6,2
2021-05-12,2021,HOU,LAA,9,1,-160,-1.5,130,8.5,-105,-115,150,1.5,-150,5.23,Minute Maid Park,10,8
2021-05-12,2021,SEA,LAD,1,7,230,1.5,110,8.0,-115,-105,-260,-1.5,-130,2.42,Dodger Stadium,8,-6
2021-05-12,2021,ARI,MIA,2,3,-125,-1.5,155,9.0,-115,-105,115,1.5,-175,5.0,Chase Field,5,-1
2021-05-12,2021,STL,MIL,1,4,164,1.5,-145,7.5,100,-120,-177,-1.5,125,2.84,Miller Park,5,-3
2021-05-12,2021,CWS,MIN,13,8,-130,-1.5,155,8.0,-115,-105,120,1.5,-175,4.52,Guaranteed Rate Field,21,5
2021-05-12,2021,BAL,NYM,1,7,161,1.5,-125,7.0,-120,100,-172,-1.5,105,2.68,Citi Field,8,-6
2021-05-12,2021,TB,NYY,0,1,175,1.5,-105,7.0,-110,-110,-190,-1.5,-115,2.55,Tropicana Field,1,-1
2021-05-12,2021,BOS,OAK,1,4,-146,-1.5,120,9.5,-110,-110,136,1.5,-140,5.64,Fenway Park,5,-3
2021-05-12,2021,WSH,PHI,2,5,116,1.5,-145,8.5,-105,-115,-126,-1.5,125,3.94,Nationals Park,7,-3
2021-05-12,2021,CIN,PIT,5,1,-167,-1.5,-105,7.0,-125,105,157,1.5,-115,4.38,PNC Park,6,4
2021-05-12,2021,COL,SD,3,5,138,1.5,-135,6.5,-115,-105,-148,-1.5,115,2.73,Coors Field,8,-2
2021-05-12,2021,COL,SD,3,2,146,1.5,-125,7.5,100,-120,-156,-1.5,105,3.05,Coors Field,5,1
2021-05-12,2021,LAD,SEA,7,1,-260,-1.5,-130,8.0,-115,-105,230,1.5,110,5.78,Dodger Stadium,8,6
2021-05-12,2021,MIL,STL,4,1,-177,-1.5,125,7.5,100,-120,164,1.5,-145,4.79,Miller Park,5,3
2021-05-12,2021,NYY,TB,1,0,-190,-1.5,-115,7.0,-110,-110,175,1.5,-105,4.59,Tropicana Field,1,1
2021-05-12,2021,ATL,TOR,1,4,-110,-1.5,185,7.5,-115,-105,100,1.5,-210,3.93,Suntrust Park,5,-3
2021-05-12,2021,PHI,WSH,5,2,-126,-1.5,125,8.5,-105,-115,116,1.5,-145,4.74,Nationals Park,7,3
2021-05-13,2021,MIA,ARI,5,1,-125,-1.5,130,8.5,-115,-105,115,1.5,-150,4.72,Chase Field,6,4
2021-05-13,2021,TOR,ATL,8,4,145,1.5,-145,8.5,-115,-105,-155,-1.5,125,3.47,Suntrust Park,12,4
2021-05-13,2021,OAK,BOS,1,8,-101,1.5,-200,9.0,-110,-110,-109,-1.5,175,4.52,Fenway Park,9,-7
2021-05-13,2021,COL,CIN,13,8,147,1.5,-105,11.5,-105,-115,-157,-1.5,-115,4.66,Coors Field,21,5
2021-05-13,2021,SEA,CLE,2,4,110,1.5,-160,7.5,-110,-110,-120,-1.5,140,3.57,T-Mobile Park,6,-2
2021-05-13,2021,CIN,COL,8,13,-157,-1.5,-115,11.5,-105,-115,147,1.5,-105,7.03,Coors Field,21,-5
2021-05-13,2021,MIN,CWS,2,4,116,1.5,-180,7.5,-110,-110,-126,-1.5,160,3.47,Guaranteed Rate Field,6,-2
2021-05-13,2021,KC,DET,3,4,-105,1.5,-200,9.0,-110,-110,-105,-1.5,175,4.61,Comerica Park,7,-1
2021-05-13,2021,TEX,HOU,3,4,180,1.5,-115,9.0,100,-120,-200,-1.5,-105,3.21,Minute Maid Park,7,-1
2021-05-13,2021,DET,KC,4,3,-105,-1.5,175,9.0,-110,-110,-105,1.5,-200,4.61,Comerica Park,7,1
2021-05-13,2021,ARI,MIA,1,5,115,1.5,-150,8.5,-115,-105,-125,-1.5,130,3.95,Chase Field,6,-4
2021-05-13,2021,STL,MIL,2,0,125,1.5,-185,6.5,-110,-110,-135,-1.5,165,2.89,Miller Park,2,2
2021-05-13,2021,CWS,MIN,4,2,-126,-1.5,160,7.5,-110,-110,116,1.5,-180,4.18,Guaranteed Rate Field,6,2
2021-05-13,2021,TB,NYY,9,1,106,1.5,-160,8.0,-105,-115,-116,-1.5,140,3.88,Tropicana Field,10,8
2021-05-13,2021,BOS,OAK,8,1,-109,-1.5,175,9.0,-110,-110,-101,1.5,-200,4.69,Fenway Park,9,7
2021-05-13,2021,WSH,PHI,5,1,-110,1.5,-175,8.0,-120,100,100,-1.5,155,4.19,Nationals Park,6,4
2021-05-13,2021,SF,PIT,3,1,-145,-1.5,100,8.0,100,-120,135,1.5,-120,4.73,PNC Park,4,2
2021-05-13,2021,CLE,SEA,4,2,-120,-1.5,140,7.5,-110,-110,110,1.5,-160,4.09,T-Mobile Park,6,2
2021-05-13,2021,PIT,SF,1,3,135,1.5,-120,8.0,100,-120,-145,-1.5,100,3.4,PNC Park,4,-2
2021-05-13,2021,MIL,STL,0,2,-135,-1.5,165,6.5,-110,-110,125,1.5,-185,3.73,Miller Park,2,-2
2021-05-13,2021,NYY,TB,1,9,-116,-1.5,140,8.0,-105,-115,106,1.5,-160,4.3,Tropicana Field,10,-8
2021-05-13,2021,HOU,TEX,4,3,-200,-1.5,-105,9.0,100,-120,180,1.5,-115,6.0,Minute Maid Park,7,1
2021-05-13,2021,ATL,TOR,4,8,-155,-1.5,125,8.5,-115,-105,145,1.5,-145,5.17,Suntrust Park,12,-4
2021-05-13,2021,PHI,WSH,1,5,100,-1.5,155,8.0,-120,100,-110,1.5,-175,4.0,Nationals Park,6,-4
2021-05-14,2021,WSH,ARI,17,2,-186,-1.5,-130,9.0,100,-120,171,1.5,110,5.85,Chase Field,19,15
2021-05-14,2021,MIL,ATL,3,6,-134,-1.5,150,7.5,-120,100,124,1.5,-170,4.29,Miller Park,9,-3
2021-05-14,2021,NYY,BAL,5,4,-168,-1.5,105,8.5,-110,-110,158,1.5,-125,5.33,Camden Yards,9,1
2021-05-14,2021,LAA,BOS,3,4,101,1.5,-185,9.5,-115,-105,-111,-1.5,165,4.73,Fenway Park,7,-1
2021-05-14,2021,DET,CHC,2,4,136,1.5,-125,9.0,100,-120,-146,-1.5,105,3.81,Comerica Park,6,-2
2021-05-14,2021,COL,CIN,9,6,-105,-1.5,165,10.5,-105,-115,-105,1.5,-185,5.38,Coors Field,15,3
2021-05-14,2021,SEA,CLE,7,3,102,1.5,-160,7.5,-110,-110,-112,-1.5,140,3.71,T-Mobile Park,10,4
2021-05-14,2021,CIN,COL,6,9,-105,1.5,-185,10.5,-105,-115,-105,-1.5,165,5.38,Coors Field,15,-3
2021-05-14,2021,KC,CWS,6,2,176,1.5,-140,6.0,-40,120,-192,-1.5,120,2.17,Guaranteed Rate Field,8,4
2021-05-14,2021,KC,CWS,1,3,156,1.5,-155,6.5,105,-125,-166,-1.5,135,2.54,Guaranteed Rate Field,4,-2
2021-05-14,2021,CHC,DET,4,2,-146,-1.5,105,9.0,100,-120,136,1.5,-125,5.34,Comerica Park,6,2
2021-05-14,2021,TEX,HOU,4,10,196,1.5,-105,9.0,100,-120,-216,-1.5,-115,3.04,Minute Maid Park,14,-6
2021-05-14,2021,CWS,KC,2,6,-192,-1.5,120,6.0,-40,120,176,1.5,-140,3.95,Guaranteed Rate Field,8,-4
2021-05-14,2021,CWS,KC,3,1,-166,-1.5,135,6.5,105,-125,156,1.5,-155,4.06,Guaranteed Rate Field,4,2
2021-05-14,2021,BOS,LAA,4,3,-111,-1.5,165,9.5,-115,-105,101,1.5,-185,5.0,Fenway Park,7,1
2021-05-14,2021,MIA,LAD,6,9,209,1.5,-115,6.5,-125,105,-229,-1.5,-105,2.1,Dodger Stadium,15,-3
2021-05-14,2021,LAD,MIA,9,6,-229,-1.5,-105,6.5,-125,105,209,1.5,-115,4.52,Dodger Stadium,15,3
2021-05-14,2021,ATL,MIL,6,3,124,1.5,-170,7.5,-120,100,-134,-1.5,150,3.35,Miller Park,9,3
2021-05-14,2021,OAK,MIN,6,1,-112,-1.5,145,8.5,-125,105,102,1.5,-165,4.49,Target Field,7,5
2021-05-14,2021,TB,NYM,3,2,-157,-1.5,130,6.5,-120,100,147,1.5,-150,3.97,Tropicana Field,5,1
2021-05-14,2021,BAL,NYY,4,5,158,1.5,-125,8.5,-110,-110,-168,-1.5,105,3.29,Camden Yards,9,-1
2021-05-14,2021,MIN,OAK,1,6,102,1.5,-165,8.5,-125,105,-112,-1.5,145,4.21,Target Field,7,-5
2021-05-14,2021,TOR,PHI,1,5,-144,-1.5,125,11.0,100,-120,134,1.5,-145,6.49,TD Ballpark,6,-4
2021-05-14,2021,SF,PIT,2,3,-184,-1.5,-120,7.5,100,-120,169,1.5,100,4.86,PNC Park,5,-1
2021-05-14,2021,STL,SD,4,5,158,1.5,-155,7.0,100,-120,-168,-1.5,135,2.71,PETCO Park,9,-1
2021-05-14,2021,CLE,SEA,3,7,-112,-1.5,140,7.5,-110,-110,102,1.5,-160,3.96,T-Mobile Park,10,-4
2021-05-14,2021,PIT,SF,3,2,169,1.5,100,7.5,100,-120,-184,-1.5,-120,2.79,PNC Park,5,1
2021-05-14,2021,SD,STL,5,4,-168,-1.5,135,7.0,100,-120,158,1.5,-155,4.39,PETCO Park,9,1
2021-05-14,2021,NYM,TB,2,3,147,1.5,-150,6.5,-120,100,-157,-1.5,130,2.63,Tropicana Field,5,-1
2021-05-14,2021,HOU,TEX,10,4,-216,-1.5,-115,9.0,100,-120,196,1.5,-105,6.15,Minute Maid Park,14,6
2021-05-14,2021,PHI,TOR,5,1,134,1.5,-145,11.0,100,-120,-144,-1.5,125,4.7,TD Ballpark,6,4
2021-05-14,2021,ARI,WSH,2,17,171,1.5,110,9.0,100,-120,-186,-1.5,-130,3.32,Chase Field,19,-15
2021-05-15,2021,WSH,ARI,4,11,-124,-1.5,120,10.0,100,-120,114,1.5,-140,5.54,Chase Field,15,-7
2021-05-15,2021,MIL,ATL,1,5,100,1.5,-170,8.0,100,-120,-110,-1.5,150,4.0,Miller Park,6,-4
2021-05-15,2021,NYY,BAL,8,2,-154,-1.5,100,8.5,-120,100,144,1.5,-120,5.15,Camden Yards,10,6
2021-05-15,2021,LAA,BOS,0,9,-113,-1.5,135,10.0,-115,-105,103,1.5,-155,5.31,Fenway Park,9,-9
2021-05-15,2021,DET,CHC,9,8,142,1.5,-125,9.0,100,-120,-152,-1.5,105,3.72,Comerica Park,17,1
2021-05-15,2021,COL,CIN,5,6,159,1.5,100,11.0,100,-120,-169,-1.5,-120,4.25,Coors Field,11,-1
2021-05-15,2021,SEA,CLE,7,3,-101,1.5,-165,8.5,-105,-115,-109,-1.5,145,4.27,T-Mobile Park,10,4
2021-05-15,2021,CIN,COL,6,5,-169,-1.5,-120,11.0,100,-120,159,1.5,100,6.91,Coors Field,11,1
2021-05-15,2021,KC,CWS,5,1,174,1.5,-120,8.0,-105,-115,-189,-1.5,100,2.92,Guaranteed Rate Field,6,4
2021-05-15,2021,CHC,DET,8,9,-152,-1.5,105,9.0,100,-120,142,1.5,-125,5.43,Comerica Park,17,-1
2021-05-15,2021,TEX,HOU,5,6,145,1.5,-140,8.5,-115,-105,-155,-1.5,120,3.47,Minute Maid Park,11,-1
2021-05-15,2021,CWS,KC,1,5,-189,-1.5,100,8.0,-105,-115,174,1.5,-120,5.23,Guaranteed Rate Field,6,-4
2021-05-15,2021,BOS,LAA,9,0,103,1.5,-155,10.0,-115,-105,-113,-1.5,135,4.93,Fenway Park,9,9
2021-05-15,2021,MIA,LAD,0,7,250,1.5,105,7.5,-105,-115,-290,-1.5,-125,2.14,Dodger Stadium,7,-7
2021-05-15,2021,LAD,MIA,7,0,-290,-1.5,-125,7.5,-105,-115,250,1.5,105,5.58,Dodger Stadium,7,7
2021-05-15,2021,ATL,MIL,5,1,-110,-1.5,150,8.0,100,-120,100,1.5,-170,4.19,Miller Park,6,4
2021-05-15,2021,OAK,MIN,4,5,125,1.5,-165,8.5,-115,-105,-135,-1.5,145,3.78,Target Field,9,-1
2021-05-15,2021,TB,NYM,12,5,-142,-1.5,135,7.5,100,-120,132,1.5,-155,4.4,Tropicana Field,17,7
2021-05-15,2021,BAL,NYY,2,8,144,1.5,-120,8.5,-120,100,-154,-1.5,100,3.48,Camden Yards,10,-6
2021-05-15,2021,MIN,OAK,5,4,-135,-1.5,145,8.5,-115,-105,125,1.5,-165,4.88,Target Field,9,1
2021-05-15,2021,TOR,PHI,4,0,133,1.5,-125,10.0,-110,-110,-143,-1.5,105,4.29,TD Ballpark,4,4
2021-05-15,2021,SF,PIT,6,8,-120,-1.5,130,7.5,-120,100,110,1.5,-150,4.09,PNC Park,14,-2
2021-05-15,2021,STL,SD,3,13,107,1.5,-205,7.0,100,-120,-117,-1.5,180,3.38,PETCO Park,16,-10
2021-05-15,2021,CLE,SEA,3,7,-109,-1.5,145,8.5,-105,-115,-101,1.5,-165,4.43,T-Mobile Park,10,-4
2021-05-15,2021,PIT,SF,8,6,110,1.5,-150,7.5,-120,100,-120,-1.5,130,3.57,PNC Park,14,2
2021-05-15,2021,SD,STL,13,3,-117,-1.5,180,7.0,100,-120,107,1.5,-205,3.77,PETCO Park,16,10
2021-05-15,2021,NYM,TB,5,12,132,1.5,-155,7.5,100,-120,-142,-1.5,135,3.23,Tropicana Field,17,-7
2021-05-15,2021,HOU,TEX,6,5,-155,-1.5,120,8.5,-115,-105,145,1.5,-140,5.17,Minute Maid Park,11,1
2021-05-15,2021,PHI,TOR,0,4,-143,-1.5,105,10.0,-110,-110,133,1.5,-125,5.88,TD Ballpark,4,-4
2021-05-15,2021,ARI,WSH,11,4,114,1.5,-140,10.0,100,-120,-124,-1.5,120,4.67,Chase Field,15,7
2021-05-16,2021,WSH,ARI,3,0,-105,1.5,-205,9.0,-115,-105,-105,-1.5,180,4.61,Chase Field,3,3
2021-05-16,2021,MIL,ATL,10,9,-130,-1.5,165,7.0,-105,-115,120,1.5,-185,3.96,Miller Park,19,1
2021-05-16,2021,NYY,BAL,6,10,-160,-1.5,-110,9.0,-110,-110,150,1.5,-110,5.54,Camden Yards,16,-4
2021-05-16,2021,LAA,BOS,6,5,144,1.5,-140,9.5,-120,100,-154,-1.5,120,3.89,Fenway Park,11,1
2021-05-16,2021,DET,CHC,1,5,132,1.5,-135,8.0,-120,100,-142,-1.5,115,3.45,Comerica Park,6,-4
2021-05-16,2021,COL,CIN,6,7,-105,1.5,-160,11.0,-115,-105,-105,-1.5,140,5.63,Coors Field,13,-1
2021-05-16,2021,SEA,CLE,3,2,180,1.5,100,7.5,100,-120,-200,-1.5,-120,2.68,T-Mobile Park,5,1
2021-05-16,2021,CIN,COL,7,6,-105,-1.5,140,11.0,-115,-105,-105,1.5,-160,5.63,Coors Field,13,1
2021-05-16,2021,KC,CWS,3,4,160,1.5,-130,8.5,100,-120,-170,-1.5,110,3.27,Guaranteed Rate Field,7,-1
2021-05-16,2021,CHC,DET,5,1,-142,-1.5,115,8.0,-120,100,132,1.5,-135,4.69,Comerica Park,6,4
2021-05-16,2021,TEX,HOU,2,6,155,1.5,-140,7.5,-115,-105,-165,-1.5,120,2.94,Minute Maid Park,8,-4
2021-05-16,2021,CWS,KC,4,3,-170,-1.5,110,8.5,100,-120,160,1.5,-130,5.35,Guaranteed Rate Field,7,1
2021-05-16,2021,BOS,LAA,5,6,-154,-1.5,120,9.5,-120,100,144,1.5,-140,5.76,Fenway Park,11,-1
2021-05-16,2021,MIA,LAD,3,2,135,1.5,-160,7.5,-115,-105,-145,-1.5,140,3.19,Dodger Stadium,5,1
2021-05-16,2021,LAD,MIA,2,3,-145,-1.5,140,7.5,-115,-105,135,1.5,-160,4.44,Dodger Stadium,5,-1
2021-05-16,2021,ATL,MIL,9,10,120,1.5,-185,7.0,-105,-115,-130,-1.5,165,3.18,Miller Park,19,-1
2021-05-16,2021,OAK,MIN,7,6,102,1.5,-190,8.5,-115,-105,-112,-1.5,170,4.21,Target Field,13,1
2021-05-16,2021,TB,NYM,7,1,-105,1.5,-175,7.5,100,-120,-105,-1.5,155,3.84,Tropicana Field,8,6
2021-05-16,2021,BAL,NYY,10,6,150,1.5,-110,9.0,-110,-110,-160,-1.5,-110,3.6,Camden Yards,16,4
2021-05-16,2021,MIN,OAK,6,7,-112,-1.5,170,8.5,-115,-105,102,1.5,-190,4.49,Target Field,13,-1
2021-05-16,2021,TOR,PHI,10,8,-192,-1.5,-105,10.0,-110,-110,176,1.5,-115,6.58,TD Ballpark,18,2
2021-05-16,2021,SF,PIT,4,1,-170,-1.5,-110,7.5,-115,-105,160,1.5,-110,4.72,PNC Park,5,3
2021-05-16,2021,STL,SD,3,5,100,1.5,-210,7.5,-105,-115,-110,-1.5,185,3.75,PETCO Park,8,-2
2021-05-16,2021,CLE,SEA,2,3,-200,-1.5,-120,7.5,100,-120,180,1.5,100,5.0,T-Mobile Park,5,-1
2021-05-16,2021,PIT,SF,1,4,160,1.5,-110,7.5,-115,-105,-170,-1.5,-110,2.88,PNC Park,5,-3
2021-05-16,2021,SD,STL,5,3,-110,-1.5,185,7.5,-105,-115,100,1.5,-210,3.93,PETCO Park,8,2
2021-05-16,2021,NYM,TB,1,7,-105,-1.5,155,7.5,100,-120,-105,1.5,-175,3.84,Tropicana Field,8,-6
2021-05-16,2021,HOU,TEX,6,2,-165,-1.5,120,7.5,-115,-105,155,1.5,-140,4.67,Minute Maid Park,8,4
2021-05-16,2021,PHI,TOR,8,10,176,1.5,-115,10.0,-110,-110,-192,-1.5,-105,3.62,TD Ballpark,18,-2
2021-05-16,2021,ARI,WSH,0,3,-105,-1.5,180,9.0,-115,-105,-105,1.5,-205,4.61,Chase Field,3,-3
2021-05-17,2021,LAD,ARI,3,1,-207,-1.5,100,7.0,-105,-115,187,1.5,-120,4.72,Dodger Stadium,4,2
2021-05-17,2021,NYM,ATL,3,1,148,1.5,-160,8.0,-110,-110,-158,-1.5,140,3.23,Suntrust Park,4,2
2021-05-17,2021,WSH,CHC,3,7,144,1.5,-150,8.0,-105,-115,-154,-1.5,130,3.28,Wrigley Field,10,-4
2021-05-17,2021,SF,CIN,6,3,120,1.5,-170,8.0,-105,-115,-130,-1.5,150,3.64,Great American Ballpark,9,3
2021-05-17,2021,LAA,CLE,7,4,-135,-1.5,155,9.5,-105,-115,125,1.5,-175,5.46,Angel Stadium,11,3
2021-05-17,2021,SD,COL,7,0,-215,-1.5,105,6.5,-105,-115,195,1.5,-125,4.44,PETCO Park,7,7
2021-05-17,2021,MIN,CWS,4,16,-110,-1.5,175,9.5,-105,-115,100,1.5,-195,4.98,Target Field,20,-12
2021-05-17,2021,SEA,DET,1,4,-170,-1.5,120,7.5,-120,100,160,1.5,-140,4.72,T-Mobile Park,5,-3
2021-05-17,2021,CLE,LAA,4,7,125,1.5,-175,9.5,-105,-115,-135,-1.5,155,4.22,Angel Stadium,11,-3
2021-05-17,2021,ARI,LAD,1,3,187,1.5,-120,7.0,-105,-115,-207,-1.5,100,2.44,Dodger Stadium,4,-2
2021-05-17,2021,CWS,MIN,16,4,100,1.5,-195,9.5,-105,-115,-110,-1.5,175,4.75,Target Field,20,12
2021-05-17,2021,ATL,NYM,1,3,-158,-1.5,140,8.0,-110,-110,148,1.5,-160,4.9,Suntrust Park,4,-2
2021-05-17,2021,TEX,NYY,5,2,230,1.5,140,8.0,100,-120,-260,-1.5,-160,2.42,Globe Life Field,7,3
2021-05-17,2021,COL,SD,0,7,195,1.5,-125,6.5,-105,-115,-215,-1.5,105,2.2,PETCO Park,7,-7
2021-05-17,2021,DET,SEA,4,1,160,1.5,-140,7.5,-120,100,-170,-1.5,120,2.88,T-Mobile Park,5,3
2021-05-17,2021,CIN,SF,3,6,-130,-1.5,150,8.0,-105,-115,120,1.5,-170,4.52,Great American Ballpark,9,-3
2021-05-17,2021,NYY,TEX,2,5,-260,-1.5,-160,8.0,100,-120,230,1.5,140,5.78,Globe Life Field,7,-3
2021-05-17,2021,CHC,WSH,7,3,-154,-1.5,130,8.0,-105,-115,144,1.5,-150,4.85,Wrigley Field,10,4
2021-05-18,2021,LAD,ARI,9,1,-260,-1.5,-125,7.5,100,-120,230,1.5,105,5.42,Dodger Stadium,10,8
2021-05-18,2021,NYM,ATL,4,3,137,1.5,-165,8.5,-110,-110,-147,-1.5,145,3.59,Suntrust Park,7,1
2021-05-18,2021,TB,BAL,13,6,-150,-1.5,100,9.0,-115,-105,140,1.5,-120,5.4,Camden Yards,19,7
2021-05-18,2021,TOR,BOS,8,0,-122,-1.5,145,9.0,-120,100,112,1.5,-165,4.95,TD Ballpark,8,8
2021-05-18,2021,WSH,CHC,3,6,-105,-1.5,140,9.0,100,-120,-105,1.5,-160,4.61,Wrigley Field,9,-3
2021-05-18,2021,SF,CIN,4,2,107,1.5,-185,8.0,-110,-110,-117,-1.5,165,3.86,Great American Ballpark,6,2
2021-05-18,2021,LAA,CLE,5,6,-110,-1.5,175,7.5,-105,-115,100,1.5,-200,3.93,Angel Stadium,11,-1
2021-05-18,2021,SD,COL,2,1,-210,-1.5,-105,7.0,-115,-105,190,1.5,-115,4.74,PETCO Park,3,1
2021-05-18,2021,MIN,CWS,5,4,135,1.5,-130,8.5,-105,-115,-145,-1.5,110,3.62,Target Field,9,1
2021-05-18,2021,SEA,DET,0,5,-113,-1.5,165,8.0,-105,-115,103,1.5,-185,4.24,T-Mobile Park,5,-5
2021-05-18,2021,OAK,HOU,6,5,106,1.5,-170,8.0,-115,-105,-116,-1.5,150,3.88,Oakland Coliseum,11,1
2021-05-18,2021,MIL,KC,0,2,-170,-1.5,-110,7.5,100,-120,160,1.5,-110,4.72,Kauffman Stadium,2,-2
2021-05-18,2021,CLE,LAA,6,5,100,1.5,-200,7.5,-105,-115,-110,-1.5,175,3.75,Angel Stadium,11,1
2021-05-18,2021,ARI,LAD,1,9,230,1.5,105,7.5,100,-120,-260,-1.5,-125,2.27,Dodger Stadium,10,-8
2021-05-18,2021,PHI,MIA,8,3,-174,-1.5,110,7.5,-120,100,162,1.5,-130,4.76,Citizens Bank Park,11,5
2021-05-18,2021,KC,MIL,2,0,160,1.5,-110,7.5,100,-120,-170,-1.5,-110,2.88,Kauffman Stadium,2,2
2021-05-18,2021,CWS,MIN,4,5,-145,-1.5,110,8.5,-105,-115,135,1.5,-130,5.03,Target Field,9,-1
2021-05-18,2021,ATL,NYM,3,4,-147,-1.5,145,8.5,-110,-110,137,1.5,-165,5.06,Suntrust Park,7,-1
2021-05-18,2021,TEX,NYY,4,7,133,1.5,-130,8.5,-110,-110,-143,-1.5,110,3.65,Globe Life Field,11,-3
2021-05-18,2021,HOU,OAK,5,6,-116,-1.5,150,8.0,-115,-105,106,1.5,-170,4.3,Oakland Coliseum,11,-1
2021-05-18,2021,MIA,PHI,3,8,162,1.5,-130,7.5,-120,100,-174,-1.5,110,2.86,Citizens Bank Park,11,-5
2021-05-18,2021,STL,PIT,5,2,-120,-1.5,165,7.5,100,-120,110,1.5,-185,4.09,Busch Stadium,7,3
2021-05-18,2021,COL,SD,1,2,190,1.5,-115,7.0,-115,-105,-210,-1.5,-105,2.41,PETCO Park,3,-1
2021-05-18,2021,DET,SEA,5,0,103,1.5,-185,8.0,-105,-115,-113,-1.5,165,3.94,T-Mobile Park,5,5
2021-05-18,2021,CIN,SF,2,4,-117,-1.5,165,8.0,-110,-110,107,1.5,-185,4.31,Great American Ballpark,6,-2
2021-05-18,2021,PIT,STL,2,5,110,1.5,-185,7.5,100,-120,-120,-1.5,165,3.57,Busch Stadium,7,-3
2021-05-18,2021,BAL,TB,6,13,140,1.5,-120,9.0,-115,-105,-150,-1.5,100,3.75,Camden Yards,19,-7
2021-05-18,2021,NYY,TEX,7,4,-143,-1.5,110,8.5,-110,-110,133,1.5,-130,5.0,Globe Life Field,11,3
2021-05-18,2021,BOS,TOR,0,8,112,1.5,-165,9.0,-120,100,-122,-1.5,145,4.25,TD Ballpark,8,-8
2021-05-18,2021,CHC,WSH,6,3,-105,1.5,-160,9.0,100,-120,-105,-1.5,140,4.61,Wrigley Field,9,3
2021-05-19,2021,LAD,ARI,4,2,-310,-1.5,-145,7.5,-105,-115,270,1.5,125,5.67,Dodger Stadium,6,2
2021-05-19,2021,NYM,ATL,4,5,177,1.5,-125,7.5,-115,-105,-194,-1.5,105,2.71,Suntrust Park,9,-1
2021-05-19,2021,TB,BAL,9,7,-106,-1.5,155,8.0,-115,-105,-104,1.5,-175,4.12,Camden Yards,16,2
2021-05-19,2021,TOR,BOS,3,7,-113,-1.5,160,9.5,-115,-105,103,1.5,-180,5.04,TD Ballpark,10,-4
2021-05-19,2021,WSH,CHC,4,3,-156,-1.5,-105,9.0,100,-120,146,1.5,-115,5.48,Wrigley Field,7,1
2021-05-19,2021,SF,CIN,4,0,-118,-1.5,140,8.5,-115,-105,108,1.5,-160,4.6,Great American Ballpark,4,4
2021-05-19,2021,LAA,CLE,2,3,-116,-1.5,170,8.0,-110,-110,106,1.5,-190,4.3,Angel Stadium,5,-1
2021-05-19,2021,SD,COL,3,0,-300,-1.5,-135,8.0,-105,-115,260,1.5,115,6.0,PETCO Park,3,3
2021-05-19,2021,MIN,CWS,1,2,115,1.5,-145,9.0,-110,-110,-125,-1.5,125,4.19,Target Field,3,-1
2021-05-19,2021,SEA,DET,2,6,-148,-1.5,140,8.0,100,-120,138,1.5,-160,4.77,T-Mobile Park,8,-4
2021-05-19,2021,OAK,HOU,1,8,111,1.5,-155,8.5,-105,-115,-121,-1.5,135,4.03,Oakland Coliseum,9,-7
2021-05-19,2021,MIL,KC,4,6,-196,-1.5,-125,7.5,-120,100,178,1.5,105,4.97,Kauffman Stadium,10,-2
2021-05-19,2021,CLE,LAA,3,2,106,1.5,-190,8.0,-110,-110,-116,-1.5,170,3.88,Angel Stadium,5,1
2021-05-19,2021,ARI,LAD,2,4,270,1.5,125,7.5,-105,-115,-310,-1.5,-145,2.03,Dodger Stadium,6,-2
2021-05-19,2021,PHI,MIA,1,3,-119,-1.5,170,7.5,-110,-110,109,1.5,-190,4.08,Citizens Bank Park,4,-2
2021-05-19,2021,KC,MIL,6,4,178,1.5,105,7.5,-120,100,-196,-1.5,-125,2.7,Kauffman Stadium,10,2
2021-05-19,2021,CWS,MIN,2,1,-125,-1.5,125,9.0,-110,-110,115,1.5,-145,5.0,Target Field,3,1
2021-05-19,2021,ATL,NYM,5,4,-194,-1.5,105,7.5,-115,-105,177,1.5,-125,4.95,Suntrust Park,9,1
2021-05-19,2021,TEX,NYY,0,2,158,1.5,-105,9.0,105,-125,-168,-1.5,-115,3.49,Globe Life Field,2,-2
2021-05-19,2021,HOU,OAK,8,1,-121,-1.5,135,8.5,-105,-115,111,1.5,-155,4.65,Oakland Coliseum,9,7
2021-05-19,2021,MIA,PHI,3,1,109,1.5,-190,7.5,-110,-110,-119,-1.5,170,3.59,Citizens Bank Park,4,2
2021-05-19,2021,STL,PIT,8,5,-220,-1.5,-105,7.0,-110,-110,200,1.5,-115,4.81,Busch Stadium,13,3
2021-05-19,2021,COL,SD,0,3,260,1.5,115,8.0,-105,-115,-300,-1.5,-135,2.22,PETCO Park,3,-3
2021-05-19,2021,DET,SEA,6,2,138,1.5,-160,8.0,100,-120,-148,-1.5,140,3.36,T-Mobile Park,8,4
2021-05-19,2021,CIN,SF,0,4,108,1.5,-160,8.5,-115,-105,-118,-1.5,140,4.09,Great American Ballpark,4,-4
2021-05-19,2021,PIT,STL,5,8,200,1.5,-115,7.0,-110,-110,-220,-1.5,-105,2.33,Busch Stadium,13,-3
2021-05-19,2021,BAL,TB,7,9,-104,1.5,-175,8.0,-115,-105,-106,-1.5,155,4.08,Camden Yards,16,-2
2021-05-19,2021,NYY,TEX,2,0,-168,-1.5,-115,9.0,105,-125,158,1.5,-105,5.64,Globe Life Field,2,2
2021-05-19,2021,BOS,TOR,7,3,103,1.5,-180,9.5,-115,-105,-113,-1.5,160,4.68,TD Ballpark,10,4
2021-05-19,2021,CHC,WSH,3,4,146,1.5,-115,9.0,100,-120,-156,-1.5,-105,3.66,Wrigley Field,7,-1
2021-05-20,2021,LAD,ARI,3,2,-200,-1.5,-105,8.5,-110,-110,180,1.5,-115,5.67,Dodger Stadium,5,1
2021-05-20,2021,PIT,ATL,6,4,189,1.5,-110,9.0,-105,-115,-209,-1.5,-110,3.11,Suntrust Park,10,2
2021-05-20,2021,TB,BAL,10,1,-150,-1.5,105,9.0,-120,100,140,1.5,-125,5.4,Camden Yards,11,9
2021-05-20,2021,TOR,BOS,7,8,-119,-1.5,150,10.0,-110,-110,109,1.5,-170,5.43,TD Ballpark,15,-1
2021-05-20,2021,WSH,CHC,2,5,-102,1.5,-180,10.5,-110,-110,-108,-1.5,160,5.3,Wrigley Field,7,-3
2021-05-20,2021,SF,CIN,19,4,135,1.5,-155,8.5,-115,-105,-145,-1.5,135,3.62,Great American Ballpark,23,15
2021-05-20,2021,OAK,HOU,4,8,107,1.5,-165,8.5,-120,100,-117,-1.5,145,4.11,Oakland Coliseum,12,-4
2021-05-20,2021,MIN,LAA,1,7,100,-1.5,170,7.0,100,-120,-110,1.5,-190,3.5,Angel Stadium,8,-6
2021-05-20,2021,MIN,LAA,6,3,-119,-1.5,150,6.0,-120,100,109,1.5,-170,3.26,Angel Stadium,9,3
2021-05-20,2021,ARI,LAD,2,3,180,1.5,-115,8.5,-110,-110,-200,-1.5,-105,3.04,Dodger Stadium,5,-1
2021-05-20,2021,PHI,MIA,0,6,-103,1.5,-160,8.5,100,-120,-107,-1.5,140,4.31,Citizens Bank Park,6,-6
2021-05-20,2021,LAA,MIN,7,1,-110,1.5,-190,7.0,100,-120,100,-1.5,170,3.67,Angel Stadium,8,6
2021-05-20,2021,LAA,MIN,3,6,109,1.5,-170,6.0,-120,100,-119,-1.5,150,2.87,Angel Stadium,9,-3
2021-05-20,2021,TEX,NYY,0,2,105,1.5,-160,7.5,-110,-110,-115,-1.5,140,3.66,Globe Life Field,2,-2
2021-05-20,2021,HOU,OAK,8,4,-117,-1.5,145,8.5,-120,100,107,1.5,-165,4.58,Oakland Coliseum,12,4
2021-05-20,2021,MIA,PHI,6,0,-107,-1.5,140,8.5,100,-120,-103,1.5,-160,4.39,Citizens Bank Park,6,6
2021-05-20,2021,ATL,PIT,4,6,-209,-1.5,-110,9.0,-105,-115,189,1.5,-110,6.09,Suntrust Park,10,-2
2021-05-20,2021,CIN,SF,4,19,-145,-1.5,135,8.5,-115,-105,135,1.5,-155,5.03,Great American Ballpark,23,-15
2021-05-20,2021,BAL,TB,1,10,140,1.5,-125,9.0,-120,100,-150,-1.5,105,3.75,Camden Yards,11,-9
2021-05-20,2021,NYY,TEX,2,0,-115,-1.5,140,7.5,-110,-110,105,1.5,-160,4.01,Globe Life Field,2,2
2021-05-20,2021,BOS,TOR,8,7,109,1.5,-170,10.0,-110,-110,-119,-1.5,150,4.78,TD Ballpark,15,1
2021-05-20,2021,CHC,WSH,5,2,-108,-1.5,160,10.5,-110,-110,-102,1.5,-180,5.45,Wrigley Field,7,3
2021-05-21,2021,COL,ARI,7,1,-149,-1.5,120,11.5,-105,-115,139,1.5,-140,6.88,Coors Field,8,6
2021-05-21,2021,PIT,ATL,1,20,175,1.5,-125,8.0,-115,-105,-190,-1.5,105,2.91,Suntrust Park,21,-19
2021-05-21,2021,WSH,BAL,4,2,-192,-1.5,105,8.5,-120,100,176,1.5,-125,5.59,Nationals Park,6,2
2021-05-21,2021,PHI,BOS,3,11,-146,-1.5,140,8.5,-115,-105,136,1.5,-160,5.04,Citizens Bank Park,14,-8
2021-05-21,2021,STL,CHC,3,12,114,1.5,-150,8.5,-120,100,-124,-1.5,130,3.97,Busch Stadium,15,-9
2021-05-21,2021,MIL,CIN,4,9,-129,-1.5,125,9.5,-105,-115,119,1.5,-145,5.35,Great American Ballpark,13,-5
2021-05-21,2021,MIN,CLE,10,0,119,1.5,-170,9.0,-115,-105,-129,-1.5,150,4.11,Progressive Field,10,10
2021-05-21,2021,ARI,COL,1,7,139,1.5,-140,11.5,-105,-115,-149,-1.5,120,4.81,Coors Field,8,-6
2021-05-21,2021,NYY,CWS,2,1,-110,1.5,-180,8.0,-120,100,100,-1.5,160,4.19,Yankee Stadium,3,1
2021-05-21,2021,KC,DET,5,7,-164,-1.5,120,8.5,-115,-105,154,1.5,-140,5.28,Kauffman Stadium,12,-2
2021-05-21,2021,TEX,HOU,7,5,114,1.5,-145,9.0,-105,-115,-124,-1.5,125,4.21,Globe Life Field,12,2
2021-05-21,2021,DET,KC,7,5,154,1.5,-140,8.5,-115,-105,-164,-1.5,120,3.35,Kauffman Stadium,12,2
2021-05-21,2021,OAK,LAA,8,4,100,1.5,-200,9.0,-105,-115,-110,-1.5,175,4.5,Angel Stadium,12,4
2021-05-21,2021,SF,LAD,1,2,111,1.5,-155,7.0,-105,-115,-121,-1.5,135,3.32,AT&T Park,3,-1
2021-05-21,2021,NYM,MIA,6,5,-105,1.5,-220,7.0,-105,-115,-105,-1.5,195,3.59,Marlins Park,11,1
2021-05-21,2021,CIN,MIL,9,4,119,1.5,-145,9.5,-105,-115,-129,-1.5,125,4.34,Great American Ballpark,13,5
2021-05-21,2021,CLE,MIN,0,10,-129,-1.5,150,9.0,-115,-105,119,1.5,-170,5.07,Progressive Field,10,-10
2021-05-21,2021,MIA,NYM,5,6,-105,-1.5,195,7.0,-105,-115,-105,1.5,-220,3.59,Marlins Park,11,-1
2021-05-21,2021,CWS,NYY,1,2,100,-1.5,160,8.0,-120,100,-110,1.5,-180,4.0,Yankee Stadium,3,-1
2021-05-21,2021,LAA,OAK,4,8,-110,-1.5,175,9.0,-105,-115,100,1.5,-200,4.71,Angel Stadium,12,-4
2021-05-21,2021,BOS,PHI,11,3,136,1.5,-160,8.5,-115,-105,-146,-1.5,140,3.6,Citizens Bank Park,14,8
2021-05-21,2021,ATL,PIT,20,1,-190,-1.5,105,8.0,-115,-105,175,1.5,-125,5.24,Suntrust Park,21,19
2021-05-21,2021,SEA,SD,1,16,195,1.5,-110,7.5,-115,-105,-215,-1.5,-110,2.54,PETCO Park,17,-15
2021-05-21,2021,SD,SEA,16,1,-215,-1.5,-110,7.5,-115,-105,195,1.5,-110,5.12,PETCO Park,17,15
2021-05-21,2021,LAD,SF,2,1,-121,-1.5,135,7.0,-105,-115,111,1.5,-155,3.83,AT&T Park,3,1
2021-05-21,2021,CHC,STL,12,3,-124,-1.5,130,8.5,-120,100,114,1.5,-150,4.71,Busch Stadium,15,9
2021-05-21,2021,TOR,TB,7,9,144,1.5,-115,9.0,100,-120,-154,-1.5,-105,3.69,TD Ballpark,16,-2
2021-05-21,2021,HOU,TEX,5,7,-124,-1.5,125,9.0,-105,-115,114,1.5,-145,4.98,Globe Life Field,12,-2
2021-05-21,2021,TB,TOR,9,7,-154,-1.5,-105,9.0,100,-120,144,1.5,-115,5.46,TD Ballpark,16,2
2021-05-21,2021,BAL,WSH,2,4,176,1.5,-125,8.5,-120,100,-192,-1.5,105,3.08,Nationals Park,6,-2
2021-05-22,2021,COL,ARI,7,6,102,1.5,-150,11.0,100,-120,-112,-1.5,130,5.45,Coors Field,13,1
2021-05-22,2021,PIT,ATL,1,6,180,1.5,-110,9.5,-105,-115,-200,-1.5,-110,3.39,Suntrust Park,7,-5
2021-05-22,2021,WSH,BAL,12,9,-147,-1.5,120,9.0,-120,100,137,1.5,-140,5.36,Nationals Park,21,3
2021-05-22,2021,PHI,BOS,3,4,120,1.5,-140,9.0,-105,-115,-130,-1.5,120,4.09,Citizens Bank Park,7,-1
2021-05-22,2021,STL,CHC,2,1,111,1.5,-150,8.5,100,-120,-121,-1.5,130,4.03,Busch Stadium,3,1
2021-05-22,2021,MIL,CIN,4,3,144,1.5,-150,9.0,100,-120,-154,-1.5,130,3.69,Great American Ballpark,7,1
2021-05-22,2021,MIN,CLE,3,5,152,1.5,-145,7.5,-115,-105,-162,-1.5,125,2.98,Progressive Field,8,-2
2021-05-22,2021,ARI,COL,6,7,-112,-1.5,130,11.0,100,-120,102,1.5,-150,5.81,Coors Field,13,-1
2021-05-22,2021,NYY,CWS,7,0,-200,-1.5,100,8.0,100,-120,180,1.5,-120,5.33,Yankee Stadium,7,7
2021-05-22,2021,KC,DET,7,5,-145,-1.5,130,8.5,-115,-105,135,1.5,-150,5.03,Kauffman Stadium,12,2
2021-05-22,2021,TEX,HOU,8,4,160,1.5,-110,9.0,-110,-110,-170,-1.5,-110,3.46,Globe Life Field,12,4
2021-05-22,2021,DET,KC,5,7,135,1.5,-150,8.5,-115,-105,-145,-1.5,130,3.62,Kauffman Stadium,12,-2
2021-05-22,2021,OAK,LAA,6,2,-134,-1.5,110,9.0,100,-120,124,1.5,-130,5.15,Angel Stadium,8,4
2021-05-22,2021,SF,LAD,3,6,141,1.5,-125,7.5,-120,100,-151,-1.5,105,3.11,AT&T Park,9,-3
2021-05-22,2021,NYM,MIA,1,3,141,1.5,-150,7.0,105,-125,-151,-1.5,130,2.9,Marlins Park,4,-2
2021-05-22,2021,CIN,MIL,3,4,-154,-1.5,130,9.0,100,-120,144,1.5,-150,5.46,Great American Ballpark,7,-1
2021-05-22,2021,CLE,MIN,5,3,-162,-1.5,125,7.5,-115,-105,152,1.5,-145,4.64,Progressive Field,8,2
2021-05-22,2021,MIA,NYM,3,1,-151,-1.5,130,7.0,105,-125,141,1.5,-150,4.21,Marlins Park,4,2
2021-05-22,2021,CWS,NYY,0,7,180,1.5,-120,8.0,100,-120,-200,-1.5,100,2.86,Yankee Stadium,7,-7
2021-05-22,2021,LAA,OAK,2,6,124,1.5,-130,9.0,100,-120,-134,-1.5,110,4.02,Angel Stadium,8,-4
2021-05-22,2021,BOS,PHI,4,3,-130,-1.5,120,9.0,-105,-115,120,1.5,-140,5.09,Citizens Bank Park,7,1
2021-05-22,2021,ATL,PIT,6,1,-200,-1.5,-110,9.5,-105,-115,180,1.5,-110,6.33,Suntrust Park,7,5
2021-05-22,2021,SEA,SD,4,6,177,1.5,-125,7.5,-120,100,-194,-1.5,105,2.71,PETCO Park,10,-2
2021-05-22,2021,SD,SEA,6,4,-194,-1.5,105,7.5,-120,100,177,1.5,-125,4.95,PETCO Park,10,2
2021-05-22,2021,LAD,SF,6,3,-151,-1.5,105,7.5,-120,100,141,1.5,-125,4.51,AT&T Park,9,3
2021-05-22,2021,CHC,STL,1,2,-121,-1.5,130,8.5,100,-120,111,1.5,-150,4.65,Busch Stadium,3,-1
2021-05-22,2021,TOR,TB,1,3,-115,-1.5,160,9.5,-105,-115,105,1.5,-180,5.08,TD Ballpark,4,-2
2021-05-22,2021,HOU,TEX,4,8,-170,-1.5,-110,9.0,-110,-110,160,1.5,-110,5.67,Globe Life Field,12,-4
2021-05-22,2021,TB,TOR,3,1,105,1.5,-180,9.5,-105,-115,-115,-1.5,160,4.63,TD Ballpark,4,2
2021-05-22,2021,BAL,WSH,9,12,137,1.5,-140,9.0,-120,100,-147,-1.5,120,3.8,Nationals Park,21,-3
2021-05-23,2021,COL,ARI,4,3,-130,-1.5,130,12.0,-105,-115,120,1.5,-150,6.78,Coors Field,7,1
2021-05-23,2021,PIT,ATL,1,7,190,1.5,-115,8.0,-115,-105,-210,-1.5,-105,2.76,Suntrust Park,8,-6
2021-05-23,2021,WSH,BAL,6,5,-180,-1.5,105,9.5,100,-120,165,1.5,-125,6.11,Nationals Park,11,1
2021-05-23,2021,PHI,BOS,6,2,-125,-1.5,175,7.5,100,-120,115,1.5,-200,4.17,Citizens Bank Park,8,4
2021-05-23,2021,STL,CHC,1,2,-129,-1.5,155,9.0,-105,-115,119,1.5,-175,5.07,Busch Stadium,3,-1
2021-05-23,2021,MIL,CIN,9,4,-115,-1.5,145,8.0,-120,100,105,1.5,-165,4.28,Great American Ballpark,13,5
2021-05-23,2021,MIN,CLE,8,5,127,1.5,-160,9.0,100,-120,-137,-1.5,140,3.96,Progressive Field,13,3
2021-05-23,2021,ARI,COL,3,4,120,1.5,-150,12.0,-105,-115,-130,-1.5,130,5.45,Coors Field,7,-1
2021-05-23,2021,NYY,CWS,5,4,-149,-1.5,130,9.5,-105,-115,139,1.5,-150,5.68,Yankee Stadium,9,1
2021-05-23,2021,KC,DET,3,2,-142,-1.5,130,9.0,-110,-110,132,1.5,-150,5.28,Kauffman Stadium,5,1
2021-05-23,2021,TEX,HOU,3,2,132,1.5,-135,9.0,-110,-110,-142,-1.5,115,3.88,Globe Life Field,5,1
2021-05-23,2021,DET,KC,2,3,132,1.5,-150,9.0,-110,-110,-142,-1.5,130,3.88,Kauffman Stadium,5,-1
2021-05-23,2021,OAK,LAA,5,6,-120,-1.5,130,8.5,-110,-110,110,1.5,-150,4.64,Angel Stadium,11,-1
2021-05-23,2021,SF,LAD,5,11,120,1.5,-150,7.5,105,-125,-130,-1.5,130,3.41,AT&T Park,16,-6
2021-05-23,2021,NYM,MIA,1,5,136,1.5,-165,7.0,-115,-105,-146,-1.5,145,2.97,Marlins Park,6,-4
2021-05-23,2021,CIN,MIL,4,9,105,1.5,-165,8.0,-120,100,-115,-1.5,145,3.9,Great American Ballpark,13,-5
2021-05-23,2021,CLE,MIN,5,8,-137,-1.5,140,9.0,100,-120,127,1.5,-160,5.2,Progressive Field,13,-3
2021-05-23,2021,MIA,NYM,5,1,-146,-1.5,145,7.0,-115,-105,136,1.5,-165,4.15,Marlins Park,6,4
2021-05-23,2021,CWS,NYY,4,5,139,1.5,-150,9.5,-105,-115,-149,-1.5,130,3.97,Yankee Stadium,9,-1
2021-05-23,2021,LAA,OAK,6,5,110,1.5,-150,8.5,-110,-110,-120,-1.5,130,4.05,Angel Stadium,11,1
2021-05-23,2021,BOS,PHI,2,6,115,1.5,-200,7.5,100,-120,-125,-1.5,175,3.49,Citizens Bank Park,8,-4
2021-05-23,2021,ATL,PIT,7,1,-210,-1.5,-105,8.0,-115,-105,190,1.5,-115,5.42,Suntrust Park,8,6
2021-05-23,2021,SEA,SD,2,9,245,1.5,110,7.0,-115,-105,-280,-1.5,-130,2.03,PETCO Park,11,-7
2021-05-23,2021,SD,SEA,9,2,-280,-1.5,-130,7.0,-115,-105,245,1.5,110,5.16,PETCO Park,11,7
2021-05-23,2021,LAD,SF,11,5,-130,-1.5,130,7.5,105,-125,120,1.5,-150,4.24,AT&T Park,16,6
2021-05-23,2021,CHC,STL,2,1,119,1.5,-175,9.0,-105,-115,-129,-1.5,155,4.11,Busch Stadium,3,1
2021-05-23,2021,TOR,TB,4,6,-166,-1.5,115,9.0,-120,100,156,1.5,-135,5.62,TD Ballpark,10,-2
2021-05-23,2021,HOU,TEX,2,3,-142,-1.5,115,9.0,-110,-110,132,1.5,-135,5.28,Globe Life Field,5,-1
2021-05-23,2021,TB,TOR,6,4,156,1.5,-135,9.0,-120,100,-166,-1.5,115,3.52,TD Ballpark,10,2
2021-05-23,2021,BAL,WSH,5,6,165,1.5,-125,9.5,100,-120,-180,-1.5,105,3.58,Nationals Park,11,-1
2021-05-24,2021,MIN,BAL,8,3,-104,-1.5,180,9.0,-115,-105,-106,1.5,-205,4.59,Target Field,11,5
2021-05-24,2021,DET,CLE,5,6,-126,-1.5,155,9.0,100,-120,116,1.5,-175,5.02,Comerica Park,11,-1
2021-05-24,2021,NYM,COL,2,3,-137,-1.5,155,6.5,-120,100,127,1.5,-175,3.76,Citi Field,5,-1
2021-05-24,2021,STL,CWS,1,5,165,1.5,-130,8.5,-115,-105,-180,-1.5,110,3.21,Guaranteed Rate Field,6,-4
2021-05-24,2021,CLE,DET,6,5,116,1.5,-175,9.0,100,-120,-126,-1.5,155,4.17,Comerica Park,11,1
2021-05-24,2021,PHI,MIA,6,9,125,1.5,-185,7.0,105,-125,-135,-1.5,165,3.11,Marlins Park,15,-3
2021-05-24,2021,SD,MIL,3,5,105,1.5,-215,7.0,-110,-110,-115,-1.5,190,3.41,Miller Park,8,-2
2021-05-24,2021,BAL,MIN,3,8,-106,1.5,-205,9.0,-115,-105,-104,-1.5,180,4.63,Target Field,11,-5
2021-05-24,2021,COL,NYM,3,2,127,1.5,-175,6.5,-120,100,-137,-1.5,155,2.86,Citi Field,5,1
2021-05-24,2021,SEA,OAK,4,2,158,1.5,-135,7.5,-120,100,-168,-1.5,115,2.91,Oakland Coliseum,6,2
2021-05-24,2021,MIA,PHI,9,6,-135,-1.5,165,7.0,105,-125,125,1.5,-185,4.02,Marlins Park,15,3
2021-05-24,2021,MIL,SD,5,3,-115,-1.5,190,7.0,-110,-110,105,1.5,-215,3.74,Miller Park,8,2
2021-05-24,2021,OAK,SEA,2,4,-168,-1.5,115,7.5,-120,100,158,1.5,-135,4.7,Oakland Coliseum,6,-2
2021-05-24,2021,CWS,STL,5,1,-180,-1.5,110,8.5,-115,-105,165,1.5,-130,5.46,Guaranteed Rate Field,6,4
2021-05-24,2021,TOR,TB,8,14,-102,1.5,-150,10.5,-115,-105,-108,-1.5,130,5.3,TD Ballpark,22,-6
2021-05-24,2021,TB,TOR,14,8,-108,-1.5,130,10.5,-115,-105,-102,1.5,-150,5.45,TD Ballpark,22,6
2021-05-25,2021,SF,ARI,8,0,-157,-1.5,100,9.0,100,-120,147,1.5,-120,5.5,Chase Field,8,8
2021-05-25,2021,BOS,ATL,1,3,-102,1.5,-160,10.0,-110,-110,-108,-1.5,140,5.05,Fenway Park,4,-2
2021-05-25,2021,MIN,BAL,7,4,-186,-1.5,-110,9.5,-120,100,171,1.5,-110,6.18,Target Field,11,3
2021-05-25,2021,ATL,BOS,3,1,-108,-1.5,140,10.0,-110,-110,-102,1.5,-160,5.19,Fenway Park,4,2
2021-05-25,2021,PIT,CHC,3,4,124,1.5,-140,9.0,100,-120,-134,-1.5,120,4.02,PNC Park,7,-1
2021-05-25,2021,WSH,CIN,1,2,-205,-1.5,-105,7.5,-115,-105,185,1.5,-115,5.04,Nationals Park,3,-1
2021-05-25,2021,DET,CLE,1,4,132,1.5,-125,9.0,-105,-115,-142,-1.5,105,3.88,Comerica Park,5,-3
2021-05-25,2021,NYM,COL,3,1,-240,-1.5,100,6.0,-115,-105,210,1.5,-120,4.24,Citi Field,4,2
2021-05-25,2021,STL,CWS,3,8,118,1.5,-180,8.0,-105,-115,-128,-1.5,160,3.67,Guaranteed Rate Field,11,-5
2021-05-25,2021,CLE,DET,4,1,-142,-1.5,105,9.0,-105,-115,132,1.5,-125,5.28,Comerica Park,5,3
2021-05-25,2021,LAD,HOU,9,2,-114,-1.5,140,8.5,100,-120,104,1.5,-160,4.53,Minute Maid Park,11,7
2021-05-25,2021,TB,KC,1,2,-185,-1.5,-105,8.5,-105,-115,170,1.5,-115,5.52,Tropicana Field,3,-1
2021-05-25,2021,TEX,LAA,5,11,160,1.5,-130,8.5,-120,100,-170,-1.5,110,3.27,Angel Stadium,16,-6
2021-05-25,2021,HOU,LAD,2,9,104,1.5,-160,8.5,100,-120,-114,-1.5,140,4.17,Minute Maid Park,11,-7
2021-05-25,2021,PHI,MIA,2,0,133,1.5,-175,7.0,-110,-110,-143,-1.5,155,3.0,Marlins Park,2,2
2021-05-25,2021,SD,MIL,7,1,115,1.5,-200,7.0,100,-120,-125,-1.5,175,3.26,Miller Park,8,6
2021-05-25,2021,BAL,MIN,4,7,171,1.5,-110,9.5,-120,100,-186,-1.5,-110,3.51,Target Field,11,-3
2021-05-25,2021,COL,NYM,1,3,210,1.5,-120,6.0,-115,-105,-240,-1.5,100,1.94,Citi Field,4,-2
2021-05-25,2021,TOR,NYY,6,2,153,1.5,-130,9.0,-110,-110,-163,-1.5,110,3.56,Yankee Stadium,8,4
2021-05-25,2021,SEA,OAK,4,3,156,1.5,-130,8.5,-110,-110,-166,-1.5,110,3.32,Oakland Coliseum,7,1
2021-05-25,2021,MIA,PHI,0,2,-143,-1.5,155,7.0,-110,-110,133,1.5,-175,4.12,Marlins Park,2,-2
2021-05-25,2021,CHC,PIT,4,3,-134,-1.5,120,9.0,100,-120,124,1.5,-140,5.15,PNC Park,7,1
2021-05-25,2021,MIL,SD,1,7,-125,-1.5,175,7.0,100,-120,115,1.5,-200,3.89,Miller Park,8,-6
2021-05-25,2021,OAK,SEA,3,4,-166,-1.5,110,8.5,-110,-110,156,1.5,-130,5.3,Oakland Coliseum,7,-1
2021-05-25,2021,ARI,SF,0,8,147,1.5,-120,9.0,100,-120,-157,-1.5,100,3.64,Chase Field,8,-8
2021-05-25,2021,CWS,STL,8,3,-128,-1.5,160,8.0,-105,-115,118,1.5,-180,4.49,Guaranteed Rate Field,11,5
2021-05-25,2021,KC,TB,2,1,170,1.5,-115,8.5,-105,-115,-185,-1.5,-105,3.15,Tropicana Field,3,1
2021-05-25,2021,LAA,TEX,11,5,-170,-1.5,110,8.5,-120,100,160,1.5,-130,5.35,Angel Stadium,16,6
2021-05-25,2021,NYY,TOR,2,6,-163,-1.5,110,9.0,-110,-110,153,1.5,-130,5.58,Yankee Stadium,8,-4
2021-05-25,2021,CIN,WSH,2,1,185,1.5,-115,7.5,-115,-105,-205,-1.5,-105,2.63,Nationals Park,3,1
2021-05-26,2021,SF,ARI,5,4,-114,-1.5,135,9.0,-115,-105,104,1.5,-155,4.79,Chase Field,9,1
2021-05-26,2021,BOS,ATL,9,5,-137,-1.5,130,11.0,-110,-110,127,1.5,-150,6.36,Fenway Park,14,4
2021-05-26,2021,MIN,BAL,3,2,-190,-1.5,-105,8.5,-120,100,175,1.5,-115,5.57,Target Field,5,1
2021-05-26,2021,ATL,BOS,5,9,127,1.5,-150,11.0,-110,-110,-137,-1.5,130,4.85,Fenway Park,14,-4
2021-05-26,2021,PIT,CHC,1,4,114,1.5,-145,8.5,-105,-115,-124,-1.5,125,3.97,PNC Park,5,-3
2021-05-26,2021,WSH,CIN,5,3,-125,-1.5,135,9.5,-110,-110,120,1.5,-165,5.28,Nationals Park,8,2
2021-05-26,2021,DET,CLE,1,0,113,1.5,-140,9.5,100,-120,-123,-1.5,120,4.46,Comerica Park,1,1
2021-05-26,2021,STL,CWS,4,0,195,1.5,-115,8.5,-125,105,-215,-1.5,-105,2.88,Guaranteed Rate Field,4,4
2021-05-26,2021,CLE,DET,0,1,-123,-1.5,120,9.5,100,-120,113,1.5,-140,5.24,Comerica Park,1,-1
2021-05-26,2021,LAD,HOU,2,5,-156,-1.5,110,8.5,-105,-115,146,1.5,-130,5.18,Minute Maid Park,7,-3
2021-05-26,2021,TB,KC,2,1,-200,-1.5,105,7.0,100,-120,180,1.5,-125,4.67,Tropicana Field,3,1
2021-05-26,2021,TEX,LAA,8,9,-112,1.5,-210,9.0,100,-120,102,-1.5,185,4.75,Angel Stadium,17,-1
2021-05-26,2021,HOU,LAD,5,2,146,1.5,-130,8.5,-105,-115,-156,-1.5,110,3.46,Minute Maid Park,7,3
2021-05-26,2021,PHI,MIA,2,4,-158,-1.5,100,7.0,-110,-110,148,1.5,-120,4.29,Marlins Park,6,-2
2021-05-26,2021,SD,MIL,2,1,-117,-1.5,135,8.0,-115,-105,107,1.5,-155,4.31,Miller Park,3,1
2021-05-26,2021,BAL,MIN,2,3,175,1.5,-115,8.5,-120,100,-190,-1.5,-105,3.09,Target Field,5,-1
2021-05-26,2021,SEA,OAK,3,6,162,1.5,-130,8.5,-120,100,-174,-1.5,110,3.24,Oakland Coliseum,9,-3
2021-05-26,2021,MIA,PHI,4,2,148,1.5,-120,7.0,-110,-110,-158,-1.5,100,2.82,Marlins Park,6,2
2021-05-26,2021,CHC,PIT,4,1,-124,-1.5,125,8.5,-105,-115,114,1.5,-145,4.71,PNC Park,5,3
2021-05-26,2021,MIL,SD,1,2,107,1.5,-155,8.0,-115,-105,-117,-1.5,135,3.86,Miller Park,3,-1
2021-05-26,2021,OAK,SEA,6,3,-174,-1.5,110,8.5,-120,100,162,1.5,-130,5.4,Oakland Coliseum,9,3
2021-05-26,2021,ARI,SF,4,5,104,1.5,-155,9.0,-115,-105,-114,-1.5,135,4.41,Chase Field,9,-1
2021-05-26,2021,CWS,STL,0,4,-215,-1.5,-105,8.5,-125,105,195,1.5,-115,5.8,Guaranteed Rate Field,4,-4
2021-05-26,2021,KC,TB,1,2,180,1.5,-125,7.0,100,-120,-200,-1.5,105,2.5,Tropicana Field,3,-1
2021-05-26,2021,LAA,TEX,9,8,102,-1.5,185,9.0,100,-120,-112,1.5,-210,4.46,Angel Stadium,17,1
2021-05-26,2021,CIN,WSH,3,5,120,1.5,-165,9.5,-110,-110,-125,-1.5,135,4.32,Nationals Park,8,-2
2021-05-27,2021,STL,ARI,5,4,-115,-1.5,130,9.5,-115,-105,105,1.5,-150,5.08,Chase Field,9,1
2021-05-27,2021,CWS,BAL,5,1,-210,-1.5,-110,8.5,-115,-105,190,1.5,-105,5.76,Guaranteed Rate Field,6,4
2021-05-27,2021,PIT,CHC,3,5,132,1.5,-135,7.5,-105,-115,-142,-1.5,115,3.23,PNC Park,8,-2
2021-05-27,2021,WSH,CIN,0,3,-126,-1.5,170,6.5,-110,-110,116,1.5,-190,3.62,Nationals Park,3,-3
2021-05-27,2021,DET,CLE,2,5,150,1.5,-130,7.0,100,-120,-160,-1.5,110,2.8,Comerica Park,7,-3
2021-05-27,2021,NYM,COL,1,0,-125,-1.5,195,5.0,-120,100,115,1.5,-220,2.78,Citi Field,1,1
2021-05-27,2021,NYM,COL,4,2,-138,-1.5,175,6.0,100,-120,128,1.5,-200,3.48,Citi Field,6,2
2021-05-27,2021,BAL,CWS,1,5,190,1.5,-105,8.5,-115,-105,-210,-1.5,-110,2.93,Guaranteed Rate Field,6,-4
2021-05-27,2021,CLE,DET,5,2,-160,-1.5,110,7.0,100,-120,150,1.5,-130,4.31,Comerica Park,7,3
2021-05-27,2021,TB,KC,7,2,-162,-1.5,115,7.5,-115,-105,152,1.5,-135,4.64,Tropicana Field,9,5
2021-05-27,2021,OAK,LAA,5,0,-198,-1.5,100,8.0,-115,-105,179,1.5,-120,5.32,Oakland Coliseum,5,5
2021-05-27,2021,SF,LAD,3,4,133,1.5,-165,7.5,-110,-110,-143,-1.5,145,3.22,Dodger Stadium,7,-1
2021-05-27,2021,PHI,MIA,3,2,130,1.5,-170,7.0,105,-125,-140,-1.5,150,3.04,Marlins Park,5,1
2021-05-27,2021,SD,MIL,5,6,-115,-1.5,140,8.0,-115,-105,105,1.5,-160,4.28,Miller Park,11,-1
2021-05-27,2021,COL,NYM,0,1,115,1.5,-220,5.0,-120,100,-125,-1.5,195,2.33,Citi Field,1,-1
2021-05-27,2021,COL,NYM,2,4,128,1.5,-200,6.0,100,-120,-138,-1.5,175,2.63,Citi Field,6,-2
2021-05-27,2021,TOR,NYY,2,0,110,1.5,-190,7.0,-110,-110,-120,-1.5,170,3.33,Yankee Stadium,2,2
2021-05-27,2021,TOR,NYY,3,5,114,1.5,-200,7.0,-105,-115,-124,-1.5,175,3.27,Yankee Stadium,8,-2
2021-05-27,2021,LAA,OAK,0,5,179,1.5,-120,8.0,-115,-105,-198,-1.5,100,2.87,Oakland Coliseum,5,-5
2021-05-27,2021,MIA,PHI,2,3,-140,-1.5,150,7.0,105,-125,130,1.5,-170,4.08,Marlins Park,5,-1
2021-05-27,2021,CHC,PIT,5,3,-142,-1.5,115,7.5,-105,-115,132,1.5,-135,4.4,PNC Park,8,2
2021-05-27,2021,MIL,SD,6,5,105,1.5,-160,8.0,-115,-105,-115,-1.5,140,3.9,Miller Park,11,1
2021-05-27,2021,TEX,SEA,0,5,-105,1.5,-190,8.5,-120,100,-105,-1.5,170,4.35,T-Mobile Park,5,-5
2021-05-27,2021,LAD,SF,4,3,-143,-1.5,145,7.5,-110,-110,133,1.5,-165,4.41,Dodger Stadium,7,1
2021-05-27,2021,ARI,STL,4,5,105,1.5,-150,9.5,-115,-105,-115,-1.5,130,4.63,Chase Field,9,-1
2021-05-27,2021,KC,TB,2,7,152,1.5,-135,7.5,-115,-105,-162,-1.5,115,2.98,Tropicana Field,9,-5
2021-05-27,2021,SEA,TEX,5,0,-105,-1.5,170,8.5,-120,100,-105,1.5,-190,4.35,T-Mobile Park,5,5
2021-05-27,2021,NYY,TOR,0,2,-120,-1.5,170,7.0,-110,-110,110,1.5,-190,3.82,Yankee Stadium,2,-2
2021-05-27,2021,NYY,TOR,5,3,-124,-1.5,175,7.0,-105,-115,114,1.5,-200,3.88,Yankee Stadium,8,2
2021-05-27,2021,CIN,WSH,3,0,116,1.5,-190,6.5,-110,-110,-126,-1.5,170,3.01,Nationals Park,3,3
2021-05-28,2021,STL,ARI,8,6,117,1.5,-175,9.5,-105,-115,-127,-1.5,155,4.38,Chase Field,14,2
2021-05-28,2021,MIA,BOS,2,5,148,1.5,-140,8.5,-120,100,-158,-1.5,120,3.43,Fenway Park,7,-3
2021-05-28,2021,CIN,CHC,0,1,165,1.5,-145,6.5,-105,-115,-180,-1.5,125,2.45,Wrigley Field,1,-1
2021-05-28,2021,CHC,CIN,1,0,-180,-1.5,125,6.5,-105,-115,165,1.5,-145,4.18,Wrigley Field,1,1
2021-05-28,2021,TOR,CLE,11,2,-164,-1.5,-110,7.5,-120,100,154,1.5,-110,4.66,Progressive Field,13,9
2021-05-28,2021,NYY,DET,2,3,-280,-1.5,-165,7.0,100,-120,245,1.5,145,5.16,Comerica Park,5,-1
2021-05-28,2021,SD,HOU,10,3,106,1.5,-205,8.0,-115,-105,-116,-1.5,180,3.88,Minute Maid Park,13,7
2021-05-28,2021,MIN,KC,3,8,-158,-1.5,125,9.0,-105,-115,148,1.5,-145,5.51,Target Field,11,-5
2021-05-28,2021,OAK,LAA,3,1,-145,-1.5,140,7.5,-105,-115,135,1.5,-160,4.44,Oakland Coliseum,4,2
2021-05-28,2021,SF,LAD,8,5,189,1.5,-115,7.5,-115,-105,-209,-1.5,-105,2.6,Dodger Stadium,13,3
2021-05-28,2021,BOS,MIA,5,2,-158,-1.5,120,8.5,-120,100,148,1.5,-140,5.21,Fenway Park,7,3
2021-05-28,2021,KC,MIN,8,3,148,1.5,-145,9.0,-105,-115,-158,-1.5,125,3.63,Target Field,11,5
2021-05-28,2021,DET,NYY,3,2,245,1.5,145,7.0,100,-120,-280,-1.5,-165,2.03,Comerica Park,5,1
2021-05-28,2021,LAA,OAK,1,3,135,1.5,-160,7.5,-105,-115,-145,-1.5,140,3.19,Oakland Coliseum,4,-2
2021-05-28,2021,HOU,SD,3,10,-116,-1.5,180,8.0,-115,-105,106,1.5,-205,4.3,Minute Maid Park,13,-7
2021-05-28,2021,TEX,SEA,2,3,106,1.5,-180,8.5,100,-120,-116,-1.5,160,4.13,T-Mobile Park,5,-1
2021-05-28,2021,LAD,SF,5,8,-209,-1.5,-105,7.5,-115,-105,189,1.5,-115,5.07,Dodger Stadium,13,-3
2021-05-28,2021,ARI,STL,6,8,-127,-1.5,155,9.5,-105,-115,117,1.5,-175,5.31,Chase Field,14,-2
2021-05-28,2021,SEA,TEX,3,2,-116,-1.5,160,8.5,100,-120,106,1.5,-180,4.56,T-Mobile Park,5,1
2021-05-28,2021,CLE,TOR,2,11,154,1.5,-110,7.5,-120,100,-164,-1.5,-110,2.95,Progressive Field,13,-9
2021-05-29,2021,STL,ARI,7,4,-143,-1.5,100,10.0,-105,-115,133,1.5,-120,5.88,Chase Field,11,3
2021-05-29,2021,NYM,ATL,13,2,135,1.5,-145,6.5,-120,100,-145,-1.5,125,2.77,Citi Field,15,11
2021-05-29,2021,CWS,BAL,7,4,-210,-1.5,100,6.5,-130,110,190,1.5,-120,4.4,Guaranteed Rate Field,11,3
2021-05-29,2021,CWS,BAL,3,1,-174,-1.5,140,5.5,105,-125,162,1.5,-160,3.49,Guaranteed Rate Field,4,2
2021-05-29,2021,MIA,BOS,1,3,153,1.5,-140,7.5,100,-120,-163,-1.5,120,2.96,Fenway Park,4,-2
2021-05-29,2021,CIN,CHC,2,10,-101,1.5,-230,7.0,-105,-115,-109,-1.5,200,3.52,Wrigley Field,12,-8
2021-05-29,2021,CHC,CIN,10,2,-109,-1.5,200,7.0,-105,-115,-101,1.5,-230,3.65,Wrigley Field,12,8
2021-05-29,2021,PIT,COL,7,0,-134,-1.5,200,5.0,-120,100,124,1.5,-230,2.86,PNC Park,7,7
2021-05-29,2021,PIT,COL,4,0,100,1.5,-185,5.5,-105,-115,-110,-1.5,165,2.75,PNC Park,4,4
2021-05-29,2021,BAL,CWS,4,7,190,1.5,-120,6.5,-130,110,-210,-1.5,100,2.24,Guaranteed Rate Field,11,-3
2021-05-29,2021,BAL,CWS,1,3,162,1.5,-160,5.5,105,-125,-174,-1.5,140,2.1,Guaranteed Rate Field,4,-2
2021-05-29,2021,NYY,DET,1,6,-125,-1.5,120,8.5,-105,-115,115,1.5,-140,4.72,Comerica Park,7,-5
2021-05-29,2021,SD,HOU,11,8,-148,-1.5,-105,8.0,-120,100,138,1.5,-115,4.77,Minute Maid Park,19,3
2021-05-29,2021,MIN,KC,6,5,-153,-1.5,120,9.5,-105,-115,143,1.5,-140,5.75,Target Field,11,1
2021-05-29,2021,OAK,LAA,0,4,-130,-1.5,150,8.0,-110,-110,120,1.5,-170,4.52,Oakland Coliseum,4,-4
2021-05-29,2021,SF,LAD,11,6,171,1.5,-125,7.5,-115,-105,-186,-1.5,105,2.77,Dodger Stadium,17,5
2021-05-29,2021,BOS,MIA,3,1,-163,-1.5,120,7.5,100,-120,153,1.5,-140,4.65,Fenway Park,4,2
2021-05-29,2021,WSH,MIL,1,4,111,1.5,-190,5.5,100,-120,-121,-1.5,170,2.61,Nationals Park,5,-3
2021-05-29,2021,WSH,MIL,2,6,-120,-1.5,195,6.5,100,-120,110,1.5,-220,3.55,Nationals Park,8,-4
2021-05-29,2021,KC,MIN,5,6,143,1.5,-140,9.5,-105,-115,-153,-1.5,120,3.91,Target Field,11,-1
2021-05-29,2021,ATL,NYM,2,13,-145,-1.5,125,6.5,-120,100,135,1.5,-145,3.85,Citi Field,15,-11
2021-05-29,2021,DET,NYY,6,1,115,1.5,-140,8.5,-105,-115,-125,-1.5,120,3.95,Comerica Park,7,5
2021-05-29,2021,LAA,OAK,4,0,120,1.5,-170,8.0,-110,-110,-130,-1.5,150,3.64,Oakland Coliseum,4,4
2021-05-29,2021,TB,PHI,5,3,-116,-1.5,180,7.0,-115,-105,106,1.5,-205,3.76,Tropicana Field,8,2
2021-05-29,2021,COL,PIT,0,7,124,1.5,-230,5.0,-120,100,-134,-1.5,200,2.23,PNC Park,7,-7
2021-05-29,2021,COL,PIT,0,4,-110,-1.5,165,5.5,-105,-115,100,1.5,-185,2.88,PNC Park,4,-4
2021-05-29,2021,HOU,SD,8,11,138,1.5,-115,8.0,-120,100,-148,-1.5,-105,3.36,Minute Maid Park,19,-3
2021-05-29,2021,TEX,SEA,2,3,-106,-1.5,150,8.5,-120,100,-104,1.5,-170,4.37,T-Mobile Park,5,-1
2021-05-29,2021,LAD,SF,6,11,-186,-1.5,105,7.5,-115,-105,171,1.5,-125,4.88,Dodger Stadium,17,-5
2021-05-29,2021,ARI,STL,4,7,133,1.5,-120,10.0,-105,-115,-143,-1.5,100,4.29,Chase Field,11,-3
2021-05-29,2021,PHI,TB,3,5,106,1.5,-205,7.0,-115,-105,-116,-1.5,180,3.4,Tropicana Field,8,-2
2021-05-29,2021,SEA,TEX,3,2,-104,1.5,-170,8.5,-120,100,-106,-1.5,150,4.33,T-Mobile Park,5,1
2021-05-29,2021,MIL,WSH,4,1,-121,-1.5,170,5.5,100,-120,111,1.5,-190,3.01,Nationals Park,5,3
2021-05-29,2021,MIL,WSH,6,2,110,1.5,-220,6.5,100,-120,-120,-1.5,195,3.1,Nationals Park,8,4
2021-05-30,2021,STL,ARI,2,9,102,-1.5,155,9.0,100,-120,-112,1.5,-175,4.46,Chase Field,11,-7
2021-05-30,2021,CWS,BAL,3,1,-205,-1.5,100,8.0,-105,-115,185,1.5,-120,5.38,Guaranteed Rate Field,4,2
2021-05-30,2021,CIN,CHC,5,1,103,1.5,-200,8.0,-115,-105,-113,-1.5,175,3.94,Wrigley Field,6,4
2021-05-30,2021,CHC,CIN,1,5,-113,-1.5,175,8.0,-115,-105,103,1.5,-200,4.24,Wrigley Field,6,-4
2021-05-30,2021,TOR,CLE,4,1,-105,1.5,-230,6.5,100,-120,-105,-1.5,200,3.33,Progressive Field,5,3
2021-05-30,2021,TOR,CLE,5,6,-158,-1.5,115,7.0,110,-130,148,1.5,-135,4.29,Progressive Field,11,-1
2021-05-30,2021,PIT,COL,3,4,-118,-1.5,175,7.5,-110,-110,108,1.5,-200,4.06,PNC Park,7,-1
2021-05-30,2021,BAL,CWS,1,3,185,1.5,-120,8.0,-105,-115,-205,-1.5,100,2.81,Guaranteed Rate Field,4,-2
2021-05-30,2021,NYY,DET,2,6,-185,-1.5,-130,9.0,-120,100,170,1.5,110,5.84,Comerica Park,8,-4
2021-05-30,2021,SD,HOU,4,7,105,1.5,-200,8.5,100,-120,-115,-1.5,175,4.15,Minute Maid Park,11,-3
2021-05-30,2021,MIN,KC,3,6,-128,-1.5,140,9.0,-110,-110,118,1.5,-160,5.05,Target Field,9,-3
2021-05-30,2021,OAK,LAA,2,4,-136,-1.5,145,9.0,-110,-110,126,1.5,-165,5.19,Oakland Coliseum,6,-2
2021-05-30,2021,SF,LAD,5,4,150,1.5,-155,7.0,-105,-115,-160,-1.5,135,2.8,Dodger Stadium,9,1
2021-05-30,2021,WSH,MIL,0,3,-112,-1.5,190,6.0,-115,-105,102,1.5,-215,3.17,Nationals Park,3,-3
2021-05-30,2021,KC,MIN,6,3,118,1.5,-160,9.0,-110,-110,-128,-1.5,140,4.13,Target Field,9,3
2021-05-30,2021,DET,NYY,6,2,170,1.5,110,9.0,-120,100,-185,-1.5,-130,3.33,Comerica Park,8,4
2021-05-30,2021,LAA,OAK,4,2,126,1.5,-165,9.0,-110,-110,-136,-1.5,145,3.98,Oakland Coliseum,6,2
2021-05-30,2021,TB,PHI,6,2,-140,-1.5,155,7.5,-110,-110,130,1.5,-175,4.38,Tropicana Field,8,4
2021-05-30,2021,COL,PIT,4,3,108,1.5,-200,7.5,-110,-110,-118,-1.5,175,3.61,PNC Park,7,1
2021-05-30,2021,HOU,SD,7,4,-115,-1.5,175,8.5,100,-120,105,1.5,-200,4.55,Minute Maid Park,11,3
2021-05-30,2021,TEX,SEA,2,4,130,1.5,-150,8.0,-115,-105,-140,-1.5,130,3.48,T-Mobile Park,6,-2
2021-05-30,2021,LAD,SF,4,5,-160,-1.5,135,7.0,-105,-115,150,1.5,-155,4.31,Dodger Stadium,9,-1
2021-05-30,2021,ARI,STL,9,2,-112,1.5,-175,9.0,100,-120,102,-1.5,155,4.75,Chase Field,11,7
2021-05-30,2021,PHI,TB,2,6,130,1.5,-175,7.5,-110,-110,-140,-1.5,155,3.26,Tropicana Field,8,-4
2021-05-30,2021,SEA,TEX,4,2,-140,-1.5,130,8.0,-115,-105,130,1.5,-150,4.67,T-Mobile Park,6,2
2021-05-30,2021,CLE,TOR,1,4,-105,-1.5,200,6.5,100,-120,-105,1.5,-230,3.33,Progressive Field,5,-3
2021-05-30,2021,CLE,TOR,6,5,148,1.5,-135,7.0,110,-130,-158,-1.5,115,2.82,Progressive Field,11,1
2021-05-30,2021,MIL,WSH,3,0,102,1.5,-215,6.0,-115,-105,-112,-1.5,190,2.97,Nationals Park,3,3
2021-05-31,2021,NYM,ARI,6,2,-165,-1.5,-110,7.5,100,-120,155,1.5,-110,4.67,Chase Field,8,4
2021-05-31,2021,WSH,ATL,3,5,175,1.5,-120,8.5,-115,-105,-190,-1.5,100,3.09,Suntrust Park,8,-2
2021-05-31,2021,MIN,BAL,3,2,-154,-1.5,100,8.5,-115,-105,144,1.5,-120,5.15,Camden Yards,5,1
2021-05-31,2021,HOU,BOS,11,2,-102,1.5,-160,9.0,-105,-115,-108,-1.5,140,4.54,Minute Maid Park,13,9
2021-05-31,2021,SD,CHC,2,7,-137,-1.5,110,10.0,100,-120,127,1.5,-130,5.78,Wrigley Field,9,-5
2021-05-31,2021,PHI,CIN,1,11,-102,1.5,-200,8.5,-120,100,-108,-1.5,175,4.29,Great American Ballpark,12,-10
2021-05-31,2021,CWS,CLE,8,6,-165,-1.5,105,5.5,-115,-105,155,1.5,-125,3.42,Progressive Field,14,2
2021-05-31,2021,CWS,CLE,1,3,-110,-1.5,155,7.0,110,-130,100,1.5,-175,3.67,Progressive Field,4,-2
2021-05-31,2021,CLE,CWS,6,8,155,1.5,-125,5.5,-115,-105,-165,-1.5,105,2.16,Progressive Field,14,-2
2021-05-31,2021,CLE,CWS,3,1,100,1.5,-175,7.0,110,-130,-110,-1.5,155,3.5,Progressive Field,4,2
2021-05-31,2021,MIL,DET,3,2,-290,-1.5,-135,7.0,-115,-105,250,1.5,115,5.21,Miller Park,5,1
2021-05-31,2021,BOS,HOU,2,11,-108,-1.5,140,9.0,-105,-115,-102,1.5,-160,4.67,Minute Maid Park,13,-9
2021-05-31,2021,PIT,KC,3,7,176,1.5,-120,8.0,-110,-110,-192,-1.5,100,2.9,Kauffman Stadium,10,-4
2021-05-31,2021,SF,LAA,6,1,-148,-1.5,135,8.0,-105,-115,138,1.5,-155,4.77,AT&T Park,7,5
2021-05-31,2021,STL,LAD,4,9,167,1.5,-135,7.0,-110,-110,-182,-1.5,115,2.62,Dodger Stadium,13,-5
2021-05-31,2021,DET,MIL,2,3,250,1.5,115,7.0,-115,-105,-290,-1.5,-135,2.0,Miller Park,5,-1
2021-05-31,2021,BAL,MIN,2,3,144,1.5,-120,8.5,-115,-105,-154,-1.5,100,3.48,Camden Yards,5,-1
2021-05-31,2021,ARI,NYM,2,6,155,1.5,-110,7.5,100,-120,-165,-1.5,-110,2.94,Chase Field,8,-4
2021-05-31,2021,TB,NYY,3,1,121,1.5,-170,8.5,-105,-115,-131,-1.5,150,3.85,Yankee Stadium,4,2
2021-05-31,2021,SEA,OAK,6,5,124,1.5,-135,8.5,100,-120,-134,-1.5,115,3.79,T-Mobile Park,11,1
2021-05-31,2021,CIN,PHI,11,1,-108,-1.5,175,8.5,-120,100,-102,1.5,-200,4.41,Great American Ballpark,12,10
2021-05-31,2021,KC,PIT,7,3,-192,-1.5,100,8.0,-110,-110,176,1.5,-120,5.26,Kauffman Stadium,10,4
2021-05-31,2021,CHC,SD,7,2,127,1.5,-130,10.0,100,-120,-137,-1.5,110,4.41,Wrigley Field,9,5
2021-05-31,2021,OAK,SEA,5,6,-134,-1.5,115,8.5,100,-120,124,1.5,-135,4.87,T-Mobile Park,11,-1
2021-05-31,2021,LAA,SF,1,6,138,1.5,-155,8.0,-105,-115,-148,-1.5,135,3.36,AT&T Park,7,-5
2021-05-31,2021,LAD,STL,9,4,-182,-1.5,115,7.0,-110,-110,167,1.5,-135,4.52,Dodger Stadium,13,5
2021-05-31,2021,NYY,TB,1,3,-131,-1.5,150,8.5,-105,-115,121,1.5,-170,4.82,Yankee Stadium,4,-2
2021-05-31,2021,ATL,WSH,5,3,-190,-1.5,100,8.5,-115,-105,175,1.5,-120,5.57,Suntrust Park,8,2
2021-06-01,2021,NYM,ARI,5,6,-114,-1.5,135,9.0,100,-120,104,1.5,-155,4.79,Chase Field,11,-1
2021-06-01,2021,WSH,ATL,11,6,127,1.5,-165,8.5,-120,100,-137,-1.5,145,3.74,Suntrust Park,17,5
2021-06-01,2021,MIN,BAL,4,7,-166,-1.5,-115,9.0,-115,-105,156,1.5,-105,5.62,Camden Yards,11,-3
2021-06-01,2021,HOU,BOS,5,1,-160,-1.5,125,8.5,-120,100,150,1.5,-145,5.23,Minute Maid Park,6,4
2021-06-01,2021,SD,CHC,3,4,113,1.5,-180,8.5,-110,-110,-123,-1.5,160,3.99,Wrigley Field,7,-1
2021-06-01,2021,PHI,CIN,17,3,101,1.5,-210,7.5,-115,-105,-111,-1.5,185,3.73,Great American Ballpark,20,14
2021-06-01,2021,CWS,CLE,5,6,143,1.5,-145,7.0,-115,-105,-153,-1.5,125,2.88,Progressive Field,11,-1
2021-06-01,2021,TEX,COL,2,3,-106,1.5,-185,9.5,-110,-110,-104,-1.5,165,4.89,Coors Field,5,-1
2021-06-01,2021,CLE,CWS,6,5,-153,-1.5,125,7.0,-115,-105,143,1.5,-145,4.23,Progressive Field,11,1
2021-06-01,2021,MIL,DET,7,10,-162,-1.5,115,7.5,-115,-105,152,1.5,-135,4.64,Miller Park,17,-3
2021-06-01,2021,BOS,HOU,1,5,150,1.5,-145,8.5,-120,100,-160,-1.5,125,3.4,Minute Maid Park,6,-4
2021-06-01,2021,PIT,KC,5,10,152,1.5,-145,8.5,-105,-115,-162,-1.5,125,3.37,Kauffman Stadium,15,-5
2021-06-01,2021,SF,LAA,1,8,-150,-1.5,135,7.0,-110,-110,140,1.5,-155,4.2,AT&T Park,9,-7
2021-06-01,2021,STL,LAD,3,2,176,1.5,-120,8.5,-110,-110,-192,-1.5,100,3.08,Dodger Stadium,5,1
2021-06-01,2021,TOR,MIA,5,1,-152,-1.5,130,8.5,100,-120,142,1.5,-150,5.13,Sahlen Field,6,4
2021-06-01,2021,DET,MIL,10,7,152,1.5,-135,7.5,-115,-105,-162,-1.5,115,2.98,Miller Park,17,3
2021-06-01,2021,BAL,MIN,7,4,156,1.5,-105,9.0,-115,-105,-166,-1.5,-115,3.52,Camden Yards,11,3
2021-06-01,2021,ARI,NYM,6,5,104,1.5,-155,9.0,100,-120,-114,-1.5,135,4.41,Chase Field,11,1
2021-06-01,2021,TB,NYY,3,5,-132,-1.5,125,7.5,-115,-105,122,1.5,-145,4.27,Yankee Stadium,8,-2
2021-06-01,2021,SEA,OAK,6,12,138,1.5,-125,7.5,-115,-105,-148,-1.5,105,3.15,T-Mobile Park,18,-6
2021-06-01,2021,CIN,PHI,3,17,-111,-1.5,185,7.5,-115,-105,101,1.5,-210,3.95,Great American Ballpark,20,-14
2021-06-01,2021,KC,PIT,10,5,-162,-1.5,125,8.5,-105,-115,152,1.5,-145,5.26,Kauffman Stadium,15,5
2021-06-01,2021,CHC,SD,4,3,-123,-1.5,160,8.5,-110,-110,113,1.5,-180,4.69,Wrigley Field,7,1
2021-06-01,2021,OAK,SEA,12,6,-148,-1.5,105,7.5,-115,-105,138,1.5,-125,4.48,T-Mobile Park,18,6
2021-06-01,2021,LAA,SF,8,1,140,1.5,-155,7.0,-110,-110,-150,-1.5,135,2.92,AT&T Park,9,7
2021-06-01,2021,LAD,STL,2,3,-192,-1.5,100,8.5,-110,-110,176,1.5,-120,5.59,Dodger Stadium,5,-1
2021-06-01,2021,NYY,TB,5,3,122,1.5,-145,7.5,-115,-105,-132,-1.5,125,3.38,Yankee Stadium,8,2
2021-06-01,2021,COL,TEX,3,2,-104,-1.5,165,9.5,-110,-110,-106,1.5,-185,4.84,Coors Field,5,1
2021-06-01,2021,MIA,TOR,1,5,142,1.5,-150,8.5,100,-120,-152,-1.5,130,3.51,Sahlen Field,6,-4
2021-06-01,2021,ATL,WSH,6,11,-137,-1.5,145,8.5,-120,100,127,1.5,-165,4.91,Suntrust Park,17,-5
2021-06-02,2021,NYM,ARI,7,6,103,1.5,-200,8.5,-110,-110,-113,-1.5,175,4.19,Chase Field,13,1
2021-06-02,2021,WSH,ATL,5,3,141,1.5,-140,9.5,-115,-105,-151,-1.5,120,3.94,Suntrust Park,8,2
2021-06-02,2021,MIN,BAL,3,6,-131,-1.5,115,9.5,-110,-110,121,1.5,-135,5.39,Camden Yards,9,-3
2021-06-02,2021,HOU,BOS,2,1,-132,-1.5,140,9.0,-105,-115,122,1.5,-160,5.12,Minute Maid Park,3,1
2021-06-02,2021,SD,CHC,1,6,108,1.5,-205,7.0,100,-120,-118,-1.5,180,3.37,Wrigley Field,7,-5
2021-06-02,2021,TEX,COL,3,6,-110,-1.5,140,11.0,-115,-105,100,1.5,-160,5.76,Coors Field,9,-3
2021-06-02,2021,BOS,HOU,1,2,122,1.5,-160,9.0,-105,-115,-132,-1.5,140,4.05,Minute Maid Park,3,-1
2021-06-02,2021,STL,LAD,3,14,205,1.5,100,8.0,-115,-105,-230,-1.5,-120,2.62,Dodger Stadium,17,-11
2021-06-02,2021,TOR,MIA,6,5,-162,-1.5,115,8.0,-120,100,152,1.5,-135,4.95,Sahlen Field,11,1
2021-06-02,2021,BAL,MIN,6,3,121,1.5,-135,9.5,-110,-110,-131,-1.5,115,4.3,Camden Yards,9,3
2021-06-02,2021,ARI,NYM,6,7,-113,-1.5,175,8.5,-110,-110,103,1.5,-200,4.51,Chase Field,13,-1
2021-06-02,2021,TB,NYY,3,4,120,1.5,-175,8.5,-105,-115,-130,-1.5,155,3.86,Yankee Stadium,7,-1
2021-06-02,2021,SEA,OAK,0,6,145,1.5,-120,8.0,-120,100,-155,-1.5,100,3.27,T-Mobile Park,6,-6
2021-06-02,2021,CHC,SD,6,1,-118,-1.5,180,7.0,100,-120,108,1.5,-205,3.79,Wrigley Field,7,5
2021-06-02,2021,OAK,SEA,6,0,-155,-1.5,100,8.0,-120,100,145,1.5,-120,4.86,T-Mobile Park,6,6
2021-06-02,2021,LAD,STL,14,3,-230,-1.5,-120,8.0,-115,-105,205,1.5,100,5.58,Dodger Stadium,17,11
2021-06-02,2021,NYY,TB,4,3,-130,-1.5,155,8.5,-105,-115,120,1.5,-175,4.8,Yankee Stadium,7,1
2021-06-02,2021,COL,TEX,6,3,100,1.5,-160,11.0,-115,-105,-110,-1.5,140,5.5,Coors Field,9,3
2021-06-02,2021,MIA,TOR,5,6,152,1.5,-135,8.0,-120,100,-162,-1.5,115,3.17,Sahlen Field,11,-1
2021-06-02,2021,ATL,WSH,3,5,-151,-1.5,120,9.5,-115,-105,141,1.5,-140,5.72,Suntrust Park,8,-2
2021-06-03,2021,MIL,ARI,7,4,-172,-1.5,110,9.5,100,-120,161,1.5,-130,6.01,Miller Park,11,3
2021-06-03,2021,WSH,ATL,1,5,120,1.5,-160,10.0,-110,-110,-130,-1.5,140,4.55,Suntrust Park,6,-4
2021-06-03,2021,HOU,BOS,1,5,-113,-1.5,165,9.0,-110,-110,103,1.5,-185,4.77,Minute Maid Park,6,-4
2021-06-03,2021,SF,CHC,7,2,-122,-1.5,160,8.0,-115,-105,112,1.5,-180,4.4,AT&T Park,9,5
2021-06-03,2021,STL,CIN,2,4,-141,-1.5,140,8.5,100,-120,131,1.5,-160,4.97,Busch Stadium,6,-2
2021-06-03,2021,TEX,COL,6,11,120,1.5,-165,10.5,-110,-110,-130,-1.5,145,4.77,Coors Field,17,-5
2021-06-03,2021,DET,CWS,1,4,186,1.5,-110,8.0,-110,-110,-206,-1.5,-110,2.8,Guaranteed Rate Field,5,-3
2021-06-03,2021,CWS,DET,4,1,-206,-1.5,-110,8.0,-110,-110,186,1.5,-110,5.39,Guaranteed Rate Field,5,3
2021-06-03,2021,BOS,HOU,5,1,103,1.5,-185,9.0,-110,-110,-113,-1.5,165,4.43,Minute Maid Park,6,4
2021-06-03,2021,MIN,KC,5,6,108,1.5,-175,9.0,-125,105,-118,-1.5,155,4.33,Kauffman Stadium,11,-1
2021-06-03,2021,SEA,LAA,6,2,143,1.5,-150,9.0,-110,-110,-153,-1.5,130,3.7,Angel Stadium,8,4
2021-06-03,2021,PIT,MIA,5,3,-105,1.5,-175,7.5,-110,-110,-105,-1.5,155,3.84,PNC Park,8,2
2021-06-03,2021,ARI,MIL,4,7,161,1.5,-130,9.5,100,-120,-172,-1.5,110,3.64,Miller Park,11,-3
2021-06-03,2021,KC,MIN,6,5,-118,-1.5,155,9.0,-125,105,108,1.5,-175,4.87,Kauffman Stadium,11,1
2021-06-03,2021,SD,NYM,4,3,-187,-1.5,120,6.5,-115,-105,172,1.5,-140,4.24,PETCO Park,7,1
2021-06-03,2021,TB,NYY,9,2,178,1.5,-125,7.5,100,-120,-196,-1.5,105,2.7,Yankee Stadium,11,7
2021-06-03,2021,MIA,PIT,3,5,-105,-1.5,155,7.5,-110,-110,-105,1.5,-175,3.84,PNC Park,8,-2
2021-06-03,2021,NYM,SD,3,4,172,1.5,-140,6.5,-115,-105,-187,-1.5,120,2.39,PETCO Park,7,-1
2021-06-03,2021,LAA,SEA,2,6,-153,-1.5,130,9.0,-110,-110,143,1.5,-150,5.44,Angel Stadium,8,-4
2021-06-03,2021,CHC,SF,2,7,112,1.5,-180,8.0,-115,-105,-122,-1.5,160,3.77,AT&T Park,9,-5
2021-06-03,2021,CIN,STL,4,2,131,1.5,-160,8.5,100,-120,-141,-1.5,140,3.68,Busch Stadium,6,2
2021-06-03,2021,NYY,TB,2,9,-196,-1.5,105,7.5,100,-120,178,1.5,-125,4.97,Yankee Stadium,11,-7
2021-06-03,2021,COL,TEX,11,6,-130,-1.5,145,10.5,-110,-110,120,1.5,-165,5.93,Coors Field,17,5
2021-06-03,2021,ATL,WSH,5,1,-130,-1.5,140,10.0,-110,-110,120,1.5,-160,5.65,Suntrust Park,6,4
2021-06-04,2021,MIL,ARI,5,1,-201,-1.5,-105,8.0,-115,-105,181,1.5,-115,5.34,Miller Park,6,4
2021-06-04,2021,LAD,ATL,9,5,-136,-1.5,115,8.5,-120,100,126,1.5,-135,4.9,Suntrust Park,14,4
2021-06-04,2021,CLE,BAL,1,3,-106,-1.5,145,8.5,-120,100,-104,1.5,-165,4.37,Camden Yards,4,-2
2021-06-04,2021,NYY,BOS,2,5,-103,1.5,-165,9.0,-110,-110,-107,-1.5,145,4.57,Yankee Stadium,7,-3
2021-06-04,2021,SF,CHC,8,5,-107,-1.5,180,8.5,-110,-110,-103,1.5,-205,4.39,AT&T Park,13,3
2021-06-04,2021,STL,CIN,4,6,-128,-1.5,165,8.5,-110,-110,118,1.5,-185,4.77,Busch Stadium,10,-2
2021-06-04,2021,BAL,CLE,3,1,-104,1.5,-165,8.5,-120,100,-106,-1.5,145,4.33,Camden Yards,4,2
2021-06-04,2021,OAK,COL,9,5,-139,-1.5,100,11.0,-110,-110,129,1.5,-120,6.4,Coors Field,14,4
2021-06-04,2021,DET,CWS,8,9,143,1.5,-140,8.5,-115,-105,-153,-1.5,120,3.5,Guaranteed Rate Field,17,-1
2021-06-04,2021,CWS,DET,9,8,-153,-1.5,120,8.5,-115,-105,143,1.5,-140,5.14,Guaranteed Rate Field,17,1
2021-06-04,2021,TOR,HOU,1,13,-132,-1.5,150,8.5,-110,-110,122,1.5,-170,4.84,Sahlen Field,14,-12
2021-06-04,2021,MIN,KC,5,14,117,1.5,-170,9.5,-110,-110,-127,-1.5,150,4.38,Kauffman Stadium,19,-9
2021-06-04,2021,SEA,LAA,2,3,155,1.5,-130,9.0,100,-120,-165,-1.5,110,3.53,Angel Stadium,5,-1
2021-06-04,2021,ATL,LAD,5,9,126,1.5,-135,8.5,-120,100,-136,-1.5,115,3.76,Suntrust Park,14,-4
2021-06-04,2021,PIT,MIA,9,2,-104,1.5,-175,8.0,100,-120,-106,-1.5,155,4.08,PNC Park,11,7
2021-06-04,2021,ARI,MIL,1,5,181,1.5,-115,8.0,-115,-105,-201,-1.5,-105,2.85,Miller Park,6,-4
2021-06-04,2021,KC,MIN,14,5,-127,-1.5,150,9.5,-110,-110,117,1.5,-170,5.31,Kauffman Stadium,19,9
2021-06-04,2021,SD,NYM,2,0,-180,-1.5,110,7.5,-105,-115,165,1.5,-130,4.82,PETCO Park,2,2
2021-06-04,2021,BOS,NYY,5,2,-107,-1.5,145,9.0,-110,-110,-103,1.5,-165,4.65,Yankee Stadium,7,3
2021-06-04,2021,COL,OAK,5,9,129,1.5,-120,11.0,-110,-110,-139,-1.5,100,4.8,Coors Field,14,-4
2021-06-04,2021,WSH,PHI,2,1,-107,-1.5,160,7.0,-110,-110,-103,1.5,-180,3.62,Citizens Bank Park,3,1
2021-06-04,2021,MIA,PIT,2,9,-106,-1.5,155,8.0,100,-120,-104,1.5,-175,4.12,PNC Park,11,-7
2021-06-04,2021,NYM,SD,0,2,165,1.5,-130,7.5,-105,-115,-180,-1.5,110,2.83,PETCO Park,2,-2
2021-06-04,2021,LAA,SEA,3,2,-165,-1.5,110,9.0,100,-120,155,1.5,-130,5.6,Angel Stadium,5,1
2021-06-04,2021,CHC,SF,5,8,-103,1.5,-205,8.5,-110,-110,-107,-1.5,180,4.31,AT&T Park,13,-3
2021-06-04,2021,CIN,STL,6,4,118,1.5,-185,8.5,-110,-110,-128,-1.5,165,3.9,Busch Stadium,10,2
2021-06-04,2021,TEX,TB,5,4,114,1.5,-150,8.0,-110,-110,-124,-1.5,130,3.74,Globe Life Field,9,1
2021-06-04,2021,TB,TEX,4,5,-124,-1.5,130,8.0,-110,-110,114,1.5,-150,4.43,Globe Life Field,9,-1
2021-06-04,2021,HOU,TOR,13,1,122,1.5,-170,8.5,-110,-110,-132,-1.5,150,3.83,Sahlen Field,14,12
2021-06-04,2021,PHI,WSH,1,2,-103,1.5,-180,7.0,-110,-110,-107,-1.5,160,3.55,Citizens Bank Park,3,-1
2021-06-05,2021,MIL,ARI,7,5,-230,-1.5,-115,7.5,-120,100,205,1.5,-105,5.23,Miller Park,12,2
2021-06-05,2021,LAD,ATL,4,6,-129,-1.5,120,8.0,-110,-110,119,1.5,-140,4.51,Suntrust Park,10,-2
2021-06-05,2021,CLE,BAL,10,4,115,1.5,-180,8.5,-105,-115,-125,-1.5,160,3.95,Camden Yards,14,6
2021-06-05,2021,NYY,BOS,3,7,-136,-1.5,135,9.5,-120,100,126,1.5,-155,5.47,Yankee Stadium,10,-4
2021-06-05,2021,SF,CHC,4,3,-158,-1.5,130,7.5,100,-120,148,1.5,-150,4.59,AT&T Park,7,1
2021-06-05,2021,STL,CIN,2,5,104,1.5,-155,9.0,110,-130,-114,-1.5,135,4.41,Busch Stadium,7,-3
2021-06-05,2021,BAL,CLE,4,10,-125,-1.5,160,8.5,-105,-115,115,1.5,-180,4.72,Camden Yards,14,-6
2021-06-05,2021,OAK,COL,6,3,-125,-1.5,115,12.0,-115,-105,115,1.5,-135,6.67,Coors Field,9,3
2021-06-05,2021,DET,CWS,4,3,205,1.5,110,8.0,-120,100,-230,-1.5,-130,2.62,Guaranteed Rate Field,7,1
2021-06-05,2021,CWS,DET,3,4,-230,-1.5,-130,8.0,-120,100,205,1.5,110,5.58,Guaranteed Rate Field,7,-1
2021-06-05,2021,TOR,HOU,6,2,-103,-1.5,175,10.0,-115,-105,-107,1.5,-200,5.07,Sahlen Field,8,4
2021-06-05,2021,MIN,KC,5,4,-101,-1.5,145,8.5,-120,100,-109,1.5,-165,4.27,Kauffman Stadium,9,1
2021-06-05,2021,SEA,LAA,5,12,140,1.5,-160,8.0,100,-120,-150,-1.5,140,3.33,Angel Stadium,17,-7
2021-06-05,2021,ATL,LAD,6,4,119,1.5,-140,8.0,-110,-110,-129,-1.5,120,3.65,Suntrust Park,10,2
2021-06-05,2021,PIT,MIA,8,7,110,1.5,-155,7.5,-115,-105,-120,-1.5,135,3.57,PNC Park,15,1
2021-06-05,2021,ARI,MIL,5,7,205,1.5,-105,7.5,-120,100,-230,-1.5,-115,2.46,Miller Park,12,-2
2021-06-05,2021,KC,MIN,4,5,-109,1.5,-165,8.5,-120,100,-101,-1.5,145,4.43,Kauffman Stadium,9,-1
2021-06-05,2021,SD,NYM,0,4,109,1.5,-170,5.5,-120,100,-119,-1.5,150,2.63,PETCO Park,4,-4
2021-06-05,2021,BOS,NYY,7,3,126,1.5,-155,9.5,-120,100,-136,-1.5,135,4.2,Yankee Stadium,10,4
2021-06-05,2021,COL,OAK,3,6,115,1.5,-135,12.0,-115,-105,-125,-1.5,115,5.58,Coors Field,9,-3
2021-06-05,2021,WSH,PHI,2,5,105,1.5,-180,10.0,-115,-105,-115,-1.5,160,4.88,Citizens Bank Park,7,-3
2021-06-05,2021,MIA,PIT,7,8,-120,-1.5,135,7.5,-115,-105,110,1.5,-155,4.09,PNC Park,15,-1
2021-06-05,2021,NYM,SD,4,0,-119,-1.5,150,5.5,-120,100,109,1.5,-170,2.99,PETCO Park,4,4
2021-06-05,2021,LAA,SEA,12,5,-150,-1.5,140,8.0,100,-120,140,1.5,-160,4.8,Angel Stadium,17,7
2021-06-05,2021,CHC,SF,3,4,148,1.5,-150,7.5,100,-120,-158,-1.5,130,3.02,AT&T Park,7,-1
2021-06-05,2021,CIN,STL,5,2,-114,-1.5,135,9.0,110,-130,104,1.5,-155,4.79,Busch Stadium,7,3
2021-06-05,2021,TEX,TB,0,3,135,1.5,-120,8.0,-110,-110,-145,-1.5,100,3.4,Globe Life Field,3,-3
2021-06-05,2021,TB,TEX,3,0,-145,-1.5,100,8.0,-110,-110,135,1.5,-120,4.73,Globe Life Field,3,3
2021-06-05,2021,HOU,TOR,2,6,-107,1.5,-200,10.0,-115,-105,-103,-1.5,175,5.17,Sahlen Field,8,-4
2021-06-05,2021,PHI,WSH,5,2,-115,-1.5,160,10.0,-115,-105,105,1.5,-180,5.35,Citizens Bank Park,7,3
2021-06-06,2021,MIL,ARI,2,0,-250,-1.5,-120,8.0,-110,-110,220,1.5,100,5.71,Miller Park,2,2
2021-06-06,2021,LAD,ATL,2,4,-135,-1.5,110,8.5,-110,-110,125,1.5,-130,4.88,Suntrust Park,6,-2
2021-06-06,2021,CLE,BAL,5,18,-112,-1.5,140,9.0,100,-120,102,1.5,-160,4.75,Camden Yards,23,-13
2021-06-06,2021,NYY,BOS,5,6,-145,-1.5,125,9.5,-105,-115,135,1.5,-145,5.62,Yankee Stadium,11,-1
2021-06-06,2021,SF,CHC,3,4,100,1.5,-170,8.0,-105,-115,-110,-1.5,150,4.0,AT&T Park,7,-1
2021-06-06,2021,STL,CIN,7,8,-120,-1.5,165,8.5,-110,-110,110,1.5,-185,4.64,Busch Stadium,15,-1
2021-06-06,2021,BAL,CLE,18,5,102,1.5,-160,9.0,100,-120,-112,-1.5,140,4.46,Camden Yards,23,13
2021-06-06,2021,OAK,COL,1,3,-105,1.5,-190,11.0,-110,-110,-105,-1.5,170,5.63,Coors Field,4,-2
2021-06-06,2021,DET,CWS,0,3,185,1.5,-110,9.0,-110,-110,-205,-1.5,-110,3.16,Guaranteed Rate Field,3,-3
2021-06-06,2021,CWS,DET,3,0,-205,-1.5,-110,9.0,-110,-110,185,1.5,-110,6.05,Guaranteed Rate Field,3,3
2021-06-06,2021,TOR,HOU,3,6,-108,-1.5,170,9.5,-105,-115,-102,1.5,-190,4.93,Sahlen Field,9,-3
2021-06-06,2021,MIN,KC,2,1,125,1.5,-160,9.0,-115,-105,-135,-1.5,140,4.0,Kauffman Stadium,3,1
2021-06-06,2021,SEA,LAA,9,5,140,1.5,-145,9.0,100,-120,-150,-1.5,125,3.75,Angel Stadium,14,4
2021-06-06,2021,ATL,LAD,4,2,125,1.5,-130,8.5,-110,-110,-135,-1.5,110,3.78,Suntrust Park,6,2
2021-06-06,2021,PIT,MIA,1,3,112,1.5,-150,8.0,-120,100,-122,-1.5,130,3.77,PNC Park,4,-2
2021-06-06,2021,ARI,MIL,0,2,220,1.5,100,8.0,-110,-110,-250,-1.5,-120,2.5,Miller Park,2,-2
2021-06-06,2021,KC,MIN,1,2,-135,-1.5,140,9.0,-115,-105,125,1.5,-160,5.17,Kauffman Stadium,3,-1
2021-06-06,2021,SD,NYM,2,6,-148,-1.5,150,7.0,-115,-105,138,1.5,-170,4.18,PETCO Park,8,-4
2021-06-06,2021,BOS,NYY,6,5,135,1.5,-145,9.5,-105,-115,-145,-1.5,125,4.04,Yankee Stadium,11,1
2021-06-06,2021,COL,OAK,3,1,-105,-1.5,170,11.0,-110,-110,-105,1.5,-190,5.63,Coors Field,4,2
2021-06-06,2021,WSH,PHI,6,12,112,1.5,-170,9.5,-110,-110,-122,-1.5,150,4.48,Citizens Bank Park,18,-6
2021-06-06,2021,MIA,PIT,3,1,-122,-1.5,130,8.0,-120,100,112,1.5,-150,4.4,PNC Park,4,2
2021-06-06,2021,NYM,SD,6,2,138,1.5,-170,7.0,-115,-105,-148,-1.5,150,2.94,PETCO Park,8,4
2021-06-06,2021,LAA,SEA,5,9,-150,-1.5,125,9.0,100,-120,140,1.5,-145,5.4,Angel Stadium,14,-4
2021-06-06,2021,CHC,SF,4,3,-110,-1.5,150,8.0,-105,-115,100,1.5,-170,4.19,AT&T Park,7,1
2021-06-06,2021,CIN,STL,8,7,110,1.5,-185,8.5,-110,-110,-120,-1.5,165,4.05,Busch Stadium,15,1
2021-06-06,2021,TEX,TB,1,7,117,1.5,-145,8.0,-105,-115,-127,-1.5,125,3.69,Globe Life Field,8,-6
2021-06-06,2021,TB,TEX,7,1,-127,-1.5,125,8.0,-105,-115,117,1.5,-145,4.48,Globe Life Field,8,6
2021-06-06,2021,HOU,TOR,6,3,-102,1.5,-190,9.5,-105,-115,-108,-1.5,170,4.8,Sahlen Field,9,3
2021-06-06,2021,PHI,WSH,12,6,-122,-1.5,150,9.5,-110,-110,112,1.5,-170,5.22,Citizens Bank Park,18,6
2021-06-07,2021,MIA,BOS,3,5,170,1.5,-110,10.0,-115,-105,-185,-1.5,-110,3.7,Fenway Park,8,-2
2021-06-07,2021,SD,CHC,9,4,-115,-1.5,170,8.0,-110,-110,105,1.5,-190,4.28,PETCO Park,13,5
2021-06-07,2021,LAA,KC,8,3,-147,-1.5,135,9.0,-105,-115,137,1.5,-155,5.36,Angel Stadium,11,5
2021-06-07,2021,KC,LAA,3,8,137,1.5,-155,9.0,-105,-115,-147,-1.5,135,3.8,Angel Stadium,11,-5
2021-06-07,2021,BOS,MIA,5,3,-185,-1.5,-110,10.0,-115,-105,170,1.5,-110,6.49,Fenway Park,8,2
2021-06-07,2021,CHC,SD,4,9,105,1.5,-190,8.0,-110,-110,-115,-1.5,170,3.9,PETCO Park,13,-5
2021-06-08,2021,OAK,ARI,5,2,-230,-1.5,-120,8.0,-115,-105,205,1.5,100,5.58,Oakland Coliseum,7,3
2021-06-08,2021,PHI,ATL,5,9,-156,-1.5,130,9.0,-110,-110,146,1.5,-150,5.48,Citizens Bank Park,14,-4
2021-06-08,2021,NYM,BAL,3,10,-112,-1.5,130,9.5,-105,-115,102,1.5,-150,5.02,Camden Yards,13,-7
2021-06-08,2021,HOU,BOS,7,1,-121,-1.5,130,10.0,-115,-105,111,1.5,-150,5.48,Fenway Park,8,6
2021-06-08,2021,SD,CHC,1,7,-183,-1.5,110,8.0,-120,100,168,1.5,-130,5.17,PETCO Park,8,-6
2021-06-08,2021,MIL,CIN,5,1,131,1.5,-160,8.5,-110,-110,-141,-1.5,140,3.68,Great American Ballpark,6,4
2021-06-08,2021,STL,CLE,1,10,150,1.5,-125,7.5,105,-125,-160,-1.5,105,3.0,Busch Stadium,11,-9
2021-06-08,2021,MIA,COL,6,2,-185,-1.5,125,7.0,100,-120,170,1.5,-145,4.54,Marlins Park,8,4
2021-06-08,2021,TOR,CWS,1,6,133,1.5,-155,8.0,-115,-105,-143,-1.5,135,3.43,Guaranteed Rate Field,7,-5
2021-06-08,2021,SEA,DET,3,5,120,1.5,-180,8.5,-110,-110,-130,-1.5,160,3.86,Comerica Park,8,-2
2021-06-08,2021,BOS,HOU,1,7,111,1.5,-150,10.0,-115,-105,-121,-1.5,130,4.74,Fenway Park,8,-6
2021-06-08,2021,LAA,KC,8,1,-159,-1.5,125,8.5,-120,100,149,1.5,-145,5.22,Angel Stadium,9,7
2021-06-08,2021,KC,LAA,1,8,149,1.5,-145,8.5,-120,100,-159,-1.5,125,3.41,Angel Stadium,9,-7
2021-06-08,2021,PIT,LAD,3,5,172,1.5,110,8.5,-105,-115,-187,-1.5,-130,3.13,PNC Park,8,-2
2021-06-08,2021,COL,MIA,2,6,170,1.5,-145,7.0,100,-120,-185,-1.5,125,2.59,Marlins Park,8,-4
2021-06-08,2021,CIN,MIL,1,5,-141,-1.5,140,8.5,-110,-110,131,1.5,-160,4.97,Great American Ballpark,6,-4
2021-06-08,2021,NYY,MIN,8,4,-111,-1.5,145,9.5,-105,-115,101,1.5,-165,5.0,Target Field,12,4
2021-06-08,2021,BAL,NYM,10,3,102,1.5,-150,9.5,-105,-115,-112,-1.5,130,4.7,Camden Yards,13,7
2021-06-08,2021,MIN,NYY,4,8,101,1.5,-165,9.5,-105,-115,-111,-1.5,145,4.73,Target Field,12,-4
2021-06-08,2021,ARI,OAK,2,5,205,1.5,100,8.0,-115,-105,-230,-1.5,-120,2.62,Oakland Coliseum,7,-3
2021-06-08,2021,ATL,PHI,9,5,146,1.5,-150,9.0,-110,-110,-156,-1.5,130,3.66,Citizens Bank Park,14,4
2021-06-08,2021,LAD,PIT,5,3,-187,-1.5,-130,8.5,-105,-115,172,1.5,110,5.54,PNC Park,8,2
2021-06-08,2021,CHC,SD,7,1,168,1.5,-130,8.0,-120,100,-183,-1.5,110,2.99,PETCO Park,8,6
2021-06-08,2021,DET,SEA,5,3,-130,-1.5,160,8.5,-110,-110,120,1.5,-180,4.8,Comerica Park,8,2
2021-06-08,2021,TEX,SF,4,9,130,1.5,-130,8.5,-115,-105,-140,-1.5,110,3.7,Globe Life Field,13,-5
2021-06-08,2021,CLE,STL,10,1,-160,-1.5,105,7.5,105,-125,150,1.5,-125,4.62,Busch Stadium,11,9
2021-06-08,2021,WSH,TB,1,3,205,1.5,-105,7.5,-115,-105,-230,-1.5,-115,2.46,Tropicana Field,4,-2
2021-06-08,2021,SF,TEX,9,4,-140,-1.5,110,8.5,-115,-105,130,1.5,-130,4.96,Globe Life Field,13,5
2021-06-08,2021,CWS,TOR,6,1,-143,-1.5,135,8.0,-115,-105,133,1.5,-155,4.71,Guaranteed Rate Field,7,5
2021-06-08,2021,TB,WSH,3,1,-230,-1.5,-115,7.5,-115,-105,205,1.5,-105,5.23,Tropicana Field,4,2
2021-06-09,2021,OAK,ARI,4,0,-190,-1.5,100,8.5,-120,100,175,1.5,-120,5.57,Oakland Coliseum,4,4
2021-06-09,2021,PHI,ATL,2,1,-128,-1.5,145,9.0,-120,100,118,1.5,-165,5.05,Citizens Bank Park,3,1
2021-06-09,2021,NYM,BAL,14,1,-127,-1.5,120,9.5,-105,-115,117,1.5,-140,5.31,Camden Yards,15,13
2021-06-09,2021,HOU,BOS,8,3,121,1.5,-155,10.0,-110,-110,-131,-1.5,135,4.52,Fenway Park,11,5
2021-06-09,2021,SD,CHC,1,3,-260,-1.5,-125,8.0,100,-120,230,1.5,105,5.78,PETCO Park,4,-2
2021-06-09,2021,MIL,CIN,3,7,107,1.5,-185,10.0,-110,-110,-117,-1.5,165,4.83,Great American Ballpark,10,-4
2021-06-09,2021,STL,CLE,8,2,-130,-1.5,155,8.0,100,-120,120,1.5,-175,4.52,Busch Stadium,10,6
2021-06-09,2021,MIA,COL,3,4,-113,-1.5,180,7.5,100,-120,103,1.5,-205,3.98,Marlins Park,7,-1
2021-06-09,2021,TOR,CWS,6,2,139,1.5,-155,8.0,-115,-105,-149,-1.5,135,3.35,Guaranteed Rate Field,8,4
2021-06-09,2021,SEA,DET,9,6,115,1.5,-175,9.0,-110,-110,-125,-1.5,155,4.19,Comerica Park,15,3
2021-06-09,2021,BOS,HOU,3,8,-131,-1.5,135,10.0,-110,-110,121,1.5,-155,5.67,Fenway Park,11,-5
2021-06-09,2021,LAA,KC,6,1,-149,-1.5,135,9.0,100,-120,139,1.5,-155,5.39,Angel Stadium,7,5
2021-06-09,2021,KC,LAA,1,6,139,1.5,-155,9.0,100,-120,-149,-1.5,135,3.77,Angel Stadium,7,-5
2021-06-09,2021,PIT,LAD,1,2,164,1.5,100,9.0,-105,-115,-178,-1.5,-120,3.41,PNC Park,3,-1
2021-06-09,2021,COL,MIA,4,3,103,1.5,-205,7.5,100,-120,-113,-1.5,180,3.69,Marlins Park,7,1
2021-06-09,2021,CIN,MIL,7,3,-117,-1.5,165,10.0,-110,-110,107,1.5,-185,5.39,Great American Ballpark,10,4
2021-06-09,2021,NYY,MIN,9,6,-184,-1.5,-130,8.5,-110,-110,169,1.5,110,5.51,Target Field,15,3
2021-06-09,2021,BAL,NYM,1,14,117,1.5,-140,9.5,-105,-115,-127,-1.5,120,4.38,Camden Yards,15,-13
2021-06-09,2021,MIN,NYY,6,9,169,1.5,110,8.5,-110,-110,-184,-1.5,-130,3.16,Target Field,15,-3
2021-06-09,2021,ARI,OAK,0,4,175,1.5,-120,8.5,-120,100,-190,-1.5,100,3.09,Oakland Coliseum,4,-4
2021-06-09,2021,ATL,PHI,1,2,118,1.5,-165,9.0,-120,100,-128,-1.5,145,4.13,Citizens Bank Park,3,-1
2021-06-09,2021,LAD,PIT,2,1,-178,-1.5,-120,9.0,-105,-115,164,1.5,100,5.76,PNC Park,3,1
2021-06-09,2021,CHC,SD,3,1,230,1.5,105,8.0,100,-120,-260,-1.5,-125,2.42,PETCO Park,4,2
2021-06-09,2021,DET,SEA,6,9,-125,-1.5,155,9.0,-110,-110,115,1.5,-175,5.0,Comerica Park,15,-3
2021-06-09,2021,TEX,SF,4,3,-108,-1.5,180,7.5,-115,-105,-102,1.5,-205,3.89,Globe Life Field,7,1
2021-06-09,2021,CLE,STL,2,8,120,1.5,-175,8.0,100,-120,-130,-1.5,155,3.64,Busch Stadium,10,-6
2021-06-09,2021,WSH,TB,9,7,157,1.5,-140,7.5,-105,-115,-167,-1.5,120,2.92,Tropicana Field,16,2
2021-06-09,2021,SF,TEX,3,4,-102,1.5,-205,7.5,-115,-105,-108,-1.5,180,3.79,Globe Life Field,7,-1
2021-06-09,2021,CWS,TOR,2,6,-149,-1.5,135,8.0,-115,-105,139,1.5,-155,4.79,Guaranteed Rate Field,8,-4
2021-06-09,2021,TB,WSH,7,9,-167,-1.5,120,7.5,-105,-115,157,1.5,-140,4.69,Tropicana Field,16,-2
2021-06-10,2021,PHI,ATL,4,3,-132,-1.5,155,7.5,100,-120,122,1.5,-175,4.27,Citizens Bank Park,7,1
2021-06-10,2021,HOU,BOS,8,12,-106,-1.5,140,9.0,-115,-105,-104,1.5,-160,4.63,Fenway Park,20,-4
2021-06-10,2021,MIL,CIN,7,2,-108,-1.5,155,8.0,-115,-105,-102,1.5,-175,4.15,Great American Ballpark,9,5
2021-06-10,2021,MIA,COL,11,4,-203,-1.5,-105,7.5,-105,-115,183,1.5,-115,5.02,Marlins Park,15,7
2021-06-10,2021,TOR,CWS,2,5,-112,-1.5,135,9.0,-110,-110,102,1.5,-155,4.75,Guaranteed Rate Field,7,-3
2021-06-10,2021,SEA,DET,3,8,107,1.5,-180,9.5,100,-120,-117,-1.5,160,4.59,Comerica Park,11,-5
2021-06-10,2021,BOS,HOU,12,8,-104,1.5,-160,9.0,-115,-105,-106,-1.5,140,4.59,Fenway Park,20,4
2021-06-10,2021,OAK,KC,1,6,-142,-1.5,130,8.0,-105,-115,132,1.5,-150,4.69,Oakland Coliseum,7,-5
2021-06-10,2021,PIT,LAD,3,6,205,1.5,125,8.0,-115,-105,-230,-1.5,-145,2.62,PNC Park,9,-3
2021-06-10,2021,COL,MIA,4,11,183,1.5,-115,7.5,-105,-115,-203,-1.5,-105,2.65,Marlins Park,15,-7
2021-06-10,2021,CIN,MIL,2,7,-102,1.5,-175,8.0,-115,-105,-108,-1.5,155,4.04,Great American Ballpark,9,-5
2021-06-10,2021,NYY,MIN,5,7,-138,-1.5,105,10.5,-125,105,128,1.5,-125,6.09,Target Field,12,-2
2021-06-10,2021,MIN,NYY,7,5,128,1.5,-125,10.5,-125,105,-138,-1.5,105,4.61,Target Field,12,2
2021-06-10,2021,KC,OAK,6,1,132,1.5,-150,8.0,-105,-115,-142,-1.5,130,3.45,Oakland Coliseum,7,5
2021-06-10,2021,ATL,PHI,3,4,122,1.5,-175,7.5,100,-120,-132,-1.5,155,3.38,Citizens Bank Park,7,-1
2021-06-10,2021,LAD,PIT,6,3,-230,-1.5,-145,8.0,-115,-105,205,1.5,125,5.58,PNC Park,9,3
2021-06-10,2021,DET,SEA,8,3,-117,-1.5,160,9.5,100,-120,107,1.5,-180,5.12,Comerica Park,11,5
2021-06-10,2021,CWS,TOR,5,2,102,1.5,-155,9.0,-110,-110,-112,-1.5,135,4.46,Guaranteed Rate Field,7,3
2021-06-11,2021,LAA,ARI,6,5,-139,-1.5,115,9.0,-115,-105,129,1.5,-135,5.23,Chase Field,11,1
2021-06-11,2021,MIA,ATL,4,3,106,1.5,-165,7.0,-115,-105,-116,-1.5,145,3.4,Marlins Park,7,1
2021-06-11,2021,TB,BAL,4,2,-178,-1.5,115,8.0,-105,-115,164,1.5,-135,5.12,Tropicana Field,6,2
2021-06-11,2021,TOR,BOS,5,6,100,1.5,-175,9.5,-110,-110,-110,-1.5,155,4.75,Fenway Park,11,-1
2021-06-11,2021,STL,CHC,5,8,137,1.5,-155,9.5,-105,-115,-147,-1.5,135,4.01,Wrigley Field,13,-3
2021-06-11,2021,COL,CIN,5,11,180,1.5,-105,9.0,-125,105,-200,-1.5,-115,3.21,Great American Ballpark,16,-6
2021-06-11,2021,SEA,CLE,0,7,144,1.5,-140,9.0,-115,-105,-154,-1.5,120,3.69,Progressive Field,7,-7
2021-06-11,2021,CIN,COL,11,5,-200,-1.5,-115,9.0,-125,105,180,1.5,-105,6.0,Great American Ballpark,16,6
2021-06-11,2021,DET,CWS,4,5,136,1.5,-130,8.5,-110,-110,-146,-1.5,110,3.6,Comerica Park,9,-1
2021-06-11,2021,CWS,DET,5,4,-146,-1.5,110,8.5,-110,-110,136,1.5,-130,5.04,Comerica Park,9,1
2021-06-11,2021,MIN,HOU,4,6,127,1.5,-115,10.5,-105,-115,-137,-1.5,-105,4.63,Target Field,10,-2
2021-06-11,2021,OAK,KC,4,3,-128,-1.5,150,8.5,-110,-110,118,1.5,-170,4.77,Oakland Coliseum,7,1
2021-06-11,2021,ARI,LAA,5,6,129,1.5,-135,9.0,-115,-105,-139,-1.5,115,3.93,Chase Field,11,-1
2021-06-11,2021,TEX,LAD,1,12,270,1.5,125,8.0,-110,-110,-310,-1.5,-145,2.16,Dodger Stadium,13,-11
2021-06-11,2021,ATL,MIA,3,4,-116,-1.5,145,7.0,-115,-105,106,1.5,-165,3.76,Marlins Park,7,-1
2021-06-11,2021,PIT,MIL,4,7,260,1.5,125,7.5,-105,-115,-300,-1.5,-145,2.08,Miller Park,11,-3
2021-06-11,2021,HOU,MIN,6,4,-137,-1.5,-105,10.5,-105,-115,127,1.5,-115,6.07,Target Field,10,2
2021-06-11,2021,SD,NYM,2,3,155,1.5,-165,6.0,-105,-115,-165,-1.5,145,2.35,Citi Field,5,-1
2021-06-11,2021,KC,OAK,3,4,118,1.5,-170,8.5,-110,-110,-128,-1.5,150,3.9,Oakland Coliseum,7,-1
2021-06-11,2021,MIL,PIT,7,4,-300,-1.5,-145,7.5,-105,-115,260,1.5,125,5.63,Miller Park,11,3
2021-06-11,2021,NYM,SD,3,2,-165,-1.5,145,6.0,-105,-115,155,1.5,-165,3.74,Citi Field,5,1
2021-06-11,2021,CLE,SEA,7,0,-154,-1.5,120,9.0,-115,-105,144,1.5,-140,5.46,Progressive Field,7,7
2021-06-11,2021,WSH,SF,0,1,-168,-1.5,125,7.5,105,-125,158,1.5,-145,4.7,Nationals Park,1,-1
2021-06-11,2021,CHC,STL,8,5,-147,-1.5,135,9.5,-105,-115,137,1.5,-155,5.65,Wrigley Field,13,3
2021-06-11,2021,BAL,TB,2,4,164,1.5,-135,8.0,-105,-115,-178,-1.5,115,3.03,Tropicana Field,6,-2
2021-06-11,2021,LAD,TEX,12,1,-310,-1.5,-145,8.0,-110,-110,270,1.5,125,6.05,Dodger Stadium,13,11
2021-06-11,2021,BOS,TOR,6,5,-110,-1.5,155,9.5,-110,-110,100,1.5,-175,4.98,Fenway Park,11,1
2021-06-11,2021,SF,WSH,1,0,158,1.5,-145,7.5,105,-125,-168,-1.5,125,2.91,Nationals Park,1,1
2021-06-12,2021,LAA,ARI,8,7,-117,-1.5,135,9.0,100,-120,107,1.5,-155,4.85,Chase Field,15,1
2021-06-12,2021,MIA,ATL,4,2,145,1.5,-120,7.5,-120,100,-155,-1.5,100,3.06,Marlins Park,6,2
2021-06-12,2021,TB,BAL,5,4,-210,-1.5,-115,8.0,-110,-110,190,1.5,-105,5.42,Tropicana Field,9,1
2021-06-12,2021,TOR,BOS,7,2,108,1.5,-170,9.5,-105,-115,-118,-1.5,150,4.57,Fenway Park,9,5
2021-06-12,2021,STL,CHC,2,7,161,1.5,-135,8.5,-115,-105,-172,-1.5,115,3.26,Wrigley Field,9,-5
2021-06-12,2021,COL,CIN,3,10,140,1.5,-145,9.0,-110,-110,-150,-1.5,125,3.75,Great American Ballpark,13,-7
2021-06-12,2021,SEA,CLE,4,5,105,1.5,-180,8.0,-110,-110,-115,-1.5,160,3.9,Progressive Field,9,-1
2021-06-12,2021,CIN,COL,10,3,-150,-1.5,125,9.0,-110,-110,140,1.5,-145,5.4,Great American Ballpark,13,7
2021-06-12,2021,DET,CWS,2,15,162,1.5,-105,9.0,-120,100,-174,-1.5,-115,3.44,Comerica Park,17,-13
2021-06-12,2021,CWS,DET,15,2,-174,-1.5,-115,9.0,-120,100,162,1.5,-105,5.72,Comerica Park,17,13
2021-06-12,2021,MIN,HOU,5,2,-101,1.5,-165,9.0,-115,-105,-109,-1.5,145,4.52,Target Field,7,3
2021-06-12,2021,OAK,KC,11,2,-150,-1.5,120,9.0,-105,-115,140,1.5,-140,5.4,Oakland Coliseum,13,9
2021-06-12,2021,ARI,LAA,7,8,107,1.5,-155,9.0,100,-120,-117,-1.5,135,4.35,Chase Field,15,-1
2021-06-12,2021,TEX,LAD,12,1,236,1.5,110,8.0,-110,-110,-266,-1.5,-130,2.38,Dodger Stadium,13,11
2021-06-12,2021,ATL,MIA,2,4,-155,-1.5,100,7.5,-120,100,145,1.5,-120,4.56,Marlins Park,6,-2
2021-06-12,2021,PIT,MIL,4,7,250,1.5,115,7.5,-105,-115,-290,-1.5,-135,2.14,Miller Park,11,-3
2021-06-12,2021,HOU,MIN,2,5,-109,-1.5,145,9.0,-115,-105,-101,1.5,-165,4.69,Target Field,7,-3
2021-06-12,2021,SD,NYM,1,4,-138,-1.5,130,7.0,-105,-115,128,1.5,-150,4.06,Citi Field,5,-3
2021-06-12,2021,PHI,NYY,8,7,111,1.5,-150,9.0,-105,-115,-121,-1.5,130,4.27,Citizens Bank Park,15,1
2021-06-12,2021,KC,OAK,2,11,140,1.5,-140,9.0,-105,-115,-150,-1.5,120,3.75,Oakland Coliseum,13,-9
2021-06-12,2021,NYY,PHI,7,8,-121,-1.5,130,9.0,-105,-115,111,1.5,-150,4.93,Citizens Bank Park,15,-1
2021-06-12,2021,MIL,PIT,7,4,-290,-1.5,-135,7.5,-105,-115,250,1.5,115,5.58,Miller Park,11,3
2021-06-12,2021,NYM,SD,4,1,128,1.5,-150,7.0,-105,-115,-138,-1.5,130,3.07,Citi Field,5,3
2021-06-12,2021,CLE,SEA,5,4,-115,-1.5,160,8.0,-110,-110,105,1.5,-180,4.28,Progressive Field,9,1
2021-06-12,2021,WSH,SF,2,0,152,1.5,-135,6.0,-115,-105,-162,-1.5,115,2.38,Nationals Park,2,2
2021-06-12,2021,WSH,SF,1,2,105,1.5,-170,7.0,-105,-115,-115,-1.5,150,3.41,Nationals Park,3,-1
2021-06-12,2021,CHC,STL,7,2,-172,-1.5,115,8.5,-115,-105,161,1.5,-135,5.38,Wrigley Field,9,5
2021-06-12,2021,BAL,TB,4,5,190,1.5,-105,8.0,-110,-110,-210,-1.5,-115,2.76,Tropicana Field,9,-1
2021-06-12,2021,LAD,TEX,1,12,-266,-1.5,-130,8.0,-110,-110,236,1.5,110,5.81,Dodger Stadium,13,-11
2021-06-12,2021,BOS,TOR,2,7,-118,-1.5,150,9.5,-105,-115,108,1.5,-170,5.14,Fenway Park,9,-5
2021-06-12,2021,SF,WSH,0,2,-162,-1.5,115,6.0,-115,-105,152,1.5,-135,3.71,Nationals Park,2,-2
2021-06-12,2021,SF,WSH,2,1,-115,-1.5,150,7.0,-105,-115,105,1.5,-170,3.74,Nationals Park,3,1
2021-06-13,2021,LAA,ARI,10,3,-129,-1.5,120,9.5,-110,-110,119,1.5,-140,5.35,Chase Field,13,7
2021-06-13,2021,MIA,ATL,4,6,-126,-1.5,165,7.5,-120,100,116,1.5,-185,4.18,Marlins Park,10,-2
2021-06-13,2021,TB,BAL,7,1,-178,-1.5,115,8.0,-110,-110,164,1.5,-135,5.12,Tropicana Field,8,6
2021-06-13,2021,TOR,BOS,18,4,-129,-1.5,120,10.5,-110,-110,119,1.5,-140,5.91,Fenway Park,22,14
2021-06-13,2021,STL,CHC,0,2,114,1.5,-165,9.5,-110,-110,-124,-1.5,145,4.44,Wrigley Field,2,-2
2021-06-13,2021,COL,CIN,2,6,144,1.5,-140,10.0,-110,-110,-154,-1.5,120,4.1,Great American Ballpark,8,-4
2021-06-13,2021,SEA,CLE,6,2,205,1.5,105,7.5,-105,-115,-230,-1.5,-125,2.46,Progressive Field,8,4
2021-06-13,2021,CIN,COL,6,2,-154,-1.5,120,10.0,-110,-110,144,1.5,-140,6.06,Great American Ballpark,8,4
2021-06-13,2021,DET,CWS,1,4,200,1.5,125,9.0,-105,-115,-220,-1.5,-145,3.0,Comerica Park,5,-3
2021-06-13,2021,CWS,DET,4,1,-220,-1.5,-145,9.0,-105,-115,200,1.5,125,6.19,Comerica Park,5,3
2021-06-13,2021,MIN,HOU,3,14,135,1.5,-115,9.5,-115,-105,-145,-1.5,-105,4.04,Target Field,17,-11
2021-06-13,2021,OAK,KC,6,3,-192,-1.5,-105,8.5,-110,-110,176,1.5,-115,5.59,Oakland Coliseum,9,3
2021-06-13,2021,ARI,LAA,3,10,119,1.5,-140,9.5,-110,-110,-129,-1.5,120,4.34,Chase Field,13,-7
2021-06-13,2021,TEX,LAD,3,5,180,1.5,-120,8.0,-105,-115,-200,-1.5,100,2.86,Dodger Stadium,8,-2
2021-06-13,2021,ATL,MIA,6,4,116,1.5,-185,7.5,-120,100,-126,-1.5,165,3.47,Marlins Park,10,2
2021-06-13,2021,PIT,MIL,2,5,164,1.5,-140,8.5,-120,100,-178,-1.5,120,3.22,Miller Park,7,-3
2021-06-13,2021,HOU,MIN,14,3,-145,-1.5,-105,9.5,-115,-105,135,1.5,-115,5.62,Target Field,17,11
2021-06-13,2021,SD,NYM,7,3,-126,-1.5,130,8.0,-110,-110,116,1.5,-150,4.46,Citi Field,10,4
2021-06-13,2021,PHI,NYY,7,0,-126,-1.5,155,8.0,-110,-110,116,1.5,-175,4.46,Citizens Bank Park,7,7
2021-06-13,2021,KC,OAK,3,6,176,1.5,-115,8.5,-110,-110,-192,-1.5,-105,3.08,Oakland Coliseum,9,-3
2021-06-13,2021,NYY,PHI,0,7,116,1.5,-175,8.0,-110,-110,-126,-1.5,155,3.7,Citizens Bank Park,7,-7
2021-06-13,2021,MIL,PIT,5,2,-178,-1.5,120,8.5,-120,100,164,1.5,-140,5.44,Miller Park,7,3
2021-06-13,2021,NYM,SD,3,7,116,1.5,-150,8.0,-110,-110,-126,-1.5,130,3.7,Citi Field,10,-4
2021-06-13,2021,CLE,SEA,2,6,-230,-1.5,-125,7.5,-105,-115,205,1.5,105,5.23,Progressive Field,8,-4
2021-06-13,2021,WSH,SF,5,0,-104,1.5,-175,9.0,-110,-110,-106,-1.5,155,4.59,Nationals Park,5,5
2021-06-13,2021,CHC,STL,2,0,-124,-1.5,145,9.5,-110,-110,114,1.5,-165,5.26,Wrigley Field,2,2
2021-06-13,2021,BAL,TB,1,7,164,1.5,-135,8.0,-110,-110,-178,-1.5,115,3.03,Tropicana Field,8,-6
2021-06-13,2021,LAD,TEX,5,3,-200,-1.5,100,8.0,-105,-115,180,1.5,-120,5.33,Dodger Stadium,8,2
2021-06-13,2021,BOS,TOR,4,18,119,1.5,-140,10.5,-110,-110,-129,-1.5,120,4.79,Fenway Park,22,-14
2021-06-13,2021,SF,WSH,0,5,-106,-1.5,155,9.0,-110,-110,-104,1.5,-175,4.63,Nationals Park,5,-5
2021-06-14,2021,SF,ARI,5,2,-174,-1.5,110,8.0,-115,-105,162,1.5,-130,5.08,AT&T Park,7,3
2021-06-14,2021,CLE,BAL,4,3,-158,-1.5,120,8.5,-115,-105,148,1.5,-140,5.21,Progressive Field,7,1
2021-06-14,2021,TOR,BOS,1,2,124,1.5,-155,9.5,-115,-105,-134,-1.5,135,4.24,Fenway Park,3,-1
2021-06-14,2021,NYM,CHC,5,2,-130,-1.5,160,9.0,105,-125,120,1.5,-180,5.09,Citi Field,7,3
2021-06-14,2021,MIL,CIN,2,10,-135,-1.5,140,9.5,-120,100,125,1.5,-160,5.46,Miller Park,12,-8
2021-06-14,2021,BAL,CLE,3,4,148,1.5,-140,8.5,-115,-105,-158,-1.5,120,3.43,Progressive Field,7,-1
2021-06-14,2021,SD,COL,2,3,-150,-1.5,-105,11.5,100,-120,140,1.5,-115,6.9,Coors Field,5,-1
2021-06-14,2021,TB,CWS,5,2,-122,-1.5,135,7.0,-120,100,112,1.5,-155,3.85,Guaranteed Rate Field,7,3
2021-06-14,2021,KC,DET,3,10,-144,-1.5,130,9.5,-120,100,134,1.5,-150,5.61,Kauffman Stadium,13,-7
2021-06-14,2021,DET,KC,10,3,134,1.5,-150,9.5,-120,100,-144,-1.5,130,4.06,Kauffman Stadium,13,7
2021-06-14,2021,OAK,LAA,8,5,-140,-1.5,140,8.0,-115,-105,130,1.5,-160,4.67,Oakland Coliseum,13,3
2021-06-14,2021,PHI,LAD,1,3,158,1.5,-135,9.0,-120,100,-168,-1.5,115,3.49,Dodger Stadium,4,-2
2021-06-14,2021,STL,MIA,4,2,-200,-1.5,105,8.5,-110,-110,180,1.5,-125,5.67,Busch Stadium,6,2
2021-06-14,2021,CIN,MIL,10,2,125,1.5,-160,9.5,-120,100,-135,-1.5,140,4.22,Miller Park,12,8
2021-06-14,2021,SEA,MIN,4,3,130,1.5,-140,8.0,-110,-110,-140,-1.5,120,3.48,T-Mobile Park,7,1
2021-06-14,2021,CHC,NYM,2,5,120,1.5,-180,9.0,105,-125,-130,-1.5,160,4.09,Citi Field,7,-3
2021-06-14,2021,LAA,OAK,5,8,130,1.5,-160,8.0,-115,-105,-140,-1.5,140,3.48,Oakland Coliseum,13,-3
2021-06-14,2021,LAD,PHI,3,1,-168,-1.5,115,9.0,-120,100,158,1.5,-135,5.64,Dodger Stadium,4,2
2021-06-14,2021,WSH,PIT,3,2,-125,-1.5,165,8.5,-120,100,115,1.5,-185,4.72,Nationals Park,5,1
2021-06-14,2021,COL,SD,3,2,140,1.5,-115,11.5,100,-120,-150,-1.5,-105,4.79,Coors Field,5,1
2021-06-14,2021,MIN,SEA,3,4,-140,-1.5,120,8.0,-110,-110,130,1.5,-140,4.67,T-Mobile Park,7,-1
2021-06-14,2021,ARI,SF,2,5,162,1.5,-130,8.0,-115,-105,-174,-1.5,110,3.05,AT&T Park,7,-3
2021-06-14,2021,MIA,STL,2,4,180,1.5,-125,8.5,-110,-110,-200,-1.5,105,3.04,Busch Stadium,6,-2
2021-06-14,2021,CWS,TB,2,5,112,1.5,-155,7.0,-120,100,-122,-1.5,135,3.3,Guaranteed Rate Field,7,-3
2021-06-14,2021,BOS,TOR,2,1,-134,-1.5,135,9.5,-115,-105,124,1.5,-155,5.44,Fenway Park,3,1
2021-06-14,2021,PIT,WSH,2,3,115,1.5,-185,8.5,-120,100,-125,-1.5,165,3.95,Nationals Park,5,-1
2021-06-15,2021,SF,ARI,9,8,-176,-1.5,110,7.5,-120,100,163,1.5,-130,4.78,AT&T Park,17,1
2021-06-15,2021,BOS,ATL,10,8,105,1.5,-190,9.5,-110,-110,-115,-1.5,170,4.63,Suntrust Park,18,2
2021-06-15,2021,CLE,BAL,7,2,-165,-1.5,115,8.5,-115,-105,155,1.5,-135,5.29,Progressive Field,9,5
2021-06-15,2021,ATL,BOS,8,10,-115,-1.5,170,9.5,-110,-110,105,1.5,-190,5.08,Suntrust Park,18,-2
2021-06-15,2021,NYM,CHC,3,2,-132,-1.5,140,8.5,-115,-105,122,1.5,-160,4.84,Citi Field,5,1
2021-06-15,2021,MIL,CIN,1,2,-107,-1.5,180,9.0,-110,-110,-103,1.5,-205,4.65,Miller Park,3,-1
2021-06-15,2021,BAL,CLE,2,7,155,1.5,-135,8.5,-115,-105,-165,-1.5,115,3.33,Progressive Field,9,-5
2021-06-15,2021,SD,COL,4,8,-240,-1.5,-160,11.5,-110,-110,210,1.5,140,8.12,Coors Field,12,-4
2021-06-15,2021,TB,CWS,0,3,104,1.5,-185,8.0,-120,100,-114,-1.5,165,3.92,Guaranteed Rate Field,3,-3
2021-06-15,2021,KC,DET,3,4,-130,-1.5,145,8.5,-115,-105,120,1.5,-165,4.8,Kauffman Stadium,7,-1
2021-06-15,2021,TEX,HOU,3,6,170,1.5,-115,8.5,100,-120,-185,-1.5,-105,3.15,Minute Maid Park,9,-3
2021-06-15,2021,DET,KC,4,3,120,1.5,-165,8.5,-115,-105,-130,-1.5,145,3.86,Kauffman Stadium,7,1
2021-06-15,2021,OAK,LAA,6,4,-128,-1.5,155,8.0,-115,-105,118,1.5,-175,4.49,Oakland Coliseum,10,2
2021-06-15,2021,PHI,LAD,3,5,143,1.5,-145,8.5,-110,-110,-153,-1.5,125,3.5,Dodger Stadium,8,-2
2021-06-15,2021,STL,MIA,2,1,-125,-1.5,165,7.5,-110,-110,115,1.5,-185,4.17,Busch Stadium,3,1
2021-06-15,2021,CIN,MIL,2,1,-103,1.5,-205,9.0,-110,-110,-107,-1.5,180,4.57,Miller Park,3,1
2021-06-15,2021,SEA,MIN,10,0,120,1.5,-145,8.5,-115,-105,-130,-1.5,125,3.86,T-Mobile Park,10,10
2021-06-15,2021,CHC,NYM,2,3,122,1.5,-160,8.5,-115,-105,-132,-1.5,140,3.83,Citi Field,5,-1
2021-06-15,2021,TOR,NYY,5,6,-122,-1.5,155,9.5,-105,-115,112,1.5,-175,5.22,Sahlen Field,11,-1
2021-06-15,2021,LAA,OAK,4,6,118,1.5,-175,8.0,-115,-105,-128,-1.5,155,3.67,Oakland Coliseum,10,-2
2021-06-15,2021,LAD,PHI,5,3,-153,-1.5,125,8.5,-110,-110,143,1.5,-145,5.14,Dodger Stadium,8,2
2021-06-15,2021,WSH,PIT,8,1,-160,-1.5,115,8.5,-110,-110,150,1.5,-135,5.23,Nationals Park,9,7
2021-06-15,2021,COL,SD,8,4,210,1.5,140,11.5,-110,-110,-240,-1.5,-160,3.71,Coors Field,12,4
2021-06-15,2021,MIN,SEA,0,10,-130,-1.5,125,8.5,-115,-105,120,1.5,-145,4.8,T-Mobile Park,10,-10
2021-06-15,2021,ARI,SF,8,9,163,1.5,-130,7.5,-120,100,-176,-1.5,110,2.85,AT&T Park,17,-1
2021-06-15,2021,MIA,STL,1,2,115,1.5,-185,7.5,-110,-110,-125,-1.5,165,3.49,Busch Stadium,3,-1
2021-06-15,2021,CWS,TB,3,0,-114,-1.5,165,8.0,-120,100,104,1.5,-185,4.26,Guaranteed Rate Field,3,3
2021-06-15,2021,HOU,TEX,6,3,-185,-1.5,-105,8.5,100,-120,170,1.5,-115,5.52,Minute Maid Park,9,3
2021-06-15,2021,NYY,TOR,6,5,112,1.5,-175,9.5,-105,-115,-122,-1.5,155,4.48,Sahlen Field,11,1
2021-06-15,2021,PIT,WSH,1,8,150,1.5,-135,8.5,-110,-110,-160,-1.5,115,3.4,Nationals Park,9,-7
2021-06-16,2021,SF,ARI,13,7,-170,-1.5,115,8.0,-120,100,160,1.5,-135,5.04,AT&T Park,20,6
2021-06-16,2021,BOS,ATL,10,8,137,1.5,-150,9.5,100,-120,-147,-1.5,130,4.01,Suntrust Park,18,2
2021-06-16,2021,CLE,BAL,8,7,-158,-1.5,120,8.0,-110,-110,148,1.5,-140,4.9,Progressive Field,15,1
2021-06-16,2021,ATL,BOS,8,10,-147,-1.5,130,9.5,100,-120,137,1.5,-150,5.65,Suntrust Park,18,-2
2021-06-16,2021,NYM,CHC,6,3,-295,-1.5,-135,6.5,-115,-105,255,1.5,115,4.85,Citi Field,9,3
2021-06-16,2021,MIL,CIN,1,2,-136,-1.5,155,7.5,-120,100,126,1.5,-175,4.32,Miller Park,3,-1
2021-06-16,2021,BAL,CLE,7,8,148,1.5,-140,8.0,-110,-110,-158,-1.5,120,3.23,Progressive Field,15,-1
2021-06-16,2021,SD,COL,7,8,-200,-1.5,-145,12.0,-120,100,180,1.5,125,8.0,Coors Field,15,-1
2021-06-16,2021,TB,CWS,7,8,115,1.5,-175,7.5,-120,100,-125,-1.5,155,3.49,Guaranteed Rate Field,15,-1
2021-06-16,2021,KC,DET,5,6,-142,-1.5,130,9.0,-115,-105,132,1.5,-150,5.28,Kauffman Stadium,11,-1
2021-06-16,2021,TEX,HOU,4,8,204,1.5,110,9.0,-105,-115,-224,-1.5,-130,2.96,Minute Maid Park,12,-4
2021-06-16,2021,DET,KC,6,5,132,1.5,-150,9.0,-115,-105,-142,-1.5,130,3.88,Kauffman Stadium,11,1
2021-06-16,2021,OAK,LAA,8,4,-118,-1.5,160,9.5,-105,-115,108,1.5,-180,5.14,Oakland Coliseum,12,4
2021-06-16,2021,PHI,LAD,2,0,137,1.5,-165,7.0,100,-120,-147,-1.5,145,2.95,Dodger Stadium,2,2
2021-06-16,2021,STL,MIA,1,0,-113,-1.5,175,7.5,105,-125,103,1.5,-200,3.98,Busch Stadium,1,1
2021-06-16,2021,CIN,MIL,2,1,126,1.5,-175,7.5,-120,100,-136,-1.5,155,3.32,Miller Park,3,1
2021-06-16,2021,SEA,MIN,2,7,122,1.5,-145,8.5,-115,-105,-132,-1.5,125,3.83,T-Mobile Park,9,-5
2021-06-16,2021,CHC,NYM,3,6,255,1.5,115,6.5,-115,-105,-295,-1.5,-135,1.83,Citi Field,9,-3
2021-06-16,2021,TOR,NYY,2,3,148,1.5,-110,8.5,-120,100,-158,-1.5,-110,3.43,Sahlen Field,5,-1
2021-06-16,2021,LAA,OAK,4,8,108,1.5,-180,9.5,-105,-115,-118,-1.5,160,4.57,Oakland Coliseum,12,-4
2021-06-16,2021,LAD,PHI,0,2,-147,-1.5,145,7.0,100,-120,137,1.5,-165,4.17,Dodger Stadium,2,-2
2021-06-16,2021,WSH,PIT,3,1,-162,-1.5,120,9.0,-120,100,152,1.5,-140,5.56,Nationals Park,4,2
2021-06-16,2021,COL,SD,8,7,180,1.5,125,12.0,-120,100,-200,-1.5,-145,4.29,Coors Field,15,1
2021-06-16,2021,MIN,SEA,7,2,-132,-1.5,125,8.5,-115,-105,122,1.5,-145,4.84,T-Mobile Park,9,5
2021-06-16,2021,ARI,SF,7,13,160,1.5,-135,8.0,-120,100,-170,-1.5,115,3.08,AT&T Park,20,-6
2021-06-16,2021,MIA,STL,0,1,103,1.5,-200,7.5,105,-125,-113,-1.5,175,3.69,Busch Stadium,1,-1
2021-06-16,2021,CWS,TB,8,7,-125,-1.5,155,7.5,-120,100,115,1.5,-175,4.17,Guaranteed Rate Field,15,1
2021-06-16,2021,HOU,TEX,8,4,-224,-1.5,-130,9.0,-105,-115,204,1.5,110,6.22,Minute Maid Park,12,4
2021-06-16,2021,NYY,TOR,3,2,-158,-1.5,-110,8.5,-120,100,148,1.5,-110,5.21,Sahlen Field,5,1
2021-06-16,2021,PIT,WSH,1,3,152,1.5,-140,9.0,-120,100,-162,-1.5,120,3.57,Nationals Park,4,-2
2021-06-17,2021,SF,ARI,10,3,-210,-1.5,-115,7.0,-120,100,190,1.5,-105,4.74,AT&T Park,13,7
2021-06-17,2021,STL,ATL,0,4,167,1.5,-120,9.5,100,-120,-182,-1.5,100,3.56,Suntrust Park,4,-4
2021-06-17,2021,CLE,BAL,10,3,-116,-1.5,160,9.5,-110,-110,106,1.5,-180,5.1,Progressive Field,13,7
2021-06-17,2021,NYM,CHC,0,2,-113,-1.5,180,7.5,-110,-110,103,1.5,-205,3.98,Citi Field,2,-2
2021-06-17,2021,SD,CIN,6,4,-176,-1.5,115,7.5,-115,-105,163,1.5,-135,4.78,PETCO Park,10,2
2021-06-17,2021,BAL,CLE,3,10,106,1.5,-180,9.5,-110,-110,-116,-1.5,160,4.61,Progressive Field,13,-7
2021-06-17,2021,MIL,COL,3,7,-154,-1.5,-110,10.5,-115,-105,144,1.5,-110,6.37,Coors Field,10,-4
2021-06-17,2021,HOU,CWS,10,2,-130,-1.5,140,9.0,100,-120,120,1.5,-160,5.09,Minute Maid Park,12,8
2021-06-17,2021,LAA,DET,7,5,-219,-1.5,-120,9.0,100,-120,199,1.5,100,6.18,Angel Stadium,12,2
2021-06-17,2021,CWS,HOU,2,10,120,1.5,-160,9.0,100,-120,-130,-1.5,140,4.09,Minute Maid Park,12,-8
2021-06-17,2021,DET,LAA,5,7,199,1.5,100,9.0,100,-120,-219,-1.5,-120,3.01,Angel Stadium,12,-2
2021-06-17,2021,COL,MIL,7,3,144,1.5,-110,10.5,-115,-105,-154,-1.5,-110,4.3,Coors Field,10,4
2021-06-17,2021,CHC,NYM,2,0,103,1.5,-205,7.5,-110,-110,-113,-1.5,180,3.69,Citi Field,2,2
2021-06-17,2021,TOR,NYY,4,8,-104,1.5,-155,10.5,-110,-110,-106,-1.5,135,5.35,Sahlen Field,12,-4
2021-06-17,2021,CIN,SD,4,6,163,1.5,-135,7.5,-115,-105,-176,-1.5,115,2.85,PETCO Park,10,-2
2021-06-17,2021,TB,SEA,5,6,-170,-1.5,-115,8.5,-105,-115,160,1.5,-105,5.35,T-Mobile Park,11,-1
2021-06-17,2021,ARI,SF,3,10,190,1.5,-105,7.0,-120,100,-210,-1.5,-115,2.41,AT&T Park,13,-7
2021-06-17,2021,ATL,STL,4,0,-182,-1.5,100,9.5,100,-120,167,1.5,-120,6.13,Suntrust Park,4,4
2021-06-17,2021,SEA,TB,6,5,160,1.5,-105,8.5,-105,-115,-170,-1.5,-115,3.27,T-Mobile Park,11,1
2021-06-17,2021,NYY,TOR,8,4,-106,-1.5,135,10.5,-110,-110,-104,1.5,-155,5.4,Sahlen Field,12,4
2021-06-18,2021,LAD,ARI,3,0,-196,-1.5,-135,9.5,-105,-115,178,1.5,115,6.29,Chase Field,3,3
2021-06-18,2021,STL,ATL,1,9,141,1.5,-140,9.5,-110,-110,-151,-1.5,120,3.94,Suntrust Park,10,-8
2021-06-18,2021,TOR,BAL,1,7,-200,-1.5,-140,10.5,-110,-110,180,1.5,120,7.0,Camden Yards,8,-6
2021-06-18,2021,KC,BOS,5,3,137,1.5,-120,10.5,-115,-105,-147,-1.5,100,4.43,Kauffman Stadium,8,2
2021-06-18,2021,MIA,CHC,10,2,149,1.5,-145,8.5,-120,100,-159,-1.5,125,3.41,Wrigley Field,12,8
2021-06-18,2021,SD,CIN,8,2,-186,-1.5,105,9.0,105,-125,171,1.5,-125,5.85,PETCO Park,10,6
2021-06-18,2021,PIT,CLE,11,10,119,1.5,-145,9.0,-110,-110,-129,-1.5,125,4.11,PNC Park,21,1
2021-06-18,2021,MIL,COL,5,6,-181,-1.5,-130,10.5,-105,-115,166,1.5,110,6.76,Coors Field,11,-1
2021-06-18,2021,HOU,CWS,2,1,-107,1.5,-170,7.5,-120,100,-103,-1.5,150,3.88,Minute Maid Park,3,1
2021-06-18,2021,LAA,DET,11,3,-205,-1.5,-115,9.0,-120,100,185,1.5,-105,6.05,Angel Stadium,14,8
2021-06-18,2021,CWS,HOU,1,2,-103,-1.5,150,7.5,-120,100,-107,1.5,-170,3.81,Minute Maid Park,3,-1
2021-06-18,2021,BOS,KC,3,5,-147,-1.5,100,10.5,-115,-105,137,1.5,-120,6.25,Kauffman Stadium,8,-2
2021-06-18,2021,DET,LAA,3,11,185,1.5,-105,9.0,-120,100,-205,-1.5,-115,3.16,Angel Stadium,14,-8
2021-06-18,2021,ARI,LAD,0,3,178,1.5,115,9.5,-105,-115,-196,-1.5,-135,3.42,Chase Field,3,-3
2021-06-18,2021,CHC,MIA,2,10,-159,-1.5,125,8.5,-120,100,149,1.5,-145,5.22,Wrigley Field,12,-8
2021-06-18,2021,COL,MIL,6,5,166,1.5,110,10.5,-105,-115,-181,-1.5,-130,3.95,Coors Field,11,1
2021-06-18,2021,TEX,MIN,5,7,145,1.5,-120,8.5,-120,100,-155,-1.5,100,3.47,Globe Life Field,12,-2
2021-06-18,2021,WSH,NYM,1,0,-129,-1.5,160,9.0,-115,-105,119,1.5,-180,5.07,Nationals Park,1,1
2021-06-18,2021,OAK,NYY,5,3,128,1.5,-155,9.5,-115,-105,-138,-1.5,135,4.17,Yankee Stadium,8,2
2021-06-18,2021,NYY,OAK,3,5,-138,-1.5,135,9.5,-115,-105,128,1.5,-155,5.51,Yankee Stadium,8,-2
2021-06-18,2021,SF,PHI,5,3,-138,-1.5,150,8.5,-105,-115,128,1.5,-170,4.93,AT&T Park,8,2
2021-06-18,2021,CLE,PIT,10,11,-129,-1.5,125,9.0,-110,-110,119,1.5,-145,5.07,PNC Park,21,-1
2021-06-18,2021,CIN,SD,2,8,171,1.5,-125,9.0,105,-125,-186,-1.5,105,3.32,PETCO Park,10,-6
2021-06-18,2021,TB,SEA,1,5,-101,1.5,-215,7.5,-120,100,-109,-1.5,190,3.77,T-Mobile Park,6,-4
2021-06-18,2021,PHI,SF,3,5,128,1.5,-170,8.5,-105,-115,-138,-1.5,150,3.73,AT&T Park,8,-2
2021-06-18,2021,ATL,STL,9,1,-151,-1.5,120,9.5,-110,-110,141,1.5,-140,5.72,Suntrust Park,10,8
2021-06-18,2021,SEA,TB,5,1,-109,-1.5,190,7.5,-120,100,-101,1.5,-215,3.91,T-Mobile Park,6,4
2021-06-18,2021,MIN,TEX,7,5,-155,-1.5,100,8.5,-120,100,145,1.5,-120,5.17,Globe Life Field,12,2
2021-06-18,2021,BAL,TOR,7,1,180,1.5,120,10.5,-110,-110,-200,-1.5,-140,3.75,Camden Yards,8,6
2021-06-18,2021,NYM,WSH,0,1,119,1.5,-180,9.0,-115,-105,-129,-1.5,160,4.11,Nationals Park,1,-1
2021-06-19,2021,LAD,ARI,9,3,-230,-1.5,-155,9.0,-110,-110,205,1.5,135,6.27,Chase Field,12,6
2021-06-19,2021,TOR,BAL,10,7,-155,-1.5,-115,10.0,-115,-105,145,1.5,-105,6.08,Camden Yards,17,3
2021-06-19,2021,KC,BOS,1,7,104,1.5,-145,11.0,100,-120,-114,-1.5,125,5.39,Kauffman Stadium,8,-6
2021-06-19,2021,MIA,CHC,11,1,116,1.5,-175,9.0,-110,-110,-126,-1.5,155,4.17,Wrigley Field,12,10
2021-06-19,2021,SD,CIN,7,5,-149,-1.5,135,9.0,100,-120,139,1.5,-155,5.39,PETCO Park,12,2
2021-06-19,2021,PIT,CLE,6,3,103,1.5,-155,8.5,-120,100,-113,-1.5,135,4.19,PNC Park,9,3
2021-06-19,2021,MIL,COL,6,5,105,1.5,-175,10.5,-120,100,-115,-1.5,155,5.12,Coors Field,11,1
2021-06-19,2021,HOU,CWS,7,3,-123,-1.5,170,7.5,-110,-110,113,1.5,-190,4.14,Minute Maid Park,10,4
2021-06-19,2021,LAA,DET,8,3,-206,-1.5,-115,9.5,100,-120,186,1.5,-105,6.4,Angel Stadium,11,5
2021-06-19,2021,CWS,HOU,3,7,113,1.5,-190,7.5,-110,-110,-123,-1.5,170,3.52,Minute Maid Park,10,-4
2021-06-19,2021,BOS,KC,7,1,-114,-1.5,125,11.0,100,-120,104,1.5,-145,5.86,Kauffman Stadium,8,6
2021-06-19,2021,DET,LAA,3,8,186,1.5,-105,9.5,100,-120,-206,-1.5,-115,3.32,Angel Stadium,11,-5
2021-06-19,2021,ARI,LAD,3,9,205,1.5,135,9.0,-110,-110,-230,-1.5,-155,2.95,Chase Field,12,-6
2021-06-19,2021,CHC,MIA,1,11,-126,-1.5,155,9.0,-110,-110,116,1.5,-175,5.02,Wrigley Field,12,-10
2021-06-19,2021,COL,MIL,5,6,-115,-1.5,155,10.5,-120,100,105,1.5,-175,5.62,Coors Field,11,-1
2021-06-19,2021,TEX,MIN,2,3,-108,-1.5,175,9.0,-110,-110,-102,1.5,-200,4.67,Globe Life Field,5,-1
2021-06-19,2021,WSH,NYM,1,5,-125,-1.5,185,6.5,-130,110,115,1.5,-210,3.61,Nationals Park,6,-4
2021-06-19,2021,WSH,NYM,6,2,-116,-1.5,180,7.0,-110,-110,106,1.5,-205,3.76,Nationals Park,8,4
2021-06-19,2021,OAK,NYY,5,7,115,1.5,-170,9.5,-110,-110,-125,-1.5,150,4.42,Yankee Stadium,12,-2
2021-06-19,2021,NYY,OAK,7,5,-125,-1.5,150,9.5,-110,-110,115,1.5,-170,5.28,Yankee Stadium,12,2
2021-06-19,2021,SF,PHI,6,13,-115,-1.5,185,7.5,-115,-105,105,1.5,-210,4.01,AT&T Park,19,-7
2021-06-19,2021,CLE,PIT,3,6,-113,-1.5,135,8.5,-120,100,103,1.5,-155,4.51,PNC Park,9,-3
2021-06-19,2021,CIN,SD,5,7,139,1.5,-155,9.0,100,-120,-149,-1.5,135,3.77,PETCO Park,12,-2
2021-06-19,2021,TB,SEA,5,6,-140,-1.5,120,7.5,-110,-110,130,1.5,-140,4.38,T-Mobile Park,11,-1
2021-06-19,2021,PHI,SF,13,6,105,1.5,-210,7.5,-115,-105,-115,-1.5,185,3.66,AT&T Park,19,7
2021-06-19,2021,SEA,TB,6,5,130,1.5,-140,7.5,-110,-110,-140,-1.5,120,3.26,T-Mobile Park,11,1
2021-06-19,2021,MIN,TEX,3,2,-102,1.5,-200,9.0,-110,-110,-108,-1.5,175,4.54,Globe Life Field,5,1
2021-06-19,2021,BAL,TOR,7,10,145,1.5,-105,10.0,-115,-105,-155,-1.5,-115,4.08,Camden Yards,17,-3
2021-06-19,2021,NYM,WSH,5,1,115,1.5,-210,6.5,-130,110,-125,-1.5,185,3.02,Nationals Park,6,4
2021-06-19,2021,NYM,WSH,2,6,106,1.5,-205,7.0,-110,-110,-116,-1.5,180,3.4,Nationals Park,8,-4
2021-06-20,2021,LAD,ARI,9,8,-172,-1.5,-125,9.0,-110,-110,161,1.5,105,5.69,Chase Field,17,1
2021-06-20,2021,STL,ATL,9,1,104,1.5,-215,7.5,100,-120,-114,-1.5,190,3.68,Suntrust Park,10,8
2021-06-20,2021,STL,ATL,0,1,120,1.5,-180,7.5,-120,100,-130,-1.5,160,3.41,Suntrust Park,1,-1
2021-06-20,2021,TOR,BAL,7,4,-176,-1.5,-125,10.5,-110,-110,163,1.5,105,6.7,Camden Yards,11,3
2021-06-20,2021,KC,BOS,7,3,122,1.5,-130,9.5,-115,-105,-132,-1.5,110,4.28,Kauffman Stadium,10,4
2021-06-20,2021,MIA,CHC,0,2,133,1.5,-145,9.5,100,-120,-143,-1.5,125,4.08,Wrigley Field,2,-2
2021-06-20,2021,SD,CIN,3,2,-127,-1.5,150,8.0,100,-120,117,1.5,-170,4.48,PETCO Park,5,1
2021-06-20,2021,PIT,CLE,1,2,-132,-1.5,150,8.0,-110,-110,122,1.5,-170,4.55,PNC Park,3,-1
2021-06-20,2021,MIL,COL,7,6,-132,-1.5,110,12.0,-110,-110,122,1.5,-130,6.83,Coors Field,13,1
2021-06-20,2021,HOU,CWS,8,2,-136,-1.5,135,8.5,-105,-115,126,1.5,-155,4.9,Minute Maid Park,10,6
2021-06-20,2021,LAA,DET,3,5,-160,-1.5,120,9.5,100,-120,150,1.5,-140,5.85,Angel Stadium,8,-2
2021-06-20,2021,CWS,HOU,2,8,126,1.5,-155,8.5,-105,-115,-136,-1.5,135,3.76,Minute Maid Park,10,-6
2021-06-20,2021,BOS,KC,3,7,-132,-1.5,110,9.5,-115,-105,122,1.5,-130,5.41,Kauffman Stadium,10,-4
2021-06-20,2021,DET,LAA,5,3,150,1.5,-140,9.5,100,-120,-160,-1.5,120,3.8,Angel Stadium,8,2
2021-06-20,2021,ARI,LAD,8,9,161,1.5,105,9.0,-110,-110,-172,-1.5,-125,3.45,Chase Field,17,-1
2021-06-20,2021,CHC,MIA,2,0,-143,-1.5,125,9.5,100,-120,133,1.5,-145,5.59,Wrigley Field,2,2
2021-06-20,2021,COL,MIL,6,7,122,1.5,-130,12.0,-110,-110,-132,-1.5,110,5.41,Coors Field,13,-1
2021-06-20,2021,TEX,MIN,2,4,112,1.5,-150,8.0,-120,100,-122,-1.5,130,3.77,Globe Life Field,6,-2
2021-06-20,2021,WSH,NYM,5,2,-114,1.5,-170,8.5,-120,100,104,-1.5,150,4.53,Nationals Park,7,3
2021-06-20,2021,OAK,NYY,1,2,129,1.5,-155,10.0,-105,-115,-139,-1.5,135,4.37,Yankee Stadium,3,-1
2021-06-20,2021,NYY,OAK,2,1,-139,-1.5,135,10.0,-105,-115,129,1.5,-155,5.82,Yankee Stadium,3,1
2021-06-20,2021,SF,PHI,11,2,-122,-1.5,160,8.0,-105,-115,112,1.5,-180,4.4,AT&T Park,13,9
2021-06-20,2021,CLE,PIT,2,1,122,1.5,-170,8.0,-110,-110,-132,-1.5,150,3.6,PNC Park,3,1
2021-06-20,2021,CIN,SD,2,3,117,1.5,-170,8.0,100,-120,-127,-1.5,150,3.69,PETCO Park,5,-1
2021-06-20,2021,TB,SEA,2,6,-155,-1.5,100,8.5,-105,-115,145,1.5,-120,5.17,T-Mobile Park,8,-4
2021-06-20,2021,PHI,SF,2,11,112,1.5,-180,8.0,-105,-115,-122,-1.5,160,3.77,AT&T Park,13,-9
2021-06-20,2021,ATL,STL,1,9,-114,-1.5,190,7.5,100,-120,104,1.5,-215,4.0,Suntrust Park,10,-8
2021-06-20,2021,ATL,STL,1,0,-130,-1.5,160,7.5,-120,100,120,1.5,-180,4.24,Suntrust Park,1,1
2021-06-20,2021,SEA,TB,6,2,145,1.5,-120,8.5,-105,-115,-155,-1.5,100,3.47,T-Mobile Park,8,4
2021-06-20,2021,MIN,TEX,4,2,-122,-1.5,130,8.0,-120,100,112,1.5,-150,4.4,Globe Life Field,6,2
2021-06-20,2021,BAL,TOR,4,7,163,1.5,105,10.5,-110,-110,-176,-1.5,-125,3.99,Camden Yards,11,-3
2021-06-20,2021,NYM,WSH,2,5,104,-1.5,150,8.5,-120,100,-114,1.5,-170,4.17,Nationals Park,7,-3
2021-06-21,2021,MIL,ARI,1,5,-122,-1.5,125,9.5,100,-120,112,1.5,-145,5.22,Chase Field,6,-4
2021-06-21,2021,NYM,ATL,4,2,-260,-1.5,-115,5.0,105,-125,230,1.5,-105,3.61,Citi Field,6,2
2021-06-21,2021,NYM,ATL,0,1,129,1.5,-155,6.5,-105,-115,-139,-1.5,135,2.84,Citi Field,1,-1
2021-06-21,2021,HOU,BAL,10,2,-163,-1.5,-120,10.5,-125,105,153,1.5,100,6.51,Camden Yards,12,8
2021-06-21,2021,CLE,CHC,4,0,128,1.5,-165,7.0,-120,100,-138,-1.5,145,3.07,Wrigley Field,4,4
2021-06-21,2021,MIN,CIN,7,5,102,1.5,-155,9.5,100,-120,-112,-1.5,135,4.7,Target Field,12,2
2021-06-21,2021,CHC,CLE,0,4,-138,-1.5,145,7.0,-120,100,128,1.5,-165,4.06,Wrigley Field,4,-4
2021-06-21,2021,BAL,HOU,2,10,153,1.5,100,10.5,-125,105,-163,-1.5,-120,4.15,Camden Yards,12,-8
2021-06-21,2021,SD,LAD,6,2,-132,-1.5,155,7.0,-125,105,122,1.5,-175,3.98,PETCO Park,8,4
2021-06-21,2021,ARI,MIL,5,1,112,1.5,-145,9.5,100,-120,-122,-1.5,125,4.48,Chase Field,6,4
2021-06-21,2021,CIN,MIN,5,7,-112,-1.5,135,9.5,100,-120,102,1.5,-155,5.02,Target Field,12,-2
2021-06-21,2021,ATL,NYM,2,4,230,1.5,-105,5.0,105,-125,-260,-1.5,-115,1.52,Citi Field,6,-2
2021-06-21,2021,ATL,NYM,1,0,-139,-1.5,135,6.5,-105,-115,129,1.5,-155,3.78,Citi Field,1,1
2021-06-21,2021,TEX,OAK,8,3,108,1.5,-150,8.0,-110,-110,-118,-1.5,130,3.85,Globe Life Field,11,5
2021-06-21,2021,LAD,SD,2,6,122,1.5,-175,7.0,-125,105,-132,-1.5,155,3.15,PETCO Park,8,-4
2021-06-21,2021,OAK,TEX,3,8,-118,-1.5,130,8.0,-110,-110,108,1.5,-150,4.33,Globe Life Field,11,-5
2021-06-22,2021,MIL,ARI,5,0,-139,-1.5,115,8.0,-105,-115,129,1.5,-135,4.65,Chase Field,5,5
2021-06-22,2021,NYM,ATL,0,3,-104,1.5,-175,7.0,-110,-110,-106,-1.5,155,3.57,Citi Field,3,-3
2021-06-22,2021,HOU,BAL,3,1,-188,-1.5,-135,9.0,-120,100,173,1.5,115,5.88,Camden Yards,4,2
2021-06-22,2021,TB,BOS,5,9,-116,-1.5,155,8.0,100,-120,106,1.5,-175,4.3,Tropicana Field,14,-4
2021-06-22,2021,CLE,CHC,1,7,180,1.5,-115,8.5,-120,100,-200,-1.5,-105,3.04,Wrigley Field,8,-6
2021-06-22,2021,MIN,CIN,7,10,-122,-1.5,160,9.0,100,-120,112,1.5,-180,4.95,Target Field,17,-3
2021-06-22,2021,CHC,CLE,7,1,-200,-1.5,-105,8.5,-120,100,180,1.5,-115,5.67,Wrigley Field,8,6
2021-06-22,2021,SEA,COL,2,1,-158,-1.5,120,8.5,-115,-105,148,1.5,-140,5.21,T-Mobile Park,3,1
2021-06-22,2021,PIT,CWS,6,3,154,1.5,-105,7.5,-120,100,-164,-1.5,-115,2.95,PNC Park,9,3
2021-06-22,2021,STL,DET,2,8,-115,-1.5,135,8.5,-120,100,105,1.5,-155,4.55,Comerica Park,10,-6
2021-06-22,2021,BAL,HOU,1,3,173,1.5,115,9.0,-120,100,-188,-1.5,-135,3.3,Camden Yards,4,-2
2021-06-22,2021,NYY,KC,5,6,-265,-1.5,-130,7.5,-115,-105,235,1.5,110,5.45,Yankee Stadium,11,-1
2021-06-22,2021,SF,LAA,5,0,114,1.5,-175,9.0,100,-120,-124,-1.5,155,4.21,Angel Stadium,5,5
2021-06-22,2021,SD,LAD,3,2,114,1.5,-160,7.5,-120,100,-124,-1.5,140,3.5,PETCO Park,5,1
2021-06-22,2021,TOR,MIA,2,1,103,1.5,-205,7.5,-115,-105,-113,-1.5,180,3.69,Marlins Park,3,1
2021-06-22,2021,ARI,MIL,0,5,129,1.5,-135,8.0,-105,-115,-139,-1.5,115,3.49,Chase Field,5,-5
2021-06-22,2021,CIN,MIN,10,7,112,1.5,-180,9.0,100,-120,-122,-1.5,160,4.25,Target Field,17,3
2021-06-22,2021,ATL,NYM,3,0,-106,-1.5,155,7.0,-110,-110,-104,1.5,-175,3.6,Citi Field,3,3
2021-06-22,2021,KC,NYY,6,5,235,1.5,110,7.5,-115,-105,-265,-1.5,-130,2.24,Yankee Stadium,11,1
2021-06-22,2021,TEX,OAK,6,13,118,1.5,-135,9.0,-120,100,-128,-1.5,115,4.13,Globe Life Field,19,-7
2021-06-22,2021,WSH,PHI,3,2,-101,1.5,-220,6.5,-105,-115,-109,-1.5,195,3.27,Citizens Bank Park,5,1
2021-06-22,2021,CWS,PIT,3,6,-164,-1.5,-115,7.5,-120,100,154,1.5,-105,4.66,PNC Park,9,-3
2021-06-22,2021,LAD,SD,2,3,-124,-1.5,140,7.5,-120,100,114,1.5,-160,4.15,PETCO Park,5,-1
2021-06-22,2021,COL,SEA,1,2,148,1.5,-140,8.5,-115,-105,-158,-1.5,120,3.43,T-Mobile Park,3,-1
2021-06-22,2021,LAA,SF,0,5,-124,-1.5,155,9.0,100,-120,114,1.5,-175,4.98,Angel Stadium,5,-5
2021-06-22,2021,DET,STL,8,2,105,1.5,-155,8.5,-120,100,-115,-1.5,135,4.15,Comerica Park,10,6
2021-06-22,2021,BOS,TB,9,5,106,1.5,-175,8.0,100,-120,-116,-1.5,155,3.88,Tropicana Field,14,4
2021-06-22,2021,OAK,TEX,13,6,-128,-1.5,115,9.0,-120,100,118,1.5,-135,5.05,Globe Life Field,19,7
2021-06-22,2021,MIA,TOR,1,2,-113,-1.5,180,7.5,-115,-105,103,1.5,-205,3.98,Marlins Park,3,-1
2021-06-22,2021,PHI,WSH,2,3,-109,-1.5,195,6.5,-105,-115,-101,1.5,-220,3.39,Citizens Bank Park,5,-1
2021-06-23,2021,MIL,ARI,3,2,-215,-1.5,-135,7.5,100,-120,195,1.5,115,5.12,Chase Field,5,1
2021-06-23,2021,NYM,ATL,7,3,-138,-1.5,150,8.5,-115,-105,128,1.5,-170,4.93,Citi Field,10,4
2021-06-23,2021,HOU,BAL,13,0,-205,-1.5,-140,9.5,-115,-105,185,1.5,120,6.39,Camden Yards,13,13
2021-06-23,2021,TB,BOS,8,2,-144,-1.5,135,9.0,-105,-115,134,1.5,-155,5.31,Tropicana Field,10,6
2021-06-23,2021,SEA,COL,2,5,100,1.5,-165,8.5,-105,-115,-110,-1.5,145,4.25,T-Mobile Park,7,-3
2021-06-23,2021,PIT,CWS,3,4,147,1.5,-120,8.5,-105,-115,-157,-1.5,100,3.44,PNC Park,7,-1
2021-06-23,2021,STL,DET,2,6,-115,-1.5,130,9.0,-120,100,105,1.5,-150,4.81,Comerica Park,8,-4
2021-06-23,2021,BAL,HOU,0,13,185,1.5,120,9.5,-115,-105,-205,-1.5,-140,3.33,Camden Yards,13,-13
2021-06-23,2021,NYY,KC,6,5,-174,-1.5,105,10.0,-105,-115,162,1.5,-125,6.35,Yankee Stadium,11,1
2021-06-23,2021,SF,LAA,9,3,-118,-1.5,135,8.0,-110,-110,108,1.5,-155,4.33,Angel Stadium,12,6
2021-06-23,2021,SD,LAD,5,3,-112,-1.5,185,7.5,-115,-105,102,1.5,-210,3.96,PETCO Park,8,2
2021-06-23,2021,TOR,MIA,3,1,-117,-1.5,140,7.5,100,-120,107,1.5,-160,4.04,Marlins Park,4,2
2021-06-23,2021,ARI,MIL,2,3,195,1.5,115,7.5,100,-120,-215,-1.5,-135,2.54,Chase Field,5,-1
2021-06-23,2021,ATL,NYM,3,7,128,1.5,-170,8.5,-115,-105,-138,-1.5,150,3.73,Citi Field,10,-4
2021-06-23,2021,KC,NYY,5,6,162,1.5,-125,10.0,-105,-115,-174,-1.5,105,3.82,Yankee Stadium,11,-1
2021-06-23,2021,TEX,OAK,5,3,128,1.5,-125,9.0,-115,-105,-138,-1.5,105,3.95,Globe Life Field,8,2
2021-06-23,2021,WSH,PHI,13,12,-101,1.5,-205,9.0,-110,-110,-109,-1.5,180,4.52,Citizens Bank Park,25,1
2021-06-23,2021,CWS,PIT,4,3,-157,-1.5,100,8.5,-105,-115,147,1.5,-120,5.19,PNC Park,7,1
2021-06-23,2021,LAD,SD,3,5,102,1.5,-210,7.5,-115,-105,-112,-1.5,185,3.71,PETCO Park,8,-2
2021-06-23,2021,COL,SEA,5,2,-110,-1.5,145,8.5,-105,-115,100,1.5,-165,4.45,T-Mobile Park,7,3
2021-06-23,2021,LAA,SF,3,9,108,1.5,-155,8.0,-110,-110,-118,-1.5,135,3.85,Angel Stadium,12,-6
2021-06-23,2021,DET,STL,6,2,105,1.5,-150,9.0,-120,100,-115,-1.5,130,4.39,Comerica Park,8,4
2021-06-23,2021,BOS,TB,2,8,134,1.5,-155,9.0,-105,-115,-144,-1.5,135,3.85,Tropicana Field,10,-6
2021-06-23,2021,OAK,TEX,3,5,-138,-1.5,105,9.0,-115,-105,128,1.5,-125,5.22,Globe Life Field,8,-2
2021-06-23,2021,MIA,TOR,1,3,107,1.5,-160,7.5,100,-120,-117,-1.5,140,3.62,Marlins Park,4,-2
2021-06-23,2021,PHI,WSH,12,13,-109,-1.5,180,9.0,-110,-110,-101,1.5,-205,4.69,Citizens Bank Park,25,-1
2021-06-24,2021,CIN,ATL,5,3,-131,-1.5,140,11.0,100,-120,121,1.5,-160,6.24,Great American Ballpark,8,2
2021-06-24,2021,TOR,BAL,9,0,-188,-1.5,-105,10.5,-105,-115,173,1.5,-115,6.85,Sahlen Field,9,9
2021-06-24,2021,TB,BOS,1,0,-111,-1.5,165,9.0,-105,-115,101,1.5,-185,4.73,Tropicana Field,1,1
2021-06-24,2021,LAD,CHC,0,4,-250,-1.5,-130,8.5,-110,-110,220,1.5,110,6.07,Dodger Stadium,4,-4
2021-06-24,2021,ATL,CIN,3,5,121,1.5,-160,11.0,100,-120,-131,-1.5,140,4.98,Great American Ballpark,8,-2
2021-06-24,2021,MIN,CLE,1,4,-183,-1.5,105,9.0,-120,100,168,1.5,-125,5.82,Target Field,5,-3
2021-06-24,2021,HOU,DET,12,3,-230,-1.5,-155,9.5,-115,-105,205,1.5,135,6.62,Comerica Park,15,9
2021-06-24,2021,DET,HOU,3,12,205,1.5,135,9.5,-115,-105,-230,-1.5,-155,3.11,Comerica Park,15,-9
2021-06-24,2021,NYY,KC,8,1,-200,-1.5,-115,9.0,-105,-115,180,1.5,-105,6.0,Yankee Stadium,9,7
2021-06-24,2021,CHC,LAD,4,0,220,1.5,110,8.5,-110,-110,-250,-1.5,-130,2.66,Dodger Stadium,4,4
2021-06-24,2021,WSH,MIA,7,3,-119,-1.5,145,8.5,-105,-115,109,1.5,-165,4.62,Marlins Park,10,4
2021-06-24,2021,CLE,MIN,4,1,168,1.5,-125,9.0,-120,100,-183,-1.5,105,3.36,Target Field,5,3
2021-06-24,2021,KC,NYY,1,8,180,1.5,-105,9.0,-105,-115,-200,-1.5,-115,3.21,Yankee Stadium,9,-7
2021-06-24,2021,TEX,OAK,1,5,135,1.5,-125,8.0,-115,-105,-145,-1.5,105,3.4,Globe Life Field,6,-4
2021-06-24,2021,STL,PIT,2,8,-154,-1.5,125,9.0,-115,-105,144,1.5,-145,5.46,Busch Stadium,10,-6
2021-06-24,2021,PIT,STL,8,2,144,1.5,-145,9.0,-115,-105,-154,-1.5,125,3.69,Busch Stadium,10,6
2021-06-24,2021,BOS,TB,0,1,101,1.5,-185,9.0,-105,-115,-111,-1.5,165,4.48,Tropicana Field,1,-1
2021-06-24,2021,OAK,TEX,5,1,-145,-1.5,105,8.0,-115,-105,135,1.5,-125,4.73,Globe Life Field,6,4
2021-06-24,2021,BAL,TOR,0,9,173,1.5,-115,10.5,-105,-115,-188,-1.5,-105,3.85,Sahlen Field,9,-9
2021-06-24,2021,MIA,WSH,3,7,109,1.5,-165,8.5,-105,-115,-119,-1.5,145,4.07,Marlins Park,10,-4
2021-06-25,2021,SD,ARI,11,5,-310,-1.5,-155,8.5,-105,-115,270,1.5,135,6.43,PETCO Park,16,6
2021-06-25,2021,CIN,ATL,2,3,-111,-1.5,160,10.5,-120,100,101,1.5,-180,5.52,Great American Ballpark,5,-1
2021-06-25,2021,TOR,BAL,5,6,-255,-1.5,-145,10.5,-120,100,225,1.5,125,7.54,Sahlen Field,11,-1
2021-06-25,2021,NYY,BOS,3,5,-123,-1.5,120,10.5,-110,-110,113,1.5,-140,5.79,Fenway Park,8,-2
2021-06-25,2021,LAD,CHC,6,2,-174,-1.5,105,9.0,-120,100,162,1.5,-125,5.72,Dodger Stadium,8,4
2021-06-25,2021,ATL,CIN,3,2,101,1.5,-180,10.5,-120,100,-111,-1.5,160,5.22,Great American Ballpark,5,1
2021-06-25,2021,MIN,CLE,8,7,-122,-1.5,150,9.5,-110,-110,112,1.5,-170,5.22,Target Field,15,1
2021-06-25,2021,MIL,COL,5,4,-280,-1.5,-130,7.5,-110,-110,245,1.5,110,5.53,Miller Park,9,1
2021-06-25,2021,SEA,CWS,9,3,180,1.5,-125,7.5,-105,-115,-200,-1.5,105,2.68,Guaranteed Rate Field,12,6
2021-06-25,2021,TEX,KC,9,4,-120,-1.5,175,8.0,-105,-115,110,1.5,-200,4.36,Globe Life Field,13,5
2021-06-25,2021,TB,LAA,4,3,-162,-1.5,120,8.0,-110,-110,152,1.5,-140,4.95,Tropicana Field,7,1
2021-06-25,2021,CHC,LAD,2,6,162,1.5,-125,9.0,-120,100,-174,-1.5,105,3.44,Dodger Stadium,8,-4
2021-06-25,2021,WSH,MIA,2,11,130,1.5,-165,7.5,-115,-105,-140,-1.5,145,3.26,Marlins Park,13,-9
2021-06-25,2021,COL,MIL,4,5,245,1.5,110,7.5,-110,-110,-280,-1.5,-130,2.17,Miller Park,9,-1
2021-06-25,2021,CLE,MIN,7,8,112,1.5,-170,9.5,-110,-110,-122,-1.5,150,4.48,Target Field,15,-1
2021-06-25,2021,PHI,NYM,1,2,110,1.5,-215,5.5,-125,105,-120,-1.5,190,2.62,Citi Field,3,-1
2021-06-25,2021,PHI,NYM,2,1,135,1.5,-175,7.0,100,-120,-145,-1.5,155,2.98,Citi Field,3,1
2021-06-25,2021,BOS,NYY,5,3,113,1.5,-140,10.5,-110,-110,-123,-1.5,120,4.93,Fenway Park,8,2
2021-06-25,2021,SF,OAK,2,0,101,1.5,-170,7.5,-120,100,-111,-1.5,150,3.73,AT&T Park,2,2
2021-06-25,2021,NYM,PHI,2,1,-120,-1.5,190,5.5,-125,105,110,1.5,-215,3.0,Citi Field,3,1
2021-06-25,2021,NYM,PHI,1,2,-145,-1.5,155,7.0,100,-120,135,1.5,-175,4.14,Citi Field,3,-1
2021-06-25,2021,STL,PIT,4,5,-168,-1.5,110,9.0,100,-120,158,1.5,-130,5.64,Busch Stadium,9,-1
2021-06-25,2021,ARI,SD,5,11,270,1.5,135,8.5,-105,-115,-310,-1.5,-155,2.3,PETCO Park,16,-6
2021-06-25,2021,CWS,SEA,3,9,-200,-1.5,105,7.5,-105,-115,180,1.5,-125,5.0,Guaranteed Rate Field,12,-6
2021-06-25,2021,OAK,SF,0,2,-111,-1.5,150,7.5,-120,100,101,1.5,-170,3.95,AT&T Park,2,-2
2021-06-25,2021,PIT,STL,5,4,158,1.5,-130,9.0,100,-120,-168,-1.5,110,3.49,Busch Stadium,9,1
2021-06-25,2021,LAA,TB,3,4,152,1.5,-140,8.0,-110,-110,-162,-1.5,120,3.17,Tropicana Field,7,-1
2021-06-25,2021,KC,TEX,4,9,110,1.5,-200,8.0,-105,-115,-120,-1.5,175,3.81,Globe Life Field,13,-5
2021-06-25,2021,BAL,TOR,6,5,225,1.5,125,10.5,-120,100,-255,-1.5,-145,3.23,Sahlen Field,11,1
2021-06-25,2021,MIA,WSH,11,2,-140,-1.5,145,7.5,-115,-105,130,1.5,-165,4.38,Marlins Park,13,9
2021-06-26,2021,SD,ARI,1,10,-260,-1.5,-130,8.0,-105,-115,230,1.5,110,5.78,PETCO Park,11,-9
2021-06-26,2021,CIN,ATL,4,1,-120,-1.5,160,9.0,-115,-105,110,1.5,-180,4.91,Great American Ballpark,5,3
2021-06-26,2021,TOR,BAL,12,4,-270,-1.5,-140,10.0,-115,-105,240,1.5,120,7.3,Sahlen Field,16,8
2021-06-26,2021,NYY,BOS,2,4,109,1.5,-175,10.0,-115,-105,-119,-1.5,155,4.78,Fenway Park,6,-2
2021-06-26,2021,LAD,CHC,3,2,-204,-1.5,-105,9.0,-110,-110,184,1.5,-115,6.04,Dodger Stadium,5,1
2021-06-26,2021,ATL,CIN,1,4,110,1.5,-180,9.0,-115,-105,-120,-1.5,160,4.29,Great American Ballpark,5,-3
2021-06-26,2021,MIL,COL,10,4,-172,-1.5,110,8.0,-110,-110,161,1.5,-130,5.06,Miller Park,14,6
2021-06-26,2021,SEA,CWS,3,2,110,1.5,-150,8.5,-110,-110,-115,-1.5,170,4.05,Guaranteed Rate Field,5,1
2021-06-26,2021,HOU,DET,1,3,-205,-1.5,-135,7.0,-115,-105,185,1.5,115,4.7,Comerica Park,4,-2
2021-06-26,2021,HOU,DET,3,2,-230,-1.5,-145,7.5,-120,100,205,1.5,125,5.23,Comerica Park,5,1
2021-06-26,2021,DET,HOU,3,1,185,1.5,115,7.0,-115,-105,-205,-1.5,-135,2.46,Comerica Park,4,2
2021-06-26,2021,DET,HOU,2,3,205,1.5,125,7.5,-120,100,-230,-1.5,-145,2.46,Comerica Park,5,-1
2021-06-26,2021,TEX,KC,8,0,-149,-1.5,135,8.0,-115,-105,139,1.5,-155,4.79,Globe Life Field,8,8
2021-06-26,2021,TB,LAA,13,3,-153,-1.5,125,7.5,-115,-105,143,1.5,-145,4.54,Tropicana Field,16,10
2021-06-26,2021,CHC,LAD,2,3,184,1.5,-115,9.0,-110,-110,-204,-1.5,-105,3.17,Dodger Stadium,5,-1
2021-06-26,2021,WSH,MIA,2,3,-103,1.5,-215,7.5,-115,-105,-107,-1.5,190,3.81,Marlins Park,5,-1
2021-06-26,2021,COL,MIL,4,10,161,1.5,-130,8.0,-110,-110,-172,-1.5,110,3.07,Miller Park,14,-6
2021-06-26,2021,PHI,NYM,3,4,225,1.5,-110,6.5,100,-120,-255,-1.5,-110,2.0,Citi Field,7,-1
2021-06-26,2021,BOS,NYY,4,2,-119,-1.5,155,10.0,-115,-105,109,1.5,-175,5.43,Fenway Park,6,2
2021-06-26,2021,SF,OAK,6,5,-118,-1.5,170,8.0,-115,-105,108,1.5,-190,4.33,AT&T Park,11,1
2021-06-26,2021,NYM,PHI,4,3,-255,-1.5,-110,6.5,100,-120,225,1.5,-110,4.67,Citi Field,7,1
2021-06-26,2021,STL,PIT,3,1,-155,-1.5,130,8.0,-110,-110,145,1.5,-150,4.86,Busch Stadium,4,2
2021-06-26,2021,ARI,SD,10,1,230,1.5,110,8.0,-105,-115,-260,-1.5,-130,2.42,PETCO Park,11,9
2021-06-26,2021,CWS,SEA,2,3,-115,-1.5,170,8.5,-110,-110,110,1.5,-150,4.55,Guaranteed Rate Field,5,-1
2021-06-26,2021,OAK,SF,5,6,108,1.5,-190,8.0,-115,-105,-118,-1.5,170,3.85,AT&T Park,11,-1
2021-06-26,2021,PIT,STL,1,3,145,1.5,-150,8.0,-110,-110,-155,-1.5,130,3.27,Busch Stadium,4,-2
2021-06-26,2021,LAA,TB,3,13,143,1.5,-145,7.5,-115,-105,-153,-1.5,125,3.09,Tropicana Field,16,-10
2021-06-26,2021,KC,TEX,0,8,139,1.5,-155,8.0,-115,-105,-149,-1.5,135,3.35,Globe Life Field,8,-8
2021-06-26,2021,BAL,TOR,4,12,240,1.5,120,10.0,-115,-105,-270,-1.5,-140,2.94,Sahlen Field,16,-8
2021-06-26,2021,MIA,WSH,3,2,-107,-1.5,190,7.5,-115,-105,-103,1.5,-215,3.88,Marlins Park,5,1
2021-06-27,2021,SD,ARI,5,4,-270,-1.5,-120,7.5,105,-125,240,1.5,100,5.47,PETCO Park,9,1
2021-06-27,2021,CIN,ATL,0,4,-140,-1.5,135,9.5,-115,-105,130,1.5,-155,5.54,Great American Ballpark,4,-4
2021-06-27,2021,TOR,BAL,5,2,-250,-1.5,-140,10.0,-115,-105,220,1.5,120,7.14,Sahlen Field,7,3
2021-06-27,2021,NYY,BOS,2,9,-150,-1.5,-105,9.5,-115,-105,140,1.5,-115,5.7,Fenway Park,11,-7
2021-06-27,2021,LAD,CHC,7,1,-200,-1.5,100,8.0,-105,-115,180,1.5,-120,5.33,Dodger Stadium,8,6
2021-06-27,2021,ATL,CIN,4,0,130,1.5,-155,9.5,-115,-105,-140,-1.5,135,4.13,Great American Ballpark,4,4
2021-06-27,2021,MIN,CLE,8,2,-130,-1.5,140,9.5,-115,-105,120,1.5,-160,5.37,Target Field,10,6
2021-06-27,2021,MIL,COL,5,0,-180,-1.5,105,9.0,-115,-105,165,1.5,-125,5.79,Miller Park,5,5
2021-06-27,2021,SEA,CWS,5,7,156,1.5,-155,7.0,100,-120,-166,-1.5,135,2.73,Guaranteed Rate Field,12,-2
2021-06-27,2021,HOU,DET,1,2,-165,-1.5,-125,9.0,-115,-105,155,1.5,105,5.6,Comerica Park,3,-1
2021-06-27,2021,DET,HOU,2,1,155,1.5,105,9.0,-115,-105,-165,-1.5,-125,3.53,Comerica Park,3,1
2021-06-27,2021,TEX,KC,4,1,-107,1.5,-170,9.0,100,-120,-103,-1.5,150,4.65,Globe Life Field,5,3
2021-06-27,2021,TB,LAA,4,6,-147,-1.5,135,8.0,100,-120,137,1.5,-155,4.76,Tropicana Field,10,-2
2021-06-27,2021,CHC,LAD,1,7,180,1.5,-120,8.0,-105,-115,-200,-1.5,100,2.86,Dodger Stadium,8,-6
2021-06-27,2021,WSH,MIA,5,1,-124,-1.5,145,6.5,-115,-105,114,1.5,-165,3.6,Marlins Park,6,4
2021-06-27,2021,COL,MIL,0,5,165,1.5,-125,9.0,-115,-105,-180,-1.5,105,3.4,Miller Park,5,-5
2021-06-27,2021,CLE,MIN,2,8,120,1.5,-160,9.5,-115,-105,-130,-1.5,140,4.32,Target Field,10,-6
2021-06-27,2021,PHI,NYM,4,2,108,1.5,-200,7.0,-110,-110,-118,-1.5,175,3.37,Citi Field,6,2
2021-06-27,2021,BOS,NYY,9,2,140,1.5,-115,9.5,-115,-105,-150,-1.5,-105,3.96,Fenway Park,11,7
2021-06-27,2021,SF,OAK,2,6,-160,-1.5,125,8.5,-105,-115,150,1.5,-145,5.23,AT&T Park,8,-4
2021-06-27,2021,NYM,PHI,2,4,-118,-1.5,175,7.0,-110,-110,108,1.5,-200,3.79,Citi Field,6,-2
2021-06-27,2021,STL,PIT,2,7,-140,-1.5,130,9.0,-115,-105,130,1.5,-150,5.25,Busch Stadium,9,-5
2021-06-27,2021,ARI,SD,4,5,240,1.5,100,7.5,105,-125,-270,-1.5,-120,2.21,PETCO Park,9,-1
2021-06-27,2021,CWS,SEA,7,5,-166,-1.5,135,7.0,100,-120,156,1.5,-155,4.37,Guaranteed Rate Field,12,2
2021-06-27,2021,OAK,SF,6,2,150,1.5,-145,8.5,-105,-115,-160,-1.5,125,3.4,AT&T Park,8,4
2021-06-27,2021,PIT,STL,7,2,130,1.5,-150,9.0,-115,-105,-140,-1.5,130,3.91,Busch Stadium,9,5
2021-06-27,2021,LAA,TB,6,4,137,1.5,-155,8.0,100,-120,-147,-1.5,135,3.38,Tropicana Field,10,2
2021-06-27,2021,KC,TEX,1,4,-103,-1.5,150,9.0,100,-120,-107,1.5,-170,4.57,Globe Life Field,5,-3
2021-06-27,2021,BAL,TOR,2,5,220,1.5,120,10.0,-115,-105,-250,-1.5,-140,3.13,Sahlen Field,7,-3
2021-06-27,2021,MIA,WSH,1,5,114,1.5,-165,6.5,-115,-105,-124,-1.5,145,3.04,Marlins Park,6,-4
2021-06-28,2021,STL,ARI,7,1,-165,-1.5,110,8.5,-120,100,155,1.5,-130,5.29,Busch Stadium,8,6
2021-06-28,2021,HOU,BAL,7,9,-350,-1.5,-175,9.5,100,-120,300,1.5,155,7.39,Minute Maid Park,16,-2
2021-06-28,2021,KC,BOS,5,6,140,1.5,-145,11.0,-115,-105,-150,-1.5,125,4.58,Fenway Park,11,-1
2021-06-28,2021,MIL,CHC,14,4,-145,-1.5,150,7.5,100,-120,135,1.5,-170,4.44,Miller Park,18,10
2021-06-28,2021,PHI,CIN,4,12,145,1.5,-145,9.5,-115,-105,-155,-1.5,125,3.88,Great American Ballpark,16,-8
2021-06-28,2021,DET,CLE,5,13,148,1.5,-140,9.5,-115,-105,-158,-1.5,120,3.83,Progressive Field,18,-8
2021-06-28,2021,PIT,COL,0,2,103,1.5,-175,11.5,100,-120,-113,-1.5,155,5.67,Coors Field,2,-2
2021-06-28,2021,CLE,DET,13,5,-158,-1.5,120,9.5,-115,-105,148,1.5,-140,5.82,Progressive Field,18,8
2021-06-28,2021,BAL,HOU,9,7,300,1.5,155,9.5,100,-120,-350,-1.5,-175,2.38,Minute Maid Park,16,2
2021-06-28,2021,BOS,KC,6,5,-150,-1.5,125,11.0,-115,-105,140,1.5,-145,6.6,Fenway Park,11,1
2021-06-28,2021,NYY,LAA,3,5,-154,-1.5,115,10.5,-115,-105,144,1.5,-135,6.37,Yankee Stadium,8,-2
2021-06-28,2021,SF,LAD,2,3,159,1.5,-135,8.5,100,-120,-169,-1.5,115,3.28,Dodger Stadium,5,-1
2021-06-28,2021,CHC,MIL,4,14,135,1.5,-170,7.5,100,-120,-145,-1.5,150,3.19,Miller Park,18,-10
2021-06-28,2021,WSH,NYM,8,4,-130,-1.5,155,9.5,-120,100,120,1.5,-175,5.37,Nationals Park,12,4
2021-06-28,2021,LAA,NYY,5,3,144,1.5,-135,10.5,-115,-105,-154,-1.5,115,4.3,Yankee Stadium,8,2
2021-06-28,2021,CIN,PHI,12,4,-155,-1.5,125,9.5,-115,-105,145,1.5,-145,5.77,Great American Ballpark,16,8
2021-06-28,2021,COL,PIT,2,0,-113,-1.5,155,11.5,100,-120,103,1.5,-175,6.1,Coors Field,2,2
2021-06-28,2021,LAD,SF,3,2,-169,-1.5,115,8.5,100,-120,159,1.5,-135,5.34,Dodger Stadium,5,1
2021-06-28,2021,ARI,STL,1,7,155,1.5,-130,8.5,-120,100,-165,-1.5,110,3.33,Busch Stadium,8,-6
2021-06-28,2021,NYM,WSH,4,8,120,1.5,-175,9.5,-120,100,-130,-1.5,155,4.32,Nationals Park,12,-4
2021-06-29,2021,STL,ARI,3,2,-155,-1.5,120,9.0,-105,-115,145,1.5,-140,5.47,Busch Stadium,5,1
2021-06-29,2021,NYM,ATL,4,3,147,1.5,-145,9.0,-105,-115,-157,-1.5,125,3.64,Suntrust Park,7,1
2021-06-29,2021,HOU,BAL,3,13,-300,-1.5,-150,9.0,-115,-105,260,1.5,130,6.75,Minute Maid Park,16,-10
2021-06-29,2021,KC,BOS,6,7,200,1.5,100,10.5,-115,-105,-220,-1.5,-120,3.5,Fenway Park,13,-1
2021-06-29,2021,MIL,CHC,2,1,-245,-1.5,-115,7.5,100,-120,215,1.5,-105,5.33,Miller Park,3,1
2021-06-29,2021,SD,CIN,5,4,-134,-1.5,105,10.5,-110,-110,124,1.5,-125,6.01,Great American Ballpark,9,1
2021-06-29,2021,PIT,COL,0,8,161,1.5,-120,10.5,-120,100,-172,-1.5,100,4.02,Coors Field,8,-8
2021-06-29,2021,MIN,CWS,6,7,118,1.5,-165,8.5,-105,-115,-128,-1.5,145,3.9,Guaranteed Rate Field,13,-1
2021-06-29,2021,BAL,HOU,13,3,260,1.5,130,9.0,-115,-105,-300,-1.5,-150,2.5,Minute Maid Park,16,10
2021-06-29,2021,BOS,KC,7,6,-220,-1.5,-120,10.5,-115,-105,200,1.5,100,7.22,Fenway Park,13,1
2021-06-29,2021,NYY,LAA,11,5,-151,-1.5,120,10.0,100,-120,141,1.5,-140,6.02,Yankee Stadium,16,6
2021-06-29,2021,SF,LAD,1,3,140,1.5,-160,7.5,-110,-110,-150,-1.5,140,3.13,Dodger Stadium,4,-2
2021-06-29,2021,PHI,MIA,4,3,-105,1.5,-165,9.0,-110,-110,-105,-1.5,145,4.61,Citizens Bank Park,7,1
2021-06-29,2021,CHC,MIL,1,2,215,1.5,-105,7.5,100,-120,-245,-1.5,-115,2.38,Miller Park,3,-1
2021-06-29,2021,CWS,MIN,7,6,-128,-1.5,145,8.5,-105,-115,118,1.5,-165,4.77,Guaranteed Rate Field,13,1
2021-06-29,2021,ATL,NYM,3,4,-157,-1.5,125,9.0,-105,-115,147,1.5,-145,5.5,Suntrust Park,7,-1
2021-06-29,2021,LAA,NYY,5,11,141,1.5,-140,10.0,100,-120,-151,-1.5,120,4.15,Yankee Stadium,16,-6
2021-06-29,2021,TEX,OAK,5,4,175,1.5,-115,8.5,-115,-105,-190,-1.5,-105,3.09,Oakland Coliseum,9,1
2021-06-29,2021,MIA,PHI,3,4,-105,-1.5,145,9.0,-110,-110,-105,1.5,-165,4.61,Citizens Bank Park,7,-1
2021-06-29,2021,COL,PIT,8,0,-172,-1.5,100,10.5,-120,100,161,1.5,-120,6.64,Coors Field,8,8
2021-06-29,2021,CIN,SD,4,5,124,1.5,-125,10.5,-110,-110,-134,-1.5,105,4.69,Great American Ballpark,9,-1
2021-06-29,2021,TOR,SEA,9,3,-220,-1.5,-120,9.5,-110,-110,200,1.5,100,6.53,Sahlen Field,12,6
2021-06-29,2021,LAD,SF,3,1,-150,-1.5,140,7.5,-110,-110,140,1.5,-160,4.5,Dodger Stadium,4,2
2021-06-29,2021,ARI,STL,2,3,145,1.5,-140,9.0,-105,-115,-155,-1.5,120,3.67,Busch Stadium,5,-1
2021-06-29,2021,WSH,TB,4,3,-109,-1.5,170,9.5,-105,-115,-101,1.5,-190,4.95,Nationals Park,7,1
2021-06-29,2021,OAK,TEX,4,5,-190,-1.5,-105,8.5,-115,-105,175,1.5,-115,5.57,Oakland Coliseum,9,-1
2021-06-29,2021,SEA,TOR,3,9,200,1.5,100,9.5,-110,-110,-220,-1.5,-120,3.17,Sahlen Field,12,-6
2021-06-29,2021,TB,WSH,3,4,-101,1.5,-190,9.5,-105,-115,-109,-1.5,170,4.77,Nationals Park,7,-1
2021-06-30,2021,STL,ARI,7,4,-210,-1.5,-105,8.5,-120,100,190,1.5,-115,5.76,Busch Stadium,11,3
2021-06-30,2021,NYM,ATL,2,20,138,1.5,-145,9.0,100,-120,-148,-1.5,125,3.78,Suntrust Park,22,-18
2021-06-30,2021,HOU,BAL,2,5,-290,-1.5,-155,9.0,-120,100,250,1.5,135,6.69,Minute Maid Park,7,-3
2021-06-30,2021,KC,BOS,2,6,134,1.5,-135,11.0,-110,-110,-144,-1.5,115,4.7,Fenway Park,8,-4
2021-06-30,2021,MIL,CHC,15,7,-150,-1.5,130,8.5,-120,100,140,1.5,-150,5.1,Miller Park,22,8
2021-06-30,2021,SD,CIN,7,5,-186,-1.5,-120,10.0,-105,-115,171,1.5,100,6.5,Great American Ballpark,12,2
2021-06-30,2021,DET,CLE,9,4,165,1.5,-130,7.5,100,-120,-180,-1.5,110,2.83,Progressive Field,13,5
2021-06-30,2021,DET,CLE,7,1,129,1.5,-175,8.0,-110,-110,-139,-1.5,155,3.49,Progressive Field,8,6
2021-06-30,2021,PIT,COL,2,6,150,1.5,-125,11.0,-115,-105,-160,-1.5,105,4.4,Coors Field,8,-4
2021-06-30,2021,MIN,CWS,3,13,110,1.5,-165,9.0,-110,-110,-120,-1.5,145,4.29,Guaranteed Rate Field,16,-10
2021-06-30,2021,CLE,DET,4,9,-180,-1.5,110,7.5,100,-120,165,1.5,-130,4.82,Progressive Field,13,-5
2021-06-30,2021,CLE,DET,1,7,-139,-1.5,155,8.0,-110,-110,129,1.5,-175,4.65,Progressive Field,8,-6
2021-06-30,2021,BAL,HOU,5,2,250,1.5,135,9.0,-120,100,-290,-1.5,-155,2.57,Minute Maid Park,7,3
2021-06-30,2021,BOS,KC,6,2,-144,-1.5,115,11.0,-110,-110,134,1.5,-135,6.49,Fenway Park,8,4
2021-06-30,2021,NYY,LAA,8,11,-116,-1.5,150,10.0,-105,-115,106,1.5,-170,5.37,Yankee Stadium,19,-3
2021-06-30,2021,PHI,MIA,6,11,-220,-1.5,-110,8.5,-105,-115,200,1.5,-110,5.84,Citizens Bank Park,17,-5
2021-06-30,2021,CHC,MIL,7,15,140,1.5,-150,8.5,-120,100,-150,-1.5,130,3.54,Miller Park,22,-8
2021-06-30,2021,CWS,MIN,13,3,-120,-1.5,145,9.0,-110,-110,110,1.5,-165,4.91,Guaranteed Rate Field,16,10
2021-06-30,2021,ATL,NYM,20,2,-148,-1.5,125,9.0,100,-120,138,1.5,-145,5.37,Suntrust Park,22,18
2021-06-30,2021,LAA,NYY,11,8,106,1.5,-170,10.0,-105,-115,-116,-1.5,150,4.85,Yankee Stadium,19,3
2021-06-30,2021,TEX,OAK,1,3,175,1.5,-115,8.0,100,-120,-190,-1.5,-105,2.91,Oakland Coliseum,4,-2
2021-06-30,2021,MIA,PHI,11,6,200,1.5,-110,8.5,-105,-115,-220,-1.5,-110,2.83,Citizens Bank Park,17,5
2021-06-30,2021,COL,PIT,6,2,-160,-1.5,105,11.0,-115,-105,150,1.5,-125,6.77,Coors Field,8,4
2021-06-30,2021,CIN,SD,5,7,171,1.5,100,10.0,-105,-115,-186,-1.5,-120,3.69,Great American Ballpark,12,-2
2021-06-30,2021,TOR,SEA,7,9,-245,-1.5,-140,10.5,-110,-110,215,1.5,120,7.46,Sahlen Field,16,-2
2021-06-30,2021,ARI,STL,4,7,190,1.5,-115,8.5,-120,100,-210,-1.5,-105,2.93,Busch Stadium,11,-3
2021-06-30,2021,WSH,TB,15,6,113,1.5,-145,9.5,-115,-105,-123,-1.5,125,4.46,Nationals Park,21,9
2021-06-30,2021,OAK,TEX,3,1,-190,-1.5,-105,8.0,100,-120,175,1.5,-115,5.24,Oakland Coliseum,4,2
2021-06-30,2021,SEA,TOR,9,7,215,1.5,120,10.5,-110,-110,-245,-1.5,-140,3.33,Sahlen Field,16,2
2021-06-30,2021,TB,WSH,6,15,-123,-1.5,125,9.5,-115,-105,113,1.5,-145,5.24,Nationals Park,21,-9
2021-07-01,2021,SF,ARI,3,5,-147,-1.5,110,9.0,-105,-115,137,1.5,-130,5.36,Chase Field,8,-2
2021-07-01,2021,NYM,ATL,3,4,-163,-1.5,-105,7.0,-105,-115,153,1.5,-115,4.34,Suntrust Park,7,-1
2021-07-01,2021,KC,BOS,1,15,210,1.5,110,10.0,-110,-110,-240,-1.5,-130,3.23,Fenway Park,16,-14
2021-07-01,2021,SD,CIN,4,5,115,1.5,-185,9.5,-115,-105,-125,-1.5,165,4.42,Great American Ballpark,9,-1
2021-07-01,2021,HOU,CLE,7,2,-170,-1.5,-110,8.5,-120,100,160,1.5,-110,5.35,Progressive Field,9,5
2021-07-01,2021,STL,COL,2,5,-130,-1.5,115,11.0,-105,-115,120,1.5,-135,6.22,Coors Field,7,-3
2021-07-01,2021,MIN,CWS,5,8,133,1.5,-155,8.5,100,-120,-143,-1.5,135,3.65,Guaranteed Rate Field,13,-3
2021-07-01,2021,CLE,HOU,2,7,160,1.5,-110,8.5,-120,100,-170,-1.5,-110,3.27,Progressive Field,9,-5
2021-07-01,2021,BOS,KC,15,1,-240,-1.5,-130,10.0,-110,-110,210,1.5,110,7.06,Fenway Park,16,14
2021-07-01,2021,WSH,LAD,2,6,129,1.5,-130,9.5,100,-120,-139,-1.5,110,4.15,Nationals Park,8,-4
2021-07-01,2021,PIT,MIL,2,7,210,1.5,125,8.0,-110,-110,-240,-1.5,-145,2.58,PNC Park,9,-5
2021-07-01,2021,CWS,MIN,8,5,-143,-1.5,135,8.5,100,-120,133,1.5,-155,5.0,Guaranteed Rate Field,13,3
2021-07-01,2021,ATL,NYM,4,3,153,1.5,-115,7.0,-105,-115,-163,-1.5,-105,2.77,Suntrust Park,7,1
2021-07-01,2021,TEX,OAK,8,3,165,1.5,-125,8.0,100,-120,-180,-1.5,105,3.02,Oakland Coliseum,11,5
2021-07-01,2021,MIL,PIT,7,2,-240,-1.5,-145,8.0,-110,-110,210,1.5,125,5.65,PNC Park,9,5
2021-07-01,2021,CIN,SD,5,4,-125,-1.5,165,9.5,-115,-105,115,1.5,-185,5.28,Great American Ballpark,9,1
2021-07-01,2021,TOR,SEA,2,7,-185,-1.5,-105,10.0,-105,-115,170,1.5,-115,6.49,Sahlen Field,9,-5
2021-07-01,2021,ARI,SF,5,3,137,1.5,-130,9.0,-105,-115,-147,-1.5,110,3.8,Chase Field,8,2
2021-07-01,2021,COL,STL,5,2,120,1.5,-135,11.0,-105,-115,-130,-1.5,115,5.0,Coors Field,7,3
2021-07-01,2021,OAK,TEX,3,8,-180,-1.5,105,8.0,100,-120,165,1.5,-125,5.14,Oakland Coliseum,11,-5
2021-07-01,2021,SEA,TOR,7,2,170,1.5,-115,10.0,-105,-115,-185,-1.5,-105,3.7,Sahlen Field,9,5
2021-07-01,2021,LAD,WSH,6,2,-139,-1.5,110,9.5,100,-120,129,1.5,-130,5.53,Nationals Park,8,4
2021-07-02,2021,SF,ARI,11,4,-146,-1.5,105,8.5,-110,-110,136,1.5,-125,5.04,Chase Field,15,7
2021-07-02,2021,MIA,ATL,0,1,-102,1.5,-200,9.0,-110,-110,-108,-1.5,175,4.54,Suntrust Park,1,-1
2021-07-02,2021,LAA,BAL,8,7,-174,-1.5,105,10.0,-105,-115,162,1.5,-125,6.35,Angel Stadium,15,1
2021-07-02,2021,OAK,BOS,2,3,102,1.5,-175,8.5,-105,-115,-112,-1.5,155,4.21,Oakland Coliseum,5,-1
2021-07-02,2021,CIN,CHC,2,1,-146,-1.5,125,9.5,-120,100,136,1.5,-145,5.64,Great American Ballpark,3,1
2021-07-02,2021,CHC,CIN,1,2,136,1.5,-145,9.5,-120,100,-146,-1.5,125,4.03,Great American Ballpark,3,-1
2021-07-02,2021,HOU,CLE,6,3,-158,-1.5,-115,9.0,100,-120,148,1.5,-105,5.51,Progressive Field,9,3
2021-07-02,2021,STL,COL,9,3,-109,1.5,-190,13.0,-105,-115,-101,-1.5,170,6.78,Coors Field,12,6
2021-07-02,2021,DET,CWS,2,8,134,1.5,-125,8.5,-115,-105,-144,-1.5,105,3.63,Comerica Park,10,-6
2021-07-02,2021,CWS,DET,8,2,-144,-1.5,105,8.5,-115,-105,134,1.5,-125,5.02,Comerica Park,10,6
2021-07-02,2021,CLE,HOU,3,6,148,1.5,-105,9.0,100,-120,-158,-1.5,-115,3.63,Progressive Field,9,-3
2021-07-02,2021,MIN,KC,4,7,-104,1.5,-185,10.0,-115,-105,-106,-1.5,165,5.1,Kauffman Stadium,11,-3
2021-07-02,2021,BAL,LAA,7,8,162,1.5,-125,10.0,-105,-115,-174,-1.5,105,3.82,Angel Stadium,15,-1
2021-07-02,2021,WSH,LAD,5,10,108,1.5,-165,8.0,-105,-115,-118,-1.5,145,3.85,Nationals Park,15,-5
2021-07-02,2021,ATL,MIA,1,0,-108,-1.5,175,9.0,-110,-110,-102,1.5,-200,4.67,Suntrust Park,1,1
2021-07-02,2021,PIT,MIL,2,7,106,1.5,-155,7.5,-115,-105,-116,-1.5,135,3.64,PNC Park,9,-5
2021-07-02,2021,KC,MIN,7,4,-106,-1.5,165,10.0,-115,-105,-104,1.5,-185,5.15,Kauffman Stadium,11,3
2021-07-02,2021,BOS,OAK,3,2,-112,-1.5,155,8.5,-105,-115,102,1.5,-175,4.49,Oakland Coliseum,5,1
2021-07-02,2021,SD,PHI,3,4,106,1.5,-190,8.5,-105,-115,-116,-1.5,170,4.13,Citizens Bank Park,7,-1
2021-07-02,2021,MIL,PIT,7,2,-116,-1.5,135,7.5,-115,-105,106,1.5,-155,4.03,PNC Park,9,5
2021-07-02,2021,PHI,SD,4,3,-116,-1.5,170,8.5,-105,-115,106,1.5,-190,4.56,Citizens Bank Park,7,1
2021-07-02,2021,TEX,SEA,4,5,106,1.5,-180,8.0,-105,-115,-116,-1.5,160,3.88,T-Mobile Park,9,-1
2021-07-02,2021,ARI,SF,4,11,136,1.5,-125,8.5,-110,-110,-146,-1.5,105,3.6,Chase Field,15,-7
2021-07-02,2021,COL,STL,3,9,-101,-1.5,170,13.0,-105,-115,-109,1.5,-190,6.53,Coors Field,12,-6
2021-07-02,2021,TOR,TB,11,1,-119,-1.5,150,10.0,-110,-110,109,1.5,-170,5.43,Sahlen Field,12,10
2021-07-02,2021,SEA,TEX,5,4,-116,-1.5,160,8.0,-105,-115,106,1.5,-180,4.3,T-Mobile Park,9,1
2021-07-02,2021,TB,TOR,1,11,109,1.5,-170,10.0,-110,-110,-119,-1.5,150,4.78,Sahlen Field,12,-10
2021-07-02,2021,LAD,WSH,10,5,-118,-1.5,145,8.0,-105,-115,108,1.5,-165,4.33,Nationals Park,15,5
2021-07-03,2021,SF,ARI,6,5,-153,-1.5,100,9.5,100,-120,143,1.5,-120,5.75,Chase Field,11,1
2021-07-03,2021,MIA,ATL,3,2,108,1.5,-180,9.0,100,-120,-118,-1.5,160,4.33,Suntrust Park,5,1
2021-07-03,2021,LAA,BAL,4,1,-200,-1.5,-110,9.5,-115,-105,180,1.5,-110,6.33,Angel Stadium,5,3
2021-07-03,2021,OAK,BOS,7,6,-139,-1.5,135,9.5,-110,-110,129,1.5,-155,5.53,Oakland Coliseum,13,1
2021-07-03,2021,CIN,CHC,3,2,-125,-1.5,145,9.5,-105,-115,115,1.5,-165,5.28,Great American Ballpark,5,1
2021-07-03,2021,CHC,CIN,2,3,115,1.5,-165,9.5,-105,-115,-125,-1.5,145,4.42,Great American Ballpark,5,-1
2021-07-03,2021,HOU,CLE,3,2,-138,-1.5,100,9.5,100,-120,128,1.5,-120,5.51,Progressive Field,5,1
2021-07-03,2021,STL,COL,2,3,101,1.5,-175,12.0,-120,100,-111,-1.5,155,5.97,Coors Field,5,-1
2021-07-03,2021,DET,CWS,11,5,-104,1.5,-160,9.0,-105,-115,-106,-1.5,140,4.59,Comerica Park,16,6
2021-07-03,2021,CWS,DET,5,11,-106,-1.5,140,9.0,-105,-115,-104,1.5,-160,4.63,Comerica Park,16,-6
2021-07-03,2021,CLE,HOU,2,3,128,1.5,-120,9.5,100,-120,-138,-1.5,100,4.17,Progressive Field,5,-1
2021-07-03,2021,MIN,KC,3,6,106,1.5,-165,10.0,-110,-110,-116,-1.5,145,4.85,Kauffman Stadium,9,-3
2021-07-03,2021,BAL,LAA,1,4,180,1.5,-110,9.5,-115,-105,-200,-1.5,-110,3.39,Angel Stadium,5,-3
2021-07-03,2021,WSH,LAD,3,5,207,1.5,125,8.5,-115,-105,-232,-1.5,-145,2.77,Nationals Park,8,-2
2021-07-03,2021,ATL,MIA,2,3,-118,-1.5,160,9.0,100,-120,108,1.5,-180,4.87,Suntrust Park,5,-1
2021-07-03,2021,PIT,MIL,2,11,140,1.5,-125,9.5,100,-120,-150,-1.5,105,3.96,PNC Park,13,-9
2021-07-03,2021,KC,MIN,6,3,-116,-1.5,145,10.0,-110,-110,106,1.5,-165,5.37,Kauffman Stadium,9,3
2021-07-03,2021,NYY,NYM,3,8,-145,-1.5,125,8.5,-115,-105,135,1.5,-145,5.03,Yankee Stadium,11,-5
2021-07-03,2021,NYM,NYY,8,3,135,1.5,-145,8.5,-115,-105,-145,-1.5,125,3.62,Yankee Stadium,11,5
2021-07-03,2021,BOS,OAK,6,7,129,1.5,-155,9.5,-110,-110,-139,-1.5,135,4.15,Oakland Coliseum,13,-1
2021-07-03,2021,SD,PHI,2,4,-153,-1.5,100,8.0,-115,-105,143,1.5,-120,4.84,Citizens Bank Park,6,-2
2021-07-03,2021,MIL,PIT,11,2,-150,-1.5,105,9.5,100,-120,140,1.5,-125,5.7,PNC Park,13,9
2021-07-03,2021,PHI,SD,4,2,143,1.5,-120,8.0,-115,-105,-153,-1.5,100,3.29,Citizens Bank Park,6,2
2021-07-03,2021,TEX,SEA,7,3,147,1.5,-145,9.0,-105,-115,-157,-1.5,125,3.64,T-Mobile Park,10,4
2021-07-03,2021,ARI,SF,5,6,143,1.5,-120,9.5,100,-120,-153,-1.5,100,3.91,Chase Field,11,-1
2021-07-03,2021,COL,STL,3,2,-111,-1.5,155,12.0,-120,100,101,1.5,-175,6.31,Coors Field,5,1
2021-07-03,2021,TOR,TB,6,3,-120,-1.5,150,10.0,-110,-110,110,1.5,-170,5.45,Sahlen Field,9,3
2021-07-03,2021,SEA,TEX,3,7,-157,-1.5,125,9.0,-105,-115,147,1.5,-145,5.5,T-Mobile Park,10,-4
2021-07-03,2021,TB,TOR,3,6,110,1.5,-170,10.0,-110,-110,-120,-1.5,150,4.76,Sahlen Field,9,-3
2021-07-03,2021,LAD,WSH,5,3,-232,-1.5,-145,8.5,-115,-105,207,1.5,125,5.94,Nationals Park,8,2
2021-07-04,2021,SF,ARI,5,2,-190,-1.5,-125,9.0,100,-120,175,1.5,105,5.9,Chase Field,7,3
2021-07-04,2021,MIA,ATL,7,8,160,1.5,-135,8.5,-105,-115,-170,-1.5,115,3.27,Suntrust Park,15,-1
2021-07-04,2021,LAA,BAL,6,5,-240,-1.5,-120,10.5,-110,-110,210,1.5,100,7.41,Angel Stadium,11,1
2021-07-04,2021,OAK,BOS,0,1,-112,-1.5,170,9.0,105,-125,102,1.5,-190,4.75,Oakland Coliseum,1,-1
2021-07-04,2021,CIN,CHC,3,2,-115,-1.5,165,9.5,-105,-115,105,1.5,-185,5.08,Great American Ballpark,5,1
2021-07-04,2021,CHC,CIN,2,3,105,1.5,-185,9.5,-105,-115,-115,-1.5,165,4.63,Great American Ballpark,5,-1
2021-07-04,2021,HOU,CLE,4,3,-140,-1.5,100,9.0,-105,-115,130,1.5,-120,5.25,Progressive Field,7,1
2021-07-04,2021,STL,COL,2,3,143,1.5,-130,11.0,-115,-105,-153,-1.5,110,4.53,Coors Field,5,-1
2021-07-04,2021,DET,CWS,6,5,163,1.5,100,9.5,-120,100,-175,-1.5,-120,3.61,Comerica Park,11,1
2021-07-04,2021,CWS,DET,5,6,-175,-1.5,-120,9.5,-120,100,163,1.5,100,6.05,Comerica Park,11,-1
2021-07-04,2021,CLE,HOU,3,4,130,1.5,-120,9.0,-105,-115,-140,-1.5,100,3.91,Progressive Field,7,-1
2021-07-04,2021,MIN,KC,6,2,-135,-1.5,110,10.0,-110,-110,125,1.5,-130,5.74,Kauffman Stadium,8,4
2021-07-04,2021,BAL,LAA,5,6,210,1.5,100,10.5,-110,-110,-240,-1.5,-120,3.39,Angel Stadium,11,-1
2021-07-04,2021,WSH,LAD,1,5,125,1.5,-135,9.0,-110,-110,-135,-1.5,115,4.0,Nationals Park,6,-4
2021-07-04,2021,ATL,MIA,8,7,-170,-1.5,115,8.5,-105,-115,160,1.5,-135,5.35,Suntrust Park,15,1
2021-07-04,2021,PIT,MIL,2,0,168,1.5,105,7.5,-105,-115,-183,-1.5,-125,2.8,PNC Park,2,2
2021-07-04,2021,KC,MIN,2,6,125,1.5,-130,10.0,-110,-110,-135,-1.5,110,4.44,Kauffman Stadium,8,-4
2021-07-04,2021,NYY,NYM,5,10,-170,-1.5,135,6.0,-105,-115,160,1.5,-155,3.78,Yankee Stadium,15,-5
2021-07-04,2021,NYY,NYM,4,2,-143,-1.5,150,7.0,-125,105,133,1.5,-170,4.12,Yankee Stadium,6,2
2021-07-04,2021,NYM,NYY,10,5,160,1.5,-155,6.0,-105,-115,-170,-1.5,135,2.31,Yankee Stadium,15,5
2021-07-04,2021,NYM,NYY,2,4,133,1.5,-170,7.0,-125,105,-143,-1.5,150,3.0,Yankee Stadium,6,-2
2021-07-04,2021,BOS,OAK,1,0,102,1.5,-190,9.0,105,-125,-112,-1.5,170,4.46,Oakland Coliseum,1,1
2021-07-04,2021,SD,PHI,11,1,-130,-1.5,120,9.0,-120,100,120,1.5,-140,5.09,Citizens Bank Park,12,10
2021-07-04,2021,MIL,PIT,0,2,-183,-1.5,-125,7.5,-105,-115,168,1.5,105,4.85,PNC Park,2,-2
2021-07-04,2021,PHI,SD,1,11,120,1.5,-140,9.0,-120,100,-130,-1.5,120,4.09,Citizens Bank Park,12,-10
2021-07-04,2021,TEX,SEA,1,4,128,1.5,-160,9.0,100,-120,-138,-1.5,140,3.95,T-Mobile Park,5,-3
2021-07-04,2021,ARI,SF,2,5,175,1.5,105,9.0,100,-120,-190,-1.5,-125,3.27,Chase Field,7,-3
2021-07-04,2021,COL,STL,3,2,-153,-1.5,110,11.0,-115,-105,143,1.5,-130,6.65,Coors Field,5,1
2021-07-04,2021,TOR,TB,1,5,-168,-1.5,110,10.0,-110,-110,158,1.5,-130,6.27,Sahlen Field,6,-4
2021-07-04,2021,SEA,TEX,4,1,-138,-1.5,140,9.0,100,-120,128,1.5,-160,5.22,T-Mobile Park,5,3
2021-07-04,2021,TB,TOR,5,1,158,1.5,-130,10.0,-110,-110,-168,-1.5,110,3.88,Sahlen Field,6,4
2021-07-04,2021,LAD,WSH,5,1,-135,-1.5,115,9.0,-110,-110,125,1.5,-135,5.17,Nationals Park,6,4
2021-07-05,2021,PIT,ATL,11,1,175,1.5,100,9.0,-115,-105,-190,-1.5,-120,3.27,PNC Park,12,10
2021-07-05,2021,LAA,BOS,4,5,114,1.5,-150,10.0,-110,-110,-124,-1.5,130,4.67,Angel Stadium,9,-1
2021-07-05,2021,PHI,CHC,13,3,140,1.5,-135,11.0,-120,100,-150,-1.5,115,4.58,Wrigley Field,16,10
2021-07-05,2021,KC,CIN,2,6,-130,-1.5,145,10.5,-105,-115,120,1.5,-165,5.93,Kauffman Stadium,8,-4
2021-07-05,2021,TB,CLE,9,8,-192,-1.5,-105,8.5,-125,105,176,1.5,-115,5.59,Tropicana Field,17,1
2021-07-05,2021,MIN,CWS,8,5,115,1.5,-140,10.0,-115,-105,-125,-1.5,120,4.65,Target Field,13,3
2021-07-05,2021,TEX,DET,3,7,-160,-1.5,115,9.0,-110,-110,150,1.5,-135,5.54,Globe Life Field,10,-4
2021-07-05,2021,CIN,KC,6,2,120,1.5,-165,10.5,-105,-115,-130,-1.5,145,4.77,Kauffman Stadium,8,4
2021-07-05,2021,BOS,LAA,5,4,-124,-1.5,130,10.0,-110,-110,114,1.5,-150,5.54,Angel Stadium,9,1
2021-07-05,2021,MIA,LAD,5,4,112,1.5,-155,6.5,-120,100,-122,-1.5,135,3.07,Marlins Park,9,1
2021-07-05,2021,LAD,MIA,4,5,-122,-1.5,135,6.5,-120,100,112,1.5,-155,3.57,Marlins Park,9,-1
2021-07-05,2021,NYM,MIL,4,2,115,1.5,-145,7.5,100,-120,-125,-1.5,125,3.49,Citi Field,6,2
2021-07-05,2021,CWS,MIN,5,8,-125,-1.5,120,10.0,-115,-105,115,1.5,-140,5.56,Target Field,13,-3
2021-07-05,2021,MIL,NYM,2,4,-125,-1.5,125,7.5,100,-120,115,1.5,-145,4.17,Citi Field,6,-2
2021-07-05,2021,CHC,PHI,3,13,-150,-1.5,115,11.0,-120,100,140,1.5,-135,6.6,Wrigley Field,16,-10
2021-07-05,2021,ATL,PIT,1,11,-190,-1.5,-120,9.0,-115,-105,175,1.5,100,5.9,PNC Park,12,-10
2021-07-05,2021,WSH,SD,7,5,220,1.5,110,8.5,-115,-105,-250,-1.5,-130,2.66,PETCO Park,12,2
2021-07-05,2021,STL,SF,5,3,190,1.5,-115,7.5,-105,-115,-210,-1.5,-105,2.59,AT&T Park,8,2
2021-07-05,2021,SF,STL,3,5,-210,-1.5,-105,7.5,-105,-115,190,1.5,-115,5.08,AT&T Park,8,-2
2021-07-05,2021,CLE,TB,8,9,176,1.5,-115,8.5,-125,105,-192,-1.5,-105,3.08,Tropicana Field,17,-1
2021-07-05,2021,DET,TEX,7,3,150,1.5,-135,9.0,-110,-110,-160,-1.5,115,3.6,Globe Life Field,10,4
2021-07-05,2021,SD,WSH,5,7,-250,-1.5,-130,8.5,-115,-105,220,1.5,110,6.07,PETCO Park,12,-2
2021-07-06,2021,COL,ARI,3,4,116,1.5,-175,8.5,100,-120,-126,-1.5,155,3.94,Chase Field,7,-1
2021-07-06,2021,PIT,ATL,2,1,169,1.5,100,9.0,-105,-115,-184,-1.5,-120,3.35,PNC Park,3,1
2021-07-06,2021,TOR,BAL,5,7,-185,-1.5,-130,11.0,-120,100,170,1.5,110,7.14,Camden Yards,12,-2
2021-07-06,2021,LAA,BOS,5,3,103,1.5,-160,8.5,100,-120,-113,-1.5,140,4.19,Angel Stadium,8,2
2021-07-06,2021,PHI,CHC,15,10,-136,-1.5,115,10.0,-115,-105,126,1.5,-135,5.76,Wrigley Field,25,5
2021-07-06,2021,KC,CIN,7,6,143,1.5,-120,9.5,-120,100,-153,-1.5,100,3.91,Kauffman Stadium,13,1
2021-07-06,2021,ARI,COL,4,3,-126,-1.5,155,8.5,100,-120,116,1.5,-175,4.74,Chase Field,7,1
2021-07-06,2021,MIN,CWS,1,4,108,1.5,-155,8.0,-105,-115,-118,-1.5,135,3.85,Target Field,5,-3
2021-07-06,2021,TEX,DET,10,5,-167,-1.5,105,9.0,-105,-115,157,1.5,-125,5.63,Globe Life Field,15,5
2021-07-06,2021,OAK,HOU,6,9,146,1.5,-145,8.5,-105,-115,-156,-1.5,125,3.46,Minute Maid Park,15,-3
2021-07-06,2021,CIN,KC,6,7,-153,-1.5,100,9.5,-120,100,143,1.5,-120,5.75,Kauffman Stadium,13,-1
2021-07-06,2021,BOS,LAA,3,5,-113,-1.5,140,8.5,100,-120,103,1.5,-160,4.51,Angel Stadium,8,-2
2021-07-06,2021,MIA,LAD,2,1,124,1.5,-145,8.0,-115,-105,-134,-1.5,125,3.57,Marlins Park,3,1
2021-07-06,2021,LAD,MIA,1,2,-134,-1.5,125,8.0,-115,-105,124,1.5,-145,4.58,Marlins Park,3,-1
2021-07-06,2021,CWS,MIN,4,1,-118,-1.5,135,8.0,-105,-115,108,1.5,-155,4.33,Target Field,5,3
2021-07-06,2021,SEA,NYY,1,12,153,1.5,-105,9.5,-105,-115,-163,-1.5,-115,3.75,T-Mobile Park,13,-11
2021-07-06,2021,HOU,OAK,9,6,-156,-1.5,125,8.5,-105,-115,146,1.5,-145,5.18,Minute Maid Park,15,3
2021-07-06,2021,CHC,PHI,10,15,126,1.5,-135,10.0,-115,-105,-136,-1.5,115,4.42,Wrigley Field,25,-5
2021-07-06,2021,ATL,PIT,1,2,-184,-1.5,-120,9.0,-105,-115,169,1.5,100,5.83,PNC Park,3,-1
2021-07-06,2021,WSH,SD,4,7,152,1.5,-135,9.0,-115,-105,-162,-1.5,115,3.57,PETCO Park,11,-3
2021-07-06,2021,NYY,SEA,12,1,-163,-1.5,-115,9.5,-105,-115,153,1.5,-105,5.89,T-Mobile Park,13,11
2021-07-06,2021,STL,SF,6,5,120,1.5,-175,8.0,-120,100,-130,-1.5,155,3.64,AT&T Park,11,1
2021-07-06,2021,SF,STL,5,6,-130,-1.5,155,8.0,-120,100,120,1.5,-175,4.52,AT&T Park,11,-1
2021-07-06,2021,DET,TEX,5,10,157,1.5,-125,9.0,-105,-115,-167,-1.5,105,3.5,Globe Life Field,15,-5
2021-07-06,2021,BAL,TOR,7,5,170,1.5,110,11.0,-120,100,-185,-1.5,-130,4.07,Camden Yards,12,2
2021-07-06,2021,SD,WSH,7,4,-162,-1.5,115,9.0,-115,-105,152,1.5,-135,5.56,PETCO Park,11,3
2021-07-07,2021,COL,ARI,4,6,-106,-1.5,145,9.5,-105,-115,-104,1.5,-165,4.89,Chase Field,10,-2
2021-07-07,2021,PIT,ATL,3,14,141,1.5,-120,9.5,-105,-115,-151,-1.5,100,3.94,PNC Park,17,-11
2021-07-07,2021,TOR,BAL,10,2,-184,-1.5,-130,11.0,-105,-115,169,1.5,110,7.13,Camden Yards,12,8
2021-07-07,2021,LAA,BOS,5,4,119,1.5,-140,9.5,-105,-115,-129,-1.5,120,4.34,Angel Stadium,9,1
2021-07-07,2021,PHI,CHC,3,8,-138,-1.5,115,7.5,100,-120,128,1.5,-135,4.35,Wrigley Field,11,-5
2021-07-07,2021,KC,CIN,2,5,116,1.5,-140,9.5,100,-120,-126,-1.5,120,4.4,Kauffman Stadium,7,-3
2021-07-07,2021,TB,CLE,8,1,-150,-1.5,140,7.0,105,-125,140,1.5,-160,4.2,Tropicana Field,9,7
2021-07-07,2021,TB,CLE,4,0,-200,-1.5,100,6.5,-115,-105,180,1.5,-120,4.33,Tropicana Field,4,4
2021-07-07,2021,ARI,COL,6,4,-104,1.5,-165,9.5,-105,-115,-106,-1.5,145,4.84,Chase Field,10,2
2021-07-07,2021,MIN,CWS,1,6,-112,-1.5,190,8.5,-105,-115,102,1.5,-215,4.49,Target Field,7,-5
2021-07-07,2021,TEX,DET,3,5,-142,-1.5,130,8.0,-105,-115,132,1.5,-150,4.69,Globe Life Field,8,-2
2021-07-07,2021,OAK,HOU,3,4,144,1.5,-145,8.5,-110,-110,-154,-1.5,125,3.48,Minute Maid Park,7,-1
2021-07-07,2021,CIN,KC,5,2,-126,-1.5,120,9.5,100,-120,116,1.5,-140,5.3,Kauffman Stadium,7,3
2021-07-07,2021,BOS,LAA,4,5,-129,-1.5,120,9.5,-105,-115,119,1.5,-140,5.35,Angel Stadium,9,-1
2021-07-07,2021,MIA,LAD,9,6,150,1.5,-115,9.0,100,-120,-160,-1.5,-105,3.6,Marlins Park,15,3
2021-07-07,2021,LAD,MIA,6,9,-160,-1.5,-105,9.0,100,-120,150,1.5,-115,5.54,Marlins Park,15,-3
2021-07-07,2021,NYM,MIL,4,3,-170,-1.5,165,4.5,-110,-110,160,1.5,-185,2.83,Citi Field,7,1
2021-07-07,2021,NYM,MIL,0,5,-117,-1.5,185,7.0,-105,-115,107,1.5,-210,3.77,Citi Field,5,-5
2021-07-07,2021,CWS,MIN,6,1,102,1.5,-215,8.5,-105,-115,-112,-1.5,190,4.21,Target Field,7,5
2021-07-07,2021,MIL,NYM,3,4,160,1.5,-185,4.5,-110,-110,-170,-1.5,165,1.73,Citi Field,7,-1
2021-07-07,2021,MIL,NYM,5,0,107,1.5,-210,7.0,-105,-115,-117,-1.5,185,3.38,Citi Field,5,5
2021-07-07,2021,SEA,NYY,4,5,-118,-1.5,170,8.5,-115,-105,108,1.5,-190,4.6,T-Mobile Park,9,-1
2021-07-07,2021,HOU,OAK,4,3,-154,-1.5,125,8.5,-110,-110,144,1.5,-145,5.15,Minute Maid Park,7,1
2021-07-07,2021,CHC,PHI,8,3,128,1.5,-135,7.5,100,-120,-138,-1.5,115,3.29,Wrigley Field,11,5
2021-07-07,2021,ATL,PIT,14,3,-151,-1.5,100,9.5,-105,-115,141,1.5,-120,5.72,PNC Park,17,11
2021-07-07,2021,WSH,SD,15,5,160,1.5,-130,8.0,-120,100,-170,-1.5,110,3.08,PETCO Park,20,10
2021-07-07,2021,NYY,SEA,5,4,108,1.5,-190,8.5,-115,-105,-118,-1.5,170,4.09,T-Mobile Park,9,1
2021-07-07,2021,STL,SF,2,5,158,1.5,-140,9.0,-105,-115,-168,-1.5,120,3.49,AT&T Park,7,-3
2021-07-07,2021,SF,STL,5,2,-168,-1.5,120,9.0,-105,-115,158,1.5,-140,5.64,AT&T Park,7,3
2021-07-07,2021,CLE,TB,1,8,140,1.5,-160,7.0,105,-125,-150,-1.5,140,2.92,Tropicana Field,9,-7
2021-07-07,2021,CLE,TB,0,4,180,1.5,-120,6.5,-115,-105,-200,-1.5,100,2.32,Tropicana Field,4,-4
2021-07-07,2021,DET,TEX,5,3,132,1.5,-150,8.0,-105,-115,-142,-1.5,130,3.45,Globe Life Field,8,2
2021-07-07,2021,BAL,TOR,2,10,169,1.5,110,11.0,-105,-115,-184,-1.5,-130,4.09,Camden Yards,12,-8
2021-07-07,2021,SD,WSH,5,15,-170,-1.5,110,8.0,-120,100,160,1.5,-130,5.04,PETCO Park,20,-10
2021-07-08,2021,COL,ARI,9,3,105,1.5,-175,9.5,-115,-105,-115,-1.5,155,4.63,Chase Field,12,6
2021-07-08,2021,PHI,CHC,8,0,-104,1.5,-210,7.5,100,-120,-106,-1.5,185,3.82,Wrigley Field,8,8
2021-07-08,2021,MIL,CIN,5,3,-111,-1.5,170,8.5,-115,-105,101,1.5,-190,4.47,Miller Park,8,2
2021-07-08,2021,KC,CLE,4,7,127,1.5,-155,9.5,-105,-115,-137,-1.5,135,4.19,Progressive Field,11,-3
2021-07-08,2021,ARI,COL,3,9,-115,-1.5,155,9.5,-115,-105,105,1.5,-175,5.08,Chase Field,12,-6
2021-07-08,2021,MIN,DET,5,3,-134,-1.5,135,9.5,-105,-115,124,1.5,-155,5.44,Target Field,8,2
2021-07-08,2021,OAK,HOU,2,1,161,1.5,-135,9.0,100,-120,-172,-1.5,115,3.45,Minute Maid Park,3,1
2021-07-08,2021,CLE,KC,7,4,-137,-1.5,135,9.5,-105,-115,127,1.5,-155,5.49,Progressive Field,11,3
2021-07-08,2021,MIA,LAD,1,6,146,1.5,-125,7.0,-120,100,-156,-1.5,105,2.85,Marlins Park,7,-5
2021-07-08,2021,LAD,MIA,6,1,-156,-1.5,105,7.0,-120,100,146,1.5,-125,4.27,Marlins Park,7,5
2021-07-08,2021,CIN,MIL,3,5,101,1.5,-190,8.5,-115,-105,-111,-1.5,170,4.23,Miller Park,8,-2
2021-07-08,2021,DET,MIN,3,5,124,1.5,-155,9.5,-105,-115,-134,-1.5,135,4.24,Target Field,8,-2
2021-07-08,2021,SEA,NYY,4,0,124,1.5,-135,8.5,-105,-115,-134,-1.5,115,3.79,T-Mobile Park,4,4
2021-07-08,2021,HOU,OAK,1,2,-172,-1.5,115,9.0,100,-120,161,1.5,-135,5.69,Minute Maid Park,3,-1
2021-07-08,2021,CHC,PHI,0,8,-106,-1.5,185,7.5,100,-120,-104,1.5,-210,3.86,Wrigley Field,8,-8
2021-07-08,2021,WSH,SD,8,9,138,1.5,-170,7.0,-115,-105,-148,-1.5,150,2.94,PETCO Park,17,-1
2021-07-08,2021,NYY,SEA,0,4,-134,-1.5,115,8.5,-105,-115,124,1.5,-135,4.87,T-Mobile Park,4,-4
2021-07-08,2021,SD,WSH,9,8,-148,-1.5,150,7.0,-115,-105,138,1.5,-170,4.18,PETCO Park,17,1
2021-07-09,2021,LAD,ARI,2,5,-270,-1.5,-135,8.5,-120,100,240,1.5,115,6.2,Dodger Stadium,7,-3
2021-07-09,2021,MIA,ATL,0,5,142,1.5,-125,8.0,-120,100,-152,-1.5,105,3.31,Marlins Park,5,-5
2021-07-09,2021,CWS,BAL,12,1,-132,-1.5,115,10.0,-110,-110,122,1.5,-135,5.69,Camden Yards,13,11
2021-07-09,2021,PHI,BOS,5,11,118,1.5,-160,11.5,-110,-110,-128,-1.5,140,5.28,Fenway Park,16,-6
2021-07-09,2021,STL,CHC,5,10,138,1.5,-150,7.5,-115,-105,-148,-1.5,130,3.15,Wrigley Field,15,-5
2021-07-09,2021,MIL,CIN,0,2,-117,-1.5,175,9.0,100,-120,107,1.5,-200,4.85,Miller Park,2,-2
2021-07-09,2021,KC,CLE,1,2,130,1.5,-145,9.5,-115,-105,-140,-1.5,125,4.13,Progressive Field,3,-1
2021-07-09,2021,SD,COL,4,2,-192,-1.5,100,9.0,-110,-110,176,1.5,-120,5.92,PETCO Park,6,2
2021-07-09,2021,BAL,CWS,1,12,122,1.5,-135,10.0,-110,-110,-132,-1.5,115,4.5,Camden Yards,13,-11
2021-07-09,2021,MIN,DET,4,2,-230,-1.5,-120,9.5,-105,-115,205,1.5,100,6.62,Target Field,6,2
2021-07-09,2021,NYY,HOU,4,0,122,1.5,-155,9.0,-115,-105,-132,-1.5,135,4.05,Minute Maid Park,4,4
2021-07-09,2021,CLE,KC,2,1,-140,-1.5,125,9.5,-115,-105,130,1.5,-145,5.54,Progressive Field,3,1
2021-07-09,2021,SEA,LAA,7,3,108,1.5,-150,9.0,100,-120,-118,-1.5,130,4.33,T-Mobile Park,10,4
2021-07-09,2021,ARI,LAD,5,2,240,1.5,115,8.5,-120,100,-270,-1.5,-135,2.5,Dodger Stadium,7,3
2021-07-09,2021,ATL,MIA,5,0,-152,-1.5,105,8.0,-120,100,142,1.5,-125,4.83,Marlins Park,5,5
2021-07-09,2021,CIN,MIL,2,0,107,1.5,-200,9.0,100,-120,-117,-1.5,175,4.35,Miller Park,2,2
2021-07-09,2021,DET,MIN,2,4,205,1.5,100,9.5,-105,-115,-230,-1.5,-120,3.11,Target Field,6,-2
2021-07-09,2021,PIT,NYM,4,13,180,1.5,-115,7.5,-120,100,-200,-1.5,-105,2.68,Citi Field,17,-9
2021-07-09,2021,HOU,NYY,0,4,-132,-1.5,135,9.0,-115,-105,122,1.5,-155,5.12,Minute Maid Park,4,-4
2021-07-09,2021,TEX,OAK,3,2,116,1.5,-140,9.0,-120,100,-126,-1.5,120,4.17,Globe Life Field,5,1
2021-07-09,2021,BOS,PHI,11,5,-128,-1.5,140,11.5,-110,-110,118,1.5,-160,6.46,Fenway Park,16,6
2021-07-09,2021,NYM,PIT,13,4,-200,-1.5,-105,7.5,-120,100,180,1.5,-115,5.0,Citi Field,17,9
2021-07-09,2021,COL,SD,2,4,176,1.5,-120,9.0,-110,-110,-192,-1.5,100,3.26,PETCO Park,6,-2
2021-07-09,2021,LAA,SEA,3,7,-118,-1.5,130,9.0,100,-120,108,1.5,-150,4.87,T-Mobile Park,10,-4
2021-07-09,2021,WSH,SF,3,5,133,1.5,-160,8.5,-115,-105,-143,-1.5,140,3.65,AT&T Park,8,-2
2021-07-09,2021,CHC,STL,10,5,-148,-1.5,130,7.5,-115,-105,138,1.5,-150,4.48,Wrigley Field,15,5
2021-07-09,2021,TOR,TB,1,7,112,1.5,-175,8.5,-115,-105,-122,-1.5,155,4.01,Tropicana Field,8,-6
2021-07-09,2021,OAK,TEX,2,3,-126,-1.5,120,9.0,-120,100,116,1.5,-140,5.02,Globe Life Field,5,-1
2021-07-09,2021,TB,TOR,7,1,-122,-1.5,155,8.5,-115,-105,112,1.5,-175,4.67,Tropicana Field,8,6
2021-07-09,2021,SF,WSH,5,3,-143,-1.5,140,8.5,-115,-105,133,1.5,-160,5.0,AT&T Park,8,2
2021-07-10,2021,LAD,ARI,22,1,-296,-1.5,-150,8.0,-110,-110,256,1.5,130,5.98,Dodger Stadium,23,21
2021-07-10,2021,MIA,ATL,4,5,-110,-1.5,190,7.0,-120,100,100,1.5,-215,3.67,Marlins Park,9,-1
2021-07-10,2021,CWS,BAL,8,3,-200,-1.5,-140,10.5,-105,-115,180,1.5,120,7.0,Camden Yards,11,5
2021-07-10,2021,PHI,BOS,11,2,145,1.5,-125,11.0,-110,-110,-155,-1.5,105,4.49,Fenway Park,13,9
2021-07-10,2021,STL,CHC,6,0,101,1.5,-200,8.0,-115,-105,-111,-1.5,175,3.98,Wrigley Field,6,6
2021-07-10,2021,MIL,CIN,3,4,-205,-1.5,-105,8.5,-115,-105,185,1.5,-115,5.71,Miller Park,7,-1
2021-07-10,2021,KC,CLE,6,14,117,1.5,-170,9.0,-115,-105,-127,-1.5,150,4.15,Progressive Field,20,-8
2021-07-10,2021,SD,COL,0,3,-208,-1.5,100,7.5,100,-120,188,1.5,-120,5.06,PETCO Park,3,-3
2021-07-10,2021,BAL,CWS,3,8,180,1.5,120,10.5,-105,-115,-200,-1.5,-140,3.75,Camden Yards,11,-5
2021-07-10,2021,MIN,DET,9,4,-180,-1.5,100,9.5,-110,-110,165,1.5,-120,6.11,Target Field,13,5
2021-07-10,2021,NYY,HOU,1,0,-106,-1.5,150,8.0,-115,-105,-104,1.5,-170,4.12,Minute Maid Park,1,1
2021-07-10,2021,CLE,KC,14,6,-127,-1.5,150,9.0,-115,-105,117,1.5,-170,5.04,Progressive Field,20,8
2021-07-10,2021,SEA,LAA,2,0,-107,-1.5,180,8.0,-120,100,-103,1.5,-205,4.14,T-Mobile Park,2,2
2021-07-10,2021,ARI,LAD,1,22,256,1.5,130,8.0,-110,-110,-296,-1.5,-150,2.25,Dodger Stadium,23,-21
2021-07-10,2021,ATL,MIA,5,4,100,1.5,-215,7.0,-120,100,-110,-1.5,190,3.5,Marlins Park,9,1
2021-07-10,2021,CIN,MIL,4,3,185,1.5,-115,8.5,-115,-105,-205,-1.5,-105,2.98,Miller Park,7,1
2021-07-10,2021,DET,MIN,4,9,165,1.5,-120,9.5,-110,-110,-180,-1.5,100,3.58,Target Field,13,-5
2021-07-10,2021,PIT,NYM,6,2,170,1.5,-145,6.0,-110,-110,-185,-1.5,125,2.22,Citi Field,8,4
2021-07-10,2021,PIT,NYM,2,4,199,1.5,-130,6.5,-105,-115,-219,-1.5,110,2.17,Citi Field,6,-2
2021-07-10,2021,HOU,NYY,0,1,-104,1.5,-170,8.0,-115,-105,-106,-1.5,150,4.08,Minute Maid Park,1,-1
2021-07-10,2021,TEX,OAK,4,8,116,1.5,-135,9.0,-115,-105,-126,-1.5,115,4.17,Globe Life Field,12,-4
2021-07-10,2021,BOS,PHI,2,11,-155,-1.5,105,11.0,-110,-110,145,1.5,-125,6.69,Fenway Park,13,-9
2021-07-10,2021,NYM,PIT,2,6,-185,-1.5,125,6.0,-110,-110,170,1.5,-145,3.89,Citi Field,8,-4
2021-07-10,2021,NYM,PIT,4,2,-219,-1.5,110,6.5,-105,-115,199,1.5,-130,4.46,Citi Field,6,2
2021-07-10,2021,COL,SD,3,0,188,1.5,-120,7.5,100,-120,-208,-1.5,100,2.6,PETCO Park,3,3
2021-07-10,2021,LAA,SEA,0,2,-103,1.5,-205,8.0,-120,100,-107,-1.5,180,4.06,T-Mobile Park,2,-2
2021-07-10,2021,WSH,SF,4,10,170,1.5,-115,8.5,-115,-105,-185,-1.5,-105,3.15,AT&T Park,14,-6
2021-07-10,2021,CHC,STL,0,6,-111,-1.5,175,8.0,-115,-105,101,1.5,-200,4.21,Wrigley Field,6,-6
2021-07-10,2021,TOR,TB,2,5,102,1.5,-200,9.0,100,-120,-112,-1.5,175,4.46,Tropicana Field,7,-3
2021-07-10,2021,OAK,TEX,8,4,-126,-1.5,115,9.0,-115,-105,116,1.5,-135,5.02,Globe Life Field,12,4
2021-07-10,2021,TB,TOR,5,2,-112,-1.5,175,9.0,100,-120,102,1.5,-200,4.75,Tropicana Field,7,3
2021-07-10,2021,SF,WSH,10,4,-185,-1.5,-105,8.5,-115,-105,170,1.5,-115,5.52,AT&T Park,14,6
2021-07-11,2021,LAD,ARI,7,4,-300,-1.5,-150,9.0,-110,-110,260,1.5,130,6.75,Dodger Stadium,11,3
2021-07-11,2021,MIA,ATL,7,4,-128,-1.5,170,6.5,-125,105,118,1.5,-190,3.65,Marlins Park,11,3
2021-07-11,2021,CWS,BAL,7,5,-172,-1.5,-125,10.0,-115,-110,161,1.5,105,6.32,Camden Yards,12,2
2021-07-11,2021,PHI,BOS,5,4,180,1.5,-105,10.5,-120,100,-200,-1.5,-115,3.75,Fenway Park,9,1
2021-07-11,2021,MIL,CIN,1,3,-169,-1.5,130,7.5,-110,-115,159,1.5,-150,4.71,Miller Park,4,-2
2021-07-11,2021,SD,COL,1,3,-186,-1.5,100,8.5,-120,100,171,1.5,-120,5.53,PETCO Park,4,-2
2021-07-11,2021,BAL,CWS,5,7,161,1.5,105,10.0,-115,-110,-172,-1.5,-125,3.83,Camden Yards,12,-2
2021-07-11,2021,MIN,DET,12,9,-220,-1.5,-120,9.0,-110,-115,200,1.5,100,6.19,Target Field,21,3
2021-07-11,2021,NYY,HOU,7,8,120,1.5,-165,8.5,-115,-110,-130,-1.5,145,3.86,Minute Maid Park,15,-1
2021-07-11,2021,SEA,LAA,1,7,-109,1.5,-175,9.0,-120,100,-101,-1.5,155,4.69,T-Mobile Park,8,-6
2021-07-11,2021,ARI,LAD,4,7,260,1.5,130,9.0,-110,-110,-300,-1.5,-150,2.5,Dodger Stadium,11,-3
2021-07-11,2021,ATL,MIA,4,7,118,1.5,-190,6.5,-125,105,-128,-1.5,170,2.98,Marlins Park,11,-3
2021-07-11,2021,CIN,MIL,3,1,159,1.5,-150,7.5,-110,-115,-169,-1.5,130,2.9,Miller Park,4,2
2021-07-11,2021,DET,MIN,9,12,200,1.5,100,9.0,-110,-115,-220,-1.5,-120,3.0,Target Field,21,-3
2021-07-11,2021,PIT,NYM,6,5,200,1.5,105,9.0,-110,-115,-220,-1.5,-125,3.0,Citi Field,11,1
2021-07-11,2021,HOU,NYY,8,7,-130,-1.5,145,8.5,-115,-110,120,1.5,-165,4.8,Minute Maid Park,15,1
2021-07-11,2021,TEX,OAK,1,4,125,1.5,-135,8.0,-120,100,-135,-1.5,115,3.56,Globe Life Field,5,-3
2021-07-11,2021,BOS,PHI,4,5,-200,-1.5,-115,10.5,-120,100,180,1.5,-105,7.0,Fenway Park,9,-1
2021-07-11,2021,NYM,PIT,5,6,-220,-1.5,-125,9.0,-110,-115,200,1.5,105,6.19,Citi Field,11,-1
2021-07-11,2021,COL,SD,3,1,171,1.5,-120,8.5,-120,100,-186,-1.5,100,3.14,PETCO Park,4,2
2021-07-11,2021,LAA,SEA,7,1,-101,-1.5,155,9.0,-120,100,-109,1.5,-175,4.52,T-Mobile Park,8,6
2021-07-11,2021,WSH,SF,1,3,175,1.5,-125,8.0,-120,100,-190,-1.5,105,2.91,AT&T Park,4,-2
2021-07-11,2021,TOR,TB,3,1,-119,-1.5,135,8.5,-120,100,109,1.5,-155,4.62,Tropicana Field,4,2
2021-07-11,2021,OAK,TEX,4,1,-135,-1.5,115,8.0,-120,100,125,1.5,-135,4.6,Globe Life Field,5,3
2021-07-11,2021,TB,TOR,1,3,109,1.5,-155,8.5,-120,100,-119,-1.5,135,4.07,Tropicana Field,4,-2
2021-07-11,2021,SF,WSH,3,1,-190,-1.5,105,8.0,-120,100,175,1.5,-125,5.24,AT&T Park,4,2
2021-07-16,2021,CHC,ARI,5,1,-152,-1.5,100,9.0,-125,105,142,1.5,-120,5.43,Chase Field,6,4
2021-07-16,2021,TB,ATL,7,6,116,1.5,-175,8.5,-110,-115,-126,-1.5,155,3.94,Suntrust Park,13,1
2021-07-16,2021,KC,BAL,9,2,-149,-1.5,120,9.5,-110,-110,139,1.5,-140,5.68,Kauffman Stadium,11,7
2021-07-16,2021,NYY,BOS,0,4,101,1.5,-160,9.5,-110,-110,-111,-1.5,140,4.73,Yankee Stadium,4,-4
2021-07-16,2021,ARI,CHC,1,5,142,1.5,-120,9.0,-125,105,-152,-1.5,100,3.72,Chase Field,6,-4
2021-07-16,2021,MIL,CIN,11,6,117,1.5,-175,9.0,-125,105,-127,-1.5,155,4.15,Great American Ballpark,17,5
2021-07-16,2021,OAK,CLE,5,4,-188,-1.5,-105,8.5,-110,-115,173,1.5,-115,5.55,Oakland Coliseum,9,1
2021-07-16,2021,LAD,COL,10,4,-247,-1.5,-165,12.0,-110,-110,217,1.5,145,8.54,Coors Field,14,6
2021-07-16,2021,HOU,CWS,7,1,-124,-1.5,125,9.0,100,-120,114,1.5,-145,4.98,Guaranteed Rate Field,8,6
2021-07-16,2021,CWS,HOU,1,7,114,1.5,-145,9.0,100,-120,-124,-1.5,125,4.21,Guaranteed Rate Field,8,-6
2021-07-16,2021,BAL,KC,2,9,139,1.5,-140,9.5,-110,-110,-149,-1.5,120,3.97,Kauffman Stadium,11,-7
2021-07-16,2021,SEA,LAA,6,5,133,1.5,-145,8.5,-120,100,-143,-1.5,125,3.65,Angel Stadium,11,1
2021-07-16,2021,COL,LAD,4,10,217,1.5,145,12.0,-110,-110,-247,-1.5,-165,3.79,Coors Field,14,-6
2021-07-16,2021,PHI,MIA,5,2,118,1.5,-165,7.0,-115,-110,-128,-1.5,145,3.21,Citizens Bank Park,7,3
2021-07-16,2021,PHI,MIA,0,7,-162,-1.5,145,6.5,-110,-110,152,1.5,-165,4.02,Citizens Bank Park,7,-7
2021-07-16,2021,CIN,MIL,6,11,-127,-1.5,155,9.0,-125,105,117,1.5,-175,5.04,Great American Ballpark,17,-5
2021-07-16,2021,PIT,NYM,4,1,148,1.5,-120,8.5,-120,100,-158,-1.5,100,3.43,PNC Park,5,3
2021-07-16,2021,BOS,NYY,4,0,-111,-1.5,140,9.5,-110,-110,101,1.5,-160,5.0,Yankee Stadium,4,4
2021-07-16,2021,CLE,OAK,4,5,173,1.5,-115,8.5,-110,-115,-188,-1.5,-105,3.11,Oakland Coliseum,9,-1
2021-07-16,2021,MIA,PHI,2,5,-128,-1.5,145,7.0,-115,-110,118,1.5,-165,3.93,Citizens Bank Park,7,-3
2021-07-16,2021,MIA,PHI,7,0,152,1.5,-165,6.5,-110,-110,-162,-1.5,145,2.58,Citizens Bank Park,7,7
2021-07-16,2021,NYM,PIT,1,4,-158,-1.5,100,8.5,-120,100,148,1.5,-120,5.21,PNC Park,5,-3
2021-07-16,2021,WSH,SD,8,24,138,1.5,-130,9.5,-115,-110,-148,-1.5,110,3.99,Nationals Park,32,-16
2021-07-16,2021,LAA,SEA,5,6,-143,-1.5,125,8.5,-120,100,133,1.5,-145,5.0,Angel Stadium,11,-1
2021-07-16,2021,STL,SF,2,7,-112,-1.5,185,8.0,-115,-110,102,1.5,-210,4.23,Busch Stadium,9,-5
2021-07-16,2021,SF,STL,7,2,102,1.5,-210,8.0,-115,-110,-112,-1.5,185,3.96,Busch Stadium,9,5
2021-07-16,2021,ATL,TB,6,7,-126,-1.5,155,8.5,-110,-115,116,1.5,-175,4.74,Suntrust Park,13,-1
2021-07-16,2021,TOR,TEX,10,2,-270,-1.5,-145,9.5,100,-120,240,1.5,125,6.93,Sahlen Field,12,8
2021-07-16,2021,TEX,TOR,2,10,240,1.5,125,9.5,100,-120,-270,-1.5,-145,2.79,Sahlen Field,12,-8
2021-07-16,2021,SD,WSH,24,8,-148,-1.5,110,9.5,-115,-110,138,1.5,-130,5.67,Nationals Park,32,16
2021-07-17,2021,CHC,ARI,4,2,-121,-1.5,135,9.0,-110,-115,111,1.5,-155,4.93,Chase Field,6,2
2021-07-17,2021,TB,ATL,0,9,105,1.5,-205,8.5,-110,-110,-115,-1.5,180,4.15,Suntrust Park,9,-9
2021-07-17,2021,KC,BAL,4,8,-155,-1.5,125,9.5,100,-120,145,1.5,-145,5.77,Kauffman Stadium,12,-4
2021-07-17,2021,NYY,BOS,3,1,-131,-1.5,155,8.0,-115,-110,121,1.5,-175,4.54,Yankee Stadium,4,2
2021-07-17,2021,ARI,CHC,2,4,111,1.5,-155,9.0,-110,-115,-121,-1.5,135,4.27,Chase Field,6,-2
2021-07-17,2021,MIL,CIN,7,4,-136,-1.5,120,8.0,-110,-110,126,1.5,-140,4.61,Great American Ballpark,11,3
2021-07-17,2021,OAK,CLE,2,3,-168,-1.5,110,8.5,-115,-110,158,1.5,-130,5.33,Oakland Coliseum,5,-1
2021-07-17,2021,LAD,COL,9,2,-240,-1.5,-165,11.5,-110,-110,210,1.5,145,8.12,Coors Field,11,7
2021-07-17,2021,HOU,CWS,1,10,-101,1.5,-200,9.0,-110,-110,-109,-1.5,175,4.52,Guaranteed Rate Field,11,-9
2021-07-17,2021,MIN,DET,0,1,-124,-1.5,130,8.0,-110,-115,114,1.5,-150,4.43,Comerica Park,1,-1
2021-07-17,2021,MIN,DET,4,5,-167,-1.5,-105,7.0,100,-120,157,1.5,-115,4.38,Comerica Park,9,-1
2021-07-17,2021,CWS,HOU,10,1,-109,-1.5,175,9.0,-110,-110,-101,1.5,-200,4.69,Guaranteed Rate Field,11,9
2021-07-17,2021,BAL,KC,8,4,145,1.5,-145,9.5,100,-120,-155,-1.5,125,3.88,Kauffman Stadium,12,4
2021-07-17,2021,SEA,LAA,4,9,120,1.5,-165,8.5,-110,-115,-130,-1.5,145,3.86,Angel Stadium,13,-5
2021-07-17,2021,COL,LAD,2,9,210,1.5,145,11.5,-110,-110,-240,-1.5,-165,3.71,Coors Field,11,-7
2021-07-17,2021,PHI,MIA,4,2,-121,-1.5,160,9.5,-120,100,111,1.5,-180,5.2,Citizens Bank Park,6,2
2021-07-17,2021,CIN,MIL,4,7,126,1.5,-140,8.0,-110,-110,-136,-1.5,120,3.54,Great American Ballpark,11,-3
2021-07-17,2021,DET,MIN,1,0,114,1.5,-150,8.0,-110,-115,-124,-1.5,130,3.74,Comerica Park,1,1
2021-07-17,2021,DET,MIN,5,4,157,1.5,-115,7.0,100,-120,-167,-1.5,-105,2.72,Comerica Park,9,1
2021-07-17,2021,PIT,NYM,9,7,153,1.5,-110,9.0,-120,100,-163,-1.5,-110,3.56,PNC Park,16,2
2021-07-17,2021,BOS,NYY,1,3,121,1.5,-175,8.0,-115,-110,-131,-1.5,155,3.62,Yankee Stadium,4,-2
2021-07-17,2021,CLE,OAK,3,2,158,1.5,-130,8.5,-115,-110,-168,-1.5,110,3.29,Oakland Coliseum,5,1
2021-07-17,2021,MIA,PHI,2,4,111,1.5,-180,9.5,-120,100,-121,-1.5,160,4.5,Citizens Bank Park,6,-2
2021-07-17,2021,NYM,PIT,7,9,-163,-1.5,-110,9.0,-120,100,153,1.5,-110,5.58,PNC Park,16,-2
2021-07-17,2021,WSH,SD,4,10,120,1.5,-135,9.5,-110,-115,-130,-1.5,115,4.32,Nationals Park,14,-6
2021-07-17,2021,LAA,SEA,9,4,-130,-1.5,145,8.5,-110,-115,120,1.5,-165,4.8,Angel Stadium,13,5
2021-07-17,2021,STL,SF,3,1,100,1.5,-165,8.0,-110,-110,-110,-1.5,145,4.0,Busch Stadium,4,2
2021-07-17,2021,SF,STL,1,3,-110,-1.5,145,8.0,-110,-110,100,1.5,-165,4.19,Busch Stadium,4,-2
2021-07-17,2021,ATL,TB,9,0,-115,-1.5,180,8.5,-110,-110,105,1.5,-205,4.55,Suntrust Park,9,9
2021-07-17,2021,SD,WSH,10,4,-130,-1.5,115,9.5,-110,-115,120,1.5,-135,5.37,Nationals Park,14,6
2021-07-18,2021,CHC,ARI,4,6,-106,-1.5,138,9.0,-101,-111,-102,1.5,-154,4.63,Chase Field,10,-2
2021-07-18,2021,TB,ATL,7,5,101,1.5,-190,9.0,-104,-108,-109,-1.5,169,4.48,Suntrust Park,12,2
2021-07-18,2021,KC,BAL,0,5,-147,-1.5,122,10.0,-103,-109,135,1.5,-135,5.95,Kauffman Stadium,5,-5
2021-07-18,2021,NYY,BOS,9,1,-118,-1.5,152,9.5,-110,-102,109,1.5,-169,5.14,Yankee Stadium,10,8
2021-07-18,2021,ARI,CHC,6,4,-102,1.5,-154,9.0,-101,-111,-106,-1.5,138,4.54,Chase Field,10,2
2021-07-18,2021,MIL,CIN,8,0,-116,-1.5,146,7.5,-104,-108,107,1.5,-162,4.03,Great American Ballpark,8,8
2021-07-18,2021,OAK,CLE,2,4,-170,-1.5,112,8.0,-103,-109,155,1.5,-124,5.04,Oakland Coliseum,6,-2
2021-07-18,2021,LAD,COL,5,6,-153,-1.5,-108,11.5,-112,-100,140,1.5,-102,6.95,Coors Field,11,-1
2021-07-18,2021,HOU,CWS,0,4,128,1.5,-164,8.0,-105,-107,-138,-1.5,147,3.51,Guaranteed Rate Field,4,-4
2021-07-18,2021,MIN,DET,0,7,-126,-1.5,118,10.5,-103,-109,117,1.5,-131,5.85,Comerica Park,7,-7
2021-07-18,2021,CWS,HOU,4,0,-138,-1.5,147,8.0,-105,-107,128,1.5,-164,4.64,Guaranteed Rate Field,4,4
2021-07-18,2021,BAL,KC,5,0,135,1.5,-135,10.0,-103,-109,-147,-1.5,122,4.26,Kauffman Stadium,5,5
2021-07-18,2021,SEA,LAA,7,4,124,1.5,-159,8.5,-117,104,-134,-1.5,143,3.79,Angel Stadium,11,3
2021-07-18,2021,COL,LAD,6,5,140,1.5,-102,11.5,-112,-100,-153,-1.5,-108,4.79,Coors Field,11,1
2021-07-18,2021,PHI,MIA,7,4,-230,-1.5,-120,8.0,-110,-110,205,1.5,100,5.58,Citizens Bank Park,11,3
2021-07-18,2021,CIN,MIL,0,8,107,1.5,-162,7.5,-104,-108,-116,-1.5,146,3.62,Great American Ballpark,8,-8
2021-07-18,2021,DET,MIN,7,0,117,1.5,-131,10.5,-103,-109,-126,-1.5,118,4.84,Comerica Park,7,7
2021-07-18,2021,PIT,NYM,6,7,126,1.5,-125,8.5,100,-112,-137,-1.5,113,3.76,PNC Park,13,-1
2021-07-18,2021,BOS,NYY,1,9,109,1.5,-169,9.5,-110,-102,-118,-1.5,152,4.55,Yankee Stadium,10,-8
2021-07-18,2021,CLE,OAK,4,2,155,1.5,-124,8.0,-103,-109,-170,-1.5,112,3.14,Oakland Coliseum,6,2
2021-07-18,2021,MIA,PHI,4,7,205,1.5,100,8.0,-110,-110,-230,-1.5,-120,2.62,Citizens Bank Park,11,-3
2021-07-18,2021,NYM,PIT,7,6,-137,-1.5,113,8.5,100,-112,126,1.5,-125,4.91,PNC Park,13,1
2021-07-18,2021,WSH,SD,8,7,-106,1.5,-177,8.0,-110,-102,-102,-1.5,158,4.12,Nationals Park,15,1
2021-07-18,2021,LAA,SEA,4,7,-134,-1.5,143,8.5,-117,104,124,1.5,-159,4.87,Angel Stadium,11,-3
2021-07-18,2021,STL,SF,2,1,104,1.5,-146,9.0,-101,-111,-112,-1.5,132,4.41,Busch Stadium,3,1
2021-07-18,2021,SF,STL,1,2,-112,-1.5,132,9.0,-101,-111,104,1.5,-146,4.75,Busch Stadium,3,-1
2021-07-18,2021,ATL,TB,5,7,-109,-1.5,169,9.0,-104,-108,101,1.5,-190,4.69,Suntrust Park,12,-2
2021-07-18,2021,TOR,TEX,5,0,-229,-1.5,-119,7.5,-116,103,207,1.5,108,5.22,Sahlen Field,5,5
2021-07-18,2021,TOR,TEX,10,0,-206,-1.5,-103,8.0,-106,-106,187,1.5,-107,5.39,Sahlen Field,10,10
2021-07-18,2021,TEX,TOR,0,5,207,1.5,108,7.5,-116,103,-229,-1.5,-119,2.44,Sahlen Field,5,-5
2021-07-18,2021,TEX,TOR,0,10,187,1.5,-107,8.0,-106,-106,-206,-1.5,-103,2.79,Sahlen Field,10,-10
2021-07-18,2021,SD,WSH,7,8,-102,-1.5,158,8.0,-110,-102,-106,1.5,-177,4.04,Nationals Park,15,-1
2021-07-19,2021,PIT,ARI,2,4,108,1.5,-173,9.5,-104,-108,-117,-1.5,155,4.57,Chase Field,6,-2
2021-07-19,2021,TB,BAL,1,6,-277,-1.5,-147,9.0,-101,-111,247,1.5,133,6.61,Tropicana Field,7,-5
2021-07-19,2021,TOR,BOS,4,13,-124,-1.5,140,10.5,-113,100,115,1.5,-155,5.81,Sahlen Field,17,-9
2021-07-19,2021,STL,CHC,8,3,103,1.5,-159,8.5,-112,100,-111,-1.5,143,4.19,Busch Stadium,11,5
2021-07-19,2021,NYM,CIN,15,11,-101,1.5,-189,11.0,-113,100,-108,-1.5,168,5.53,Great American Ballpark,26,4
2021-07-19,2021,HOU,CLE,4,3,-214,-1.5,-113,9.0,-103,-110,194,1.5,103,6.13,Minute Maid Park,7,1
2021-07-19,2021,MIN,CWS,3,2,199,1.5,-104,7.0,-103,-109,-220,-1.5,-106,2.34,Guaranteed Rate Field,5,1
2021-07-19,2021,MIN,CWS,3,5,-114,-1.5,143,7.0,-108,-104,106,1.5,-159,3.73,Guaranteed Rate Field,8,-2
2021-07-19,2021,TEX,DET,0,14,-106,-1.5,149,9.0,100,-112,-102,1.5,-166,4.63,Comerica Park,14,-14
2021-07-19,2021,CLE,HOU,3,4,194,1.5,103,9.0,-103,-110,-214,-1.5,-113,3.06,Minute Maid Park,7,-1
2021-07-19,2021,OAK,LAA,4,1,-122,-1.5,174,8.0,100,-113,113,1.5,-195,4.4,Oakland Coliseum,5,3
2021-07-19,2021,SF,LAD,7,2,115,1.5,-192,7.5,-109,-103,-124,-1.5,171,3.49,Dodger Stadium,9,5
2021-07-19,2021,WSH,MIA,18,1,-132,-1.5,146,9.5,-105,-107,122,1.5,-162,5.41,Nationals Park,19,17
2021-07-19,2021,CWS,MIN,2,3,-220,-1.5,-106,7.0,-103,-109,199,1.5,-104,4.81,Guaranteed Rate Field,5,-1
2021-07-19,2021,CWS,MIN,5,3,106,1.5,-159,7.0,-108,-104,-114,-1.5,143,3.4,Guaranteed Rate Field,8,2
2021-07-19,2021,CIN,NYM,11,15,-108,-1.5,168,11.0,-113,100,-101,1.5,-189,5.71,Great American Ballpark,26,-4
2021-07-19,2021,LAA,OAK,1,4,113,1.5,-195,8.0,100,-113,-122,-1.5,174,3.76,Oakland Coliseum,5,-3
2021-07-19,2021,ARI,PIT,4,2,-117,-1.5,155,9.5,-104,-108,108,1.5,-173,5.12,Chase Field,6,2
2021-07-19,2021,LAD,SF,2,7,-124,-1.5,171,7.5,-109,-103,115,1.5,-192,4.15,Dodger Stadium,9,-5
2021-07-19,2021,CHC,STL,3,8,-111,-1.5,143,8.5,-112,100,103,1.5,-159,4.47,Busch Stadium,11,-5
2021-07-19,2021,BAL,TB,6,1,247,1.5,133,9.0,-101,-111,-277,-1.5,-147,2.59,Tropicana Field,7,5
2021-07-19,2021,DET,TEX,14,0,-102,1.5,-166,9.0,100,-112,-106,-1.5,149,4.54,Comerica Park,14,14
2021-07-19,2021,BOS,TOR,13,4,115,1.5,-155,10.5,-113,100,-124,-1.5,140,4.88,Sahlen Field,17,9
2021-07-19,2021,MIA,WSH,1,18,122,1.5,-162,9.5,-105,-107,-132,-1.5,146,4.28,Nationals Park,19,-17
2021-07-20,2021,PIT,ARI,6,11,-107,1.5,-200,9.0,-110,-110,-103,-1.5,175,4.65,Chase Field,17,-5
2021-07-20,2021,SD,ATL,1,2,-166,-1.5,-110,9.0,-120,100,156,1.5,-110,5.62,Suntrust Park,3,-1
2021-07-20,2021,TB,BAL,9,3,-200,-1.5,-110,7.5,-115,-105,180,1.5,-110,5.0,Tropicana Field,12,6
2021-07-20,2021,STL,CHC,6,7,-109,-1.5,170,9.0,-105,-115,-101,1.5,-190,4.69,Busch Stadium,13,-1
2021-07-20,2021,NYM,CIN,3,4,137,1.5,-155,10.5,-115,-105,-147,-1.5,135,4.43,Great American Ballpark,7,-1
2021-07-20,2021,HOU,CLE,9,3,-205,-1.5,-120,8.5,-115,-105,185,1.5,100,5.71,Minute Maid Park,12,6
2021-07-20,2021,SEA,COL,6,4,165,1.5,-120,11.0,-105,-115,-180,-1.5,100,4.15,Coors Field,10,2
2021-07-20,2021,MIN,CWS,5,9,126,1.5,-150,9.5,-110,-110,-136,-1.5,130,4.2,Guaranteed Rate Field,14,-4
2021-07-20,2021,TEX,DET,1,4,105,1.5,-200,9.0,-105,-115,-115,-1.5,175,4.39,Comerica Park,5,-3
2021-07-20,2021,CLE,HOU,3,9,185,1.5,100,8.5,-115,-105,-205,-1.5,-120,2.98,Minute Maid Park,12,-6
2021-07-20,2021,MIL,KC,2,5,-155,-1.5,115,9.5,100,-120,145,1.5,-135,5.77,Miller Park,7,-3
2021-07-20,2021,OAK,LAA,6,0,-150,-1.5,135,8.5,-105,-115,140,1.5,-155,5.1,Oakland Coliseum,6,6
2021-07-20,2021,SF,LAD,6,8,127,1.5,-160,8.5,-110,-110,-137,-1.5,140,3.74,Dodger Stadium,14,-2
2021-07-20,2021,WSH,MIA,6,3,-105,1.5,-165,9.0,-105,-115,-105,-1.5,145,4.61,Nationals Park,9,3
2021-07-20,2021,KC,MIL,5,2,145,1.5,-135,9.5,100,-120,-155,-1.5,115,3.88,Miller Park,7,3
2021-07-20,2021,CWS,MIN,9,5,-136,-1.5,130,9.5,-110,-110,126,1.5,-150,5.47,Guaranteed Rate Field,14,4
2021-07-20,2021,CIN,NYM,4,3,-147,-1.5,135,10.5,-115,-105,137,1.5,-155,6.25,Great American Ballpark,7,1
2021-07-20,2021,PHI,NYY,4,6,-128,-1.5,125,9.0,-115,-105,118,1.5,-145,5.05,Yankee Stadium,10,-2
2021-07-20,2021,LAA,OAK,0,6,140,1.5,-155,8.5,-105,-115,-150,-1.5,135,3.54,Oakland Coliseum,6,-6
2021-07-20,2021,NYY,PHI,6,4,118,1.5,-145,9.0,-115,-105,-128,-1.5,125,4.13,Yankee Stadium,10,2
2021-07-20,2021,ARI,PIT,11,6,-103,-1.5,175,9.0,-110,-110,-107,1.5,-200,4.57,Chase Field,17,5
2021-07-20,2021,ATL,SD,2,1,156,1.5,-110,9.0,-120,100,-166,-1.5,-110,3.52,Suntrust Park,3,1
2021-07-20,2021,COL,SEA,4,6,-180,-1.5,100,11.0,-105,-115,165,1.5,-120,7.07,Coors Field,10,-2
2021-07-20,2021,LAD,SF,8,6,-137,-1.5,140,8.5,-110,-110,127,1.5,-160,4.91,Dodger Stadium,14,2
2021-07-20,2021,CHC,STL,7,6,-101,1.5,-190,9.0,-105,-115,-109,-1.5,170,4.52,Busch Stadium,13,1
2021-07-20,2021,BAL,TB,3,9,180,1.5,-110,7.5,-115,-105,-200,-1.5,-110,2.68,Tropicana Field,12,-6
2021-07-20,2021,DET,TEX,4,1,-115,-1.5,175,9.0,-105,-115,105,1.5,-200,4.81,Comerica Park,5,3
2021-07-20,2021,MIA,WSH,3,6,-105,-1.5,145,9.0,-105,-115,-105,1.5,-165,4.61,Nationals Park,9,-3
2021-07-21,2021,PIT,ARI,4,6,118,1.5,-170,9.0,-110,-110,-128,-1.5,150,4.13,Chase Field,10,-2
2021-07-21,2021,SD,ATL,3,2,-118,-1.5,145,7.5,105,-125,108,1.5,-165,4.06,Suntrust Park,5,1
2021-07-21,2021,SD,ATL,6,5,113,1.5,-205,8.0,-105,-115,-123,-1.5,180,3.76,Suntrust Park,11,1
2021-07-21,2021,TB,BAL,5,4,-230,-1.5,-115,8.5,-120,100,205,1.5,-105,5.92,Tropicana Field,9,1
2021-07-21,2021,TOR,BOS,4,7,-200,-1.5,-120,10.5,-120,100,180,1.5,100,7.0,Sahlen Field,11,-3
2021-07-21,2021,STL,CHC,3,2,-131,-1.5,160,8.0,-105,-115,121,1.5,-180,4.54,Busch Stadium,5,1
2021-07-21,2021,NYM,CIN,7,0,-133,-1.5,110,10.0,-125,105,123,1.5,-130,5.71,Great American Ballpark,7,7
2021-07-21,2021,HOU,CLE,4,5,-244,-1.5,-135,8.5,-110,-110,214,1.5,115,6.03,Minute Maid Park,9,-1
2021-07-21,2021,SEA,COL,3,6,128,1.5,-145,11.0,-110,-110,-138,-1.5,125,4.82,Coors Field,9,-3
2021-07-21,2021,MIN,CWS,7,2,144,1.5,-140,9.0,100,-120,-154,-1.5,120,3.69,Guaranteed Rate Field,9,5
2021-07-21,2021,TEX,DET,2,4,106,1.5,-185,9.5,-105,-115,-116,-1.5,165,4.61,Comerica Park,6,-2
2021-07-21,2021,CLE,HOU,5,4,214,1.5,115,8.5,-110,-110,-244,-1.5,-135,2.71,Minute Maid Park,9,1
2021-07-21,2021,MIL,KC,3,6,-176,-1.5,105,9.0,-120,100,163,1.5,-125,5.74,Miller Park,9,-3
2021-07-21,2021,SF,LAD,4,2,149,1.5,-140,8.5,-105,-115,-159,-1.5,120,3.41,Dodger Stadium,6,2
2021-07-21,2021,WSH,MIA,1,3,-154,-1.5,120,10.0,-105,-115,144,1.5,-140,6.06,Nationals Park,4,-2
2021-07-21,2021,KC,MIL,6,3,163,1.5,-125,9.0,-120,100,-176,-1.5,105,3.42,Miller Park,9,3
2021-07-21,2021,CWS,MIN,2,7,-154,-1.5,120,9.0,100,-120,144,1.5,-140,5.46,Guaranteed Rate Field,9,-5
2021-07-21,2021,CIN,NYM,0,7,123,1.5,-130,10.0,-125,105,-133,-1.5,110,4.48,Great American Ballpark,7,-7
2021-07-21,2021,PHI,NYY,5,6,-108,-1.5,150,10.5,-110,-110,-102,1.5,-170,5.45,Yankee Stadium,11,-1
2021-07-21,2021,NYY,PHI,6,5,-102,1.5,-170,10.5,-110,-110,-108,-1.5,150,5.3,Yankee Stadium,11,1
2021-07-21,2021,ARI,PIT,6,4,-128,-1.5,150,9.0,-110,-110,118,1.5,-170,5.05,Chase Field,10,2
2021-07-21,2021,ATL,SD,2,3,108,1.5,-165,7.5,105,-125,-118,-1.5,145,3.61,Suntrust Park,5,-1
2021-07-21,2021,ATL,SD,5,6,-123,-1.5,180,8.0,-105,-115,113,1.5,-205,4.41,Suntrust Park,11,-1
2021-07-21,2021,COL,SEA,6,3,-138,-1.5,125,11.0,-110,-110,128,1.5,-145,6.38,Coors Field,9,3
2021-07-21,2021,LAD,SF,2,4,-159,-1.5,120,8.5,-105,-115,149,1.5,-140,5.22,Dodger Stadium,6,-2
2021-07-21,2021,CHC,STL,2,3,121,1.5,-180,8.0,-105,-115,-131,-1.5,160,3.62,Busch Stadium,5,-1
2021-07-21,2021,BAL,TB,4,5,205,1.5,-105,8.5,-120,100,-230,-1.5,-115,2.79,Tropicana Field,9,-1
2021-07-21,2021,DET,TEX,4,2,-116,-1.5,165,9.5,-105,-115,106,1.5,-185,5.1,Comerica Park,6,2
2021-07-21,2021,BOS,TOR,7,4,180,1.5,100,10.5,-120,100,-200,-1.5,-120,3.75,Sahlen Field,11,3
2021-07-21,2021,MIA,WSH,3,1,144,1.5,-140,10.0,-105,-115,-154,-1.5,120,4.1,Nationals Park,4,2
2021-07-22,2021,PHI,ATL,2,7,130,1.5,-125,8.5,-115,-105,-140,-1.5,105,3.7,Citizens Bank Park,9,-5
2021-07-22,2021,NYY,BOS,4,5,138,1.5,-150,9.5,-105,-115,-148,-1.5,130,3.99,Fenway Park,9,-1
2021-07-22,2021,STL,CHC,3,2,-132,-1.5,145,8.5,100,-120,122,1.5,-165,4.84,Busch Stadium,5,1
2021-07-22,2021,TB,CLE,5,4,-131,-1.5,120,9.5,100,-120,121,1.5,-140,5.39,Progressive Field,9,1
2021-07-22,2021,TEX,DET,5,7,128,1.5,-150,9.5,100,-120,-138,-1.5,130,4.17,Comerica Park,12,-2
2021-07-22,2021,MIN,LAA,2,3,-123,-1.5,150,9.0,-105,-115,113,1.5,-170,4.96,Target Field,5,-1
2021-07-22,2021,SF,LAD,5,3,173,1.5,-125,8.0,-110,-110,-188,-1.5,105,2.93,Dodger Stadium,8,2
2021-07-22,2021,SD,MIA,3,2,-151,-1.5,110,8.5,-115,-105,141,1.5,-130,5.11,Marlins Park,5,1
2021-07-22,2021,LAA,MIN,3,2,113,1.5,-170,9.0,-105,-115,-123,-1.5,150,4.23,Target Field,5,1
2021-07-22,2021,BOS,NYY,5,4,-148,-1.5,130,9.5,-105,-115,138,1.5,-150,5.67,Fenway Park,9,1
2021-07-22,2021,SEA,OAK,1,4,128,1.5,-130,7.5,-110,-110,-138,-1.5,110,3.29,T-Mobile Park,5,-3
2021-07-22,2021,ATL,PHI,7,2,-140,-1.5,105,8.5,-115,-105,130,1.5,-125,4.96,Citizens Bank Park,9,5
2021-07-22,2021,MIA,SD,2,3,141,1.5,-130,8.5,-115,-105,-151,-1.5,110,3.53,Marlins Park,5,-1
2021-07-22,2021,OAK,SEA,4,1,-138,-1.5,110,7.5,-110,-110,128,1.5,-130,4.35,T-Mobile Park,5,3
2021-07-22,2021,LAD,SF,3,5,-188,-1.5,105,8.0,-110,-110,173,1.5,-125,5.22,Dodger Stadium,8,-2
2021-07-22,2021,CHC,STL,2,3,122,1.5,-165,8.5,100,-120,-132,-1.5,145,3.83,Busch Stadium,5,-1
2021-07-22,2021,CLE,TB,4,5,121,1.5,-140,9.5,100,-120,-131,-1.5,120,4.3,Progressive Field,9,-1
2021-07-22,2021,DET,TEX,7,5,-138,-1.5,130,9.5,100,-120,128,1.5,-150,5.51,Comerica Park,12,2
2021-07-23,2021,CHC,ARI,8,3,-125,-1.5,135,10.0,-105,-115,115,1.5,-155,5.56,Wrigley Field,11,5
2021-07-23,2021,PHI,ATL,5,1,-152,-1.5,140,7.5,-115,-105,142,1.5,-160,4.52,Citizens Bank Park,6,4
2021-07-23,2021,WSH,BAL,1,6,-127,-1.5,115,10.5,-105,-115,117,1.5,-135,5.87,Camden Yards,7,-5
2021-07-23,2021,NYY,BOS,2,6,-101,1.5,-205,8.5,-115,-105,-109,-1.5,180,4.27,Fenway Park,8,-4
2021-07-23,2021,ARI,CHC,3,8,115,1.5,-155,10.0,-105,-115,-125,-1.5,135,4.65,Wrigley Field,11,-5
2021-07-23,2021,STL,CIN,5,6,146,1.5,-140,9.5,-115,-105,-156,-1.5,120,3.86,Great American Ballpark,11,-1
2021-07-23,2021,TB,CLE,10,5,-125,-1.5,125,9.5,-110,-110,115,1.5,-145,5.28,Progressive Field,15,5
2021-07-23,2021,LAD,COL,6,9,-270,-1.5,-140,9.0,-110,-110,240,1.5,120,6.57,Dodger Stadium,15,-3
2021-07-23,2021,MIL,CWS,7,1,-131,-1.5,165,7.5,-120,100,121,1.5,-185,4.25,Miller Park,8,6
2021-07-23,2021,KC,DET,5,3,-114,-1.5,155,10.5,-105,-115,104,1.5,-175,5.59,Kauffman Stadium,8,2
2021-07-23,2021,TEX,HOU,3,7,186,1.5,-110,8.5,-125,105,-206,-1.5,-110,2.97,Minute Maid Park,10,-4
2021-07-23,2021,DET,KC,3,5,104,1.5,-175,10.5,-105,-115,-114,-1.5,155,5.15,Kauffman Stadium,8,-2
2021-07-23,2021,MIN,LAA,5,4,-105,1.5,-160,9.5,-110,-110,-105,-1.5,140,4.87,Target Field,9,1
2021-07-23,2021,COL,LAD,9,6,240,1.5,120,9.0,-110,-110,-270,-1.5,-140,2.65,Dodger Stadium,15,3
2021-07-23,2021,SD,MIA,5,2,-138,-1.5,115,8.0,-105,-115,128,1.5,-135,4.64,Marlins Park,7,3
2021-07-23,2021,CWS,MIL,1,7,121,1.5,-185,7.5,-120,100,-131,-1.5,165,3.39,Miller Park,8,-6
2021-07-23,2021,LAA,MIN,4,5,-105,-1.5,140,9.5,-110,-110,-105,1.5,-160,4.87,Target Field,9,-1
2021-07-23,2021,TOR,NYM,0,3,-103,1.5,-200,9.0,-105,-115,-107,-1.5,175,4.57,Citi Field,3,-3
2021-07-23,2021,BOS,NYY,6,2,-109,-1.5,180,8.5,-115,-105,-101,1.5,-205,4.43,Fenway Park,8,4
2021-07-23,2021,SEA,OAK,4,3,110,1.5,-155,7.5,-115,-105,-120,-1.5,135,3.57,T-Mobile Park,7,1
2021-07-23,2021,ATL,PHI,1,5,142,1.5,-160,7.5,-115,-105,-152,-1.5,140,3.1,Citizens Bank Park,6,-4
2021-07-23,2021,SF,PIT,4,6,-185,-1.5,100,8.5,-110,-110,170,1.5,-120,5.52,AT&T Park,10,-2
2021-07-23,2021,MIA,SD,2,5,128,1.5,-135,8.0,-105,-115,-138,-1.5,115,3.51,Marlins Park,7,-3
2021-07-23,2021,OAK,SEA,3,4,-120,-1.5,135,7.5,-115,-105,110,1.5,-155,4.09,T-Mobile Park,7,-1
2021-07-23,2021,PIT,SF,6,4,170,1.5,-120,8.5,-110,-110,-185,-1.5,100,3.15,AT&T Park,10,2
2021-07-23,2021,CIN,STL,6,5,-156,-1.5,120,9.5,-115,-105,146,1.5,-140,5.79,Great American Ballpark,11,1
2021-07-23,2021,CLE,TB,5,10,115,1.5,-145,9.5,-110,-110,-125,-1.5,125,4.42,Progressive Field,15,-5
2021-07-23,2021,HOU,TEX,7,3,-206,-1.5,-110,8.5,-125,105,186,1.5,-110,5.72,Minute Maid Park,10,4
2021-07-23,2021,NYM,TOR,3,0,-107,-1.5,175,9.0,-105,-115,-103,1.5,-200,4.65,Citi Field,3,3
2021-07-23,2021,BAL,WSH,6,1,117,1.5,-135,10.5,-105,-115,-127,-1.5,115,4.84,Camden Yards,7,5
2021-07-24,2021,CHC,ARI,3,7,-168,-1.5,105,11.0,100,-120,158,1.5,-125,6.9,Wrigley Field,10,-4
2021-07-24,2021,PHI,ATL,3,15,-122,-1.5,155,10.5,-110,-110,112,1.5,-175,5.77,Citizens Bank Park,18,-12
2021-07-24,2021,WSH,BAL,3,5,-131,-1.5,110,11.0,-105,-115,121,1.5,-130,6.24,Camden Yards,8,-2
2021-07-24,2021,NYY,BOS,4,3,157,1.5,-130,9.0,-115,-105,-167,-1.5,110,3.5,Fenway Park,7,1
2021-07-24,2021,ARI,CHC,7,3,158,1.5,-125,11.0,100,-120,-168,-1.5,105,4.26,Wrigley Field,10,4
2021-07-24,2021,STL,CIN,3,5,163,1.5,-125,9.5,100,-120,-176,-1.5,105,3.61,Great American Ballpark,8,-2
2021-07-24,2021,TB,CLE,8,2,-150,-1.5,-105,10.5,-110,-110,140,1.5,-115,6.3,Progressive Field,10,6
2021-07-24,2021,LAD,COL,1,0,-201,-1.5,-105,8.5,-110,-110,181,1.5,-115,5.68,Dodger Stadium,1,1
2021-07-24,2021,MIL,CWS,6,1,-126,-1.5,175,7.0,-105,-115,116,1.5,-195,3.9,Miller Park,7,5
2021-07-24,2021,KC,DET,9,8,-136,-1.5,135,10.0,-115,-105,126,1.5,-155,5.76,Kauffman Stadium,17,1
2021-07-24,2021,TEX,HOU,1,4,190,1.5,-105,8.0,-120,100,-210,-1.5,-115,2.76,Minute Maid Park,5,-3
2021-07-24,2021,DET,KC,8,9,126,1.5,-155,10.0,-115,-105,-136,-1.5,135,4.42,Kauffman Stadium,17,-1
2021-07-24,2021,MIN,LAA,1,2,-126,-1.5,145,9.0,-110,-110,116,1.5,-165,5.02,Target Field,3,-1
2021-07-24,2021,COL,LAD,0,1,181,1.5,-115,8.5,-110,-110,-201,-1.5,-105,3.02,Dodger Stadium,1,-1
2021-07-24,2021,SD,MIA,2,3,-152,-1.5,100,9.0,100,-120,142,1.5,-120,5.43,Marlins Park,5,-1
2021-07-24,2021,CWS,MIL,1,6,116,1.5,-195,7.0,-105,-115,-126,-1.5,175,3.24,Miller Park,7,-5
2021-07-24,2021,LAA,MIN,2,1,116,1.5,-165,9.0,-110,-110,-126,-1.5,145,4.17,Target Field,3,1
2021-07-24,2021,TOR,NYM,10,3,-116,-1.5,140,8.5,-115,-105,106,1.5,-160,4.56,Citi Field,13,7
2021-07-24,2021,BOS,NYY,3,4,-167,-1.5,110,9.0,-115,-105,157,1.5,-130,5.63,Fenway Park,7,-1
2021-07-24,2021,SEA,OAK,5,4,103,1.5,-165,7.5,100,-120,-113,-1.5,145,3.69,T-Mobile Park,9,1
2021-07-24,2021,ATL,PHI,15,3,112,1.5,-175,10.5,-110,-110,-122,-1.5,155,4.95,Citizens Bank Park,18,12
2021-07-24,2021,SF,PIT,2,10,-264,-1.5,-135,8.0,100,-120,234,1.5,115,5.8,AT&T Park,12,-8
2021-07-24,2021,MIA,SD,3,2,142,1.5,-120,9.0,100,-120,-152,-1.5,100,3.72,Marlins Park,5,1
2021-07-24,2021,OAK,SEA,4,5,-113,-1.5,145,7.5,100,-120,103,1.5,-165,3.98,T-Mobile Park,9,-1
2021-07-24,2021,PIT,SF,10,2,234,1.5,115,8.0,100,-120,-264,-1.5,-135,2.4,AT&T Park,12,8
2021-07-24,2021,CIN,STL,5,3,-176,-1.5,105,9.5,100,-120,163,1.5,-125,6.06,Great American Ballpark,8,2
2021-07-24,2021,CLE,TB,2,8,140,1.5,-115,10.5,-110,-110,-150,-1.5,-105,4.38,Progressive Field,10,-6
2021-07-24,2021,HOU,TEX,4,1,-210,-1.5,-115,8.0,-120,100,190,1.5,-105,5.42,Minute Maid Park,5,3
2021-07-24,2021,NYM,TOR,3,10,106,1.5,-160,8.5,-115,-105,-116,-1.5,140,4.13,Citi Field,13,-7
2021-07-24,2021,BAL,WSH,5,3,121,1.5,-130,11.0,-105,-115,-131,-1.5,110,4.98,Camden Yards,8,2
2021-07-25,2021,CHC,ARI,5,1,-180,-1.5,100,9.0,-110,-110,165,1.5,-120,5.79,Wrigley Field,6,4
2021-07-25,2021,PHI,ATL,2,1,-162,-1.5,120,9.5,100,-120,152,1.5,-140,5.87,Citizens Bank Park,3,1
2021-07-25,2021,WSH,BAL,4,5,-114,1.5,-200,10.0,-120,100,104,-1.5,175,5.33,Camden Yards,9,-1
2021-07-25,2021,NYY,BOS,4,5,127,1.5,-150,10.5,-120,100,-137,-1.5,130,4.63,Fenway Park,9,-1
2021-07-25,2021,ARI,CHC,1,5,165,1.5,-120,9.0,-110,-110,-180,-1.5,100,3.4,Wrigley Field,6,-4
2021-07-25,2021,STL,CIN,10,6,150,1.5,-135,10.0,-120,100,-160,-1.5,115,4.0,Great American Ballpark,16,4
2021-07-25,2021,TB,CLE,2,3,-168,-1.5,-115,9.0,-120,100,158,1.5,-105,5.64,Progressive Field,5,-1
2021-07-25,2021,LAD,COL,3,2,-167,-1.5,115,8.5,-115,-105,157,1.5,-135,5.32,Dodger Stadium,5,1
2021-07-25,2021,MIL,CWS,1,3,-154,-1.5,135,7.5,-105,-115,144,1.5,-155,4.55,Miller Park,4,-2
2021-07-25,2021,KC,DET,6,1,-106,1.5,-165,10.0,-110,-110,-104,-1.5,145,5.15,Kauffman Stadium,7,5
2021-07-25,2021,TEX,HOU,1,3,230,1.5,115,8.5,-115,-105,-260,-1.5,-135,2.58,Minute Maid Park,4,-2
2021-07-25,2021,DET,KC,1,6,-104,-1.5,145,10.0,-110,-110,-106,1.5,-165,5.1,Kauffman Stadium,7,-5
2021-07-25,2021,MIN,LAA,2,6,-120,-1.5,150,10.0,-115,-105,110,1.5,-170,5.45,Target Field,8,-4
2021-07-25,2021,COL,LAD,2,3,157,1.5,-135,8.5,-115,-105,-167,-1.5,115,3.31,Dodger Stadium,5,-1
2021-07-25,2021,SD,MIA,3,9,-210,-1.5,-130,7.5,-105,-115,190,1.5,110,5.08,Marlins Park,12,-6
2021-07-25,2021,CWS,MIL,3,1,144,1.5,-155,7.5,-105,-115,-154,-1.5,135,3.07,Miller Park,4,2
2021-07-25,2021,LAA,MIN,6,2,110,1.5,-170,10.0,-115,-105,-120,-1.5,150,4.76,Target Field,8,4
2021-07-25,2021,TOR,NYM,4,5,-115,-1.5,135,9.5,-105,-115,105,1.5,-155,5.08,Citi Field,9,-1
2021-07-25,2021,BOS,NYY,5,4,-137,-1.5,130,10.5,-120,100,127,1.5,-150,6.07,Fenway Park,9,1
2021-07-25,2021,SEA,OAK,4,3,121,1.5,-140,9.0,105,-125,-131,-1.5,120,4.07,T-Mobile Park,7,1
2021-07-25,2021,ATL,PHI,1,2,152,1.5,-140,9.5,100,-120,-162,-1.5,120,3.77,Citizens Bank Park,3,-1
2021-07-25,2021,SF,PIT,6,1,-188,-1.5,110,8.0,-105,-115,173,1.5,-130,5.22,AT&T Park,7,5
2021-07-25,2021,MIA,SD,9,3,190,1.5,110,7.5,-105,-115,-210,-1.5,-130,2.59,Marlins Park,12,6
2021-07-25,2021,OAK,SEA,3,4,-131,-1.5,120,9.0,105,-125,121,1.5,-140,5.1,T-Mobile Park,7,-1
2021-07-25,2021,PIT,SF,1,6,173,1.5,-130,8.0,-105,-115,-188,-1.5,110,2.93,AT&T Park,7,-5
2021-07-25,2021,CIN,STL,6,10,-160,-1.5,115,10.0,-120,100,150,1.5,-135,6.15,Great American Ballpark,16,-4
2021-07-25,2021,CLE,TB,3,2,158,1.5,-105,9.0,-120,100,-168,-1.5,-115,3.49,Progressive Field,5,1
2021-07-25,2021,HOU,TEX,3,1,-260,-1.5,-135,8.5,-115,-105,230,1.5,115,6.14,Minute Maid Park,4,2
2021-07-25,2021,NYM,TOR,5,4,105,1.5,-155,9.5,-105,-115,-115,-1.5,135,4.63,Citi Field,9,1
2021-07-25,2021,BAL,WSH,5,4,104,-1.5,175,10.0,-120,100,-114,1.5,-200,4.9,Camden Yards,9,1
2021-07-26,2021,NYM,ATL,0,2,-145,-1.5,160,6.5,100,-120,135,1.5,-180,3.85,Citi Field,2,-2
2021-07-26,2021,NYM,ATL,1,0,-167,-1.5,125,7.0,-105,-115,157,1.5,-145,4.38,Citi Field,1,1
2021-07-26,2021,TOR,BOS,4,5,122,1.5,-155,11.5,-120,100,-132,-1.5,135,5.18,Fenway Park,9,-1
2021-07-26,2021,CIN,CHC,5,6,122,1.5,-165,8.5,-120,100,-132,-1.5,145,3.83,Wrigley Field,11,-1
2021-07-26,2021,CHC,CIN,6,5,-132,-1.5,145,8.5,-120,100,122,1.5,-165,4.84,Wrigley Field,11,1
2021-07-26,2021,LAA,COL,6,2,-150,-1.5,135,7.5,-120,100,140,1.5,-155,4.5,Angel Stadium,8,4
2021-07-26,2021,KC,CWS,4,3,109,1.5,-140,9.5,-115,-105,-119,-1.5,120,4.55,Kauffman Stadium,7,1
2021-07-26,2021,MIN,DET,6,5,-172,-1.5,105,10.0,-110,-110,161,1.5,-125,6.32,Target Field,11,1
2021-07-26,2021,SEA,HOU,11,8,155,1.5,-105,8.5,-120,100,-165,-1.5,-115,3.33,T-Mobile Park,19,3
2021-07-26,2021,CWS,KC,3,4,-119,-1.5,120,9.5,-115,-105,109,1.5,-140,5.16,Kauffman Stadium,7,-1
2021-07-26,2021,COL,LAA,2,6,140,1.5,-155,7.5,-120,100,-150,-1.5,135,3.13,Angel Stadium,8,-4
2021-07-26,2021,DET,MIN,5,6,161,1.5,-125,10.0,-110,-110,-172,-1.5,105,3.83,Target Field,11,-1
2021-07-26,2021,ATL,NYM,2,0,135,1.5,-180,6.5,100,-120,-145,-1.5,160,2.77,Citi Field,2,2
2021-07-26,2021,ATL,NYM,0,1,157,1.5,-145,7.0,-105,-115,-167,-1.5,125,2.72,Citi Field,1,-1
2021-07-26,2021,WSH,PHI,5,6,114,1.5,-165,9.5,100,-120,-124,-1.5,145,4.44,Citizens Bank Park,11,-1
2021-07-26,2021,HOU,SEA,8,11,-165,-1.5,-115,8.5,-120,100,155,1.5,-105,5.29,T-Mobile Park,19,-3
2021-07-26,2021,BOS,TOR,5,4,-132,-1.5,135,11.5,-120,100,122,1.5,-155,6.54,Fenway Park,9,1
2021-07-26,2021,PHI,WSH,6,5,-124,-1.5,145,9.5,100,-120,114,1.5,-165,5.26,Citizens Bank Park,11,1
2021-07-27,2021,TEX,ARI,5,4,-136,-1.5,145,8.5,-105,-115,126,1.5,-165,4.9,Globe Life Field,9,1
2021-07-27,2021,NYM,ATL,5,12,130,1.5,-135,9.0,-110,-110,-140,-1.5,115,3.91,Citi Field,17,-7
2021-07-27,2021,MIA,BAL,7,3,-127,-1.5,120,9.0,-110,-110,117,1.5,-140,5.04,Camden Yards,10,4
2021-07-27,2021,CIN,CHC,7,4,150,1.5,-140,10.5,-115,-105,-160,-1.5,120,4.2,Wrigley Field,11,3
2021-07-27,2021,CHC,CIN,4,7,-160,-1.5,120,10.5,-115,-105,150,1.5,-140,6.46,Wrigley Field,11,-3
2021-07-27,2021,STL,CLE,4,2,-117,-1.5,135,9.5,-120,100,107,1.5,-155,5.12,Progressive Field,6,2
2021-07-27,2021,LAA,COL,3,12,-134,-1.5,140,9.0,-105,-115,124,1.5,-160,5.15,Angel Stadium,15,-9
2021-07-27,2021,KC,CWS,3,5,135,1.5,-120,9.5,-115,-105,-145,-1.5,100,4.04,Kauffman Stadium,8,-2
2021-07-27,2021,MIN,DET,5,6,-185,-1.5,-105,9.0,-115,-105,170,1.5,-115,5.84,Target Field,11,-1
2021-07-27,2021,SEA,HOU,6,8,148,1.5,-115,8.0,-115,-105,-158,-1.5,-105,3.23,T-Mobile Park,14,-2
2021-07-27,2021,CWS,KC,5,3,-145,-1.5,100,9.5,-115,-105,135,1.5,-120,5.62,Kauffman Stadium,8,2
2021-07-27,2021,COL,LAA,12,3,124,1.5,-160,9.0,-105,-115,-134,-1.5,140,4.02,Angel Stadium,15,9
2021-07-27,2021,SF,LAD,2,1,107,1.5,-155,8.5,-105,-115,-117,-1.5,135,4.11,AT&T Park,3,1
2021-07-27,2021,BAL,MIA,3,7,117,1.5,-140,9.0,-110,-110,-127,-1.5,120,4.15,Camden Yards,10,-4
2021-07-27,2021,PIT,MIL,0,9,137,1.5,-120,9.0,-120,100,-140,-1.5,100,3.8,PNC Park,9,-9
2021-07-27,2021,DET,MIN,6,5,170,1.5,-115,9.0,-115,-105,-185,-1.5,-105,3.33,Target Field,11,1
2021-07-27,2021,ATL,NYM,12,5,-140,-1.5,115,9.0,-110,-110,130,1.5,-135,5.25,Citi Field,17,7
2021-07-27,2021,TB,NYY,3,4,-136,-1.5,140,7.5,-115,-105,126,1.5,-160,4.32,Tropicana Field,7,-1
2021-07-27,2021,SD,OAK,7,4,-152,-1.5,130,8.5,-120,100,142,1.5,-150,5.13,PETCO Park,11,3
2021-07-27,2021,WSH,PHI,6,4,112,1.5,-170,10.5,-120,100,-122,-1.5,150,4.95,Citizens Bank Park,10,2
2021-07-27,2021,MIL,PIT,9,0,-140,-1.5,100,9.0,-120,100,137,1.5,-120,5.25,PNC Park,9,9
2021-07-27,2021,OAK,SD,4,7,142,1.5,-150,8.5,-120,100,-152,-1.5,130,3.51,PETCO Park,11,-3
2021-07-27,2021,HOU,SEA,8,6,-158,-1.5,-105,8.0,-115,-105,148,1.5,-115,4.9,T-Mobile Park,14,2
2021-07-27,2021,LAD,SF,1,2,-117,-1.5,135,8.5,-105,-115,107,1.5,-155,4.58,AT&T Park,3,-1
2021-07-27,2021,CLE,STL,2,4,107,1.5,-155,9.5,-120,100,-117,-1.5,135,4.59,Progressive Field,6,-2
2021-07-27,2021,NYY,TB,4,3,126,1.5,-160,7.5,-115,-105,-136,-1.5,140,3.32,Tropicana Field,7,1
2021-07-27,2021,ARI,TEX,4,5,126,1.5,-165,8.5,-105,-115,-136,-1.5,145,3.76,Globe Life Field,9,-1
2021-07-27,2021,PHI,WSH,4,6,-122,-1.5,150,10.5,-120,100,112,1.5,-170,5.77,Citizens Bank Park,10,-2
2021-07-28,2021,TEX,ARI,2,3,-117,-1.5,160,9.0,-105,-115,107,1.5,-180,4.85,Globe Life Field,5,-1
2021-07-28,2021,NYM,ATL,2,1,-119,-1.5,170,7.5,-120,100,109,1.5,-190,4.08,Citi Field,3,1
2021-07-28,2021,MIA,BAL,7,8,119,1.5,-170,10.0,-105,-115,-129,-1.5,150,4.57,Camden Yards,15,-1
2021-07-28,2021,TOR,BOS,4,1,-150,-1.5,110,8.5,105,-125,140,1.5,-130,5.1,Fenway Park,5,3
2021-07-28,2021,TOR,BOS,1,4,120,1.5,-170,8.0,-110,-110,-130,-1.5,150,3.64,Fenway Park,5,-3
2021-07-28,2021,CIN,CHC,8,2,-110,-1.5,140,10.0,-110,-110,100,1.5,-160,5.24,Wrigley Field,10,6
2021-07-28,2021,CHC,CIN,2,8,100,1.5,-160,10.0,-110,-110,-110,-1.5,140,5.0,Wrigley Field,10,-6
2021-07-28,2021,STL,CLE,2,7,-111,-1.5,150,8.5,-120,100,101,1.5,-170,4.47,Progressive Field,9,-5
2021-07-28,2021,LAA,COL,8,7,-213,-1.5,-110,9.0,-120,100,193,1.5,-110,6.12,Angel Stadium,15,1
2021-07-28,2021,KC,CWS,3,2,160,1.5,100,10.0,-110,-110,-170,-1.5,-120,3.85,Kauffman Stadium,5,1
2021-07-28,2021,MIN,DET,14,17,-138,-1.5,130,10.0,100,-120,128,1.5,-150,5.8,Target Field,31,-3
2021-07-28,2021,SEA,HOU,4,11,100,1.5,-165,8.5,-110,-110,-110,-1.5,145,4.25,T-Mobile Park,15,-7
2021-07-28,2021,CWS,KC,2,3,-170,-1.5,-120,10.0,-110,-110,160,1.5,100,6.3,Kauffman Stadium,5,-1
2021-07-28,2021,COL,LAA,7,8,193,1.5,-110,9.0,-120,100,-213,-1.5,-110,3.07,Angel Stadium,15,-1
2021-07-28,2021,SF,LAD,0,8,119,1.5,-145,7.5,-110,-110,-129,-1.5,125,3.42,AT&T Park,8,-8
2021-07-28,2021,BAL,MIA,8,7,-129,-1.5,150,10.0,-105,-115,119,1.5,-170,5.63,Camden Yards,15,1
2021-07-28,2021,PIT,MIL,3,7,134,1.5,-125,9.0,-115,-105,-144,-1.5,105,3.85,PNC Park,10,-4
2021-07-28,2021,DET,MIN,17,14,128,1.5,-150,10.0,100,-120,-138,-1.5,130,4.39,Target Field,31,3
2021-07-28,2021,ATL,NYM,1,2,109,1.5,-190,7.5,-120,100,-119,-1.5,170,3.59,Citi Field,3,-1
2021-07-28,2021,TB,NYY,1,3,-134,-1.5,135,8.5,-115,-105,124,1.5,-155,4.87,Tropicana Field,4,-2
2021-07-28,2021,SD,OAK,4,10,-127,-1.5,145,8.0,-115,-105,117,1.5,-165,4.48,PETCO Park,14,-6
2021-07-28,2021,MIL,PIT,7,3,-144,-1.5,105,9.0,-115,-105,134,1.5,-125,5.31,PNC Park,10,4
2021-07-28,2021,OAK,SD,10,4,117,1.5,-165,8.0,-115,-105,-127,-1.5,145,3.69,PETCO Park,14,6
2021-07-28,2021,HOU,SEA,11,4,-110,-1.5,145,8.5,-110,-110,100,1.5,-165,4.45,T-Mobile Park,15,7
2021-07-28,2021,LAD,SF,8,0,-129,-1.5,125,7.5,-110,-110,119,1.5,-145,4.22,AT&T Park,8,8
2021-07-28,2021,CLE,STL,7,2,101,1.5,-170,8.5,-120,100,-111,-1.5,150,4.23,Progressive Field,9,5
2021-07-28,2021,NYY,TB,3,1,124,1.5,-155,8.5,-115,-105,-134,-1.5,135,3.79,Tropicana Field,4,2
2021-07-28,2021,ARI,TEX,3,2,107,1.5,-180,9.0,-105,-115,-117,-1.5,160,4.35,Globe Life Field,5,1
2021-07-28,2021,BOS,TOR,1,4,140,1.5,-130,8.5,105,-125,-150,-1.5,110,3.54,Fenway Park,5,-3
2021-07-28,2021,BOS,TOR,4,1,-130,-1.5,150,8.0,-110,-110,120,1.5,-170,4.52,Fenway Park,5,3
2021-07-29,2021,NYM,ATL,3,6,-128,-1.5,155,8.5,-110,-110,118,1.5,-175,4.77,Citi Field,9,-3
2021-07-29,2021,DET,BAL,6,2,-150,-1.5,120,10.0,100,-120,140,1.5,-140,6.0,Comerica Park,8,4
2021-07-29,2021,TOR,BOS,13,1,107,1.5,-175,10.5,-110,-110,-117,-1.5,155,5.07,Fenway Park,14,12
2021-07-29,2021,CIN,CHC,7,4,-130,-1.5,135,7.0,-105,-115,120,1.5,-155,3.96,Wrigley Field,11,3
2021-07-29,2021,CHC,CIN,4,7,120,1.5,-155,7.0,-105,-115,-130,-1.5,135,3.18,Wrigley Field,11,-3
2021-07-29,2021,SD,COL,3,0,-266,-1.5,-130,8.0,-110,-110,236,1.5,110,5.81,PETCO Park,3,3
2021-07-29,2021,KC,CWS,5,0,160,1.5,100,9.0,-120,100,-170,-1.5,-120,3.46,Kauffman Stadium,5,5
2021-07-29,2021,BAL,DET,2,6,140,1.5,-140,10.0,100,-120,-150,-1.5,120,4.17,Comerica Park,8,-4
2021-07-29,2021,CWS,KC,0,5,-170,-1.5,-120,9.0,-120,100,160,1.5,100,5.67,Kauffman Stadium,5,-5
2021-07-29,2021,OAK,LAA,4,0,-149,-1.5,105,9.0,-120,100,139,1.5,-125,5.39,Angel Stadium,4,4
2021-07-29,2021,SF,LAD,5,0,111,1.5,-155,8.5,-120,100,-121,-1.5,135,4.03,AT&T Park,5,5
2021-07-29,2021,PIT,MIL,0,12,175,1.5,100,8.0,-110,-110,-190,-1.5,-120,2.91,PNC Park,12,-12
2021-07-29,2021,ATL,NYM,6,3,118,1.5,-175,8.5,-110,-110,-128,-1.5,155,3.9,Citi Field,9,3
2021-07-29,2021,TB,NYY,14,0,112,1.5,-150,7.5,-110,-110,-122,-1.5,130,3.54,Tropicana Field,14,14
2021-07-29,2021,LAA,OAK,0,4,139,1.5,-125,9.0,-120,100,-149,-1.5,105,3.77,Angel Stadium,4,-4
2021-07-29,2021,WSH,PHI,3,1,142,1.5,-180,5.0,-135,115,-152,-1.5,160,2.07,Citizens Bank Park,4,2
2021-07-29,2021,WSH,PHI,8,11,132,1.5,-170,7.0,-110,-110,-142,-1.5,150,3.02,Citizens Bank Park,19,-3
2021-07-29,2021,MIL,PIT,12,0,-190,-1.5,-120,8.0,-110,-110,175,1.5,100,5.24,PNC Park,12,12
2021-07-29,2021,COL,SD,0,3,236,1.5,110,8.0,-110,-110,-266,-1.5,-130,2.38,PETCO Park,3,-3
2021-07-29,2021,LAD,SF,0,5,-121,-1.5,135,8.5,-120,100,111,1.5,-155,4.65,AT&T Park,5,-5
2021-07-29,2021,NYY,TB,0,14,-122,-1.5,130,7.5,-110,-110,112,1.5,-150,4.12,Tropicana Field,14,-14
2021-07-29,2021,BOS,TOR,1,13,-117,-1.5,155,10.5,-110,-110,107,1.5,-175,5.66,Fenway Park,14,-12
2021-07-29,2021,PHI,WSH,1,3,-152,-1.5,160,5.0,-135,115,142,1.5,-180,3.02,Citizens Bank Park,4,-2
2021-07-29,2021,PHI,WSH,11,8,-142,-1.5,150,7.0,-110,-110,132,1.5,-170,4.11,Citizens Bank Park,19,3
2021-07-30,2021,LAD,ARI,5,6,-194,-1.5,-130,9.0,-115,-105,177,1.5,110,5.94,Chase Field,11,-1
2021-07-30,2021,MIL,ATL,9,5,-140,-1.5,120,8.5,-115,-105,130,1.5,-140,4.96,Suntrust Park,14,4
2021-07-30,2021,DET,BAL,3,4,-148,-1.5,125,9.0,-120,100,138,1.5,-145,5.37,Comerica Park,7,-1
2021-07-30,2021,TB,BOS,7,3,-139,-1.5,135,9.0,-110,-110,129,1.5,-155,5.23,Tropicana Field,10,4
2021-07-30,2021,WSH,CHC,4,3,-131,-1.5,155,9.0,-105,-115,121,1.5,-175,5.1,Nationals Park,7,1
2021-07-30,2021,NYM,CIN,2,6,-135,-1.5,155,8.0,-115,-105,125,1.5,-175,4.6,Citi Field,8,-4
2021-07-30,2021,CWS,CLE,6,4,-224,-1.5,-120,8.0,-115,-105,204,1.5,100,5.53,Guaranteed Rate Field,10,2
2021-07-30,2021,SD,COL,4,9,-190,-1.5,105,8.5,-105,-115,175,1.5,-125,5.57,PETCO Park,13,-5
2021-07-30,2021,CLE,CWS,4,6,204,1.5,100,8.0,-115,-105,-224,-1.5,-120,2.63,Guaranteed Rate Field,10,-2
2021-07-30,2021,BAL,DET,4,3,138,1.5,-145,9.0,-120,100,-148,-1.5,125,3.78,Comerica Park,7,1
2021-07-30,2021,SF,HOU,6,9,-123,-1.5,170,8.0,-120,100,113,1.5,-190,4.41,AT&T Park,15,-3
2021-07-30,2021,TOR,KC,6,4,-230,-1.5,-135,10.0,-110,-110,205,1.5,115,6.97,Rogers Centre,10,2
2021-07-30,2021,OAK,LAA,2,0,-115,-1.5,135,8.5,-105,-115,105,1.5,-155,4.55,Angel Stadium,2,2
2021-07-30,2021,ARI,LAD,6,5,177,1.5,110,9.0,-115,-105,-194,-1.5,-130,3.25,Chase Field,11,1
2021-07-30,2021,NYY,MIA,3,1,-160,-1.5,-105,7.5,-105,-115,150,1.5,-115,4.62,Marlins Park,4,2
2021-07-30,2021,ATL,MIL,5,9,130,1.5,-140,8.5,-115,-105,-140,-1.5,120,3.7,Suntrust Park,14,-4
2021-07-30,2021,STL,MIN,5,1,-149,-1.5,130,9.0,-105,-115,139,1.5,-150,5.39,Busch Stadium,6,4
2021-07-30,2021,CIN,NYM,6,2,125,1.5,-175,8.0,-115,-105,-135,-1.5,155,3.56,Citi Field,8,4
2021-07-30,2021,MIA,NYY,1,3,150,1.5,-115,7.5,-105,-115,-160,-1.5,-105,3.0,Marlins Park,4,-2
2021-07-30,2021,LAA,OAK,0,2,105,1.5,-155,8.5,-105,-115,-115,-1.5,135,4.15,Angel Stadium,2,-2
2021-07-30,2021,PIT,PHI,7,0,120,1.5,-135,9.0,-120,100,-130,-1.5,115,4.09,PNC Park,7,7
2021-07-30,2021,PHI,PIT,0,7,-130,-1.5,115,9.0,-120,100,120,1.5,-135,5.09,PNC Park,7,-7
2021-07-30,2021,COL,SD,9,4,175,1.5,-125,8.5,-105,-115,-190,-1.5,105,3.09,PETCO Park,13,5
2021-07-30,2021,TEX,SEA,5,9,144,1.5,-120,7.5,-115,-105,-154,-1.5,100,3.07,Globe Life Field,14,-4
2021-07-30,2021,HOU,SF,9,6,113,1.5,-190,8.0,-120,100,-123,-1.5,170,3.76,AT&T Park,15,3
2021-07-30,2021,MIN,STL,1,5,139,1.5,-150,9.0,-105,-115,-149,-1.5,130,3.77,Busch Stadium,6,-4
2021-07-30,2021,BOS,TB,3,7,129,1.5,-155,9.0,-110,-110,-139,-1.5,135,3.93,Tropicana Field,10,-4
2021-07-30,2021,SEA,TEX,9,5,-154,-1.5,100,7.5,-115,-105,144,1.5,-120,4.55,Globe Life Field,14,4
2021-07-30,2021,KC,TOR,4,6,205,1.5,115,10.0,-110,-110,-230,-1.5,-135,3.28,Rogers Centre,10,-2
2021-07-30,2021,CHC,WSH,3,4,121,1.5,-175,9.0,-105,-115,-131,-1.5,155,4.07,Nationals Park,7,-1
2021-07-31,2021,LAD,ARI,8,3,-169,-1.5,-115,9.5,-120,100,159,1.5,-105,5.97,Chase Field,11,5
2021-07-31,2021,MIL,ATL,1,8,-139,-1.5,115,9.0,100,-120,129,1.5,-135,5.23,Suntrust Park,9,-7
2021-07-31,2021,DET,BAL,2,5,-110,1.5,-170,9.5,100,-120,100,-1.5,150,4.98,Comerica Park,7,-3
2021-07-31,2021,TB,BOS,9,5,-113,-1.5,175,8.5,-105,-115,103,1.5,-200,4.51,Tropicana Field,14,4
2021-07-31,2021,WSH,CHC,3,6,-117,-1.5,165,8.0,-105,-115,107,1.5,-185,4.31,Nationals Park,9,-3
2021-07-31,2021,NYM,CIN,5,4,-121,-1.5,160,9.0,100,-120,111,1.5,-180,4.93,Citi Field,9,1
2021-07-31,2021,CWS,CLE,11,12,-153,-1.5,120,9.0,-110,-110,143,1.5,-140,5.44,Guaranteed Rate Field,23,-1
2021-07-31,2021,SD,COL,3,5,-187,-1.5,115,7.0,-115,-105,172,1.5,-135,4.56,PETCO Park,8,-2
2021-07-31,2021,CLE,CWS,12,11,143,1.5,-140,9.0,-110,-110,-153,-1.5,120,3.7,Guaranteed Rate Field,23,1
2021-07-31,2021,BAL,DET,5,2,100,-1.5,150,9.5,100,-120,-110,1.5,-170,4.75,Comerica Park,7,3
2021-07-31,2021,SF,HOU,8,6,-114,-1.5,175,8.5,100,-120,104,1.5,-200,4.53,AT&T Park,14,2
2021-07-31,2021,TOR,KC,4,0,-240,-1.5,-125,9.0,-120,100,210,1.5,105,6.35,Rogers Centre,4,4
2021-07-31,2021,OAK,LAA,0,1,-145,-1.5,105,10.0,-115,-105,135,1.5,-125,5.92,Angel Stadium,1,-1
2021-07-31,2021,ARI,LAD,3,8,159,1.5,-105,9.5,-120,100,-169,-1.5,-115,3.67,Chase Field,11,-5
2021-07-31,2021,NYY,MIA,4,2,-132,-1.5,120,7.5,100,-120,122,1.5,-140,4.27,Marlins Park,6,2
2021-07-31,2021,ATL,MIL,8,1,129,1.5,-135,9.0,100,-120,-139,-1.5,115,3.93,Suntrust Park,9,7
2021-07-31,2021,STL,MIN,1,8,-126,-1.5,150,8.5,-110,-110,116,1.5,-170,4.74,Busch Stadium,9,-7
2021-07-31,2021,CIN,NYM,4,5,111,1.5,-180,9.0,100,-120,-121,-1.5,160,4.27,Citi Field,9,-1
2021-07-31,2021,MIA,NYY,2,4,122,1.5,-140,7.5,100,-120,-132,-1.5,120,3.38,Marlins Park,6,-2
2021-07-31,2021,LAA,OAK,1,0,135,1.5,-125,10.0,-115,-105,-145,-1.5,105,4.26,Angel Stadium,1,1
2021-07-31,2021,PIT,PHI,3,2,167,1.5,-105,7.5,-115,-105,-182,-1.5,-115,2.81,PNC Park,5,1
2021-07-31,2021,PHI,PIT,2,3,-182,-1.5,-115,7.5,-115,-105,167,1.5,-105,4.84,PNC Park,5,-1
2021-07-31,2021,COL,SD,5,3,172,1.5,-135,7.0,-115,-105,-187,-1.5,115,2.57,PETCO Park,8,2
2021-07-31,2021,TEX,SEA,5,4,123,1.5,-130,8.5,-115,-105,-133,-1.5,110,3.81,Globe Life Field,9,1
2021-07-31,2021,HOU,SF,6,8,104,1.5,-200,8.5,100,-120,-114,-1.5,175,4.17,AT&T Park,14,-2
2021-07-31,2021,MIN,STL,8,1,116,1.5,-170,8.5,-110,-110,-126,-1.5,150,3.94,Busch Stadium,9,7
2021-07-31,2021,BOS,TB,5,9,103,1.5,-200,8.5,-105,-115,-113,-1.5,175,4.19,Tropicana Field,14,-4
2021-07-31,2021,SEA,TEX,4,5,-133,-1.5,110,8.5,-115,-105,123,1.5,-130,4.85,Globe Life Field,9,-1
2021-07-31,2021,KC,TOR,0,4,210,1.5,105,9.0,-120,100,-240,-1.5,-125,2.9,Rogers Centre,4,-4
2021-07-31,2021,CHC,WSH,6,3,107,1.5,-185,8.0,-105,-115,-117,-1.5,165,3.86,Nationals Park,9,3
2021-08-01,2021,LAD,ARI,13,0,-246,-1.5,-155,9.5,100,-120,216,1.5,135,6.75,Chase Field,13,13
2021-08-01,2021,MIL,ATL,2,1,152,1.5,-140,9.0,-120,100,-162,-1.5,120,3.57,Suntrust Park,3,1
2021-08-01,2021,DET,BAL,6,2,-144,-1.5,125,10.0,-115,-105,134,1.5,-145,5.9,Comerica Park,8,4
2021-08-01,2021,TB,BOS,3,2,-156,-1.5,115,9.0,100,-120,146,1.5,-135,5.48,Tropicana Field,5,1
2021-08-01,2021,WSH,CHC,6,5,-112,-1.5,170,8.5,-115,-105,102,1.5,-190,4.49,Nationals Park,11,1
2021-08-01,2021,NYM,CIN,1,7,-185,-1.5,105,8.5,-115,-105,170,1.5,-125,5.52,Citi Field,8,-6
2021-08-01,2021,CWS,CLE,2,1,-166,-1.5,110,9.5,-105,-115,156,1.5,-130,5.93,Guaranteed Rate Field,3,1
2021-08-01,2021,SD,COL,8,1,-152,-1.5,125,8.5,-120,100,142,1.5,-145,5.13,PETCO Park,9,7
2021-08-01,2021,CLE,CWS,1,2,156,1.5,-130,9.5,-105,-115,-166,-1.5,110,3.71,Guaranteed Rate Field,3,-1
2021-08-01,2021,BAL,DET,2,6,134,1.5,-145,10.0,-115,-105,-144,-1.5,125,4.27,Comerica Park,8,-4
2021-08-01,2021,SF,HOU,5,3,-118,-1.5,170,8.5,-105,-115,108,1.5,-190,4.6,AT&T Park,8,2
2021-08-01,2021,TOR,KC,5,1,-250,-1.5,-130,8.5,-115,-105,220,1.5,110,6.07,Rogers Centre,6,4
2021-08-01,2021,OAK,LAA,8,3,105,1.5,-175,9.5,-110,-110,-115,-1.5,155,4.63,Angel Stadium,11,5
2021-08-01,2021,ARI,LAD,0,13,216,1.5,135,9.5,100,-120,-246,-1.5,-155,3.01,Chase Field,13,-13
2021-08-01,2021,NYY,MIA,3,1,-159,-1.5,105,7.0,-110,-110,149,1.5,-125,4.3,Marlins Park,4,2
2021-08-01,2021,ATL,MIL,1,2,-162,-1.5,120,9.0,-120,100,152,1.5,-140,5.56,Suntrust Park,3,-1
2021-08-01,2021,STL,MIN,7,3,-156,-1.5,130,8.0,-120,100,146,1.5,-150,4.88,Busch Stadium,10,4
2021-08-01,2021,CIN,NYM,7,1,170,1.5,-125,8.5,-115,-105,-185,-1.5,105,3.15,Citi Field,8,6
2021-08-01,2021,MIA,NYY,1,3,149,1.5,-125,7.0,-110,-110,-159,-1.5,105,2.81,Marlins Park,4,-2
2021-08-01,2021,LAA,OAK,3,8,-115,-1.5,155,9.5,-110,-110,105,1.5,-175,5.08,Angel Stadium,11,-5
2021-08-01,2021,PIT,PHI,4,15,142,1.5,-125,8.5,-120,100,-152,-1.5,105,3.51,PNC Park,19,-11
2021-08-01,2021,PHI,PIT,15,4,-152,-1.5,105,8.5,-120,100,142,1.5,-125,5.13,PNC Park,19,11
2021-08-01,2021,COL,SD,1,8,142,1.5,-145,8.5,-120,100,-152,-1.5,125,3.51,PETCO Park,9,-7
2021-08-01,2021,TEX,SEA,4,3,132,1.5,-125,9.0,-105,-115,-142,-1.5,105,3.88,Globe Life Field,7,1
2021-08-01,2021,HOU,SF,3,5,108,1.5,-190,8.5,-105,-115,-118,-1.5,170,4.09,AT&T Park,8,-2
2021-08-01,2021,MIN,STL,3,7,146,1.5,-150,8.0,-120,100,-156,-1.5,130,3.25,Busch Stadium,10,-4
2021-08-01,2021,BOS,TB,2,3,146,1.5,-135,9.0,100,-120,-156,-1.5,115,3.66,Tropicana Field,5,-1
2021-08-01,2021,SEA,TEX,3,4,-142,-1.5,105,9.0,-105,-115,132,1.5,-125,5.28,Globe Life Field,7,-1
2021-08-01,2021,KC,TOR,1,5,220,1.5,110,8.5,-115,-105,-250,-1.5,-130,2.66,Rogers Centre,6,-4
2021-08-01,2021,CHC,WSH,5,6,102,1.5,-190,8.5,-115,-105,-112,-1.5,170,4.21,Nationals Park,11,-1
2021-08-02,2021,SF,ARI,11,8,-205,-1.5,-130,9.5,100,-120,185,1.5,110,6.39,Chase Field,19,3
2021-08-02,2021,NYY,BAL,1,7,-290,-1.5,-150,10.0,-120,100,250,1.5,130,7.44,Yankee Stadium,8,-6
2021-08-02,2021,TOR,CLE,2,5,-250,-1.5,-135,9.0,-120,100,220,1.5,115,6.43,Rogers Centre,7,-3
2021-08-02,2021,TEX,LAA,4,1,-108,-1.5,175,8.5,-115,-105,-102,1.5,-200,4.41,Globe Life Field,5,3
2021-08-02,2021,NYM,MIA,3,6,-160,-1.5,110,7.5,100,-120,150,1.5,-130,4.62,Marlins Park,9,-3
2021-08-02,2021,PIT,MIL,2,6,185,1.5,-115,9.0,-115,-105,-205,-1.5,-105,3.16,Miller Park,8,-4
2021-08-02,2021,MIA,NYM,6,3,150,1.5,-130,7.5,100,-120,-160,-1.5,110,3.0,Marlins Park,9,3
2021-08-02,2021,BAL,NYY,7,1,250,1.5,130,10.0,-120,100,-290,-1.5,-150,2.86,Yankee Stadium,8,6
2021-08-02,2021,WSH,PHI,5,7,107,1.5,-155,8.5,-115,-105,-117,-1.5,135,4.11,Nationals Park,12,-2
2021-08-02,2021,MIL,PIT,6,2,-205,-1.5,-105,9.0,-115,-105,185,1.5,-115,6.05,Miller Park,8,4
2021-08-02,2021,TB,SEA,2,8,-190,-1.5,100,9.0,-105,-115,175,1.5,-120,5.9,Tropicana Field,10,-6
2021-08-02,2021,ARI,SF,8,11,185,1.5,110,9.5,100,-120,-205,-1.5,-130,3.33,Chase Field,19,-3
2021-08-02,2021,SEA,TB,8,2,175,1.5,-120,9.0,-105,-115,-190,-1.5,100,3.27,Tropicana Field,10,6
2021-08-02,2021,LAA,TEX,1,4,-102,1.5,-200,8.5,-115,-105,-108,-1.5,175,4.29,Globe Life Field,5,-3
2021-08-02,2021,CLE,TOR,5,2,220,1.5,115,9.0,-120,100,-250,-1.5,-135,2.81,Rogers Centre,7,3
2021-08-02,2021,PHI,WSH,7,5,-117,-1.5,135,8.5,-115,-105,107,1.5,-155,4.58,Nationals Park,12,2
2021-08-03,2021,SF,ARI,1,3,-174,-1.5,-120,9.5,-110,-110,162,1.5,100,6.03,Chase Field,4,-2
2021-08-03,2021,STL,ATL,1,6,118,1.5,-145,8.5,-120,100,-128,-1.5,125,3.9,Busch Stadium,7,-5
2021-08-03,2021,NYY,BAL,13,1,-250,-1.5,-140,10.5,-110,-110,220,1.5,120,7.5,Yankee Stadium,14,12
2021-08-03,2021,DET,BOS,4,2,131,1.5,-120,10.0,-115,-105,-141,-1.5,100,4.33,Comerica Park,6,2
2021-08-03,2021,COL,CHC,13,6,-138,-1.5,125,11.5,105,-125,128,1.5,-145,6.67,Coors Field,19,7
2021-08-03,2021,MIN,CIN,7,5,125,1.5,-165,9.0,-105,-115,-135,-1.5,145,4.0,Great American Ballpark,12,2
2021-08-03,2021,TOR,CLE,7,2,-200,-1.5,-110,9.0,-105,-115,180,1.5,-110,6.0,Rogers Centre,9,5
2021-08-03,2021,CHC,COL,6,13,128,1.5,-145,11.5,105,-125,-138,-1.5,125,5.04,Coors Field,19,-7
2021-08-03,2021,KC,CWS,1,7,220,1.5,105,9.0,-105,-115,-250,-1.5,-125,2.81,Guaranteed Rate Field,8,-6
2021-08-03,2021,BOS,DET,2,4,-141,-1.5,100,10.0,-115,-105,131,1.5,-120,5.85,Comerica Park,6,-2
2021-08-03,2021,LAD,HOU,0,3,-176,-1.5,115,8.5,-115,-105,163,1.5,-135,5.42,Dodger Stadium,3,-3
2021-08-03,2021,CWS,KC,7,1,-250,-1.5,-125,9.0,-105,-115,220,1.5,105,6.43,Guaranteed Rate Field,8,6
2021-08-03,2021,TEX,LAA,3,11,118,1.5,-150,8.5,-115,-105,-128,-1.5,130,3.9,Globe Life Field,14,-8
2021-08-03,2021,HOU,LAD,3,0,163,1.5,-135,8.5,-115,-105,-176,-1.5,115,3.23,Dodger Stadium,3,3
2021-08-03,2021,NYM,MIA,4,5,-185,-1.5,-110,8.5,-115,-105,170,1.5,-110,5.52,Marlins Park,9,-1
2021-08-03,2021,PIT,MIL,8,5,205,1.5,105,9.0,-105,-115,-230,-1.5,-125,2.95,Miller Park,13,3
2021-08-03,2021,CIN,MIN,5,7,-135,-1.5,145,9.0,-105,-115,125,1.5,-165,5.17,Great American Ballpark,12,-2
2021-08-03,2021,MIA,NYM,5,4,170,1.5,-110,8.5,-115,-105,-185,-1.5,-110,3.15,Marlins Park,9,1
2021-08-03,2021,BAL,NYY,1,13,220,1.5,120,10.5,-110,-110,-250,-1.5,-140,3.28,Yankee Stadium,14,-12
2021-08-03,2021,SD,OAK,8,1,153,1.5,-140,8.5,100,-120,-163,-1.5,120,3.36,Oakland Coliseum,9,7
2021-08-03,2021,WSH,PHI,4,5,158,1.5,-110,8.0,-115,-105,-168,-1.5,-110,3.1,Nationals Park,9,-1
2021-08-03,2021,MIL,PIT,5,8,-230,-1.5,-125,9.0,-105,-115,205,1.5,105,6.27,Miller Park,13,-3
2021-08-03,2021,OAK,SD,1,8,-163,-1.5,120,8.5,100,-120,153,1.5,-140,5.27,Oakland Coliseum,9,-7
2021-08-03,2021,TB,SEA,2,4,-153,-1.5,120,8.0,-115,-105,143,1.5,-140,4.84,Tropicana Field,6,-2
2021-08-03,2021,ARI,SF,3,1,162,1.5,100,9.5,-110,-110,-174,-1.5,-120,3.63,Chase Field,4,2
2021-08-03,2021,ATL,STL,6,1,-128,-1.5,125,8.5,-120,100,118,1.5,-145,4.77,Busch Stadium,7,5
2021-08-03,2021,SEA,TB,4,2,143,1.5,-140,8.0,-115,-105,-153,-1.5,120,3.29,Tropicana Field,6,2
2021-08-03,2021,LAA,TEX,11,3,-128,-1.5,130,8.5,-115,-105,118,1.5,-150,4.77,Globe Life Field,14,8
2021-08-03,2021,CLE,TOR,2,7,180,1.5,-110,9.0,-105,-115,-200,-1.5,-110,3.21,Rogers Centre,9,-5
2021-08-03,2021,PHI,WSH,5,4,-168,-1.5,-110,8.0,-115,-105,158,1.5,-110,5.01,Nationals Park,9,1
2021-08-04,2021,SF,ARI,7,1,-178,-1.5,-115,9.0,105,-125,164,1.5,-105,5.76,Chase Field,8,6
2021-08-04,2021,STL,ATL,4,7,-102,1.5,-160,9.0,-120,100,-108,-1.5,140,4.54,Busch Stadium,11,-3
2021-08-04,2021,NYY,BAL,10,3,-254,-1.5,-135,9.0,-115,-105,224,1.5,115,6.46,Yankee Stadium,13,7
2021-08-04,2021,DET,BOS,1,4,135,1.5,-115,9.0,-110,-110,-145,-1.5,-105,3.83,Comerica Park,5,-3
2021-08-04,2021,COL,CHC,2,3,-172,-1.5,105,11.0,100,-120,161,1.5,-125,6.96,Coors Field,5,-1
2021-08-04,2021,MIN,CIN,5,6,210,1.5,100,9.5,-105,-115,-240,-1.5,-120,3.06,Great American Ballpark,11,-1
2021-08-04,2021,TOR,CLE,8,6,-205,-1.5,-115,9.5,-120,100,185,1.5,-105,6.39,Rogers Centre,14,2
2021-08-04,2021,CHC,COL,3,2,161,1.5,-125,11.0,100,-120,-172,-1.5,105,4.21,Coors Field,5,1
2021-08-04,2021,KC,CWS,9,1,230,1.5,110,8.5,-120,100,-260,-1.5,-130,2.58,Guaranteed Rate Field,10,8
2021-08-04,2021,BOS,DET,4,1,-145,-1.5,-105,9.0,-110,-110,135,1.5,-115,5.33,Comerica Park,5,3
2021-08-04,2021,LAD,HOU,7,5,-230,-1.5,-120,9.0,-105,-115,205,1.5,100,6.27,Dodger Stadium,12,2
2021-08-04,2021,CWS,KC,1,9,-260,-1.5,-130,8.5,-120,100,230,1.5,110,6.14,Guaranteed Rate Field,10,-8
2021-08-04,2021,TEX,LAA,1,2,161,1.5,-115,8.0,-115,-105,-172,-1.5,-105,3.07,Globe Life Field,3,-1
2021-08-04,2021,HOU,LAD,5,7,205,1.5,100,9.0,-105,-115,-230,-1.5,-120,2.95,Dodger Stadium,12,-2
2021-08-04,2021,NYM,MIA,5,3,-149,-1.5,110,7.5,100,-120,139,1.5,-130,4.49,Marlins Park,8,2
2021-08-04,2021,PIT,MIL,2,4,225,1.5,105,8.0,-115,-105,-255,-1.5,-125,2.46,Miller Park,6,-2
2021-08-04,2021,CIN,MIN,6,5,-240,-1.5,-120,9.5,-105,-115,210,1.5,100,6.71,Great American Ballpark,11,1
2021-08-04,2021,MIA,NYM,3,5,139,1.5,-130,7.5,100,-120,-149,-1.5,110,3.14,Marlins Park,8,-2
2021-08-04,2021,BAL,NYY,3,10,224,1.5,115,9.0,-115,-105,-254,-1.5,-135,2.78,Yankee Stadium,13,-7
2021-08-04,2021,SD,OAK,4,5,110,1.5,-190,8.0,100,-120,-120,-1.5,170,3.81,Oakland Coliseum,9,-1
2021-08-04,2021,WSH,PHI,5,9,-114,-1.5,175,9.5,100,-120,104,1.5,-200,5.06,Nationals Park,14,-4
2021-08-04,2021,MIL,PIT,4,2,-255,-1.5,-125,8.0,-115,-105,225,1.5,105,5.75,Miller Park,6,2
2021-08-04,2021,OAK,SD,5,4,-120,-1.5,170,8.0,100,-120,110,1.5,-190,4.36,Oakland Coliseum,9,1
2021-08-04,2021,TB,SEA,4,3,-154,-1.5,130,8.0,-105,-115,144,1.5,-150,4.85,Tropicana Field,7,1
2021-08-04,2021,ARI,SF,1,7,164,1.5,-105,9.0,105,-125,-178,-1.5,-115,3.41,Chase Field,8,-6
2021-08-04,2021,ATL,STL,7,4,-108,-1.5,140,9.0,-120,100,-102,1.5,-160,4.67,Busch Stadium,11,3
2021-08-04,2021,SEA,TB,3,4,144,1.5,-150,8.0,-105,-115,-154,-1.5,130,3.28,Tropicana Field,7,-1
2021-08-04,2021,LAA,TEX,2,1,-172,-1.5,-105,8.0,-115,-105,161,1.5,-115,5.06,Globe Life Field,3,1
2021-08-04,2021,CLE,TOR,6,8,185,1.5,-105,9.5,-120,100,-205,-1.5,-115,3.33,Rogers Centre,14,-2
2021-08-04,2021,PHI,WSH,9,5,104,1.5,-200,9.5,100,-120,-114,-1.5,175,4.66,Nationals Park,14,4
2021-08-05,2021,SF,ARI,5,4,-157,-1.5,-110,9.0,-105,-115,147,1.5,-110,5.5,Chase Field,9,1
2021-08-05,2021,STL,ATL,4,8,109,1.5,-155,9.0,-115,-105,-119,-1.5,135,4.31,Busch Stadium,12,-4
2021-08-05,2021,DET,BOS,8,1,114,1.5,-140,10.0,-105,-115,-124,-1.5,120,4.67,Comerica Park,9,7
2021-08-05,2021,COL,CHC,6,5,-151,-1.5,115,11.5,-110,-110,141,1.5,-135,6.92,Coors Field,11,1
2021-08-05,2021,PIT,CIN,4,7,216,1.5,105,9.5,-115,-105,-246,-1.5,-125,3.01,Great American Ballpark,11,-3
2021-08-05,2021,TOR,CLE,3,0,-200,-1.5,-115,9.0,-115,-105,180,1.5,-105,6.0,Rogers Centre,3,3
2021-08-05,2021,CHC,COL,5,6,141,1.5,-135,11.5,-110,-110,-151,-1.5,115,4.77,Coors Field,11,-1
2021-08-05,2021,KC,CWS,3,2,173,1.5,-110,9.5,-110,-110,-188,-1.5,-110,3.48,Guaranteed Rate Field,5,1
2021-08-05,2021,BOS,DET,1,8,-124,-1.5,120,10.0,-105,-115,114,1.5,-140,5.54,Comerica Park,9,-7
2021-08-05,2021,MIN,HOU,5,3,210,1.5,110,9.0,-120,100,-240,-1.5,-130,2.9,Minute Maid Park,8,2
2021-08-05,2021,CWS,KC,2,3,-188,-1.5,-110,9.5,-110,-110,173,1.5,-110,6.2,Guaranteed Rate Field,5,-1
2021-08-05,2021,TEX,LAA,0,5,-103,1.5,-160,9.0,-105,-115,-107,-1.5,140,4.57,Globe Life Field,5,-5
2021-08-05,2021,NYM,MIA,2,4,-129,-1.5,120,8.0,-120,100,119,1.5,-140,4.51,Marlins Park,6,-2
2021-08-05,2021,HOU,MIN,3,5,-240,-1.5,-130,9.0,-120,100,210,1.5,110,6.35,Minute Maid Park,8,-2
2021-08-05,2021,MIA,NYM,4,2,119,1.5,-140,8.0,-120,100,-129,-1.5,120,3.65,Marlins Park,6,2
2021-08-05,2021,SEA,NYY,3,5,178,1.5,-110,9.5,100,-120,-196,-1.5,-110,3.42,Yankee Stadium,8,-2
2021-08-05,2021,WSH,PHI,6,7,136,1.5,-125,8.5,-125,105,-146,-1.5,105,3.6,Nationals Park,13,-1
2021-08-05,2021,CIN,PIT,7,4,-246,-1.5,-125,9.5,-115,-105,216,1.5,105,6.75,Great American Ballpark,11,3
2021-08-05,2021,NYY,SEA,5,3,-196,-1.5,-110,9.5,100,-120,178,1.5,-110,6.29,Yankee Stadium,8,2
2021-08-05,2021,ARI,SF,4,5,147,1.5,-110,9.0,-105,-115,-157,-1.5,-110,3.64,Chase Field,9,-1
2021-08-05,2021,ATL,STL,8,4,-119,-1.5,135,9.0,-115,-105,109,1.5,-155,4.89,Busch Stadium,12,4
2021-08-05,2021,LAA,TEX,5,0,-107,-1.5,140,9.0,-105,-115,-103,1.5,-160,4.65,Globe Life Field,5,5
2021-08-05,2021,CLE,TOR,0,3,180,1.5,-105,9.0,-115,-105,-200,-1.5,-115,3.21,Rogers Centre,3,-3
2021-08-05,2021,PHI,WSH,7,6,-146,-1.5,105,8.5,-125,105,136,1.5,-125,5.04,Nationals Park,13,1
2021-08-06,2021,SD,ARI,5,8,-210,-1.5,-105,8.5,-120,100,190,1.5,-115,5.76,PETCO Park,13,-3
2021-08-06,2021,WSH,ATL,4,8,176,1.5,-110,9.0,-110,-110,-192,-1.5,-110,3.26,Suntrust Park,12,-4
2021-08-06,2021,TB,BAL,10,6,-143,-1.5,105,10.0,-105,-115,133,1.5,-125,5.88,Camden Yards,16,4
2021-08-06,2021,TOR,BOS,12,4,-143,-1.5,135,9.0,-120,100,133,1.5,-155,5.3,Rogers Centre,16,8
2021-08-06,2021,CWS,CHC,8,6,-200,-1.5,-125,8.5,-115,-105,180,1.5,105,5.67,Wrigley Field,14,2
2021-08-06,2021,PIT,CIN,0,10,170,1.5,-110,9.5,-105,-115,-185,-1.5,-110,3.52,Great American Ballpark,10,-10
2021-08-06,2021,DET,CLE,1,6,124,1.5,-160,9.5,-115,-105,-134,-1.5,140,4.24,Progressive Field,7,-5
2021-08-06,2021,MIA,COL,2,14,149,1.5,-140,9.5,-105,-115,-159,-1.5,120,3.82,Coors Field,16,-12
2021-08-06,2021,CHC,CWS,6,8,180,1.5,105,8.5,-115,-105,-200,-1.5,-125,3.04,Wrigley Field,14,-2
2021-08-06,2021,CLE,DET,6,1,-134,-1.5,140,9.5,-115,-105,124,1.5,-160,5.44,Progressive Field,7,5
2021-08-06,2021,MIN,HOU,5,4,178,1.5,-105,9.0,-115,-105,-196,-1.5,-115,3.24,Minute Maid Park,9,1
2021-08-06,2021,STL,KC,4,2,-182,-1.5,110,8.0,100,-120,167,1.5,-130,5.16,Busch Stadium,6,2
2021-08-06,2021,LAD,LAA,3,4,-212,-1.5,-110,8.0,-115,-105,192,1.5,-110,5.44,Dodger Stadium,7,-1
2021-08-06,2021,LAA,LAD,4,3,192,1.5,-110,8.0,-115,-105,-212,-1.5,-110,2.74,Dodger Stadium,7,1
2021-08-06,2021,COL,MIA,14,2,-159,-1.5,120,9.5,-105,-115,149,1.5,-140,5.83,Coors Field,16,12
2021-08-06,2021,SF,MIL,1,2,133,1.5,-165,8.0,100,-120,-143,-1.5,145,3.43,Miller Park,3,-1
2021-08-06,2021,HOU,MIN,4,5,-196,-1.5,-115,9.0,-115,-105,178,1.5,-105,5.96,Minute Maid Park,9,-1
2021-08-06,2021,PHI,NYM,4,2,-112,-1.5,170,9.5,-105,-115,102,1.5,-190,5.02,Citizens Bank Park,6,2
2021-08-06,2021,SEA,NYY,2,3,158,1.5,-125,10.5,-110,-110,-168,-1.5,105,4.07,Yankee Stadium,5,-1
2021-08-06,2021,TEX,OAK,1,4,260,1.5,130,8.0,-110,-110,-300,-1.5,-150,2.22,Oakland Coliseum,5,-3
2021-08-06,2021,NYM,PHI,2,4,102,1.5,-190,9.5,-105,-115,-112,-1.5,170,4.7,Citizens Bank Park,6,-2
2021-08-06,2021,CIN,PIT,10,0,-185,-1.5,-110,9.5,-105,-115,170,1.5,-110,6.17,Great American Ballpark,10,10
2021-08-06,2021,ARI,SD,8,5,190,1.5,-115,8.5,-120,100,-210,-1.5,-105,2.93,PETCO Park,13,3
2021-08-06,2021,NYY,SEA,3,2,-168,-1.5,105,10.5,-110,-110,158,1.5,-125,6.58,Yankee Stadium,5,1
2021-08-06,2021,MIL,SF,2,1,-143,-1.5,145,8.0,100,-120,133,1.5,-165,4.71,Miller Park,3,1
2021-08-06,2021,KC,STL,2,4,167,1.5,-130,8.0,100,-120,-182,-1.5,110,3.0,Busch Stadium,6,-2
2021-08-06,2021,BAL,TB,6,10,133,1.5,-125,10.0,-105,-115,-143,-1.5,105,4.29,Camden Yards,16,-4
2021-08-06,2021,OAK,TEX,4,1,-300,-1.5,-150,8.0,-110,-110,260,1.5,130,6.0,Oakland Coliseum,5,3
2021-08-06,2021,BOS,TOR,4,12,133,1.5,-155,9.0,-120,100,-143,-1.5,135,3.86,Rogers Centre,16,-8
2021-08-06,2021,ATL,WSH,8,4,-192,-1.5,-110,9.0,-110,-110,176,1.5,-110,5.92,Suntrust Park,12,4
2021-08-07,2021,SD,ARI,6,2,-300,-1.5,-155,8.0,-120,100,260,1.5,135,6.0,PETCO Park,8,4
2021-08-07,2021,WSH,ATL,3,2,230,1.5,115,8.5,-110,-110,-260,-1.5,-135,2.58,Suntrust Park,5,1
2021-08-07,2021,TB,BAL,12,3,-230,-1.5,-145,10.0,-105,-115,205,1.5,125,6.97,Camden Yards,15,9
2021-08-07,2021,TOR,BOS,1,0,-185,-1.5,115,7.0,100,-120,170,1.5,-135,4.54,Rogers Centre,1,1
2021-08-07,2021,TOR,BOS,1,2,-159,-1.5,135,7.0,105,-125,149,1.5,-155,4.3,Rogers Centre,3,-1
2021-08-07,2021,CWS,CHC,4,0,-192,-1.5,-120,8.5,-105,-115,176,1.5,100,5.59,Wrigley Field,4,4
2021-08-07,2021,PIT,CIN,3,11,175,1.5,-110,10.5,-115,-105,-190,-1.5,-110,3.82,Great American Ballpark,14,-8
2021-08-07,2021,DET,CLE,2,1,133,1.5,-155,9.5,-115,-105,-143,-1.5,135,4.08,Progressive Field,3,1
2021-08-07,2021,MIA,COL,4,7,148,1.5,-135,10.5,-120,100,-158,-1.5,115,4.23,Coors Field,11,-3
2021-08-07,2021,CHC,CWS,0,4,176,1.5,100,8.5,-105,-115,-192,-1.5,-120,3.08,Wrigley Field,4,-4
2021-08-07,2021,CLE,DET,1,2,-143,-1.5,135,9.5,-115,-105,133,1.5,-155,5.59,Progressive Field,3,-1
2021-08-07,2021,MIN,HOU,0,4,205,1.5,100,8.5,-120,100,-230,-1.5,-120,2.79,Minute Maid Park,4,-4
2021-08-07,2021,STL,KC,5,2,-151,-1.5,125,8.5,-120,100,141,1.5,-145,5.11,Busch Stadium,7,3
2021-08-07,2021,LAD,LAA,5,3,-360,-1.5,-180,8.5,-120,100,310,1.5,160,6.65,Dodger Stadium,8,2
2021-08-07,2021,LAA,LAD,3,5,310,1.5,160,8.5,-120,100,-360,-1.5,-180,2.07,Dodger Stadium,8,-2
2021-08-07,2021,COL,MIA,7,4,-158,-1.5,115,10.5,-120,100,148,1.5,-135,6.43,Coors Field,11,3
2021-08-07,2021,SF,MIL,9,6,171,1.5,-130,8.5,-105,-115,-186,-1.5,110,3.14,Miller Park,15,3
2021-08-07,2021,HOU,MIN,4,0,-230,-1.5,-120,8.5,-120,100,205,1.5,100,5.92,Minute Maid Park,4,4
2021-08-07,2021,PHI,NYM,5,3,-112,-1.5,170,9.5,-115,-105,102,1.5,-190,5.02,Citizens Bank Park,8,2
2021-08-07,2021,SEA,NYY,4,5,179,1.5,-105,10.5,-115,-105,-198,-1.5,-115,3.76,Yankee Stadium,9,-1
2021-08-07,2021,TEX,OAK,3,12,210,1.5,105,8.5,-105,-115,-240,-1.5,-125,2.74,Oakland Coliseum,15,-9
2021-08-07,2021,NYM,PHI,3,5,102,1.5,-190,9.5,-115,-105,-112,-1.5,170,4.7,Citizens Bank Park,8,-2
2021-08-07,2021,CIN,PIT,11,3,-190,-1.5,-110,10.5,-115,-105,175,1.5,-110,6.88,Great American Ballpark,14,8
2021-08-07,2021,ARI,SD,2,6,260,1.5,135,8.0,-120,100,-300,-1.5,-155,2.22,PETCO Park,8,-4
2021-08-07,2021,NYY,SEA,5,4,-198,-1.5,-115,10.5,-115,-105,179,1.5,-105,6.98,Yankee Stadium,9,1
2021-08-07,2021,MIL,SF,6,9,-186,-1.5,110,8.5,-105,-115,171,1.5,-130,5.53,Miller Park,15,-3
2021-08-07,2021,KC,STL,2,5,141,1.5,-145,8.5,-120,100,-151,-1.5,125,3.53,Busch Stadium,7,-3
2021-08-07,2021,BAL,TB,3,12,205,1.5,125,10.0,-105,-115,-230,-1.5,-145,3.28,Camden Yards,15,-9
2021-08-07,2021,OAK,TEX,12,3,-240,-1.5,-125,8.5,-105,-115,210,1.5,105,6.0,Oakland Coliseum,15,9
2021-08-07,2021,BOS,TOR,0,1,170,1.5,-135,7.0,100,-120,-185,-1.5,115,2.59,Rogers Centre,1,-1
2021-08-07,2021,BOS,TOR,2,1,149,1.5,-155,7.0,105,-125,-159,-1.5,135,2.81,Rogers Centre,3,1
2021-08-07,2021,ATL,WSH,2,3,-260,-1.5,-135,8.5,-110,-110,230,1.5,115,6.14,Suntrust Park,5,-1
2021-08-08,2021,SD,ARI,2,0,-210,-1.5,-110,8.5,-115,-105,190,1.5,-110,5.76,PETCO Park,2,2
2021-08-08,2021,WSH,ATL,4,5,190,1.5,-110,8.5,100,-120,-210,-1.5,-110,2.93,Suntrust Park,9,-1
2021-08-08,2021,TB,BAL,9,6,-176,-1.5,-125,10.0,-120,100,163,1.5,115,6.38,Camden Yards,15,3
2021-08-08,2021,TOR,BOS,9,8,-180,-1.5,100,9.0,-120,100,165,1.5,-135,5.79,Rogers Centre,17,1
2021-08-08,2021,CWS,CHC,9,3,-174,-1.5,-120,10.0,-115,-105,162,1.5,100,6.35,Wrigley Field,12,6
2021-08-08,2021,PIT,CIN,2,3,230,1.5,120,10.5,-105,-115,-260,-1.5,-140,3.18,Great American Ballpark,5,-1
2021-08-08,2021,DET,CLE,5,7,144,1.5,-135,9.5,-110,-110,-154,-1.5,115,3.89,Progressive Field,12,-2
2021-08-08,2021,MIA,COL,8,13,153,1.5,-125,11.0,-120,100,-163,-1.5,105,4.35,Coors Field,21,-5
2021-08-08,2021,CHC,CWS,3,9,162,1.5,100,10.0,-115,-105,-174,-1.5,-120,3.82,Wrigley Field,12,-6
2021-08-08,2021,CLE,DET,7,5,-154,-1.5,115,9.5,-110,-110,144,1.5,-135,5.76,Progressive Field,12,2
2021-08-08,2021,MIN,HOU,7,5,164,1.5,-125,8.0,100,-120,-178,-1.5,105,3.03,Minute Maid Park,12,2
2021-08-08,2021,STL,KC,5,6,-130,-1.5,135,10.0,-110,-110,120,1.5,-155,5.65,Busch Stadium,11,-1
2021-08-08,2021,LAD,LAA,8,2,-350,-1.5,-170,8.5,-105,-115,300,1.5,150,6.61,Dodger Stadium,10,6
2021-08-08,2021,LAA,LAD,2,8,300,1.5,150,8.5,-105,-115,-350,-1.5,-170,2.13,Dodger Stadium,10,-6
2021-08-08,2021,COL,MIA,13,8,-163,-1.5,105,11.0,-120,100,153,1.5,-125,6.82,Coors Field,21,5
2021-08-08,2021,SF,MIL,5,4,-102,1.5,-200,9.5,-110,-110,-108,-1.5,175,4.8,Miller Park,9,1
2021-08-08,2021,HOU,MIN,5,7,-178,-1.5,105,8.0,100,-120,164,1.5,-125,5.12,Minute Maid Park,12,-2
2021-08-08,2021,PHI,NYM,3,0,-180,-1.5,120,8.0,-110,-110,165,1.5,-140,5.14,Citizens Bank Park,3,3
2021-08-08,2021,SEA,NYY,2,0,126,1.5,-155,9.0,100,-120,-136,-1.5,135,3.98,Yankee Stadium,2,2
2021-08-08,2021,TEX,OAK,3,6,230,1.5,110,8.5,100,-120,-260,-1.5,-130,2.58,Oakland Coliseum,9,-3
2021-08-08,2021,NYM,PHI,0,3,165,1.5,-140,8.0,-110,-110,-180,-1.5,120,3.02,Citizens Bank Park,3,-3
2021-08-08,2021,CIN,PIT,3,2,-260,-1.5,-140,10.5,-105,-115,230,1.5,120,7.58,Great American Ballpark,5,1
2021-08-08,2021,ARI,SD,0,2,190,1.5,-110,8.5,-115,-105,-210,-1.5,-110,2.93,PETCO Park,2,-2
2021-08-08,2021,NYY,SEA,0,2,-136,-1.5,135,9.0,100,-120,126,1.5,-155,5.19,Yankee Stadium,2,-2
2021-08-08,2021,MIL,SF,4,5,-108,-1.5,175,9.5,-110,-110,-102,1.5,-200,4.93,Miller Park,9,-1
2021-08-08,2021,KC,STL,6,5,120,1.5,-155,10.0,-110,-110,-130,-1.5,135,4.55,Busch Stadium,11,1
2021-08-08,2021,BAL,TB,6,9,163,1.5,115,10.0,-120,100,-176,-1.5,-125,3.8,Camden Yards,15,-3
2021-08-08,2021,OAK,TEX,6,3,-260,-1.5,-130,8.5,100,-120,230,1.5,110,6.14,Oakland Coliseum,9,3
2021-08-08,2021,BOS,TOR,8,9,165,1.5,-135,9.0,-120,100,-180,-1.5,100,3.4,Rogers Centre,17,-1
2021-08-08,2021,ATL,WSH,5,4,-210,-1.5,-110,8.5,100,-120,190,1.5,-110,5.76,Suntrust Park,9,1
2021-08-09,2021,CLE,CIN,9,3,162,1.5,100,9.5,-120,100,-174,-1.5,-120,3.63,Progressive Field,12,6
2021-08-09,2021,CIN,CLE,3,9,-174,-1.5,-120,9.5,-120,100,162,1.5,100,6.03,Progressive Field,12,-6
2021-08-09,2021,MIN,CWS,1,11,188,1.5,115,10.0,-105,-115,-208,-1.5,-135,3.47,Target Field,12,-10
2021-08-09,2021,NYY,KC,8,6,-165,-1.5,-115,10.0,100,-120,155,1.5,-105,6.23,Kauffman Stadium,14,2
2021-08-09,2021,SD,MIA,8,3,-250,-1.5,-120,7.5,-105,-115,220,1.5,100,5.36,PETCO Park,11,5
2021-08-09,2021,CWS,MIN,11,1,-208,-1.5,-135,10.0,-105,-115,188,1.5,115,6.75,Target Field,12,10
2021-08-09,2021,KC,NYY,6,8,155,1.5,-105,10.0,100,-120,-165,-1.5,-115,3.92,Kauffman Stadium,14,-2
2021-08-09,2021,MIA,SD,3,8,220,1.5,100,7.5,-105,-115,-250,-1.5,-120,2.34,PETCO Park,11,-5
2021-08-10,2021,SF,ARI,8,7,-220,-1.5,-115,8.0,-115,-105,200,1.5,-105,5.5,AT&T Park,15,1
2021-08-10,2021,CIN,ATL,2,3,110,1.5,-180,9.5,-105,-115,-120,-1.5,160,4.52,Suntrust Park,5,-1
2021-08-10,2021,DET,BAL,9,4,-125,-1.5,120,10.0,-110,-110,115,1.5,-140,5.56,Camden Yards,13,5
2021-08-10,2021,TB,BOS,8,4,112,1.5,-160,9.5,-120,100,-122,-1.5,140,4.48,Fenway Park,12,4
2021-08-10,2021,MIL,CHC,4,2,-188,-1.5,-115,7.0,105,-125,173,1.5,-105,4.57,Wrigley Field,6,2
2021-08-10,2021,MIL,CHC,6,3,-148,-1.5,110,8.0,-105,-115,138,1.5,-130,4.77,Wrigley Field,9,3
2021-08-10,2021,ATL,CIN,3,2,-120,-1.5,160,9.5,-105,-115,110,1.5,-180,5.18,Suntrust Park,5,1
2021-08-10,2021,OAK,CLE,4,3,-142,-1.5,100,9.5,-110,-110,132,1.5,-120,5.57,Progressive Field,7,1
2021-08-10,2021,HOU,COL,5,0,-182,-1.5,100,9.0,-105,-115,167,1.5,-120,5.81,Minute Maid Park,5,5
2021-08-10,2021,MIN,CWS,4,3,140,1.5,-105,10.5,-115,-105,-150,-1.5,-115,4.38,Target Field,7,1
2021-08-10,2021,BAL,DET,4,9,115,1.5,-140,10.0,-110,-110,-125,-1.5,120,4.65,Camden Yards,13,-5
2021-08-10,2021,COL,HOU,0,5,167,1.5,-120,9.0,-105,-115,-182,-1.5,100,3.37,Minute Maid Park,5,-5
2021-08-10,2021,NYY,KC,4,8,-147,-1.5,-105,10.0,-120,100,137,1.5,-115,5.95,Kauffman Stadium,12,-4
2021-08-10,2021,TOR,LAA,3,6,-163,-1.5,125,7.5,100,-120,153,1.5,-145,4.65,Angel Stadium,9,-3
2021-08-10,2021,TOR,LAA,4,0,-170,-1.5,100,7.5,-120,100,160,1.5,-120,4.72,Angel Stadium,4,4
2021-08-10,2021,PHI,LAD,0,5,135,1.5,-135,8.5,-105,-115,-145,-1.5,115,3.62,Citizens Bank Park,5,-5
2021-08-10,2021,SD,MIA,6,5,-240,-1.5,-125,7.5,-115,-105,210,1.5,105,5.29,PETCO Park,11,1
2021-08-10,2021,CHC,MIL,2,4,173,1.5,-105,7.0,105,-125,-188,-1.5,-115,2.56,Wrigley Field,6,-2
2021-08-10,2021,CHC,MIL,3,6,138,1.5,-130,8.0,-105,-115,-148,-1.5,110,3.36,Wrigley Field,9,-3
2021-08-10,2021,CWS,MIN,3,4,-150,-1.5,-115,10.5,-115,-105,140,1.5,-105,6.3,Target Field,7,-1
2021-08-10,2021,WSH,NYM,7,8,130,1.5,-160,9.0,-110,-110,-150,-1.5,130,3.91,Citi Field,15,-1
2021-08-10,2021,KC,NYY,8,4,137,1.5,-115,10.0,-120,100,-147,-1.5,-105,4.22,Kauffman Stadium,12,4
2021-08-10,2021,CLE,OAK,3,4,132,1.5,-120,9.5,-110,-110,-142,-1.5,100,4.09,Progressive Field,7,-1
2021-08-10,2021,LAD,PHI,5,0,-145,-1.5,115,8.5,-105,-115,135,1.5,-135,5.03,Citizens Bank Park,5,5
2021-08-10,2021,STL,PIT,4,1,-131,-1.5,115,9.5,100,-120,121,1.5,-135,5.39,PNC Park,5,3
2021-08-10,2021,MIA,SD,5,6,210,1.5,105,7.5,-115,-105,-240,-1.5,-125,2.42,PETCO Park,11,-1
2021-08-10,2021,TEX,SEA,5,4,190,1.5,-110,8.0,100,-120,-210,-1.5,-110,2.76,T-Mobile Park,9,1
2021-08-10,2021,ARI,SF,7,8,200,1.5,-105,8.0,-115,-105,-220,-1.5,-115,2.67,AT&T Park,15,-1
2021-08-10,2021,PIT,STL,1,4,121,1.5,-135,9.5,100,-120,-131,-1.5,115,4.3,PNC Park,5,-3
2021-08-10,2021,BOS,TB,4,8,-122,-1.5,140,9.5,-120,100,112,1.5,-160,5.22,Fenway Park,12,-4
2021-08-10,2021,SEA,TEX,4,5,-210,-1.5,-110,8.0,100,-120,190,1.5,-110,5.42,T-Mobile Park,9,-1
2021-08-10,2021,LAA,TOR,6,3,153,1.5,-145,7.5,100,-120,-163,-1.5,125,2.96,Angel Stadium,9,3
2021-08-10,2021,LAA,TOR,0,4,160,1.5,-120,7.5,-120,100,-170,-1.5,100,2.88,Angel Stadium,4,-4
2021-08-10,2021,NYM,WSH,8,7,-150,-1.5,130,9.0,-110,-110,130,1.5,-160,5.4,Citi Field,15,1
2021-08-11,2021,SF,ARI,7,2,-269,-1.5,-130,7.5,-110,-110,239,1.5,110,5.47,AT&T Park,9,5
2021-08-11,2021,CIN,ATL,6,8,112,1.5,-180,9.5,-110,-110,-122,-1.5,160,4.48,Suntrust Park,14,-2
2021-08-11,2021,DET,BAL,5,2,-110,-1.5,135,10.0,-115,-105,100,1.5,-155,5.24,Camden Yards,7,3
2021-08-11,2021,TB,BOS,8,20,103,1.5,-175,10.5,-115,-105,-113,-1.5,155,5.17,Fenway Park,28,-12
2021-08-11,2021,MIL,CHC,10,0,-260,-1.5,-175,10.0,-105,-115,230,1.5,155,7.22,Wrigley Field,10,10
2021-08-11,2021,ATL,CIN,8,6,-122,-1.5,160,9.5,-110,-110,112,1.5,-180,5.22,Suntrust Park,14,2
2021-08-11,2021,OAK,CLE,6,3,-147,-1.5,105,9.5,100,-120,137,1.5,-125,5.65,Progressive Field,9,3
2021-08-11,2021,HOU,COL,5,1,-250,-1.5,-135,9.0,-105,-115,220,1.5,115,6.43,Minute Maid Park,6,4
2021-08-11,2021,MIN,CWS,1,0,135,1.5,-125,9.5,105,-125,-145,-1.5,105,4.04,Target Field,1,1
2021-08-11,2021,BAL,DET,2,5,100,1.5,-155,10.0,-115,-105,-110,-1.5,135,5.0,Camden Yards,7,-3
2021-08-11,2021,COL,HOU,1,5,220,1.5,115,9.0,-105,-115,-250,-1.5,-135,2.81,Minute Maid Park,6,-4
2021-08-11,2021,NYY,KC,5,2,-134,-1.5,105,10.0,-115,-105,124,1.5,-125,5.73,Kauffman Stadium,7,3
2021-08-11,2021,TOR,LAA,10,2,-182,-1.5,-125,9.5,-105,-115,167,1.5,105,6.13,Angel Stadium,12,8
2021-08-11,2021,PHI,LAD,2,8,142,1.5,-110,10.5,-115,-105,-152,-1.5,-110,4.34,Citizens Bank Park,10,-6
2021-08-11,2021,SD,MIA,0,7,-155,-1.5,125,8.0,-110,-110,145,1.5,-145,4.86,PETCO Park,7,-7
2021-08-11,2021,CHC,MIL,0,10,230,1.5,155,10.0,-105,-115,-260,-1.5,-175,3.03,Wrigley Field,10,-10
2021-08-11,2021,CWS,MIN,0,1,-145,-1.5,105,9.5,105,-125,135,1.5,-125,5.62,Target Field,1,-1
2021-08-11,2021,KC,NYY,2,5,124,1.5,-125,10.0,-115,-105,-134,-1.5,105,4.46,Kauffman Stadium,7,-3
2021-08-11,2021,CLE,OAK,3,6,137,1.5,-125,9.5,100,-120,-147,-1.5,105,4.01,Progressive Field,9,-3
2021-08-11,2021,LAD,PHI,8,2,-152,-1.5,-110,10.5,-115,-105,142,1.5,-110,6.33,Citizens Bank Park,10,6
2021-08-11,2021,STL,PIT,4,0,-163,-1.5,-105,9.0,-105,-115,153,1.5,-115,5.58,PNC Park,4,4
2021-08-11,2021,MIA,SD,7,0,145,1.5,-145,8.0,-110,-110,-155,-1.5,125,3.27,PETCO Park,7,7
2021-08-11,2021,TEX,SEA,1,2,180,1.5,-120,8.0,-120,100,-200,-1.5,100,2.86,T-Mobile Park,3,-1
2021-08-11,2021,ARI,SF,2,7,239,1.5,110,7.5,-110,-110,-269,-1.5,-130,2.21,AT&T Park,9,-5
2021-08-11,2021,PIT,STL,0,4,153,1.5,-115,9.0,-105,-115,-163,-1.5,-105,3.56,PNC Park,4,-4
2021-08-11,2021,BOS,TB,20,8,-113,-1.5,155,10.5,-115,-105,103,1.5,-175,5.57,Fenway Park,28,12
2021-08-11,2021,SEA,TEX,2,1,-200,-1.5,100,8.0,-120,100,180,1.5,-120,5.33,T-Mobile Park,3,1
2021-08-11,2021,LAA,TOR,2,10,167,1.5,105,9.5,-105,-115,-182,-1.5,-125,3.56,Angel Stadium,12,-8
2021-08-12,2021,SD,ARI,3,12,-240,-1.5,-150,9.0,-115,-105,210,1.5,130,6.35,Chase Field,15,-9
2021-08-12,2021,CIN,ATL,12,3,146,1.5,-140,10.0,-115,-105,-156,-1.5,120,4.07,Suntrust Park,15,9
2021-08-12,2021,DET,BAL,6,4,134,1.5,-145,10.5,-105,-115,-144,-1.5,125,4.49,Camden Yards,10,2
2021-08-12,2021,TB,BOS,8,1,108,1.5,-170,11.0,100,-120,-118,-1.5,150,5.29,Fenway Park,9,7
2021-08-12,2021,MIL,CHC,17,4,-215,-1.5,-135,8.5,-115,-105,195,1.5,115,5.8,Wrigley Field,21,13
2021-08-12,2021,ATL,CIN,3,12,-156,-1.5,120,10.0,-115,-105,146,1.5,-140,6.09,Suntrust Park,15,-9
2021-08-12,2021,OAK,CLE,17,0,-168,-1.5,-115,9.5,-105,-115,158,1.5,-105,5.96,Progressive Field,17,17
2021-08-12,2021,SF,COL,7,0,-190,-1.5,110,7.5,-105,-115,175,1.5,-130,4.91,AT&T Park,7,7
2021-08-12,2021,NYY,CWS,8,9,162,1.5,-125,9.5,-125,105,-174,-1.5,105,3.63,Field of Dreams,17,-1
2021-08-12,2021,BAL,DET,4,6,-144,-1.5,125,10.5,-105,-115,134,1.5,-145,6.2,Camden Yards,10,-2
2021-08-12,2021,TOR,LAA,3,6,-133,-1.5,120,8.5,-105,-115,123,1.5,-140,4.85,Angel Stadium,9,-3
2021-08-12,2021,PHI,LAD,2,1,120,1.5,-130,10.0,-115,-105,-130,-1.5,110,4.55,Citizens Bank Park,3,1
2021-08-12,2021,CHC,MIL,4,17,195,1.5,115,8.5,-115,-105,-215,-1.5,-135,2.88,Wrigley Field,21,-13
2021-08-12,2021,WSH,NYM,1,4,200,1.5,-125,6.5,-120,100,-220,-1.5,105,2.17,Citi Field,5,-3
2021-08-12,2021,WSH,NYM,4,5,146,1.5,-155,7.0,-105,-115,-156,-1.5,135,2.85,Citi Field,9,-1
2021-08-12,2021,CWS,NYY,9,8,-174,-1.5,105,9.5,-125,105,162,1.5,-125,6.03,Field of Dreams,17,1
2021-08-12,2021,CLE,OAK,0,17,158,1.5,-105,9.5,-105,-115,-168,-1.5,-115,3.68,Progressive Field,17,-17
2021-08-12,2021,LAD,PHI,1,2,-130,-1.5,110,10.0,-115,-105,120,1.5,-130,5.65,Citizens Bank Park,3,-1
2021-08-12,2021,STL,PIT,7,6,-129,-1.5,120,8.5,-120,100,119,1.5,-140,4.79,PNC Park,13,1
2021-08-12,2021,ARI,SD,12,3,210,1.5,130,9.0,-115,-105,-240,-1.5,-150,2.9,Chase Field,15,9
2021-08-12,2021,TEX,SEA,1,3,195,1.5,-110,8.5,-115,-105,-215,-1.5,-110,2.88,T-Mobile Park,4,-2
2021-08-12,2021,COL,SF,0,7,175,1.5,-130,7.5,-105,-115,-190,-1.5,110,2.73,AT&T Park,7,-7
2021-08-12,2021,PIT,STL,6,7,119,1.5,-140,8.5,-120,100,-129,-1.5,120,3.88,PNC Park,13,-1
2021-08-12,2021,BOS,TB,1,8,-118,-1.5,150,11.0,100,-120,108,1.5,-170,5.95,Fenway Park,9,-7
2021-08-12,2021,SEA,TEX,3,1,-215,-1.5,-110,8.5,-115,-105,195,1.5,-110,5.8,T-Mobile Park,4,2
2021-08-12,2021,LAA,TOR,6,3,123,1.5,-140,8.5,-105,-115,-133,-1.5,120,3.81,Angel Stadium,9,3
2021-08-12,2021,NYM,WSH,4,1,-220,-1.5,105,6.5,-120,100,200,1.5,-125,4.47,Citi Field,5,3
2021-08-12,2021,NYM,WSH,5,4,-156,-1.5,135,7.0,-105,-115,146,1.5,-155,4.27,Citi Field,9,1
2021-08-13,2021,SD,ARI,2,3,-174,-1.5,-110,8.5,-120,100,162,1.5,-110,5.4,Chase Field,5,-1
2021-08-13,2021,WSH,ATL,2,4,154,1.5,-110,9.0,-105,-115,-164,-1.5,-110,3.54,Nationals Park,6,-2
2021-08-13,2021,BOS,BAL,8,1,-245,-1.5,-135,11.0,-105,-115,215,1.5,115,7.81,Fenway Park,9,7
2021-08-13,2021,BAL,BOS,1,8,215,1.5,115,11.0,-105,-115,-245,-1.5,-135,3.49,Fenway Park,9,-7
2021-08-13,2021,MIA,CHC,14,10,-114,-1.5,175,7.5,100,-120,104,1.5,-200,4.0,Marlins Park,24,4
2021-08-13,2021,PHI,CIN,1,6,-159,-1.5,125,8.5,-110,-110,149,1.5,-145,5.22,Citizens Bank Park,7,-5
2021-08-13,2021,DET,CLE,4,7,105,1.5,-155,9.5,100,-120,-115,-1.5,135,4.63,Comerica Park,11,-3
2021-08-13,2021,SF,COL,5,4,-218,-1.5,-110,7.5,-120,100,198,1.5,-110,5.14,AT&T Park,9,1
2021-08-13,2021,CLE,DET,7,4,-115,-1.5,135,9.5,100,-120,105,1.5,-155,5.08,Comerica Park,11,3
2021-08-13,2021,LAA,HOU,1,4,126,1.5,-130,9.0,-105,-115,-136,-1.5,110,3.98,Angel Stadium,5,-3
2021-08-13,2021,STL,KC,6,0,-137,-1.5,115,8.5,-110,-110,127,1.5,-135,4.91,Kauffman Stadium,6,6
2021-08-13,2021,HOU,LAA,4,1,-136,-1.5,110,9.0,-105,-115,126,1.5,-130,5.19,Angel Stadium,5,3
2021-08-13,2021,NYM,LAD,5,6,154,1.5,-115,8.0,-120,100,-164,-1.5,-105,3.15,Citi Field,11,-1
2021-08-13,2021,CHC,MIA,10,14,104,1.5,-200,7.5,100,-120,-114,-1.5,175,3.68,Marlins Park,24,-4
2021-08-13,2021,TB,MIN,10,4,-164,-1.5,-115,9.5,-105,-115,154,1.5,-105,5.9,Target Field,14,6
2021-08-13,2021,LAD,NYM,6,5,-164,-1.5,-105,8.0,-120,100,154,1.5,-115,4.97,Citi Field,11,1
2021-08-13,2021,TEX,OAK,8,6,147,1.5,-115,8.5,-105,-115,-157,-1.5,-105,3.44,Globe Life Field,14,2
2021-08-13,2021,CIN,PHI,6,1,149,1.5,-145,8.5,-110,-110,-159,-1.5,125,3.41,Citizens Bank Park,7,5
2021-08-13,2021,ARI,SD,3,2,162,1.5,-110,8.5,-120,100,-174,-1.5,-110,3.24,Chase Field,5,1
2021-08-13,2021,TOR,SEA,2,3,-158,-1.5,-110,8.5,-125,105,148,1.5,-110,5.21,T-Mobile Park,5,-1
2021-08-13,2021,COL,SF,4,5,198,1.5,-110,7.5,-120,100,-218,-1.5,-110,2.52,AT&T Park,9,-1
2021-08-13,2021,KC,STL,0,6,127,1.5,-135,8.5,-110,-110,-137,-1.5,115,3.74,Kauffman Stadium,6,-6
2021-08-13,2021,MIN,TB,4,10,154,1.5,-105,9.5,-105,-115,-164,-1.5,-115,3.74,Target Field,14,-6
2021-08-13,2021,OAK,TEX,6,8,-157,-1.5,-105,8.5,-105,-115,147,1.5,-115,5.19,Globe Life Field,14,-2
2021-08-13,2021,SEA,TOR,3,2,148,1.5,-110,8.5,-125,105,-158,-1.5,-110,3.43,T-Mobile Park,5,1
2021-08-13,2021,ATL,WSH,4,2,-164,-1.5,-110,9.0,-105,-115,154,1.5,-110,5.59,Nationals Park,6,2
2021-08-14,2021,SD,ARI,0,7,-215,-1.5,-135,9.0,-105,-115,195,1.5,115,6.14,Chase Field,7,-7
2021-08-14,2021,WSH,ATL,2,12,154,1.5,-110,9.0,-115,-105,-164,-1.5,-110,3.54,Nationals Park,14,-10
2021-08-14,2021,BOS,BAL,16,2,-320,-1.5,-170,10.0,-110,-110,280,1.5,150,7.62,Fenway Park,18,14
2021-08-14,2021,BAL,BOS,2,16,280,1.5,150,10.0,-110,-110,-320,-1.5,-170,2.63,Fenway Park,18,-14
2021-08-14,2021,MIA,CHC,5,4,-155,-1.5,125,7.5,-120,100,145,1.5,-145,4.56,Marlins Park,9,1
2021-08-14,2021,PHI,CIN,6,1,116,1.5,-135,9.5,-115,-105,-126,-1.5,115,4.4,Citizens Bank Park,7,5
2021-08-14,2021,DET,CLE,6,4,-127,-1.5,145,10.0,-105,-115,117,1.5,-165,5.59,Comerica Park,10,2
2021-08-14,2021,SF,COL,1,4,-210,-1.5,-105,8.5,-115,-105,190,1.5,-115,5.76,AT&T Park,5,-3
2021-08-14,2021,NYY,CWS,7,5,125,1.5,-160,8.5,-115,-105,-135,-1.5,140,3.78,Guaranteed Rate Field,12,2
2021-08-14,2021,CLE,DET,4,6,117,1.5,-165,10.0,-105,-115,-127,-1.5,145,4.61,Comerica Park,10,-2
2021-08-14,2021,LAA,HOU,2,8,181,1.5,115,9.5,105,-125,-201,-1.5,-135,3.38,Angel Stadium,10,-6
2021-08-14,2021,STL,KC,9,4,105,1.5,-190,10.0,-110,-110,-115,-1.5,170,4.88,Kauffman Stadium,13,5
2021-08-14,2021,HOU,LAA,8,2,-201,-1.5,-135,9.5,105,-125,181,1.5,115,6.34,Angel Stadium,10,6
2021-08-14,2021,NYM,LAD,1,2,174,1.5,105,8.5,-110,-110,-189,-1.5,-125,3.1,Citi Field,3,-1
2021-08-14,2021,CHC,MIA,4,5,145,1.5,-145,7.5,-120,100,-155,-1.5,125,3.06,Marlins Park,9,-1
2021-08-14,2021,PIT,MIL,14,4,177,1.5,-105,7.0,105,-125,-194,-1.5,-115,2.53,PNC Park,18,10
2021-08-14,2021,PIT,MIL,0,6,176,1.5,100,7.5,115,-35,-192,-1.5,-120,2.72,PNC Park,6,-6
2021-08-14,2021,TB,MIN,0,12,-105,-1.5,140,9.5,-120,100,-105,1.5,-160,4.87,Target Field,12,-12
2021-08-14,2021,LAD,NYM,2,1,-189,-1.5,-125,8.5,-110,-110,174,1.5,105,5.56,Citi Field,3,1
2021-08-14,2021,CWS,NYY,5,7,-135,-1.5,140,8.5,-115,-105,125,1.5,-160,4.88,Guaranteed Rate Field,12,-2
2021-08-14,2021,TEX,OAK,3,8,200,1.5,120,9.0,-110,-110,-220,-1.5,-140,3.0,Globe Life Field,11,-5
2021-08-14,2021,CIN,PHI,1,6,-126,-1.5,115,9.5,-115,-105,116,1.5,-135,5.3,Citizens Bank Park,7,-5
2021-08-14,2021,MIL,PIT,4,14,-194,-1.5,-115,7.0,105,-125,177,1.5,-105,4.62,PNC Park,18,-10
2021-08-14,2021,MIL,PIT,6,0,-192,-1.5,-120,7.5,115,-35,176,1.5,100,4.93,PNC Park,6,6
2021-08-14,2021,ARI,SD,7,0,195,1.5,115,9.0,-105,-115,-215,-1.5,-135,3.05,Chase Field,7,7
2021-08-14,2021,TOR,SEA,3,9,-138,-1.5,115,9.0,100,-120,128,1.5,-135,5.22,T-Mobile Park,12,-6
2021-08-14,2021,COL,SF,4,1,190,1.5,-115,8.5,-115,-105,-210,-1.5,-105,2.93,AT&T Park,5,3
2021-08-14,2021,KC,STL,4,9,-115,-1.5,170,10.0,-110,-110,105,1.5,-190,5.35,Kauffman Stadium,13,-5
2021-08-14,2021,MIN,TB,12,0,-105,1.5,-160,9.5,-120,100,-105,-1.5,140,4.87,Target Field,12,12
2021-08-14,2021,OAK,TEX,8,3,-220,-1.5,-140,9.0,-110,-110,200,1.5,120,6.19,Globe Life Field,11,5
2021-08-14,2021,SEA,TOR,9,3,128,1.5,-135,9.0,100,-120,-138,-1.5,115,3.95,T-Mobile Park,12,6
2021-08-14,2021,ATL,WSH,12,2,-164,-1.5,-110,9.0,-115,-105,154,1.5,-110,5.59,Nationals Park,14,10
2021-08-15,2021,SD,ARI,8,2,-165,-1.5,-105,9.0,-125,105,155,1.5,-115,5.6,Chase Field,10,6
2021-08-15,2021,WSH,ATL,5,6,137,1.5,-115,9.5,-110,-110,-147,-1.5,-105,4.01,Nationals Park,11,-1
2021-08-15,2021,BOS,BAL,6,2,-290,-1.5,-160,10.5,-110,-110,250,1.5,140,7.81,Fenway Park,8,4
2021-08-15,2021,BAL,BOS,2,6,250,1.5,140,10.5,-110,-110,-290,-1.5,-160,3.0,Fenway Park,8,-4
2021-08-15,2021,MIA,CHC,4,1,-143,-1.5,145,7.0,-120,100,133,1.5,-165,4.12,Marlins Park,5,3
2021-08-15,2021,PHI,CIN,4,7,-135,-1.5,150,8.0,-115,-105,125,1.5,-170,4.6,Citizens Bank Park,11,-3
2021-08-15,2021,DET,CLE,0,11,123,1.5,-135,9.5,100,-120,-133,-1.5,115,4.26,Comerica Park,11,-11
2021-08-15,2021,SF,COL,5,2,-186,-1.5,110,8.0,100,-120,171,1.5,-130,5.2,AT&T Park,7,3
2021-08-15,2021,NYY,CWS,5,3,163,1.5,-130,8.5,-120,100,-176,-1.5,110,3.23,Guaranteed Rate Field,8,2
2021-08-15,2021,CLE,DET,11,0,-133,-1.5,115,9.5,100,-120,123,1.5,-135,5.42,Comerica Park,11,11
2021-08-15,2021,LAA,HOU,3,1,169,1.5,105,9.0,-115,-105,-184,-1.5,-125,3.35,Angel Stadium,4,2
2021-08-15,2021,STL,KC,7,2,-115,-1.5,130,10.0,-110,-110,105,1.5,-150,5.35,Kauffman Stadium,9,5
2021-08-15,2021,HOU,LAA,1,3,-184,-1.5,-125,9.0,-115,-105,169,1.5,105,5.83,Angel Stadium,4,-2
2021-08-15,2021,NYM,LAD,4,14,169,1.5,-105,8.0,-115,-105,-184,-1.5,-115,2.97,Citi Field,18,-10
2021-08-15,2021,CHC,MIA,1,4,133,1.5,-165,7.0,-120,100,-143,-1.5,145,3.0,Marlins Park,5,-3
2021-08-15,2021,PIT,MIL,1,2,178,1.5,105,9.0,100,-120,-196,-1.5,-125,3.24,PNC Park,3,-1
2021-08-15,2021,TB,MIN,4,5,-151,-1.5,-110,10.5,-110,-110,141,1.5,-110,6.32,Target Field,9,-1
2021-08-15,2021,LAD,NYM,14,4,-184,-1.5,-115,8.0,-115,-105,169,1.5,-105,5.18,Citi Field,18,10
2021-08-15,2021,CWS,NYY,3,5,-176,-1.5,110,8.5,-120,100,163,1.5,-130,5.42,Guaranteed Rate Field,8,-2
2021-08-15,2021,TEX,OAK,7,4,205,1.5,120,8.5,-105,-115,-225,-1.5,-140,2.79,Globe Life Field,11,3
2021-08-15,2021,CIN,PHI,7,4,125,1.5,-170,8.0,-115,-105,-135,-1.5,150,3.56,Citizens Bank Park,11,3
2021-08-15,2021,MIL,PIT,2,1,-196,-1.5,-125,9.0,100,-120,178,1.5,105,5.96,PNC Park,3,1
2021-08-15,2021,ARI,SD,2,8,155,1.5,-115,9.0,-125,105,-165,-1.5,-105,3.53,Chase Field,10,-6
2021-08-15,2021,TOR,SEA,8,3,-107,-1.5,140,8.5,-105,-115,-103,1.5,-160,4.39,T-Mobile Park,11,5
2021-08-15,2021,COL,SF,2,5,171,1.5,-130,8.0,100,-120,-186,-1.5,110,2.95,AT&T Park,7,-3
2021-08-15,2021,KC,STL,2,7,105,1.5,-150,10.0,-110,-110,-115,-1.5,130,4.88,Kauffman Stadium,9,-5
2021-08-15,2021,MIN,TB,5,4,141,1.5,-110,10.5,-110,-110,-151,-1.5,-110,4.36,Target Field,9,1
2021-08-15,2021,OAK,TEX,4,7,-225,-1.5,-140,8.5,-105,-115,205,1.5,120,5.88,Globe Life Field,11,-3
2021-08-15,2021,SEA,TOR,3,8,-103,1.5,-160,8.5,-105,-115,-107,-1.5,140,4.31,T-Mobile Park,11,-5
2021-08-15,2021,ATL,WSH,6,5,-147,-1.5,-105,9.5,-110,-110,137,1.5,-115,5.65,Nationals Park,11,1
2021-08-16,2021,MIA,ATL,2,12,145,1.5,-125,8.5,-110,-110,-155,-1.5,105,3.47,Marlins Park,14,-10
2021-08-16,2021,TB,BAL,9,2,-255,-1.5,-135,8.5,-115,-105,225,1.5,115,6.11,Tropicana Field,11,7
2021-08-16,2021,CIN,CHC,14,5,-201,-1.5,-115,9.5,100,-120,181,1.5,-105,6.34,Great American Ballpark,19,9
2021-08-16,2021,CHC,CIN,5,14,181,1.5,-105,9.5,100,-120,-201,-1.5,-115,3.38,Great American Ballpark,19,-9
2021-08-16,2021,MIN,CLE,5,4,-123,-1.5,150,9.5,-110,-110,113,1.5,-170,5.24,Target Field,9,1
2021-08-16,2021,SD,COL,5,6,-125,-1.5,110,13.0,-110,-110,115,1.5,-130,7.22,Coors Field,11,-1
2021-08-16,2021,OAK,CWS,2,5,-118,-1.5,130,9.0,-115,-105,108,1.5,-150,4.87,Guaranteed Rate Field,7,-3
2021-08-16,2021,KC,HOU,7,6,140,1.5,-115,10.0,-110,-110,-150,-1.5,-105,4.17,Kauffman Stadium,13,1
2021-08-16,2021,HOU,KC,6,7,-150,-1.5,-105,10.0,-110,-110,140,1.5,-115,6.0,Kauffman Stadium,13,-1
2021-08-16,2021,NYY,LAA,2,1,-274,-1.5,-140,8.5,-120,100,244,1.5,120,6.23,Yankee Stadium,3,1
2021-08-16,2021,PIT,LAD,1,2,230,1.5,105,9.0,100,-120,-260,-1.5,-125,2.73,Dodger Stadium,3,-1
2021-08-16,2021,ATL,MIA,12,2,-155,-1.5,105,8.5,-110,-110,145,1.5,-125,5.17,Marlins Park,14,10
2021-08-16,2021,CLE,MIN,4,5,113,1.5,-170,9.5,-110,-110,-123,-1.5,150,4.46,Target Field,9,-1
2021-08-16,2021,SF,NYM,7,5,-223,-1.5,-120,9.0,-105,-115,203,1.5,100,6.21,AT&T Park,12,2
2021-08-16,2021,LAA,NYY,1,2,244,1.5,120,8.5,-120,100,-274,-1.5,-140,2.47,Yankee Stadium,3,-1
2021-08-16,2021,CWS,OAK,5,2,108,1.5,-150,9.0,-115,-105,-118,-1.5,130,4.33,Guaranteed Rate Field,7,3
2021-08-16,2021,LAD,PIT,2,1,-260,-1.5,-125,9.0,100,-120,230,1.5,105,6.5,Dodger Stadium,3,1
2021-08-16,2021,COL,SD,6,5,115,1.5,-130,13.0,-110,-110,-125,-1.5,110,6.05,Coors Field,11,1
2021-08-16,2021,NYM,SF,5,7,203,1.5,100,9.0,-105,-115,-223,-1.5,-120,2.97,AT&T Park,12,-2
2021-08-16,2021,BAL,TB,2,9,225,1.5,115,8.5,-115,-105,-255,-1.5,-135,2.62,Tropicana Field,11,-7
2021-08-17,2021,PHI,ARI,2,3,-146,-1.5,110,9.5,-105,-115,136,1.5,-130,5.64,Chase Field,5,-1
2021-08-17,2021,MIA,ATL,0,2,125,1.5,-155,7.5,-120,100,-135,-1.5,135,3.33,Marlins Park,2,-2
2021-08-17,2021,TB,BAL,10,0,-250,-1.5,-125,8.5,-105,-115,220,1.5,105,6.07,Tropicana Field,10,10
2021-08-17,2021,NYY,BOS,5,3,-112,-1.5,175,7.0,-110,-110,102,1.5,-200,3.7,Yankee Stadium,8,2
2021-08-17,2021,NYY,BOS,2,0,-103,-1.5,200,7.0,-110,-110,-107,1.5,-230,3.55,Yankee Stadium,2,2
2021-08-17,2021,CIN,CHC,1,2,-180,-1.5,100,9.5,-110,-110,165,1.5,-120,6.11,Great American Ballpark,3,-1
2021-08-17,2021,CHC,CIN,2,1,165,1.5,-120,9.5,-110,-110,-180,-1.5,100,3.58,Great American Ballpark,3,1
2021-08-17,2021,MIN,CLE,1,3,-170,-1.5,115,9.5,-105,-115,160,1.5,-135,5.98,Target Field,4,-2
2021-08-17,2021,SD,COL,3,7,-110,1.5,-180,12.5,-105,-115,100,-1.5,160,6.55,Coors Field,10,-4
2021-08-17,2021,OAK,CWS,0,9,-110,-1.5,135,8.5,-125,105,100,1.5,-155,4.45,Guaranteed Rate Field,9,-9
2021-08-17,2021,LAA,DET,8,2,130,1.5,-155,9.0,-120,100,-140,-1.5,135,3.91,Comerica Park,10,6
2021-08-17,2021,KC,HOU,3,1,160,1.5,105,9.5,-115,-105,-170,-1.5,-125,3.65,Kauffman Stadium,4,2
2021-08-17,2021,HOU,KC,1,3,-170,-1.5,-125,9.5,-115,-105,160,1.5,105,5.98,Kauffman Stadium,4,-2
2021-08-17,2021,DET,LAA,2,8,-140,-1.5,135,9.0,-120,100,130,1.5,-155,5.25,Comerica Park,10,-6
2021-08-17,2021,PIT,LAD,3,4,280,1.5,145,9.0,-105,-115,-320,-1.5,-165,2.37,Dodger Stadium,7,-1
2021-08-17,2021,ATL,MIA,2,0,-135,-1.5,135,7.5,-120,100,125,1.5,-155,4.31,Marlins Park,2,2
2021-08-17,2021,STL,MIL,0,2,148,1.5,-130,7.0,-110,-110,-158,-1.5,110,2.82,Busch Stadium,2,-2
2021-08-17,2021,CLE,MIN,3,1,160,1.5,-135,9.5,-105,-115,-170,-1.5,115,3.65,Target Field,4,2
2021-08-17,2021,SF,NYM,3,2,-147,-1.5,135,8.0,-115,-105,137,1.5,-155,4.76,AT&T Park,5,1
2021-08-17,2021,BOS,NYY,3,5,102,1.5,-200,7.0,-110,-110,-112,-1.5,175,3.47,Yankee Stadium,8,-2
2021-08-17,2021,BOS,NYY,0,2,-107,1.5,-230,7.0,-110,-110,-103,-1.5,200,3.62,Yankee Stadium,2,-2
2021-08-17,2021,CWS,OAK,9,0,100,1.5,-155,8.5,-125,105,-110,-1.5,135,4.25,Guaranteed Rate Field,9,9
2021-08-17,2021,ARI,PHI,3,2,136,1.5,-130,9.5,-105,-115,-146,-1.5,110,4.03,Chase Field,5,1
2021-08-17,2021,LAD,PIT,4,3,-320,-1.5,-165,9.0,-105,-115,280,1.5,145,6.86,Dodger Stadium,7,1
2021-08-17,2021,COL,SD,7,3,100,-1.5,160,12.5,-105,-115,-110,1.5,-180,6.25,Coors Field,10,4
2021-08-17,2021,TEX,SEA,1,3,120,1.5,-135,8.5,-115,-105,-130,-1.5,115,3.86,Globe Life Field,4,-2
2021-08-17,2021,NYM,SF,2,3,137,1.5,-155,8.0,-115,-105,-147,-1.5,135,3.38,AT&T Park,5,-1
2021-08-17,2021,MIL,STL,2,0,-158,-1.5,110,7.0,-110,-110,148,1.5,-130,4.29,Busch Stadium,2,2
2021-08-17,2021,BAL,TB,0,10,220,1.5,105,8.5,-105,-115,-250,-1.5,-125,2.66,Tropicana Field,10,-10
2021-08-17,2021,SEA,TEX,3,1,-130,-1.5,115,8.5,-115,-105,120,1.5,-135,4.8,Globe Life Field,4,2
2021-08-17,2021,WSH,TOR,12,6,178,1.5,110,9.0,-120,100,-196,-1.5,-130,3.24,Nationals Park,18,6
2021-08-17,2021,TOR,WSH,6,12,-196,-1.5,-130,9.0,-120,100,178,1.5,110,5.96,Nationals Park,18,-6
2021-08-18,2021,PHI,ARI,2,4,-169,-1.5,-110,9.5,100,-120,159,1.5,-110,5.97,Chase Field,6,-2
2021-08-18,2021,MIA,ATL,9,11,200,1.5,110,7.5,-120,100,-220,-1.5,-130,2.5,Marlins Park,20,-2
2021-08-18,2021,TB,BAL,8,4,-320,-1.5,-160,9.0,-110,-110,280,1.5,140,6.86,Tropicana Field,12,4
2021-08-18,2021,NYY,BOS,5,2,-114,-1.5,155,10.0,-110,-110,104,1.5,-175,5.33,Yankee Stadium,7,3
2021-08-18,2021,CIN,CHC,1,7,-320,-1.5,-185,9.5,-115,-105,280,1.5,165,7.24,Great American Ballpark,8,-6
2021-08-18,2021,CHC,CIN,7,1,280,1.5,165,9.5,-115,-105,-320,-1.5,-185,2.5,Great American Ballpark,8,6
2021-08-18,2021,MIN,CLE,8,7,-112,1.5,-165,9.5,-105,-115,102,-1.5,145,5.02,Target Field,15,1
2021-08-18,2021,SD,COL,5,7,-147,-1.5,-105,14.0,-120,100,137,1.5,-115,8.33,Coors Field,12,-2
2021-08-18,2021,OAK,CWS,2,3,179,1.5,-110,9.0,-105,-115,-198,-1.5,-110,3.23,Guaranteed Rate Field,5,-1
2021-08-18,2021,LAA,DET,3,1,-125,-1.5,125,8.5,100,-120,115,1.5,-145,4.72,Comerica Park,4,2
2021-08-18,2021,KC,HOU,3,2,162,1.5,100,9.5,105,-125,-174,-1.5,-120,3.63,Kauffman Stadium,5,1
2021-08-18,2021,HOU,KC,2,3,-174,-1.5,-120,9.5,105,-125,162,1.5,100,6.03,Kauffman Stadium,5,-1
2021-08-18,2021,DET,LAA,1,3,115,1.5,-145,8.5,100,-120,-125,-1.5,125,3.95,Comerica Park,4,-2
2021-08-18,2021,PIT,LAD,0,9,262,1.5,135,8.5,-120,100,-302,-1.5,-155,2.35,Dodger Stadium,9,-9
2021-08-18,2021,ATL,MIA,11,9,-220,-1.5,-130,7.5,-120,100,200,1.5,110,5.16,Marlins Park,20,2
2021-08-18,2021,STL,MIL,4,6,111,1.5,-160,7.0,-105,-115,-121,-1.5,140,3.32,Busch Stadium,10,-2
2021-08-18,2021,CLE,MIN,7,8,102,-1.5,145,9.5,-105,-115,-112,1.5,-165,4.7,Target Field,15,-1
2021-08-18,2021,SF,NYM,2,6,-138,-1.5,140,9.0,-105,-115,128,1.5,-160,5.22,AT&T Park,8,-4
2021-08-18,2021,BOS,NYY,2,5,104,1.5,-175,10.0,-110,-110,-114,-1.5,155,4.9,Yankee Stadium,7,-3
2021-08-18,2021,CWS,OAK,3,2,-198,-1.5,-110,9.0,-105,-115,179,1.5,-110,5.98,Guaranteed Rate Field,5,1
2021-08-18,2021,ARI,PHI,4,2,159,1.5,-110,9.5,100,-120,-169,-1.5,-110,3.67,Chase Field,6,2
2021-08-18,2021,LAD,PIT,9,0,-302,-1.5,-155,8.5,-120,100,262,1.5,135,6.39,Dodger Stadium,9,9
2021-08-18,2021,COL,SD,7,5,137,1.5,-115,14.0,-120,100,-147,-1.5,-105,5.91,Coors Field,12,2
2021-08-18,2021,TEX,SEA,1,3,146,1.5,-120,8.5,-115,-105,-156,-1.5,100,3.46,Globe Life Field,4,-2
2021-08-18,2021,NYM,SF,6,2,128,1.5,-160,9.0,-105,-115,-138,-1.5,140,3.95,AT&T Park,8,4
2021-08-18,2021,MIL,STL,6,4,-121,-1.5,140,7.0,-105,-115,111,1.5,-160,3.83,Busch Stadium,10,2
2021-08-18,2021,BAL,TB,4,8,280,1.5,140,9.0,-110,-110,-320,-1.5,-160,2.37,Tropicana Field,12,-4
2021-08-18,2021,SEA,TEX,3,1,-156,-1.5,100,8.5,-115,-105,146,1.5,-120,5.18,Globe Life Field,4,2
2021-08-18,2021,WSH,TOR,8,5,150,1.5,-115,9.0,-110,-110,-160,-1.5,-105,3.6,Nationals Park,13,3
2021-08-18,2021,TOR,WSH,5,8,-160,-1.5,-105,9.0,-110,-110,150,1.5,-115,5.54,Nationals Park,13,-3
2021-08-19,2021,PHI,ARI,2,6,-196,-1.5,-120,8.0,-110,-110,178,1.5,100,5.3,Chase Field,8,-4
2021-08-19,2021,TB,BAL,7,2,-360,-1.5,-180,9.0,-105,-115,310,1.5,160,7.04,Tropicana Field,9,5
2021-08-19,2021,MIA,CIN,1,6,250,1.5,130,9.0,-115,-105,-290,-1.5,-150,2.57,Great American Ballpark,7,-5
2021-08-19,2021,OAK,CWS,5,4,140,1.5,-145,9.0,-105,-115,-150,-1.5,125,3.75,Guaranteed Rate Field,9,1
2021-08-19,2021,LAA,DET,13,10,-109,-1.5,135,9.5,-105,-115,-101,1.5,-155,4.95,Comerica Park,23,3
2021-08-19,2021,KC,HOU,3,6,155,1.5,-105,9.0,-110,-110,-165,-1.5,-115,3.53,Kauffman Stadium,9,-3
2021-08-19,2021,HOU,KC,6,3,-165,-1.5,-115,9.0,-110,-110,155,1.5,-105,5.6,Kauffman Stadium,9,3
2021-08-19,2021,DET,LAA,10,13,-101,1.5,-155,9.5,-105,-115,-109,-1.5,135,4.77,Comerica Park,23,-3
2021-08-19,2021,NYM,LAD,1,4,178,1.5,-110,9.0,-115,-105,-196,-1.5,-110,3.24,Dodger Stadium,5,-3
2021-08-19,2021,CIN,MIA,6,1,-290,-1.5,-150,9.0,-115,-105,250,1.5,130,6.69,Great American Ballpark,7,5
2021-08-19,2021,STL,MIL,8,4,175,1.5,105,8.0,-110,-110,-190,-1.5,-125,2.91,Busch Stadium,12,4
2021-08-19,2021,NYY,MIN,7,5,-240,-1.5,-140,10.5,-105,-115,210,1.5,120,7.41,Yankee Stadium,12,2
2021-08-19,2021,LAD,NYM,4,1,-196,-1.5,-110,9.0,-115,-105,178,1.5,-110,5.96,Dodger Stadium,5,3
2021-08-19,2021,MIN,NYY,5,7,210,1.5,120,10.5,-105,-115,-240,-1.5,-140,3.39,Yankee Stadium,12,-2
2021-08-19,2021,CWS,OAK,4,5,-150,-1.5,125,9.0,-105,-115,140,1.5,-145,5.4,Guaranteed Rate Field,9,-1
2021-08-19,2021,ARI,PHI,6,2,178,1.5,100,8.0,-110,-110,-196,-1.5,-120,2.88,Chase Field,8,4
2021-08-19,2021,TEX,SEA,8,9,124,1.5,-135,8.5,-120,100,-134,-1.5,115,3.79,Globe Life Field,17,-1
2021-08-19,2021,MIL,STL,4,8,-190,-1.5,-125,8.0,-110,-110,175,1.5,105,5.24,Busch Stadium,12,-4
2021-08-19,2021,BAL,TB,2,7,310,1.5,160,9.0,-105,-115,-360,-1.5,-180,2.2,Tropicana Field,9,-5
2021-08-19,2021,SEA,TEX,9,8,-134,-1.5,115,8.5,-120,100,124,1.5,-135,4.87,Globe Life Field,17,1
2021-08-20,2021,COL,ARI,9,4,-192,-1.5,-115,11.5,100,-120,176,1.5,-105,7.56,Coors Field,13,5
2021-08-20,2021,BAL,ATL,0,3,212,1.5,140,10.0,-110,-110,-242,-1.5,-160,3.21,Camden Yards,3,-3
2021-08-20,2021,ATL,BAL,3,0,-242,-1.5,-160,10.0,-110,-110,212,1.5,140,7.08,Camden Yards,3,3
2021-08-20,2021,TEX,BOS,0,6,260,1.5,130,9.0,100,-120,-300,-1.5,-150,2.5,Fenway Park,6,-6
2021-08-20,2021,KC,CHC,6,2,-102,-1.5,150,8.5,-115,-105,-108,1.5,-170,4.29,Wrigley Field,8,4
2021-08-20,2021,MIA,CIN,3,5,168,1.5,-135,8.5,-120,100,-183,-1.5,115,3.17,Great American Ballpark,8,-2
2021-08-20,2021,LAA,CLE,1,9,111,1.5,-170,9.5,-115,-105,-121,-1.5,150,4.5,Progressive Field,10,-8
2021-08-20,2021,ARI,COL,4,9,176,1.5,-105,11.5,100,-120,-192,-1.5,-115,4.17,Coors Field,13,-5
2021-08-20,2021,TB,CWS,5,7,-102,1.5,-165,8.5,-120,100,-108,-1.5,145,4.29,Tropicana Field,12,-2
2021-08-20,2021,TOR,DET,1,4,-264,-1.5,-145,9.5,-115,-105,234,1.5,125,6.89,Rogers Centre,5,-3
2021-08-20,2021,SEA,HOU,3,12,164,1.5,-130,8.5,-105,-115,-178,-1.5,110,3.22,Minute Maid Park,15,-9
2021-08-20,2021,CHC,KC,2,6,-108,1.5,-170,8.5,-115,-105,-102,-1.5,150,4.41,Wrigley Field,8,-4
2021-08-20,2021,CLE,LAA,9,1,-121,-1.5,150,9.5,-115,-105,111,1.5,-170,5.2,Progressive Field,10,8
2021-08-20,2021,NYM,LAD,2,3,210,1.5,100,8.0,-120,100,-240,-1.5,-120,2.58,Dodger Stadium,5,-1
2021-08-20,2021,CIN,MIA,5,3,-183,-1.5,115,8.5,-120,100,168,1.5,-135,5.5,Great American Ballpark,8,2
2021-08-20,2021,WSH,MIL,4,1,173,1.5,-125,9.0,-110,-110,-188,-1.5,105,3.3,Miller Park,5,3
2021-08-20,2021,NYY,MIN,10,2,-230,-1.5,-130,10.5,-105,-115,205,1.5,110,7.32,Yankee Stadium,12,8
2021-08-20,2021,LAD,NYM,3,2,-240,-1.5,-120,8.0,-120,100,210,1.5,100,5.65,Dodger Stadium,5,1
2021-08-20,2021,MIN,NYY,2,10,205,1.5,110,10.5,-105,-115,-230,-1.5,-130,3.44,Yankee Stadium,12,-8
2021-08-20,2021,SF,OAK,1,4,-107,-1.5,145,9.0,-105,-115,-103,1.5,-165,4.65,Oakland Coliseum,5,-3
2021-08-20,2021,SD,PHI,3,4,-202,-1.5,-105,9.0,100,-120,182,1.5,-115,6.02,PETCO Park,7,-1
2021-08-20,2021,STL,PIT,0,4,-210,-1.5,-115,8.5,-120,100,190,1.5,-105,5.76,Busch Stadium,4,-4
2021-08-20,2021,PHI,SD,4,3,182,1.5,-115,9.0,100,-120,-202,-1.5,-105,3.19,PETCO Park,7,1
2021-08-20,2021,HOU,SEA,12,3,-178,-1.5,110,8.5,-105,-115,164,1.5,-130,5.44,Minute Maid Park,15,9
2021-08-20,2021,OAK,SF,4,1,-103,1.5,-165,9.0,-105,-115,-107,-1.5,145,4.57,Oakland Coliseum,5,3
2021-08-20,2021,PIT,STL,4,0,190,1.5,-105,8.5,-120,100,-210,-1.5,-115,2.93,Busch Stadium,4,4
2021-08-20,2021,CWS,TB,7,5,-108,-1.5,145,8.5,-120,100,-102,1.5,-165,4.41,Tropicana Field,12,2
2021-08-20,2021,BOS,TEX,6,0,-300,-1.5,-150,9.0,100,-120,260,1.5,130,6.75,Fenway Park,6,6
2021-08-20,2021,DET,TOR,4,1,234,1.5,125,9.5,-115,-105,-264,-1.5,-145,2.84,Rogers Centre,5,3
2021-08-20,2021,MIL,WSH,1,4,-188,-1.5,105,9.0,-110,-110,173,1.5,-125,5.88,Miller Park,5,-3
2021-08-21,2021,COL,ARI,5,2,-146,-1.5,115,11.5,100,-120,136,1.5,-135,6.83,Coors Field,7,3
2021-08-21,2021,BAL,ATL,4,5,157,1.5,100,10.5,-120,100,-167,-1.5,-120,4.09,Camden Yards,9,-1
2021-08-21,2021,ATL,BAL,5,4,-167,-1.5,-120,10.5,-120,100,157,1.5,100,6.57,Camden Yards,9,1
2021-08-21,2021,TEX,BOS,10,1,290,1.5,155,9.5,-115,-105,-340,-1.5,-175,2.44,Fenway Park,11,9
2021-08-21,2021,KC,CHC,4,2,116,1.5,-170,9.5,-115,-105,-126,-1.5,150,4.4,Wrigley Field,6,2
2021-08-21,2021,MIA,CIN,4,7,178,1.5,-110,9.0,-120,100,-196,-1.5,-110,3.24,Great American Ballpark,11,-3
2021-08-21,2021,LAA,CLE,1,5,118,1.5,-160,9.0,100,-120,-128,-1.5,140,4.13,Progressive Field,6,-4
2021-08-21,2021,ARI,COL,2,5,136,1.5,-135,11.5,100,-120,-146,-1.5,115,4.87,Coors Field,7,-3
2021-08-21,2021,TB,CWS,8,4,-147,-1.5,130,9.0,-115,-105,137,1.5,-150,5.36,Tropicana Field,12,4
2021-08-21,2021,TOR,DET,3,0,-245,-1.5,-145,9.5,-105,-115,215,1.5,125,6.75,Rogers Centre,3,3
2021-08-21,2021,SEA,HOU,1,15,132,1.5,-155,9.0,100,-120,-142,-1.5,135,3.88,Minute Maid Park,16,-14
2021-08-21,2021,CHC,KC,2,4,-126,-1.5,150,9.5,-115,-105,116,1.5,-170,5.3,Wrigley Field,6,-2
2021-08-21,2021,CLE,LAA,5,1,-128,-1.5,140,9.0,100,-120,118,1.5,-160,5.05,Progressive Field,6,4
2021-08-21,2021,NYM,LAD,3,4,230,1.5,120,8.5,-120,100,-260,-1.5,-140,2.58,Dodger Stadium,7,-1
2021-08-21,2021,CIN,MIA,7,4,-196,-1.5,-110,9.0,-120,100,178,1.5,-110,5.96,Great American Ballpark,11,3
2021-08-21,2021,WSH,MIL,6,9,205,1.5,-110,9.0,-115,-105,-230,-1.5,-110,2.95,Miller Park,15,-3
2021-08-21,2021,NYY,MIN,7,1,-240,-1.5,-125,8.0,105,-125,210,1.5,105,5.65,Yankee Stadium,8,6
2021-08-21,2021,LAD,NYM,4,3,-260,-1.5,-140,8.5,-120,100,230,1.5,120,6.14,Dodger Stadium,7,1
2021-08-21,2021,MIN,NYY,1,7,210,1.5,105,8.0,105,-125,-240,-1.5,-125,2.58,Yankee Stadium,8,-6
2021-08-21,2021,SF,OAK,6,5,-110,-1.5,145,8.0,-120,100,100,1.5,-165,4.19,Oakland Coliseum,11,1
2021-08-21,2021,SD,PHI,4,3,-151,-1.5,130,7.5,-120,100,141,1.5,-150,4.51,PETCO Park,7,1
2021-08-21,2021,STL,PIT,4,5,-200,-1.5,-105,9.0,-105,-115,180,1.5,-115,6.0,Busch Stadium,9,-1
2021-08-21,2021,PHI,SD,3,4,141,1.5,-150,7.5,-120,100,-151,-1.5,130,3.11,PETCO Park,7,-1
2021-08-21,2021,HOU,SEA,15,1,-142,-1.5,135,9.0,100,-120,132,1.5,-155,5.28,Minute Maid Park,16,14
2021-08-21,2021,OAK,SF,5,6,100,1.5,-165,8.0,-120,100,-110,-1.5,145,4.0,Oakland Coliseum,11,-1
2021-08-21,2021,PIT,STL,5,4,180,1.5,-115,9.0,-105,-115,-200,-1.5,-105,3.21,Busch Stadium,9,1
2021-08-21,2021,CWS,TB,4,8,137,1.5,-150,9.0,-115,-105,-147,-1.5,130,3.8,Tropicana Field,12,-4
2021-08-21,2021,BOS,TEX,1,10,-340,-1.5,-175,9.5,-115,-105,290,1.5,155,7.34,Fenway Park,11,-9
2021-08-21,2021,DET,TOR,0,3,215,1.5,125,9.5,-105,-115,-245,-1.5,-145,3.02,Rogers Centre,3,-3
2021-08-21,2021,MIL,WSH,9,6,-230,-1.5,-110,9.0,-115,-105,205,1.5,-110,6.27,Miller Park,15,3
2021-08-22,2021,COL,ARI,4,8,-178,-1.5,-105,11.5,-110,-110,164,1.5,-115,7.36,Coors Field,12,-4
2021-08-22,2021,BAL,ATL,1,3,150,1.5,-110,9.5,-110,-110,-160,-1.5,-110,3.8,Camden Yards,4,-2
2021-08-22,2021,ATL,BAL,3,1,-160,-1.5,-110,9.5,-110,-110,150,1.5,-110,5.85,Camden Yards,4,2
2021-08-22,2021,KC,CHC,9,1,103,1.5,-200,8.0,-110,-110,-113,-1.5,175,3.94,Wrigley Field,10,8
2021-08-22,2021,MIA,CIN,1,3,120,1.5,-165,8.5,-110,-110,-130,-1.5,145,3.86,Great American Ballpark,4,-2
2021-08-22,2021,LAA,CLE,0,3,108,1.5,-180,9.0,-115,-105,-118,-1.5,160,4.33,BB&T Ballpark at Bowman Field,3,-3
2021-08-22,2021,ARI,COL,8,4,164,1.5,-115,11.5,-110,-110,-178,-1.5,-105,4.36,Coors Field,12,4
2021-08-22,2021,TB,CWS,9,0,-120,-1.5,155,9.0,100,-120,110,1.5,-175,4.91,Tropicana Field,9,9
2021-08-22,2021,TOR,DET,3,5,-270,-1.5,-150,10.0,-110,-110,240,1.5,130,7.3,Rogers Centre,8,-2
2021-08-22,2021,SEA,HOU,6,3,178,1.5,-115,9.0,100,-120,-196,-1.5,-105,3.24,Minute Maid Park,9,3
2021-08-22,2021,CHC,KC,1,9,-113,-1.5,175,8.0,-110,-110,103,1.5,-200,4.24,Wrigley Field,10,-8
2021-08-22,2021,CLE,LAA,3,0,-118,-1.5,160,9.0,-115,-105,108,1.5,-180,4.87,BB&T Ballpark at Bowman Field,3,3
2021-08-22,2021,NYM,LAD,7,2,162,1.5,-130,8.5,-110,-110,-174,-1.5,110,3.24,Dodger Stadium,9,5
2021-08-22,2021,CIN,MIA,3,1,-130,-1.5,145,8.5,-110,-110,120,1.5,-165,4.8,Great American Ballpark,4,2
2021-08-22,2021,WSH,MIL,3,7,200,1.5,-105,9.0,-115,-105,-220,-1.5,-115,3.0,Miller Park,10,-4
2021-08-22,2021,LAD,NYM,2,7,-174,-1.5,110,8.5,-110,-110,162,1.5,-130,5.4,Dodger Stadium,9,-5
2021-08-22,2021,SF,OAK,2,1,-114,-1.5,145,8.0,-120,100,104,1.5,-165,4.26,Oakland Coliseum,3,1
2021-08-22,2021,SD,PHI,4,7,-153,-1.5,130,9.0,100,-120,143,1.5,-150,5.44,PETCO Park,11,-3
2021-08-22,2021,STL,PIT,3,0,-240,-1.5,-125,8.5,-110,-110,210,1.5,105,6.0,Busch Stadium,3,3
2021-08-22,2021,PHI,SD,7,4,143,1.5,-150,9.0,100,-120,-153,-1.5,130,3.7,PETCO Park,11,3
2021-08-22,2021,HOU,SEA,3,6,-196,-1.5,-105,9.0,100,-120,178,1.5,-115,5.96,Minute Maid Park,9,-3
2021-08-22,2021,OAK,SF,1,2,104,1.5,-165,8.0,-120,100,-114,-1.5,145,3.92,Oakland Coliseum,3,-1
2021-08-22,2021,PIT,STL,0,3,210,1.5,105,8.5,-110,-110,-240,-1.5,-125,2.74,Busch Stadium,3,-3
2021-08-22,2021,CWS,TB,0,9,110,1.5,-175,9.0,100,-120,-120,-1.5,155,4.29,Tropicana Field,9,-9
2021-08-22,2021,DET,TOR,5,3,240,1.5,130,10.0,-110,-110,-270,-1.5,-150,2.94,Rogers Centre,8,2
2021-08-22,2021,MIL,WSH,7,3,-220,-1.5,-115,9.0,-115,-105,200,1.5,-105,6.19,Miller Park,10,4
2021-08-23,2021,PIT,ARI,6,5,-116,-1.5,160,9.5,-110,-110,106,1.5,-180,5.1,PNC Park,11,1
2021-08-23,2021,NYY,ATL,5,1,-105,1.5,-210,9.0,-120,100,-105,-1.5,185,4.61,Suntrust Park,6,4
2021-08-23,2021,TEX,BOS,4,8,250,1.5,130,9.5,-115,-105,-290,-1.5,-150,2.71,Fenway Park,12,-4
2021-08-23,2021,COL,CHC,4,6,114,1.5,-180,8.5,-115,-105,-124,-1.5,160,3.97,Wrigley Field,10,-2
2021-08-23,2021,CHC,COL,6,4,-124,-1.5,160,8.5,-115,-105,114,1.5,-180,4.71,Wrigley Field,10,2
2021-08-23,2021,TOR,CWS,2,1,-114,-1.5,160,8.5,-120,100,104,1.5,-180,4.53,Rogers Centre,3,1
2021-08-23,2021,KC,HOU,7,1,220,1.5,110,9.0,-105,-115,-250,-1.5,-130,2.81,Minute Maid Park,8,6
2021-08-23,2021,HOU,KC,1,7,-250,-1.5,-130,9.0,-105,-115,220,1.5,110,6.43,Minute Maid Park,8,-6
2021-08-23,2021,ATL,NYY,1,5,-105,-1.5,185,9.0,-120,100,-105,1.5,-210,4.61,Suntrust Park,6,-4
2021-08-23,2021,SEA,OAK,5,3,124,1.5,-170,8.5,-115,-105,-134,-1.5,150,3.79,Oakland Coliseum,8,2
2021-08-23,2021,ARI,PIT,5,6,106,1.5,-180,9.5,-110,-110,-116,-1.5,160,4.61,PNC Park,11,-1
2021-08-23,2021,OAK,SEA,3,5,-134,-1.5,150,8.5,-115,-105,124,1.5,-170,4.87,Oakland Coliseum,8,-2
2021-08-23,2021,BOS,TEX,8,4,-290,-1.5,-150,9.5,-115,-105,250,1.5,130,7.06,Fenway Park,12,4
2021-08-23,2021,CWS,TOR,1,2,104,1.5,-180,8.5,-120,100,-114,-1.5,160,4.17,Rogers Centre,3,-1
2021-08-24,2021,PIT,ARI,4,2,104,1.5,-160,9.0,-105,-115,-114,-1.5,140,4.41,PNC Park,6,2
2021-08-24,2021,NYY,ATL,5,4,125,1.5,-155,9.0,-120,100,-135,-1.5,135,4.0,Suntrust Park,9,1
2021-08-24,2021,LAA,BAL,14,8,-126,-1.5,115,10.0,-120,100,116,1.5,-135,5.58,Camden Yards,22,6
2021-08-24,2021,MIN,BOS,9,11,196,1.5,105,10.5,-115,-105,-216,-1.5,-125,3.55,Fenway Park,20,-2
2021-08-24,2021,MIL,CIN,7,4,-198,-1.5,105,7.5,-105,-115,179,1.5,-125,4.98,Miller Park,11,3
2021-08-24,2021,TEX,CLE,7,3,155,1.5,-135,9.0,-120,100,-165,-1.5,115,3.53,Progressive Field,10,4
2021-08-24,2021,TOR,CWS,2,5,-127,-1.5,150,9.0,-105,-115,117,1.5,-170,5.04,Rogers Centre,7,-3
2021-08-24,2021,STL,DET,3,4,-222,-1.5,-105,8.0,-105,-115,202,1.5,-115,5.52,Busch Stadium,7,-1
2021-08-24,2021,KC,HOU,0,4,218,1.5,105,8.5,-120,100,-248,-1.5,-125,2.67,Minute Maid Park,4,-4
2021-08-24,2021,HOU,KC,4,0,-248,-1.5,-125,8.5,-120,100,218,1.5,105,6.06,Minute Maid Park,4,4
2021-08-24,2021,BAL,LAA,8,14,116,1.5,-135,10.0,-120,100,-126,-1.5,115,4.63,Camden Yards,22,-6
2021-08-24,2021,SD,LAD,2,5,129,1.5,-130,8.5,-120,100,-139,-1.5,110,3.71,PETCO Park,7,-3
2021-08-24,2021,WSH,MIA,5,1,101,1.5,-210,8.5,-105,-115,-111,-1.5,185,4.23,Marlins Park,6,4
2021-08-24,2021,CIN,MIL,4,7,179,1.5,-125,7.5,-105,-115,-198,-1.5,105,2.69,Miller Park,11,-3
2021-08-24,2021,BOS,MIN,11,9,-216,-1.5,-125,10.5,-115,-105,196,1.5,105,7.18,Fenway Park,20,2
2021-08-24,2021,SF,NYM,8,0,109,1.5,-185,8.5,-115,-105,-119,-1.5,165,4.07,Citi Field,8,8
2021-08-24,2021,ATL,NYY,4,5,-135,-1.5,135,9.0,-120,100,125,1.5,-155,5.17,Suntrust Park,9,-1
2021-08-24,2021,SEA,OAK,5,1,142,1.5,-150,9.0,100,-120,-152,-1.5,130,3.72,Oakland Coliseum,6,4
2021-08-24,2021,TB,PHI,3,1,-113,-1.5,145,9.0,-110,-110,103,1.5,-165,4.77,Citizens Bank Park,4,2
2021-08-24,2021,ARI,PIT,2,4,-114,-1.5,140,9.0,-105,-115,104,1.5,-160,4.79,PNC Park,6,-2
2021-08-24,2021,LAD,SD,5,2,-139,-1.5,110,8.5,-120,100,129,1.5,-130,4.94,PETCO Park,7,3
2021-08-24,2021,OAK,SEA,1,5,-152,-1.5,130,9.0,100,-120,142,1.5,-150,5.43,Oakland Coliseum,6,-4
2021-08-24,2021,NYM,SF,0,8,-119,-1.5,165,8.5,-115,-105,109,1.5,-185,4.62,Citi Field,8,-8
2021-08-24,2021,DET,STL,4,3,202,1.5,-115,8.0,-105,-115,-222,-1.5,-105,2.65,Busch Stadium,7,1
2021-08-24,2021,PHI,TB,1,3,103,1.5,-165,9.0,-110,-110,-113,-1.5,145,4.43,Citizens Bank Park,4,-2
2021-08-24,2021,CLE,TEX,3,7,-165,-1.5,115,9.0,-120,100,155,1.5,-135,5.6,Progressive Field,10,-4
2021-08-24,2021,CWS,TOR,5,2,117,1.5,-170,9.0,-105,-115,-127,-1.5,150,4.15,Rogers Centre,7,3
2021-08-24,2021,MIA,WSH,1,5,-111,-1.5,185,8.5,-105,-115,101,1.5,-210,4.47,Marlins Park,6,-4
2021-08-25,2021,PIT,ARI,2,5,103,1.5,-155,9.0,100,-120,-113,-1.5,135,4.43,PNC Park,7,-3
2021-08-25,2021,LAA,BAL,6,10,-207,-1.5,-145,9.0,-115,-105,187,1.5,125,6.07,Camden Yards,16,-4
2021-08-25,2021,MIN,BOS,9,6,143,1.5,-125,10.5,-110,-110,-153,-1.5,105,4.32,Fenway Park,15,3
2021-08-25,2021,COL,CHC,2,5,-134,-1.5,135,7.0,-110,-110,124,1.5,-155,4.01,Wrigley Field,7,-3
2021-08-25,2021,COL,CHC,13,10,-142,-1.5,135,7.0,115,-35,132,1.5,-155,4.11,Wrigley Field,23,3
2021-08-25,2021,MIL,CIN,4,1,-155,-1.5,140,7.5,-110,-110,145,1.5,-160,4.56,Miller Park,5,3
2021-08-25,2021,TEX,CLE,2,7,177,1.5,-120,9.0,-110,-110,-194,-1.5,100,3.25,Progressive Field,9,-5
2021-08-25,2021,CHC,COL,5,2,124,1.5,-155,7.0,-110,-110,-134,-1.5,135,3.13,Wrigley Field,7,3
2021-08-25,2021,CHC,COL,10,13,132,1.5,-155,7.0,115,-35,-142,-1.5,135,3.02,Wrigley Field,23,-3
2021-08-25,2021,TOR,CWS,3,1,-119,-1.5,160,8.5,100,-120,109,1.5,-180,4.62,Rogers Centre,4,2
2021-08-25,2021,STL,DET,3,2,-120,-1.5,155,9.0,-120,100,110,1.5,-175,4.91,Busch Stadium,5,1
2021-08-25,2021,KC,HOU,5,6,230,1.5,110,8.0,-115,-105,-260,-1.5,-130,2.42,Minute Maid Park,11,-1
2021-08-25,2021,HOU,KC,6,5,-260,-1.5,-130,8.0,-115,-105,230,1.5,110,5.78,Minute Maid Park,11,1
2021-08-25,2021,BAL,LAA,10,6,187,1.5,125,9.0,-115,-105,-207,-1.5,-145,3.14,Camden Yards,16,4
2021-08-25,2021,SD,LAD,3,5,126,1.5,-140,8.0,-115,-105,-136,-1.5,120,3.54,PETCO Park,8,-2
2021-08-25,2021,WSH,MIA,3,4,-105,-1.5,155,8.0,-105,-115,-105,1.5,-175,4.1,Marlins Park,7,-1
2021-08-25,2021,CIN,MIL,1,4,145,1.5,-160,7.5,-110,-110,-155,-1.5,140,3.06,Miller Park,5,-3
2021-08-25,2021,BOS,MIN,6,9,-153,-1.5,105,10.5,-110,-110,143,1.5,-125,6.35,Fenway Park,15,-3
2021-08-25,2021,SF,NYM,3,2,-107,1.5,-210,8.5,-115,-105,-103,-1.5,185,4.39,Citi Field,5,1
2021-08-25,2021,TB,PHI,7,4,143,1.5,-155,8.0,-115,-105,-153,-1.5,135,3.29,Citizens Bank Park,11,3
2021-08-25,2021,ARI,PIT,5,2,-113,-1.5,135,9.0,100,-120,103,1.5,-155,4.77,PNC Park,7,3
2021-08-25,2021,LAD,SD,5,3,-136,-1.5,120,8.0,-115,-105,126,1.5,-140,4.61,PETCO Park,8,2
2021-08-25,2021,NYM,SF,2,3,-103,-1.5,185,8.5,-115,-105,-107,1.5,-210,4.31,Citi Field,5,-1
2021-08-25,2021,DET,STL,2,3,110,1.5,-175,9.0,-120,100,-120,-1.5,155,4.29,Busch Stadium,5,-1
2021-08-25,2021,PHI,TB,4,7,-153,-1.5,135,8.0,-115,-105,143,1.5,-155,4.84,Citizens Bank Park,11,-3
2021-08-25,2021,CLE,TEX,7,2,-194,-1.5,100,9.0,-110,-110,177,1.5,-120,5.94,Progressive Field,9,5
2021-08-25,2021,CWS,TOR,1,3,109,1.5,-180,8.5,100,-120,-119,-1.5,160,4.07,Rogers Centre,4,-2
2021-08-25,2021,MIA,WSH,4,3,-105,1.5,-175,8.0,-105,-115,-105,-1.5,155,4.1,Marlins Park,7,1
2021-08-26,2021,PHI,ARI,7,8,-139,-1.5,140,9.0,-115,-105,129,1.5,-160,5.23,Citizens Bank Park,15,-1
2021-08-26,2021,LAA,BAL,1,13,-105,-1.5,130,10.5,-120,100,-105,1.5,-150,5.38,Camden Yards,14,-12
2021-08-26,2021,MIN,BOS,2,12,224,1.5,115,10.0,-105,-115,-254,-1.5,-135,3.09,Fenway Park,14,-10
2021-08-26,2021,MIL,CIN,1,5,100,-1.5,180,9.0,100,-120,-110,1.5,-205,4.5,Miller Park,6,-4
2021-08-26,2021,TEX,CLE,6,10,142,1.5,-125,9.5,100,-120,-152,-1.5,105,3.93,Progressive Field,16,-4
2021-08-26,2021,TOR,CWS,7,10,-103,-1.5,180,8.5,-105,-115,-107,1.5,-205,4.31,Rogers Centre,17,-3
2021-08-26,2021,SEA,KC,4,6,-164,-1.5,115,8.0,-105,-115,154,1.5,-135,4.97,T-Mobile Park,10,-2
2021-08-26,2021,BAL,LAA,13,1,-105,1.5,-150,10.5,-120,100,-105,-1.5,130,5.38,Camden Yards,14,12
2021-08-26,2021,SD,LAD,0,4,129,1.5,-130,7.5,-115,-105,-139,-1.5,110,3.28,PETCO Park,4,-4
2021-08-26,2021,WSH,MIA,5,7,107,1.5,-200,7.5,-115,-105,-117,-1.5,175,3.62,Marlins Park,12,-2
2021-08-26,2021,CIN,MIL,5,1,-110,1.5,-205,9.0,100,-120,100,-1.5,180,4.71,Miller Park,6,4
2021-08-26,2021,BOS,MIN,12,2,-254,-1.5,-135,10.0,-105,-115,224,1.5,115,7.18,Fenway Park,14,10
2021-08-26,2021,SF,NYM,3,2,-114,-1.5,145,8.5,-105,-115,104,1.5,-165,4.53,Citi Field,5,1
2021-08-26,2021,OAK,NYY,6,7,106,1.5,-155,8.5,-115,-105,-116,-1.5,135,4.13,Oakland Coliseum,13,-1
2021-08-26,2021,NYY,OAK,7,6,-116,-1.5,135,8.5,-115,-105,106,1.5,-155,4.56,Oakland Coliseum,13,1
2021-08-26,2021,ARI,PHI,8,7,129,1.5,-160,9.0,-115,-105,-139,-1.5,140,3.93,Citizens Bank Park,15,1
2021-08-26,2021,STL,PIT,7,11,-159,-1.5,-105,8.5,-115,-105,149,1.5,-115,5.22,PNC Park,18,-4
2021-08-26,2021,LAD,SD,4,0,-139,-1.5,110,7.5,-115,-105,129,1.5,-130,4.36,PETCO Park,4,4
2021-08-26,2021,KC,SEA,6,4,154,1.5,-135,8.0,-105,-115,-164,-1.5,115,3.15,T-Mobile Park,10,2
2021-08-26,2021,NYM,SF,2,3,104,1.5,-165,8.5,-105,-115,-114,-1.5,145,4.17,Citi Field,5,-1
2021-08-26,2021,PIT,STL,11,7,149,1.5,-115,8.5,-115,-105,-159,-1.5,-105,3.41,PNC Park,18,4
2021-08-26,2021,CLE,TEX,10,6,-152,-1.5,105,9.5,100,-120,142,1.5,-125,5.73,Progressive Field,16,4
2021-08-26,2021,CWS,TOR,10,7,-107,1.5,-205,8.5,-105,-115,-103,-1.5,180,4.39,Rogers Centre,17,3
2021-08-26,2021,MIA,WSH,7,5,-117,-1.5,175,7.5,-115,-105,107,1.5,-200,4.04,Marlins Park,12,2
2021-08-27,2021,PHI,ARI,7,6,-247,-1.5,-125,8.5,-115,-105,217,1.5,105,6.05,Citizens Bank Park,13,1
2021-08-27,2021,SF,ATL,5,6,114,1.5,-185,8.5,-105,-115,-124,-1.5,165,3.97,Suntrust Park,11,-1
2021-08-27,2021,TB,BAL,6,3,-230,-1.5,-150,10.0,-110,-110,205,1.5,130,6.97,Camden Yards,9,3
2021-08-27,2021,CLE,BOS,3,4,156,1.5,-105,9.5,-115,-105,-166,-1.5,-115,3.71,Progressive Field,7,-1
2021-08-27,2021,CWS,CHC,17,13,-211,-1.5,-120,9.0,-115,-105,191,1.5,100,6.11,Guaranteed Rate Field,30,4
2021-08-27,2021,MIA,CIN,0,6,119,1.5,-145,8.0,100,-120,-129,-1.5,125,3.65,Marlins Park,6,-6
2021-08-27,2021,BOS,CLE,4,3,-166,-1.5,-115,9.5,-115,-105,156,1.5,-105,5.93,Progressive Field,7,1
2021-08-27,2021,LAD,COL,2,4,-263,-1.5,-130,9.0,100,-120,233,1.5,110,6.52,Dodger Stadium,6,-2
2021-08-27,2021,CHC,CWS,13,17,191,1.5,100,9.0,-115,-105,-211,-1.5,-120,3.09,Guaranteed Rate Field,30,-4
2021-08-27,2021,TOR,DET,1,2,-160,-1.5,-120,9.5,-115,-105,150,1.5,100,5.85,Comerica Park,3,-1
2021-08-27,2021,TEX,HOU,4,5,171,1.5,110,9.0,-115,-105,-186,-1.5,-130,3.32,Globe Life Field,9,-1
2021-08-27,2021,SEA,KC,7,8,-174,-1.5,115,8.0,-105,-115,162,1.5,-135,5.08,T-Mobile Park,15,-1
2021-08-27,2021,SD,LAA,5,0,-201,-1.5,-130,9.0,-105,-115,181,1.5,110,6.01,Angel Stadium,5,5
2021-08-27,2021,COL,LAD,4,2,233,1.5,110,9.0,100,-120,-263,-1.5,-130,2.7,Dodger Stadium,6,2
2021-08-27,2021,CIN,MIA,6,0,-129,-1.5,125,8.0,100,-120,119,1.5,-145,4.51,Marlins Park,6,6
2021-08-27,2021,MIN,MIL,2,0,117,1.5,-140,9.5,-105,-115,-127,-1.5,120,4.38,Target Field,2,2
2021-08-27,2021,MIL,MIN,0,2,-127,-1.5,120,9.5,-105,-115,117,1.5,-140,5.31,Target Field,2,-2
2021-08-27,2021,WSH,NYM,2,1,171,1.5,-125,8.5,-120,100,-186,-1.5,105,3.14,Citi Field,3,1
2021-08-27,2021,OAK,NYY,2,8,154,1.5,-115,8.0,-105,-115,-164,-1.5,-105,3.15,Oakland Coliseum,10,-6
2021-08-27,2021,NYY,OAK,8,2,-164,-1.5,-105,8.0,-105,-115,154,1.5,-115,4.97,Oakland Coliseum,10,6
2021-08-27,2021,ARI,PHI,6,7,217,1.5,105,8.5,-115,-105,-247,-1.5,-125,2.68,Citizens Bank Park,13,-1
2021-08-27,2021,STL,PIT,4,3,-164,-1.5,100,8.5,-14,-6,154,1.5,-120,5.28,PNC Park,7,1
2021-08-27,2021,LAA,SD,0,5,181,1.5,110,9.0,-105,-115,-201,-1.5,-130,3.2,Angel Stadium,5,-5
2021-08-27,2021,KC,SEA,8,7,162,1.5,-135,8.0,-105,-115,-174,-1.5,115,3.05,T-Mobile Park,15,1
2021-08-27,2021,ATL,SF,6,5,-124,-1.5,165,8.5,-105,-115,114,1.5,-185,4.71,Suntrust Park,11,1
2021-08-27,2021,PIT,STL,3,4,154,1.5,-120,8.5,-14,-6,-164,-1.5,100,3.35,PNC Park,7,-1
2021-08-27,2021,BAL,TB,3,6,205,1.5,130,10.0,-110,-110,-230,-1.5,-150,3.28,Camden Yards,9,-3
2021-08-27,2021,HOU,TEX,5,4,-186,-1.5,-130,9.0,-115,-105,171,1.5,110,5.85,Globe Life Field,9,1
2021-08-27,2021,DET,TOR,2,1,150,1.5,100,9.5,-115,-105,-160,-1.5,-120,3.8,Comerica Park,3,1
2021-08-27,2021,NYM,WSH,1,2,-186,-1.5,105,8.5,-120,100,171,1.5,-125,5.53,Citi Field,3,-1
2021-08-28,2021,PHI,ARI,7,0,-192,-1.5,110,8.5,-115,-105,176,1.5,-130,5.59,Citizens Bank Park,7,7
2021-08-28,2021,SF,ATL,5,0,-102,1.5,-200,8.5,-105,-115,-108,-1.5,175,4.29,Suntrust Park,5,5
2021-08-28,2021,TB,BAL,4,3,-157,-1.5,-105,9.5,100,-120,147,1.5,-115,5.8,Camden Yards,7,1
2021-08-28,2021,CLE,BOS,3,5,126,1.5,-130,9.0,-105,-115,-136,-1.5,110,3.98,Progressive Field,8,-2
2021-08-28,2021,CWS,CHC,0,7,-300,-1.5,-145,9.0,-105,-115,260,1.5,125,6.75,Guaranteed Rate Field,7,-7
2021-08-28,2021,MIA,CIN,6,1,-105,1.5,-175,7.5,-115,-105,-105,-1.5,155,3.84,Marlins Park,7,5
2021-08-28,2021,BOS,CLE,5,3,-136,-1.5,110,9.0,-105,-115,126,1.5,-130,5.19,Progressive Field,8,2
2021-08-28,2021,LAD,COL,5,2,-241,-1.5,-125,9.0,-115,-105,211,1.5,105,6.36,Dodger Stadium,7,3
2021-08-28,2021,CHC,CWS,7,0,260,1.5,125,9.0,-105,-115,-300,-1.5,-145,2.5,Guaranteed Rate Field,7,7
2021-08-28,2021,TOR,DET,3,2,-183,-1.5,-130,9.5,-105,-115,168,1.5,110,6.14,Comerica Park,5,1
2021-08-28,2021,TEX,HOU,2,5,205,1.5,125,9.0,-110,-110,-230,-1.5,-145,2.95,Globe Life Field,7,-3
2021-08-28,2021,SEA,KC,2,4,-153,-1.5,135,8.5,-105,-115,143,1.5,-155,5.14,T-Mobile Park,6,-2
2021-08-28,2021,SD,LAA,2,10,-125,-1.5,125,10.0,-115,-105,115,1.5,-145,5.56,Angel Stadium,12,-8
2021-08-28,2021,COL,LAD,2,5,211,1.5,105,9.0,-115,-105,-241,-1.5,-125,2.89,Dodger Stadium,7,-3
2021-08-28,2021,CIN,MIA,1,6,-105,-1.5,155,7.5,-115,-105,-105,1.5,-175,3.84,Marlins Park,7,-5
2021-08-28,2021,MIN,MIL,6,4,132,1.5,-125,10.0,-115,-105,-142,-1.5,105,4.31,Target Field,10,2
2021-08-28,2021,MIL,MIN,4,6,-142,-1.5,105,10.0,-115,-105,132,1.5,-125,5.87,Target Field,10,-2
2021-08-28,2021,WSH,NYM,3,5,194,1.5,-110,8.0,-105,-115,-214,-1.5,-110,2.72,Citi Field,8,-2
2021-08-28,2021,OAK,NYY,3,2,-123,-1.5,165,9.0,-105,-115,113,1.5,-185,4.96,Oakland Coliseum,5,1
2021-08-28,2021,NYY,OAK,2,3,113,1.5,-185,9.0,-105,-115,-123,-1.5,165,4.23,Oakland Coliseum,5,-1
2021-08-28,2021,ARI,PHI,0,7,176,1.5,-130,8.5,-115,-105,-192,-1.5,110,3.08,Citizens Bank Park,7,-7
2021-08-28,2021,STL,PIT,13,0,-185,-1.5,-115,8.5,-105,-115,170,1.5,-105,5.52,PNC Park,13,13
2021-08-28,2021,LAA,SD,10,2,115,1.5,-145,10.0,-115,-105,-125,-1.5,125,4.65,Angel Stadium,12,8
2021-08-28,2021,KC,SEA,4,2,143,1.5,-155,8.5,-105,-115,-153,-1.5,135,3.5,T-Mobile Park,6,2
2021-08-28,2021,ATL,SF,0,5,-108,-1.5,175,8.5,-105,-115,-102,1.5,-200,4.41,Suntrust Park,5,-5
2021-08-28,2021,PIT,STL,0,13,170,1.5,-105,8.5,-105,-115,-185,-1.5,-115,3.15,PNC Park,13,-13
2021-08-28,2021,BAL,TB,3,4,147,1.5,-115,9.5,100,-120,-157,-1.5,-105,3.85,Camden Yards,7,-1
2021-08-28,2021,HOU,TEX,5,2,-230,-1.5,-145,9.0,-110,-110,205,1.5,125,6.27,Globe Life Field,7,3
2021-08-28,2021,DET,TOR,2,3,168,1.5,110,9.5,-105,-115,-183,-1.5,-130,3.54,Comerica Park,5,-1
2021-08-28,2021,NYM,WSH,5,3,-214,-1.5,-110,8.0,-105,-115,194,1.5,-110,5.45,Citi Field,8,2
2021-08-29,2021,PHI,ARI,7,4,-174,-1.5,110,8.5,-105,-115,162,1.5,-130,5.4,Citizens Bank Park,11,3
2021-08-29,2021,SF,ATL,0,9,117,1.5,-170,9.0,-105,-115,-127,-1.5,150,4.15,Suntrust Park,9,-9
2021-08-29,2021,TB,BAL,12,8,-240,-1.5,-150,10.0,-110,-110,210,1.5,130,7.06,Camden Yards,20,4
2021-08-29,2021,CLE,BOS,7,5,139,1.5,-115,10.5,-105,-115,-149,-1.5,-105,4.39,Progressive Field,12,2
2021-08-29,2021,CWS,CHC,13,1,-250,-1.5,-120,9.0,100,-120,220,1.5,100,6.43,Guaranteed Rate Field,14,12
2021-08-29,2021,MIA,CIN,2,1,170,1.5,100,8.0,-110,-110,-185,-1.5,-120,2.96,Marlins Park,3,1
2021-08-29,2021,BOS,CLE,5,7,-149,-1.5,-105,10.5,-105,-115,139,1.5,-115,6.28,Progressive Field,12,-2
2021-08-29,2021,LAD,COL,0,5,-240,-1.5,-115,9.0,-105,-115,210,1.5,-105,6.35,Dodger Stadium,5,-5
2021-08-29,2021,CHC,CWS,1,13,220,1.5,100,9.0,100,-120,-250,-1.5,-120,2.81,Guaranteed Rate Field,14,-12
2021-08-29,2021,TOR,DET,2,1,-168,-1.5,-120,9.0,-115,-105,158,1.5,100,5.64,Comerica Park,3,1
2021-08-29,2021,TEX,HOU,13,2,180,1.5,110,8.5,-120,100,-200,-1.5,-130,3.04,Globe Life Field,15,11
2021-08-29,2021,SEA,KC,4,3,-140,-1.5,130,8.5,-115,-105,130,1.5,-150,4.96,T-Mobile Park,7,1
2021-08-29,2021,COL,LAD,5,0,210,1.5,-105,9.0,-105,-115,-240,-1.5,-115,2.9,Dodger Stadium,5,5
2021-08-29,2021,CIN,MIA,1,2,-185,-1.5,-120,8.0,-110,-110,170,1.5,100,5.19,Marlins Park,3,-1
2021-08-29,2021,MIN,MIL,2,6,133,1.5,-125,9.5,-110,-110,-143,-1.5,105,4.08,Target Field,8,-4
2021-08-29,2021,MIL,MIN,6,2,-143,-1.5,105,9.5,-110,-110,133,1.5,-125,5.59,Target Field,8,4
2021-08-29,2021,WSH,NYM,4,9,171,1.5,-130,8.0,-105,-115,-186,-1.5,110,2.95,Citi Field,13,-5
2021-08-29,2021,OAK,NYY,3,1,137,1.5,-130,9.0,-110,-110,-147,-1.5,110,3.8,Oakland Coliseum,4,2
2021-08-29,2021,NYY,OAK,1,3,-147,-1.5,110,9.0,-110,-110,137,1.5,-130,5.36,Oakland Coliseum,4,-2
2021-08-29,2021,ARI,PHI,4,7,162,1.5,-130,8.5,-105,-115,-174,-1.5,110,3.24,Citizens Bank Park,11,-3
2021-08-29,2021,STL,PIT,3,4,-150,-1.5,100,9.0,-120,100,140,1.5,-120,5.4,PNC Park,7,-1
2021-08-29,2021,KC,SEA,3,4,130,1.5,-150,8.5,-115,-105,-140,-1.5,130,3.7,T-Mobile Park,7,-1
2021-08-29,2021,ATL,SF,9,0,-127,-1.5,150,9.0,-105,-115,117,1.5,-170,5.04,Suntrust Park,9,9
2021-08-29,2021,PIT,STL,4,3,140,1.5,-120,9.0,-120,100,-150,-1.5,100,3.75,PNC Park,7,1
2021-08-29,2021,BAL,TB,8,12,210,1.5,130,10.0,-110,-110,-240,-1.5,-150,3.23,Camden Yards,20,-4
2021-08-29,2021,HOU,TEX,2,13,-200,-1.5,-130,8.5,-120,100,180,1.5,110,5.67,Globe Life Field,15,-11
2021-08-29,2021,DET,TOR,1,2,158,1.5,100,9.0,-115,-105,-168,-1.5,-120,3.49,Comerica Park,3,-1
2021-08-29,2021,NYM,WSH,9,4,-186,-1.5,110,8.0,-105,-115,171,1.5,-130,5.2,Citi Field,13,5
2021-08-30,2021,SD,ARI,7,5,-170,-1.5,-110,9.5,-105,-115,160,1.5,-110,5.98,Chase Field,12,2
2021-08-30,2021,LAD,ATL,5,3,-200,-1.5,-110,8.5,-120,100,180,1.5,-110,5.67,Dodger Stadium,8,2
2021-08-30,2021,TOR,BAL,7,3,-340,-1.5,-160,9.0,-115,-105,290,1.5,140,6.95,Rogers Centre,10,4
2021-08-30,2021,TB,BOS,6,1,-144,-1.5,135,9.0,-105,-115,134,1.5,-155,5.31,Tropicana Field,7,5
2021-08-30,2021,STL,CIN,3,1,185,1.5,-120,9.5,-105,-115,-205,-1.5,100,3.33,Great American Ballpark,4,2
2021-08-30,2021,TEX,COL,4,3,135,1.5,-125,8.5,100,-120,-145,-1.5,105,3.62,Globe Life Field,7,1
2021-08-30,2021,MIN,DET,3,2,-124,-1.5,130,9.0,-120,100,114,1.5,-150,4.98,Comerica Park,5,1
2021-08-30,2021,SEA,HOU,3,4,139,1.5,-125,8.0,-115,-105,-149,-1.5,105,3.35,T-Mobile Park,7,-1
2021-08-30,2021,NYY,LAA,7,8,-190,-1.5,-120,9.0,-115,-105,175,1.5,100,5.9,Angel Stadium,15,-1
2021-08-30,2021,ATL,LAD,3,5,180,1.5,-110,8.5,-120,100,-200,-1.5,-110,3.04,Dodger Stadium,8,-2
2021-08-30,2021,SF,MIL,1,3,124,1.5,-145,7.5,-105,-115,-134,-1.5,125,3.35,AT&T Park,4,-2
2021-08-30,2021,DET,MIN,2,3,114,1.5,-150,9.0,-120,100,-124,-1.5,130,4.21,Comerica Park,5,-1
2021-08-30,2021,LAA,NYY,8,7,175,1.5,100,9.0,-115,-105,-190,-1.5,-120,3.27,Angel Stadium,15,1
2021-08-30,2021,WSH,PHI,4,7,125,1.5,-130,8.0,-115,-105,-135,-1.5,110,3.56,Nationals Park,11,-3
2021-08-30,2021,ARI,SD,5,7,160,1.5,-110,9.5,-105,-115,-170,-1.5,-110,3.65,Chase Field,12,-2
2021-08-30,2021,HOU,SEA,4,3,-149,-1.5,105,8.0,-115,-105,139,1.5,-125,4.79,T-Mobile Park,7,1
2021-08-30,2021,MIL,SF,3,1,-134,-1.5,125,7.5,-105,-115,124,1.5,-145,4.29,AT&T Park,4,2
2021-08-30,2021,CIN,STL,1,3,-205,-1.5,100,9.5,-105,-115,185,1.5,-120,6.39,Great American Ballpark,4,-2
2021-08-30,2021,BOS,TB,1,6,134,1.5,-155,9.0,-105,-115,-144,-1.5,135,3.85,Tropicana Field,7,-5
2021-08-30,2021,COL,TEX,3,4,-145,-1.5,105,8.5,100,-120,135,1.5,-125,5.03,Globe Life Field,7,-1
2021-08-30,2021,BAL,TOR,3,7,290,1.5,140,9.0,-115,-105,-340,-1.5,-160,2.31,Rogers Centre,10,-4
2021-08-30,2021,PHI,WSH,7,4,-135,-1.5,110,8.0,-115,-105,125,1.5,-130,4.6,Nationals Park,11,3
2021-08-31,2021,SD,ARI,3,0,-154,-1.5,100,8.0,-115,-105,144,1.5,-120,4.85,Chase Field,3,3
2021-08-31,2021,LAD,ATL,3,2,-185,-1.5,120,7.5,100,-120,170,1.5,-140,4.87,Dodger Stadium,5,1
2021-08-31,2021,TOR,BAL,2,4,-300,-1.5,-155,9.5,-120,100,260,1.5,135,7.13,Rogers Centre,6,-2
2021-08-31,2021,TB,BOS,8,5,-155,-1.5,130,9.0,-110,-110,145,1.5,-150,5.47,Tropicana Field,13,3
2021-08-31,2021,MIN,CHC,1,3,-149,-1.5,130,9.5,100,-120,139,1.5,-150,5.68,Target Field,4,-2
2021-08-31,2021,KC,CLE,2,7,-116,-1.5,160,8.5,-120,100,106,1.5,-180,4.56,Kauffman Stadium,9,-5
2021-08-31,2021,TEX,COL,4,3,118,1.5,-140,8.5,-115,-105,-128,-1.5,120,3.9,Globe Life Field,7,1
2021-08-31,2021,PIT,CWS,2,4,290,1.5,140,8.5,-115,-105,-340,-1.5,-160,2.18,Guaranteed Rate Field,6,-2
2021-08-31,2021,OAK,DET,9,3,-112,-1.5,135,9.0,-105,-115,102,1.5,-155,4.75,Comerica Park,12,6
2021-08-31,2021,SEA,HOU,4,0,144,1.5,-125,8.0,-105,-115,-154,-1.5,105,3.28,T-Mobile Park,4,4
2021-08-31,2021,CLE,KC,7,2,106,1.5,-180,8.5,-120,100,-116,-1.5,160,4.13,Kauffman Stadium,9,5
2021-08-31,2021,NYY,LAA,4,6,-186,-1.5,-130,9.5,100,-120,171,1.5,110,6.18,Angel Stadium,10,-2
2021-08-31,2021,ATL,LAD,2,3,170,1.5,-140,7.5,100,-120,-185,-1.5,120,2.78,Dodger Stadium,5,-1
2021-08-31,2021,NYM,MIA,3,1,-172,-1.5,140,6.5,105,-125,161,1.5,-160,4.11,Citi Field,4,2
2021-08-31,2021,SF,MIL,2,6,114,1.5,-165,7.5,-105,-115,-124,-1.5,145,3.5,AT&T Park,8,-4
2021-08-31,2021,CHC,MIN,3,1,139,1.5,-150,9.5,100,-120,-149,-1.5,130,3.97,Target Field,4,2
2021-08-31,2021,MIA,NYM,1,3,161,1.5,-160,6.5,105,-125,-172,-1.5,140,2.49,Citi Field,4,-2
2021-08-31,2021,LAA,NYY,6,4,171,1.5,110,9.5,100,-120,-186,-1.5,-130,3.51,Angel Stadium,10,2
2021-08-31,2021,DET,OAK,3,9,102,1.5,-155,9.0,-105,-115,-112,-1.5,135,4.46,Comerica Park,12,-6
2021-08-31,2021,WSH,PHI,6,12,-128,-1.5,145,9.0,-120,100,118,1.5,-165,5.05,Nationals Park,18,-6
2021-08-31,2021,CWS,PIT,4,2,-340,-1.5,-160,8.5,-115,-105,290,1.5,140,6.57,Guaranteed Rate Field,6,2
2021-08-31,2021,ARI,SD,0,3,144,1.5,-120,8.0,-115,-105,-154,-1.5,100,3.28,Chase Field,3,-3
2021-08-31,2021,HOU,SEA,0,4,-154,-1.5,105,8.0,-105,-115,144,1.5,-125,4.85,T-Mobile Park,4,-4
2021-08-31,2021,MIL,SF,6,2,-124,-1.5,145,7.5,-105,-115,114,1.5,-165,4.15,AT&T Park,8,4
2021-08-31,2021,BOS,TB,5,8,145,1.5,-150,9.0,-110,-110,-155,-1.5,130,3.67,Tropicana Field,13,-3
2021-08-31,2021,COL,TEX,3,4,-128,-1.5,120,8.5,-115,-105,118,1.5,-140,4.77,Globe Life Field,7,-1
2021-08-31,2021,BAL,TOR,4,2,260,1.5,135,9.5,-120,100,-300,-1.5,-155,2.64,Rogers Centre,6,2
2021-08-31,2021,PHI,WSH,12,6,118,1.5,-165,9.0,-120,100,-128,-1.5,145,4.13,Nationals Park,18,6
2021-09-01,2021,SD,ARI,3,8,-200,-1.5,-125,8.5,-120,100,180,1.5,105,5.67,Chase Field,11,-5
2021-09-01,2021,LAD,ATL,4,3,-205,-1.5,100,7.5,100,-120,185,1.5,-120,5.04,Dodger Stadium,7,1
2021-09-01,2021,TOR,BAL,5,4,-240,-1.5,-130,9.5,-115,-105,210,1.5,110,6.71,Rogers Centre,9,1
2021-09-01,2021,TB,BOS,2,3,-114,-1.5,195,7.5,-105,-115,104,1.5,-220,4.0,Tropicana Field,5,-1
2021-09-01,2021,MIN,CHC,0,3,-174,-1.5,115,9.0,-105,-115,162,1.5,-135,5.72,Target Field,3,-3
2021-09-01,2021,STL,CIN,5,4,112,1.5,-200,7.0,-110,-110,-122,-1.5,175,3.3,Great American Ballpark,9,1
2021-09-01,2021,STL,CIN,2,12,154,1.5,-150,7.0,-110,-110,-164,-1.5,130,2.76,Great American Ballpark,14,-10
2021-09-01,2021,KC,CLE,3,5,-125,-1.5,150,9.0,-110,-110,115,1.5,-170,5.0,Kauffman Stadium,8,-2
2021-09-01,2021,TEX,COL,5,9,130,1.5,-135,8.5,-115,-105,-140,-1.5,115,3.7,Globe Life Field,14,-4
2021-09-01,2021,PIT,CWS,3,6,300,1.5,150,8.5,-120,100,-350,-1.5,-170,2.13,Guaranteed Rate Field,9,-3
2021-09-01,2021,OAK,DET,6,8,-172,-1.5,-115,9.5,-110,-110,161,1.5,-105,6.01,Comerica Park,14,-2
2021-09-01,2021,SEA,HOU,1,0,122,1.5,-140,8.5,-115,-105,-132,-1.5,120,3.83,T-Mobile Park,1,1
2021-09-01,2021,CLE,KC,5,3,115,1.5,-170,9.0,-110,-110,-125,-1.5,150,4.19,Kauffman Stadium,8,2
2021-09-01,2021,NYY,LAA,4,1,-270,-1.5,-155,8.5,-110,-110,240,1.5,135,6.2,Angel Stadium,5,3
2021-09-01,2021,ATL,LAD,3,4,185,1.5,-120,7.5,100,-120,-205,-1.5,100,2.63,Dodger Stadium,7,-1
2021-09-01,2021,SF,MIL,2,5,-178,-1.5,120,8.0,-110,-110,164,1.5,-140,5.12,AT&T Park,7,-3
2021-09-01,2021,CHC,MIN,3,0,162,1.5,-135,9.0,-105,-115,-174,-1.5,115,3.44,Target Field,3,3
2021-09-01,2021,LAA,NYY,1,4,240,1.5,135,8.5,-110,-110,-270,-1.5,-155,2.5,Angel Stadium,5,-3
2021-09-01,2021,DET,OAK,8,6,161,1.5,-105,9.5,-110,-110,-172,-1.5,-115,3.64,Comerica Park,14,2
2021-09-01,2021,CWS,PIT,6,3,-350,-1.5,-170,8.5,-120,100,300,1.5,150,6.61,Guaranteed Rate Field,9,3
2021-09-01,2021,ARI,SD,8,3,180,1.5,105,8.5,-120,100,-200,-1.5,-125,3.04,Chase Field,11,5
2021-09-01,2021,HOU,SEA,0,1,-132,-1.5,120,8.5,-115,-105,122,1.5,-140,4.84,T-Mobile Park,1,-1
2021-09-01,2021,MIL,SF,5,2,164,1.5,-140,8.0,-110,-110,-178,-1.5,120,3.03,AT&T Park,7,3
2021-09-01,2021,CIN,STL,4,5,-122,-1.5,175,7.0,-110,-110,112,1.5,-200,3.85,Great American Ballpark,9,-1
2021-09-01,2021,CIN,STL,12,2,-164,-1.5,130,7.0,-110,-110,154,1.5,-150,4.35,Great American Ballpark,14,10
2021-09-01,2021,BOS,TB,3,2,104,1.5,-220,7.5,-105,-115,-114,-1.5,195,3.68,Tropicana Field,5,1
2021-09-01,2021,COL,TEX,9,5,-140,-1.5,115,8.5,-115,-105,130,1.5,-135,4.96,Globe Life Field,14,4
2021-09-01,2021,BAL,TOR,4,5,210,1.5,110,9.5,-115,-105,-240,-1.5,-130,3.06,Rogers Centre,9,-1
2021-09-02,2021,COL,ATL,5,6,137,1.5,-115,12.5,-120,100,-147,-1.5,-105,5.27,Coors Field,11,-1
2021-09-02,2021,TB,BOS,0,4,-159,-1.5,125,7.5,-115,-105,149,1.5,-145,4.6,Tropicana Field,4,-4
2021-09-02,2021,PIT,CHC,5,6,120,1.5,-170,8.5,-105,-115,-130,-1.5,150,3.86,Wrigley Field,11,-1
2021-09-02,2021,KC,CLE,2,4,-112,1.5,-180,8.5,-120,100,102,-1.5,160,4.49,Kauffman Stadium,6,-2
2021-09-02,2021,ATL,COL,6,5,-147,-1.5,-105,12.5,-120,100,137,1.5,-115,7.44,Coors Field,11,1
2021-09-02,2021,OAK,DET,8,6,-200,-1.5,-125,9.0,-120,100,180,1.5,105,6.0,Comerica Park,14,2
2021-09-02,2021,CLE,KC,4,2,102,-1.5,160,8.5,-120,100,-112,1.5,-180,4.21,Kauffman Stadium,6,2
2021-09-02,2021,NYM,MIA,4,3,-153,-1.5,140,7.0,105,-125,143,1.5,-160,4.23,Citi Field,7,1
2021-09-02,2021,SF,MIL,5,1,-176,-1.5,115,7.5,-105,-115,163,1.5,-135,4.78,AT&T Park,6,4
2021-09-02,2021,MIA,NYM,3,4,143,1.5,-160,7.0,105,-125,-153,-1.5,140,2.88,Citi Field,7,-1
2021-09-02,2021,DET,OAK,6,8,180,1.5,105,9.0,-120,100,-200,-1.5,-125,3.21,Comerica Park,14,-2
2021-09-02,2021,WSH,PHI,6,7,140,1.5,-130,8.0,-115,-105,-150,-1.5,110,3.33,Nationals Park,13,-1
2021-09-02,2021,CHC,PIT,6,5,-130,-1.5,150,8.5,-105,-115,120,1.5,-170,4.8,Wrigley Field,11,1
2021-09-02,2021,MIL,SF,1,5,163,1.5,-135,7.5,-105,-115,-176,-1.5,115,2.85,AT&T Park,6,-4
2021-09-02,2021,BOS,TB,4,0,149,1.5,-145,7.5,-115,-105,-159,-1.5,125,3.01,Tropicana Field,4,4
2021-09-02,2021,PHI,WSH,7,6,-150,-1.5,110,8.0,-115,-105,140,1.5,-130,4.8,Nationals Park,13,1
2021-09-03,2021,SEA,ARI,6,5,-108,-1.5,145,8.5,-115,-105,-102,1.5,-165,4.41,Chase Field,11,1
2021-09-03,2021,COL,ATL,4,3,121,1.5,-130,11.0,-110,-110,-131,-1.5,110,4.98,Coors Field,7,1
2021-09-03,2021,NYY,BAL,4,3,-230,-1.5,-115,9.0,-120,100,205,1.5,-105,6.27,Yankee Stadium,7,1
2021-09-03,2021,CLE,BOS,5,8,157,1.5,-135,9.0,-105,-115,-167,-1.5,115,3.5,Fenway Park,13,-3
2021-09-03,2021,PIT,CHC,5,6,134,1.5,-155,8.5,-115,-105,-144,-1.5,135,3.63,Wrigley Field,11,-1
2021-09-03,2021,DET,CIN,15,5,161,1.5,-125,9.5,100,-120,-172,-1.5,105,3.64,Great American Ballpark,20,10
2021-09-03,2021,BOS,CLE,8,5,-167,-1.5,115,9.0,-105,-115,157,1.5,-135,5.63,Fenway Park,13,3
2021-09-03,2021,ATL,COL,3,4,-131,-1.5,110,11.0,-110,-110,121,1.5,-130,6.24,Coors Field,7,-1
2021-09-03,2021,KC,CWS,7,2,110,1.5,-145,9.0,-125,105,-120,-1.5,125,4.29,Kauffman Stadium,9,5
2021-09-03,2021,CIN,DET,5,15,-172,-1.5,105,9.5,100,-120,161,1.5,-125,6.01,Great American Ballpark,20,-10
2021-09-03,2021,SD,HOU,3,6,108,1.5,-145,9.0,-105,-115,-118,-1.5,125,4.33,PETCO Park,9,-3
2021-09-03,2021,CWS,KC,2,7,-120,-1.5,125,9.0,-125,105,110,1.5,-145,4.91,Kauffman Stadium,9,-5
2021-09-03,2021,TEX,LAA,2,3,164,1.5,-135,7.5,-120,100,-178,-1.5,115,2.84,Angel Stadium,5,-1
2021-09-03,2021,SF,LAD,3,2,109,1.5,-155,8.5,-120,100,-119,-1.5,135,4.07,AT&T Park,5,1
2021-09-03,2021,PHI,MIA,3,10,-139,-1.5,115,7.5,-115,-105,129,1.5,-135,4.36,Marlins Park,13,-7
2021-09-03,2021,STL,MIL,15,4,152,1.5,-150,7.5,100,-120,-162,-1.5,130,2.98,Miller Park,19,11
2021-09-03,2021,TB,MIN,5,3,-188,-1.5,105,9.0,-110,-110,173,1.5,-125,5.88,Tropicana Field,8,2
2021-09-03,2021,WSH,NYM,2,6,115,1.5,-140,9.0,-115,-105,-125,-1.5,120,4.19,Nationals Park,8,-4
2021-09-03,2021,BAL,NYY,3,4,205,1.5,-105,9.0,-120,100,-230,-1.5,-115,2.95,Yankee Stadium,7,-1
2021-09-03,2021,TOR,OAK,11,10,-147,-1.5,125,9.0,100,-120,137,1.5,-145,5.36,Rogers Centre,21,1
2021-09-03,2021,MIA,PHI,10,3,129,1.5,-135,7.5,-115,-105,-139,-1.5,115,3.28,Marlins Park,13,7
2021-09-03,2021,CHC,PIT,6,5,-144,-1.5,135,8.5,-115,-105,134,1.5,-155,5.02,Wrigley Field,11,1
2021-09-03,2021,HOU,SD,6,3,-118,-1.5,125,9.0,-105,-115,108,1.5,-145,4.87,PETCO Park,9,3
2021-09-03,2021,ARI,SEA,5,6,-102,1.5,-165,8.5,-115,-105,-108,-1.5,145,4.29,Chase Field,11,-1
2021-09-03,2021,LAD,SF,2,3,-119,-1.5,135,8.5,-120,100,109,1.5,-155,4.62,AT&T Park,5,-1
2021-09-03,2021,MIL,STL,4,15,-162,-1.5,130,7.5,100,-120,152,1.5,-150,4.64,Miller Park,19,-11
2021-09-03,2021,MIN,TB,3,5,173,1.5,-125,9.0,-110,-110,-188,-1.5,105,3.3,Tropicana Field,8,-2
2021-09-03,2021,LAA,TEX,3,2,-178,-1.5,115,7.5,-120,100,164,1.5,-135,4.8,Angel Stadium,5,1
2021-09-03,2021,OAK,TOR,10,11,137,1.5,-145,9.0,100,-120,-147,-1.5,125,3.8,Rogers Centre,21,-1
2021-09-03,2021,NYM,WSH,6,2,-125,-1.5,120,9.0,-115,-105,115,1.5,-140,5.0,Nationals Park,8,4
2021-09-04,2021,SEA,ARI,8,5,-127,-1.5,120,9.0,-105,-115,117,1.5,-140,5.04,Chase Field,13,3
2021-09-04,2021,COL,ATL,7,6,100,1.5,-150,11.0,-105,-115,-110,-1.5,130,5.5,Coors Field,13,1
2021-09-04,2021,NYY,BAL,3,4,-350,-1.5,-175,9.0,-120,100,300,1.5,155,7.0,Yankee Stadium,7,-1
2021-09-04,2021,CLE,BOS,3,4,175,1.5,-115,9.5,-105,-115,-190,-1.5,-105,3.45,Fenway Park,7,-1
2021-09-04,2021,PIT,CHC,6,7,138,1.5,-150,8.5,-115,-105,-148,-1.5,130,3.57,Wrigley Field,13,-1
2021-09-04,2021,DET,CIN,4,7,173,1.5,-115,9.0,-105,-115,-188,-1.5,-105,3.3,Great American Ballpark,11,-3
2021-09-04,2021,BOS,CLE,4,3,-190,-1.5,-105,9.5,-105,-115,175,1.5,-115,6.22,Fenway Park,7,1
2021-09-04,2021,ATL,COL,6,7,-110,-1.5,130,11.0,-105,-115,100,1.5,-150,5.76,Coors Field,13,-1
2021-09-04,2021,KC,CWS,7,10,138,1.5,-115,8.5,-120,100,-148,-1.5,-105,3.57,Kauffman Stadium,17,-3
2021-09-04,2021,CIN,DET,7,4,-188,-1.5,-105,9.0,-105,-115,173,1.5,-115,5.88,Great American Ballpark,11,3
2021-09-04,2021,SD,HOU,10,2,-111,-1.5,175,7.5,-105,-115,101,1.5,-200,3.95,PETCO Park,12,8
2021-09-04,2021,CWS,KC,10,7,-148,-1.5,-105,8.5,-120,100,138,1.5,-115,5.07,Kauffman Stadium,17,3
2021-09-04,2021,TEX,LAA,1,4,135,1.5,-140,9.0,100,-120,-145,-1.5,120,3.83,Angel Stadium,5,-3
2021-09-04,2021,SF,LAD,1,6,151,1.5,-115,8.5,-110,-110,-161,-1.5,-105,3.39,AT&T Park,7,-5
2021-09-04,2021,PHI,MIA,2,3,-118,-1.5,145,7.5,105,-125,108,1.5,-165,4.06,Marlins Park,5,-1
2021-09-04,2021,STL,MIL,0,4,109,1.5,-170,8.5,-105,-115,-119,-1.5,150,4.07,Miller Park,4,-4
2021-09-04,2021,TB,MIN,11,4,-210,-1.5,-115,8.5,-120,100,190,1.5,-105,5.76,Tropicana Field,15,7
2021-09-04,2021,WSH,NYM,9,11,140,1.5,-140,6.5,-115,-105,-150,-1.5,120,2.71,Nationals Park,20,-2
2021-09-04,2021,WSH,NYM,4,3,143,1.5,-125,7.0,-115,-105,-153,-1.5,105,2.88,Nationals Park,7,1
2021-09-04,2021,BAL,NYY,4,3,300,1.5,155,9.0,-120,100,-350,-1.5,-175,2.25,Yankee Stadium,7,1
2021-09-04,2021,TOR,OAK,10,8,-178,-1.5,105,9.0,-105,-115,164,1.5,-125,5.76,Rogers Centre,18,2
2021-09-04,2021,MIA,PHI,3,2,108,1.5,-165,7.5,105,-125,-118,-1.5,145,3.61,Marlins Park,5,1
2021-09-04,2021,CHC,PIT,7,6,-148,-1.5,130,8.5,-115,-105,138,1.5,-150,5.07,Wrigley Field,13,1
2021-09-04,2021,HOU,SD,2,10,101,1.5,-200,7.5,-105,-115,-111,-1.5,175,3.73,PETCO Park,12,-8
2021-09-04,2021,ARI,SEA,5,8,117,1.5,-140,9.0,-105,-115,-127,-1.5,120,4.15,Chase Field,13,-3
2021-09-04,2021,LAD,SF,6,1,-161,-1.5,-105,8.5,-110,-110,151,1.5,-115,5.24,AT&T Park,7,5
2021-09-04,2021,MIL,STL,4,0,-119,-1.5,150,8.5,-105,-115,109,1.5,-170,4.62,Miller Park,4,4
2021-09-04,2021,MIN,TB,4,11,190,1.5,-105,8.5,-120,100,-210,-1.5,-115,2.93,Tropicana Field,15,-7
2021-09-04,2021,LAA,TEX,4,1,-145,-1.5,120,9.0,100,-120,135,1.5,-140,5.33,Angel Stadium,5,3
2021-09-04,2021,OAK,TOR,8,10,164,1.5,-125,9.0,-105,-115,-178,-1.5,105,3.41,Rogers Centre,18,-2
2021-09-04,2021,NYM,WSH,11,9,-150,-1.5,120,6.5,-115,-105,140,1.5,-140,3.9,Nationals Park,20,2
2021-09-04,2021,NYM,WSH,3,4,-153,-1.5,105,7.0,-115,-105,143,1.5,-125,4.23,Nationals Park,7,-1
2021-09-05,2021,SEA,ARI,10,4,-120,-1.5,130,9.0,100,-120,110,1.5,-150,4.91,Chase Field,14,6
2021-09-05,2021,COL,ATL,2,9,180,1.5,110,11.5,-110,-110,-200,-1.5,-130,4.11,Coors Field,11,-7
2021-09-05,2021,NYY,BAL,7,8,-330,-1.5,-160,9.5,-115,-105,285,1.5,140,7.29,Yankee Stadium,15,-1
2021-09-05,2021,CLE,BOS,11,5,124,1.5,-155,9.5,-120,100,-134,-1.5,135,4.24,Fenway Park,16,6
2021-09-05,2021,PIT,CHC,8,11,130,1.5,-155,9.0,-120,100,-140,-1.5,135,3.91,Wrigley Field,19,-3
2021-09-05,2021,DET,CIN,4,1,190,1.5,-110,9.0,-105,-115,-210,-1.5,-110,3.1,Great American Ballpark,5,3
2021-09-05,2021,BOS,CLE,5,11,-134,-1.5,135,9.5,-120,100,124,1.5,-155,5.44,Fenway Park,16,-6
2021-09-05,2021,ATL,COL,9,2,-200,-1.5,-130,11.5,-110,-110,180,1.5,110,7.67,Coors Field,11,7
2021-09-05,2021,KC,CWS,6,0,130,1.5,-135,8.5,-115,-105,-140,-1.5,115,3.7,Kauffman Stadium,6,6
2021-09-05,2021,CIN,DET,1,4,-210,-1.5,-110,9.0,-105,-115,190,1.5,-110,6.1,Great American Ballpark,5,-3
2021-09-05,2021,SD,HOU,4,3,-105,1.5,-170,8.5,-115,-105,-105,-1.5,150,4.35,PETCO Park,7,1
2021-09-05,2021,CWS,KC,0,6,-140,-1.5,115,8.5,-115,-105,130,1.5,-135,4.96,Kauffman Stadium,6,-6
2021-09-05,2021,TEX,LAA,7,3,114,1.5,-170,9.5,-105,-115,-124,-1.5,150,4.44,Angel Stadium,10,4
2021-09-05,2021,SF,LAD,6,4,170,1.5,-105,8.0,-110,-110,-185,-1.5,-115,2.96,AT&T Park,10,2
2021-09-05,2021,PHI,MIA,4,3,-104,-1.5,160,7.5,-115,-105,-106,1.5,-180,3.82,Marlins Park,7,1
2021-09-05,2021,STL,MIL,5,6,190,1.5,-115,7.5,-105,-115,-210,-1.5,-105,2.59,Miller Park,11,-1
2021-09-05,2021,TB,MIN,5,6,-210,-1.5,-115,9.0,100,-120,190,1.5,-105,6.1,Tropicana Field,11,-1
2021-09-05,2021,WSH,NYM,6,13,112,1.5,-155,9.0,100,-120,-122,-1.5,135,4.25,Nationals Park,19,-7
2021-09-05,2021,BAL,NYY,8,7,285,1.5,140,9.5,-115,-105,-330,-1.5,-160,2.47,Yankee Stadium,15,1
2021-09-05,2021,TOR,OAK,8,0,-210,-1.5,-115,9.5,-105,-115,190,1.5,-105,6.44,Rogers Centre,8,8
2021-09-05,2021,MIA,PHI,3,4,-106,1.5,-180,7.5,-115,-105,-104,-1.5,160,3.86,Marlins Park,7,-1
2021-09-05,2021,CHC,PIT,11,8,-140,-1.5,135,9.0,-120,100,130,1.5,-155,5.25,Wrigley Field,19,3
2021-09-05,2021,HOU,SD,3,4,-105,-1.5,150,8.5,-115,-105,-105,1.5,-170,4.35,PETCO Park,7,-1
2021-09-05,2021,ARI,SEA,4,10,110,1.5,-150,9.0,100,-120,-120,-1.5,130,4.29,Chase Field,14,-6
2021-09-05,2021,LAD,SF,4,6,-185,-1.5,-115,8.0,-110,-110,170,1.5,-105,5.19,AT&T Park,10,-2
2021-09-05,2021,MIL,STL,6,5,-210,-1.5,-105,7.5,-105,-115,190,1.5,-115,5.08,Miller Park,11,1
2021-09-05,2021,MIN,TB,6,5,190,1.5,-105,9.0,100,-120,-210,-1.5,-115,3.1,Tropicana Field,11,1
2021-09-05,2021,LAA,TEX,3,7,-124,-1.5,150,9.5,-105,-115,114,1.5,-170,5.26,Angel Stadium,10,-4
2021-09-05,2021,OAK,TOR,0,8,190,1.5,-105,9.5,-105,-115,-210,-1.5,-115,3.28,Rogers Centre,8,-8
2021-09-05,2021,NYM,WSH,13,6,-122,-1.5,135,9.0,100,-120,112,1.5,-155,4.95,Nationals Park,19,7
2021-09-06,2021,KC,BAL,3,2,-110,-1.5,150,10.0,-115,-105,100,1.5,-170,5.24,Camden Yards,5,1
2021-09-06,2021,TB,BOS,11,10,130,1.5,-155,10.0,-105,-115,-140,-1.5,135,4.35,Fenway Park,21,1
2021-09-06,2021,CIN,CHC,3,4,-150,-1.5,-110,8.0,-110,-110,140,1.5,-110,4.8,Wrigley Field,7,-1
2021-09-06,2021,CHC,CIN,4,3,140,1.5,-110,8.0,-110,-110,-150,-1.5,-110,3.33,Wrigley Field,7,1
2021-09-06,2021,MIN,CLE,5,2,-120,-1.5,125,9.5,100,-120,110,1.5,-145,5.18,Progressive Field,7,3
2021-09-06,2021,SF,COL,10,5,-144,-1.5,100,10.5,-115,-105,134,1.5,-120,6.2,Coors Field,15,5
2021-09-06,2021,PIT,DET,6,3,120,1.5,-140,8.5,-105,-115,-130,-1.5,120,3.86,PNC Park,9,3
2021-09-06,2021,SEA,HOU,2,11,195,1.5,-115,8.5,-115,-105,-215,-1.5,-105,2.88,Minute Maid Park,13,-9
2021-09-06,2021,BAL,KC,2,3,100,1.5,-170,10.0,-115,-105,-110,-1.5,150,5.0,Camden Yards,5,-1
2021-09-06,2021,TEX,LAA,4,0,122,1.5,-155,9.0,100,-120,-132,-1.5,135,4.05,Angel Stadium,4,4
2021-09-06,2021,STL,LAD,1,5,190,1.5,105,7.5,-115,-105,-210,-1.5,-125,2.59,Busch Stadium,6,-4
2021-09-06,2021,PHI,MIL,12,0,118,1.5,-185,7.0,-110,-110,-128,-1.5,165,3.21,Miller Park,12,12
2021-09-06,2021,CLE,MIN,2,5,110,1.5,-145,9.5,100,-120,-120,-1.5,125,4.52,Progressive Field,7,-3
2021-09-06,2021,WSH,NYM,4,3,112,1.5,-150,9.5,100,-120,-122,-1.5,130,4.48,Nationals Park,7,1
2021-09-06,2021,TOR,NYY,8,0,128,1.5,-145,10.0,-105,-115,-138,-1.5,125,4.39,Yankee Stadium,8,8
2021-09-06,2021,MIL,PHI,0,12,-128,-1.5,165,7.0,-110,-110,118,1.5,-185,3.93,Miller Park,12,-12
2021-09-06,2021,DET,PIT,3,6,-130,-1.5,120,8.5,-105,-115,120,1.5,-140,4.8,PNC Park,9,-3
2021-09-06,2021,HOU,SEA,11,2,-215,-1.5,-105,8.5,-115,-105,195,1.5,-115,5.8,Minute Maid Park,13,9
2021-09-06,2021,COL,SF,5,10,134,1.5,-120,10.5,-115,-105,-144,-1.5,100,4.49,Coors Field,15,-5
2021-09-06,2021,LAD,STL,5,1,-210,-1.5,-125,7.5,-115,-105,190,1.5,105,5.08,Busch Stadium,6,4
2021-09-06,2021,BOS,TB,10,11,-140,-1.5,135,10.0,-105,-115,130,1.5,-155,5.83,Fenway Park,21,-1
2021-09-06,2021,LAA,TEX,0,4,-132,-1.5,135,9.0,100,-120,122,1.5,-155,5.12,Angel Stadium,4,-4
2021-09-06,2021,NYY,TOR,0,8,-138,-1.5,125,10.0,-105,-115,128,1.5,-145,5.8,Yankee Stadium,8,-8
2021-09-06,2021,NYM,WSH,3,4,-122,-1.5,130,9.5,100,-120,112,1.5,-150,5.22,Nationals Park,7,-1
2021-09-07,2021,TEX,ARI,3,1,160,1.5,-140,8.5,-115,-105,-170,-1.5,120,3.27,Chase Field,4,2
2021-09-07,2021,WSH,ATL,5,8,230,1.5,110,9.0,-115,-105,-260,-1.5,-130,2.73,Suntrust Park,13,-3
2021-09-07,2021,KC,BAL,3,7,-120,-1.5,130,10.0,-120,100,110,1.5,-150,5.45,Camden Yards,10,-4
2021-09-07,2021,TB,BOS,12,7,102,1.5,-185,9.5,-120,100,-112,-1.5,165,4.7,Fenway Park,19,5
2021-09-07,2021,CIN,CHC,4,3,-139,-1.5,115,9.5,105,-125,129,1.5,-135,5.53,Wrigley Field,7,1
2021-09-07,2021,CHC,CIN,3,4,129,1.5,-135,9.5,105,-125,-139,-1.5,115,4.15,Wrigley Field,7,-1
2021-09-07,2021,MIN,CLE,3,0,118,1.5,-155,10.0,-120,100,-128,-1.5,135,4.59,Progressive Field,3,3
2021-09-07,2021,SF,COL,12,3,-220,-1.5,-140,12.0,-105,-115,200,1.5,120,8.25,Coors Field,15,9
2021-09-07,2021,OAK,CWS,3,6,-127,-1.5,150,9.0,-105,-115,117,1.5,-170,5.04,Oakland Coliseum,9,-3
2021-09-07,2021,PIT,DET,3,2,-110,-1.5,175,9.0,100,-120,100,1.5,-200,4.71,PNC Park,5,1
2021-09-07,2021,SEA,HOU,4,5,153,1.5,-135,8.5,-115,-105,-163,-1.5,115,3.36,Minute Maid Park,9,-1
2021-09-07,2021,BAL,KC,7,3,110,1.5,-150,10.0,-120,100,-120,-1.5,130,4.76,Camden Yards,10,4
2021-09-07,2021,SD,LAA,0,4,-310,-1.5,-155,7.5,-125,105,270,1.5,135,5.67,PETCO Park,4,-4
2021-09-07,2021,STL,LAD,2,7,135,1.5,-130,9.0,-105,-115,-145,-1.5,110,3.83,Busch Stadium,9,-5
2021-09-07,2021,NYM,MIA,9,4,-174,-1.5,-105,7.5,-115,-105,162,1.5,-115,4.76,Marlins Park,13,5
2021-09-07,2021,PHI,MIL,0,10,100,-1.5,155,8.5,-115,-105,-110,1.5,-175,4.25,Miller Park,10,-10
2021-09-07,2021,CLE,MIN,0,3,-128,-1.5,135,10.0,-120,100,118,1.5,-155,5.61,Progressive Field,3,-3
2021-09-07,2021,MIA,NYM,4,9,162,1.5,-115,7.5,-115,-105,-174,-1.5,-105,2.86,Marlins Park,13,-5
2021-09-07,2021,TOR,NYY,5,1,200,1.5,-115,8.0,-115,-105,-220,-1.5,-105,2.67,Yankee Stadium,6,4
2021-09-07,2021,CWS,OAK,6,3,117,1.5,-170,9.0,-105,-115,-127,-1.5,150,4.15,Oakland Coliseum,9,3
2021-09-07,2021,MIL,PHI,10,0,-110,1.5,-175,8.5,-115,-105,100,-1.5,155,4.45,Miller Park,10,10
2021-09-07,2021,DET,PIT,2,3,100,1.5,-200,9.0,100,-120,-110,-1.5,175,4.5,PNC Park,5,-1
2021-09-07,2021,LAA,SD,4,0,270,1.5,135,7.5,-125,105,-310,-1.5,-155,2.03,PETCO Park,4,4
2021-09-07,2021,HOU,SEA,5,4,-163,-1.5,115,8.5,-115,-105,153,1.5,-135,5.27,Minute Maid Park,9,1
2021-09-07,2021,COL,SF,3,12,200,1.5,120,12.0,-105,-115,-220,-1.5,-140,4.0,Coors Field,15,-9
2021-09-07,2021,LAD,STL,7,2,-145,-1.5,110,9.0,-105,-115,135,1.5,-130,5.33,Busch Stadium,9,5
2021-09-07,2021,BOS,TB,7,12,-112,-1.5,165,9.5,-120,100,102,1.5,-185,5.02,Fenway Park,19,-5
2021-09-07,2021,ARI,TEX,1,3,-170,-1.5,120,8.5,-115,-105,160,1.5,-140,5.35,Chase Field,4,-2
2021-09-07,2021,NYY,TOR,1,5,-220,-1.5,-105,8.0,-115,-105,200,1.5,-115,5.5,Yankee Stadium,6,-4
2021-09-07,2021,ATL,WSH,8,5,-260,-1.5,-130,9.0,-115,-105,230,1.5,110,6.5,Suntrust Park,13,3
2021-09-08,2021,TEX,ARI,8,5,143,1.5,-145,9.0,100,-120,-153,-1.5,125,3.7,Chase Field,13,3
2021-09-08,2021,WSH,ATL,4,2,180,1.5,-115,10.0,-110,-110,-200,-1.5,-105,3.57,Suntrust Park,6,2
2021-09-08,2021,KC,BAL,8,9,-121,-1.5,130,9.5,-110,-110,111,1.5,-150,5.2,Camden Yards,17,-1
2021-09-08,2021,TB,BOS,1,2,-101,1.5,-190,10.0,-105,-115,-109,-1.5,170,5.02,Fenway Park,3,-1
2021-09-08,2021,CIN,CHC,1,4,-110,-1.5,135,9.0,-110,-110,100,1.5,-155,4.71,Wrigley Field,5,-3
2021-09-08,2021,CHC,CIN,4,1,100,1.5,-155,9.0,-110,-110,-110,-1.5,135,4.5,Wrigley Field,5,3
2021-09-08,2021,MIN,CLE,3,0,114,1.5,-165,9.0,100,-120,-124,-1.5,145,4.21,Progressive Field,3,3
2021-09-08,2021,SF,COL,7,4,-137,-1.5,100,11.5,-105,-115,127,1.5,-120,6.65,Coors Field,11,3
2021-09-08,2021,OAK,CWS,5,1,-149,-1.5,130,8.5,-105,-115,139,1.5,-150,5.09,Oakland Coliseum,6,4
2021-09-08,2021,PIT,DET,1,5,-122,-1.5,160,9.0,-120,100,112,1.5,-180,4.95,PNC Park,6,-4
2021-09-08,2021,SEA,HOU,8,5,150,1.5,-135,8.5,100,-120,-160,-1.5,115,3.4,Minute Maid Park,13,3
2021-09-08,2021,BAL,KC,9,8,111,1.5,-150,9.5,-110,-110,-121,-1.5,130,4.5,Camden Yards,17,1
2021-09-08,2021,SD,LAA,8,5,-270,-1.5,-135,8.0,-120,100,240,1.5,115,5.84,PETCO Park,13,3
2021-09-08,2021,STL,LAD,5,4,117,1.5,-150,8.0,-115,-105,-127,-1.5,130,3.69,Busch Stadium,9,1
2021-09-08,2021,NYM,MIA,1,2,-105,-1.5,155,7.0,-115,-105,-105,1.5,-175,3.59,Marlins Park,3,-1
2021-09-08,2021,PHI,MIL,3,4,150,1.5,-140,8.0,-110,-110,-160,-1.5,120,3.2,Miller Park,7,-1
2021-09-08,2021,CLE,MIN,0,3,-124,-1.5,145,9.0,100,-120,114,1.5,-165,4.98,Progressive Field,3,-3
2021-09-08,2021,MIA,NYM,2,1,-105,1.5,-175,7.0,-115,-105,-105,-1.5,155,3.59,Marlins Park,3,1
2021-09-08,2021,TOR,NYY,6,3,116,1.5,-170,9.5,-110,-110,-126,-1.5,150,4.4,Yankee Stadium,9,3
2021-09-08,2021,CWS,OAK,1,5,139,1.5,-150,8.5,-105,-115,-149,-1.5,130,3.56,Oakland Coliseum,6,-4
2021-09-08,2021,MIL,PHI,4,3,-160,-1.5,120,8.0,-110,-110,150,1.5,-140,4.92,Miller Park,7,1
2021-09-08,2021,DET,PIT,5,1,112,1.5,-180,9.0,-120,100,-122,-1.5,160,4.25,PNC Park,6,4
2021-09-08,2021,LAA,SD,5,8,240,1.5,115,8.0,-120,100,-270,-1.5,-135,2.35,PETCO Park,13,-3
2021-09-08,2021,HOU,SEA,5,8,-160,-1.5,115,8.5,100,-120,150,1.5,-135,5.23,Minute Maid Park,13,-3
2021-09-08,2021,COL,SF,4,7,127,1.5,-120,11.5,-105,-115,-137,-1.5,100,5.07,Coors Field,11,-3
2021-09-08,2021,LAD,STL,4,5,-127,-1.5,130,8.0,-115,-105,117,1.5,-150,4.48,Busch Stadium,9,-1
2021-09-08,2021,BOS,TB,2,1,-109,-1.5,170,10.0,-105,-115,-101,1.5,-190,5.22,Fenway Park,3,1
2021-09-08,2021,ARI,TEX,5,8,-153,-1.5,125,9.0,100,-120,143,1.5,-145,5.44,Chase Field,13,-3
2021-09-08,2021,NYY,TOR,3,6,-126,-1.5,150,9.5,-110,-110,116,1.5,-170,5.3,Yankee Stadium,9,-3
2021-09-08,2021,ATL,WSH,2,4,-200,-1.5,-105,10.0,-110,-110,180,1.5,-115,6.67,Suntrust Park,6,-2
2021-09-09,2021,WSH,ATL,6,7,190,1.5,-105,9.0,-120,100,-210,-1.5,-115,3.1,Suntrust Park,13,-1
2021-09-09,2021,KC,BAL,6,0,106,1.5,-180,8.5,-115,-105,-116,-1.5,160,4.13,Camden Yards,6,6
2021-09-09,2021,MIN,CLE,1,4,148,1.5,-140,9.0,-110,-110,-158,-1.5,120,3.63,Progressive Field,5,-3
2021-09-09,2021,PHI,COL,3,4,-174,-1.5,110,8.0,-115,-105,162,1.5,-130,5.08,Citizens Bank Park,7,-1
2021-09-09,2021,OAK,CWS,3,1,-145,-1.5,135,7.5,-120,100,135,1.5,-155,4.44,Oakland Coliseum,4,2
2021-09-09,2021,BAL,KC,0,6,-116,-1.5,160,8.5,-115,-105,106,1.5,-180,4.56,Camden Yards,6,-6
2021-09-09,2021,STL,LAD,2,1,145,1.5,-120,9.0,100,-120,-155,-1.5,100,3.67,Busch Stadium,3,1
2021-09-09,2021,NYM,MIA,2,3,-167,-1.5,100,7.5,-115,-105,157,1.5,-120,4.69,Marlins Park,5,-1
2021-09-09,2021,CLE,MIN,4,1,-158,-1.5,120,9.0,-110,-110,148,1.5,-140,5.51,Progressive Field,5,3
2021-09-09,2021,MIA,NYM,3,2,157,1.5,-120,7.5,-115,-105,-167,-1.5,100,2.92,Marlins Park,5,1
2021-09-09,2021,TOR,NYY,6,4,101,1.5,-185,8.5,-115,-105,-111,-1.5,165,4.23,Yankee Stadium,10,2
2021-09-09,2021,CWS,OAK,1,3,135,1.5,-155,7.5,-120,100,-145,-1.5,135,3.19,Oakland Coliseum,4,-2
2021-09-09,2021,COL,PHI,4,3,162,1.5,-130,8.0,-115,-105,-174,-1.5,110,3.05,Citizens Bank Park,7,1
2021-09-09,2021,LAD,STL,1,2,-155,-1.5,100,9.0,100,-120,145,1.5,-120,5.47,Busch Stadium,3,-1
2021-09-09,2021,NYY,TOR,4,6,-111,-1.5,165,8.5,-115,-105,101,1.5,-185,4.47,Yankee Stadium,10,-2
2021-09-09,2021,ATL,WSH,7,6,-210,-1.5,-115,9.0,-120,100,190,1.5,-105,6.1,Suntrust Park,13,1
2021-09-10,2021,SEA,ARI,5,4,-149,-1.5,130,8.0,-115,-105,139,1.5,-150,4.79,T-Mobile Park,9,1
2021-09-10,2021,MIA,ATL,2,6,167,1.5,-125,8.0,-115,-105,-182,-1.5,105,3.0,Suntrust Park,8,-4
2021-09-10,2021,TOR,BAL,3,6,-295,-1.5,-180,9.0,-115,-105,255,1.5,160,6.72,Camden Yards,9,-3
2021-09-10,2021,CWS,BOS,4,3,-151,-1.5,130,8.5,-110,-110,141,1.5,-150,5.11,Guaranteed Rate Field,7,1
2021-09-10,2021,SF,CHC,6,1,-143,-1.5,110,9.5,-105,-115,133,1.5,-130,5.59,Wrigley Field,7,5
2021-09-10,2021,STL,CIN,2,4,108,1.5,-145,8.5,100,-120,-118,-1.5,125,4.09,Busch Stadium,6,-2
2021-09-10,2021,MIL,CLE,10,3,-134,-1.5,115,9.5,-105,-115,124,1.5,-135,5.44,Progressive Field,13,7
2021-09-10,2021,PHI,COL,2,11,-150,-1.5,135,8.5,100,-120,140,1.5,-155,5.1,Citizens Bank Park,13,-9
2021-09-10,2021,BOS,CWS,3,4,141,1.5,-150,8.5,-110,-110,-151,-1.5,130,3.53,Guaranteed Rate Field,7,-1
2021-09-10,2021,TB,DET,4,10,-154,-1.5,100,9.0,-115,-105,144,1.5,-120,5.46,Comerica Park,14,-6
2021-09-10,2021,LAA,HOU,5,10,178,1.5,-120,7.5,-115,-105,-196,-1.5,100,2.7,Minute Maid Park,15,-5
2021-09-10,2021,MIN,KC,4,6,-129,-1.5,145,9.5,-110,-110,119,1.5,-165,5.35,Target Field,10,-2
2021-09-10,2021,HOU,LAA,10,5,-196,-1.5,100,7.5,-115,-105,178,1.5,-120,4.97,Minute Maid Park,15,5
2021-09-10,2021,SD,LAD,0,3,146,1.5,-145,7.5,-115,-105,-156,-1.5,125,3.05,Dodger Stadium,3,-3
2021-09-10,2021,ATL,MIA,6,2,-182,-1.5,105,8.0,-115,-105,167,1.5,-125,5.16,Suntrust Park,8,4
2021-09-10,2021,CLE,MIL,3,10,124,1.5,-135,9.5,-105,-115,-134,-1.5,115,4.24,Progressive Field,13,-7
2021-09-10,2021,KC,MIN,6,4,119,1.5,-165,9.5,-110,-110,-129,-1.5,145,4.34,Target Field,10,2
2021-09-10,2021,NYY,NYM,3,10,-116,-1.5,135,8.0,100,-120,106,1.5,-155,4.3,Citi Field,13,-7
2021-09-10,2021,NYM,NYY,10,3,106,1.5,-155,8.0,100,-120,-116,-1.5,135,3.88,Citi Field,13,7
2021-09-10,2021,TEX,OAK,5,10,160,1.5,-135,8.5,-105,-115,-170,-1.5,115,3.27,Oakland Coliseum,15,-5
2021-09-10,2021,COL,PHI,11,2,140,1.5,-155,8.5,100,-120,-150,-1.5,135,3.54,Citizens Bank Park,13,9
2021-09-10,2021,WSH,PIT,3,4,113,1.5,-185,9.0,100,-120,-123,-1.5,165,4.23,PNC Park,7,-1
2021-09-10,2021,LAD,SD,3,0,-156,-1.5,125,7.5,-115,-105,146,1.5,-145,4.57,Dodger Stadium,3,3
2021-09-10,2021,ARI,SEA,4,5,139,1.5,-150,8.0,-115,-105,-149,-1.5,130,3.35,T-Mobile Park,9,-1
2021-09-10,2021,CHC,SF,1,6,133,1.5,-130,9.5,-105,-115,-143,-1.5,110,4.08,Wrigley Field,7,-5
2021-09-10,2021,CIN,STL,4,2,-118,-1.5,125,8.5,100,-120,108,1.5,-145,4.6,Busch Stadium,6,2
2021-09-10,2021,DET,TB,10,4,144,1.5,-120,9.0,-115,-105,-154,-1.5,100,3.69,Comerica Park,14,6
2021-09-10,2021,OAK,TEX,10,5,-170,-1.5,115,8.5,-105,-115,160,1.5,-135,5.35,Oakland Coliseum,15,5
2021-09-10,2021,BAL,TOR,6,3,255,1.5,160,9.0,-115,-105,-295,-1.5,-180,2.54,Camden Yards,9,3
2021-09-10,2021,PIT,WSH,4,3,-123,-1.5,165,9.0,100,-120,113,1.5,-185,4.96,PNC Park,7,1
2021-09-11,2021,SEA,ARI,3,7,-170,-1.5,110,8.5,-115,-105,160,1.5,-130,5.35,T-Mobile Park,10,-4
2021-09-11,2021,MIA,ATL,6,4,215,1.5,100,7.5,-120,100,-245,-1.5,-120,2.38,Suntrust Park,10,2
2021-09-11,2021,TOR,BAL,11,10,-240,-1.5,-140,7.5,-115,-105,210,1.5,120,5.29,Camden Yards,21,1
2021-09-11,2021,TOR,BAL,11,2,-190,-1.5,-130,8.0,-120,100,175,1.5,110,5.24,Camden Yards,13,9
2021-09-11,2021,CWS,BOS,8,9,-174,-1.5,110,9.5,-105,-115,162,1.5,-130,6.03,Guaranteed Rate Field,17,-1
2021-09-11,2021,SF,CHC,15,4,-200,-1.5,-140,10.5,-115,-105,180,1.5,120,7.0,Wrigley Field,19,11
2021-09-11,2021,STL,CIN,6,4,103,1.5,-160,8.0,-105,-115,-113,-1.5,140,3.94,Busch Stadium,10,2
2021-09-11,2021,MIL,CLE,3,0,-192,-1.5,-110,9.0,100,-120,176,1.5,-110,5.92,Progressive Field,3,3
2021-09-11,2021,PHI,COL,6,1,-215,-1.5,100,7.5,-110,-110,195,1.5,-120,5.12,Citizens Bank Park,7,5
2021-09-11,2021,BOS,CWS,9,8,162,1.5,-130,9.5,-105,-115,-174,-1.5,110,3.63,Guaranteed Rate Field,17,1
2021-09-11,2021,TB,DET,7,2,-152,-1.5,100,9.5,-105,-115,142,1.5,-120,5.73,Comerica Park,9,5
2021-09-11,2021,LAA,HOU,4,2,210,1.5,105,8.5,-115,-105,-240,-1.5,-125,2.74,Minute Maid Park,6,2
2021-09-11,2021,MIN,KC,9,2,-138,-1.5,135,9.0,-115,-105,128,1.5,-155,5.22,Target Field,11,7
2021-09-11,2021,HOU,LAA,2,4,-240,-1.5,-125,8.5,-115,-105,210,1.5,105,6.0,Minute Maid Park,6,-2
2021-09-11,2021,SD,LAD,4,5,190,1.5,-115,8.0,-115,-105,-210,-1.5,-105,2.76,Dodger Stadium,9,-1
2021-09-11,2021,ATL,MIA,4,6,-245,-1.5,-120,7.5,-120,100,215,1.5,100,5.33,Suntrust Park,10,-2
2021-09-11,2021,CLE,MIL,0,3,176,1.5,-110,9.0,100,-120,-192,-1.5,-110,3.26,Progressive Field,3,-3
2021-09-11,2021,KC,MIN,2,9,128,1.5,-155,9.0,-115,-105,-138,-1.5,135,3.95,Target Field,11,-7
2021-09-11,2021,NYY,NYM,8,7,-111,-1.5,135,8.0,-105,-115,101,1.5,-155,4.21,Citi Field,15,1
2021-09-11,2021,NYM,NYY,7,8,101,1.5,-155,8.0,-105,-115,-111,-1.5,135,3.98,Citi Field,15,-1
2021-09-11,2021,TEX,OAK,8,6,176,1.5,-120,9.0,-105,-115,-192,-1.5,100,3.26,Oakland Coliseum,14,2
2021-09-11,2021,COL,PHI,1,6,195,1.5,-120,7.5,-110,-110,-215,-1.5,100,2.54,Citizens Bank Park,7,-5
2021-09-11,2021,WSH,PIT,7,10,-132,-1.5,120,9.0,-120,100,122,1.5,-140,5.12,PNC Park,17,-3
2021-09-11,2021,LAD,SD,5,4,-210,-1.5,-105,8.0,-115,-105,190,1.5,-115,5.42,Dodger Stadium,9,1
2021-09-11,2021,ARI,SEA,7,3,160,1.5,-130,8.5,-115,-105,-170,-1.5,110,3.27,T-Mobile Park,10,4
2021-09-11,2021,CHC,SF,4,15,180,1.5,120,10.5,-115,-105,-200,-1.5,-140,3.75,Wrigley Field,19,-11
2021-09-11,2021,CIN,STL,4,6,-113,-1.5,140,8.0,-105,-115,103,1.5,-160,4.24,Busch Stadium,10,-2
2021-09-11,2021,DET,TB,2,7,142,1.5,-120,9.5,-105,-115,-152,-1.5,100,3.93,Comerica Park,9,-5
2021-09-11,2021,OAK,TEX,6,8,-192,-1.5,100,9.0,-105,-115,176,1.5,-120,5.92,Oakland Coliseum,14,-2
2021-09-11,2021,BAL,TOR,10,11,210,1.5,120,7.5,-115,-105,-240,-1.5,-140,2.42,Camden Yards,21,-1
2021-09-11,2021,BAL,TOR,2,11,175,1.5,110,8.0,-120,100,-190,-1.5,-130,2.91,Camden Yards,13,-9
2021-09-11,2021,PIT,WSH,10,7,122,1.5,-140,9.0,-120,100,-132,-1.5,120,4.05,PNC Park,17,3
2021-09-12,2021,SEA,ARI,4,5,-160,-1.5,115,8.0,-115,-105,150,1.5,-135,4.92,T-Mobile Park,9,-1
2021-09-12,2021,MIA,ATL,3,5,245,1.5,110,8.5,-105,-115,-280,-1.5,-130,2.46,Suntrust Park,8,-2
2021-09-12,2021,TOR,BAL,22,7,-200,-1.5,-140,11.0,-110,-110,180,1.5,120,7.33,Camden Yards,29,15
2021-09-12,2021,CWS,BOS,2,1,-160,-1.5,120,9.0,-115,-105,150,1.5,-140,5.54,Guaranteed Rate Field,3,1
2021-09-12,2021,SF,CHC,6,5,-210,-1.5,-130,9.0,-115,-105,190,1.5,110,6.1,Wrigley Field,11,1
2021-09-12,2021,STL,CIN,2,0,105,1.5,-155,9.0,100,-120,-115,-1.5,135,4.39,Busch Stadium,2,2
2021-09-12,2021,MIL,CLE,11,1,-110,-1.5,135,9.5,-105,-115,100,1.5,-155,4.98,Progressive Field,12,10
2021-09-12,2021,PHI,COL,4,5,-275,-1.5,-140,9.0,-115,-105,245,1.5,120,6.6,Citizens Bank Park,9,-1
2021-09-12,2021,BOS,CWS,1,2,150,1.5,-140,9.0,-115,-105,-160,-1.5,120,3.6,Guaranteed Rate Field,3,-1
2021-09-12,2021,TB,DET,7,8,-145,-1.5,100,9.0,100,-120,135,1.5,-120,5.33,Comerica Park,15,-1
2021-09-12,2021,LAA,HOU,1,3,250,1.5,120,8.5,-120,100,-290,-1.5,-140,2.43,Minute Maid Park,4,-2
2021-09-12,2021,MIN,KC,3,5,-162,-1.5,120,8.5,-115,-105,152,1.5,-140,5.26,Target Field,8,-2
2021-09-12,2021,HOU,LAA,3,1,-290,-1.5,-140,8.5,-120,100,250,1.5,120,6.32,Minute Maid Park,4,2
2021-09-12,2021,SD,LAD,0,8,152,1.5,-145,7.5,-105,-115,-162,-1.5,125,2.98,Dodger Stadium,8,-8
2021-09-12,2021,ATL,MIA,5,3,-280,-1.5,-130,8.5,-105,-115,245,1.5,110,6.26,Suntrust Park,8,2
2021-09-12,2021,CLE,MIL,1,11,100,1.5,-155,9.5,-105,-115,-110,-1.5,135,4.75,Progressive Field,12,-10
2021-09-12,2021,KC,MIN,5,3,152,1.5,-140,8.5,-115,-105,-162,-1.5,120,3.37,Target Field,8,2
2021-09-12,2021,NYY,NYM,6,7,105,1.5,-200,8.5,-120,100,-115,-1.5,175,4.15,Citi Field,13,-1
2021-09-12,2021,NYM,NYY,7,6,-115,-1.5,175,8.5,-120,100,105,1.5,-200,4.55,Citi Field,13,1
2021-09-12,2021,TEX,OAK,4,3,165,1.5,-135,8.0,-120,100,-180,-1.5,115,3.02,Oakland Coliseum,7,1
2021-09-12,2021,COL,PHI,5,4,245,1.5,120,9.0,-115,-105,-275,-1.5,-140,2.61,Citizens Bank Park,9,1
2021-09-12,2021,WSH,PIT,6,2,-122,-1.5,130,9.0,105,-125,112,1.5,-150,4.95,PNC Park,8,4
2021-09-12,2021,LAD,SD,8,0,-162,-1.5,125,7.5,-105,-115,152,1.5,-145,4.64,Dodger Stadium,8,8
2021-09-12,2021,ARI,SEA,5,4,150,1.5,-135,8.0,-115,-105,-160,-1.5,115,3.2,T-Mobile Park,9,1
2021-09-12,2021,CHC,SF,5,6,190,1.5,110,9.0,-115,-105,-210,-1.5,-130,3.1,Wrigley Field,11,-1
2021-09-12,2021,CIN,STL,0,2,-115,-1.5,135,9.0,100,-120,105,1.5,-155,4.81,Busch Stadium,2,-2
2021-09-12,2021,DET,TB,8,7,135,1.5,-120,9.0,100,-120,-145,-1.5,100,3.83,Comerica Park,15,1
2021-09-12,2021,OAK,TEX,3,4,-180,-1.5,115,8.0,-120,100,165,1.5,-135,5.14,Oakland Coliseum,7,-1
2021-09-12,2021,BAL,TOR,7,22,180,1.5,120,11.0,-110,-110,-200,-1.5,-140,3.93,Camden Yards,29,-15
2021-09-12,2021,PIT,WSH,2,6,112,1.5,-150,9.0,105,-125,-122,-1.5,130,4.25,PNC Park,8,-4
2021-09-13,2021,LAD,ARI,5,1,-298,-1.5,-140,8.0,100,-120,258,1.5,120,5.99,Dodger Stadium,6,4
2021-09-13,2021,SEA,BOS,5,4,110,1.5,-150,8.0,-105,-115,-120,-1.5,130,3.81,T-Mobile Park,9,1
2021-09-13,2021,TEX,HOU,1,15,164,1.5,100,9.0,100,-120,-178,-1.5,-120,3.41,Globe Life Field,16,-14
2021-09-13,2021,ARI,LAD,1,5,258,1.5,120,8.0,100,-120,-298,-1.5,-140,2.23,Dodger Stadium,6,-4
2021-09-13,2021,WSH,MIA,0,3,-102,1.5,-175,7.5,-115,-105,-108,-1.5,155,3.79,Nationals Park,3,-3
2021-09-13,2021,NYY,MIN,6,5,-166,-1.5,110,10.0,-115,-105,156,1.5,-130,6.24,Yankee Stadium,11,1
2021-09-13,2021,STL,NYM,7,0,-103,-1.5,155,8.0,100,-120,-107,1.5,-175,4.06,Citi Field,7,7
2021-09-13,2021,MIN,NYY,5,6,156,1.5,-130,10.0,-115,-105,-166,-1.5,110,3.91,Yankee Stadium,11,-1
2021-09-13,2021,SF,SD,9,1,-104,-1.5,180,8.0,-110,-110,-106,1.5,-205,4.08,AT&T Park,10,8
2021-09-13,2021,BOS,SEA,4,5,-120,-1.5,130,8.0,-105,-115,110,1.5,-150,4.36,T-Mobile Park,9,-1
2021-09-13,2021,SD,SF,1,9,-106,1.5,-205,8.0,-110,-110,-104,-1.5,180,4.12,AT&T Park,10,-8
2021-09-13,2021,NYM,STL,0,7,-107,1.5,-175,8.0,100,-120,-103,-1.5,155,4.14,Citi Field,7,-7
2021-09-13,2021,TOR,TB,8,1,-130,-1.5,145,9.0,-105,-115,120,1.5,-165,5.09,Rogers Centre,9,7
2021-09-13,2021,HOU,TEX,15,1,-178,-1.5,-120,9.0,100,-120,164,1.5,100,5.76,Globe Life Field,16,14
2021-09-13,2021,TB,TOR,1,8,120,1.5,-165,9.0,-105,-115,-130,-1.5,145,4.09,Rogers Centre,9,-7
2021-09-13,2021,MIA,WSH,3,0,-108,-1.5,155,7.5,-115,-105,-102,1.5,-175,3.89,Nationals Park,3,3
2021-09-14,2021,LAD,ARI,8,4,-250,-1.5,-130,9.0,-105,-115,220,1.5,110,6.43,Dodger Stadium,12,4
2021-09-14,2021,COL,ATL,5,4,137,1.5,-150,9.0,-115,-105,-147,-1.5,130,3.8,Suntrust Park,9,1
2021-09-14,2021,NYY,BAL,7,2,-340,-1.5,-200,9.5,-110,-110,290,1.5,175,7.34,Camden Yards,9,5
2021-09-14,2021,SEA,BOS,4,8,126,1.5,-135,8.0,-110,-110,-136,-1.5,115,3.54,T-Mobile Park,12,-4
2021-09-14,2021,PHI,CHC,3,6,-188,-1.5,100,9.5,105,-125,173,1.5,-120,6.2,Citizens Bank Park,9,-3
2021-09-14,2021,PIT,CIN,6,5,144,1.5,-130,8.5,-120,100,-154,-1.5,110,3.48,PNC Park,11,1
2021-09-14,2021,MIN,CLE,1,3,-120,-1.5,175,6.0,-125,105,110,1.5,-195,3.27,Target Field,4,-2
2021-09-14,2021,MIN,CLE,6,3,-126,-1.5,170,7.5,-115,-105,116,1.5,-190,4.18,Target Field,9,3
2021-09-14,2021,ATL,COL,4,5,-147,-1.5,130,9.0,-115,-105,137,1.5,-150,5.36,Suntrust Park,9,-1
2021-09-14,2021,LAA,CWS,3,9,230,1.5,115,9.0,-105,-115,-260,-1.5,-135,2.73,Guaranteed Rate Field,12,-6
2021-09-14,2021,MIL,DET,0,1,-210,-1.5,-135,9.0,-105,-115,190,1.5,115,6.1,Comerica Park,1,-1
2021-09-14,2021,TEX,HOU,8,1,175,1.5,100,9.0,-115,-105,-190,-1.5,-120,3.27,Globe Life Field,9,7
2021-09-14,2021,OAK,KC,7,10,-158,-1.5,-105,9.0,100,-120,148,1.5,-115,5.51,Kauffman Stadium,17,-3
2021-09-14,2021,CWS,LAA,9,3,-260,-1.5,-135,9.0,-105,-115,230,1.5,115,6.5,Guaranteed Rate Field,12,6
2021-09-14,2021,ARI,LAD,4,8,220,1.5,110,9.0,-105,-115,-250,-1.5,-130,2.81,Dodger Stadium,12,-4
2021-09-14,2021,WSH,MIA,8,2,-144,-1.5,145,8.5,-110,-110,134,1.5,-165,5.02,Nationals Park,10,6
2021-09-14,2021,DET,MIL,1,0,190,1.5,115,9.0,-105,-115,-210,-1.5,-135,3.1,Comerica Park,1,1
2021-09-14,2021,CLE,MIN,3,1,110,1.5,-195,6.0,-125,105,-120,-1.5,175,2.86,Target Field,4,2
2021-09-14,2021,CLE,MIN,3,6,116,1.5,-190,7.5,-115,-105,-126,-1.5,170,3.47,Target Field,9,-3
2021-09-14,2021,STL,NYM,7,6,160,1.5,-140,8.0,-105,-115,-170,-1.5,120,3.08,Citi Field,13,1
2021-09-14,2021,BAL,NYY,2,7,290,1.5,175,9.5,-110,-110,-340,-1.5,-200,2.44,Camden Yards,9,-5
2021-09-14,2021,KC,OAK,10,7,148,1.5,-115,9.0,100,-120,-158,-1.5,-105,3.63,Kauffman Stadium,17,3
2021-09-14,2021,CHC,PHI,6,3,173,1.5,-120,9.5,105,-125,-188,-1.5,100,3.48,Citizens Bank Park,9,3
2021-09-14,2021,CIN,PIT,5,6,-154,-1.5,110,8.5,-120,100,144,1.5,-130,5.15,PNC Park,11,-1
2021-09-14,2021,SF,SD,6,1,-190,-1.5,100,9.0,-110,-110,175,1.5,-120,5.9,AT&T Park,7,5
2021-09-14,2021,BOS,SEA,8,4,-136,-1.5,115,8.0,-110,-110,126,1.5,-135,4.61,T-Mobile Park,12,4
2021-09-14,2021,SD,SF,1,6,175,1.5,-120,9.0,-110,-110,-190,-1.5,100,3.27,AT&T Park,7,-5
2021-09-14,2021,NYM,STL,6,7,-170,-1.5,120,8.0,-105,-115,160,1.5,-140,5.04,Citi Field,13,-1
2021-09-14,2021,TOR,TB,0,2,-140,-1.5,135,9.0,-115,-105,130,1.5,-155,5.25,Rogers Centre,2,-2
2021-09-14,2021,HOU,TEX,1,8,-190,-1.5,-120,9.0,-115,-105,175,1.5,100,5.9,Globe Life Field,9,-7
2021-09-14,2021,TB,TOR,2,0,130,1.5,-155,9.0,-115,-105,-140,-1.5,135,3.91,Rogers Centre,2,2
2021-09-14,2021,MIA,WSH,2,8,134,1.5,-165,8.5,-110,-110,-144,-1.5,145,3.63,Nationals Park,10,-6
2021-09-15,2021,LAD,ARI,5,3,-380,-1.5,-175,8.0,-105,-115,320,1.5,155,6.33,Dodger Stadium,8,2
2021-09-15,2021,COL,ATL,3,2,186,1.5,-110,9.0,100,-120,-206,-1.5,-110,3.15,Suntrust Park,5,1
2021-09-15,2021,NYY,BAL,4,3,-159,-1.5,-110,10.0,-105,-115,149,1.5,-110,6.14,Camden Yards,7,1
2021-09-15,2021,SEA,BOS,4,9,118,1.5,-145,8.5,-115,-105,-128,-1.5,125,3.9,T-Mobile Park,13,-5
2021-09-15,2021,PHI,CHC,6,5,-196,-1.5,105,9.0,-110,-110,178,1.5,-125,5.96,Citizens Bank Park,11,1
2021-09-15,2021,PIT,CIN,5,4,119,1.5,-140,9.0,-105,-115,-129,-1.5,120,4.11,PNC Park,9,1
2021-09-15,2021,MIN,CLE,3,12,-112,-1.5,170,9.0,-125,105,102,1.5,-190,4.75,Target Field,15,-9
2021-09-15,2021,ATL,COL,2,3,-206,-1.5,-110,9.0,100,-120,186,1.5,-110,6.06,Suntrust Park,5,-1
2021-09-15,2021,LAA,CWS,3,2,200,1.5,105,9.5,105,-125,-220,-1.5,-125,3.17,Guaranteed Rate Field,5,1
2021-09-15,2021,MIL,DET,1,4,-240,-1.5,-145,8.5,-115,-105,210,1.5,125,6.0,Comerica Park,5,-3
2021-09-15,2021,TEX,HOU,2,7,169,1.5,100,9.0,100,-120,-184,-1.5,-120,3.35,Globe Life Field,9,-5
2021-09-15,2021,OAK,KC,12,10,-131,-1.5,120,8.5,-115,-105,121,1.5,-140,4.82,Kauffman Stadium,22,2
2021-09-15,2021,CWS,LAA,2,3,-220,-1.5,-125,9.5,105,-125,200,1.5,105,6.53,Guaranteed Rate Field,5,-1
2021-09-15,2021,ARI,LAD,3,5,320,1.5,155,8.0,-105,-115,-380,-1.5,-175,1.9,Dodger Stadium,8,-2
2021-09-15,2021,WSH,MIA,6,8,110,1.5,-155,9.0,100,-120,-120,-1.5,135,4.29,Nationals Park,14,-2
2021-09-15,2021,DET,MIL,4,1,210,1.5,125,8.5,-115,-105,-240,-1.5,-145,2.74,Comerica Park,5,3
2021-09-15,2021,CLE,MIN,12,3,102,1.5,-190,9.0,-125,105,-112,-1.5,170,4.46,Target Field,15,9
2021-09-15,2021,STL,NYM,11,4,158,1.5,-145,8.5,-110,-110,-168,-1.5,125,3.29,Citi Field,15,7
2021-09-15,2021,BAL,NYY,3,4,149,1.5,-110,10.0,-105,-115,-159,-1.5,-110,4.02,Camden Yards,7,-1
2021-09-15,2021,KC,OAK,10,12,121,1.5,-140,8.5,-115,-105,-131,-1.5,120,3.85,Kauffman Stadium,22,-2
2021-09-15,2021,CHC,PHI,5,6,178,1.5,-125,9.0,-110,-110,-196,-1.5,105,3.24,Citizens Bank Park,11,-1
2021-09-15,2021,CIN,PIT,4,5,-129,-1.5,120,9.0,-105,-115,119,1.5,-140,5.07,PNC Park,9,-1
2021-09-15,2021,SF,SD,6,9,-108,-1.5,185,8.5,100,-120,-102,1.5,-210,4.41,AT&T Park,15,-3
2021-09-15,2021,BOS,SEA,9,4,-128,-1.5,125,8.5,-115,-105,118,1.5,-145,4.77,T-Mobile Park,13,5
2021-09-15,2021,SD,SF,9,6,-102,1.5,-210,8.5,100,-120,-108,-1.5,185,4.29,AT&T Park,15,3
2021-09-15,2021,NYM,STL,4,11,-168,-1.5,125,8.5,-110,-110,158,1.5,-145,5.33,Citi Field,15,-7
2021-09-15,2021,TOR,TB,6,3,-174,-1.5,100,9.0,100,-120,162,1.5,-120,5.72,Rogers Centre,9,3
2021-09-15,2021,HOU,TEX,7,2,-184,-1.5,-120,9.0,100,-120,169,1.5,100,5.83,Globe Life Field,9,5
2021-09-15,2021,TB,TOR,3,6,162,1.5,-120,9.0,100,-120,-174,-1.5,100,3.44,Rogers Centre,9,-3
2021-09-15,2021,MIA,WSH,8,6,-120,-1.5,135,9.0,100,-120,110,1.5,-155,4.91,Nationals Park,14,2
2021-09-16,2021,NYY,BAL,2,3,-230,-1.5,-150,10.5,-105,-115,205,1.5,130,7.32,Camden Yards,5,-1
2021-09-16,2021,PHI,CHC,17,8,-150,-1.5,130,9.0,-115,-105,140,1.5,-150,5.4,Citizens Bank Park,25,9
2021-09-16,2021,PIT,CIN,0,1,147,1.5,-120,8.0,-120,100,-157,-1.5,100,3.24,PNC Park,1,-1
2021-09-16,2021,LAA,CWS,9,3,160,1.5,-135,8.0,-120,100,-170,-1.5,115,3.08,Guaranteed Rate Field,12,6
2021-09-16,2021,TB,DET,5,2,-200,-1.5,-105,8.5,-110,-110,180,1.5,-115,5.67,Tropicana Field,7,3
2021-09-16,2021,TEX,HOU,1,12,151,1.5,-115,8.5,-120,100,-161,-1.5,-105,3.39,Globe Life Field,13,-11
2021-09-16,2021,OAK,KC,7,2,-116,-1.5,125,10.5,105,-125,106,1.5,-145,5.64,Kauffman Stadium,9,5
2021-09-16,2021,CWS,LAA,3,9,-170,-1.5,115,8.0,-120,100,160,1.5,-135,5.04,Guaranteed Rate Field,12,-6
2021-09-16,2021,BAL,NYY,3,2,205,1.5,130,10.5,-105,-115,-230,-1.5,-150,3.44,Camden Yards,5,1
2021-09-16,2021,KC,OAK,2,7,106,1.5,-145,10.5,105,-125,-116,-1.5,125,5.1,Kauffman Stadium,9,-5
2021-09-16,2021,CHC,PHI,8,17,140,1.5,-150,9.0,-115,-105,-150,-1.5,130,3.75,Citizens Bank Park,25,-9
2021-09-16,2021,CIN,PIT,1,0,-157,-1.5,100,8.0,-120,100,147,1.5,-120,4.89,PNC Park,1,1
2021-09-16,2021,SF,SD,4,7,-180,-1.5,105,8.0,-115,-105,165,1.5,-125,5.14,AT&T Park,11,-3
2021-09-16,2021,SD,SF,7,4,165,1.5,-125,8.0,-115,-105,-180,-1.5,105,3.02,AT&T Park,11,3
2021-09-16,2021,DET,TB,2,5,180,1.5,-115,8.5,-110,-110,-200,-1.5,-105,3.04,Tropicana Field,7,-3
2021-09-16,2021,HOU,TEX,12,1,-161,-1.5,-105,8.5,-120,100,151,1.5,-115,5.24,Globe Life Field,13,11
2021-09-17,2021,HOU,ARI,4,3,-216,-1.5,-120,9.0,-120,100,196,1.5,100,6.15,Minute Maid Park,7,1
2021-09-17,2021,SF,ATL,6,5,-159,-1.5,135,8.0,100,-120,149,1.5,-155,4.91,AT&T Park,11,1
2021-09-17,2021,BOS,BAL,7,1,-314,-1.5,-160,9.5,-105,-115,274,1.5,140,7.21,Fenway Park,8,6
2021-09-17,2021,BAL,BOS,1,7,274,1.5,140,9.5,-105,-115,-314,-1.5,-160,2.54,Fenway Park,8,-6
2021-09-17,2021,MIL,CHC,8,5,-220,-1.5,-120,9.0,-105,-115,200,1.5,100,6.19,Miller Park,13,3
2021-09-17,2021,LAD,CIN,1,3,-163,-1.5,-105,8.5,-120,100,153,1.5,-115,5.27,Great American Ballpark,4,-2
2021-09-17,2021,NYY,CLE,8,0,-202,-1.5,-105,9.0,100,-120,182,1.5,-115,6.02,Yankee Stadium,8,8
2021-09-17,2021,WSH,COL,8,9,106,1.5,-160,8.5,-125,105,-116,-1.5,140,4.13,Nationals Park,17,-1
2021-09-17,2021,TEX,CWS,0,8,165,1.5,-105,8.5,-105,-115,-179,-1.5,-115,3.21,Globe Life Field,8,-8
2021-09-17,2021,TB,DET,7,4,-198,-1.5,100,8.5,-120,100,179,1.5,-120,5.65,Tropicana Field,11,3
2021-09-17,2021,ARI,HOU,3,4,196,1.5,100,9.0,-120,100,-216,-1.5,-120,3.04,Minute Maid Park,7,-1
2021-09-17,2021,SEA,KC,6,2,-110,-1.5,140,9.0,-110,-110,100,1.5,-160,4.71,Kauffman Stadium,8,4
2021-09-17,2021,OAK,LAA,5,4,-134,-1.5,120,9.0,-120,100,124,1.5,-140,5.15,Angel Stadium,9,1
2021-09-17,2021,CIN,LAD,3,1,153,1.5,-115,8.5,-120,100,-163,-1.5,-105,3.36,Great American Ballpark,4,2
2021-09-17,2021,PIT,MIA,2,1,140,1.5,-150,7.5,-115,-105,-150,-1.5,130,3.13,Marlins Park,3,1
2021-09-17,2021,CHC,MIL,5,8,200,1.5,100,9.0,-105,-115,-220,-1.5,-120,3.0,Miller Park,13,-3
2021-09-17,2021,TOR,MIN,3,7,-202,-1.5,-110,9.5,100,-120,182,1.5,-110,6.35,Rogers Centre,10,-4
2021-09-17,2021,PHI,NYM,4,3,-127,-1.5,135,7.5,100,-120,117,1.5,-155,4.2,Citi Field,7,1
2021-09-17,2021,CLE,NYY,0,8,182,1.5,-115,9.0,100,-120,-202,-1.5,-105,3.19,Yankee Stadium,8,-8
2021-09-17,2021,LAA,OAK,4,5,124,1.5,-140,9.0,-120,100,-134,-1.5,120,4.02,Angel Stadium,9,-1
2021-09-17,2021,NYM,PHI,3,4,117,1.5,-155,7.5,100,-120,-127,-1.5,135,3.46,Citi Field,7,-1
2021-09-17,2021,MIA,PIT,1,2,-150,-1.5,130,7.5,-115,-105,140,1.5,-150,4.5,Marlins Park,3,-1
2021-09-17,2021,STL,SD,8,2,-115,-1.5,160,9.0,-105,-115,105,1.5,-180,4.81,Busch Stadium,10,6
2021-09-17,2021,KC,SEA,2,6,100,1.5,-160,9.0,-110,-110,-110,-1.5,140,4.5,Kauffman Stadium,8,-4
2021-09-17,2021,ATL,SF,5,6,149,1.5,-155,8.0,100,-120,-159,-1.5,135,3.21,AT&T Park,11,-1
2021-09-17,2021,SD,STL,2,8,105,1.5,-180,9.0,-105,-115,-115,-1.5,160,4.39,Busch Stadium,10,-6
2021-09-17,2021,DET,TB,4,7,179,1.5,-120,8.5,-120,100,-198,-1.5,100,3.05,Tropicana Field,11,-3
2021-09-17,2021,CWS,TEX,8,0,-179,-1.5,-115,8.5,-105,-115,165,1.5,-105,5.45,Globe Life Field,8,8
2021-09-17,2021,MIN,TOR,7,3,182,1.5,-110,9.5,100,-120,-202,-1.5,-110,3.37,Rogers Centre,10,4
2021-09-17,2021,COL,WSH,9,8,-116,-1.5,140,8.5,-125,105,106,1.5,-160,4.56,Nationals Park,17,1
2021-09-18,2021,HOU,ARI,4,6,-280,-1.5,-140,8.5,-120,100,245,1.5,120,6.26,Minute Maid Park,10,-2
2021-09-18,2021,SF,ATL,2,0,-106,-1.5,175,7.5,-110,-110,-104,1.5,-200,3.86,AT&T Park,2,2
2021-09-18,2021,BOS,BAL,9,3,-280,-1.5,-160,10.5,-110,-110,245,1.5,140,7.74,Fenway Park,12,6
2021-09-18,2021,BAL,BOS,3,9,245,1.5,140,10.5,-110,-110,-280,-1.5,-160,3.04,Fenway Park,12,-6
2021-09-18,2021,MIL,CHC,6,4,-315,-1.5,-145,7.5,-105,-115,275,1.5,125,5.69,Miller Park,10,2
2021-09-18,2021,LAD,CIN,5,1,-205,-1.5,-125,8.0,-110,-110,185,1.5,105,5.38,Great American Ballpark,6,4
2021-09-18,2021,NYY,CLE,3,11,-190,-1.5,100,9.5,-105,-115,175,1.5,-120,6.22,Yankee Stadium,14,-8
2021-09-18,2021,WSH,COL,0,6,-130,-1.5,155,9.0,-115,-105,120,1.5,-175,5.09,Nationals Park,6,-6
2021-09-18,2021,TEX,CWS,2,1,204,1.5,120,8.5,-120,100,-224,-1.5,-140,2.8,Globe Life Field,3,1
2021-09-18,2021,TB,DET,3,4,-178,-1.5,105,8.5,-105,-115,164,1.5,-125,5.44,Tropicana Field,7,-1
2021-09-18,2021,ARI,HOU,6,4,245,1.5,120,8.5,-120,100,-280,-1.5,-140,2.46,Minute Maid Park,10,2
2021-09-18,2021,SEA,KC,1,8,100,-1.5,145,9.0,-115,-105,-110,1.5,-165,4.5,Kauffman Stadium,9,-7
2021-09-18,2021,OAK,LAA,3,1,-114,-1.5,135,9.0,-115,-105,104,1.5,-155,4.79,Angel Stadium,4,2
2021-09-18,2021,CIN,LAD,1,5,185,1.5,105,8.0,-110,-110,-205,-1.5,-125,2.81,Great American Ballpark,6,-4
2021-09-18,2021,PIT,MIA,6,3,119,1.5,-175,8.0,-105,-115,-129,-1.5,155,3.65,Marlins Park,9,3
2021-09-18,2021,CHC,MIL,4,6,275,1.5,125,7.5,-105,-115,-315,-1.5,-145,2.0,Miller Park,10,-2
2021-09-18,2021,TOR,MIN,6,2,-162,-1.5,110,9.5,100,-120,152,1.5,-130,5.87,Rogers Centre,8,4
2021-09-18,2021,PHI,NYM,5,3,-108,-1.5,155,7.5,-120,100,-102,1.5,-175,3.89,Citi Field,8,2
2021-09-18,2021,CLE,NYY,11,3,175,1.5,-120,9.5,-105,-115,-190,-1.5,100,3.45,Yankee Stadium,14,8
2021-09-18,2021,LAA,OAK,1,3,104,1.5,-155,9.0,-115,-105,-114,-1.5,135,4.41,Angel Stadium,4,-2
2021-09-18,2021,NYM,PHI,3,5,-102,1.5,-175,7.5,-120,100,-108,-1.5,155,3.79,Citi Field,8,-2
2021-09-18,2021,MIA,PIT,3,6,-129,-1.5,155,8.0,-105,-115,119,1.5,-175,4.51,Marlins Park,9,-3
2021-09-18,2021,STL,SD,3,2,-118,-1.5,170,7.5,-115,-105,108,1.5,-190,4.06,Busch Stadium,5,1
2021-09-18,2021,KC,SEA,8,1,-110,1.5,-165,9.0,-115,-105,100,-1.5,145,4.71,Kauffman Stadium,9,7
2021-09-18,2021,ATL,SF,0,2,-104,1.5,-200,7.5,-110,-110,-106,-1.5,175,3.82,AT&T Park,2,-2
2021-09-18,2021,SD,STL,2,3,108,1.5,-190,7.5,-115,-105,-118,-1.5,170,3.61,Busch Stadium,5,-1
2021-09-18,2021,DET,TB,4,3,164,1.5,-125,8.5,-105,-115,-178,-1.5,105,3.22,Tropicana Field,7,1
2021-09-18,2021,CWS,TEX,1,2,-224,-1.5,-140,8.5,-120,100,204,1.5,120,5.88,Globe Life Field,3,-1
2021-09-18,2021,MIN,TOR,2,6,152,1.5,-130,9.5,100,-120,-162,-1.5,110,3.77,Rogers Centre,8,-4
2021-09-18,2021,COL,WSH,6,0,120,1.5,-175,9.0,-115,-105,-130,-1.5,155,4.09,Nationals Park,6,6
2021-09-19,2021,HOU,ARI,7,6,-190,-1.5,-105,8.5,-115,-105,175,1.5,-115,5.57,Minute Maid Park,13,1
2021-09-19,2021,SF,ATL,0,3,-126,-1.5,165,8.0,-115,-105,116,1.5,-185,4.46,AT&T Park,3,-3
2021-09-19,2021,BOS,BAL,8,6,-330,-1.5,-165,9.5,-115,-105,285,1.5,145,7.29,Fenway Park,14,2
2021-09-19,2021,BAL,BOS,6,8,285,1.5,145,9.5,-115,-105,-330,-1.5,-165,2.47,Fenway Park,14,-2
2021-09-19,2021,MIL,CHC,4,6,-220,-1.5,-115,9.0,100,-120,200,1.5,-105,6.19,Miller Park,10,-2
2021-09-19,2021,LAD,CIN,8,5,-190,-1.5,-120,9.0,-110,-110,175,1.5,100,5.9,Great American Ballpark,13,3
2021-09-19,2021,NYY,CLE,1,11,-330,-1.5,-160,8.5,-105,-115,285,1.5,140,6.52,Yankee Stadium,12,-10
2021-09-19,2021,WSH,COL,3,0,-106,-1.5,180,8.5,-120,100,-104,1.5,-205,4.37,Nationals Park,3,3
2021-09-19,2021,TEX,CWS,2,7,180,1.5,110,8.5,-115,-105,-200,-1.5,-130,3.04,Globe Life Field,9,-5
2021-09-19,2021,TB,DET,0,2,-270,-1.5,-140,8.5,-110,-110,240,1.5,120,6.2,Tropicana Field,2,-2
2021-09-19,2021,ARI,HOU,6,7,175,1.5,-115,8.5,-115,-105,-190,-1.5,-105,3.09,Minute Maid Park,13,-1
2021-09-19,2021,SEA,KC,7,1,-118,-1.5,130,9.5,100,-120,108,1.5,-150,5.14,Kauffman Stadium,8,6
2021-09-19,2021,OAK,LAA,3,2,-128,-1.5,125,8.0,-120,100,118,1.5,-145,4.49,Angel Stadium,5,1
2021-09-19,2021,CIN,LAD,5,8,175,1.5,100,9.0,-110,-110,-190,-1.5,-120,3.27,Great American Ballpark,13,-3
2021-09-19,2021,PIT,MIA,5,6,185,1.5,-130,7.0,100,-120,-205,-1.5,110,2.46,Marlins Park,11,-1
2021-09-19,2021,CHC,MIL,6,4,200,1.5,-105,9.0,100,-120,-220,-1.5,-115,3.0,Miller Park,10,2
2021-09-19,2021,TOR,MIN,5,3,-210,-1.5,-115,9.0,-110,-110,190,1.5,-105,6.1,Rogers Centre,8,2
2021-09-19,2021,PHI,NYM,2,3,118,1.5,-180,8.0,-115,-105,-128,-1.5,160,3.67,Citi Field,5,-1
2021-09-19,2021,CLE,NYY,11,1,285,1.5,140,8.5,-105,-115,-330,-1.5,-160,2.21,Yankee Stadium,12,10
2021-09-19,2021,LAA,OAK,2,3,118,1.5,-145,8.0,-120,100,-128,-1.5,125,3.67,Angel Stadium,5,-1
2021-09-19,2021,NYM,PHI,3,2,-128,-1.5,160,8.0,-115,-105,118,1.5,-180,4.49,Citi Field,5,1
2021-09-19,2021,MIA,PIT,6,5,-205,-1.5,110,7.0,100,-120,185,1.5,-130,4.7,Marlins Park,11,1
2021-09-19,2021,STL,SD,8,7,-114,-1.5,175,9.0,-110,-110,104,1.5,-200,4.79,Busch Stadium,15,1
2021-09-19,2021,KC,SEA,1,7,108,1.5,-150,9.5,100,-120,-118,-1.5,130,4.57,Kauffman Stadium,8,-6
2021-09-19,2021,ATL,SF,3,0,116,1.5,-185,8.0,-115,-105,-126,-1.5,165,3.7,AT&T Park,3,3
2021-09-19,2021,SD,STL,7,8,104,1.5,-200,9.0,-110,-110,-114,-1.5,175,4.41,Busch Stadium,15,-1
2021-09-19,2021,DET,TB,2,0,240,1.5,120,8.5,-110,-110,-270,-1.5,-140,2.5,Tropicana Field,2,2
2021-09-19,2021,CWS,TEX,7,2,-200,-1.5,-130,8.5,-115,-105,180,1.5,110,5.67,Globe Life Field,9,5
2021-09-19,2021,MIN,TOR,3,5,190,1.5,-105,9.0,-110,-110,-210,-1.5,-115,3.1,Rogers Centre,8,-2
2021-09-19,2021,COL,WSH,0,3,-104,1.5,-205,8.5,-120,100,-106,-1.5,180,4.33,Nationals Park,3,-3
2021-09-20,2021,ATL,ARI,11,4,-186,-1.5,-120,9.5,-105,-115,171,1.5,100,6.18,Chase Field,15,7
2021-09-20,2021,ARI,ATL,4,11,171,1.5,100,9.5,-105,-115,-186,-1.5,-120,3.51,Chase Field,15,-7
2021-09-20,2021,PHI,BAL,0,2,-200,-1.5,105,7.5,-115,-105,180,1.5,-125,5.0,Citizens Bank Park,2,-2
2021-09-20,2021,PIT,CIN,5,9,148,1.5,-130,9.5,-105,-115,-158,-1.5,110,3.83,Great American Ballpark,14,-4
2021-09-20,2021,KC,CLE,7,2,146,1.5,-165,7.0,105,-125,-156,-1.5,145,2.85,Progressive Field,9,5
2021-09-20,2021,KC,CLE,4,2,119,1.5,-190,8.0,110,-30,-129,-1.5,170,3.65,Progressive Field,6,2
2021-09-20,2021,DET,CWS,4,3,205,1.5,125,8.5,-115,-105,-230,-1.5,-145,2.79,Comerica Park,7,1
2021-09-20,2021,CWS,DET,3,4,-230,-1.5,-145,8.5,-115,-105,205,1.5,125,5.92,Comerica Park,7,-1
2021-09-20,2021,LAA,HOU,0,10,190,1.5,100,9.0,-110,-110,-210,-1.5,-120,3.1,Angel Stadium,10,-10
2021-09-20,2021,CLE,KC,2,7,-156,-1.5,145,7.0,105,-125,146,1.5,-165,4.27,Progressive Field,9,-5
2021-09-20,2021,CLE,KC,2,4,-129,-1.5,170,8.0,110,-30,119,1.5,-190,4.51,Progressive Field,6,-2
2021-09-20,2021,HOU,LAA,10,0,-210,-1.5,-120,9.0,-110,-110,190,1.5,100,6.1,Angel Stadium,10,10
2021-09-20,2021,WSH,MIA,7,8,-105,1.5,-220,8.0,-105,-115,-105,-1.5,195,4.1,Marlins Park,15,-1
2021-09-20,2021,STL,MIL,5,2,167,1.5,-130,8.0,-110,-110,-182,-1.5,110,3.0,Miller Park,7,3
2021-09-20,2021,TEX,NYY,3,4,230,1.5,125,8.5,-110,-110,-260,-1.5,-145,2.58,Yankee Stadium,7,-1
2021-09-20,2021,SEA,OAK,4,2,158,1.5,-140,8.0,-110,-110,-168,-1.5,120,3.1,Oakland Coliseum,6,2
2021-09-20,2021,BAL,PHI,2,0,180,1.5,-125,7.5,-115,-105,-200,-1.5,105,2.68,Citizens Bank Park,2,2
2021-09-20,2021,CIN,PIT,9,5,-158,-1.5,110,9.5,-105,-115,148,1.5,-130,5.82,Great American Ballpark,14,4
2021-09-20,2021,OAK,SEA,2,4,-168,-1.5,120,8.0,-110,-110,158,1.5,-140,5.01,Oakland Coliseum,6,-2
2021-09-20,2021,MIL,STL,2,5,-182,-1.5,110,8.0,-110,-110,167,1.5,-130,5.16,Miller Park,7,-3
2021-09-20,2021,TOR,TB,4,6,-125,-1.5,125,8.0,-105,-115,115,1.5,-145,4.44,Tropicana Field,10,-2
2021-09-20,2021,NYY,TEX,4,3,-260,-1.5,-145,8.5,-110,-110,230,1.5,125,6.14,Yankee Stadium,7,1
2021-09-20,2021,TB,TOR,6,4,115,1.5,-145,8.0,-105,-115,-125,-1.5,125,3.72,Tropicana Field,10,2
2021-09-20,2021,MIA,WSH,8,7,-105,-1.5,195,8.0,-105,-115,-105,1.5,-220,4.1,Marlins Park,15,1
2021-09-21,2021,ATL,ARI,6,1,-142,-1.5,105,9.5,-110,-110,132,1.5,-125,5.57,Chase Field,7,5
2021-09-21,2021,ARI,ATL,1,6,132,1.5,-125,9.5,-110,-110,-142,-1.5,105,4.09,Chase Field,7,-5
2021-09-21,2021,PHI,BAL,3,2,-200,-1.5,-120,9.5,100,-120,180,1.5,100,6.33,Citizens Bank Park,5,1
2021-09-21,2021,NYM,BOS,3,6,121,1.5,-160,9.5,100,-120,-131,-1.5,140,4.3,Fenway Park,9,-3
2021-09-21,2021,MIN,CHC,9,5,108,1.5,-190,8.0,100,-120,-118,-1.5,170,3.85,Wrigley Field,14,4
2021-09-21,2021,PIT,CIN,6,2,190,1.5,-105,9.0,100,-120,-210,-1.5,-115,3.1,Great American Ballpark,8,4
2021-09-21,2021,KC,CLE,1,4,148,1.5,-145,9.0,-120,100,-158,-1.5,125,3.63,Progressive Field,5,-3
2021-09-21,2021,LAD,COL,5,4,-210,-1.5,-145,11.0,-105,-115,190,1.5,125,7.45,Coors Field,9,1
2021-09-21,2021,DET,CWS,5,3,146,1.5,-115,9.5,-105,-115,-156,-1.5,-105,3.86,Comerica Park,8,2
2021-09-21,2021,CWS,DET,3,5,-156,-1.5,-105,9.5,-105,-115,146,1.5,-115,5.79,Comerica Park,8,-2
2021-09-21,2021,LAA,HOU,5,10,173,1.5,110,9.5,-110,-110,-188,-1.5,-130,3.48,Angel Stadium,15,-5
2021-09-21,2021,CLE,KC,4,1,-158,-1.5,125,9.0,-120,100,148,1.5,-145,5.51,Progressive Field,5,3
2021-09-21,2021,HOU,LAA,10,5,-188,-1.5,-130,9.5,-110,-110,173,1.5,110,6.2,Angel Stadium,15,5
2021-09-21,2021,COL,LAD,4,5,190,1.5,125,11.0,-105,-115,-210,-1.5,-145,3.79,Coors Field,9,-1
2021-09-21,2021,WSH,MIA,7,1,132,1.5,-170,8.0,-105,-115,-142,-1.5,150,3.45,Marlins Park,8,6
2021-09-21,2021,STL,MIL,2,1,179,1.5,-120,7.5,-115,-105,-198,-1.5,100,2.69,Miller Park,3,1
2021-09-21,2021,CHC,MIN,5,9,-118,-1.5,170,8.0,100,-120,108,1.5,-190,4.33,Wrigley Field,14,-4
2021-09-21,2021,BOS,NYM,6,3,-131,-1.5,140,9.5,100,-120,121,1.5,-160,5.39,Fenway Park,9,3
2021-09-21,2021,TEX,NYY,1,7,230,1.5,115,8.5,-105,-115,-260,-1.5,-135,2.58,Yankee Stadium,8,-6
2021-09-21,2021,SEA,OAK,5,2,120,1.5,-170,8.5,-120,100,-130,-1.5,150,3.86,Oakland Coliseum,7,3
2021-09-21,2021,BAL,PHI,2,3,180,1.5,100,9.5,100,-120,-200,-1.5,-120,3.39,Citizens Bank Park,5,-1
2021-09-21,2021,CIN,PIT,2,6,-210,-1.5,-115,9.0,100,-120,190,1.5,-105,6.1,Great American Ballpark,8,-4
2021-09-21,2021,SF,SD,6,5,100,1.5,-215,7.5,-120,100,-110,-1.5,190,3.75,PETCO Park,11,1
2021-09-21,2021,OAK,SEA,2,5,-130,-1.5,150,8.5,-120,100,120,1.5,-170,4.8,Oakland Coliseum,7,-3
2021-09-21,2021,SD,SF,5,6,-110,-1.5,190,7.5,-120,100,100,1.5,-215,3.93,PETCO Park,11,-1
2021-09-21,2021,MIL,STL,1,2,-198,-1.5,100,7.5,-115,-105,179,1.5,-120,4.98,Miller Park,3,-1
2021-09-21,2021,TOR,TB,4,2,-103,1.5,-200,8.5,-110,-110,-107,-1.5,175,4.31,Tropicana Field,6,2
2021-09-21,2021,NYY,TEX,7,1,-260,-1.5,-135,8.5,-105,-115,230,1.5,115,6.14,Yankee Stadium,8,6
2021-09-21,2021,TB,TOR,2,4,-107,-1.5,175,8.5,-110,-110,-103,1.5,-200,4.39,Tropicana Field,6,-2
2021-09-21,2021,MIA,WSH,1,7,-142,-1.5,150,8.0,-105,-115,132,1.5,-170,4.69,Marlins Park,8,-6
2021-09-22,2021,ATL,ARI,9,2,-164,-1.5,-105,9.5,-105,-115,154,1.5,-115,5.9,Chase Field,11,7
2021-09-22,2021,ARI,ATL,2,9,154,1.5,-115,9.5,-105,-115,-164,-1.5,-105,3.74,Chase Field,11,-7
2021-09-22,2021,PHI,BAL,4,3,-330,-1.5,-150,8.0,-115,-105,285,1.5,130,6.14,Citizens Bank Park,7,1
2021-09-22,2021,NYM,BOS,5,12,163,1.5,-125,9.5,100,-120,-176,-1.5,105,3.61,Fenway Park,17,-7
2021-09-22,2021,MIN,CHC,5,4,-111,-1.5,150,6.5,-120,100,101,1.5,-170,3.42,Wrigley Field,9,1
2021-09-22,2021,LAD,COL,5,10,-186,-1.5,-125,10.5,-110,-110,171,1.5,105,6.83,Coors Field,15,-5
2021-09-22,2021,LAA,HOU,5,9,180,1.5,115,9.5,-105,-115,-200,-1.5,-135,3.39,Angel Stadium,14,-4
2021-09-22,2021,HOU,LAA,9,5,-200,-1.5,-135,9.5,-105,-115,180,1.5,115,6.33,Angel Stadium,14,4
2021-09-22,2021,COL,LAD,10,5,171,1.5,105,10.5,-110,-110,-186,-1.5,-125,3.87,Coors Field,15,5
2021-09-22,2021,WSH,MIA,7,5,122,1.5,-170,8.0,-115,-105,-132,-1.5,150,3.6,Marlins Park,12,2
2021-09-22,2021,STL,MIL,10,2,119,1.5,-170,9.0,-105,-115,-129,-1.5,150,4.11,Miller Park,12,8
2021-09-22,2021,CHC,MIN,4,5,101,1.5,-170,6.5,-120,100,-111,-1.5,150,3.23,Wrigley Field,9,-1
2021-09-22,2021,BOS,NYM,12,5,-176,-1.5,105,9.5,100,-120,163,1.5,-125,6.06,Fenway Park,17,7
2021-09-22,2021,TEX,NYY,3,7,230,1.5,115,9.0,-105,-115,-260,-1.5,-135,2.73,Yankee Stadium,10,-4
2021-09-22,2021,SEA,OAK,4,1,136,1.5,-160,8.5,-105,-115,-146,-1.5,140,3.6,Oakland Coliseum,5,3
2021-09-22,2021,BAL,PHI,3,4,285,1.5,130,8.0,-115,-105,-330,-1.5,-150,2.08,Citizens Bank Park,7,-1
2021-09-22,2021,SF,SD,8,6,104,1.5,-190,9.5,-105,-115,-114,-1.5,170,4.66,PETCO Park,14,2
2021-09-22,2021,OAK,SEA,1,4,-146,-1.5,140,8.5,-105,-115,136,1.5,-160,5.04,Oakland Coliseum,5,-3
2021-09-22,2021,SD,SF,6,8,-114,-1.5,170,9.5,-105,-115,104,1.5,-190,5.06,PETCO Park,14,-2
2021-09-22,2021,MIL,STL,2,10,-129,-1.5,150,9.0,-105,-115,119,1.5,-170,5.07,Miller Park,12,-8
2021-09-22,2021,TOR,TB,1,7,100,1.5,-190,9.0,105,-125,-110,-1.5,170,4.5,Tropicana Field,8,-6
2021-09-22,2021,NYY,TEX,7,3,-260,-1.5,-135,9.0,-105,-115,230,1.5,115,6.5,Yankee Stadium,10,4
2021-09-22,2021,TB,TOR,7,1,-110,-1.5,170,9.0,105,-125,100,1.5,-190,4.71,Tropicana Field,8,6
2021-09-22,2021,MIA,WSH,5,7,-132,-1.5,150,8.0,-115,-105,122,1.5,-170,4.55,Marlins Park,12,-2
2021-09-23,2021,ATL,ARI,4,6,-194,-1.5,-115,8.5,-115,-105,177,1.5,-105,5.61,Chase Field,10,-2
2021-09-23,2021,ARI,ATL,6,4,177,1.5,-105,8.5,-115,-105,-194,-1.5,-115,3.07,Chase Field,10,2
2021-09-23,2021,TEX,BAL,0,3,-126,-1.5,125,9.0,-105,-115,116,1.5,-145,5.02,Camden Yards,3,-3
2021-09-23,2021,WSH,CIN,3,2,171,1.5,-130,9.0,-105,-115,-186,-1.5,110,3.32,Great American Ballpark,5,1
2021-09-23,2021,CWS,CLE,7,2,-135,-1.5,140,7.0,110,-30,125,1.5,-160,4.02,Progressive Field,9,5
2021-09-23,2021,CWS,CLE,3,5,-123,-1.5,145,6.0,-120,100,113,1.5,-165,3.31,Progressive Field,8,-2
2021-09-23,2021,LAD,COL,7,5,-250,-1.5,-155,10.5,100,-120,220,1.5,135,7.5,Coors Field,12,2
2021-09-23,2021,CLE,CWS,2,7,125,1.5,-160,7.0,110,-30,-135,-1.5,140,3.11,Progressive Field,9,-5
2021-09-23,2021,CLE,CWS,5,3,113,1.5,-165,6.0,-120,100,-123,-1.5,145,2.82,Progressive Field,8,2
2021-09-23,2021,LAA,HOU,3,2,140,1.5,-120,8.5,-105,-115,-150,-1.5,100,3.54,Angel Stadium,5,1
2021-09-23,2021,HOU,LAA,2,3,-150,-1.5,100,8.5,-105,-115,140,1.5,-120,5.1,Angel Stadium,5,-1
2021-09-23,2021,COL,LAD,5,7,220,1.5,135,10.5,100,-120,-250,-1.5,-155,3.28,Coors Field,12,-2
2021-09-23,2021,STL,MIL,8,5,107,1.5,-190,8.0,-105,-115,-117,-1.5,170,3.86,Miller Park,13,3
2021-09-23,2021,TOR,MIN,2,7,-136,-1.5,115,9.5,100,-120,126,1.5,-135,5.47,Target Field,9,-5
2021-09-23,2021,SEA,OAK,6,5,156,1.5,-140,8.5,-120,100,-166,-1.5,120,3.32,Oakland Coliseum,11,1
2021-09-23,2021,PIT,PHI,6,12,240,1.5,110,8.0,-120,100,-270,-1.5,-130,2.35,Citizens Bank Park,18,-6
2021-09-23,2021,PHI,PIT,12,6,-270,-1.5,-130,8.0,-120,100,240,1.5,110,5.84,Citizens Bank Park,18,6
2021-09-23,2021,SF,SD,6,7,-109,-1.5,160,7.5,-110,-110,-101,1.5,-180,3.91,PETCO Park,13,-1
2021-09-23,2021,OAK,SEA,5,6,-166,-1.5,120,8.5,-120,100,156,1.5,-140,5.3,Oakland Coliseum,11,-1
2021-09-23,2021,SD,SF,7,6,-101,1.5,-180,7.5,-110,-110,-109,-1.5,160,3.77,PETCO Park,13,1
2021-09-23,2021,MIL,STL,5,8,-117,-1.5,170,8.0,-105,-115,107,1.5,-190,4.31,Miller Park,13,-3
2021-09-23,2021,BAL,TEX,3,0,116,1.5,-145,9.0,-105,-115,-126,-1.5,125,4.17,Camden Yards,3,3
2021-09-23,2021,MIN,TOR,7,2,126,1.5,-135,9.5,100,-120,-136,-1.5,115,4.2,Target Field,9,5
2021-09-23,2021,CIN,WSH,2,3,-186,-1.5,110,9.0,-105,-115,171,1.5,-130,5.85,Great American Ballpark,5,-1
2021-09-24,2021,LAD,ARI,4,2,-230,-1.5,-145,10.0,-115,-105,205,1.5,125,6.97,Chase Field,6,2
2021-09-24,2021,SD,ATL,0,4,117,1.5,-145,8.5,-105,-115,-127,-1.5,125,3.92,PETCO Park,4,-4
2021-09-24,2021,TEX,BAL,8,5,-103,1.5,-190,9.5,100,-120,-107,-1.5,170,4.82,Camden Yards,13,3
2021-09-24,2021,NYY,BOS,8,3,-115,-1.5,140,9.0,-105,-115,105,1.5,-160,4.81,Fenway Park,11,5
2021-09-24,2021,STL,CHC,8,5,-138,-1.5,115,8.5,-115,-105,128,1.5,-135,4.93,Wrigley Field,13,3
2021-09-24,2021,STL,CHC,12,4,-180,-1.5,-115,8.5,-105,-115,165,1.5,-105,5.46,Wrigley Field,16,8
2021-09-24,2021,WSH,CIN,7,8,151,1.5,-140,8.5,-115,-105,-161,-1.5,120,3.39,Great American Ballpark,15,-1
2021-09-24,2021,CWS,CLE,1,0,-112,-1.5,135,8.0,-110,-110,102,1.5,-155,4.23,Progressive Field,1,1
2021-09-24,2021,SF,COL,7,2,-190,-1.5,-140,12.0,-115,-105,175,1.5,120,7.86,Coors Field,9,5
2021-09-24,2021,CLE,CWS,0,1,102,1.5,-155,8.0,-110,-110,-112,-1.5,135,3.96,Progressive Field,1,-1
2021-09-24,2021,KC,DET,3,1,-107,-1.5,145,8.5,-120,100,-103,1.5,-165,4.39,Comerica Park,4,2
2021-09-24,2021,OAK,HOU,14,2,-129,-1.5,155,8.5,-115,-105,119,1.5,-175,4.79,Oakland Coliseum,16,12
2021-09-24,2021,DET,KC,1,3,-103,1.5,-165,8.5,-120,100,-107,-1.5,145,4.31,Comerica Park,4,-2
2021-09-24,2021,SEA,LAA,6,5,-128,-1.5,125,8.5,-105,-115,118,1.5,-145,4.77,Angel Stadium,11,1
2021-09-24,2021,ARI,LAD,2,4,205,1.5,125,10.0,-115,-105,-230,-1.5,-145,3.28,Chase Field,6,-2
2021-09-24,2021,TB,MIA,8,0,-247,-1.5,-130,8.5,-110,-110,217,1.5,110,6.05,Tropicana Field,8,8
2021-09-24,2021,NYM,MIL,1,5,124,1.5,-170,8.0,-120,100,-134,-1.5,150,3.57,Miller Park,6,-4
2021-09-24,2021,TOR,MIN,1,3,-144,-1.5,100,9.0,-105,-115,134,1.5,-120,5.31,Target Field,4,-2
2021-09-24,2021,MIL,NYM,5,1,-134,-1.5,150,8.0,-120,100,124,1.5,-170,4.58,Miller Park,6,4
2021-09-24,2021,BOS,NYY,3,8,105,1.5,-160,9.0,-105,-115,-115,-1.5,140,4.39,Fenway Park,11,-5
2021-09-24,2021,HOU,OAK,2,14,119,1.5,-175,8.5,-115,-105,-129,-1.5,155,3.88,Oakland Coliseum,16,-12
2021-09-24,2021,PIT,PHI,6,8,200,1.5,105,8.5,-120,100,-220,-1.5,-125,2.83,Citizens Bank Park,14,-2
2021-09-24,2021,PHI,PIT,8,6,-220,-1.5,-125,8.5,-120,100,200,1.5,105,5.84,Citizens Bank Park,14,2
2021-09-24,2021,ATL,SD,4,0,-127,-1.5,125,8.5,-105,-115,117,1.5,-145,4.76,PETCO Park,4,4
2021-09-24,2021,LAA,SEA,5,6,118,1.5,-145,8.5,-105,-115,-128,-1.5,125,3.9,Angel Stadium,11,-1
2021-09-24,2021,COL,SF,2,7,175,1.5,120,12.0,-115,-105,-190,-1.5,-140,4.36,Coors Field,9,-5
2021-09-24,2021,CHC,STL,5,8,128,1.5,-135,8.5,-115,-105,-138,-1.5,115,3.73,Wrigley Field,13,-3
2021-09-24,2021,CHC,STL,4,12,165,1.5,-105,8.5,-105,-115,-180,-1.5,-115,3.21,Wrigley Field,16,-8
2021-09-24,2021,MIA,TB,0,8,217,1.5,110,8.5,-110,-110,-247,-1.5,-130,2.68,Tropicana Field,8,-8
2021-09-24,2021,BAL,TEX,5,8,-107,-1.5,170,9.5,100,-120,-103,1.5,-190,4.91,Camden Yards,13,-3
2021-09-24,2021,MIN,TOR,3,1,134,1.5,-120,9.0,-105,-115,-144,-1.5,100,3.85,Target Field,4,2
2021-09-24,2021,CIN,WSH,8,7,-161,-1.5,120,8.5,-115,-105,151,1.5,-140,5.24,Great American Ballpark,15,1
2021-09-25,2021,LAD,ARI,2,7,-245,-1.5,-150,9.0,100,-120,215,1.5,130,6.39,Chase Field,9,-5
2021-09-25,2021,SD,ATL,8,10,105,1.5,-155,8.5,-115,-105,-115,-1.5,135,4.15,PETCO Park,18,-2
2021-09-25,2021,TEX,BAL,2,3,-102,1.5,-190,9.0,-110,-110,-108,-1.5,170,4.54,Camden Yards,5,-1
2021-09-25,2021,NYY,BOS,5,3,100,1.5,-180,10.0,-115,-105,-110,-1.5,160,5.0,Fenway Park,8,2
2021-09-25,2021,STL,CHC,8,5,-142,-1.5,100,10.0,-115,-105,132,1.5,-120,5.87,Wrigley Field,13,3
2021-09-25,2021,WSH,CIN,6,7,107,1.5,-175,10.0,-105,-115,-117,-1.5,155,4.83,Great American Ballpark,13,-1
2021-09-25,2021,CWS,CLE,0,6,-190,-1.5,-120,8.5,-110,-110,175,1.5,100,5.57,Progressive Field,6,-6
2021-09-25,2021,SF,COL,7,2,-140,-1.5,-105,11.5,-105,-115,130,1.5,-115,6.71,Coors Field,9,5
2021-09-25,2021,CLE,CWS,6,0,175,1.5,100,8.5,-110,-110,-190,-1.5,-120,3.09,Progressive Field,6,6
2021-09-25,2021,KC,DET,1,5,120,1.5,-165,9.0,100,-120,-130,-1.5,145,4.09,Comerica Park,6,-4
2021-09-25,2021,OAK,HOU,2,1,-103,1.5,-170,8.0,-105,-115,-107,-1.5,150,4.06,Oakland Coliseum,3,1
2021-09-25,2021,DET,KC,5,1,-130,-1.5,145,9.0,100,-120,120,1.5,-165,5.09,Comerica Park,6,4
2021-09-25,2021,SEA,LAA,1,14,-138,-1.5,110,8.5,-120,100,128,1.5,-130,4.93,Angel Stadium,15,-13
2021-09-25,2021,ARI,LAD,7,2,215,1.5,130,9.0,100,-120,-245,-1.5,-150,2.86,Chase Field,9,5
2021-09-25,2021,TB,MIA,7,3,-200,-1.5,105,7.0,100,-120,180,1.5,-125,4.67,Tropicana Field,10,4
2021-09-25,2021,NYM,MIL,1,2,185,1.5,-120,7.5,100,-120,-205,-1.5,100,2.63,Miller Park,3,-1
2021-09-25,2021,TOR,MIN,6,1,-180,-1.5,-120,8.5,-115,-105,165,1.5,100,5.46,Target Field,7,5
2021-09-25,2021,MIL,NYM,2,1,-205,-1.5,100,7.5,100,-120,185,1.5,-120,5.04,Miller Park,3,1
2021-09-25,2021,BOS,NYY,3,5,-110,-1.5,160,10.0,-115,-105,100,1.5,-180,5.24,Fenway Park,8,-2
2021-09-25,2021,HOU,OAK,1,2,-107,-1.5,150,8.0,-105,-115,-103,1.5,-170,4.14,Oakland Coliseum,3,-1
2021-09-25,2021,PIT,PHI,0,3,240,1.5,115,8.5,-120,100,-270,-1.5,-135,2.5,Citizens Bank Park,3,-3
2021-09-25,2021,PHI,PIT,3,0,-270,-1.5,-135,8.5,-120,100,240,1.5,115,6.2,Citizens Bank Park,3,3
2021-09-25,2021,ATL,SD,10,8,-115,-1.5,135,8.5,-115,-105,105,1.5,-155,4.55,PETCO Park,18,2
2021-09-25,2021,LAA,SEA,14,1,128,1.5,-130,8.5,-120,100,-138,-1.5,110,3.73,Angel Stadium,15,13
2021-09-25,2021,COL,SF,2,7,130,1.5,-115,11.5,-105,-115,-140,-1.5,-105,5.0,Coors Field,9,-5
2021-09-25,2021,CHC,STL,5,8,132,1.5,-120,10.0,-115,-105,-142,-1.5,100,4.31,Wrigley Field,13,-3
2021-09-25,2021,MIA,TB,3,7,180,1.5,-125,7.0,100,-120,-200,-1.5,105,2.5,Tropicana Field,10,-4
2021-09-25,2021,BAL,TEX,3,2,-108,-1.5,170,9.0,-110,-110,-102,1.5,-190,4.67,Camden Yards,5,1
2021-09-25,2021,MIN,TOR,1,6,165,1.5,100,8.5,-115,-105,-180,-1.5,-120,3.21,Target Field,7,-5
2021-09-25,2021,CIN,WSH,7,6,-117,-1.5,155,10.0,-105,-115,107,1.5,-175,5.39,Great American Ballpark,13,1
2021-09-26,2021,LAD,ARI,3,0,-270,-1.5,-165,9.0,-110,-110,240,1.5,145,6.57,Chase Field,3,3
2021-09-26,2021,SD,ATL,3,4,-125,-1.5,155,8.0,-110,-110,115,1.5,-175,4.44,PETCO Park,7,-1
2021-09-26,2021,TEX,BAL,7,4,112,1.5,-180,8.5,100,-120,-122,-1.5,160,4.01,Camden Yards,11,3
2021-09-26,2021,NYY,BOS,6,3,-103,1.5,-190,9.5,-115,-105,-107,-1.5,170,4.82,Fenway Park,9,3
2021-09-26,2021,STL,CHC,4,2,-145,-1.5,100,11.0,-110,-110,135,1.5,-120,6.51,Wrigley Field,6,2
2021-09-26,2021,WSH,CIN,2,9,165,1.5,-125,9.0,-115,-105,-180,-1.5,105,3.4,Great American Ballpark,11,-7
2021-09-26,2021,CWS,CLE,5,2,-150,-1.5,100,8.5,-105,-115,140,1.5,-120,5.1,Progressive Field,7,3
2021-09-26,2021,SF,COL,6,2,-162,-1.5,-110,11.5,-105,-115,152,1.5,-110,7.11,Coors Field,8,4
2021-09-26,2021,CLE,CWS,2,5,140,1.5,-120,8.5,-105,-115,-150,-1.5,100,3.54,Progressive Field,7,-3
2021-09-26,2021,KC,DET,2,1,-108,1.5,-210,9.0,-105,-115,-102,-1.5,185,4.67,Comerica Park,3,1
2021-09-26,2021,OAK,HOU,4,3,102,1.5,-150,9.0,-110,-110,-112,-1.5,130,4.46,Oakland Coliseum,7,1
2021-09-26,2021,DET,KC,1,2,-102,-1.5,185,9.0,-105,-115,-108,1.5,-210,4.54,Comerica Park,3,-1
2021-09-26,2021,SEA,LAA,5,1,120,1.5,-165,8.5,-105,-115,-130,-1.5,145,3.86,Angel Stadium,6,4
2021-09-26,2021,ARI,LAD,0,3,240,1.5,145,9.0,-110,-110,-270,-1.5,-165,2.65,Chase Field,3,-3
2021-09-26,2021,TB,MIA,3,2,-260,-1.5,-125,8.0,-110,-110,230,1.5,105,5.78,Tropicana Field,5,1
2021-09-26,2021,NYM,MIL,4,8,145,1.5,-150,8.0,105,-125,-155,-1.5,130,3.27,Miller Park,12,-4
2021-09-26,2021,TOR,MIN,5,2,-166,-1.5,-115,9.5,-110,-110,156,1.5,-105,5.93,Target Field,7,3
2021-09-26,2021,MIL,NYM,8,4,-155,-1.5,130,8.0,105,-125,145,1.5,-150,4.86,Miller Park,12,4
2021-09-26,2021,BOS,NYY,3,6,-107,-1.5,170,9.5,-115,-105,-103,1.5,-190,4.91,Fenway Park,9,-3
2021-09-26,2021,HOU,OAK,3,4,-112,-1.5,130,9.0,-110,-110,102,1.5,-150,4.75,Oakland Coliseum,7,-1
2021-09-26,2021,PIT,PHI,6,0,205,1.5,100,9.0,-115,-105,-230,-1.5,-120,2.95,Citizens Bank Park,6,6
2021-09-26,2021,PHI,PIT,0,6,-230,-1.5,-120,9.0,-115,-105,205,1.5,100,6.27,Citizens Bank Park,6,-6
2021-09-26,2021,ATL,SD,4,3,115,1.5,-175,8.0,-110,-110,-125,-1.5,155,3.72,PETCO Park,7,1
2021-09-26,2021,LAA,SEA,1,5,-130,-1.5,145,8.5,-105,-115,120,1.5,-165,4.8,Angel Stadium,6,-4
2021-09-26,2021,COL,SF,2,6,152,1.5,-110,11.5,-105,-115,-162,-1.5,-110,4.56,Coors Field,8,-4
2021-09-26,2021,CHC,STL,2,4,135,1.5,-120,11.0,-110,-110,-145,-1.5,100,4.68,Wrigley Field,6,-2
2021-09-26,2021,MIA,TB,2,3,230,1.5,105,8.0,-110,-110,-260,-1.5,-125,2.42,Tropicana Field,5,-1
2021-09-26,2021,BAL,TEX,4,7,-122,-1.5,160,8.5,100,-120,112,1.5,-180,4.67,Camden Yards,11,-3
2021-09-26,2021,MIN,TOR,2,5,156,1.5,-105,9.5,-110,-110,-166,-1.5,-115,3.71,Target Field,7,-3
2021-09-26,2021,CIN,WSH,9,2,-180,-1.5,105,9.0,-115,-105,165,1.5,-125,5.79,Great American Ballpark,11,7
2021-09-27,2021,PIT,CIN,1,13,161,1.5,-130,9.5,-105,-115,-172,-1.5,110,3.64,Great American Ballpark,14,-12
2021-09-27,2021,KC,CLE,3,8,159,1.5,-130,9.5,-105,-115,-169,-1.5,110,3.67,Progressive Field,11,-5
2021-09-27,2021,WSH,COL,5,4,152,1.5,-125,11.5,-120,100,-162,-1.5,105,4.56,Coors Field,9,1
2021-09-27,2021,DET,CWS,7,8,135,1.5,-125,9.5,-115,-105,-145,-1.5,105,4.04,Comerica Park,15,-1
2021-09-27,2021,CWS,DET,8,7,-145,-1.5,105,9.5,-115,-105,135,1.5,-125,5.62,Comerica Park,15,1
2021-09-27,2021,CLE,KC,8,3,-169,-1.5,110,9.5,-105,-115,159,1.5,-130,5.97,Progressive Field,11,5
2021-09-27,2021,SEA,OAK,13,4,-122,-1.5,170,8.5,100,-120,112,1.5,-190,4.67,T-Mobile Park,17,9
2021-09-27,2021,CIN,PIT,13,1,-172,-1.5,110,9.5,-105,-115,161,1.5,-130,6.01,Great American Ballpark,14,12
2021-09-27,2021,OAK,SEA,4,13,112,1.5,-190,8.5,100,-120,-122,-1.5,170,4.01,T-Mobile Park,17,-9
2021-09-27,2021,COL,WSH,4,5,-162,-1.5,105,11.5,-120,100,152,1.5,-125,7.11,Coors Field,9,-1
2021-09-28,2021,SF,ARI,6,4,-255,-1.5,-125,7.5,-120,100,225,1.5,105,5.39,AT&T Park,10,2
2021-09-28,2021,PHI,ATL,1,2,111,1.5,-185,7.5,-115,-105,-121,-1.5,165,3.55,Suntrust Park,3,-1
2021-09-28,2021,BOS,BAL,2,4,-260,-1.5,-175,9.0,-115,-105,230,1.5,155,6.5,Camden Yards,6,-2
2021-09-28,2021,BAL,BOS,4,2,230,1.5,155,9.0,-115,-105,-260,-1.5,-175,2.73,Camden Yards,6,2
2021-09-28,2021,PIT,CHC,8,6,-105,-1.5,175,8.5,-115,-105,-105,1.5,-200,4.35,PNC Park,14,2
2021-09-28,2021,CWS,CIN,7,1,-180,-1.5,105,9.0,-115,-105,165,1.5,-125,5.79,Guaranteed Rate Field,8,6
2021-09-28,2021,KC,CLE,6,4,-120,-1.5,165,9.0,110,-30,110,1.5,-185,4.91,Kauffman Stadium,10,2
2021-09-28,2021,WSH,COL,1,3,122,1.5,-145,11.5,-115,-105,-132,-1.5,125,5.18,Coors Field,4,-2
2021-09-28,2021,CIN,CWS,1,7,165,1.5,-125,9.0,-115,-105,-180,-1.5,105,3.4,Guaranteed Rate Field,8,-6
2021-09-28,2021,MIN,DET,3,2,-140,-1.5,135,9.5,-120,100,130,1.5,-155,5.54,Target Field,5,1
2021-09-28,2021,TB,HOU,3,4,120,1.5,-160,9.0,-120,100,-130,-1.5,140,4.09,Minute Maid Park,7,-1
2021-09-28,2021,CLE,KC,4,6,110,1.5,-185,9.0,110,-30,-120,-1.5,165,4.29,Kauffman Stadium,10,-2
2021-09-28,2021,TEX,LAA,5,2,100,-1.5,180,9.0,-115,-105,-110,1.5,-205,4.5,Globe Life Field,7,3
2021-09-28,2021,SD,LAD,1,2,175,1.5,-125,7.5,-115,-105,-190,-1.5,105,2.73,Dodger Stadium,3,-1
2021-09-28,2021,NYM,MIA,5,2,-200,-1.5,130,5.5,-115,-105,180,1.5,-150,3.67,Citi Field,7,3
2021-09-28,2021,NYM,MIA,2,1,-138,-1.5,160,6.0,115,-35,128,1.5,-180,3.48,Citi Field,3,1
2021-09-28,2021,STL,MIL,6,2,103,1.5,-175,7.0,-110,-110,-113,-1.5,155,3.45,Busch Stadium,8,4
2021-09-28,2021,DET,MIN,2,3,130,1.5,-155,9.5,-120,100,-140,-1.5,135,4.13,Target Field,5,-1
2021-09-28,2021,MIA,NYM,2,5,180,1.5,-150,5.5,-115,-105,-200,-1.5,130,1.96,Citi Field,7,-3
2021-09-28,2021,MIA,NYM,1,2,128,1.5,-180,6.0,115,-35,-138,-1.5,160,2.63,Citi Field,3,-1
2021-09-28,2021,TOR,NYY,2,7,-120,-1.5,155,9.0,-120,100,110,1.5,-175,4.91,Rogers Centre,9,-5
2021-09-28,2021,SEA,OAK,4,2,100,1.5,-170,8.0,-110,-110,-110,-1.5,150,4.0,T-Mobile Park,6,2
2021-09-28,2021,ATL,PHI,2,1,-121,-1.5,165,7.5,-115,-105,111,1.5,-185,4.11,Suntrust Park,3,1
2021-09-28,2021,CHC,PIT,6,8,-105,1.5,-200,8.5,-115,-105,-105,-1.5,175,4.35,PNC Park,14,-2
2021-09-28,2021,LAD,SD,2,1,-190,-1.5,105,7.5,-115,-105,175,1.5,-125,4.91,Dodger Stadium,3,1
2021-09-28,2021,OAK,SEA,2,4,-110,-1.5,150,8.0,-110,-110,100,1.5,-170,4.19,T-Mobile Park,6,-2
2021-09-28,2021,ARI,SF,4,6,225,1.5,105,7.5,-120,100,-255,-1.5,-125,2.31,AT&T Park,10,-2
2021-09-28,2021,MIL,STL,2,6,-113,-1.5,155,7.0,-110,-110,103,1.5,-175,3.71,Busch Stadium,8,-4
2021-09-28,2021,HOU,TB,4,3,-130,-1.5,140,9.0,-120,100,120,1.5,-160,5.09,Minute Maid Park,7,1
2021-09-28,2021,LAA,TEX,2,5,-110,1.5,-205,9.0,-115,-105,100,-1.5,180,4.71,Globe Life Field,7,-3
2021-09-28,2021,NYY,TOR,7,2,110,1.5,-175,9.0,-120,100,-120,-1.5,155,4.29,Rogers Centre,9,5
2021-09-28,2021,COL,WSH,3,1,-132,-1.5,125,11.5,-115,-105,122,1.5,-145,6.54,Coors Field,4,2
2021-09-29,2021,SF,ARI,1,0,-260,-1.5,-135,8.0,-105,-115,230,1.5,115,5.78,AT&T Park,1,1
2021-09-29,2021,PHI,ATL,2,7,136,1.5,-160,8.0,-110,-110,-146,-1.5,140,3.39,Suntrust Park,9,-5
2021-09-29,2021,BOS,BAL,6,0,-254,-1.5,-175,9.5,-110,-110,224,1.5,155,6.82,Camden Yards,6,6
2021-09-29,2021,BAL,BOS,0,6,224,1.5,155,9.5,-110,-110,-254,-1.5,-175,2.93,Camden Yards,6,-6
2021-09-29,2021,PIT,CHC,2,3,110,1.5,-155,8.5,-110,-110,-120,-1.5,135,4.05,PNC Park,5,-1
2021-09-29,2021,CWS,CIN,6,1,-182,-1.5,110,7.5,-110,-110,167,1.5,-130,4.84,Guaranteed Rate Field,7,5
2021-09-29,2021,KC,CLE,10,5,-101,1.5,-150,9.0,-110,-110,-109,-1.5,130,4.52,Kauffman Stadium,15,5
2021-09-29,2021,WSH,COL,5,10,108,1.5,-170,11.5,-115,-105,-118,-1.5,150,5.53,Coors Field,15,-5
2021-09-29,2021,CIN,CWS,1,6,167,1.5,-130,7.5,-110,-110,-182,-1.5,110,2.81,Guaranteed Rate Field,7,-5
2021-09-29,2021,MIN,DET,5,2,-168,-1.5,110,9.0,-110,-110,158,1.5,-130,5.64,Target Field,7,3
2021-09-29,2021,TB,HOU,7,0,125,1.5,-165,9.0,100,-120,-135,-1.5,145,4.0,Minute Maid Park,7,7
2021-09-29,2021,CLE,KC,5,10,-109,-1.5,130,9.0,-110,-110,-101,1.5,-150,4.69,Kauffman Stadium,15,-5
2021-09-29,2021,TEX,LAA,2,7,-119,-1.5,165,9.0,100,-120,109,1.5,-185,4.89,Globe Life Field,9,-5
2021-09-29,2021,SD,LAD,9,11,270,1.5,135,8.0,100,-120,-310,-1.5,-155,2.16,Dodger Stadium,20,-2
2021-09-29,2021,NYM,MIA,2,3,-172,-1.5,130,7.5,100,-120,161,1.5,-150,4.74,Citi Field,5,-1
2021-09-29,2021,STL,MIL,0,4,-113,-1.5,180,7.5,-115,-105,103,1.5,-205,3.98,Busch Stadium,4,-4
2021-09-29,2021,DET,MIN,2,5,158,1.5,-130,9.0,-110,-110,-168,-1.5,110,3.49,Target Field,7,-3
2021-09-29,2021,MIA,NYM,3,2,161,1.5,-150,7.5,100,-120,-172,-1.5,130,2.87,Citi Field,5,1
2021-09-29,2021,TOR,NYY,6,5,104,1.5,-160,8.0,-105,-115,-114,-1.5,140,3.92,Rogers Centre,11,1
2021-09-29,2021,SEA,OAK,4,2,-111,-1.5,180,7.5,100,-120,101,1.5,-205,3.95,T-Mobile Park,6,2
2021-09-29,2021,ATL,PHI,7,2,-146,-1.5,140,8.0,-110,-110,136,1.5,-160,4.75,Suntrust Park,9,5
2021-09-29,2021,CHC,PIT,3,2,-120,-1.5,135,8.5,-110,-110,110,1.5,-155,4.64,PNC Park,5,1
2021-09-29,2021,LAD,SD,11,9,-310,-1.5,-155,8.0,100,-120,270,1.5,135,6.05,Dodger Stadium,20,2
2021-09-29,2021,OAK,SEA,2,4,101,1.5,-205,7.5,100,-120,-111,-1.5,180,3.73,T-Mobile Park,6,-2
2021-09-29,2021,ARI,SF,0,1,230,1.5,115,8.0,-105,-115,-260,-1.5,-135,2.42,AT&T Park,1,-1
2021-09-29,2021,MIL,STL,4,0,103,1.5,-205,7.5,-115,-105,-113,-1.5,180,3.69,Busch Stadium,4,4
2021-09-29,2021,HOU,TB,0,7,-135,-1.5,145,9.0,100,-120,125,1.5,-165,5.17,Minute Maid Park,7,-7
2021-09-29,2021,LAA,TEX,7,2,109,1.5,-185,9.0,100,-120,-119,-1.5,165,4.31,Globe Life Field,9,5
2021-09-29,2021,NYY,TOR,5,6,-114,-1.5,140,8.0,-105,-115,104,1.5,-160,4.26,Rogers Centre,11,-1
2021-09-29,2021,COL,WSH,10,5,-118,-1.5,150,11.5,-115,-105,108,1.5,-170,6.22,Coors Field,15,5
2021-09-30,2021,SF,ARI,5,4,-216,-1.5,-105,8.5,-115,-105,196,1.5,-115,5.81,AT&T Park,9,1
2021-09-30,2021,PHI,ATL,3,5,139,1.5,-155,8.5,-120,100,-149,-1.5,135,3.56,Suntrust Park,8,-2
2021-09-30,2021,BOS,BAL,2,6,-215,-1.5,-150,10.0,100,-120,195,1.5,130,6.83,Camden Yards,8,-4
2021-09-30,2021,BAL,BOS,6,2,195,1.5,130,10.0,100,-120,-215,-1.5,-150,3.39,Camden Yards,8,4
2021-09-30,2021,PIT,CHC,0,9,101,1.5,-165,8.5,-120,100,-111,-1.5,145,4.23,PNC Park,9,-9
2021-09-30,2021,KC,CLE,1,6,140,1.5,-130,8.5,-110,-110,-150,-1.5,110,3.54,Kauffman Stadium,7,-5
2021-09-30,2021,MIN,DET,7,10,-178,-1.5,105,8.5,-115,-105,164,1.5,-125,5.44,Target Field,17,-3
2021-09-30,2021,TB,HOU,2,3,136,1.5,-150,8.5,-115,-105,-146,-1.5,130,3.6,Minute Maid Park,5,-1
2021-09-30,2021,CLE,KC,6,1,-150,-1.5,110,8.5,-110,-110,140,1.5,-130,5.1,Kauffman Stadium,7,5
2021-09-30,2021,TEX,LAA,7,6,122,1.5,-145,8.0,-110,-110,-132,-1.5,125,3.6,Globe Life Field,13,1
2021-09-30,2021,SD,LAD,3,8,205,1.5,110,9.0,-115,-105,-230,-1.5,-130,2.95,Dodger Stadium,11,-5
2021-09-30,2021,NYM,MIA,12,3,-210,-1.5,100,7.5,100,-120,190,1.5,-120,5.08,Citi Field,15,9
2021-09-30,2021,STL,MIL,4,3,-113,-1.5,165,8.5,-115,-105,103,1.5,-185,4.51,Busch Stadium,7,1
2021-09-30,2021,DET,MIN,10,7,164,1.5,-125,8.5,-115,-105,-178,-1.5,105,3.22,Target Field,17,3
2021-09-30,2021,MIA,NYM,3,12,190,1.5,-120,7.5,100,-120,-210,-1.5,100,2.59,Citi Field,15,-9
2021-09-30,2021,TOR,NYY,2,6,-145,-1.5,130,8.5,-105,-115,135,1.5,-150,5.03,Rogers Centre,8,-4
2021-09-30,2021,ATL,PHI,5,3,-149,-1.5,135,8.5,-120,100,139,1.5,-155,5.09,Suntrust Park,8,2
2021-09-30,2021,CHC,PIT,9,0,-111,-1.5,145,8.5,-120,100,101,1.5,-165,4.47,PNC Park,9,9
2021-09-30,2021,LAD,SD,8,3,-230,-1.5,-130,9.0,-115,-105,205,1.5,110,6.27,Dodger Stadium,11,5
2021-09-30,2021,ARI,SF,4,5,196,1.5,-115,8.5,-115,-105,-216,-1.5,-105,2.87,AT&T Park,9,-1
2021-09-30,2021,MIL,STL,3,4,103,1.5,-185,8.5,-115,-105,-113,-1.5,165,4.19,Busch Stadium,7,-1
2021-09-30,2021,HOU,TB,3,2,-146,-1.5,130,8.5,-115,-105,136,1.5,-150,5.04,Minute Maid Park,5,1
2021-09-30,2021,LAA,TEX,6,7,-132,-1.5,125,8.0,-110,-110,122,1.5,-145,4.55,Globe Life Field,13,-1
2021-09-30,2021,NYY,TOR,6,2,135,1.5,-150,8.5,-105,-115,-145,-1.5,130,3.62,Rogers Centre,8,4
2021-10-01,2021,COL,ARI,9,7,-113,-1.5,137,9.0,-118,102,105,1.5,-153,4.77,Chase Field,16,2
2021-10-01,2021,NYM,ATL,4,3,106,1.5,-188,8.0,-118,102,-115,-1.5,167,3.88,Suntrust Park,7,1
2021-10-01,2021,TOR,BAL,6,4,-379,-1.5,-188,9.5,-118,102,319,1.5,167,7.52,Rogers Centre,10,2
2021-10-01,2021,WSH,BOS,2,4,179,1.5,107,9.0,-113,-103,-194,-1.5,-123,3.23,Nationals Park,6,-2
2021-10-01,2021,STL,CHC,4,3,-204,-1.5,102,8.0,-113,-103,184,1.5,-118,5.37,Busch Stadium,7,1
2021-10-01,2021,PIT,CIN,9,2,178,1.5,107,8.0,-113,-103,-193,-1.5,-123,2.88,PNC Park,11,7
2021-10-01,2021,TEX,CLE,6,9,103,1.5,-153,8.5,-118,102,-111,-1.5,137,4.19,Globe Life Field,15,-3
2021-10-01,2021,ARI,COL,7,9,105,1.5,-153,9.0,-118,102,-113,-1.5,137,4.39,Chase Field,16,-2
2021-10-01,2021,DET,CWS,1,8,236,1.5,122,8.5,-103,-113,-266,-1.5,-138,2.53,Guaranteed Rate Field,9,-7
2021-10-01,2021,CWS,DET,8,1,-266,-1.5,-138,8.5,-103,-113,236,1.5,122,6.18,Guaranteed Rate Field,9,7
2021-10-01,2021,OAK,HOU,8,6,125,1.5,-163,8.0,-118,102,-135,-1.5,147,3.56,Minute Maid Park,14,2
2021-10-01,2021,MIN,KC,6,11,-109,-1.5,137,9.5,-108,-108,101,1.5,-153,4.95,Kauffman Stadium,17,-5
2021-10-01,2021,SEA,LAA,1,2,-157,-1.5,122,7.5,-113,-103,147,1.5,-138,4.58,T-Mobile Park,3,-1
2021-10-01,2021,MIL,LAD,6,8,199,1.5,-108,8.0,102,-118,-224,-1.5,-108,2.68,Dodger Stadium,14,-2
2021-10-01,2021,PHI,MIA,5,0,-113,-1.5,157,6.5,102,-118,105,1.5,-178,3.45,Marlins Park,5,5
2021-10-01,2021,LAD,MIL,8,6,-224,-1.5,-108,8.0,102,-118,199,1.5,-108,5.53,Dodger Stadium,14,2
2021-10-01,2021,KC,MIN,11,6,101,1.5,-153,9.5,-108,-108,-109,-1.5,137,4.73,Kauffman Stadium,17,5
2021-10-01,2021,ATL,NYM,3,4,-115,-1.5,167,8.0,-118,102,106,1.5,-188,4.28,Suntrust Park,7,-1
2021-10-01,2021,TB,NYY,4,3,118,1.5,-163,8.5,-103,-113,-127,-1.5,147,3.9,Yankee Stadium,7,1
2021-10-01,2021,HOU,OAK,6,8,-135,-1.5,147,8.0,-118,102,125,1.5,-163,4.6,Minute Maid Park,14,-2
2021-10-01,2021,MIA,PHI,0,5,105,1.5,-178,6.5,102,-118,-113,-1.5,157,3.17,Marlins Park,5,-5
2021-10-01,2021,CIN,PIT,2,9,-193,-1.5,-123,8.0,-113,-103,178,1.5,107,5.27,PNC Park,11,-7
2021-10-01,2021,SF,SD,3,0,-200,-1.5,102,9.0,-103,-113,180,1.5,-118,6.0,AT&T Park,3,3
2021-10-01,2021,LAA,SEA,2,1,147,1.5,-138,7.5,-113,-103,-157,-1.5,122,3.04,T-Mobile Park,3,1
2021-10-01,2021,SD,SF,0,3,180,1.5,-118,9.0,-103,-113,-200,-1.5,102,3.21,AT&T Park,3,-3
2021-10-01,2021,CHC,STL,3,4,184,1.5,-118,8.0,-113,-103,-204,-1.5,102,2.82,Busch Stadium,7,-1
2021-10-01,2021,NYY,TB,3,4,-127,-1.5,147,8.5,-103,-113,118,1.5,-163,4.76,Yankee Stadium,7,-1
2021-10-01,2021,CLE,TEX,9,6,-111,-1.5,137,8.5,-118,102,103,1.5,-153,4.47,Globe Life Field,15,3
2021-10-01,2021,BAL,TOR,4,6,319,1.5,167,9.5,-118,102,-379,-1.5,-188,2.27,Rogers Centre,10,-2
2021-10-01,2021,BOS,WSH,4,2,-194,-1.5,-123,9.0,-113,-103,179,1.5,107,5.94,Nationals Park,6,2
2021-10-02,2021,COL,ARI,2,11,124,1.5,-170,8.5,-110,-110,-134,-1.5,150,3.79,Chase Field,13,-9
2021-10-02,2021,NYM,ATL,5,6,113,1.5,-175,8.5,-120,100,-123,-1.5,155,3.99,Suntrust Park,11,-1
2021-10-02,2021,TOR,BAL,10,1,-260,-1.5,-130,8.5,-115,-105,230,1.5,110,6.14,Rogers Centre,11,9
2021-10-02,2021,WSH,BOS,3,5,135,1.5,-125,9.5,-105,-115,-145,-1.5,105,4.04,Nationals Park,8,-2
2021-10-02,2021,STL,CHC,5,6,-172,-1.5,105,9.0,-105,-115,161,1.5,-125,5.69,Busch Stadium,11,-1
2021-10-02,2021,PIT,CIN,8,6,138,1.5,-125,8.5,-105,-115,-148,-1.5,105,3.57,PNC Park,14,2
2021-10-02,2021,TEX,CLE,7,2,132,1.5,-125,8.5,-120,100,-142,-1.5,105,3.66,Globe Life Field,9,5
2021-10-02,2021,ARI,COL,11,2,-134,-1.5,150,8.5,-110,-110,124,1.5,-170,4.87,Chase Field,13,9
2021-10-02,2021,DET,CWS,4,5,240,1.5,115,9.0,100,-120,-270,-1.5,-135,2.65,Guaranteed Rate Field,9,-1
2021-10-02,2021,CWS,DET,5,4,-270,-1.5,-135,9.0,100,-120,240,1.5,115,6.57,Guaranteed Rate Field,9,1
2021-10-02,2021,OAK,HOU,4,10,152,1.5,-135,9.5,-105,-115,-162,-1.5,115,3.77,Minute Maid Park,14,-6
2021-10-02,2021,MIN,KC,4,0,110,1.5,-180,9.0,-110,-110,-120,-1.5,160,4.29,Kauffman Stadium,4,4
2021-10-02,2021,SEA,LAA,6,4,-176,-1.5,115,8.0,-115,-105,163,1.5,-135,5.1,T-Mobile Park,10,2
2021-10-02,2021,MIL,LAD,3,8,136,1.5,-165,7.0,-115,-105,-146,-1.5,145,2.97,Dodger Stadium,11,-5
2021-10-02,2021,PHI,MIA,1,3,-122,-1.5,140,8.0,-105,-115,112,1.5,-160,4.4,Marlins Park,4,-2
2021-10-02,2021,LAD,MIL,8,3,-146,-1.5,145,7.0,-115,-105,136,1.5,-165,4.15,Dodger Stadium,11,5
2021-10-02,2021,KC,MIN,0,4,-120,-1.5,160,9.0,-110,-110,110,1.5,-180,4.91,Kauffman Stadium,4,-4
2021-10-02,2021,ATL,NYM,6,5,-123,-1.5,155,8.5,-120,100,113,1.5,-175,4.69,Suntrust Park,11,1
2021-10-02,2021,TB,NYY,12,2,119,1.5,-165,8.5,-120,100,-129,-1.5,145,3.88,Yankee Stadium,14,10
2021-10-02,2021,HOU,OAK,10,4,-162,-1.5,115,9.5,-105,-115,152,1.5,-135,5.87,Minute Maid Park,14,6
2021-10-02,2021,MIA,PHI,3,1,112,1.5,-160,8.0,-105,-115,-122,-1.5,140,3.77,Marlins Park,4,2
2021-10-02,2021,CIN,PIT,6,8,-148,-1.5,105,8.5,-105,-115,138,1.5,-125,5.07,PNC Park,14,-2
2021-10-02,2021,SF,SD,2,3,-150,-1.5,135,8.0,100,-120,140,1.5,-155,4.8,AT&T Park,5,-1
2021-10-02,2021,LAA,SEA,4,6,163,1.5,-135,8.0,-115,-105,-176,-1.5,115,3.04,T-Mobile Park,10,-2
2021-10-02,2021,SD,SF,3,2,140,1.5,-155,8.0,100,-120,-150,-1.5,135,3.33,AT&T Park,5,1
2021-10-02,2021,CHC,STL,6,5,161,1.5,-125,9.0,-105,-115,-172,-1.5,105,3.45,Busch Stadium,11,1
2021-10-02,2021,NYY,TB,2,12,-129,-1.5,145,8.5,-120,100,119,1.5,-165,4.79,Yankee Stadium,14,-10
2021-10-02,2021,CLE,TEX,2,7,-142,-1.5,105,8.5,-120,100,132,1.5,-125,4.99,Globe Life Field,9,-5
2021-10-02,2021,BAL,TOR,1,10,230,1.5,110,8.5,-115,-105,-260,-1.5,-130,2.58,Rogers Centre,11,-9
2021-10-02,2021,BOS,WSH,5,3,-145,-1.5,105,9.5,-105,-115,135,1.5,-125,5.62,Nationals Park,8,2
2021-10-03,2021,COL,ARI,4,5,100,-1.5,155,9.0,-110,-110,-110,1.5,-175,4.5,Chase Field,9,-1
2021-10-03,2021,NYM,ATL,0,5,156,1.5,-140,8.5,-110,-110,-166,-1.5,120,3.32,Suntrust Park,5,-5
2021-10-03,2021,TOR,BAL,12,4,-350,-1.5,-180,10.0,-105,-115,300,1.5,160,7.78,Rogers Centre,16,8
2021-10-03,2021,WSH,BOS,5,7,190,1.5,120,9.5,100,-120,-210,-1.5,-140,3.28,Nationals Park,12,-2
2021-10-03,2021,STL,CHC,2,3,-158,-1.5,120,8.5,-110,-110,148,1.5,-140,5.21,Busch Stadium,5,-1
2021-10-03,2021,PIT,CIN,3,6,145,1.5,-120,9.0,-115,-105,-155,-1.5,100,3.67,PNC Park,9,-3
2021-10-03,2021,TEX,CLE,0,6,-112,-1.5,175,8.0,-110,-110,102,1.5,-200,4.23,Globe Life Field,6,-6
2021-10-03,2021,ARI,COL,5,4,-110,1.5,-175,9.0,-110,-110,100,-1.5,155,4.71,Chase Field,9,1
2021-10-03,2021,DET,CWS,5,2,220,1.5,105,8.0,100,-120,-250,-1.5,-125,2.5,Guaranteed Rate Field,7,3
2021-10-03,2021,CWS,DET,2,5,-250,-1.5,-125,8.0,100,-120,220,1.5,105,5.71,Guaranteed Rate Field,7,-3
2021-10-03,2021,OAK,HOU,6,7,151,1.5,-135,9.0,100,-120,-161,-1.5,115,3.59,Minute Maid Park,13,-1
2021-10-03,2021,MIN,KC,7,3,-111,-1.5,135,10.0,-110,-110,101,1.5,-155,5.26,Kauffman Stadium,10,4
2021-10-03,2021,SEA,LAA,3,7,-164,-1.5,120,7.5,-110,-110,154,1.5,-140,4.66,T-Mobile Park,10,-4
2021-10-03,2021,MIL,LAD,3,10,245,1.5,125,8.5,-115,-105,-280,-1.5,-145,2.46,Dodger Stadium,13,-7
2021-10-03,2021,PHI,MIA,4,5,-110,-1.5,155,7.5,100,-120,100,1.5,-175,3.93,Marlins Park,9,-1
2021-10-03,2021,LAD,MIL,10,3,-280,-1.5,-145,8.5,-115,-105,245,1.5,125,6.26,Dodger Stadium,13,7
2021-10-03,2021,KC,MIN,3,7,101,1.5,-155,10.0,-110,-110,-111,-1.5,135,4.98,Kauffman Stadium,10,-4
2021-10-03,2021,ATL,NYM,5,0,-166,-1.5,120,8.5,-110,-110,156,1.5,-140,5.3,Suntrust Park,5,5
2021-10-03,2021,TB,NYY,0,1,114,1.5,-170,9.5,100,-120,-124,-1.5,150,4.44,Yankee Stadium,1,-1
2021-10-03,2021,HOU,OAK,7,6,-161,-1.5,115,9.0,100,-120,151,1.5,-135,5.55,Minute Maid Park,13,1
2021-10-03,2021,MIA,PHI,5,4,100,1.5,-175,7.5,100,-120,-110,-1.5,155,3.75,Marlins Park,9,1
2021-10-03,2021,CIN,PIT,6,3,-155,-1.5,100,9.0,-115,-105,145,1.5,-120,5.47,PNC Park,9,3
2021-10-03,2021,SF,SD,11,4,-220,-1.5,-105,8.5,-115,-105,200,1.5,-115,5.84,AT&T Park,15,7
2021-10-03,2021,LAA,SEA,7,3,154,1.5,-140,7.5,-110,-110,-164,-1.5,120,2.95,T-Mobile Park,10,4
2021-10-03,2021,SD,SF,4,11,200,1.5,-115,8.5,-115,-105,-220,-1.5,-105,2.83,AT&T Park,15,-7
2021-10-03,2021,CHC,STL,3,2,148,1.5,-140,8.5,-110,-110,-158,-1.5,120,3.43,Busch Stadium,5,1
2021-10-03,2021,NYY,TB,1,0,-124,-1.5,150,9.5,100,-120,114,1.5,-170,5.26,Yankee Stadium,1,1
2021-10-03,2021,CLE,TEX,6,0,102,1.5,-200,8.0,-110,-110,-112,-1.5,175,3.96,Globe Life Field,6,6
2021-10-03,2021,BAL,TOR,4,12,300,1.5,160,10.0,-105,-115,-350,-1.5,-180,2.5,Rogers Centre,16,-8
2021-10-03,2021,BOS,WSH,7,5,-210,-1.5,-140,9.5,100,-120,190,1.5,120,6.44,Nationals Park,12,2
