date,season,team,opponent,runs,oppRuns,moneyLine,runLine,runLineOdds,total,overOdds,underOdds,oppMoneyLine,oppRunLine,oppRunLineOdds,projectedRuns,parkName,totalRuns,runDif
3/22/2014,2014,LAD,ARI,3,1,-170,-1.5,-104,6.5,-120,100,150,1.5,-116,4.09,Sydney Cricket Ground,4,2
3/22/2014,2014,ARI,LAD,1,3,150,1.5,-116,6.5,-120,100,-170,-1.5,-104,2.6,Sydney Cricket Ground,4,-2
3/23/2014,2014,LAD,ARI,7,5,-119,-1.5,140,7.5,-115,-105,109,1.5,-160,4.08,Sydney Cricket Ground,12,2
3/23/2014,2014,ARI,LAD,5,7,109,1.5,-160,7.5,-115,-105,-119,-1.5,140,3.59,Sydney Cricket Ground,12,-2
3/30/2014,2014,SD,LAD,3,1,105,1.5,-170,6.5,-105,-115,-115,-1.5,150,3.17,PETCO Park,4,2
3/30/2014,2014,LAD,SD,1,3,-115,-1.5,150,6.5,-105,-115,105,1.5,-170,3.48,PETCO Park,4,-2
3/31/2014,2014,SF,ARI,9,8,-118,-1.5,140,8,-114,-106,108,1.5,-160,4.33,Chase Field,17,1
3/31/2014,2014,MIL,ATL,2,0,103,1.5,-165,8,-105,-115,-113,-1.5,145,3.94,Miller Park,2,2
3/31/2014,2014,BOS,BAL,1,2,-115,-1.5,140,9,105,-125,105,1.5,-160,4.81,Camden Yards,3,-1
3/31/2014,2014,BAL,BOS,2,1,105,1.5,-160,9,105,-125,-115,-1.5,140,4.39,Camden Yards,3,1
3/31/2014,2014,PIT,CHC,1,0,-190,-1.5,125,6.5,-110,-110,170,1.5,-145,4.26,PNC Park,1,1
3/31/2014,2014,STL,CIN,1,0,-120,-1.5,135,7,-110,-110,110,1.5,-155,3.82,Great American Ballpark,1,1
3/31/2014,2014,OAK,CLE,0,2,-145,-1.5,155,7,-114,-106,130,1.5,-175,4.14,Oakland Coliseum,2,-2
3/31/2014,2014,MIA,COL,10,1,-145,-1.5,155,6.5,100,-120,130,1.5,-175,3.85,Marlins Park,11,9
3/31/2014,2014,MIN,CWS,3,5,155,1.5,-145,7,-120,100,-175,-1.5,125,2.75,Guaranteed Rate Field,8,-2
3/31/2014,2014,KC,DET,3,4,133,1.5,-170,7,-105,-115,-148,-1.5,150,3,Comerica Park,7,-1
3/31/2014,2014,DET,KC,4,3,-148,-1.5,150,7,-105,-115,133,1.5,-170,4.18,Comerica Park,7,1
3/31/2014,2014,SEA,LAA,10,3,104,1.5,-212,7,-114,-106,-114,-1.5,182,3.43,Angel Stadium,13,7
3/31/2014,2014,COL,MIA,1,10,130,1.5,-175,6.5,100,-120,-145,-1.5,155,2.83,Marlins Park,11,-9
3/31/2014,2014,ATL,MIL,0,2,-113,-1.5,145,8,-105,-115,103,1.5,-165,4.24,Miller Park,2,-2
3/31/2014,2014,CWS,MIN,5,3,-175,-1.5,125,7,-120,100,155,1.5,-145,4.45,Guaranteed Rate Field,8,2
3/31/2014,2014,WSH,NYM,9,7,-179,-1.5,-105,6.5,100,-120,159,1.5,-115,4.17,Citi Field,16,2
3/31/2014,2014,CLE,OAK,2,0,130,1.5,-175,7,-114,-106,-145,-1.5,155,3.04,Oakland Coliseum,2,2
3/31/2014,2014,TEX,PHI,10,14,-105,-1.5,185,7.5,-115,-105,-105,1.5,-215,3.84,Rangers Ballpark,24,-4
3/31/2014,2014,CHC,PIT,0,1,170,1.5,-145,6.5,-110,-110,-190,-1.5,125,2.41,PNC Park,1,-1
3/31/2014,2014,LAA,SEA,3,10,-114,-1.5,182,7,-114,-106,104,1.5,-212,3.73,Angel Stadium,13,-7
3/31/2014,2014,ARI,SF,8,9,108,1.5,-160,8,-114,-106,-118,-1.5,140,3.85,Chase Field,17,-1
3/31/2014,2014,CIN,STL,0,1,110,1.5,-155,7,-110,-110,-120,-1.5,135,3.33,Great American Ballpark,1,-1
3/31/2014,2014,TOR,TB,2,9,149,1.5,-155,7,-105,-115,-164,-1.5,135,2.81,Tropicana Field,11,-7
3/31/2014,2014,PHI,TEX,14,10,-105,1.5,-215,7.5,-115,-105,-105,-1.5,185,3.84,Rangers Ballpark,24,4
3/31/2014,2014,TB,TOR,9,2,-164,-1.5,135,7,-105,-115,149,1.5,-155,4.35,Tropicana Field,11,7
3/31/2014,2014,NYM,WSH,7,9,159,1.5,-115,6.5,100,-120,-179,-1.5,-105,2.51,Citi Field,16,-2
4/1/2014,2014,SF,ARI,4,5,107,1.5,-205,8.5,-110,-110,-117,-1.5,175,4.11,Chase Field,9,-1
4/1/2014,2014,MIL,ATL,2,5,-114,-1.5,175,8.5,-110,-110,104,1.5,-205,4.53,Miller Park,7,-3
4/1/2014,2014,MIA,COL,4,3,112,1.5,-165,7,-115,-105,-122,-1.5,145,3.3,Marlins Park,7,1
4/1/2014,2014,NYY,HOU,2,6,-150,-1.5,110,8.5,-120,100,135,1.5,-130,5.1,Minute Maid Park,8,-4
4/1/2014,2014,SEA,LAA,8,3,150,1.5,-145,7.5,105,-125,-170,-1.5,125,3,Angel Stadium,11,5
4/1/2014,2014,SD,LAD,2,3,135,1.5,-135,6.5,-110,-110,-150,-1.5,115,2.77,PETCO Park,5,-1
4/1/2014,2014,COL,MIA,3,4,-122,-1.5,145,7,-115,-105,112,1.5,-165,3.85,Marlins Park,7,-1
4/1/2014,2014,ATL,MIL,5,2,104,1.5,-205,8.5,-110,-110,-114,-1.5,175,4.17,Miller Park,7,3
4/1/2014,2014,HOU,NYY,6,2,135,1.5,-130,8.5,-120,100,-150,-1.5,110,3.62,Minute Maid Park,8,4
4/1/2014,2014,TEX,PHI,3,2,-146,-1.5,145,8.5,-115,-105,131,1.5,-165,5.04,Rangers Ballpark,5,1
4/1/2014,2014,LAD,SD,3,2,-150,-1.5,115,6.5,-110,-110,135,1.5,-135,3.9,PETCO Park,5,1
4/1/2014,2014,LAA,SEA,3,8,-170,-1.5,125,7.5,105,-125,150,1.5,-145,4.72,Angel Stadium,11,-5
4/1/2014,2014,ARI,SF,5,4,-117,-1.5,175,8.5,-110,-110,107,1.5,-205,4.58,Chase Field,9,1
4/1/2014,2014,TOR,TB,4,2,150,1.5,-145,7.5,-105,-115,-165,-1.5,125,3,Tropicana Field,6,2
4/1/2014,2014,PHI,TEX,2,3,131,1.5,-165,8.5,-115,-105,-146,-1.5,145,3.68,Rangers Ballpark,5,-1
4/1/2014,2014,TB,TOR,2,4,-165,-1.5,125,7.5,-105,-115,150,1.5,-145,4.67,Tropicana Field,6,-2
4/2/2014,2014,SF,ARI,2,0,-105,1.5,-215,8.5,-120,100,-105,-1.5,185,4.35,Chase Field,2,2
4/2/2014,2014,MIL,ATL,0,1,-124,-1.5,150,9,-105,-115,114,1.5,-170,4.98,Miller Park,1,-1
4/2/2014,2014,BOS,BAL,6,2,-117,-1.5,140,8.5,-115,-105,107,1.5,-160,4.58,Camden Yards,8,4
4/2/2014,2014,BAL,BOS,2,6,107,1.5,-160,8.5,-115,-105,-117,-1.5,140,4.11,Camden Yards,8,-4
4/2/2014,2014,PIT,CHC,4,3,-155,-1.5,147,7,110,-130,140,1.5,-167,4.25,PNC Park,7,1
4/2/2014,2014,STL,CIN,0,1,-116,-1.5,145,7,-110,-110,106,1.5,-165,3.76,Great American Ballpark,1,-1
4/2/2014,2014,OAK,CLE,6,1,-145,-1.5,155,7.5,-105,-130,118,1.5,-185,4.44,Oakland Coliseum,7,5
4/2/2014,2014,OAK,CLE,4,6,-128,-1.5,165,8,110,-115,130,1.5,-175,4.49,Oakland Coliseum,10,-2
4/2/2014,2014,MIA,COL,5,6,-123,-1.5,175,7.5,102,-122,113,1.5,-205,4.14,Marlins Park,11,-1
4/2/2014,2014,MIN,CWS,6,7,125,1.5,-175,8,102,-122,-140,-1.5,155,3.56,Guaranteed Rate Field,13,-1
4/2/2014,2014,KC,DET,1,2,170,1.5,-125,7.5,-107,-113,-200,-1.5,105,2.78,Comerica Park,3,-1
4/2/2014,2014,NYY,HOU,1,3,-170,-1.5,-110,8,-122,102,150,1.5,-110,5.04,Minute Maid Park,4,-2
4/2/2014,2014,DET,KC,2,1,-200,-1.5,105,7.5,-107,-113,170,1.5,-125,5,Comerica Park,3,1
4/2/2014,2014,SEA,LAA,8,2,127,1.5,-175,7.5,105,-125,-142,-1.5,155,3.3,Angel Stadium,10,6
4/2/2014,2014,SD,LAD,1,5,-110,-1.5,190,6.5,-125,105,100,1.5,-230,3.4,PETCO Park,6,-4
4/2/2014,2014,COL,MIA,6,5,113,1.5,-205,7.5,102,-122,-123,-1.5,175,3.52,Marlins Park,11,1
4/2/2014,2014,ATL,MIL,1,0,114,1.5,-170,9,-105,-115,-124,-1.5,150,4.21,Miller Park,1,1
4/2/2014,2014,CWS,MIN,7,6,-140,-1.5,155,8,102,-122,125,1.5,-175,4.67,Guaranteed Rate Field,13,1
4/2/2014,2014,WSH,NYM,5,1,-122,-1.5,140,6.5,-120,100,112,1.5,-160,3.57,Citi Field,6,4
4/2/2014,2014,HOU,NYY,3,1,150,1.5,-110,8,-122,102,-170,-1.5,-110,3.2,Minute Maid Park,4,2
4/2/2014,2014,CLE,OAK,1,6,118,1.5,-185,8,-105,-130,-145,-1.5,155,3.67,Oakland Coliseum,7,-5
4/2/2014,2014,CLE,OAK,6,4,130,1.5,-175,7.5,110,-115,-128,-1.5,165,3.26,Oakland Coliseum,10,2
4/2/2014,2014,TEX,PHI,4,3,-170,-1.5,115,9.5,-110,-110,150,1.5,-135,5.98,Rangers Ballpark,7,1
4/2/2014,2014,CHC,PIT,3,4,140,1.5,-167,7,110,-130,-155,-1.5,147,2.92,PNC Park,7,-1
4/2/2014,2014,LAD,SD,5,1,100,1.5,-230,6.5,-125,105,-110,-1.5,190,3.25,PETCO Park,6,4
4/2/2014,2014,LAA,SEA,2,8,-142,-1.5,155,7.5,105,-125,127,1.5,-175,4.4,Angel Stadium,10,-6
4/2/2014,2014,ARI,SF,0,2,-105,-1.5,185,8.5,-120,100,-105,1.5,-215,4.35,Chase Field,2,-2
4/2/2014,2014,CIN,STL,1,0,106,1.5,-165,7,-110,-110,-116,-1.5,145,3.4,Great American Ballpark,1,1
4/2/2014,2014,TOR,TB,3,0,138,1.5,-160,8,100,-120,-153,-1.5,140,3.36,Tropicana Field,3,3
4/2/2014,2014,PHI,TEX,3,4,150,1.5,-135,9.5,-110,-110,-170,-1.5,115,3.8,Rangers Ballpark,7,-1
4/2/2014,2014,TB,TOR,0,3,-153,-1.5,140,8,100,-120,138,1.5,-160,4.84,Tropicana Field,3,-3
4/2/2014,2014,NYM,WSH,1,5,112,1.5,-160,6.5,-120,100,-122,-1.5,140,3.07,Citi Field,6,-4
4/3/2014,2014,SF,ARI,8,5,107,1.5,-200,8.5,-110,-110,-117,-1.5,170,4.11,Chase Field,13,3
4/3/2014,2014,BOS,BAL,4,3,-101,1.5,-210,9,-105,-115,-109,-1.5,180,4.52,Camden Yards,7,1
4/3/2014,2014,BAL,BOS,3,4,-109,-1.5,180,9,-105,-115,-101,1.5,-210,4.69,Camden Yards,7,-1
4/3/2014,2014,PIT,CHC,2,3,-159,-1.5,140,7,-115,-105,144,1.5,-160,4.3,PNC Park,5,-1
4/3/2014,2014,STL,CIN,7,6,102,1.5,-220,7.5,100,-120,-112,-1.5,190,3.71,Great American Ballpark,13,1
4/3/2014,2014,MIA,COL,8,5,103,1.5,-170,7.5,105,-125,-113,-1.5,150,3.69,Marlins Park,13,3
4/3/2014,2014,MIN,CWS,10,9,125,1.5,-170,7.5,-110,-110,-140,-1.5,150,3.33,Guaranteed Rate Field,19,1
4/3/2014,2014,NYY,HOU,4,2,-152,-1.5,110,8.5,100,-120,137,1.5,-130,5.13,Minute Maid Park,6,2
4/3/2014,2014,COL,MIA,5,8,-113,-1.5,150,7.5,105,-125,103,1.5,-170,3.98,Marlins Park,13,-3
4/3/2014,2014,CWS,MIN,9,10,-140,-1.5,150,7.5,-110,-110,125,1.5,-170,4.38,Guaranteed Rate Field,19,-1
4/3/2014,2014,WSH,NYM,8,2,-117,-1.5,145,7,105,-125,107,1.5,-165,3.77,Citi Field,10,6
4/3/2014,2014,HOU,NYY,2,4,137,1.5,-130,8.5,100,-120,-152,-1.5,110,3.59,Minute Maid Park,6,-2
4/3/2014,2014,SEA,OAK,2,3,125,1.5,-165,8,100,-120,-140,-1.5,145,3.56,Oakland Coliseum,5,-1
4/3/2014,2014,CHC,PIT,3,2,144,1.5,-160,7,-115,-105,-159,-1.5,140,2.87,PNC Park,5,1
4/3/2014,2014,OAK,SEA,3,2,-140,-1.5,145,8,100,-120,125,1.5,-165,4.67,Oakland Coliseum,5,1
4/3/2014,2014,ARI,SF,5,8,-117,-1.5,170,8.5,-110,-110,107,1.5,-200,4.58,Chase Field,13,-3
4/3/2014,2014,CIN,STL,6,7,-112,-1.5,190,7.5,100,-120,102,1.5,-220,3.96,Great American Ballpark,13,-1
4/3/2014,2014,TOR,TB,2,7,141,1.5,-150,8,-105,-115,-156,-1.5,130,3.32,Tropicana Field,9,-5
4/3/2014,2014,TB,TOR,7,2,-156,-1.5,130,8,-105,-115,141,1.5,-150,4.88,Tropicana Field,9,5
4/3/2014,2014,NYM,WSH,2,8,107,1.5,-165,7,105,-125,-117,-1.5,145,3.38,Citi Field,10,-6
4/4/2014,2014,COL,ARI,12,2,-126,-1.5,160,10,-105,-115,116,1.5,-180,5.58,Coors Field,14,10
4/4/2014,2014,WSH,ATL,1,2,-172,-1.5,125,7.5,-110,-110,152,1.5,-145,4.74,Nationals Park,3,-1
4/4/2014,2014,DET,BAL,10,4,-167,-1.5,130,7.5,-120,100,152,1.5,-150,4.69,Comerica Park,14,6
4/4/2014,2014,MIL,BOS,6,2,128,1.5,-165,8.5,-125,105,-143,-1.5,145,3.73,Fenway Park,8,4
4/4/2014,2014,PHI,CHC,7,2,135,1.5,-155,11,-105,-115,-150,-1.5,135,4.68,Wrigley Field,9,5
4/4/2014,2014,NYM,CIN,4,3,-109,-1.5,190,7,-115,-105,-101,1.5,-220,3.65,Citi Field,7,1
4/4/2014,2014,MIN,CLE,2,7,170,1.5,-130,7.5,-112,-108,-190,-1.5,110,2.78,Progressive Field,9,-5
4/4/2014,2014,ARI,COL,2,12,116,1.5,-180,10,-105,-115,-126,-1.5,160,4.63,Coors Field,14,-10
4/4/2014,2014,KC,CWS,7,5,-152,-1.5,140,8.5,100,-120,137,1.5,-160,5.13,Kauffman Stadium,12,2
4/4/2014,2014,BAL,DET,4,10,152,1.5,-150,7.5,-120,100,-167,-1.5,130,2.98,Comerica Park,14,-6
4/4/2014,2014,LAA,HOU,11,1,-180,-1.5,-115,9.5,100,-120,160,1.5,-105,6.11,Minute Maid Park,12,10
4/4/2014,2014,CWS,KC,5,7,137,1.5,-160,8.5,100,-120,-152,-1.5,140,3.59,Kauffman Stadium,12,-2
4/4/2014,2014,HOU,LAA,1,11,160,1.5,-105,9.5,100,-120,-180,-1.5,-115,3.65,Minute Maid Park,12,-10
4/4/2014,2014,SF,LAD,8,4,165,1.5,-150,7.5,103,-123,-185,-1.5,130,2.83,Dodger Stadium,12,4
4/4/2014,2014,SD,MIA,2,8,-103,1.5,-215,7.5,-110,-110,-107,-1.5,185,3.81,Marlins Park,10,-6
4/4/2014,2014,BOS,MIL,2,6,-143,-1.5,145,8.5,-125,105,128,1.5,-165,5,Fenway Park,8,-4
4/4/2014,2014,CLE,MIN,7,2,-190,-1.5,110,7.5,-112,-108,170,1.5,-130,4.91,Progressive Field,9,5
4/4/2014,2014,CIN,NYM,3,4,-101,1.5,-220,7,-115,-105,-109,-1.5,190,3.52,Citi Field,7,-1
4/4/2014,2014,TOR,NYY,3,7,128,1.5,-140,8.5,-115,-105,-143,-1.5,120,3.73,Rogers Centre,10,-4
4/4/2014,2014,CHC,PHI,2,7,-150,-1.5,135,11,-105,-115,135,1.5,-155,6.6,Wrigley Field,9,-5
4/4/2014,2014,STL,PIT,2,12,-102,1.5,-240,7,105,-125,-108,-1.5,200,3.53,PNC Park,14,-10
4/4/2014,2014,MIA,SD,8,2,-107,-1.5,185,7.5,-110,-110,-103,1.5,-215,3.88,Marlins Park,10,6
4/4/2014,2014,LAD,SF,4,8,-185,-1.5,130,7.5,103,-123,165,1.5,-150,4.87,Dodger Stadium,12,-4
4/4/2014,2014,PIT,STL,12,2,-108,-1.5,200,7,105,-125,-102,1.5,-240,3.63,PNC Park,14,10
4/4/2014,2014,TEX,TB,1,8,139,1.5,-155,8.5,-113,-107,-154,-1.5,135,3.56,Tropicana Field,9,-7
4/4/2014,2014,TB,TEX,8,1,-154,-1.5,135,8.5,-113,-107,139,1.5,-155,5.15,Tropicana Field,9,7
4/4/2014,2014,NYY,TOR,7,3,-143,-1.5,120,8.5,-115,-105,128,1.5,-140,5,Rogers Centre,10,4
4/4/2014,2014,ATL,WSH,2,1,152,1.5,-145,7.5,-110,-110,-172,-1.5,125,2.98,Nationals Park,3,1
4/5/2014,2014,COL,ARI,9,4,-117,-1.5,170,9.5,-105,-115,107,1.5,-200,5.12,Coors Field,13,5
4/5/2014,2014,WSH,ATL,2,6,-158,-1.5,145,6.5,-105,-115,143,1.5,-165,3.98,Nationals Park,8,-4
4/5/2014,2014,DET,BAL,7,6,-133,-1.5,155,8.5,-120,100,118,1.5,-175,4.85,Comerica Park,13,1
4/5/2014,2014,MIL,BOS,7,6,170,1.5,-140,8.5,-110,-110,-190,-1.5,120,3.15,Fenway Park,13,1
4/5/2014,2014,PHI,CHC,2,0,-116,-1.5,155,6.5,-105,-115,106,1.5,-175,3.49,Wrigley Field,2,2
4/5/2014,2014,NYM,CIN,6,3,115,1.5,-150,6.5,-115,-105,-130,-1.5,130,3.02,Citi Field,9,3
4/5/2014,2014,MIN,CLE,7,3,143,1.5,-155,8.5,-105,-115,-158,-1.5,135,3.5,Progressive Field,10,4
4/5/2014,2014,ARI,COL,4,9,107,1.5,-200,9.5,-105,-115,-117,-1.5,170,4.59,Coors Field,13,-5
4/5/2014,2014,KC,CWS,4,3,-151,-1.5,140,8,-105,-115,136,1.5,-160,4.81,Kauffman Stadium,7,1
4/5/2014,2014,BAL,DET,6,7,118,1.5,-175,8.5,-120,100,-133,-1.5,155,3.9,Comerica Park,13,-1
4/5/2014,2014,LAA,HOU,5,1,-150,-1.5,105,9,-110,-110,135,1.5,-125,5.4,Minute Maid Park,6,4
4/5/2014,2014,CWS,KC,3,4,136,1.5,-160,8,-105,-115,-151,-1.5,140,3.39,Kauffman Stadium,7,-1
4/5/2014,2014,HOU,LAA,1,5,135,1.5,-125,9,-110,-110,-150,-1.5,105,3.83,Minute Maid Park,6,-4
4/5/2014,2014,SF,LAD,7,2,-112,-1.5,150,7.5,100,-120,102,1.5,-170,3.96,Dodger Stadium,9,5
4/5/2014,2014,SD,MIA,0,5,135,1.5,-170,6.5,100,-120,-150,-1.5,150,2.77,Marlins Park,5,-5
4/5/2014,2014,BOS,MIL,6,7,-190,-1.5,120,8.5,-110,-110,170,1.5,-140,5.57,Fenway Park,13,-1
4/5/2014,2014,CLE,MIN,3,7,-158,-1.5,135,8.5,-105,-115,143,1.5,-155,5.21,Progressive Field,10,-4
4/5/2014,2014,CIN,NYM,3,6,-130,-1.5,130,6.5,-115,-105,115,1.5,-150,3.67,Citi Field,9,-3
4/5/2014,2014,TOR,NYY,4,0,-129,-1.5,145,9,100,-120,119,1.5,-165,5.07,Rogers Centre,4,4
4/5/2014,2014,SEA,OAK,3,1,-122,-1.5,140,7,100,-120,112,1.5,-160,3.85,Oakland Coliseum,4,2
4/5/2014,2014,CHC,PHI,0,2,106,1.5,-175,6.5,-105,-115,-116,-1.5,155,3.16,Wrigley Field,2,-2
4/5/2014,2014,STL,PIT,6,1,130,1.5,-180,7,100,-120,-145,-1.5,160,3.04,PNC Park,7,5
4/5/2014,2014,MIA,SD,5,0,-150,-1.5,150,6.5,100,-120,135,1.5,-170,3.9,Marlins Park,5,5
4/5/2014,2014,OAK,SEA,1,3,112,1.5,-160,7,100,-120,-122,-1.5,140,3.3,Oakland Coliseum,4,-2
4/5/2014,2014,LAD,SF,2,7,102,1.5,-170,7.5,100,-120,-112,-1.5,150,3.71,Dodger Stadium,9,-5
4/5/2014,2014,PIT,STL,1,6,-145,-1.5,160,7,100,-120,130,1.5,-180,4.14,PNC Park,7,-5
4/5/2014,2014,TEX,TB,4,5,160,1.5,-140,7.5,-110,-110,-180,-1.5,120,2.88,Tropicana Field,9,-1
4/5/2014,2014,TB,TEX,5,4,-180,-1.5,120,7.5,-110,-110,160,1.5,-140,4.82,Tropicana Field,9,1
4/5/2014,2014,NYY,TOR,0,4,119,1.5,-165,9,100,-120,-129,-1.5,145,4.11,Rogers Centre,4,-4
4/5/2014,2014,ATL,WSH,6,2,143,1.5,-165,6.5,-105,-115,-158,-1.5,145,2.67,Nationals Park,8,4
4/6/2014,2014,COL,ARI,3,5,-126,-1.5,160,9,-110,-110,116,1.5,-180,5.02,Coors Field,8,-2
4/6/2014,2014,WSH,ATL,2,1,-103,-1.5,195,7,100,-120,-107,1.5,-225,3.55,Nationals Park,3,1
4/6/2014,2014,DET,BAL,1,3,-154,-1.5,140,7.5,-105,-115,139,1.5,-160,4.55,Comerica Park,4,-2
4/6/2014,2014,MIL,BOS,4,0,141,1.5,-150,9,100,-120,-156,-1.5,130,3.73,Fenway Park,4,4
4/6/2014,2014,PHI,CHC,3,8,-114,-1.5,155,7.5,107,-127,104,1.5,-175,4,Wrigley Field,11,-5
4/6/2014,2014,NYM,CIN,1,2,-106,-1.5,195,7,-115,-105,-104,1.5,-225,3.6,Citi Field,3,-1
4/6/2014,2014,MIN,CLE,10,7,175,1.5,-130,7.5,103,-123,-195,-1.5,110,2.73,Progressive Field,17,3
4/6/2014,2014,ARI,COL,5,3,116,1.5,-180,9,-110,-110,-126,-1.5,160,4.17,Coors Field,8,2
4/6/2014,2014,KC,CWS,1,5,-116,-1.5,180,7,100,-120,106,1.5,-210,3.76,Kauffman Stadium,6,-4
4/6/2014,2014,BAL,DET,3,1,139,1.5,-160,7.5,-105,-115,-154,-1.5,140,3.14,Comerica Park,4,2
4/6/2014,2014,LAA,HOU,4,7,-156,-1.5,105,8,-120,100,141,1.5,-125,4.88,Minute Maid Park,11,-3
4/6/2014,2014,CWS,KC,5,1,106,1.5,-210,7,100,-120,-116,-1.5,180,3.4,Kauffman Stadium,6,4
4/6/2014,2014,HOU,LAA,7,4,141,1.5,-125,8,-120,100,-156,-1.5,105,3.32,Minute Maid Park,11,3
4/6/2014,2014,SF,LAD,2,6,132,1.5,-164,6.5,-125,105,-147,-1.5,144,2.8,Dodger Stadium,8,-4
4/6/2014,2014,SD,MIA,4,2,109,1.5,-195,7.5,-105,-115,-119,-1.5,165,3.59,Marlins Park,6,2
4/6/2014,2014,BOS,MIL,0,4,-156,-1.5,130,9,100,-120,141,1.5,-150,5.48,Fenway Park,4,-4
4/6/2014,2014,CLE,MIN,7,10,-195,-1.5,110,7.5,103,-123,175,1.5,-130,4.96,Progressive Field,17,-3
4/6/2014,2014,CIN,NYM,2,1,-104,1.5,-225,7,-115,-105,-106,-1.5,195,3.57,Citi Field,3,1
4/6/2014,2014,TOR,NYY,4,6,-121,-1.5,170,8.5,-115,-105,111,1.5,-200,4.65,Rogers Centre,10,-2
4/6/2014,2014,SEA,OAK,3,6,132,1.5,-161,7.5,-108,-112,-147,-1.5,141,3.23,Oakland Coliseum,9,-3
4/6/2014,2014,CHC,PHI,8,3,104,1.5,-175,7.5,107,-127,-114,-1.5,155,3.68,Wrigley Field,11,5
4/6/2014,2014,STL,PIT,1,2,-165,-1.5,-101,7,-106,-114,150,1.5,-119,4.36,PNC Park,3,-1
4/6/2014,2014,MIA,SD,2,4,-119,-1.5,165,7.5,-105,-115,109,1.5,-195,4.08,Marlins Park,6,-2
4/6/2014,2014,OAK,SEA,6,3,-147,-1.5,141,7.5,-108,-112,132,1.5,-161,4.46,Oakland Coliseum,9,3
4/6/2014,2014,LAD,SF,6,2,-147,-1.5,144,6.5,-125,105,132,1.5,-164,3.87,Dodger Stadium,8,4
4/6/2014,2014,PIT,STL,2,1,150,1.5,-119,7,-106,-114,-165,-1.5,-101,2.8,PNC Park,3,1
4/6/2014,2014,TEX,TB,3,0,-108,-1.5,165,7,-110,-110,-102,1.5,-185,3.63,Tropicana Field,3,3
4/6/2014,2014,TB,TEX,0,3,-102,1.5,-185,7,-110,-110,-108,-1.5,165,3.53,Tropicana Field,3,-3
4/6/2014,2014,NYY,TOR,6,4,111,1.5,-200,8.5,-115,-105,-121,-1.5,170,4.03,Rogers Centre,10,2
4/6/2014,2014,ATL,WSH,1,2,-107,1.5,-225,7,100,-120,-103,-1.5,195,3.62,Nationals Park,3,-1
4/7/2014,2014,NYY,BAL,4,2,-142,-1.5,155,8,-110,-110,127,1.5,-175,4.69,Yankee Stadium,6,2
4/7/2014,2014,TEX,BOS,1,5,138,1.5,-145,9,-125,105,-153,-1.5,125,3.78,Fenway Park,6,-4
4/7/2014,2014,STL,CIN,5,3,-153,-1.5,155,6.5,100,-120,138,1.5,-175,3.93,Busch Stadium,8,2
4/7/2014,2014,CWS,COL,1,8,136,1.5,-155,9.5,-110,-110,-151,-1.5,135,4.03,Coors Field,9,-7
4/7/2014,2014,COL,CWS,8,1,-151,-1.5,135,9.5,-110,-110,136,1.5,-155,5.72,Coors Field,9,7
4/7/2014,2014,LAA,HOU,9,1,-160,-1.5,-101,8.5,-115,-105,145,1.5,-119,5.23,Minute Maid Park,10,8
4/7/2014,2014,TB,KC,2,4,-101,1.5,-220,7.5,-110,-110,-109,-1.5,190,3.77,Kauffman Stadium,6,-2
4/7/2014,2014,HOU,LAA,1,9,145,1.5,-119,8.5,-115,-105,-160,-1.5,-101,3.47,Minute Maid Park,10,-8
4/7/2014,2014,OAK,MIN,8,3,-144,-1.5,115,8,-105,-115,129,1.5,-135,4.72,Target Field,11,5
4/7/2014,2014,BAL,NYY,2,4,127,1.5,-175,8,-110,-110,-142,-1.5,155,3.52,Yankee Stadium,6,-2
4/7/2014,2014,MIN,OAK,3,8,129,1.5,-135,8,-105,-115,-144,-1.5,115,3.49,Target Field,11,-5
4/7/2014,2014,CIN,STL,3,5,138,1.5,-175,6.5,100,-120,-153,-1.5,155,2.73,Busch Stadium,8,-2
4/7/2014,2014,KC,TB,4,2,-109,-1.5,190,7.5,-110,-110,-101,1.5,-220,3.91,Kauffman Stadium,6,2
4/7/2014,2014,BOS,TEX,5,1,-153,-1.5,125,9,-125,105,138,1.5,-145,5.44,Fenway Park,6,4
4/8/2014,2014,SF,ARI,7,3,-155,-1.5,145,7.5,-101,-119,140,1.5,-165,4.56,AT&T Park,10,4
4/8/2014,2014,NYM,ATL,4,0,119,1.5,-190,7,-115,-105,-129,-1.5,160,3.2,Turner Field,4,4
4/8/2014,2014,NYY,BAL,5,14,-105,-1.5,169,9,-125,105,-105,1.5,-199,4.61,Yankee Stadium,19,-9
4/8/2014,2014,TEX,BOS,10,7,118,1.5,-180,9.5,100,-120,-128,-1.5,160,4.36,Fenway Park,17,3
4/8/2014,2014,PIT,CHC,7,6,-118,-1.5,145,7,-120,100,108,1.5,-165,3.79,Wrigley Field,13,1
4/8/2014,2014,STL,CIN,7,5,-133,-1.5,170,7,-110,-110,118,1.5,-200,4,Busch Stadium,12,2
4/8/2014,2014,SD,CLE,6,8,119,1.5,-190,7.5,100,-120,-129,-1.5,160,3.42,Progressive Field,14,-2
4/8/2014,2014,CWS,COL,15,3,140,1.5,-155,9.5,100,-120,-155,-1.5,135,3.96,Coors Field,18,12
4/8/2014,2014,COL,CWS,3,15,-155,-1.5,135,9.5,100,-120,140,1.5,-155,5.77,Coors Field,18,-12
4/8/2014,2014,LAD,DET,3,2,112,1.5,-170,7,100,-120,-122,-1.5,150,3.3,Dodger Stadium,5,1
4/8/2014,2014,TOR,HOU,5,2,-205,-1.5,-101,9.5,100,-120,175,1.5,-119,6.39,Rogers Centre,7,3
4/8/2014,2014,TB,KC,1,0,-109,-1.5,150,7.5,-113,-107,-101,1.5,-170,3.91,Kauffman Stadium,1,1
4/8/2014,2014,SEA,LAA,5,3,-120,-1.5,170,7.5,-110,-110,110,1.5,-200,4.09,T-Mobile Park,8,2
4/8/2014,2014,DET,LAD,2,3,-122,-1.5,150,7,100,-120,112,1.5,-170,3.85,Dodger Stadium,5,-1
4/8/2014,2014,WSH,MIA,5,0,-200,-1.5,110,7,-120,100,170,1.5,-130,4.67,Nationals Park,5,5
4/8/2014,2014,PHI,MIL,4,10,119,1.5,-160,9,100,-120,-129,-1.5,140,4.11,Citizens Bank Park,14,-6
4/8/2014,2014,ATL,NYM,0,4,-129,-1.5,160,7,-115,-105,119,1.5,-190,3.94,Turner Field,4,-4
4/8/2014,2014,BAL,NYY,14,5,-105,1.5,-199,9,-125,105,-105,-1.5,169,4.61,Yankee Stadium,19,9
4/8/2014,2014,MIL,PHI,10,4,-129,-1.5,140,9,100,-120,119,1.5,-160,5.07,Citizens Bank Park,14,6
4/8/2014,2014,CHC,PIT,6,7,108,1.5,-165,7,-120,100,-118,-1.5,145,3.37,Wrigley Field,13,-1
4/8/2014,2014,CLE,SD,8,6,-129,-1.5,160,7.5,100,-120,119,1.5,-190,4.22,Progressive Field,14,2
4/8/2014,2014,LAA,SEA,3,5,110,1.5,-200,7.5,-110,-110,-120,-1.5,170,3.57,T-Mobile Park,8,-2
4/8/2014,2014,ARI,SF,3,7,140,1.5,-165,7.5,-101,-119,-155,-1.5,145,3.13,AT&T Park,10,-4
4/8/2014,2014,CIN,STL,5,7,118,1.5,-200,7,-110,-110,-133,-1.5,170,3.21,Busch Stadium,12,-2
4/8/2014,2014,KC,TB,0,1,-101,1.5,-170,7.5,-113,-107,-109,-1.5,150,3.77,Kauffman Stadium,1,-1
4/8/2014,2014,BOS,TEX,7,10,-128,-1.5,160,9.5,100,-120,118,1.5,-180,5.33,Fenway Park,17,-3
4/8/2014,2014,HOU,TOR,2,5,175,1.5,-119,9.5,100,-120,-205,-1.5,-101,3.45,Rogers Centre,7,-3
4/8/2014,2014,MIA,WSH,0,5,170,1.5,-130,7,-120,100,-200,-1.5,110,2.59,Nationals Park,5,-5
4/9/2014,2014,SF,ARI,3,7,-126,-1.5,170,7.5,-105,-115,116,1.5,-200,4.18,AT&T Park,10,-4
4/9/2014,2014,NYM,ATL,3,4,152,1.5,-155,7,-106,-114,-167,-1.5,135,2.78,Turner Field,7,-1
4/9/2014,2014,NYY,BAL,4,5,-177,-1.5,115,8,-105,-115,157,1.5,-135,5.11,Yankee Stadium,9,-1
4/9/2014,2014,TEX,BOS,2,4,130,1.5,-165,8.5,-120,100,-145,-1.5,145,3.7,Fenway Park,6,-2
4/9/2014,2014,PIT,CHC,5,7,-109,-1.5,145,9,-105,-115,-101,1.5,-165,4.69,Wrigley Field,12,-2
4/9/2014,2014,STL,CIN,0,4,-143,-1.5,155,7.5,105,-125,128,1.5,-175,4.41,Busch Stadium,4,-4
4/9/2014,2014,SD,CLE,0,2,135,1.5,-160,8,-115,-105,-150,-1.5,140,3.4,Progressive Field,2,-2
4/9/2014,2014,SD,CLE,2,1,109,1.5,-200,8.5,-105,-115,-119,-1.5,170,4.07,Progressive Field,3,1
4/9/2014,2014,CWS,COL,4,10,150,1.5,-140,10,-110,-110,-170,-1.5,120,4,Coors Field,14,-6
4/9/2014,2014,COL,CWS,10,4,-170,-1.5,120,10,-110,-110,150,1.5,-140,6.3,Coors Field,14,6
4/9/2014,2014,LAD,DET,6,7,106,1.5,-165,7,-105,-115,-116,-1.5,145,3.4,Dodger Stadium,13,-1
4/9/2014,2014,TOR,HOU,7,3,-205,-1.5,-110,9,-125,105,175,1.5,-110,6.05,Rogers Centre,10,4
4/9/2014,2014,TB,KC,3,7,-117,-1.5,130,9,100,-120,107,1.5,-150,4.85,Kauffman Stadium,10,-4
4/9/2014,2014,SEA,LAA,0,2,-102,1.5,-170,8.5,-115,-105,-108,-1.5,150,4.29,T-Mobile Park,2,-2
4/9/2014,2014,DET,LAD,7,6,-116,-1.5,145,7,-105,-115,106,1.5,-165,3.76,Dodger Stadium,13,1
4/9/2014,2014,WSH,MIA,10,7,-200,-1.5,115,7,-105,-115,170,1.5,-135,4.67,Nationals Park,17,3
4/9/2014,2014,PHI,MIL,4,9,116,1.5,-150,7.5,105,-125,-126,-1.5,130,3.47,Citizens Bank Park,13,-5
4/9/2014,2014,OAK,MIN,7,4,-140,-1.5,120,8.5,-104,-116,125,1.5,-140,4.96,Target Field,11,3
4/9/2014,2014,ATL,NYM,4,3,-167,-1.5,135,7,-106,-114,152,1.5,-155,4.38,Turner Field,7,1
4/9/2014,2014,BAL,NYY,5,4,157,1.5,-135,8,-105,-115,-177,-1.5,115,3.11,Yankee Stadium,9,1
4/9/2014,2014,MIN,OAK,4,7,125,1.5,-140,8.5,-104,-116,-140,-1.5,120,3.78,Target Field,11,-3
4/9/2014,2014,MIL,PHI,9,4,-126,-1.5,130,7.5,105,-125,116,1.5,-150,4.18,Citizens Bank Park,13,5
4/9/2014,2014,CHC,PIT,7,5,-101,1.5,-165,9,-105,-115,-109,-1.5,145,4.52,Wrigley Field,12,2
4/9/2014,2014,CLE,SD,2,0,-150,-1.5,140,8,-115,-105,135,1.5,-160,4.8,Progressive Field,2,2
4/9/2014,2014,CLE,SD,1,2,-119,-1.5,170,8.5,-105,-115,109,1.5,-200,4.62,Progressive Field,3,-1
4/9/2014,2014,LAA,SEA,2,0,-108,-1.5,150,8.5,-115,-105,-102,1.5,-170,4.41,T-Mobile Park,2,2
4/9/2014,2014,ARI,SF,7,3,116,1.5,-200,7.5,-105,-115,-126,-1.5,170,3.47,AT&T Park,10,4
4/9/2014,2014,CIN,STL,4,0,128,1.5,-175,7.5,105,-125,-143,-1.5,155,3.29,Busch Stadium,4,4
4/9/2014,2014,KC,TB,7,3,107,1.5,-150,9,100,-120,-117,-1.5,130,4.35,Kauffman Stadium,10,4
4/9/2014,2014,BOS,TEX,4,2,-145,-1.5,145,8.5,-120,100,130,1.5,-165,5.03,Fenway Park,6,2
4/9/2014,2014,HOU,TOR,3,7,175,1.5,-110,9,-125,105,-205,-1.5,-110,3.27,Rogers Centre,10,-4
4/9/2014,2014,MIA,WSH,7,10,170,1.5,-135,7,-105,-115,-200,-1.5,115,2.59,Nationals Park,17,-3
4/10/2014,2014,SF,ARI,5,6,-117,-1.5,180,8,-120,100,107,1.5,-210,4.31,AT&T Park,11,-1
4/10/2014,2014,NYM,ATL,6,4,125,1.5,-180,7.5,101,-121,-140,-1.5,160,3.33,Turner Field,10,2
4/10/2014,2014,NYY,BOS,4,1,-109,-1.5,180,8.5,-113,-107,-101,1.5,-210,4.43,Yankee Stadium,5,3
4/10/2014,2014,PIT,CHC,5,4,-130,-1.5,125,7.5,105,-125,115,1.5,-145,4.24,Wrigley Field,9,1
4/10/2014,2014,CWS,CLE,7,3,116,1.5,-150,8,-115,-105,-126,-1.5,130,3.7,Guaranteed Rate Field,10,4
4/10/2014,2014,CLE,CWS,3,7,-126,-1.5,130,8,-115,-105,116,1.5,-150,4.46,Guaranteed Rate Field,10,-4
4/10/2014,2014,TOR,HOU,4,6,-203,-1.5,-105,9.5,100,-120,173,1.5,-115,6.36,Rogers Centre,10,-2
4/10/2014,2014,WSH,MIA,7,1,-220,-1.5,100,7,-115,-105,190,1.5,-120,4.81,Nationals Park,8,6
4/10/2014,2014,PHI,MIL,2,6,-118,-1.5,180,7,-120,100,108,1.5,-210,3.79,Citizens Bank Park,8,-4
4/10/2014,2014,OAK,MIN,6,1,-140,-1.5,115,8.5,100,-120,125,1.5,-135,4.96,Target Field,7,5
4/10/2014,2014,ATL,NYM,4,6,-140,-1.5,160,7.5,101,-121,125,1.5,-180,4.38,Turner Field,10,-2
4/10/2014,2014,BOS,NYY,1,4,-101,1.5,-210,8.5,-113,-107,-109,-1.5,180,4.27,Yankee Stadium,5,-3
4/10/2014,2014,MIN,OAK,1,6,125,1.5,-135,8.5,100,-120,-140,-1.5,115,3.78,Target Field,7,-5
4/10/2014,2014,MIL,PHI,6,2,108,1.5,-210,7,-120,100,-118,-1.5,180,3.37,Citizens Bank Park,8,4
4/10/2014,2014,CHC,PIT,4,5,115,1.5,-145,7.5,105,-125,-130,-1.5,125,3.49,Wrigley Field,9,-1
4/10/2014,2014,ARI,SF,6,5,107,1.5,-210,8,-120,100,-117,-1.5,180,3.86,AT&T Park,11,1
4/10/2014,2014,HOU,TOR,6,4,173,1.5,-115,9.5,100,-120,-203,-1.5,-105,3.48,Rogers Centre,10,2
4/10/2014,2014,MIA,WSH,1,7,190,1.5,-120,7,-115,-105,-220,-1.5,100,2.41,Nationals Park,8,-6
4/11/2014,2014,LAD,ARI,6,0,-115,-1.5,140,8.5,-125,105,105,1.5,-160,4.55,Chase Field,6,6
4/11/2014,2014,WSH,ATL,6,7,114,1.5,-205,7.5,100,-120,-124,-1.5,175,3.5,Turner Field,13,-1
4/11/2014,2014,TOR,BAL,2,0,142,1.5,-150,8.5,-115,-105,-157,-1.5,130,3.51,Camden Yards,2,2
4/11/2014,2014,NYY,BOS,2,4,116,1.5,-140,8,100,-120,-126,-1.5,120,3.7,Yankee Stadium,6,-2
4/11/2014,2014,STL,CHC,3,6,-141,-1.5,155,7,-125,105,126,1.5,-175,4.1,Busch Stadium,9,-3
4/11/2014,2014,TB,CIN,2,1,-123,-1.5,140,7,107,-127,113,1.5,-160,3.86,Great American Ballpark,3,1
4/11/2014,2014,CWS,CLE,9,6,-158,-1.5,135,7.5,-115,-105,143,1.5,-155,4.59,Guaranteed Rate Field,15,3
4/11/2014,2014,SF,COL,6,5,-161,-1.5,145,6.5,-105,-115,146,1.5,-165,4.01,AT&T Park,11,1
4/11/2014,2014,CLE,CWS,6,9,143,1.5,-155,7.5,-115,-105,-158,-1.5,135,3.09,Guaranteed Rate Field,15,-3
4/11/2014,2014,SD,DET,6,0,-112,-1.5,190,7,105,-125,102,1.5,-230,3.7,PETCO Park,6,6
4/11/2014,2014,TEX,HOU,1,0,-220,-1.5,-110,8,-120,100,190,1.5,-110,5.5,Rangers Ballpark,1,1
4/11/2014,2014,MIN,KC,10,1,110,1.5,-160,8,-110,-110,-120,-1.5,140,3.81,Target Field,11,9
4/11/2014,2014,NYM,LAA,4,5,145,1.5,-155,8,-105,-115,-160,-1.5,135,3.27,Angel Stadium,9,-1
4/11/2014,2014,ARI,LAD,0,6,105,1.5,-160,8.5,-125,105,-115,-1.5,140,4.15,Chase Field,6,-6
4/11/2014,2014,PHI,MIA,6,3,125,1.5,-145,7,-105,-115,-140,-1.5,125,3.11,Citizens Bank Park,9,3
4/11/2014,2014,PIT,MIL,2,4,105,1.5,-210,8.5,-105,-115,-115,-1.5,180,4.15,Miller Park,6,-2
4/11/2014,2014,KC,MIN,1,10,-120,-1.5,140,8,-110,-110,110,1.5,-160,4.36,Target Field,11,-9
4/11/2014,2014,LAA,NYM,5,4,-160,-1.5,135,8,-105,-115,145,1.5,-155,4.92,Angel Stadium,9,1
4/11/2014,2014,BOS,NYY,4,2,-126,-1.5,120,8,100,-120,116,1.5,-140,4.46,Yankee Stadium,6,2
4/11/2014,2014,SEA,OAK,6,4,-151,-1.5,150,6.5,-105,-115,136,1.5,-170,3.91,T-Mobile Park,10,2
4/11/2014,2014,MIA,PHI,3,6,-140,-1.5,125,7,-105,-115,125,1.5,-145,4.08,Citizens Bank Park,9,-3
4/11/2014,2014,MIL,PIT,4,2,-115,-1.5,180,8.5,-105,-115,105,1.5,-210,4.55,Miller Park,6,2
4/11/2014,2014,DET,SD,0,6,102,1.5,-230,7,105,-125,-112,-1.5,190,3.47,PETCO Park,6,-6
4/11/2014,2014,OAK,SEA,4,6,136,1.5,-170,6.5,-105,-115,-151,-1.5,150,2.75,T-Mobile Park,10,-2
4/11/2014,2014,COL,SF,5,6,146,1.5,-165,6.5,-105,-115,-161,-1.5,145,2.64,AT&T Park,11,-1
4/11/2014,2014,CHC,STL,6,3,126,1.5,-175,7,-125,105,-141,-1.5,155,3.1,Busch Stadium,9,3
4/11/2014,2014,CIN,TB,1,2,113,1.5,-160,7,107,-127,-123,-1.5,140,3.29,Great American Ballpark,3,-1
4/11/2014,2014,HOU,TEX,0,1,190,1.5,-110,8,-120,100,-220,-1.5,-110,2.76,Rangers Ballpark,1,-1
4/11/2014,2014,BAL,TOR,0,2,-157,-1.5,130,8.5,-115,-105,142,1.5,-150,5.19,Camden Yards,2,-2
4/11/2014,2014,ATL,WSH,7,6,-124,-1.5,175,7.5,100,-120,114,1.5,-205,4.15,Turner Field,13,1
4/12/2014,2014,LAD,ARI,8,5,-116,-1.5,140,8,-110,-110,106,1.5,-160,4.3,Chase Field,13,3
4/12/2014,2014,WSH,ATL,3,6,128,1.5,-180,7,-105,-115,-143,-1.5,160,3.07,Turner Field,9,-3
4/12/2014,2014,TOR,BAL,1,2,101,1.5,-205,9,-110,-110,-111,-1.5,175,4.48,Camden Yards,3,-1
4/12/2014,2014,NYY,BOS,7,4,-112,-1.5,180,8.5,100,-120,102,1.5,-210,4.49,Yankee Stadium,11,3
4/12/2014,2014,STL,CHC,10,4,-230,-1.5,-110,7,-105,-115,200,1.5,-110,4.88,Busch Stadium,14,6
4/12/2014,2014,TB,CIN,1,0,-130,-1.5,130,7.5,105,-125,115,1.5,-150,4.24,Great American Ballpark,1,1
4/12/2014,2014,CWS,CLE,6,12,115,1.5,-150,9,-117,-103,-125,-1.5,130,4.19,Guaranteed Rate Field,18,-6
4/12/2014,2014,SF,COL,0,1,-126,-1.5,170,7.5,-110,-110,116,1.5,-200,4.18,AT&T Park,1,-1
4/12/2014,2014,CLE,CWS,12,6,-125,-1.5,130,9,-117,-103,115,1.5,-150,5,Guaranteed Rate Field,18,6
4/12/2014,2014,SD,DET,2,6,116,1.5,-150,6.5,100,-120,-131,-1.5,130,3.01,PETCO Park,8,-4
4/12/2014,2014,TEX,HOU,5,6,-170,-1.5,115,9.5,-105,-115,150,1.5,-135,5.98,Rangers Ballpark,11,-1
4/12/2014,2014,MIN,KC,7,1,126,1.5,-130,7.5,-109,-111,-141,-1.5,110,3.32,Target Field,8,6
4/12/2014,2014,NYM,LAA,7,6,150,1.5,-145,7.5,-110,-110,-170,-1.5,125,3,Angel Stadium,13,1
4/12/2014,2014,ARI,LAD,5,8,106,1.5,-160,8,-110,-110,-116,-1.5,140,3.88,Chase Field,13,-3
4/12/2014,2014,PHI,MIA,5,4,-108,-1.5,195,8,-105,-115,-102,1.5,-225,4.15,Citizens Bank Park,9,1
4/12/2014,2014,PIT,MIL,2,3,130,1.5,-165,8.5,-115,-105,-145,-1.5,145,3.7,Miller Park,5,-1
4/12/2014,2014,KC,MIN,1,7,-141,-1.5,110,7.5,-109,-111,126,1.5,-130,4.39,Target Field,8,-6
4/12/2014,2014,LAA,NYM,6,7,-170,-1.5,125,7.5,-110,-110,150,1.5,-145,4.72,Angel Stadium,13,-1
4/12/2014,2014,BOS,NYY,4,7,102,1.5,-210,8.5,100,-120,-112,-1.5,180,4.21,Yankee Stadium,11,-3
4/12/2014,2014,SEA,OAK,1,3,112,1.5,-150,7.5,100,-120,-122,-1.5,130,3.54,T-Mobile Park,4,-2
4/12/2014,2014,MIA,PHI,4,5,-102,1.5,-225,8,-105,-115,-108,-1.5,195,4.04,Citizens Bank Park,9,-1
4/12/2014,2014,MIL,PIT,3,2,-145,-1.5,145,8.5,-115,-105,130,1.5,-165,5.03,Miller Park,5,1
4/12/2014,2014,DET,SD,6,2,-131,-1.5,130,6.5,100,-120,116,1.5,-150,3.69,PETCO Park,8,4
4/12/2014,2014,OAK,SEA,3,1,-122,-1.5,130,7.5,100,-120,112,1.5,-150,4.12,T-Mobile Park,4,2
4/12/2014,2014,COL,SF,1,0,116,1.5,-200,7.5,-110,-110,-126,-1.5,170,3.47,AT&T Park,1,1
4/12/2014,2014,CHC,STL,4,10,200,1.5,-110,7,-105,-115,-230,-1.5,-110,2.33,Busch Stadium,14,-6
4/12/2014,2014,CIN,TB,0,1,115,1.5,-150,7.5,105,-125,-130,-1.5,130,3.49,Great American Ballpark,1,-1
4/12/2014,2014,HOU,TEX,6,5,150,1.5,-135,9.5,-105,-115,-170,-1.5,115,3.8,Rangers Ballpark,11,1
4/12/2014,2014,BAL,TOR,2,1,-111,-1.5,175,9,-110,-110,101,1.5,-205,4.73,Camden Yards,3,1
4/12/2014,2014,ATL,WSH,6,3,-143,-1.5,160,7,-105,-115,128,1.5,-180,4.12,Turner Field,9,3
4/13/2014,2014,LAD,ARI,8,6,-120,-1.5,135,9,-125,105,110,1.5,-155,4.91,Chase Field,14,2
4/13/2014,2014,WSH,ATL,2,10,-130,-1.5,130,7,-105,-115,115,1.5,-150,3.96,Turner Field,12,-8
4/13/2014,2014,TOR,BAL,11,3,-105,1.5,-210,9,-105,-115,-105,-1.5,180,4.61,Camden Yards,14,8
4/13/2014,2014,NYY,BOS,3,2,-118,-1.5,175,9,-115,-105,108,1.5,-205,4.87,Yankee Stadium,5,1
4/13/2014,2014,STL,CHC,6,4,-245,-1.5,-115,7.5,-116,-104,205,1.5,-105,5.33,Busch Stadium,10,2
4/13/2014,2014,TB,CIN,4,12,112,1.5,-200,7.5,-120,100,-122,-1.5,170,3.54,Great American Ballpark,16,-8
4/13/2014,2014,CWS,CLE,4,3,-114,-1.5,170,9,105,-125,104,1.5,-200,4.79,Guaranteed Rate Field,7,1
4/13/2014,2014,SF,COL,5,4,-157,-1.5,135,7.5,-110,-110,142,1.5,-155,4.58,AT&T Park,9,1
4/13/2014,2014,CLE,CWS,3,4,104,1.5,-200,9,105,-125,-114,-1.5,170,4.41,Guaranteed Rate Field,7,-1
4/13/2014,2014,SD,DET,5,1,149,1.5,-125,6.5,-105,-115,-164,-1.5,105,2.61,PETCO Park,6,4
4/13/2014,2014,TEX,HOU,1,0,-160,-1.5,125,9,-115,-105,145,1.5,-145,5.54,Rangers Ballpark,1,1
4/13/2014,2014,MIN,KC,4,3,108,1.5,-155,8,-105,-115,-118,-1.5,135,3.85,Target Field,7,1
4/13/2014,2014,NYM,LAA,2,14,129,1.5,-165,8,-110,-110,-144,-1.5,145,3.49,Angel Stadium,16,-12
4/13/2014,2014,ARI,LAD,6,8,110,1.5,-155,9,-125,105,-120,-1.5,135,4.29,Chase Field,14,-2
4/13/2014,2014,PHI,MIA,4,3,-117,-1.5,175,8.5,-115,-105,107,1.5,-205,4.58,Citizens Bank Park,7,1
4/13/2014,2014,PIT,MIL,1,4,108,1.5,-205,8.5,-110,-110,-118,-1.5,175,4.09,Miller Park,5,-3
4/13/2014,2014,KC,MIN,3,4,-118,-1.5,135,8,-105,-115,108,1.5,-155,4.33,Target Field,7,-1
4/13/2014,2014,LAA,NYM,14,2,-144,-1.5,145,8,-110,-110,129,1.5,-165,4.72,Angel Stadium,16,12
4/13/2014,2014,BOS,NYY,2,3,108,1.5,-205,9,-115,-105,-118,-1.5,175,4.33,Yankee Stadium,5,-1
4/13/2014,2014,SEA,OAK,0,3,124,1.5,-140,7.5,110,-130,-139,-1.5,120,3.35,T-Mobile Park,3,-3
4/13/2014,2014,MIA,PHI,3,4,107,1.5,-205,8.5,-115,-105,-117,-1.5,175,4.11,Citizens Bank Park,7,-1
4/13/2014,2014,MIL,PIT,4,1,-118,-1.5,175,8.5,-110,-110,108,1.5,-205,4.6,Miller Park,5,3
4/13/2014,2014,DET,SD,1,5,-164,-1.5,105,6.5,-105,-115,149,1.5,-125,4.04,PETCO Park,6,-4
4/13/2014,2014,OAK,SEA,3,0,-139,-1.5,120,7.5,110,-130,124,1.5,-140,4.36,T-Mobile Park,3,3
4/13/2014,2014,COL,SF,4,5,142,1.5,-155,7.5,-110,-110,-157,-1.5,135,3.1,AT&T Park,9,-1
4/13/2014,2014,CHC,STL,4,6,205,1.5,-105,7.5,-116,-104,-245,-1.5,-115,2.46,Busch Stadium,10,-2
4/13/2014,2014,CIN,TB,12,4,-122,-1.5,170,7.5,-120,100,112,1.5,-200,4.12,Great American Ballpark,16,8
4/13/2014,2014,HOU,TEX,0,1,145,1.5,-145,9,-115,-105,-160,-1.5,125,3.67,Rangers Ballpark,1,-1
4/13/2014,2014,BAL,TOR,3,11,-105,-1.5,180,9,-105,-115,-105,1.5,-210,4.61,Camden Yards,14,-8
4/13/2014,2014,ATL,WSH,10,2,115,1.5,-150,7,-105,-115,-130,-1.5,130,3.26,Turner Field,12,8
4/14/2014,2014,NYM,ARI,7,3,115,1.5,-175,9,-110,-110,-130,-1.5,155,4.19,Chase Field,10,4
4/14/2014,2014,PHI,ATL,6,9,111,1.5,-160,8.5,-110,-110,-121,-1.5,140,4.03,Citizens Bank Park,15,-3
4/14/2014,2014,TB,BAL,1,7,-113,-1.5,150,8.5,-114,-106,103,1.5,-170,4.51,Camden Yards,8,-6
4/14/2014,2014,PIT,CIN,8,7,113,1.5,-205,7.5,-105,-115,-123,-1.5,175,3.52,Great American Ballpark,15,1
4/14/2014,2014,SD,COL,5,4,-117,-1.5,185,7.5,100,-120,107,1.5,-215,4.04,PETCO Park,9,1
4/14/2014,2014,OAK,LAA,3,2,-113,-1.5,140,8.5,-115,-105,103,1.5,-160,4.51,Angel Stadium,5,1
4/14/2014,2014,WSH,MIA,9,2,-155,-1.5,105,7.5,-115,-105,140,1.5,-125,4.56,Marlins Park,11,7
4/14/2014,2014,STL,MIL,4,0,113,1.5,-195,8.5,-110,-110,-123,-1.5,165,3.99,Miller Park,4,4
4/14/2014,2014,ARI,NYM,3,7,-130,-1.5,155,9,-110,-110,115,1.5,-175,5.09,Chase Field,10,-4
4/14/2014,2014,LAA,OAK,2,3,103,1.5,-160,8.5,-115,-105,-113,-1.5,140,4.19,Angel Stadium,5,-1
4/14/2014,2014,ATL,PHI,9,6,-121,-1.5,140,8.5,-110,-110,111,1.5,-160,4.65,Citizens Bank Park,15,3
4/14/2014,2014,CIN,PIT,7,8,-123,-1.5,175,7.5,-105,-115,113,1.5,-205,4.14,Great American Ballpark,15,-1
4/14/2014,2014,COL,SD,4,5,107,1.5,-215,7.5,100,-120,-117,-1.5,185,3.62,PETCO Park,9,-1
4/14/2014,2014,TEX,SEA,1,7,-110,-1.5,190,9,-105,-115,100,1.5,-220,4.71,Rangers Ballpark,8,-6
4/14/2014,2014,MIL,STL,0,4,-123,-1.5,165,8.5,-110,-110,113,1.5,-195,4.69,Miller Park,4,-4
4/14/2014,2014,BAL,TB,7,1,103,1.5,-170,8.5,-114,-106,-113,-1.5,150,4.19,Camden Yards,8,6
4/14/2014,2014,SEA,TEX,7,1,100,1.5,-220,9,-105,-115,-110,-1.5,190,4.5,Rangers Ballpark,8,6
4/14/2014,2014,MIA,WSH,2,9,140,1.5,-125,7.5,-115,-105,-155,-1.5,105,3.13,Marlins Park,11,-7
4/15/2014,2014,NYM,ARI,9,0,125,1.5,-165,9,-115,-105,-140,-1.5,145,4,Chase Field,9,9
4/15/2014,2014,CWS,BOS,2,1,125,1.5,-140,8,-105,-115,-140,-1.5,120,3.56,Guaranteed Rate Field,3,1
4/15/2014,2014,PIT,CIN,5,7,-109,-1.5,160,7,110,-130,-101,1.5,-180,3.65,Great American Ballpark,12,-2
4/15/2014,2014,SD,COL,2,3,-112,-1.5,190,7,-110,-110,102,1.5,-230,3.7,PETCO Park,5,-1
4/15/2014,2014,BOS,CWS,1,2,-140,-1.5,120,8,-105,-115,125,1.5,-140,4.67,Guaranteed Rate Field,3,-1
4/15/2014,2014,KC,HOU,4,2,-174,-1.5,-115,8,-110,-110,154,1.5,-105,5.08,Minute Maid Park,6,2
4/15/2014,2014,HOU,KC,2,4,154,1.5,-105,8,-110,-110,-174,-1.5,-115,3.15,Minute Maid Park,6,-2
4/15/2014,2014,OAK,LAA,10,9,102,1.5,-210,8.5,100,-120,-112,-1.5,180,4.21,Angel Stadium,19,1
4/15/2014,2014,SF,LAD,3,2,-105,1.5,-180,8,-110,-110,-105,-1.5,160,4.1,AT&T Park,5,1
4/15/2014,2014,WSH,MIA,2,11,-178,-1.5,-110,7,-120,100,158,1.5,-110,4.48,Marlins Park,13,-9
4/15/2014,2014,STL,MIL,6,1,104,1.5,-210,8,-111,-109,-114,-1.5,180,3.92,Miller Park,7,5
4/15/2014,2014,TOR,MIN,9,3,-122,-1.5,140,8,112,-132,112,1.5,-160,4.4,Target Field,12,6
4/15/2014,2014,ARI,NYM,0,9,-140,-1.5,145,9,-115,-105,125,1.5,-165,5.25,Chase Field,9,-9
4/15/2014,2014,LAA,OAK,9,10,-112,-1.5,180,8.5,100,-120,102,1.5,-210,4.49,Angel Stadium,19,-1
4/15/2014,2014,CIN,PIT,7,5,-101,1.5,-180,7,110,-130,-109,-1.5,160,3.52,Great American Ballpark,12,2
4/15/2014,2014,COL,SD,3,2,102,1.5,-230,7,-110,-110,-112,-1.5,190,3.47,PETCO Park,5,1
4/15/2014,2014,TEX,SEA,5,0,-155,-1.5,135,8.5,-128,108,140,1.5,-155,5.17,Rangers Ballpark,5,5
4/15/2014,2014,LAD,SF,2,3,-105,-1.5,160,8,-110,-110,-105,1.5,-180,4.1,AT&T Park,5,-1
4/15/2014,2014,MIL,STL,1,6,-114,-1.5,180,8,-111,-109,104,1.5,-210,4.26,Miller Park,7,-5
4/15/2014,2014,SEA,TEX,0,5,140,1.5,-155,8.5,-128,108,-155,-1.5,135,3.54,Rangers Ballpark,5,-5
4/15/2014,2014,MIN,TOR,3,9,112,1.5,-160,8,112,-132,-122,-1.5,140,3.77,Target Field,12,-6
4/15/2014,2014,MIA,WSH,11,2,158,1.5,-110,7,-120,100,-178,-1.5,-110,2.71,Marlins Park,13,9
4/16/2014,2014,NYM,ARI,5,2,133,1.5,-165,9,-105,-115,-148,-1.5,145,3.86,Chase Field,7,3
4/16/2014,2014,PHI,ATL,0,1,-132,-1.5,170,6.5,-109,-111,117,1.5,-200,3.7,Citizens Bank Park,1,-1
4/16/2014,2014,TB,BAL,0,3,-101,1.5,-205,8,-120,100,-109,-1.5,175,4.02,Camden Yards,3,-3
4/16/2014,2014,CWS,BOS,4,6,116,1.5,-155,7.5,100,-120,-126,-1.5,135,3.47,Guaranteed Rate Field,10,-2
4/16/2014,2014,NYY,CHC,3,0,-190,-1.5,110,7,-125,105,170,1.5,-130,4.59,Yankee Stadium,3,3
4/16/2014,2014,NYY,CHC,2,0,-150,-1.5,150,7,-119,-101,135,1.5,-170,4.2,Yankee Stadium,2,2
4/16/2014,2014,PIT,CIN,0,4,103,1.5,-230,7,110,-130,-113,-1.5,190,3.45,Great American Ballpark,4,-4
4/16/2014,2014,DET,CLE,2,3,-141,-1.5,155,7.5,100,-120,126,1.5,-175,4.39,Comerica Park,5,-1
4/16/2014,2014,SD,COL,4,2,-132,-1.5,170,6.5,-105,-115,117,1.5,-200,3.7,PETCO Park,6,2
4/16/2014,2014,BOS,CWS,6,4,-126,-1.5,135,7.5,100,-120,116,1.5,-155,4.18,Guaranteed Rate Field,10,2
4/16/2014,2014,CLE,DET,3,2,126,1.5,-175,7.5,100,-120,-141,-1.5,155,3.32,Comerica Park,5,1
4/16/2014,2014,KC,HOU,6,4,-116,-1.5,145,8,-104,-116,106,1.5,-165,4.3,Minute Maid Park,10,2
4/16/2014,2014,HOU,KC,4,6,106,1.5,-165,8,-104,-116,-116,-1.5,145,3.88,Minute Maid Park,10,-2
4/16/2014,2014,OAK,LAA,4,5,117,1.5,-195,8,-110,-110,-127,-1.5,165,3.69,Angel Stadium,9,-1
4/16/2014,2014,SF,LAD,2,1,-108,-1.5,180,8.5,102,-122,-102,1.5,-210,4.41,AT&T Park,3,1
4/16/2014,2014,WSH,MIA,6,3,152,1.5,-155,6.5,-125,105,-172,-1.5,135,2.58,Marlins Park,9,3
4/16/2014,2014,STL,MIL,1,5,-104,1.5,-220,8.5,-110,-110,-106,-1.5,190,4.33,Miller Park,6,-4
4/16/2014,2014,ARI,NYM,2,5,-148,-1.5,145,9,-105,-115,133,1.5,-165,5.37,Chase Field,7,-3
4/16/2014,2014,CHC,NYY,0,3,170,1.5,-130,7,-125,105,-190,-1.5,110,2.59,Yankee Stadium,3,-3
4/16/2014,2014,CHC,NYY,0,2,135,1.5,-170,7,-119,-101,-150,-1.5,150,2.98,Yankee Stadium,2,-2
4/16/2014,2014,LAA,OAK,5,4,-127,-1.5,165,8,-110,-110,117,1.5,-195,4.48,Angel Stadium,9,1
4/16/2014,2014,ATL,PHI,1,0,117,1.5,-200,6.5,-109,-111,-132,-1.5,170,3,Citizens Bank Park,1,1
4/16/2014,2014,CIN,PIT,4,0,-113,-1.5,190,7,110,-130,103,1.5,-230,3.71,Great American Ballpark,4,4
4/16/2014,2014,COL,SD,2,4,117,1.5,-200,6.5,-105,-115,-132,-1.5,170,3,PETCO Park,6,-2
4/16/2014,2014,TEX,SEA,3,2,-123,-1.5,180,6.5,-125,105,113,1.5,-210,3.59,Rangers Ballpark,5,1
4/16/2014,2014,LAD,SF,1,2,-102,1.5,-210,8.5,102,-122,-108,-1.5,180,4.29,AT&T Park,3,-1
4/16/2014,2014,MIL,STL,5,1,-106,-1.5,190,8.5,-110,-110,-104,1.5,-220,4.37,Miller Park,6,4
4/16/2014,2014,BAL,TB,3,0,-109,-1.5,175,8,-120,100,-101,1.5,-205,4.17,Camden Yards,3,3
4/16/2014,2014,SEA,TEX,2,3,113,1.5,-210,6.5,-125,105,-123,-1.5,180,3.05,Rangers Ballpark,5,-1
4/16/2014,2014,MIA,WSH,3,6,-172,-1.5,135,6.5,-125,105,152,1.5,-155,4.11,Marlins Park,9,-3
4/17/2014,2014,PHI,ATL,1,0,130,1.5,-140,7,115,-135,-145,-1.5,120,3.04,Citizens Bank Park,1,1
4/17/2014,2014,CWS,BOS,1,3,-108,-1.5,185,7,-101,-119,-102,1.5,-215,3.63,Guaranteed Rate Field,4,-2
4/17/2014,2014,DET,CLE,7,5,-154,-1.5,145,7.5,-104,-116,139,1.5,-165,4.55,Comerica Park,12,2
4/17/2014,2014,SD,COL,1,3,-127,-1.5,175,7,-125,105,117,1.5,-205,3.92,PETCO Park,4,-2
4/17/2014,2014,BOS,CWS,3,1,-102,1.5,-215,7,-101,-119,-108,-1.5,185,3.53,Guaranteed Rate Field,4,2
4/17/2014,2014,CLE,DET,5,7,139,1.5,-165,7.5,-104,-116,-154,-1.5,145,3.14,Comerica Park,12,-2
4/17/2014,2014,KC,HOU,5,1,-131,-1.5,125,7.5,100,-120,116,1.5,-145,4.25,Minute Maid Park,6,4
4/17/2014,2014,HOU,KC,1,5,116,1.5,-145,7.5,100,-120,-131,-1.5,125,3.47,Minute Maid Park,6,-4
4/17/2014,2014,SF,LAD,1,2,-123,-1.5,185,6.5,-111,-109,113,1.5,-215,3.59,AT&T Park,3,-1
4/17/2014,2014,PIT,MIL,11,2,-108,-1.5,195,7,-105,-115,-102,1.5,-225,3.63,PNC Park,13,9
4/17/2014,2014,TOR,MIN,0,7,-120,-1.5,135,7,-120,100,110,1.5,-155,3.82,Target Field,7,-7
4/17/2014,2014,TOR,MIN,5,9,-125,-1.5,130,7,-130,110,115,1.5,-150,3.89,Target Field,14,-4
4/17/2014,2014,TB,NYY,2,10,-166,-1.5,130,6.5,-125,105,151,1.5,-150,4.06,Tropicana Field,12,-8
4/17/2014,2014,ATL,PHI,0,1,-145,-1.5,120,7,115,-135,130,1.5,-140,4.14,Citizens Bank Park,1,-1
4/17/2014,2014,MIL,PIT,2,11,-102,1.5,-225,7,-105,-115,-108,-1.5,195,3.53,PNC Park,13,-9
4/17/2014,2014,COL,SD,3,1,117,1.5,-205,7,-125,105,-127,-1.5,175,3.23,PETCO Park,4,2
4/17/2014,2014,TEX,SEA,8,6,-120,-1.5,170,9,-109,-111,110,1.5,-200,4.91,Rangers Ballpark,14,2
4/17/2014,2014,LAD,SF,2,1,113,1.5,-215,6.5,-111,-109,-123,-1.5,185,3.05,AT&T Park,3,1
4/17/2014,2014,WSH,STL,0,8,126,1.5,-145,6.5,-110,-110,-141,-1.5,125,2.88,Nationals Park,8,-8
4/17/2014,2014,NYY,TB,10,2,151,1.5,-150,6.5,-125,105,-166,-1.5,130,2.59,Tropicana Field,12,8
4/17/2014,2014,SEA,TEX,6,8,110,1.5,-200,9,-109,-111,-120,-1.5,170,4.29,Rangers Ballpark,14,-2
4/17/2014,2014,MIN,TOR,7,0,110,1.5,-155,7,-120,100,-120,-1.5,135,3.33,Target Field,7,7
4/17/2014,2014,MIN,TOR,9,5,115,1.5,-150,7,-130,110,-125,-1.5,130,3.26,Target Field,14,4
4/17/2014,2014,STL,WSH,8,0,-141,-1.5,125,6.5,-110,-110,126,1.5,-145,3.8,Nationals Park,8,8
4/18/2014,2014,LAD,ARI,2,4,-180,-1.5,120,6.5,-105,-115,160,1.5,-140,4.18,Dodger Stadium,6,-2
4/18/2014,2014,NYM,ATL,0,6,-103,1.5,-190,7,-105,-115,-107,-1.5,160,3.55,Citi Field,6,-6
4/18/2014,2014,BOS,BAL,4,8,-130,-1.5,160,7.5,-120,100,115,1.5,-190,4.24,Fenway Park,12,-4
4/18/2014,2014,BAL,BOS,8,4,115,1.5,-190,7.5,-120,100,-130,-1.5,160,3.49,Fenway Park,12,4
4/18/2014,2014,CIN,CHC,4,1,-102,1.5,-230,6.5,105,-125,-108,-1.5,190,3.28,Wrigley Field,5,3
4/18/2014,2014,CHC,CIN,1,4,-108,-1.5,190,6.5,105,-125,-102,1.5,-230,3.38,Wrigley Field,5,-3
4/18/2014,2014,TOR,CLE,3,2,125,1.5,-175,8,104,-124,-140,-1.5,155,3.56,Progressive Field,5,1
4/18/2014,2014,PHI,COL,1,12,137,1.5,-145,10.5,-120,100,-152,-1.5,125,4.43,Coors Field,13,-11
4/18/2014,2014,TEX,CWS,12,0,-155,-1.5,130,8.5,-105,-115,140,1.5,-150,5.17,Rangers Ballpark,12,12
4/18/2014,2014,LAA,DET,11,6,116,1.5,-200,8,-110,-110,-126,-1.5,170,3.7,Comerica Park,17,5
4/18/2014,2014,OAK,HOU,11,3,-234,-1.5,-110,7,-110,-110,204,1.5,-110,4.9,Oakland Coliseum,14,8
4/18/2014,2014,MIN,KC,0,5,128,1.5,-165,7.5,105,-125,-143,-1.5,145,3.29,Kauffman Stadium,5,-5
4/18/2014,2014,DET,LAA,6,11,-126,-1.5,170,8,-110,-110,116,1.5,-200,4.46,Comerica Park,17,-5
4/18/2014,2014,ARI,LAD,4,2,160,1.5,-140,6.5,-105,-115,-180,-1.5,120,2.5,Dodger Stadium,6,2
4/18/2014,2014,SEA,MIA,4,8,106,1.5,-210,7.5,-116,-104,-116,-1.5,180,3.64,Marlins Park,12,-4
4/18/2014,2014,PIT,MIL,3,5,-118,-1.5,180,7,105,-125,108,1.5,-210,3.79,PNC Park,8,-2
4/18/2014,2014,KC,MIN,5,0,-143,-1.5,145,7.5,105,-125,128,1.5,-165,4.41,Kauffman Stadium,5,5
4/18/2014,2014,ATL,NYM,6,0,-107,-1.5,160,7,-105,-115,-103,1.5,-190,3.62,Citi Field,6,6
4/18/2014,2014,TB,NYY,11,5,100,1.5,-190,7.5,105,-125,-110,-1.5,160,3.75,Tropicana Field,16,6
4/18/2014,2014,HOU,OAK,3,11,204,1.5,-110,7,-110,-110,-234,-1.5,-110,2.3,Oakland Coliseum,14,-8
4/18/2014,2014,COL,PHI,12,1,-152,-1.5,125,10.5,-120,100,137,1.5,-145,6.33,Coors Field,13,11
4/18/2014,2014,MIL,PIT,5,3,108,1.5,-210,7,105,-125,-118,-1.5,180,3.37,PNC Park,8,2
4/18/2014,2014,SF,SD,1,2,100,1.5,-225,6.5,-105,-115,-110,-1.5,195,3.25,PETCO Park,3,-1
4/18/2014,2014,MIA,SEA,8,4,-116,-1.5,180,7.5,-116,-104,106,1.5,-210,4.03,Marlins Park,12,4
4/18/2014,2014,SD,SF,2,1,-110,-1.5,195,6.5,-105,-115,100,1.5,-225,3.4,PETCO Park,3,1
4/18/2014,2014,WSH,STL,3,1,100,1.5,-185,6.5,-105,-115,-110,-1.5,165,3.25,Nationals Park,4,2
4/18/2014,2014,NYY,TB,5,11,-110,-1.5,160,7.5,105,-125,100,1.5,-190,3.93,Tropicana Field,16,-6
4/18/2014,2014,CWS,TEX,0,12,140,1.5,-150,8.5,-105,-115,-155,-1.5,130,3.54,Rangers Ballpark,12,-12
4/18/2014,2014,CLE,TOR,2,3,-140,-1.5,155,8,104,-124,125,1.5,-175,4.67,Progressive Field,5,-1
4/18/2014,2014,STL,WSH,1,3,-110,-1.5,165,6.5,-105,-115,100,1.5,-185,3.4,Nationals Park,4,-2
4/19/2014,2014,LAD,ARI,8,6,-195,-1.5,110,7.5,105,-125,175,1.5,-130,4.96,Dodger Stadium,14,2
4/19/2014,2014,NYM,ATL,5,7,118,1.5,-150,7,100,-120,-128,-1.5,130,3.21,Citi Field,12,-2
4/19/2014,2014,BOS,BAL,4,2,-141,-1.5,140,9,105,-125,126,1.5,-160,5.27,Fenway Park,6,2
4/19/2014,2014,BAL,BOS,2,4,126,1.5,-160,9,105,-125,-141,-1.5,140,3.98,Fenway Park,6,-2
4/19/2014,2014,CIN,CHC,4,8,-146,-1.5,110,7.5,105,-125,131,1.5,-130,4.45,Wrigley Field,12,-4
4/19/2014,2014,CHC,CIN,8,4,131,1.5,-130,7.5,105,-125,-146,-1.5,110,3.25,Wrigley Field,12,4
4/19/2014,2014,TOR,CLE,5,0,107,1.5,-205,7.5,100,-120,-117,-1.5,175,3.62,Progressive Field,5,5
4/19/2014,2014,PHI,COL,1,3,128,1.5,-155,10.5,-105,-115,-143,-1.5,135,4.61,Coors Field,4,-2
4/19/2014,2014,TEX,CWS,6,3,-124,-1.5,160,8.5,-125,105,114,1.5,-190,4.71,Rangers Ballpark,9,3
4/19/2014,2014,LAA,DET,2,5,149,1.5,-155,7.5,109,-129,-164,-1.5,135,3.01,Comerica Park,7,-3
4/19/2014,2014,OAK,HOU,4,3,-215,-1.5,-107,7.5,-105,-115,185,1.5,-113,5.12,Oakland Coliseum,7,1
4/19/2014,2014,MIN,KC,4,5,130,1.5,-160,8.5,-105,-115,-145,-1.5,140,3.7,Kauffman Stadium,9,-1
4/19/2014,2014,DET,LAA,5,2,-164,-1.5,135,7.5,109,-129,149,1.5,-155,4.66,Comerica Park,7,3
4/19/2014,2014,ARI,LAD,6,8,175,1.5,-130,7.5,105,-125,-195,-1.5,110,2.73,Dodger Stadium,14,-2
4/19/2014,2014,SEA,MIA,0,7,-107,-1.5,155,7.5,-111,-109,-103,1.5,-175,3.88,Marlins Park,7,-7
4/19/2014,2014,PIT,MIL,7,8,-109,-1.5,190,7,-120,100,-101,1.5,-230,3.65,PNC Park,15,-1
4/19/2014,2014,KC,MIN,5,4,-145,-1.5,140,8.5,-105,-115,130,1.5,-160,5.03,Kauffman Stadium,9,1
4/19/2014,2014,ATL,NYM,7,5,-128,-1.5,130,7,100,-120,118,1.5,-150,3.93,Citi Field,12,2
4/19/2014,2014,TB,NYY,16,1,-140,-1.5,150,7.5,-105,-115,125,1.5,-170,4.38,Tropicana Field,17,15
4/19/2014,2014,HOU,OAK,3,4,185,1.5,-113,7.5,-105,-115,-215,-1.5,-107,2.63,Oakland Coliseum,7,-1
4/19/2014,2014,COL,PHI,3,1,-143,-1.5,135,10.5,-105,-115,128,1.5,-155,6.18,Coors Field,4,2
4/19/2014,2014,MIL,PIT,8,7,-101,1.5,-230,7,-120,100,-109,-1.5,190,3.52,PNC Park,15,1
4/19/2014,2014,SF,SD,1,3,-124,-1.5,135,7,-122,102,114,1.5,-155,3.88,PETCO Park,4,-2
4/19/2014,2014,MIA,SEA,7,0,-103,1.5,-175,7.5,-111,-109,-107,-1.5,155,3.81,Marlins Park,7,7
4/19/2014,2014,SD,SF,3,1,114,1.5,-155,7,-122,102,-124,-1.5,135,3.27,PETCO Park,4,2
4/19/2014,2014,WSH,STL,3,4,-120,-1.5,175,7,-115,-105,110,1.5,-205,3.82,Nationals Park,7,-1
4/19/2014,2014,NYY,TB,1,16,125,1.5,-170,7.5,-105,-115,-140,-1.5,150,3.33,Tropicana Field,17,-15
4/19/2014,2014,CWS,TEX,3,6,114,1.5,-190,8.5,-125,105,-124,-1.5,160,3.97,Rangers Ballpark,9,-3
4/19/2014,2014,CLE,TOR,0,5,-117,-1.5,175,7.5,100,-120,107,1.5,-205,4.04,Progressive Field,5,-5
4/19/2014,2014,STL,WSH,4,3,110,1.5,-205,7,-115,-105,-120,-1.5,175,3.33,Nationals Park,7,1
4/20/2014,2014,LAD,ARI,4,1,-144,-1.5,155,7.5,105,-125,129,1.5,-175,4.43,Dodger Stadium,5,3
4/20/2014,2014,NYM,ATL,4,3,-108,-1.5,185,7,-120,100,-102,1.5,-215,3.63,Citi Field,7,1
4/20/2014,2014,BOS,BAL,6,5,-161,-1.5,125,8,100,-120,146,1.5,-145,4.93,Fenway Park,11,1
4/20/2014,2014,BAL,BOS,5,6,146,1.5,-145,8,100,-120,-161,-1.5,125,3.25,Fenway Park,11,-1
4/20/2014,2014,CIN,CHC,8,2,-140,-1.5,120,9,-105,-115,125,1.5,-140,5.25,Wrigley Field,10,6
4/20/2014,2014,CHC,CIN,2,8,125,1.5,-140,9,-105,-115,-140,-1.5,120,4,Wrigley Field,10,-6
4/20/2014,2014,TOR,CLE,4,6,-114,-1.5,145,8.5,-115,-105,104,1.5,-165,4.53,Progressive Field,10,-2
4/20/2014,2014,PHI,COL,10,9,137,1.5,-150,9.5,-115,-105,-152,-1.5,130,4.01,Coors Field,19,1
4/20/2014,2014,TEX,CWS,2,16,-176,-1.5,115,9,-105,-115,156,1.5,-135,5.74,Rangers Ballpark,18,-14
4/20/2014,2014,LAA,DET,1,2,126,1.5,-170,9,100,-120,-141,-1.5,150,3.98,Comerica Park,3,-1
4/20/2014,2014,OAK,HOU,4,1,-275,-1.5,-125,8,-120,100,235,1.5,105,5.87,Oakland Coliseum,5,3
4/20/2014,2014,MIN,KC,8,3,163,1.5,-135,8,100,-120,-183,-1.5,115,3.04,Kauffman Stadium,11,5
4/20/2014,2014,DET,LAA,2,1,-141,-1.5,150,9,100,-120,126,1.5,-170,5.27,Comerica Park,3,1
4/20/2014,2014,ARI,LAD,1,4,129,1.5,-175,7.5,105,-125,-144,-1.5,155,3.28,Dodger Stadium,5,-3
4/20/2014,2014,SEA,MIA,2,3,-101,1.5,-220,8,100,-120,-109,-1.5,190,4.02,Marlins Park,5,-1
4/20/2014,2014,PIT,MIL,2,3,-123,-1.5,180,6.5,-125,105,113,1.5,-210,3.59,PNC Park,5,-1
4/20/2014,2014,KC,MIN,3,8,-183,-1.5,115,8,100,-120,163,1.5,-135,5.17,Kauffman Stadium,11,-5
4/20/2014,2014,ATL,NYM,3,4,-102,1.5,-215,7,-120,100,-108,-1.5,185,3.53,Citi Field,7,-1
4/20/2014,2014,TB,NYY,1,5,-140,-1.5,150,8.5,-105,-115,125,1.5,-170,4.96,Tropicana Field,6,-4
4/20/2014,2014,HOU,OAK,1,4,235,1.5,105,8,-120,100,-275,-1.5,-125,2.39,Oakland Coliseum,5,-3
4/20/2014,2014,COL,PHI,9,10,-152,-1.5,130,9.5,-115,-105,137,1.5,-150,5.73,Coors Field,19,-1
4/20/2014,2014,MIL,PIT,3,2,113,1.5,-210,6.5,-125,105,-123,-1.5,180,3.05,PNC Park,5,1
4/20/2014,2014,SF,SD,4,3,-102,1.5,-220,7,-125,105,-108,-1.5,190,3.53,PETCO Park,7,1
4/20/2014,2014,MIA,SEA,3,2,-109,-1.5,190,8,100,-120,-101,1.5,-220,4.17,Marlins Park,5,1
4/20/2014,2014,SD,SF,3,4,-108,-1.5,190,7,-125,105,-102,1.5,-220,3.63,PETCO Park,7,-1
4/20/2014,2014,WSH,STL,3,2,-145,-1.5,150,7,112,-132,130,1.5,-170,4.14,Nationals Park,5,1
4/20/2014,2014,NYY,TB,5,1,125,1.5,-170,8.5,-105,-115,-140,-1.5,150,3.78,Tropicana Field,6,4
4/20/2014,2014,CWS,TEX,16,2,156,1.5,-135,9,-105,-115,-176,-1.5,115,3.52,Rangers Ballpark,18,14
4/20/2014,2014,CLE,TOR,6,4,104,1.5,-165,8.5,-115,-105,-114,-1.5,145,4.17,Progressive Field,10,2
4/20/2014,2014,STL,WSH,2,3,130,1.5,-170,7,112,-132,-145,-1.5,150,3.04,Nationals Park,5,-1
4/21/2014,2014,CHC,ARI,5,1,-115,-1.5,180,9,100,-120,105,1.5,-210,4.81,Wrigley Field,6,4
4/21/2014,2014,MIA,ATL,2,4,160,1.5,-140,7.5,-120,100,-180,-1.5,120,2.88,Turner Field,6,-2
4/21/2014,2014,BOS,BAL,6,7,-158,-1.5,135,7.5,-120,100,143,1.5,-155,4.59,Fenway Park,13,-1
4/21/2014,2014,BAL,BOS,7,6,143,1.5,-155,7.5,-120,100,-158,-1.5,135,3.09,Fenway Park,13,1
4/21/2014,2014,ARI,CHC,1,5,105,1.5,-210,9,100,-120,-115,-1.5,180,4.39,Wrigley Field,6,-4
4/21/2014,2014,PIT,CIN,6,5,-153,-1.5,155,7.5,-110,-110,138,1.5,-175,4.54,PNC Park,11,1
4/21/2014,2014,KC,CLE,3,4,133,1.5,-155,8.5,-120,100,-148,-1.5,135,3.65,Progressive Field,7,-1
4/21/2014,2014,SF,COL,2,8,131,1.5,-155,10.5,-120,100,-146,-1.5,135,4.55,Coors Field,10,-6
4/21/2014,2014,DET,CWS,1,3,-191,-1.5,110,8.5,-110,-110,171,1.5,-130,5.58,Comerica Park,4,-2
4/21/2014,2014,CWS,DET,3,1,171,1.5,-130,8.5,-110,-110,-191,-1.5,110,3.14,Comerica Park,4,2
4/21/2014,2014,SEA,HOU,2,7,-255,-1.5,-110,6,-110,-110,215,1.5,-110,4.31,T-Mobile Park,9,-5
4/21/2014,2014,CLE,KC,4,3,-148,-1.5,135,8.5,-120,100,133,1.5,-155,5.07,Progressive Field,7,1
4/21/2014,2014,WSH,LAA,2,4,-115,-1.5,185,8,-115,-105,105,1.5,-215,4.28,Nationals Park,6,-2
4/21/2014,2014,PHI,LAD,7,0,100,1.5,-225,6.5,-110,-110,-110,-1.5,195,3.25,Dodger Stadium,7,7
4/21/2014,2014,ATL,MIA,4,2,-180,-1.5,120,7.5,-120,100,160,1.5,-140,4.82,Turner Field,6,2
4/21/2014,2014,SD,MIL,3,4,-103,1.5,-225,7.5,-115,-105,-107,-1.5,195,3.81,Miller Park,7,-1
4/21/2014,2014,STL,NYM,0,2,-116,-1.5,140,7.5,-113,-107,106,1.5,-160,4.03,Citi Field,2,-2
4/21/2014,2014,TEX,OAK,4,3,-108,-1.5,160,7,105,-125,-102,1.5,-180,3.63,Oakland Coliseum,7,1
4/21/2014,2014,LAD,PHI,0,7,-110,-1.5,195,6.5,-110,-110,100,1.5,-225,3.4,Dodger Stadium,7,-7
4/21/2014,2014,CIN,PIT,5,6,138,1.5,-175,7.5,-110,-110,-153,-1.5,155,3.15,PNC Park,11,-1
4/21/2014,2014,MIL,SD,4,3,-107,-1.5,195,7.5,-115,-105,-103,1.5,-225,3.88,Miller Park,7,1
4/21/2014,2014,HOU,SEA,7,2,215,1.5,-110,6,-110,-110,-255,-1.5,-110,1.9,T-Mobile Park,9,5
4/21/2014,2014,COL,SF,8,2,-146,-1.5,135,10.5,-120,100,131,1.5,-155,6.23,Coors Field,10,6
4/21/2014,2014,NYM,STL,2,0,106,1.5,-160,7.5,-113,-107,-116,-1.5,140,3.64,Citi Field,2,2
4/21/2014,2014,OAK,TEX,3,4,-102,1.5,-180,7,105,-125,-108,-1.5,160,3.53,Oakland Coliseum,7,-1
4/21/2014,2014,LAA,WSH,4,2,105,1.5,-215,8,-115,-105,-115,-1.5,185,3.9,Nationals Park,6,2
4/22/2014,2014,CHC,ARI,9,2,-115,-1.5,185,6.5,100,-120,105,1.5,-215,3.48,Wrigley Field,11,7
4/22/2014,2014,MIA,ATL,1,0,118,1.5,-215,6.5,-110,-110,-128,-1.5,185,2.98,Turner Field,1,1
4/22/2014,2014,TOR,BAL,9,3,-152,-1.5,142,9.5,100,-120,137,1.5,-162,5.73,Rogers Centre,12,6
4/22/2014,2014,NYY,BOS,9,3,102,1.5,-210,8,-105,-115,-112,-1.5,180,3.96,Fenway Park,12,6
4/22/2014,2014,ARI,CHC,2,9,105,1.5,-215,6.5,100,-120,-115,-1.5,185,3.17,Wrigley Field,11,-7
4/22/2014,2014,PIT,CIN,1,4,100,1.5,-170,7,-120,100,-110,-1.5,150,3.5,PNC Park,5,-3
4/22/2014,2014,KC,CLE,8,2,-108,-1.5,155,7,100,-120,-102,1.5,-175,3.63,Progressive Field,10,6
4/22/2014,2014,SF,COL,1,2,-110,-1.5,140,10,-120,100,100,1.5,-160,5.24,Coors Field,3,-1
4/22/2014,2014,DET,CWS,8,6,-240,-1.5,-115,8.5,-115,-105,200,1.5,-105,6,Comerica Park,14,2
4/22/2014,2014,CWS,DET,6,8,200,1.5,-105,8.5,-115,-105,-240,-1.5,-115,2.83,Comerica Park,14,-2
4/22/2014,2014,SEA,HOU,2,5,-160,-1.5,130,8.5,100,-120,145,1.5,-150,5.23,T-Mobile Park,7,-3
4/22/2014,2014,CLE,KC,2,8,-102,1.5,-175,7,100,-120,-108,-1.5,155,3.53,Progressive Field,10,-6
4/22/2014,2014,WSH,LAA,2,7,-112,-1.5,180,8,-120,100,102,1.5,-210,4.23,Nationals Park,9,-5
4/22/2014,2014,PHI,LAD,3,2,172,1.5,-140,6.5,-110,-110,-192,-1.5,120,2.39,Dodger Stadium,5,1
4/22/2014,2014,ATL,MIA,0,1,-128,-1.5,185,6.5,-110,-110,118,1.5,-215,3.65,Turner Field,1,-1
4/22/2014,2014,SD,MIL,2,1,125,1.5,-170,8,-110,-110,-140,-1.5,150,3.56,Miller Park,3,1
4/22/2014,2014,TB,MIN,7,3,-232,-1.5,-105,7.5,100,-120,202,1.5,-115,5.24,Tropicana Field,10,4
4/22/2014,2014,STL,NYM,3,0,-165,-1.5,-101,7,-123,103,150,1.5,-119,4.36,Citi Field,3,3
4/22/2014,2014,BOS,NYY,3,9,-112,-1.5,180,8,-105,-115,102,1.5,-210,4.23,Fenway Park,12,-6
4/22/2014,2014,TEX,OAK,5,4,150,1.5,-155,7.5,100,-120,-165,-1.5,135,3,Oakland Coliseum,9,1
4/22/2014,2014,LAD,PHI,2,3,-192,-1.5,120,6.5,-110,-110,172,1.5,-140,4.27,Dodger Stadium,5,-1
4/22/2014,2014,CIN,PIT,4,1,-110,-1.5,150,7,-120,100,100,1.5,-170,3.67,PNC Park,5,3
4/22/2014,2014,MIL,SD,1,2,-140,-1.5,150,8,-110,-110,125,1.5,-170,4.67,Miller Park,3,-1
4/22/2014,2014,HOU,SEA,5,2,145,1.5,-150,8.5,100,-120,-160,-1.5,130,3.47,T-Mobile Park,7,3
4/22/2014,2014,COL,SF,2,1,100,1.5,-160,10,-120,100,-110,-1.5,140,5,Coors Field,3,1
4/22/2014,2014,NYM,STL,0,3,150,1.5,-119,7,-123,103,-165,-1.5,-101,2.8,Citi Field,3,-3
4/22/2014,2014,MIN,TB,3,7,202,1.5,-115,7.5,100,-120,-232,-1.5,-105,2.48,Tropicana Field,10,-4
4/22/2014,2014,OAK,TEX,4,5,-165,-1.5,135,7.5,100,-120,150,1.5,-155,4.67,Oakland Coliseum,9,-1
4/22/2014,2014,BAL,TOR,3,9,137,1.5,-162,9.5,100,-120,-152,-1.5,142,4.01,Rogers Centre,12,-6
4/22/2014,2014,LAA,WSH,7,2,102,1.5,-210,8,-120,100,-112,-1.5,180,3.96,Nationals Park,9,5
4/23/2014,2014,CHC,ARI,5,7,-115,-1.5,180,6.5,-110,-110,105,1.5,-210,3.48,Wrigley Field,12,-2
4/23/2014,2014,MIA,ATL,1,3,125,1.5,-190,7,100,-120,-140,-1.5,160,3.11,Turner Field,4,-2
4/23/2014,2014,TOR,BAL,8,10,-109,-1.5,175,8.5,-128,108,-101,1.5,-205,4.43,Rogers Centre,18,-2
4/23/2014,2014,NYY,BOS,1,5,-102,1.5,-210,8.5,-120,100,-108,-1.5,180,4.29,Fenway Park,6,-4
4/23/2014,2014,ARI,CHC,7,5,105,1.5,-210,6.5,-110,-110,-115,-1.5,180,3.17,Wrigley Field,12,2
4/23/2014,2014,PIT,CIN,2,5,-122,-1.5,175,7.5,-102,-118,112,1.5,-205,4.12,PNC Park,7,-3
4/23/2014,2014,KC,CLE,3,5,109,1.5,-205,7,100,-120,-119,-1.5,175,3.35,Progressive Field,8,-2
4/23/2014,2014,SF,COL,12,10,100,1.5,-205,9.5,-105,-115,-110,-1.5,175,4.75,Coors Field,22,2
4/23/2014,2014,DET,CWS,4,6,-191,-1.5,105,8.5,100,-120,171,1.5,-125,5.58,Comerica Park,10,-2
4/23/2014,2014,CWS,DET,6,4,171,1.5,-125,8.5,100,-120,-191,-1.5,105,3.14,Comerica Park,10,2
4/23/2014,2014,SEA,HOU,5,3,-150,-1.5,145,8,100,-120,135,1.5,-165,4.8,T-Mobile Park,8,2
4/23/2014,2014,CLE,KC,5,3,-119,-1.5,175,7,100,-120,109,1.5,-205,3.8,Progressive Field,8,2
4/23/2014,2014,WSH,LAA,5,4,-124,-1.5,170,7,-120,100,114,1.5,-200,3.88,Nationals Park,9,1
4/23/2014,2014,PHI,LAD,2,5,151,1.5,-155,6.5,100,-120,-171,-1.5,135,2.59,Dodger Stadium,7,-3
4/23/2014,2014,ATL,MIA,3,1,-140,-1.5,160,7,100,-120,125,1.5,-190,4.08,Turner Field,4,2
4/23/2014,2014,SD,MIL,2,5,116,1.5,-200,7.5,105,-125,-131,-1.5,170,3.47,Miller Park,7,-3
4/23/2014,2014,TB,MIN,4,6,-180,-1.5,110,8.5,100,-120,160,1.5,-130,5.46,Tropicana Field,10,-2
4/23/2014,2014,STL,NYM,2,3,-146,-1.5,120,6.5,-110,-110,131,1.5,-140,3.86,Citi Field,5,-1
4/23/2014,2014,BOS,NYY,5,1,-108,-1.5,180,8.5,-120,100,-102,1.5,-210,4.41,Fenway Park,6,4
4/23/2014,2014,TEX,OAK,3,0,151,1.5,-150,7,-120,100,-171,-1.5,130,2.79,Oakland Coliseum,3,3
4/23/2014,2014,LAD,PHI,5,2,-171,-1.5,135,6.5,100,-120,151,1.5,-155,4.1,Dodger Stadium,7,3
4/23/2014,2014,CIN,PIT,5,2,112,1.5,-205,7.5,-102,-118,-122,-1.5,175,3.54,PNC Park,7,3
4/23/2014,2014,MIL,SD,5,2,-131,-1.5,170,7.5,105,-125,116,1.5,-200,4.25,Miller Park,7,3
4/23/2014,2014,HOU,SEA,3,5,135,1.5,-165,8,100,-120,-150,-1.5,145,3.4,T-Mobile Park,8,-2
4/23/2014,2014,COL,SF,10,12,-110,-1.5,175,9.5,-105,-115,100,1.5,-205,4.98,Coors Field,22,-2
4/23/2014,2014,NYM,STL,3,2,131,1.5,-140,6.5,-110,-110,-146,-1.5,120,2.81,Citi Field,5,1
4/23/2014,2014,MIN,TB,6,4,160,1.5,-130,8.5,100,-120,-180,-1.5,110,3.27,Tropicana Field,10,2
4/23/2014,2014,OAK,TEX,0,3,-171,-1.5,130,7,-120,100,151,1.5,-150,4.42,Oakland Coliseum,3,-3
4/23/2014,2014,BAL,TOR,10,8,-101,1.5,-205,8.5,-128,108,-109,-1.5,175,4.27,Rogers Centre,18,2
4/23/2014,2014,LAA,WSH,4,5,114,1.5,-200,7,-120,100,-124,-1.5,170,3.27,Nationals Park,9,-1
4/24/2014,2014,CHC,ARI,2,5,-123,-1.5,155,10,-115,-105,113,1.5,-175,5.52,Wrigley Field,7,-3
4/24/2014,2014,TOR,BAL,4,11,-140,-1.5,150,8.5,-125,105,125,1.5,-170,4.96,Rogers Centre,15,-7
4/24/2014,2014,NYY,BOS,14,5,107,1.5,-200,8.5,-110,-110,-117,-1.5,170,4.11,Fenway Park,19,9
4/24/2014,2014,ARI,CHC,5,2,113,1.5,-175,10,-115,-105,-123,-1.5,155,4.69,Wrigley Field,7,3
4/24/2014,2014,PIT,CIN,1,2,-110,-1.5,190,7,-115,-105,100,1.5,-220,3.67,PNC Park,3,-1
4/24/2014,2014,KC,CLE,1,5,115,1.5,-200,7.5,105,-125,-125,-1.5,170,3.49,Progressive Field,6,-4
4/24/2014,2014,DET,CWS,7,4,-220,-1.5,-110,7.5,100,-120,190,1.5,-110,5.16,Comerica Park,11,3
4/24/2014,2014,CWS,DET,4,7,190,1.5,-110,7.5,100,-120,-220,-1.5,-110,2.59,Comerica Park,11,-3
4/24/2014,2014,OAK,HOU,10,1,-171,-1.5,-110,8.5,-120,100,151,1.5,-110,5.36,Minute Maid Park,11,9
4/24/2014,2014,CLE,KC,5,1,-125,-1.5,170,7.5,105,-125,115,1.5,-200,4.17,Progressive Field,6,4
4/24/2014,2014,PHI,LAD,7,3,154,1.5,-150,7,-110,-110,-169,-1.5,130,2.76,Dodger Stadium,10,4
4/24/2014,2014,TB,MIN,7,9,-160,-1.5,135,7.5,-110,-110,145,1.5,-155,4.62,Tropicana Field,16,-2
4/24/2014,2014,STL,NYM,1,4,-127,-1.5,130,7,-106,-114,117,1.5,-150,3.92,Citi Field,5,-3
4/24/2014,2014,BOS,NYY,5,14,-117,-1.5,170,8.5,-110,-110,107,1.5,-200,4.58,Fenway Park,19,-9
4/24/2014,2014,HOU,OAK,1,10,151,1.5,-110,8.5,-120,100,-171,-1.5,-110,3.39,Minute Maid Park,11,-9
4/24/2014,2014,LAD,PHI,3,7,-169,-1.5,130,7,-110,-110,154,1.5,-150,4.4,Dodger Stadium,10,-4
4/24/2014,2014,CIN,PIT,2,1,100,1.5,-220,7,-115,-105,-110,-1.5,190,3.5,PNC Park,3,1
4/24/2014,2014,WSH,SD,3,4,-155,-1.5,140,7,-110,-110,140,1.5,-160,4.25,Nationals Park,7,-1
4/24/2014,2014,NYM,STL,4,1,117,1.5,-150,7,-106,-114,-127,-1.5,130,3.23,Citi Field,5,3
4/24/2014,2014,MIN,TB,9,7,145,1.5,-155,7.5,-110,-110,-160,-1.5,135,3.06,Tropicana Field,16,2
4/24/2014,2014,BAL,TOR,11,4,125,1.5,-170,8.5,-125,105,-140,-1.5,150,3.78,Rogers Centre,15,7
4/24/2014,2014,SD,WSH,4,3,140,1.5,-160,7,-110,-110,-155,-1.5,140,2.92,Nationals Park,7,1
4/25/2014,2014,PHI,ARI,4,5,116,1.5,-180,9,-125,105,-126,-1.5,160,4.17,Chase Field,9,-1
4/25/2014,2014,CIN,ATL,4,5,118,1.5,-175,7,-115,-105,-133,-1.5,155,3.21,Turner Field,9,-1
4/25/2014,2014,KC,BAL,5,0,-103,1.5,-210,8,-120,100,-107,-1.5,180,4.06,Camden Yards,5,5
4/25/2014,2014,TOR,BOS,1,8,-113,-1.5,170,9.5,100,-120,103,1.5,-200,5.04,Rogers Centre,9,-7
4/25/2014,2014,MIL,CHC,5,2,-182,-1.5,115,8,-115,-105,162,1.5,-135,5.16,Miller Park,7,3
4/25/2014,2014,ATL,CIN,5,4,-133,-1.5,155,7,-115,-105,118,1.5,-175,4,Turner Field,9,1
4/25/2014,2014,SF,CLE,5,1,-153,-1.5,140,7.5,100,-120,138,1.5,-160,4.54,AT&T Park,6,4
4/25/2014,2014,LAD,COL,4,5,-143,-1.5,155,7,-120,100,128,1.5,-175,4.12,Dodger Stadium,9,-1
4/25/2014,2014,TB,CWS,6,9,-140,-1.5,110,8.5,-110,-110,125,1.5,-130,4.96,Guaranteed Rate Field,15,-3
4/25/2014,2014,MIN,DET,6,10,114,1.5,-150,8.5,-110,-110,-124,-1.5,130,3.97,Target Field,16,-4
4/25/2014,2014,OAK,HOU,12,5,-183,-1.5,-120,9,-120,100,163,1.5,100,5.82,Minute Maid Park,17,7
4/25/2014,2014,BAL,KC,0,5,-107,-1.5,180,8,-120,100,-103,1.5,-210,4.14,Camden Yards,5,-5
4/25/2014,2014,NYY,LAA,1,13,-120,-1.5,175,8,100,-120,110,1.5,-205,4.36,Yankee Stadium,14,-12
4/25/2014,2014,COL,LAD,5,4,128,1.5,-175,7,-120,100,-143,-1.5,155,3.07,Dodger Stadium,9,1
4/25/2014,2014,NYM,MIA,4,3,-114,-1.5,190,7,100,-120,104,1.5,-220,3.73,Citi Field,7,1
4/25/2014,2014,CHC,MIL,2,5,162,1.5,-135,8,-115,-105,-182,-1.5,115,3.05,Miller Park,7,-3
4/25/2014,2014,DET,MIN,10,6,-124,-1.5,130,8.5,-110,-110,114,1.5,-150,4.71,Target Field,16,4
4/25/2014,2014,MIA,NYM,3,4,104,1.5,-220,7,100,-120,-114,-1.5,190,3.43,Citi Field,7,-1
4/25/2014,2014,LAA,NYY,13,1,110,1.5,-205,8,100,-120,-120,-1.5,175,3.81,Yankee Stadium,14,12
4/25/2014,2014,HOU,OAK,5,12,163,1.5,100,9,-120,100,-183,-1.5,-120,3.42,Minute Maid Park,17,-7
4/25/2014,2014,ARI,PHI,5,4,-126,-1.5,160,9,-125,105,116,1.5,-180,5.02,Chase Field,9,1
4/25/2014,2014,STL,PIT,1,0,-111,-1.5,185,7.5,105,-125,101,1.5,-215,3.95,Busch Stadium,1,1
4/25/2014,2014,WSH,SD,11,1,-190,-1.5,115,6.5,-115,-105,170,1.5,-135,4.26,Nationals Park,12,10
4/25/2014,2014,TEX,SEA,5,6,-113,-1.5,145,7,-113,-107,103,1.5,-165,3.71,T-Mobile Park,11,-1
4/25/2014,2014,CLE,SF,1,5,138,1.5,-160,7.5,100,-120,-153,-1.5,140,3.15,AT&T Park,6,-4
4/25/2014,2014,PIT,STL,0,1,101,1.5,-215,7.5,105,-125,-111,-1.5,185,3.73,Busch Stadium,1,-1
4/25/2014,2014,CWS,TB,9,6,125,1.5,-130,8.5,-110,-110,-140,-1.5,110,3.78,Guaranteed Rate Field,15,3
4/25/2014,2014,SEA,TEX,6,5,103,1.5,-165,7,-113,-107,-113,-1.5,145,3.45,T-Mobile Park,11,1
4/25/2014,2014,BOS,TOR,8,1,103,1.5,-200,9.5,100,-120,-113,-1.5,170,4.68,Rogers Centre,9,7
4/25/2014,2014,SD,WSH,1,11,170,1.5,-135,6.5,-115,-105,-190,-1.5,115,2.41,Nationals Park,12,-10
4/26/2014,2014,PHI,ARI,6,5,-149,-1.5,105,8,-104,-116,134,1.5,-125,4.79,Chase Field,11,1
4/26/2014,2014,CIN,ATL,1,4,113,1.5,-205,7.5,-105,-115,-123,-1.5,175,3.52,Turner Field,5,-3
4/26/2014,2014,KC,BAL,2,3,125,1.5,-170,8.5,-120,100,-140,-1.5,150,3.78,Camden Yards,5,-1
4/26/2014,2014,TOR,BOS,6,7,-105,-1.5,180,9,-120,100,-105,1.5,-210,4.61,Rogers Centre,13,-1
4/26/2014,2014,MIL,CHC,5,3,-167,-1.5,130,8,-105,-115,152,1.5,-150,5,Miller Park,8,2
4/26/2014,2014,ATL,CIN,4,1,-123,-1.5,175,7.5,-105,-115,113,1.5,-205,4.14,Turner Field,5,3
4/26/2014,2014,SF,CLE,5,3,-110,-1.5,185,7.5,100,-120,100,1.5,-215,3.93,AT&T Park,8,2
4/26/2014,2014,LAD,COL,6,3,-109,-1.5,190,7,-115,-105,-101,1.5,-230,3.65,Dodger Stadium,9,3
4/26/2014,2014,TB,CWS,4,0,-112,-1.5,155,8.5,-111,-109,102,1.5,-175,4.49,Guaranteed Rate Field,4,4
4/26/2014,2014,MIN,DET,5,3,125,1.5,-135,8,-105,-115,-140,-1.5,115,3.56,Target Field,8,2
4/26/2014,2014,OAK,HOU,6,7,-141,-1.5,115,9,-115,-105,126,1.5,-135,5.27,Minute Maid Park,13,-1
4/26/2014,2014,BAL,KC,3,2,-140,-1.5,150,8.5,-120,100,125,1.5,-170,4.96,Camden Yards,5,1
4/26/2014,2014,NYY,LAA,4,3,-111,-1.5,175,9,-125,105,101,1.5,-205,4.73,Yankee Stadium,7,1
4/26/2014,2014,COL,LAD,3,6,-101,1.5,-230,7,-115,-105,-109,-1.5,190,3.52,Dodger Stadium,9,-3
4/26/2014,2014,NYM,MIA,6,7,-141,-1.5,160,7,-129,109,126,1.5,-180,4.1,Citi Field,13,-1
4/26/2014,2014,CHC,MIL,3,5,152,1.5,-150,8,-105,-115,-167,-1.5,130,3.17,Miller Park,8,-2
4/26/2014,2014,DET,MIN,3,5,-140,-1.5,115,8,-105,-115,125,1.5,-135,4.67,Target Field,8,-2
4/26/2014,2014,MIA,NYM,7,6,126,1.5,-180,7,-129,109,-141,-1.5,160,3.1,Citi Field,13,1
4/26/2014,2014,LAA,NYY,3,4,101,1.5,-205,9,-125,105,-111,-1.5,175,4.48,Yankee Stadium,7,-1
4/26/2014,2014,HOU,OAK,7,6,126,1.5,-135,9,-115,-105,-141,-1.5,115,3.98,Minute Maid Park,13,1
4/26/2014,2014,ARI,PHI,5,6,134,1.5,-125,8,-104,-116,-149,-1.5,105,3.42,Chase Field,11,-1
4/26/2014,2014,STL,PIT,1,6,-113,-1.5,185,8,100,-120,103,1.5,-215,4.24,Busch Stadium,7,-5
4/26/2014,2014,WSH,SD,4,0,-110,-1.5,190,7,-105,-115,100,1.5,-230,3.67,Nationals Park,4,4
4/26/2014,2014,TEX,SEA,6,3,152,1.5,-140,7,105,-125,-172,-1.5,120,2.78,T-Mobile Park,9,3
4/26/2014,2014,CLE,SF,3,5,100,1.5,-215,7.5,100,-120,-110,-1.5,185,3.75,AT&T Park,8,-2
4/26/2014,2014,PIT,STL,6,1,103,1.5,-215,8,100,-120,-113,-1.5,185,3.94,Busch Stadium,7,5
4/26/2014,2014,CWS,TB,0,4,102,1.5,-175,8.5,-111,-109,-112,-1.5,155,4.21,Guaranteed Rate Field,4,-4
4/26/2014,2014,SEA,TEX,3,6,-172,-1.5,120,7,105,-125,152,1.5,-140,4.43,T-Mobile Park,9,-3
4/26/2014,2014,BOS,TOR,7,6,-105,1.5,-210,9,-120,100,-105,-1.5,180,4.61,Rogers Centre,13,1
4/26/2014,2014,SD,WSH,0,4,100,1.5,-230,7,-105,-115,-110,-1.5,190,3.5,Nationals Park,4,-4
4/27/2014,2014,PHI,ARI,2,0,118,1.5,-190,8.5,-107,-113,-133,-1.5,160,3.9,Chase Field,2,2
4/27/2014,2014,CIN,ATL,0,1,-105,1.5,-225,6.5,-124,104,-105,-1.5,195,3.33,Turner Field,1,-1
4/27/2014,2014,KC,BAL,9,3,-130,-1.5,125,7.5,-105,-115,115,1.5,-145,4.24,Camden Yards,12,6
4/27/2014,2014,TOR,BOS,7,1,100,1.5,-170,8.5,-110,-110,-110,-1.5,150,4.25,Rogers Centre,8,6
4/27/2014,2014,MIL,CHC,0,4,-145,-1.5,155,7.5,100,-120,130,1.5,-175,4.44,Miller Park,4,-4
4/27/2014,2014,ATL,CIN,1,0,-105,-1.5,195,6.5,-124,104,-105,1.5,-225,3.33,Turner Field,1,1
4/27/2014,2014,SF,CLE,4,1,106,1.5,-165,8,100,-120,-116,-1.5,145,3.88,AT&T Park,5,3
4/27/2014,2014,LAD,COL,1,6,-147,-1.5,150,7,100,-120,132,1.5,-170,4.17,Dodger Stadium,7,-5
4/27/2014,2014,TB,CWS,2,9,-176,-1.5,-105,8,-110,-110,156,1.5,-115,5.1,Guaranteed Rate Field,11,-7
4/27/2014,2014,OAK,HOU,1,5,-147,-1.5,110,9.5,100,-120,132,1.5,-130,5.65,Minute Maid Park,6,-4
4/27/2014,2014,BAL,KC,3,9,115,1.5,-145,7.5,-105,-115,-130,-1.5,125,3.49,Camden Yards,12,-6
4/27/2014,2014,NYY,LAA,3,2,-164,-1.5,126,7.5,-105,-115,149,1.5,-145,4.66,Yankee Stadium,5,1
4/27/2014,2014,COL,LAD,6,1,132,1.5,-170,7,100,-120,-147,-1.5,150,3.02,Dodger Stadium,7,5
4/27/2014,2014,NYM,MIA,4,0,-119,-1.5,194,7,100,-120,109,1.5,-224,3.8,Citi Field,4,4
4/27/2014,2014,CHC,MIL,4,0,130,1.5,-175,7.5,100,-120,-145,-1.5,155,3.26,Miller Park,4,4
4/27/2014,2014,MIA,NYM,0,4,109,1.5,-224,7,100,-120,-119,-1.5,194,3.35,Citi Field,4,-4
4/27/2014,2014,LAA,NYY,2,3,149,1.5,-145,7.5,-105,-115,-164,-1.5,126,3.01,Yankee Stadium,5,-1
4/27/2014,2014,HOU,OAK,5,1,132,1.5,-130,9.5,100,-120,-147,-1.5,110,4.09,Minute Maid Park,6,4
4/27/2014,2014,ARI,PHI,0,2,-133,-1.5,160,8.5,-107,-113,118,1.5,-190,4.85,Chase Field,2,-2
4/27/2014,2014,STL,PIT,7,0,-190,-1.5,115,7.5,-115,-105,170,1.5,-135,4.91,Busch Stadium,7,7
4/27/2014,2014,WSH,SD,2,4,-116,-1.5,185,7,-125,105,106,1.5,-215,3.76,Nationals Park,6,-2
4/27/2014,2014,TEX,SEA,5,6,-106,-1.5,155,7.5,-103,-117,-104,1.5,-175,3.86,T-Mobile Park,11,-1
4/27/2014,2014,CLE,SF,1,4,-116,-1.5,145,8,100,-120,106,1.5,-165,4.3,AT&T Park,5,-3
4/27/2014,2014,PIT,STL,0,7,170,1.5,-135,7.5,-115,-105,-190,-1.5,115,2.78,Busch Stadium,7,-7
4/27/2014,2014,CWS,TB,9,2,156,1.5,-115,8,-110,-110,-176,-1.5,-105,3.13,Guaranteed Rate Field,11,7
4/27/2014,2014,SEA,TEX,6,5,-104,1.5,-175,7.5,-103,-117,-106,-1.5,155,3.82,T-Mobile Park,11,1
4/27/2014,2014,BOS,TOR,1,7,-110,-1.5,150,8.5,-110,-110,100,1.5,-170,4.45,Rogers Centre,8,-6
4/27/2014,2014,SD,WSH,4,2,106,1.5,-215,7,-125,105,-116,-1.5,185,3.4,Nationals Park,6,2
4/28/2014,2014,COL,ARI,8,5,116,1.5,-185,8.5,-105,-115,-131,-1.5,165,3.94,Chase Field,13,3
4/28/2014,2014,LAA,CLE,6,3,-128,-1.5,160,8.5,-110,-110,118,1.5,-180,4.77,Angel Stadium,9,3
4/28/2014,2014,ARI,COL,5,8,-131,-1.5,165,8.5,-105,-115,116,1.5,-185,4.82,Chase Field,13,-3
4/28/2014,2014,TB,CWS,3,7,-128,-1.5,130,9,-110,-110,118,1.5,-150,5.05,Guaranteed Rate Field,10,-4
4/28/2014,2014,CLE,LAA,3,6,118,1.5,-180,8.5,-110,-110,-128,-1.5,160,3.9,Angel Stadium,9,-3
4/28/2014,2014,STL,MIL,3,5,-170,-1.5,130,7,-110,-110,150,1.5,-150,4.41,Busch Stadium,8,-2
4/28/2014,2014,TEX,OAK,0,4,-127,-1.5,160,8,-117,-103,117,1.5,-190,4.48,Rangers Ballpark,4,-4
4/28/2014,2014,SF,SD,4,6,-173,-1.5,140,6,-105,-115,153,1.5,-160,3.8,AT&T Park,10,-2
4/28/2014,2014,SD,SF,6,4,153,1.5,-160,6,-105,-115,-173,-1.5,140,2.37,AT&T Park,10,2
4/28/2014,2014,MIL,STL,5,3,150,1.5,-150,7,-110,-110,-170,-1.5,130,2.8,Busch Stadium,8,2
4/28/2014,2014,CWS,TB,7,3,118,1.5,-150,9,-110,-110,-128,-1.5,130,4.13,Guaranteed Rate Field,10,4
4/28/2014,2014,OAK,TEX,4,0,117,1.5,-190,8,-117,-103,-127,-1.5,160,3.69,Rangers Ballpark,4,4
4/29/2014,2014,COL,ARI,5,4,-110,-1.5,150,8.5,-120,100,100,1.5,-170,4.45,Chase Field,9,1
4/29/2014,2014,MIA,ATL,9,0,-133,-1.5,175,6,-107,-113,118,1.5,-205,3.42,Marlins Park,9,9
4/29/2014,2014,TB,BOS,4,7,152,1.5,-140,8.5,-104,-116,-167,-1.5,120,3.37,Fenway Park,11,-3
4/29/2014,2014,CIN,CHC,3,2,-132,-1.5,170,7.5,105,-125,117,1.5,-200,4.27,Great American Ballpark,5,1
4/29/2014,2014,CHC,CIN,2,3,117,1.5,-200,7.5,105,-125,-132,-1.5,170,3.46,Great American Ballpark,5,-1
4/29/2014,2014,LAA,CLE,6,4,-129,-1.5,161,8.5,-110,-110,119,1.5,-191,4.79,Angel Stadium,10,2
4/29/2014,2014,ARI,COL,4,5,100,1.5,-170,8.5,-120,100,-110,-1.5,150,4.25,Chase Field,9,-1
4/29/2014,2014,DET,CWS,4,3,-140,-1.5,120,8.5,100,-120,125,1.5,-140,4.96,Guaranteed Rate Field,7,1
4/29/2014,2014,CWS,DET,3,4,125,1.5,-140,8.5,100,-120,-140,-1.5,120,3.78,Guaranteed Rate Field,7,-1
4/29/2014,2014,WSH,HOU,4,3,-144,-1.5,115,8.5,-115,-105,129,1.5,-135,5.02,Minute Maid Park,7,1
4/29/2014,2014,TOR,KC,7,10,129,1.5,-170,8.5,-105,-115,-144,-1.5,150,3.71,Kauffman Stadium,17,-3
4/29/2014,2014,CLE,LAA,4,6,119,1.5,-191,8.5,-110,-110,-129,-1.5,161,3.88,Angel Stadium,10,-2
4/29/2014,2014,ATL,MIA,0,9,118,1.5,-205,6,-107,-113,-133,-1.5,175,2.75,Marlins Park,9,-9
4/29/2014,2014,STL,MIL,4,5,-165,-1.5,140,6.5,-125,105,150,1.5,-160,4.05,Busch Stadium,9,-1
4/29/2014,2014,PHI,NYM,1,6,-140,-1.5,160,6.5,-125,105,125,1.5,-190,3.79,Citizens Bank Park,7,-5
4/29/2014,2014,SEA,NYY,6,3,154,1.5,-135,8,-120,100,-174,-1.5,115,3.15,Yankee Stadium,9,3
4/29/2014,2014,TEX,OAK,3,9,-101,1.5,-160,8,-110,-110,-109,-1.5,140,4.02,Rangers Ballpark,12,-6
4/29/2014,2014,NYM,PHI,6,1,125,1.5,-190,6.5,-125,105,-140,-1.5,160,2.89,Citizens Bank Park,7,5
4/29/2014,2014,SF,SD,6,0,-150,-1.5,145,7,-110,-110,135,1.5,-165,4.2,AT&T Park,6,6
4/29/2014,2014,NYY,SEA,3,6,-174,-1.5,115,8,-120,100,154,1.5,-135,5.08,Yankee Stadium,9,-3
4/29/2014,2014,SD,SF,0,6,135,1.5,-165,7,-110,-110,-150,-1.5,145,2.98,AT&T Park,6,-6
4/29/2014,2014,MIL,STL,5,4,150,1.5,-160,6.5,-125,105,-165,-1.5,140,2.6,Busch Stadium,9,1
4/29/2014,2014,BOS,TB,7,4,-167,-1.5,120,8.5,-104,-116,152,1.5,-140,5.32,Fenway Park,11,3
4/29/2014,2014,OAK,TEX,9,3,-109,-1.5,140,8,-110,-110,-101,1.5,-160,4.17,Rangers Ballpark,12,6
4/29/2014,2014,KC,TOR,10,7,-144,-1.5,150,8.5,-105,-115,129,1.5,-170,5.02,Kauffman Stadium,17,3
4/29/2014,2014,HOU,WSH,3,4,129,1.5,-135,8.5,-115,-105,-144,-1.5,115,3.71,Minute Maid Park,7,-1
4/30/2014,2014,COL,ARI,4,5,105,1.5,-200,8.5,-120,100,-115,-1.5,170,4.15,Chase Field,9,-1
4/30/2014,2014,MIA,ATL,9,3,-104,1.5,-175,7,-125,105,-106,-1.5,155,3.57,Marlins Park,12,6
4/30/2014,2014,CIN,CHC,4,9,-184,-1.5,115,7.5,100,-120,164,1.5,-135,4.86,Great American Ballpark,13,-5
4/30/2014,2014,CHC,CIN,9,4,164,1.5,-135,7.5,100,-120,-184,-1.5,115,2.84,Great American Ballpark,13,5
4/30/2014,2014,LAA,CLE,7,1,-147,-1.5,140,9,-115,-105,132,1.5,-160,5.36,Angel Stadium,8,6
4/30/2014,2014,ARI,COL,5,4,-115,-1.5,170,8.5,-120,100,105,1.5,-200,4.55,Chase Field,9,1
4/30/2014,2014,DET,CWS,5,1,-177,-1.5,-115,8,-115,-105,157,1.5,-105,5.11,Guaranteed Rate Field,6,4
4/30/2014,2014,CWS,DET,1,5,157,1.5,-105,8,-115,-105,-177,-1.5,-115,3.11,Guaranteed Rate Field,6,-4
4/30/2014,2014,WSH,HOU,7,0,-142,-1.5,115,8.5,-103,-117,127,1.5,-135,4.99,Minute Maid Park,7,7
4/30/2014,2014,TOR,KC,2,4,119,1.5,-190,7,-120,100,-134,-1.5,160,3.2,Kauffman Stadium,6,-2
4/30/2014,2014,CLE,LAA,1,7,132,1.5,-160,9,-115,-105,-147,-1.5,140,3.88,Angel Stadium,8,-6
4/30/2014,2014,MIN,LAD,4,6,146,1.5,-115,7.5,-106,-114,-161,-1.5,-105,3.05,Target Field,10,-2
4/30/2014,2014,ATL,MIA,3,9,-106,-1.5,155,7,-125,105,-104,1.5,-175,3.6,Marlins Park,12,-6
4/30/2014,2014,STL,MIL,9,3,-141,-1.5,160,7,100,-120,126,1.5,-180,4.1,Busch Stadium,12,6
4/30/2014,2014,LAD,MIN,6,4,-161,-1.5,-105,7.5,-106,-114,146,1.5,-115,4.63,Target Field,10,2
4/30/2014,2014,TEX,OAK,1,12,-120,-1.5,175,8,-105,-115,110,1.5,-205,4.36,Rangers Ballpark,13,-11
4/30/2014,2014,SF,SD,3,2,-170,-1.5,130,7,100,-120,150,1.5,-150,4.41,AT&T Park,5,1
4/30/2014,2014,SD,SF,2,3,150,1.5,-150,7,100,-120,-170,-1.5,130,2.8,AT&T Park,5,-1
4/30/2014,2014,MIL,STL,3,9,126,1.5,-180,7,100,-120,-141,-1.5,160,3.1,Busch Stadium,12,-6
4/30/2014,2014,OAK,TEX,12,1,110,1.5,-205,8,-105,-115,-120,-1.5,175,3.81,Rangers Ballpark,13,11
4/30/2014,2014,KC,TOR,4,2,-134,-1.5,160,7,-120,100,119,1.5,-190,4.01,Kauffman Stadium,6,2
4/30/2014,2014,HOU,WSH,0,7,127,1.5,-135,8.5,-103,-117,-142,-1.5,115,3.74,Minute Maid Park,7,-7
5/1/2014,2014,MIA,ATL,5,4,117,1.5,-150,7.5,105,-125,-132,-1.5,130,3.46,Marlins Park,9,1
5/1/2014,2014,PIT,BAL,1,5,108,1.5,-200,9,-105,-115,-118,-1.5,170,4.33,Camden Yards,6,-4
5/1/2014,2014,PIT,BAL,5,6,118,1.5,-200,8.5,100,-120,-128,-1.5,170,3.9,Camden Yards,11,-1
5/1/2014,2014,TB,BOS,2,1,143,1.5,-145,9,-120,100,-158,-1.5,125,3.7,Fenway Park,3,1
5/1/2014,2014,TB,BOS,6,5,103,1.5,-195,9,-124,104,-113,-1.5,165,4.43,Fenway Park,11,1
5/1/2014,2014,MIL,CIN,3,8,109,1.5,-205,7,-120,100,-119,-1.5,175,3.35,Great American Ballpark,11,-5
5/1/2014,2014,NYM,COL,4,7,125,1.5,-170,9.5,100,-120,-140,-1.5,150,4.22,Coors Field,11,-3
5/1/2014,2014,TOR,KC,7,3,-109,-1.5,140,8,-115,-105,-101,1.5,-160,4.17,Kauffman Stadium,10,4
5/1/2014,2014,MIN,LAD,4,9,140,1.5,-120,8.5,-125,105,-155,-1.5,100,3.54,Target Field,13,-5
5/1/2014,2014,MIN,LAD,3,4,-112,-1.5,180,9,103,-123,102,1.5,-210,4.75,Target Field,7,-1
5/1/2014,2014,ATL,MIA,4,5,-132,-1.5,130,7.5,105,-125,117,1.5,-150,4.27,Marlins Park,9,-1
5/1/2014,2014,CIN,MIL,8,3,-119,-1.5,175,7,-120,100,109,1.5,-205,3.8,Great American Ballpark,11,5
5/1/2014,2014,LAD,MIN,9,4,-155,-1.5,100,8.5,-125,105,140,1.5,-120,5.17,Target Field,13,5
5/1/2014,2014,LAD,MIN,4,3,102,1.5,-210,9,103,-123,-112,-1.5,180,4.46,Target Field,7,1
5/1/2014,2014,COL,NYM,7,4,-140,-1.5,150,9.5,100,-120,125,1.5,-170,5.54,Coors Field,11,3
5/1/2014,2014,SEA,NYY,4,2,134,1.5,-165,9,-105,-115,-149,-1.5,145,3.85,Yankee Stadium,6,2
5/1/2014,2014,BAL,PIT,5,1,-118,-1.5,170,9,-105,-115,108,1.5,-200,4.87,Camden Yards,6,4
5/1/2014,2014,BAL,PIT,6,5,-128,-1.5,170,8.5,100,-120,118,1.5,-200,4.77,Camden Yards,11,1
5/1/2014,2014,NYY,SEA,2,4,-149,-1.5,145,9,-105,-115,134,1.5,-165,5.39,Yankee Stadium,6,-2
5/1/2014,2014,BOS,TB,1,2,-158,-1.5,125,9,-120,100,143,1.5,-145,5.51,Fenway Park,3,-1
5/1/2014,2014,BOS,TB,5,6,-113,-1.5,165,9,-124,104,103,1.5,-195,4.77,Fenway Park,11,-1
5/1/2014,2014,KC,TOR,3,7,-101,1.5,-160,8,-115,-105,-109,-1.5,140,4.02,Kauffman Stadium,10,-4
5/2/2014,2014,SD,ARI,0,2,-144,-1.5,155,7,105,-125,129,1.5,-175,4.13,PETCO Park,2,-2
5/2/2014,2014,SF,ATL,2,1,119,1.5,-190,7.5,105,-125,-134,-1.5,160,3.42,Turner Field,3,1
5/2/2014,2014,MIN,BAL,0,3,-111,-1.5,180,8.5,-120,100,101,1.5,-210,4.47,Target Field,3,-3
5/2/2014,2014,OAK,BOS,1,7,107,1.5,-195,9.5,-110,-110,-117,-1.5,165,4.59,Fenway Park,8,-6
5/2/2014,2014,STL,CHC,5,6,-165,-1.5,-106,8,-115,-105,150,1.5,-114,4.98,Wrigley Field,11,-1
5/2/2014,2014,MIL,CIN,2,0,107,1.5,-210,7.5,-110,-110,-117,-1.5,180,3.62,Great American Ballpark,2,2
5/2/2014,2014,CWS,CLE,5,12,136,1.5,-155,8,-120,100,-151,-1.5,135,3.39,Progressive Field,17,-7
5/2/2014,2014,NYM,COL,3,10,117,1.5,-175,10,100,-120,-132,-1.5,155,4.61,Coors Field,13,-7
5/2/2014,2014,CLE,CWS,12,5,-151,-1.5,135,8,-120,100,136,1.5,-155,4.81,Progressive Field,17,7
5/2/2014,2014,KC,DET,2,8,-138,-1.5,150,7.5,-110,-110,123,1.5,-170,4.35,Kauffman Stadium,10,-6
5/2/2014,2014,SEA,HOU,4,5,-203,-1.5,-125,8,100,-120,173,1.5,105,5.36,Minute Maid Park,9,-1
5/2/2014,2014,DET,KC,8,2,123,1.5,-170,7.5,-110,-110,-138,-1.5,150,3.36,Kauffman Stadium,10,6
5/2/2014,2014,TEX,LAA,5,2,119,1.5,-180,9,100,-120,-134,-1.5,160,4.11,Angel Stadium,7,3
5/2/2014,2014,MIA,LAD,6,3,105,1.5,-170,7.5,-120,100,-115,-1.5,150,3.66,Marlins Park,9,3
5/2/2014,2014,LAD,MIA,3,6,-115,-1.5,150,7.5,-120,100,105,1.5,-170,4.01,Marlins Park,9,-3
5/2/2014,2014,CIN,MIL,0,2,-117,-1.5,180,7.5,-110,-110,107,1.5,-210,4.04,Great American Ballpark,2,-2
5/2/2014,2014,BAL,MIN,3,0,101,1.5,-210,8.5,-120,100,-111,-1.5,180,4.23,Target Field,3,3
5/2/2014,2014,COL,NYM,10,3,-132,-1.5,155,10,100,-120,117,1.5,-175,5.69,Coors Field,13,7
5/2/2014,2014,TB,NYY,10,5,-142,-1.5,120,8.5,103,-123,127,1.5,-140,4.99,Yankee Stadium,15,5
5/2/2014,2014,BOS,OAK,7,1,-117,-1.5,165,9.5,-110,-110,107,1.5,-195,5.12,Fenway Park,8,6
5/2/2014,2014,WSH,PHI,5,3,-102,1.5,-235,6.5,-125,105,-108,-1.5,195,3.28,Citizens Bank Park,8,2
5/2/2014,2014,TOR,PIT,5,6,125,1.5,-175,7.5,105,-125,-140,-1.5,155,3.33,PNC Park,11,-1
5/2/2014,2014,ARI,SD,2,0,129,1.5,-175,7,105,-125,-144,-1.5,155,3.06,PETCO Park,2,2
5/2/2014,2014,HOU,SEA,5,4,173,1.5,105,8,100,-120,-203,-1.5,-125,2.93,Minute Maid Park,9,1
5/2/2014,2014,ATL,SF,1,2,-134,-1.5,160,7.5,105,-125,119,1.5,-190,4.29,Turner Field,3,-1
5/2/2014,2014,CHC,STL,6,5,150,1.5,-114,8,-115,-105,-165,-1.5,-106,3.2,Wrigley Field,11,1
5/2/2014,2014,NYY,TB,5,10,127,1.5,-140,8.5,103,-123,-142,-1.5,120,3.74,Yankee Stadium,15,-5
5/2/2014,2014,LAA,TEX,2,5,-134,-1.5,160,9,100,-120,119,1.5,-180,5.15,Angel Stadium,7,-3
5/2/2014,2014,PIT,TOR,6,5,-140,-1.5,155,7.5,105,-125,125,1.5,-175,4.38,PNC Park,11,1
5/2/2014,2014,PHI,WSH,3,5,-108,-1.5,195,6.5,-125,105,-102,1.5,-235,3.38,Citizens Bank Park,8,-2
5/3/2014,2014,SD,ARI,3,4,-132,-1.5,170,6.5,-112,-108,117,1.5,-200,3.7,PETCO Park,7,-1
5/3/2014,2014,SF,ATL,3,1,157,1.5,-140,7.5,100,-120,-177,-1.5,120,2.92,Turner Field,4,2
5/3/2014,2014,MIN,BAL,6,1,110,1.5,-145,8,-111,-109,-120,-1.5,125,3.81,Target Field,7,5
5/3/2014,2014,OAK,BOS,3,6,125,1.5,-165,9,-105,-115,-140,-1.5,145,4,Fenway Park,9,-3
5/3/2014,2014,STL,CHC,0,3,-190,-1.5,-119,8,-112,-108,170,1.5,-101,5.24,Wrigley Field,3,-3
5/3/2014,2014,MIL,CIN,2,6,139,1.5,-170,7,105,-125,-154,-1.5,150,2.93,Great American Ballpark,8,-4
5/3/2014,2014,CWS,CLE,0,2,148,1.5,-150,8.5,-115,-105,-163,-1.5,130,3.43,Progressive Field,2,-2
5/3/2014,2014,NYM,COL,10,11,116,1.5,-175,10.5,-105,-115,-126,-1.5,155,4.86,Coors Field,21,-1
5/3/2014,2014,CLE,CWS,2,0,-163,-1.5,130,8.5,-115,-105,148,1.5,-150,5.27,Progressive Field,2,2
5/3/2014,2014,KC,DET,2,9,-101,1.5,-175,8,-120,100,-109,-1.5,155,4.02,Kauffman Stadium,11,-7
5/3/2014,2014,SEA,HOU,9,8,-122,-1.5,130,8,-105,-115,112,1.5,-151,4.4,Minute Maid Park,17,1
5/3/2014,2014,DET,KC,9,2,-109,-1.5,155,8,-120,100,-101,1.5,-175,4.17,Kauffman Stadium,11,7
5/3/2014,2014,TEX,LAA,3,5,130,1.5,-165,8.5,-105,-115,-145,-1.5,145,3.7,Angel Stadium,8,-2
5/3/2014,2014,MIA,LAD,7,9,108,1.5,-160,8.5,-115,-105,-118,-1.5,140,4.09,Marlins Park,16,-2
5/3/2014,2014,LAD,MIA,9,7,-118,-1.5,140,8.5,-115,-105,108,1.5,-160,4.6,Marlins Park,16,2
5/3/2014,2014,CIN,MIL,6,2,-154,-1.5,150,7,105,-125,139,1.5,-170,4.24,Great American Ballpark,8,4
5/3/2014,2014,BAL,MIN,1,6,-120,-1.5,125,8,-111,-109,110,1.5,-145,4.36,Target Field,7,-5
5/3/2014,2014,COL,NYM,11,10,-126,-1.5,155,10.5,-105,-115,116,1.5,-175,5.85,Coors Field,21,1
5/3/2014,2014,TB,NYY,3,9,170,1.5,-119,8.5,100,-120,-200,-1.5,-101,3.15,Yankee Stadium,12,-6
5/3/2014,2014,BOS,OAK,6,3,-140,-1.5,145,9,-105,-115,125,1.5,-165,5.25,Fenway Park,9,3
5/3/2014,2014,WSH,PHI,2,7,-102,1.5,-225,7.5,-110,-110,-108,-1.5,195,3.79,Citizens Bank Park,9,-5
5/3/2014,2014,TOR,PIT,6,8,111,1.5,-205,7,-120,100,-121,-1.5,175,3.32,PNC Park,14,-2
5/3/2014,2014,ARI,SD,4,3,117,1.5,-200,6.5,-112,-108,-132,-1.5,170,3,PETCO Park,7,1
5/3/2014,2014,HOU,SEA,8,9,112,1.5,-151,8,-105,-115,-122,-1.5,130,3.77,Minute Maid Park,17,-1
5/3/2014,2014,ATL,SF,1,3,-177,-1.5,120,7.5,100,-120,157,1.5,-140,4.79,Turner Field,4,-2
5/3/2014,2014,CHC,STL,3,0,170,1.5,-101,8,-112,-108,-190,-1.5,-119,2.96,Wrigley Field,3,3
5/3/2014,2014,NYY,TB,9,3,-200,-1.5,-101,8.5,100,-120,170,1.5,-119,5.67,Yankee Stadium,12,6
5/3/2014,2014,LAA,TEX,5,3,-145,-1.5,145,8.5,-105,-115,130,1.5,-165,5.03,Angel Stadium,8,2
5/3/2014,2014,PIT,TOR,8,6,-121,-1.5,175,7,-120,100,111,1.5,-205,3.83,PNC Park,14,2
5/3/2014,2014,PHI,WSH,7,2,-108,-1.5,195,7.5,-110,-110,-102,1.5,-225,3.89,Citizens Bank Park,9,5
5/4/2014,2014,SD,ARI,4,3,-124,-1.5,175,6.5,-110,-110,114,1.5,-205,3.6,PETCO Park,7,1
5/4/2014,2014,SF,ATL,4,1,115,1.5,-211,7,-105,-115,-130,-1.5,181,3.26,Turner Field,5,3
5/4/2014,2014,MIN,BAL,5,2,-110,-1.5,181,8,-120,100,100,1.5,-211,4.19,Target Field,7,3
5/4/2014,2014,OAK,BOS,3,2,-105,-1.5,150,8.5,-126,106,-105,1.5,-170,4.35,Fenway Park,5,1
5/4/2014,2014,STL,CHC,5,4,-132,-1.5,120,7,-115,-105,117,1.5,-140,3.98,Wrigley Field,9,1
5/4/2014,2014,MIL,CIN,3,4,100,1.5,-215,7.5,-105,-115,-110,-1.5,185,3.75,Great American Ballpark,7,-1
5/4/2014,2014,CWS,CLE,4,3,138,1.5,-159,8.5,-110,-110,-153,-1.5,140,3.57,Progressive Field,7,1
5/4/2014,2014,NYM,COL,5,1,116,1.5,-175,11,-105,-115,-126,-1.5,155,5.09,Coors Field,6,4
5/4/2014,2014,CLE,CWS,3,4,-153,-1.5,140,8.5,-110,-110,138,1.5,-159,5.14,Progressive Field,7,-1
5/4/2014,2014,KC,DET,4,9,119,1.5,-145,8.5,-104,-116,-134,-1.5,125,3.88,Kauffman Stadium,13,-5
5/4/2014,2014,SEA,HOU,8,7,-101,1.5,-211,8.5,-115,-105,-109,-1.5,181,4.27,Minute Maid Park,15,1
5/4/2014,2014,DET,KC,9,4,-134,-1.5,125,8.5,-104,-116,119,1.5,-145,4.87,Kauffman Stadium,13,5
5/4/2014,2014,TEX,LAA,14,3,-111,-1.5,145,7.5,101,-121,101,1.5,-165,3.95,Angel Stadium,17,11
5/4/2014,2014,MIA,LAD,5,4,-181,-1.5,120,7,-115,-105,161,1.5,-140,4.51,Marlins Park,9,1
5/4/2014,2014,LAD,MIA,4,5,161,1.5,-140,7,-115,-105,-181,-1.5,120,2.68,Marlins Park,9,-1
5/4/2014,2014,CIN,MIL,4,3,-110,-1.5,185,7.5,-105,-115,100,1.5,-215,3.93,Great American Ballpark,7,1
5/4/2014,2014,BAL,MIN,2,5,100,1.5,-211,8,-120,100,-110,-1.5,181,4,Target Field,7,-3
5/4/2014,2014,COL,NYM,1,5,-126,-1.5,155,11,-105,-115,116,1.5,-175,6.13,Coors Field,6,-4
5/4/2014,2014,TB,NYY,5,1,126,1.5,-165,9,-110,-110,-141,-1.5,145,3.98,Yankee Stadium,6,4
5/4/2014,2014,BOS,OAK,2,3,-105,1.5,-170,8.5,-126,106,-105,-1.5,150,4.35,Fenway Park,5,-1
5/4/2014,2014,WSH,PHI,0,1,-130,-1.5,120,7.5,-115,-105,115,1.5,-140,4.24,Citizens Bank Park,1,-1
5/4/2014,2014,TOR,PIT,7,2,113,1.5,-195,8.5,-110,-110,-123,-1.5,165,3.99,PNC Park,9,5
5/4/2014,2014,ARI,SD,3,4,114,1.5,-205,6.5,-110,-110,-124,-1.5,175,3.04,PETCO Park,7,-1
5/4/2014,2014,HOU,SEA,7,8,-109,-1.5,181,8.5,-115,-105,-101,1.5,-211,4.43,Minute Maid Park,15,-1
5/4/2014,2014,ATL,SF,1,4,-130,-1.5,181,7,-105,-115,115,1.5,-211,3.96,Turner Field,5,-3
5/4/2014,2014,CHC,STL,4,5,117,1.5,-140,7,-115,-105,-132,-1.5,120,3.23,Wrigley Field,9,-1
5/4/2014,2014,NYY,TB,1,5,-141,-1.5,145,9,-110,-110,126,1.5,-165,5.27,Yankee Stadium,6,-4
5/4/2014,2014,LAA,TEX,3,14,101,1.5,-165,7.5,101,-121,-111,-1.5,145,3.73,Angel Stadium,17,-11
5/4/2014,2014,PIT,TOR,2,7,-123,-1.5,165,8.5,-110,-110,113,1.5,-195,4.69,PNC Park,9,-5
5/4/2014,2014,PHI,WSH,1,0,115,1.5,-140,7.5,-115,-105,-130,-1.5,120,3.49,Citizens Bank Park,1,1
5/5/2014,2014,MIL,ARI,8,3,-150,-1.5,145,8,100,-120,135,1.5,-165,4.8,Miller Park,11,5
5/5/2014,2014,STL,ATL,4,3,-101,1.5,-210,7.5,-105,-115,-109,-1.5,180,3.77,Turner Field,7,1
5/5/2014,2014,CWS,CHC,3,1,114,1.5,-210,6.5,-110,-110,-124,-1.5,180,3.04,Wrigley Field,4,2
5/5/2014,2014,MIN,CLE,1,0,143,1.5,-155,8,-105,-115,-158,-1.5,135,3.29,Progressive Field,1,1
5/5/2014,2014,TEX,COL,2,8,106,1.5,-195,10.5,-120,100,-116,-1.5,165,5.1,Coors Field,10,-6
5/5/2014,2014,CHC,CWS,1,3,-124,-1.5,180,6.5,-110,-110,114,1.5,-210,3.6,Wrigley Field,4,-2
5/5/2014,2014,HOU,DET,0,2,245,1.5,110,7.5,-120,100,-285,-1.5,-130,2.17,Comerica Park,2,-2
5/5/2014,2014,DET,HOU,2,0,-285,-1.5,-130,7.5,-120,100,245,1.5,110,5.55,Comerica Park,2,2
5/5/2014,2014,SD,KC,6,5,113,1.5,-155,6.5,100,-120,-123,-1.5,135,3.05,PETCO Park,11,1
5/5/2014,2014,NYY,LAA,1,4,130,1.5,-165,8,-110,-110,-145,-1.5,145,3.48,Angel Stadium,5,-3
5/5/2014,2014,WSH,LAD,4,0,102,1.5,-180,7,110,-130,-112,-1.5,160,3.47,Nationals Park,4,4
5/5/2014,2014,NYM,MIA,3,4,119,1.5,-195,7,-125,105,-134,-1.5,165,3.2,Marlins Park,7,-1
5/5/2014,2014,ARI,MIL,3,8,135,1.5,-165,8,100,-120,-150,-1.5,145,3.4,Miller Park,11,-5
5/5/2014,2014,CLE,MIN,0,1,-158,-1.5,135,8,-105,-115,143,1.5,-155,4.9,Progressive Field,1,-1
5/5/2014,2014,MIA,NYM,4,3,-134,-1.5,165,7,-125,105,119,1.5,-195,4.01,Marlins Park,7,1
5/5/2014,2014,LAA,NYY,4,1,-145,-1.5,145,8,-110,-110,130,1.5,-165,4.73,Angel Stadium,5,3
5/5/2014,2014,SEA,OAK,4,2,171,1.5,-125,7.5,103,-123,-201,-1.5,105,2.77,Oakland Coliseum,6,2
5/5/2014,2014,TOR,PHI,3,0,-111,-1.5,155,8.5,-115,-105,101,1.5,-175,4.47,Citizens Bank Park,3,3
5/5/2014,2014,SF,PIT,11,10,-104,-1.5,150,7,-110,-110,-106,1.5,-170,3.57,PNC Park,21,1
5/5/2014,2014,KC,SD,5,6,-123,-1.5,135,6.5,100,-120,113,1.5,-155,3.59,PETCO Park,11,-1
5/5/2014,2014,OAK,SEA,2,4,-201,-1.5,105,7.5,103,-123,171,1.5,-125,5.01,Oakland Coliseum,6,-2
5/5/2014,2014,PIT,SF,10,11,-106,1.5,-170,7,-110,-110,-104,-1.5,150,3.6,PNC Park,21,-1
5/5/2014,2014,ATL,STL,3,4,-109,-1.5,180,7.5,-105,-115,-101,1.5,-210,3.91,Turner Field,7,-1
5/5/2014,2014,COL,TEX,8,2,-116,-1.5,165,10.5,-120,100,106,1.5,-195,5.64,Coors Field,10,6
5/5/2014,2014,PHI,TOR,0,3,101,1.5,-175,8.5,-115,-105,-111,-1.5,155,4.23,Citizens Bank Park,3,-3
5/5/2014,2014,LAD,WSH,0,4,-112,-1.5,160,7,110,-130,102,1.5,-180,3.7,Nationals Park,4,-4
5/6/2014,2014,MIL,ARI,5,7,-146,-1.5,150,7.5,-115,-105,131,1.5,-170,4.45,Miller Park,12,-2
5/6/2014,2014,STL,ATL,1,2,106,1.5,-205,8,-105,-115,-116,-1.5,175,3.88,Turner Field,3,-1
5/6/2014,2014,TB,BAL,3,5,-140,-1.5,150,7.5,-115,-105,125,1.5,-170,4.38,Tropicana Field,8,-2
5/6/2014,2014,CIN,BOS,3,4,115,1.5,-190,8.5,-105,-115,-130,-1.5,160,3.95,Fenway Park,7,-1
5/6/2014,2014,CWS,CHC,5,1,125,1.5,-190,7,-120,100,-140,-1.5,160,3.11,Wrigley Field,6,4
5/6/2014,2014,BOS,CIN,4,3,-130,-1.5,160,8.5,-105,-115,115,1.5,-190,4.8,Fenway Park,7,1
5/6/2014,2014,MIN,CLE,2,4,133,1.5,-170,7.5,105,-125,-148,-1.5,150,3.22,Progressive Field,6,-2
5/6/2014,2014,TEX,COL,1,12,114,1.5,-190,10.5,-105,-115,-124,-1.5,160,4.91,Coors Field,13,-11
5/6/2014,2014,CHC,CWS,1,5,-140,-1.5,160,7,-120,100,125,1.5,-190,4.08,Wrigley Field,6,-4
5/6/2014,2014,HOU,DET,4,11,159,1.5,-130,9,-115,-105,-179,-1.5,110,3.47,Comerica Park,15,-7
5/6/2014,2014,DET,HOU,11,4,-179,-1.5,110,9,-115,-105,159,1.5,-130,5.77,Comerica Park,15,7
5/6/2014,2014,SD,KC,1,3,-114,-1.5,190,6.5,-105,-115,104,1.5,-220,3.46,PETCO Park,4,-2
5/6/2014,2014,NYY,LAA,4,3,119,1.5,-175,7.5,-115,-105,-134,-1.5,155,3.42,Angel Stadium,7,1
5/6/2014,2014,WSH,LAD,3,8,149,1.5,-120,7,105,-125,-164,-1.5,100,2.81,Nationals Park,11,-5
5/6/2014,2014,NYM,MIA,0,3,109,1.5,-205,7.5,-115,-105,-119,-1.5,175,3.59,Marlins Park,3,-3
5/6/2014,2014,ARI,MIL,7,5,131,1.5,-170,7.5,-115,-105,-146,-1.5,150,3.25,Miller Park,12,2
5/6/2014,2014,CLE,MIN,4,2,-148,-1.5,150,7.5,105,-125,133,1.5,-170,4.48,Progressive Field,6,2
5/6/2014,2014,MIA,NYM,3,0,-119,-1.5,175,7.5,-115,-105,109,1.5,-205,4.08,Marlins Park,3,3
5/6/2014,2014,LAA,NYY,3,4,-134,-1.5,155,7.5,-115,-105,119,1.5,-175,4.29,Angel Stadium,7,-1
5/6/2014,2014,SEA,OAK,8,3,158,1.5,-140,7,-130,110,-178,-1.5,120,2.71,Oakland Coliseum,11,5
5/6/2014,2014,TOR,PHI,6,5,105,1.5,-215,7.5,100,-120,-115,-1.5,185,3.66,Citizens Bank Park,11,1
5/6/2014,2014,SF,PIT,1,2,-113,-1.5,150,7.5,-105,-115,103,1.5,-170,3.98,PNC Park,3,-1
5/6/2014,2014,KC,SD,3,1,104,1.5,-220,6.5,-105,-115,-114,-1.5,190,3.19,PETCO Park,4,2
5/6/2014,2014,OAK,SEA,3,8,-178,-1.5,120,7,-130,110,158,1.5,-140,4.48,Oakland Coliseum,11,-5
5/6/2014,2014,PIT,SF,2,1,103,1.5,-170,7.5,-105,-115,-113,-1.5,150,3.69,PNC Park,3,1
5/6/2014,2014,ATL,STL,2,1,-116,-1.5,175,8,-105,-115,106,1.5,-205,4.3,Turner Field,3,1
5/6/2014,2014,BAL,TB,5,3,125,1.5,-170,7.5,-115,-105,-140,-1.5,150,3.33,Tropicana Field,8,2
5/6/2014,2014,COL,TEX,12,1,-124,-1.5,160,10.5,-105,-115,114,1.5,-190,5.81,Coors Field,13,11
5/6/2014,2014,PHI,TOR,5,6,-115,-1.5,185,7.5,100,-120,105,1.5,-215,4.01,Citizens Bank Park,11,-1
5/6/2014,2014,LAD,WSH,8,3,-164,-1.5,100,7,105,-125,149,1.5,-120,4.35,Nationals Park,11,5
5/7/2014,2014,MIL,ARI,2,3,-150,-1.5,145,8,-110,-110,135,1.5,-165,4.8,Miller Park,5,-1
5/7/2014,2014,STL,ATL,7,1,-114,-1.5,150,6.5,-126,106,104,1.5,-170,3.46,Turner Field,8,6
5/7/2014,2014,TB,BAL,3,4,-124,-1.5,170,8,100,-120,114,1.5,-200,4.43,Tropicana Field,7,-1
5/7/2014,2014,CIN,BOS,3,4,143,1.5,-150,8.5,-102,-118,-158,-1.5,130,3.5,Fenway Park,7,-1
5/7/2014,2014,CWS,CHC,8,3,-102,1.5,-175,9,-105,-115,-108,-1.5,155,4.54,Guaranteed Rate Field,11,5
5/7/2014,2014,BOS,CIN,4,3,-158,-1.5,130,8.5,-102,-118,143,1.5,-150,5.21,Fenway Park,7,1
5/7/2014,2014,MIN,CLE,3,4,143,1.5,-159,7.5,-120,100,-158,-1.5,139,3.09,Progressive Field,7,-1
5/7/2014,2014,TEX,COL,2,9,-123,-1.5,160,9.5,-110,-110,113,1.5,-190,5.24,Rangers Ballpark,11,-7
5/7/2014,2014,CHC,CWS,3,8,-108,-1.5,155,9,-105,-115,-102,1.5,-175,4.67,Guaranteed Rate Field,11,-5
5/7/2014,2014,HOU,DET,2,3,179,1.5,-110,8.5,-120,100,-209,-1.5,-110,3.05,Comerica Park,5,-1
5/7/2014,2014,DET,HOU,3,2,-209,-1.5,-110,8.5,-120,100,179,1.5,-110,5.75,Comerica Park,5,1
5/7/2014,2014,SD,KC,0,8,107,1.5,-190,5.5,-120,100,-117,-1.5,160,2.66,PETCO Park,8,-8
5/7/2014,2014,NYY,LAA,9,2,125,1.5,-170,8.5,-105,-115,-140,-1.5,150,3.78,Angel Stadium,11,7
5/7/2014,2014,WSH,LAD,3,2,-140,-1.5,160,6.5,-120,100,125,1.5,-180,3.79,Nationals Park,5,1
5/7/2014,2014,NYM,MIA,0,1,102,1.5,-210,7.5,113,-133,-112,-1.5,180,3.71,Marlins Park,1,-1
5/7/2014,2014,ARI,MIL,3,2,135,1.5,-165,8,-110,-110,-150,-1.5,145,3.4,Miller Park,5,1
5/7/2014,2014,CLE,MIN,4,3,-158,-1.5,139,7.5,-120,100,143,1.5,-159,4.59,Progressive Field,7,1
5/7/2014,2014,MIA,NYM,1,0,-112,-1.5,180,7.5,113,-133,102,1.5,-210,3.96,Marlins Park,1,1
5/7/2014,2014,LAA,NYY,2,9,-140,-1.5,150,8.5,-105,-115,125,1.5,-170,4.96,Angel Stadium,11,-7
5/7/2014,2014,SEA,OAK,6,4,-120,-1.5,140,7,-125,105,110,1.5,-160,3.82,Oakland Coliseum,10,2
5/7/2014,2014,SEA,OAK,0,2,150,1.5,-160,7.5,-110,-110,-165,-1.5,135,3,Oakland Coliseum,2,-2
5/7/2014,2014,TOR,PHI,10,0,-108,-1.5,185,8,-110,-110,-102,1.5,-215,4.15,Rogers Centre,10,10
5/7/2014,2014,SF,PIT,3,4,142,1.5,-169,7,-110,-110,-157,-1.5,149,2.89,PNC Park,7,-1
5/7/2014,2014,KC,SD,8,0,-117,-1.5,160,5.5,-120,100,107,1.5,-190,2.97,PETCO Park,8,8
5/7/2014,2014,OAK,SEA,4,6,110,1.5,-160,7,-125,105,-120,-1.5,140,3.33,Oakland Coliseum,10,-2
5/7/2014,2014,OAK,SEA,2,0,-165,-1.5,135,7.5,-110,-110,150,1.5,-160,4.67,Oakland Coliseum,2,2
5/7/2014,2014,PIT,SF,4,3,-157,-1.5,149,7,-110,-110,142,1.5,-169,4.28,PNC Park,7,1
5/7/2014,2014,ATL,STL,1,7,104,1.5,-170,6.5,-126,106,-114,-1.5,150,3.19,Turner Field,8,-6
5/7/2014,2014,BAL,TB,4,3,114,1.5,-200,8,100,-120,-124,-1.5,170,3.74,Tropicana Field,7,1
5/7/2014,2014,COL,TEX,9,2,113,1.5,-190,9.5,-110,-110,-123,-1.5,160,4.46,Rangers Ballpark,11,7
5/7/2014,2014,PHI,TOR,0,10,-102,1.5,-215,8,-110,-110,-108,-1.5,185,4.04,Rogers Centre,10,-10
5/7/2014,2014,LAD,WSH,2,3,125,1.5,-180,6.5,-120,100,-140,-1.5,160,2.89,Nationals Park,5,-1
5/8/2014,2014,TB,BAL,1,3,-173,-1.5,125,7,-125,105,153,1.5,-145,4.44,Tropicana Field,4,-2
5/8/2014,2014,CWS,CHC,5,12,-120,-1.5,170,9,-115,-105,110,1.5,-200,4.91,Guaranteed Rate Field,17,-7
5/8/2014,2014,MIN,CLE,4,9,150,1.5,-140,8.5,-118,-102,-170,-1.5,120,3.4,Progressive Field,13,-5
5/8/2014,2014,TEX,COL,5,0,-129,-1.5,155,9,100,-120,119,1.5,-175,5.07,Rangers Ballpark,5,5
5/8/2014,2014,CHC,CWS,12,5,110,1.5,-200,9,-115,-105,-120,-1.5,170,4.29,Guaranteed Rate Field,17,7
5/8/2014,2014,HOU,DET,6,2,171,1.5,-125,9,-110,-110,-191,-1.5,105,3.32,Comerica Park,8,4
5/8/2014,2014,DET,HOU,2,6,-191,-1.5,105,9,-110,-110,171,1.5,-125,5.91,Comerica Park,8,-4
5/8/2014,2014,SEA,KC,1,0,-122,-1.5,175,6.5,-125,105,112,1.5,-205,3.57,T-Mobile Park,1,1
5/8/2014,2014,SF,LAD,3,1,133,1.5,-172,7,-115,-105,-148,-1.5,151,3,Dodger Stadium,4,2
5/8/2014,2014,SD,MIA,1,3,-155,-1.5,145,7,110,-130,140,1.5,-165,4.25,PETCO Park,4,-2
5/8/2014,2014,CLE,MIN,9,4,-170,-1.5,120,8.5,-118,-102,150,1.5,-140,5.35,Progressive Field,13,5
5/8/2014,2014,TOR,PHI,12,6,-150,-1.5,145,9,-105,-115,135,1.5,-165,5.4,Rogers Centre,18,6
5/8/2014,2014,MIA,SD,3,1,140,1.5,-165,7,110,-130,-155,-1.5,145,2.92,PETCO Park,4,2
5/8/2014,2014,KC,SEA,0,1,112,1.5,-205,6.5,-125,105,-122,-1.5,175,3.07,T-Mobile Park,1,-1
5/8/2014,2014,LAD,SF,1,3,-148,-1.5,151,7,-115,-105,133,1.5,-172,4.18,Dodger Stadium,4,-2
5/8/2014,2014,BAL,TB,3,1,153,1.5,-145,7,-125,105,-173,-1.5,125,2.77,Tropicana Field,4,2
5/8/2014,2014,COL,TEX,0,5,119,1.5,-175,9,100,-120,-129,-1.5,155,4.11,Rangers Ballpark,5,-5
5/8/2014,2014,PHI,TOR,6,12,135,1.5,-165,9,-105,-115,-150,-1.5,145,3.83,Rogers Centre,18,-6
5/9/2014,2014,CWS,ARI,9,3,119,1.5,-145,9,-110,-110,-134,-1.5,125,4.11,Guaranteed Rate Field,12,6
5/9/2014,2014,CHC,ATL,2,3,157,1.5,-150,6.5,-120,100,-177,-1.5,130,2.53,Turner Field,5,-1
5/9/2014,2014,HOU,BAL,3,4,147,1.5,-150,8.5,100,-120,-162,-1.5,130,3.44,Camden Yards,7,-1
5/9/2014,2014,TEX,BOS,8,0,-165,-1.5,130,8.5,-116,-104,150,1.5,-150,5.29,Rangers Ballpark,8,8
5/9/2014,2014,ATL,CHC,3,2,-177,-1.5,130,6.5,-120,100,157,1.5,-150,4.15,Turner Field,5,1
5/9/2014,2014,COL,CIN,3,4,154,1.5,-150,7,-130,110,-169,-1.5,130,2.76,Great American Ballpark,7,-1
5/9/2014,2014,TB,CLE,3,6,-117,-1.5,180,7.5,-105,-115,107,1.5,-210,4.04,Tropicana Field,9,-3
5/9/2014,2014,CIN,COL,4,3,-169,-1.5,130,7,-130,110,154,1.5,-150,4.4,Great American Ballpark,7,1
5/9/2014,2014,ARI,CWS,3,9,-134,-1.5,125,9,-110,-110,119,1.5,-145,5.15,Guaranteed Rate Field,12,-6
5/9/2014,2014,MIN,DET,2,1,190,1.5,-120,8.5,-116,-104,-220,-1.5,100,2.93,Comerica Park,3,1
5/9/2014,2014,BAL,HOU,4,3,-162,-1.5,130,8.5,100,-120,147,1.5,-150,5.26,Camden Yards,7,1
5/9/2014,2014,SEA,KC,1,6,100,1.5,-170,7,-115,-105,-110,-1.5,150,3.5,T-Mobile Park,7,-5
5/9/2014,2014,TOR,LAA,3,4,101,1.5,-165,10,-105,-115,-111,-1.5,145,4.98,Rogers Centre,7,-1
5/9/2014,2014,SF,LAD,3,1,-131,-1.5,130,7,-105,-115,116,1.5,-150,3.97,Dodger Stadium,4,2
5/9/2014,2014,SD,MIA,10,1,125,1.5,-150,5.5,-120,100,-140,-1.5,130,2.44,PETCO Park,11,9
5/9/2014,2014,NYY,MIL,5,3,-130,-1.5,125,7.5,100,-120,115,1.5,-145,4.24,Miller Park,8,2
5/9/2014,2014,DET,MIN,1,2,-220,-1.5,100,8.5,-116,-104,190,1.5,-120,5.84,Comerica Park,3,-1
5/9/2014,2014,PHI,NYM,3,2,112,1.5,-205,7,100,-120,-122,-1.5,175,3.3,Citi Field,5,1
5/9/2014,2014,MIL,NYY,3,5,115,1.5,-145,7.5,100,-120,-130,-1.5,125,3.49,Miller Park,8,-2
5/9/2014,2014,WSH,OAK,0,8,118,1.5,-200,7,-125,105,-128,-1.5,170,3.21,Oakland Coliseum,8,-8
5/9/2014,2014,NYM,PHI,2,3,-122,-1.5,175,7,100,-120,112,1.5,-205,3.85,Citi Field,5,-1
5/9/2014,2014,STL,PIT,4,6,-119,-1.5,140,7,-115,-105,109,1.5,-160,3.8,PNC Park,10,-2
5/9/2014,2014,MIA,SD,1,10,-140,-1.5,130,5.5,-120,100,125,1.5,-150,3.21,PETCO Park,11,-9
5/9/2014,2014,KC,SEA,6,1,-110,-1.5,150,7,-115,-105,100,1.5,-170,3.67,T-Mobile Park,7,5
5/9/2014,2014,LAD,SF,1,3,116,1.5,-150,7,-105,-115,-131,-1.5,130,3.24,Dodger Stadium,4,-2
5/9/2014,2014,PIT,STL,6,4,109,1.5,-160,7,-115,-105,-119,-1.5,140,3.35,PNC Park,10,2
5/9/2014,2014,CLE,TB,6,3,107,1.5,-210,7.5,-105,-115,-117,-1.5,180,3.62,Tropicana Field,9,3
5/9/2014,2014,BOS,TEX,0,8,150,1.5,-150,8.5,-116,-104,-165,-1.5,130,3.4,Rangers Ballpark,8,-8
5/9/2014,2014,LAA,TOR,4,3,-111,-1.5,145,10,-105,-115,101,1.5,-165,5.26,Rogers Centre,7,1
5/9/2014,2014,OAK,WSH,8,0,-128,-1.5,170,7,-125,105,118,1.5,-200,3.93,Oakland Coliseum,8,8
5/10/2014,2014,CWS,ARI,3,4,-117,-1.5,160,8.5,-108,-112,107,1.5,-190,4.58,Guaranteed Rate Field,7,-1
5/10/2014,2014,CHC,ATL,0,2,148,1.5,-165,7,110,-130,-163,-1.5,145,2.82,Turner Field,2,-2
5/10/2014,2014,HOU,BAL,4,5,131,1.5,-155,8.5,-115,-105,-146,-1.5,135,3.68,Camden Yards,9,-1
5/10/2014,2014,TEX,BOS,3,8,119,1.5,-145,9,105,-125,-129,-1.5,125,4.11,Rangers Ballpark,11,-5
5/10/2014,2014,ATL,CHC,2,0,-163,-1.5,145,7,110,-130,148,1.5,-165,4.34,Turner Field,2,2
5/10/2014,2014,COL,CIN,11,2,105,1.5,-205,8,100,-120,-115,-1.5,175,3.9,Great American Ballpark,13,9
5/10/2014,2014,TB,CLE,7,1,-126,-1.5,170,8,100,-120,116,1.5,-200,4.46,Tropicana Field,8,6
5/10/2014,2014,CIN,COL,2,11,-115,-1.5,175,8,100,-120,105,1.5,-205,4.28,Great American Ballpark,13,-9
5/10/2014,2014,ARI,CWS,4,3,107,1.5,-190,8.5,-108,-112,-117,-1.5,160,4.11,Guaranteed Rate Field,7,1
5/10/2014,2014,MIN,DET,3,9,235,1.5,105,8,-110,-110,-275,-1.5,-125,2.39,Comerica Park,12,-6
5/10/2014,2014,BAL,HOU,5,4,-146,-1.5,135,8.5,-115,-105,131,1.5,-155,5.04,Camden Yards,9,1
5/10/2014,2014,SEA,KC,3,1,126,1.5,-145,6.5,-120,100,-141,-1.5,125,2.88,T-Mobile Park,4,2
5/10/2014,2014,TOR,LAA,3,5,-105,-1.5,180,10,105,-125,-105,1.5,-210,5.12,Rogers Centre,8,-2
5/10/2014,2014,SF,LAD,2,6,143,1.5,-165,7,105,-125,-158,-1.5,145,2.88,Dodger Stadium,8,-4
5/10/2014,2014,SD,MIA,9,3,103,1.5,-180,6.5,-105,-115,-113,-1.5,160,3.2,PETCO Park,12,6
5/10/2014,2014,NYY,MIL,4,5,112,1.5,-200,7.5,-110,-110,-122,-1.5,170,3.54,Miller Park,9,-1
5/10/2014,2014,DET,MIN,9,3,-275,-1.5,-125,8,-110,-110,235,1.5,105,5.87,Comerica Park,12,6
5/10/2014,2014,PHI,NYM,5,4,116,1.5,-195,7,-115,-105,-126,-1.5,165,3.24,Citi Field,9,1
5/10/2014,2014,MIL,NYY,5,4,-122,-1.5,170,7.5,-110,-110,112,1.5,-200,4.12,Miller Park,9,1
5/10/2014,2014,WSH,OAK,3,4,155,1.5,-150,7,105,-125,-175,-1.5,130,2.75,Oakland Coliseum,7,-1
5/10/2014,2014,NYM,PHI,4,5,-126,-1.5,165,7,-115,-105,116,1.5,-195,3.9,Citi Field,9,-1
5/10/2014,2014,STL,PIT,3,4,-122,-1.5,140,7,-125,105,112,1.5,-160,3.85,PNC Park,7,-1
5/10/2014,2014,MIA,SD,3,9,-113,-1.5,160,6.5,-105,-115,103,1.5,-180,3.45,PETCO Park,12,-6
5/10/2014,2014,KC,SEA,1,3,-141,-1.5,125,6.5,-120,100,126,1.5,-145,3.8,T-Mobile Park,4,-2
5/10/2014,2014,LAD,SF,6,2,-158,-1.5,145,7,105,-125,143,1.5,-165,4.29,Dodger Stadium,8,4
5/10/2014,2014,PIT,STL,4,3,112,1.5,-160,7,-125,105,-122,-1.5,140,3.3,PNC Park,7,1
5/10/2014,2014,CLE,TB,1,7,116,1.5,-200,8,100,-120,-126,-1.5,170,3.7,Tropicana Field,8,-6
5/10/2014,2014,BOS,TEX,8,3,-129,-1.5,125,9,105,-125,119,1.5,-145,5.07,Rangers Ballpark,11,5
5/10/2014,2014,LAA,TOR,5,3,-105,1.5,-210,10,105,-125,-105,-1.5,180,5.12,Rogers Centre,8,2
5/10/2014,2014,OAK,WSH,4,3,-175,-1.5,130,7,105,-125,155,1.5,-150,4.45,Oakland Coliseum,7,1
5/11/2014,2014,CWS,ARI,1,5,-104,1.5,-170,9,-120,100,-106,-1.5,150,4.59,Guaranteed Rate Field,6,-4
5/11/2014,2014,CHC,ATL,2,5,135,1.5,-165,7,-120,100,-150,-1.5,145,2.98,Turner Field,7,-3
5/11/2014,2014,HOU,BAL,5,2,163,1.5,-140,8.5,-115,-105,-183,-1.5,120,3.23,Camden Yards,7,3
5/11/2014,2014,TEX,BOS,2,5,-102,1.5,-160,9.5,100,-120,-108,-1.5,140,4.8,Rangers Ballpark,7,-3
5/11/2014,2014,ATL,CHC,5,2,-150,-1.5,145,7,-120,100,135,1.5,-165,4.2,Turner Field,7,3
5/11/2014,2014,COL,CIN,1,4,118,1.5,-195,7.5,-110,-110,-128,-1.5,165,3.44,Great American Ballpark,5,-3
5/11/2014,2014,TB,CLE,5,6,-140,-1.5,160,7.5,-105,-115,125,1.5,-180,4.38,Tropicana Field,11,-1
5/11/2014,2014,CIN,COL,4,1,-128,-1.5,165,7.5,-110,-110,118,1.5,-195,4.21,Great American Ballpark,5,3
5/11/2014,2014,ARI,CWS,5,1,-106,-1.5,150,9,-120,100,-104,1.5,-170,4.63,Guaranteed Rate Field,6,4
5/11/2014,2014,MIN,DET,4,3,140,1.5,-155,9.5,-105,-115,-155,-1.5,135,3.96,Comerica Park,7,1
5/11/2014,2014,BAL,HOU,2,5,-183,-1.5,120,8.5,-115,-105,163,1.5,-140,5.5,Camden Yards,7,-3
5/11/2014,2014,SEA,KC,7,9,-140,-1.5,160,7,105,-125,125,1.5,-190,4.08,T-Mobile Park,16,-2
5/11/2014,2014,TOR,LAA,3,9,-128,-1.5,165,9,-115,-105,118,1.5,-185,5.05,Rogers Centre,12,-6
5/11/2014,2014,SF,LAD,7,4,153,1.5,-150,6,-120,100,-173,-1.5,130,2.37,Dodger Stadium,11,3
5/11/2014,2014,SD,MIA,5,4,-127,-1.5,180,7,105,-125,117,1.5,-210,3.92,PETCO Park,9,1
5/11/2014,2014,NYY,MIL,5,6,-102,1.5,-215,7.5,100,-120,-108,-1.5,185,3.79,Miller Park,11,-1
5/11/2014,2014,DET,MIN,3,4,-155,-1.5,135,9.5,-105,-115,140,1.5,-155,5.77,Comerica Park,7,-1
5/11/2014,2014,PHI,NYM,4,5,116,1.5,-210,6.5,-110,-110,-126,-1.5,180,3.01,Citi Field,9,-1
5/11/2014,2014,MIL,NYY,6,5,-108,-1.5,185,7.5,100,-120,-102,1.5,-215,3.89,Miller Park,11,1
5/11/2014,2014,WSH,OAK,1,9,125,1.5,-190,7,-125,105,-140,-1.5,160,3.11,Oakland Coliseum,10,-8
5/11/2014,2014,NYM,PHI,5,4,-126,-1.5,180,6.5,-110,-110,116,1.5,-210,3.62,Citi Field,9,1
5/11/2014,2014,STL,PIT,6,5,-115,-1.5,140,7.5,-110,-110,105,1.5,-160,4.01,PNC Park,11,1
5/11/2014,2014,MIA,SD,4,5,117,1.5,-210,7,105,-125,-127,-1.5,180,3.23,PETCO Park,9,-1
5/11/2014,2014,KC,SEA,9,7,125,1.5,-190,7,105,-125,-140,-1.5,160,3.11,T-Mobile Park,16,2
5/11/2014,2014,LAD,SF,4,7,-173,-1.5,130,6,-120,100,153,1.5,-150,3.8,Dodger Stadium,11,-3
5/11/2014,2014,PIT,STL,5,6,105,1.5,-160,7.5,-110,-110,-115,-1.5,140,3.66,PNC Park,11,-1
5/11/2014,2014,CLE,TB,6,5,125,1.5,-180,7.5,-105,-115,-140,-1.5,160,3.33,Tropicana Field,11,1
5/11/2014,2014,BOS,TEX,5,2,-108,-1.5,140,9.5,100,-120,-102,1.5,-160,4.93,Rangers Ballpark,7,3
5/11/2014,2014,LAA,TOR,9,3,118,1.5,-185,9,-115,-105,-128,-1.5,165,4.13,Rogers Centre,12,6
5/11/2014,2014,OAK,WSH,9,1,-140,-1.5,160,7,-125,105,125,1.5,-190,4.08,Oakland Coliseum,10,8
5/12/2014,2014,WSH,ARI,6,5,-117,-1.5,145,8,-105,-115,107,1.5,-165,4.31,Chase Field,11,1
5/12/2014,2014,SF,ATL,4,2,-105,1.5,-180,7,-105,-115,-105,-1.5,160,3.59,AT&T Park,6,2
5/12/2014,2014,DET,BAL,4,1,-105,1.5,-215,9,105,-125,-105,-1.5,185,4.61,Camden Yards,5,3
5/12/2014,2014,STL,CHC,5,17,-173,-1.5,130,7.5,-120,100,153,1.5,-150,4.75,Busch Stadium,22,-12
5/12/2014,2014,OAK,CWS,5,4,-210,-1.5,-101,8,-115,-105,180,1.5,-119,5.42,Oakland Coliseum,9,1
5/12/2014,2014,BAL,DET,1,4,-105,-1.5,185,9,105,-125,-105,1.5,-215,4.61,Camden Yards,5,-3
5/12/2014,2014,TEX,HOU,4,0,-140,-1.5,120,9,-120,100,125,1.5,-140,5.25,Minute Maid Park,4,4
5/12/2014,2014,TOR,LAA,7,3,-113,-1.5,175,9,-125,105,103,1.5,-205,4.77,Rogers Centre,10,4
5/12/2014,2014,MIA,LAD,5,6,130,1.5,-175,7,-142,122,-145,-1.5,155,3.04,Dodger Stadium,11,-1
5/12/2014,2014,LAD,MIA,6,5,-145,-1.5,155,7,-142,122,130,1.5,-175,4.14,Dodger Stadium,11,1
5/12/2014,2014,NYY,NYM,7,9,-173,-1.5,125,8.5,-123,103,153,1.5,-145,5.39,Yankee Stadium,16,-2
5/12/2014,2014,NYM,NYY,9,7,153,1.5,-145,8.5,-123,103,-173,-1.5,125,3.36,Yankee Stadium,16,2
5/12/2014,2014,CWS,OAK,4,5,180,1.5,-119,8,-115,-105,-210,-1.5,-101,2.86,Oakland Coliseum,9,-1
5/12/2014,2014,TB,SEA,5,12,141,1.5,-160,7,105,-125,-156,-1.5,140,2.9,T-Mobile Park,17,-7
5/12/2014,2014,ATL,SF,2,4,-105,-1.5,160,7,-105,-115,-105,1.5,-180,3.59,AT&T Park,6,-2
5/12/2014,2014,CHC,STL,17,5,153,1.5,-150,7.5,-120,100,-173,-1.5,130,2.96,Busch Stadium,22,12
5/12/2014,2014,SEA,TB,12,5,-156,-1.5,140,7,105,-125,141,1.5,-160,4.27,T-Mobile Park,17,7
5/12/2014,2014,HOU,TEX,0,4,125,1.5,-140,9,-120,100,-140,-1.5,120,4,Minute Maid Park,4,-4
5/12/2014,2014,LAA,TOR,3,7,103,1.5,-205,9,-125,105,-113,-1.5,175,4.43,Rogers Centre,10,-4
5/12/2014,2014,ARI,WSH,5,6,107,1.5,-165,8,-105,-115,-117,-1.5,145,3.86,Chase Field,11,-1
5/13/2014,2014,WSH,ARI,1,3,-134,-1.5,125,8,100,-120,119,1.5,-145,4.58,Chase Field,4,-2
5/13/2014,2014,SF,ATL,0,5,100,1.5,-180,7,-120,100,-110,-1.5,160,3.5,AT&T Park,5,-5
5/13/2014,2014,DET,BAL,4,1,-108,-1.5,150,9,105,-125,-102,1.5,-170,4.67,Camden Yards,5,3
5/13/2014,2014,MIN,BOS,8,6,119,1.5,-150,7.5,-110,-110,-134,-1.5,130,3.42,Target Field,14,2
5/13/2014,2014,STL,CHC,4,3,-230,-1.5,-110,6.5,-125,105,200,1.5,-110,4.53,Busch Stadium,7,1
5/13/2014,2014,SD,CIN,2,1,102,1.5,-215,7,-120,100,-112,-1.5,185,3.47,Great American Ballpark,3,1
5/13/2014,2014,TOR,CLE,5,4,-133,-1.5,160,9,-110,-110,118,1.5,-190,5.14,Rogers Centre,9,1
5/13/2014,2014,KC,COL,5,1,-150,-1.5,150,7,-120,100,135,1.5,-170,4.2,Kauffman Stadium,6,4
5/13/2014,2014,OAK,CWS,11,0,-195,-1.5,110,8.5,-120,100,175,1.5,-130,5.62,Oakland Coliseum,11,11
5/13/2014,2014,BAL,DET,1,4,-102,1.5,-170,9,105,-125,-108,-1.5,150,4.54,Camden Yards,5,-3
5/13/2014,2014,TEX,HOU,0,8,-114,-1.5,145,8,-115,-105,104,1.5,-165,4.26,Minute Maid Park,8,-8
5/13/2014,2014,COL,KC,1,5,135,1.5,-170,7,-120,100,-150,-1.5,150,2.98,Kauffman Stadium,6,-4
5/13/2014,2014,PHI,LAA,3,4,-180,-1.5,125,7.5,-110,-110,160,1.5,-145,4.82,Citizens Bank Park,7,-1
5/13/2014,2014,MIA,LAD,1,7,145,1.5,-160,8,-105,-115,-160,-1.5,140,3.27,Dodger Stadium,8,-6
5/13/2014,2014,LAD,MIA,7,1,-160,-1.5,140,8,-105,-115,145,1.5,-160,4.92,Dodger Stadium,8,6
5/13/2014,2014,PIT,MIL,2,5,103,1.5,-220,7.5,100,-120,-113,-1.5,190,3.69,Miller Park,7,-3
5/13/2014,2014,BOS,MIN,6,8,-134,-1.5,130,7.5,-110,-110,119,1.5,-150,4.29,Target Field,14,-2
5/13/2014,2014,NYY,NYM,7,12,-141,-1.5,155,8.5,-113,-107,126,1.5,-175,4.97,Yankee Stadium,19,-5
5/13/2014,2014,NYM,NYY,12,7,126,1.5,-175,8.5,-113,-107,-141,-1.5,155,3.76,Yankee Stadium,19,5
5/13/2014,2014,CWS,OAK,0,11,175,1.5,-130,8.5,-120,100,-195,-1.5,110,3.09,Oakland Coliseum,11,-11
5/13/2014,2014,LAA,PHI,4,3,160,1.5,-145,7.5,-110,-110,-180,-1.5,125,2.88,Citizens Bank Park,7,1
5/13/2014,2014,MIL,PIT,5,2,-113,-1.5,190,7.5,100,-120,103,1.5,-220,3.98,Miller Park,7,3
5/13/2014,2014,CIN,SD,1,2,-112,-1.5,185,7,-120,100,102,1.5,-215,3.7,Great American Ballpark,3,-1
5/13/2014,2014,TB,SEA,2,1,-122,-1.5,140,6.5,-115,-105,112,1.5,-160,3.57,T-Mobile Park,3,1
5/13/2014,2014,ATL,SF,5,0,-110,-1.5,160,7,-120,100,100,1.5,-180,3.67,AT&T Park,5,5
5/13/2014,2014,CHC,STL,3,4,200,1.5,-110,6.5,-125,105,-230,-1.5,-110,2.17,Busch Stadium,7,-1
5/13/2014,2014,SEA,TB,1,2,112,1.5,-160,6.5,-115,-105,-122,-1.5,140,3.07,T-Mobile Park,3,-1
5/13/2014,2014,HOU,TEX,8,0,104,1.5,-165,8,-115,-105,-114,-1.5,145,3.92,Minute Maid Park,8,8
5/13/2014,2014,CLE,TOR,4,5,118,1.5,-190,9,-110,-110,-133,-1.5,160,4.13,Rogers Centre,9,-1
5/13/2014,2014,ARI,WSH,3,1,119,1.5,-145,8,100,-120,-134,-1.5,125,3.65,Chase Field,4,2
5/14/2014,2014,WSH,ARI,5,1,111,1.5,-205,7.5,-105,-115,-121,-1.5,175,3.55,Chase Field,6,4
5/14/2014,2014,SF,ATL,10,4,-133,-1.5,175,7,105,-125,118,1.5,-205,4,AT&T Park,14,6
5/14/2014,2014,DET,BAL,7,5,-113,-1.5,140,7.5,-110,-110,103,1.5,-160,3.98,Camden Yards,12,2
5/14/2014,2014,MIN,BOS,4,9,117,1.5,-145,8.5,100,-120,-127,-1.5,126,3.92,Target Field,13,-5
5/14/2014,2014,TOR,CLE,4,15,-108,-1.5,180,9,-125,105,-102,1.5,-210,4.67,Rogers Centre,19,-11
5/14/2014,2014,KC,COL,3,2,-130,-1.5,160,7.5,105,-125,115,1.5,-190,4.24,Kauffman Stadium,5,1
5/14/2014,2014,OAK,CWS,2,4,-200,-1.5,100,9,-105,-115,170,1.5,-120,6,Oakland Coliseum,6,-2
5/14/2014,2014,BAL,DET,5,7,103,1.5,-160,7.5,-110,-110,-113,-1.5,140,3.69,Camden Yards,12,-2
5/14/2014,2014,TEX,HOU,4,5,-116,-1.5,140,8.5,-105,-115,106,1.5,-160,4.56,Minute Maid Park,9,-1
5/14/2014,2014,COL,KC,2,3,115,1.5,-190,7.5,105,-125,-130,-1.5,160,3.49,Kauffman Stadium,5,-1
5/14/2014,2014,PHI,LAA,0,3,-101,1.5,-165,7.5,-110,-110,-109,-1.5,145,3.77,Citizens Bank Park,3,-3
5/14/2014,2014,MIA,LAD,13,3,142,1.5,-165,8.5,100,-120,-157,-1.5,145,3.51,Dodger Stadium,16,10
5/14/2014,2014,LAD,MIA,3,13,-157,-1.5,145,8.5,100,-120,142,1.5,-165,5.19,Dodger Stadium,16,-10
5/14/2014,2014,PIT,MIL,4,1,107,1.5,-205,7.5,-105,-115,-117,-1.5,175,3.62,Miller Park,5,3
5/14/2014,2014,BOS,MIN,9,4,-127,-1.5,126,8.5,100,-120,117,1.5,-145,4.76,Target Field,13,5
5/14/2014,2014,NYY,NYM,4,0,-155,-1.5,115,6.5,105,-125,140,1.5,-135,3.95,Citi Field,4,4
5/14/2014,2014,NYM,NYY,0,4,140,1.5,-135,6.5,105,-125,-155,-1.5,115,2.71,Citi Field,4,-4
5/14/2014,2014,CWS,OAK,4,2,170,1.5,-120,9,-105,-115,-200,-1.5,100,3.33,Oakland Coliseum,6,2
5/14/2014,2014,LAA,PHI,3,0,-109,-1.5,145,7.5,-110,-110,-101,1.5,-165,3.91,Citizens Bank Park,3,3
5/14/2014,2014,MIL,PIT,1,4,-117,-1.5,175,7.5,-105,-115,107,1.5,-205,4.04,Miller Park,5,-3
5/14/2014,2014,TB,SEA,2,0,-117,-1.5,145,8,-110,-110,107,1.5,-165,4.31,T-Mobile Park,2,2
5/14/2014,2014,ATL,SF,4,10,118,1.5,-205,7,105,-125,-133,-1.5,175,3.21,AT&T Park,14,-6
5/14/2014,2014,SEA,TB,0,2,107,1.5,-165,8,-110,-110,-117,-1.5,145,3.86,T-Mobile Park,2,-2
5/14/2014,2014,HOU,TEX,5,4,106,1.5,-160,8.5,-105,-115,-116,-1.5,140,4.13,Minute Maid Park,9,1
5/14/2014,2014,CLE,TOR,15,4,-102,1.5,-210,9,-125,105,-108,-1.5,180,4.54,Rogers Centre,19,11
5/14/2014,2014,ARI,WSH,1,5,-121,-1.5,175,7.5,-105,-115,111,1.5,-205,4.11,Chase Field,6,-4
5/15/2014,2014,KC,BAL,1,2,-140,-1.5,160,7,105,-125,125,1.5,-190,4.08,Kauffman Stadium,3,-1
5/15/2014,2014,MIN,BOS,4,3,111,1.5,-155,7.5,-110,-110,-121,-1.5,135,3.55,Target Field,7,1
5/15/2014,2014,STL,CHC,5,3,-195,-1.5,120,6.5,-110,-110,175,1.5,-140,4.3,Busch Stadium,8,2
5/15/2014,2014,SD,CIN,0,5,125,1.5,-180,6.5,-110,-110,-140,-1.5,160,2.89,Great American Ballpark,5,-5
5/15/2014,2014,SD,CIN,6,1,-115,-1.5,140,7,-125,105,105,1.5,-160,3.74,Great American Ballpark,7,5
5/15/2014,2014,TOR,CLE,4,2,-105,-1.5,185,9.5,-105,-115,-105,1.5,-215,4.87,Rogers Centre,6,2
5/15/2014,2014,BAL,KC,2,1,125,1.5,-190,7,105,-125,-140,-1.5,160,3.11,Kauffman Stadium,3,1
5/15/2014,2014,TB,LAA,5,6,131,1.5,-170,9,-105,-115,-146,-1.5,150,3.9,Angel Stadium,11,-1
5/15/2014,2014,SF,MIA,6,4,-146,-1.5,160,7,104,-124,131,1.5,-190,4.15,AT&T Park,10,2
5/15/2014,2014,PIT,MIL,3,4,137,1.5,-160,8,-120,100,-152,-1.5,140,3.38,Miller Park,7,-1
5/15/2014,2014,BOS,MIN,3,4,-121,-1.5,135,7.5,-110,-110,111,1.5,-155,4.11,Target Field,7,-1
5/15/2014,2014,NYY,NYM,1,0,-114,-1.5,145,7,-120,100,104,1.5,-165,3.73,Citi Field,1,1
5/15/2014,2014,NYM,NYY,0,1,104,1.5,-165,7,-120,100,-114,-1.5,145,3.43,Citi Field,1,-1
5/15/2014,2014,MIL,PIT,4,3,-152,-1.5,140,8,-120,100,137,1.5,-160,4.83,Miller Park,7,1
5/15/2014,2014,CIN,SD,5,0,-140,-1.5,160,6.5,-110,-110,125,1.5,-180,3.79,Great American Ballpark,5,5
5/15/2014,2014,CIN,SD,1,6,105,1.5,-160,7,-125,105,-115,-1.5,140,3.41,Great American Ballpark,7,-5
5/15/2014,2014,MIA,SF,4,6,131,1.5,-190,7,104,-124,-146,-1.5,160,3.03,AT&T Park,10,-2
5/15/2014,2014,CHC,STL,3,5,175,1.5,-140,6.5,-110,-110,-195,-1.5,120,2.36,Busch Stadium,8,-2
5/15/2014,2014,LAA,TB,6,5,-146,-1.5,150,9,-105,-115,131,1.5,-170,5.34,Angel Stadium,11,1
5/15/2014,2014,CLE,TOR,2,4,-105,1.5,-215,9.5,-105,-115,-105,-1.5,185,4.87,Rogers Centre,6,-2
5/16/2014,2014,LAD,ARI,7,0,-146,-1.5,110,8.5,-120,100,131,1.5,-130,5.04,Chase Field,7,7
5/16/2014,2014,STL,ATL,5,2,-110,-1.5,185,6.5,-110,-110,100,1.5,-215,3.4,Busch Stadium,7,3
5/16/2014,2014,KC,BAL,0,4,-101,1.5,-170,7,-125,105,-109,-1.5,150,3.52,Kauffman Stadium,4,-4
5/16/2014,2014,DET,BOS,1,0,-105,-1.5,150,8,-115,-105,-105,1.5,-170,4.1,Fenway Park,1,1
5/16/2014,2014,MIL,CHC,4,3,116,1.5,-210,6.5,-110,-110,-126,-1.5,180,3.01,Wrigley Field,7,1
5/16/2014,2014,PHI,CIN,0,3,-133,-1.5,160,8,100,-120,118,1.5,-190,4.57,Citizens Bank Park,3,-3
5/16/2014,2014,OAK,CLE,11,1,-134,-1.5,120,7.5,105,-125,119,1.5,-140,4.29,Progressive Field,12,10
5/16/2014,2014,SD,COL,1,3,145,1.5,-145,9.5,-105,-115,-160,-1.5,125,3.88,Coors Field,4,-2
5/16/2014,2014,HOU,CWS,2,7,-106,-1.5,190,8,-120,100,-104,1.5,-220,4.12,Minute Maid Park,9,-5
5/16/2014,2014,BOS,DET,0,1,-105,1.5,-170,8,-115,-105,-105,-1.5,150,4.1,Fenway Park,1,-1
5/16/2014,2014,CWS,HOU,7,2,-104,1.5,-220,8,-120,100,-106,-1.5,190,4.08,Minute Maid Park,9,5
5/16/2014,2014,BAL,KC,4,0,-109,-1.5,150,7,-125,105,-101,1.5,-170,3.65,Kauffman Stadium,4,4
5/16/2014,2014,TB,LAA,3,0,126,1.5,-175,8.5,100,-120,-141,-1.5,155,3.76,Angel Stadium,3,3
5/16/2014,2014,ARI,LAD,0,7,131,1.5,-130,8.5,-120,100,-146,-1.5,110,3.68,Chase Field,7,-7
5/16/2014,2014,SF,MIA,5,7,-143,-1.5,160,7,-125,105,128,1.5,-190,4.12,AT&T Park,12,-2
5/16/2014,2014,CHC,MIL,3,4,-126,-1.5,180,6.5,-110,-110,116,1.5,-210,3.62,Wrigley Field,7,-1
5/16/2014,2014,SEA,MIN,4,5,-102,1.5,-210,8.5,-120,100,-108,-1.5,180,4.29,Target Field,9,-1
5/16/2014,2014,WSH,NYM,5,2,-146,-1.5,160,7.5,-110,-110,131,1.5,-190,4.45,Nationals Park,7,3
5/16/2014,2014,CLE,OAK,1,11,119,1.5,-140,7.5,105,-125,-134,-1.5,120,3.42,Progressive Field,12,-10
5/16/2014,2014,CIN,PHI,3,0,118,1.5,-190,8,100,-120,-133,-1.5,160,3.67,Citizens Bank Park,3,3
5/16/2014,2014,COL,SD,3,1,-160,-1.5,125,9.5,-105,-115,145,1.5,-145,5.85,Coors Field,4,2
5/16/2014,2014,MIN,SEA,5,4,-108,-1.5,180,8.5,-120,100,-102,1.5,-210,4.41,Target Field,9,1
5/16/2014,2014,MIA,SF,7,5,128,1.5,-190,7,-125,105,-143,-1.5,160,3.07,AT&T Park,12,2
5/16/2014,2014,ATL,STL,2,5,100,1.5,-215,6.5,-110,-110,-110,-1.5,185,3.25,Busch Stadium,7,-3
5/16/2014,2014,LAA,TB,0,3,-141,-1.5,155,8.5,100,-120,126,1.5,-175,4.97,Angel Stadium,3,-3
5/16/2014,2014,TOR,TEX,2,0,151,1.5,-140,8.5,-115,-105,-171,-1.5,120,3.39,Rangers Ballpark,2,2
5/16/2014,2014,TEX,TOR,0,2,-171,-1.5,120,8.5,-115,-105,151,1.5,-140,5.36,Rangers Ballpark,2,-2
5/16/2014,2014,NYM,WSH,2,5,131,1.5,-190,7.5,-110,-110,-146,-1.5,160,3.25,Nationals Park,7,-3
5/17/2014,2014,LAD,ARI,7,18,-179,-1.5,-110,8,100,-120,159,1.5,-110,5.13,Chase Field,25,-11
5/17/2014,2014,STL,ATL,4,1,-123,-1.5,180,7,-105,-115,113,1.5,-210,3.86,Busch Stadium,5,3
5/17/2014,2014,KC,BAL,1,0,-126,-1.5,175,7,-110,-110,116,1.5,-205,3.9,Kauffman Stadium,1,1
5/17/2014,2014,DET,BOS,6,1,125,1.5,-165,9,100,-120,-140,-1.5,145,4,Fenway Park,7,5
5/17/2014,2014,MIL,CHC,0,3,-117,-1.5,145,7.5,-105,-115,107,1.5,-165,4.04,Wrigley Field,3,-3
5/17/2014,2014,PHI,CIN,12,1,-144,-1.5,160,7,105,-125,129,1.5,-190,4.13,Citizens Bank Park,13,11
5/17/2014,2014,OAK,CLE,6,2,-141,-1.5,115,7.5,100,-120,126,1.5,-135,4.39,Progressive Field,8,4
5/17/2014,2014,SD,COL,8,5,119,1.5,-175,9.5,-110,-110,-129,-1.5,155,4.34,Coors Field,13,3
5/17/2014,2014,HOU,CWS,6,5,-116,-1.5,175,9,-110,-110,106,1.5,-205,4.83,Minute Maid Park,11,1
5/17/2014,2014,BOS,DET,1,6,-140,-1.5,145,9,100,-120,125,1.5,-165,5.25,Fenway Park,7,-5
5/17/2014,2014,CWS,HOU,5,6,106,1.5,-205,9,-110,-110,-116,-1.5,175,4.37,Minute Maid Park,11,-1
5/17/2014,2014,BAL,KC,0,1,116,1.5,-205,7,-110,-110,-126,-1.5,175,3.24,Kauffman Stadium,1,-1
5/17/2014,2014,TB,LAA,0,6,151,1.5,-145,8.5,-110,-110,-171,-1.5,125,3.39,Angel Stadium,6,-6
5/17/2014,2014,ARI,LAD,18,7,159,1.5,-110,8,100,-120,-179,-1.5,-110,3.09,Chase Field,25,11
5/17/2014,2014,SF,MIA,0,5,-145,-1.5,150,7.5,105,-125,130,1.5,-170,4.44,AT&T Park,5,-5
5/17/2014,2014,CHC,MIL,3,0,107,1.5,-165,7.5,-105,-115,-117,-1.5,145,3.62,Wrigley Field,3,3
5/17/2014,2014,SEA,MIN,3,4,-110,-1.5,150,8.5,-105,-115,100,1.5,-170,4.45,Target Field,7,-1
5/17/2014,2014,WSH,NYM,2,5,-152,-1.5,140,7,105,-125,137,1.5,-160,4.22,Nationals Park,7,-3
5/17/2014,2014,PIT,NYY,1,7,125,1.5,-175,9,-110,-110,-140,-1.5,155,4,Yankee Stadium,8,-6
5/17/2014,2014,CLE,OAK,2,6,126,1.5,-135,7.5,100,-120,-141,-1.5,115,3.32,Progressive Field,8,-4
5/17/2014,2014,CIN,PHI,1,12,129,1.5,-190,7,105,-125,-144,-1.5,160,3.06,Citizens Bank Park,13,-11
5/17/2014,2014,NYY,PIT,7,1,-140,-1.5,155,9,-110,-110,125,1.5,-175,5.25,Yankee Stadium,8,6
5/17/2014,2014,COL,SD,5,8,-129,-1.5,155,9.5,-110,-110,119,1.5,-175,5.35,Coors Field,13,-3
5/17/2014,2014,MIN,SEA,4,3,100,1.5,-170,8.5,-105,-115,-110,-1.5,150,4.25,Target Field,7,1
5/17/2014,2014,MIA,SF,5,0,130,1.5,-170,7.5,105,-125,-145,-1.5,150,3.26,AT&T Park,5,5
5/17/2014,2014,ATL,STL,1,4,113,1.5,-210,7,-105,-115,-123,-1.5,180,3.29,Busch Stadium,5,-3
5/17/2014,2014,LAA,TB,6,0,-171,-1.5,125,8.5,-110,-110,151,1.5,-145,5.36,Angel Stadium,6,6
5/17/2014,2014,TOR,TEX,4,2,-105,1.5,-210,9,-105,-115,-105,-1.5,180,4.61,Rangers Ballpark,6,2
5/17/2014,2014,TEX,TOR,2,4,-105,-1.5,180,9,-105,-115,-105,1.5,-210,4.61,Rangers Ballpark,6,-2
5/17/2014,2014,NYM,WSH,5,2,137,1.5,-160,7,105,-125,-152,-1.5,140,2.95,Nationals Park,7,3
5/18/2014,2014,LAD,ARI,3,5,-111,-1.5,140,9,105,-125,101,1.5,-160,4.73,Chase Field,8,-2
5/18/2014,2014,STL,ATL,5,6,-110,-1.5,190,7,102,-122,100,1.5,-220,3.67,Busch Stadium,11,-1
5/18/2014,2014,KC,BAL,8,6,-147,-1.5,155,7,105,-125,132,1.5,-175,4.17,Kauffman Stadium,14,2
5/18/2014,2014,DET,BOS,6,2,107,1.5,-200,8.5,-110,-110,-117,-1.5,170,4.11,Fenway Park,8,4
5/18/2014,2014,MIL,CHC,2,4,-119,-1.5,140,9,-110,-110,109,1.5,-160,4.89,Wrigley Field,6,-2
5/18/2014,2014,PHI,CIN,8,3,-140,-1.5,170,6.5,100,-120,125,1.5,-200,3.79,Citizens Bank Park,11,5
5/18/2014,2014,OAK,CLE,13,3,-115,-1.5,135,7,-125,105,105,1.5,-155,3.74,Progressive Field,16,10
5/18/2014,2014,SD,COL,6,8,160,1.5,-135,10.5,-120,100,-180,-1.5,115,4.04,Coors Field,14,-2
5/18/2014,2014,HOU,CWS,8,2,-127,-1.5,165,9.5,100,-120,117,1.5,-195,5.31,Minute Maid Park,10,6
5/18/2014,2014,BOS,DET,2,6,-117,-1.5,170,8.5,-110,-110,107,1.5,-200,4.58,Fenway Park,8,-4
5/18/2014,2014,CWS,HOU,2,8,117,1.5,-195,9.5,100,-120,-127,-1.5,165,4.38,Minute Maid Park,10,-6
5/18/2014,2014,BAL,KC,6,8,132,1.5,-175,7,105,-125,-147,-1.5,155,3.02,Kauffman Stadium,14,-2
5/18/2014,2014,TB,LAA,2,6,-124,-1.5,135,7.5,-120,100,114,1.5,-155,4.15,Angel Stadium,8,-4
5/18/2014,2014,ARI,LAD,5,3,101,1.5,-160,9,105,-125,-111,-1.5,140,4.48,Chase Field,8,2
5/18/2014,2014,SF,MIA,4,1,-165,-1.5,130,7.5,102,-122,150,1.5,-150,4.67,AT&T Park,5,3
5/18/2014,2014,CHC,MIL,4,2,109,1.5,-160,9,-110,-110,-119,-1.5,140,4.31,Wrigley Field,6,2
5/18/2014,2014,SEA,MIN,6,2,-157,-1.5,100,7.5,-115,-105,142,1.5,-120,4.58,Target Field,8,4
5/18/2014,2014,WSH,NYM,6,3,-170,-1.5,135,6.5,-123,103,150,1.5,-155,4.09,Nationals Park,9,3
5/18/2014,2014,PIT,NYY,3,4,142,1.5,-155,8.5,-118,-102,-157,-1.5,135,3.51,Yankee Stadium,7,-1
5/18/2014,2014,PIT,NYY,5,3,-127,-1.5,130,9,105,-125,117,1.5,-150,5.04,Yankee Stadium,8,2
5/18/2014,2014,CLE,OAK,3,13,105,1.5,-155,7,-125,105,-115,-1.5,135,3.41,Progressive Field,16,-10
5/18/2014,2014,CIN,PHI,3,8,125,1.5,-200,6.5,100,-120,-140,-1.5,170,2.89,Citizens Bank Park,11,-5
5/18/2014,2014,NYY,PIT,4,3,-157,-1.5,135,8.5,-118,-102,142,1.5,-155,5.19,Yankee Stadium,7,1
5/18/2014,2014,NYY,PIT,3,5,117,1.5,-150,9,105,-125,-127,-1.5,130,4.15,Yankee Stadium,8,-2
5/18/2014,2014,COL,SD,8,6,-180,-1.5,115,10.5,-120,100,160,1.5,-135,6.75,Coors Field,14,2
5/18/2014,2014,MIN,SEA,2,6,142,1.5,-120,7.5,-115,-105,-157,-1.5,100,3.1,Target Field,8,-4
5/18/2014,2014,MIA,SF,1,4,150,1.5,-150,7.5,102,-122,-165,-1.5,130,3,AT&T Park,5,-3
5/18/2014,2014,ATL,STL,6,5,100,1.5,-220,7,102,-122,-110,-1.5,190,3.5,Busch Stadium,11,1
5/18/2014,2014,LAA,TB,6,2,114,1.5,-155,7.5,-120,100,-124,-1.5,135,3.5,Angel Stadium,8,4
5/18/2014,2014,TOR,TEX,2,6,-121,-1.5,135,9,-125,105,111,1.5,-155,4.93,Rangers Ballpark,8,-4
5/18/2014,2014,TEX,TOR,6,2,111,1.5,-155,9,-125,105,-121,-1.5,135,4.27,Rangers Ballpark,8,4
5/18/2014,2014,NYM,WSH,3,6,150,1.5,-155,6.5,-123,103,-170,-1.5,135,2.6,Nationals Park,9,-3
5/19/2014,2014,MIL,ATL,3,9,109,1.5,-210,7,105,-125,-119,-1.5,180,3.35,Turner Field,12,-6
5/19/2014,2014,WSH,CIN,3,4,-175,-1.5,125,6.5,-103,-117,155,1.5,-145,4.14,Nationals Park,7,-1
5/19/2014,2014,DET,CLE,4,5,107,1.5,-210,7,-115,-105,-117,-1.5,180,3.38,Progressive Field,9,-1
5/19/2014,2014,KC,CWS,6,7,-200,-1.5,-101,8.5,-125,105,170,1.5,-119,5.67,Kauffman Stadium,13,-1
5/19/2014,2014,CLE,DET,5,4,-117,-1.5,180,7,-115,-105,107,1.5,-210,3.77,Progressive Field,9,1
5/19/2014,2014,LAA,HOU,2,5,-195,-1.5,105,7.5,105,-125,175,1.5,-125,4.96,Angel Stadium,7,-3
5/19/2014,2014,CWS,KC,7,6,170,1.5,-119,8.5,-125,105,-200,-1.5,-101,3.15,Kauffman Stadium,13,1
5/19/2014,2014,HOU,LAA,5,2,175,1.5,-125,7.5,105,-125,-195,-1.5,105,2.73,Angel Stadium,7,3
5/19/2014,2014,ATL,MIL,9,3,-119,-1.5,180,7,105,-125,109,1.5,-210,3.8,Turner Field,12,6
5/19/2014,2014,CIN,WSH,4,3,155,1.5,-145,6.5,-103,-117,-175,-1.5,125,2.55,Nationals Park,7,1
5/20/2014,2014,STL,ARI,5,0,-190,-1.5,115,7.5,100,-120,170,1.5,-135,4.91,Busch Stadium,5,5
5/20/2014,2014,MIL,ATL,0,5,125,1.5,-190,6.5,-115,-105,-140,-1.5,160,2.89,Turner Field,5,-5
5/20/2014,2014,PIT,BAL,2,9,-148,-1.5,155,7,-120,100,133,1.5,-175,4.18,PNC Park,11,-7
5/20/2014,2014,TOR,BOS,7,4,119,1.5,-160,9.5,-115,-105,-134,-1.5,141,4.34,Fenway Park,11,3
5/20/2014,2014,NYY,CHC,1,6,-172,-1.5,-105,8.5,-105,-115,152,1.5,-115,5.38,Wrigley Field,7,-5
5/20/2014,2014,WSH,CIN,9,4,-103,1.5,-175,6.5,105,-125,-107,-1.5,155,3.3,Nationals Park,13,5
5/20/2014,2014,DET,CLE,2,6,-126,-1.5,125,8,-105,-115,116,1.5,-145,4.46,Progressive Field,8,-4
5/20/2014,2014,SF,COL,4,5,-101,-1.5,150,9.5,-120,100,-109,1.5,-170,4.77,Coors Field,9,-1
5/20/2014,2014,KC,CWS,6,7,-175,-1.5,120,8.5,-115,-105,155,1.5,-140,5.41,Kauffman Stadium,13,-1
5/20/2014,2014,CLE,DET,6,2,116,1.5,-145,8,-105,-115,-126,-1.5,125,3.7,Progressive Field,8,4
5/20/2014,2014,LAA,HOU,9,3,-175,-1.5,120,8,-105,-115,155,1.5,-140,5.09,Angel Stadium,12,6
5/20/2014,2014,CWS,KC,7,6,155,1.5,-140,8.5,-115,-105,-175,-1.5,120,3.33,Kauffman Stadium,13,1
5/20/2014,2014,HOU,LAA,3,9,155,1.5,-140,8,-105,-115,-175,-1.5,120,3.14,Angel Stadium,12,-6
5/20/2014,2014,NYM,LAD,4,9,114,1.5,-150,7,-125,105,-124,-1.5,130,3.27,Citi Field,13,-5
5/20/2014,2014,PHI,MIA,6,5,105,1.5,-215,7.5,100,-120,-115,-1.5,185,3.66,Marlins Park,11,1
5/20/2014,2014,ATL,MIL,5,0,-140,-1.5,160,6.5,-115,-105,125,1.5,-190,3.79,Turner Field,5,5
5/20/2014,2014,SD,MIN,3,5,-182,-1.5,120,7,-110,-110,162,1.5,-140,4.52,PETCO Park,8,-2
5/20/2014,2014,LAD,NYM,9,4,-124,-1.5,130,7,-125,105,114,1.5,-150,3.88,Citi Field,13,5
5/20/2014,2014,CHC,NYY,6,1,152,1.5,-115,8.5,-105,-115,-172,-1.5,-105,3.37,Wrigley Field,7,5
5/20/2014,2014,TB,OAK,0,3,100,1.5,-170,7.5,100,-120,-110,-1.5,150,3.75,Tropicana Field,3,-3
5/20/2014,2014,MIA,PHI,5,6,-115,-1.5,185,7.5,100,-120,105,1.5,-215,4.01,Marlins Park,11,-1
5/20/2014,2014,BAL,PIT,9,2,133,1.5,-175,7,-120,100,-148,-1.5,155,3,PNC Park,11,7
5/20/2014,2014,MIN,SD,5,3,162,1.5,-140,7,-110,-110,-182,-1.5,120,2.67,PETCO Park,8,2
5/20/2014,2014,TEX,SEA,2,6,102,1.5,-165,8.5,-120,100,-112,-1.5,145,4.21,Rangers Ballpark,8,-4
5/20/2014,2014,COL,SF,5,4,-109,1.5,-170,9.5,-120,100,-101,-1.5,150,4.95,Coors Field,9,1
5/20/2014,2014,ARI,STL,0,5,170,1.5,-135,7.5,100,-120,-190,-1.5,115,2.78,Busch Stadium,5,-5
5/20/2014,2014,OAK,TB,3,0,-110,-1.5,150,7.5,100,-120,100,1.5,-170,3.93,Tropicana Field,3,3
5/20/2014,2014,SEA,TEX,6,2,-112,-1.5,145,8.5,-120,100,102,1.5,-165,4.49,Rangers Ballpark,8,4
5/20/2014,2014,BOS,TOR,4,7,-134,-1.5,141,9.5,-115,-105,119,1.5,-160,5.44,Fenway Park,11,-3
5/20/2014,2014,CIN,WSH,4,9,-107,-1.5,155,6.5,105,-125,-103,1.5,-175,3.36,Nationals Park,13,-5
5/21/2014,2014,STL,ARI,3,2,-160,-1.5,135,7,-105,-115,145,1.5,-155,4.31,Busch Stadium,5,1
5/21/2014,2014,MIL,ATL,6,1,119,1.5,-190,6.5,-110,-110,-134,-1.5,160,2.97,Turner Field,7,5
5/21/2014,2014,PIT,BAL,9,8,-120,-1.5,170,7.5,-115,-105,110,1.5,-200,4.09,PNC Park,17,1
5/21/2014,2014,TOR,BOS,6,4,102,1.5,-200,9,-110,-110,-112,-1.5,170,4.46,Fenway Park,10,2
5/21/2014,2014,NYY,CHC,4,2,-103,1.5,-210,7.5,-120,100,-107,-1.5,180,3.81,Wrigley Field,6,2
5/21/2014,2014,WSH,CIN,1,2,-140,-1.5,160,7,-120,100,125,1.5,-180,4.08,Nationals Park,3,-1
5/21/2014,2014,DET,CLE,10,11,-151,-1.5,110,7.5,-115,-105,136,1.5,-130,4.51,Progressive Field,21,-1
5/21/2014,2014,SF,COL,5,1,119,1.5,-175,10,-115,-105,-129,-1.5,155,4.57,Coors Field,6,4
5/21/2014,2014,KC,CWS,3,1,-118,-1.5,180,8,-120,100,108,1.5,-210,4.33,Kauffman Stadium,4,2
5/21/2014,2014,CLE,DET,11,10,136,1.5,-130,7.5,-115,-105,-151,-1.5,110,3.18,Progressive Field,21,1
5/21/2014,2014,LAA,HOU,2,1,-166,-1.5,120,7.5,-115,-105,151,1.5,-140,4.68,Angel Stadium,3,1
5/21/2014,2014,CWS,KC,1,3,108,1.5,-210,8,-120,100,-118,-1.5,180,3.85,Kauffman Stadium,4,-2
5/21/2014,2014,HOU,LAA,1,2,151,1.5,-140,7.5,-115,-105,-166,-1.5,120,2.99,Angel Stadium,3,-1
5/21/2014,2014,NYM,LAD,3,4,113,1.5,-155,7,-110,-110,-123,-1.5,135,3.29,Citi Field,7,-1
5/21/2014,2014,PHI,MIA,5,14,130,1.5,-175,7.5,-110,-110,-145,-1.5,155,3.26,Marlins Park,19,-9
5/21/2014,2014,ATL,MIL,1,6,-134,-1.5,160,6.5,-110,-110,119,1.5,-190,3.72,Turner Field,7,-5
5/21/2014,2014,SD,MIN,0,2,-133,-1.5,165,6.5,-108,-112,118,1.5,-195,3.71,PETCO Park,2,-2
5/21/2014,2014,LAD,NYM,4,3,-123,-1.5,135,7,-110,-110,113,1.5,-155,3.86,Citi Field,7,1
5/21/2014,2014,CHC,NYY,2,4,-107,-1.5,180,7.5,-120,100,-103,1.5,-210,3.88,Wrigley Field,6,-2
5/21/2014,2014,TB,OAK,2,3,102,1.5,-160,7.5,-115,-105,-112,-1.5,140,3.71,Tropicana Field,5,-1
5/21/2014,2014,MIA,PHI,14,5,-145,-1.5,155,7.5,-110,-110,130,1.5,-175,4.44,Marlins Park,19,9
5/21/2014,2014,BAL,PIT,8,9,110,1.5,-200,7.5,-115,-105,-120,-1.5,170,3.57,PNC Park,17,-1
5/21/2014,2014,MIN,SD,2,0,118,1.5,-195,6.5,-108,-112,-133,-1.5,165,2.98,PETCO Park,2,2
5/21/2014,2014,TEX,SEA,4,3,-150,-1.5,140,9,-115,-105,135,1.5,-160,5.4,Rangers Ballpark,7,1
5/21/2014,2014,COL,SF,1,5,-129,-1.5,155,10,-115,-105,119,1.5,-175,5.63,Coors Field,6,-4
5/21/2014,2014,ARI,STL,2,3,145,1.5,-155,7,-105,-115,-160,-1.5,135,2.86,Busch Stadium,5,-1
5/21/2014,2014,OAK,TB,3,2,-112,-1.5,140,7.5,-115,-105,102,1.5,-160,3.96,Tropicana Field,5,1
5/21/2014,2014,SEA,TEX,3,4,135,1.5,-160,9,-115,-105,-150,-1.5,140,3.83,Rangers Ballpark,7,-1
5/21/2014,2014,BOS,TOR,4,6,-112,-1.5,170,9,-110,-110,102,1.5,-200,4.75,Fenway Park,10,-2
5/21/2014,2014,CIN,WSH,2,1,125,1.5,-180,7,-120,100,-140,-1.5,160,3.11,Nationals Park,3,1
5/22/2014,2014,STL,ARI,4,2,-156,-1.5,150,7,-115,-105,141,1.5,-170,4.27,Busch Stadium,6,2
5/22/2014,2014,MIL,ATL,4,5,127,1.5,-190,7,-120,100,-142,-1.5,160,3.08,Turner Field,9,-1
5/22/2014,2014,CLE,BAL,8,7,130,1.5,-165,9,105,-125,-145,-1.5,145,3.91,Camden Yards,15,1
5/22/2014,2014,TOR,BOS,7,2,135,1.5,-160,8.5,-113,-107,-150,-1.5,140,3.62,Fenway Park,9,5
5/22/2014,2014,SD,CHC,1,5,-140,-1.5,165,7,105,-125,125,1.5,-195,4.08,PETCO Park,6,-4
5/22/2014,2014,BAL,CLE,7,8,-145,-1.5,145,9,105,-125,130,1.5,-165,5.33,Camden Yards,15,-1
5/22/2014,2014,SF,COL,4,2,111,1.5,-190,9.5,105,-125,-121,-1.5,160,4.5,Coors Field,6,2
5/22/2014,2014,NYY,CWS,2,3,136,1.5,-160,7,-125,105,-151,-1.5,140,2.97,Guaranteed Rate Field,5,-1
5/22/2014,2014,TEX,DET,9,2,-117,-1.5,140,7.5,-110,-110,107,1.5,-165,4.04,Comerica Park,11,7
5/22/2014,2014,SEA,HOU,3,1,-164,-1.5,135,7.5,-115,-105,149,1.5,-155,4.66,T-Mobile Park,4,2
5/22/2014,2014,NYM,LAD,5,3,135,1.5,-135,7,-115,-105,-150,-1.5,115,2.98,Citi Field,8,2
5/22/2014,2014,PHI,MIA,3,4,-108,-1.5,155,7,105,-125,-102,1.5,-175,3.63,Marlins Park,7,-1
5/22/2014,2014,ATL,MIL,5,4,-142,-1.5,160,7,-120,100,127,1.5,-190,4.11,Turner Field,9,1
5/22/2014,2014,LAD,NYM,3,5,-150,-1.5,115,7,-115,-105,135,1.5,-135,4.2,Citi Field,8,-2
5/22/2014,2014,CWS,NYY,3,2,-151,-1.5,140,7,-125,105,136,1.5,-160,4.21,Guaranteed Rate Field,5,1
5/22/2014,2014,TB,OAK,5,2,-107,-1.5,190,7,-110,-110,-103,1.5,-230,3.62,Tropicana Field,7,3
5/22/2014,2014,MIA,PHI,4,3,-102,1.5,-175,7,105,-125,-108,-1.5,155,3.53,Marlins Park,7,1
5/22/2014,2014,WSH,PIT,1,3,111,1.5,-205,7.5,-105,-115,-121,-1.5,175,3.55,PNC Park,4,-2
5/22/2014,2014,CHC,SD,5,1,125,1.5,-195,7,105,-125,-140,-1.5,165,3.11,PETCO Park,6,4
5/22/2014,2014,HOU,SEA,1,3,149,1.5,-155,7.5,-115,-105,-164,-1.5,135,3.01,T-Mobile Park,4,-2
5/22/2014,2014,COL,SF,2,4,-121,-1.5,160,9.5,105,-125,111,1.5,-190,5.2,Coors Field,6,-2
5/22/2014,2014,ARI,STL,2,4,141,1.5,-170,7,-115,-105,-156,-1.5,150,2.9,Busch Stadium,6,-2
5/22/2014,2014,OAK,TB,2,5,-103,1.5,-230,7,-110,-110,-107,-1.5,190,3.55,Tropicana Field,7,-3
5/22/2014,2014,DET,TEX,2,9,107,1.5,-165,7.5,-110,-110,-117,-1.5,140,3.62,Comerica Park,11,-7
5/22/2014,2014,BOS,TOR,2,7,-150,-1.5,140,8.5,-113,-107,135,1.5,-160,5.1,Fenway Park,9,-5
5/22/2014,2014,PIT,WSH,3,1,-121,-1.5,175,7.5,-105,-115,111,1.5,-205,4.11,PNC Park,4,2
5/23/2014,2014,COL,ATL,2,3,125,1.5,-175,7.5,105,-125,-140,-1.5,155,3.33,Turner Field,5,-1
5/23/2014,2014,CLE,BAL,4,8,118,1.5,-175,8.5,-113,-107,-133,-1.5,155,3.9,Camden Yards,12,-4
5/23/2014,2014,TB,BOS,1,0,-108,-1.5,190,7,-115,-105,-102,1.5,-230,3.63,Tropicana Field,1,1
5/23/2014,2014,SD,CHC,11,1,-132,-1.5,175,6.5,-125,105,117,1.5,-205,3.7,PETCO Park,12,10
5/23/2014,2014,STL,CIN,3,5,-101,1.5,-215,7,-120,100,-109,-1.5,185,3.52,Great American Ballpark,8,-2
5/23/2014,2014,BAL,CLE,8,4,-133,-1.5,155,8.5,-113,-107,118,1.5,-175,4.85,Camden Yards,12,4
5/23/2014,2014,ATL,COL,3,2,-140,-1.5,155,7.5,105,-125,125,1.5,-175,4.38,Turner Field,5,1
5/23/2014,2014,NYY,CWS,5,6,-144,-1.5,115,8.5,-105,-115,129,1.5,-135,5.02,Guaranteed Rate Field,11,-1
5/23/2014,2014,TEX,DET,2,7,170,1.5,-130,8,-120,100,-190,-1.5,110,2.96,Comerica Park,9,-5
5/23/2014,2014,SEA,HOU,6,1,-250,-1.5,-110,6.5,-115,-105,210,1.5,-110,4.64,T-Mobile Park,7,5
5/23/2014,2014,LAA,KC,6,1,-160,-1.5,140,7,-120,100,145,1.5,-160,4.31,Angel Stadium,7,5
5/23/2014,2014,KC,LAA,1,6,145,1.5,-160,7,-120,100,-160,-1.5,140,2.86,Angel Stadium,7,-5
5/23/2014,2014,PHI,LAD,0,2,152,1.5,-115,7,-115,-105,-172,-1.5,-105,2.78,Citizens Bank Park,2,-2
5/23/2014,2014,MIL,MIA,9,5,106,1.5,-210,7,-125,105,-116,-1.5,180,3.4,Marlins Park,14,4
5/23/2014,2014,MIA,MIL,5,9,-116,-1.5,180,7,-125,105,106,1.5,-210,3.76,Marlins Park,14,-4
5/23/2014,2014,SF,MIN,6,2,-160,-1.5,140,7,-125,105,145,1.5,-160,4.31,AT&T Park,8,4
5/23/2014,2014,CWS,NYY,6,5,129,1.5,-135,8.5,-105,-115,-144,-1.5,115,3.71,Guaranteed Rate Field,11,1
5/23/2014,2014,TOR,OAK,3,2,107,1.5,-150,9.5,-102,-118,-117,-1.5,130,4.59,Rogers Centre,5,1
5/23/2014,2014,LAD,PHI,2,0,-172,-1.5,-105,7,-115,-105,152,1.5,-115,4.43,Citizens Bank Park,2,2
5/23/2014,2014,WSH,PIT,3,4,115,1.5,-205,7,105,-125,-125,-1.5,175,3.26,PNC Park,7,-1
5/23/2014,2014,CHC,SD,1,11,117,1.5,-205,6.5,-125,105,-132,-1.5,175,3,PETCO Park,12,-10
5/23/2014,2014,HOU,SEA,1,6,210,1.5,-110,6.5,-115,-105,-250,-1.5,-110,2.1,T-Mobile Park,7,-5
5/23/2014,2014,MIN,SF,2,6,145,1.5,-160,7,-125,105,-160,-1.5,140,2.86,AT&T Park,8,-4
5/23/2014,2014,CIN,STL,5,3,-109,-1.5,185,7,-120,100,-101,1.5,-215,3.65,Great American Ballpark,8,2
5/23/2014,2014,BOS,TB,0,1,-102,1.5,-230,7,-115,-105,-108,-1.5,190,3.53,Tropicana Field,1,-1
5/23/2014,2014,DET,TEX,7,2,-190,-1.5,110,8,-120,100,170,1.5,-130,5.24,Comerica Park,9,5
5/23/2014,2014,OAK,TOR,2,3,-117,-1.5,130,9.5,-102,-118,107,1.5,-150,5.12,Rogers Centre,5,-1
5/23/2014,2014,PIT,WSH,4,3,-125,-1.5,175,7,105,-125,115,1.5,-205,3.89,PNC Park,7,1
5/24/2014,2014,NYM,ARI,2,3,-115,-1.5,185,7,-120,100,105,1.5,-215,3.74,Citi Field,5,-1
5/24/2014,2014,COL,ATL,3,1,141,1.5,-165,7.5,-107,-113,-156,-1.5,145,3.11,Turner Field,4,2
5/24/2014,2014,CLE,BAL,9,0,-106,-1.5,150,8,-105,-115,-104,1.5,-170,4.12,Camden Yards,9,9
5/24/2014,2014,TB,BOS,6,5,-160,-1.5,135,6.5,-118,-102,145,1.5,-155,4,Tropicana Field,11,1
5/24/2014,2014,SD,CHC,2,3,-105,-1.5,190,6.5,-125,105,-105,1.5,-230,3.33,PETCO Park,5,-1
5/24/2014,2014,STL,CIN,6,3,-123,-1.5,140,7,-120,100,113,1.5,-160,3.86,Great American Ballpark,9,3
5/24/2014,2014,BAL,CLE,0,9,-104,1.5,-170,8,-105,-115,-106,-1.5,150,4.08,Camden Yards,9,-9
5/24/2014,2014,ATL,COL,1,3,-156,-1.5,145,7.5,-107,-113,141,1.5,-165,4.57,Turner Field,4,-2
5/24/2014,2014,NYY,CWS,4,3,-124,-1.5,135,9,105,-125,114,1.5,-155,4.98,Guaranteed Rate Field,7,1
5/24/2014,2014,TEX,DET,12,2,153,1.5,-145,9,-105,-115,-173,-1.5,125,3.56,Comerica Park,14,10
5/24/2014,2014,SEA,HOU,4,9,-115,-1.5,180,7.5,-105,-115,105,1.5,-210,4.01,T-Mobile Park,13,-5
5/24/2014,2014,LAA,KC,4,7,-105,-1.5,190,7.5,100,-120,-105,1.5,-230,3.84,Angel Stadium,11,-3
5/24/2014,2014,KC,LAA,7,4,-105,1.5,-230,7.5,100,-120,-105,-1.5,190,3.84,Angel Stadium,11,3
5/24/2014,2014,PHI,LAD,5,3,116,1.5,-145,8.5,-120,100,-131,-1.5,125,3.94,Citizens Bank Park,8,2
5/24/2014,2014,MIL,MIA,1,2,-105,1.5,-215,8,100,-120,-105,-1.5,185,4.1,Marlins Park,3,-1
5/24/2014,2014,MIA,MIL,2,1,-105,-1.5,185,8,100,-120,-105,1.5,-215,4.1,Marlins Park,3,1
5/24/2014,2014,SF,MIN,2,1,-140,-1.5,155,7.5,105,-125,125,1.5,-175,4.38,AT&T Park,3,1
5/24/2014,2014,ARI,NYM,3,2,105,1.5,-215,7,-120,100,-115,-1.5,185,3.41,Citi Field,5,1
5/24/2014,2014,CWS,NYY,3,4,114,1.5,-155,9,105,-125,-124,-1.5,135,4.21,Guaranteed Rate Field,7,-1
5/24/2014,2014,TOR,OAK,5,2,-106,-1.5,185,9,100,-120,-104,1.5,-215,4.63,Rogers Centre,7,3
5/24/2014,2014,LAD,PHI,3,5,-131,-1.5,125,8.5,-120,100,116,1.5,-145,4.82,Citizens Bank Park,8,-2
5/24/2014,2014,WSH,PIT,2,3,-110,1.5,-230,6.5,100,-120,100,-1.5,190,3.4,PNC Park,5,-1
5/24/2014,2014,CHC,SD,3,2,-105,1.5,-230,6.5,-125,105,-105,-1.5,190,3.33,PETCO Park,5,1
5/24/2014,2014,HOU,SEA,9,4,105,1.5,-210,7.5,-105,-115,-115,-1.5,180,3.66,T-Mobile Park,13,5
5/24/2014,2014,MIN,SF,1,2,125,1.5,-175,7.5,105,-125,-140,-1.5,155,3.33,AT&T Park,3,-1
5/24/2014,2014,CIN,STL,3,6,113,1.5,-160,7,-120,100,-123,-1.5,140,3.29,Great American Ballpark,9,-3
5/24/2014,2014,BOS,TB,5,6,145,1.5,-155,6.5,-118,-102,-160,-1.5,135,2.65,Tropicana Field,11,-1
5/24/2014,2014,DET,TEX,2,12,-173,-1.5,125,9,-105,-115,153,1.5,-145,5.7,Comerica Park,14,-10
5/24/2014,2014,OAK,TOR,2,5,-104,1.5,-215,9,100,-120,-106,-1.5,185,4.59,Rogers Centre,7,-3
5/24/2014,2014,PIT,WSH,3,2,100,-1.5,190,6.5,100,-120,-110,1.5,-230,3.25,PNC Park,5,1
5/25/2014,2014,NYM,ARI,1,2,101,1.5,-170,7,-120,100,-111,-1.5,150,3.48,Citi Field,3,-1
5/25/2014,2014,NYM,ARI,4,2,-121,-1.5,170,7.5,-110,-110,111,1.5,-200,4.11,Citi Field,6,2
5/25/2014,2014,COL,ATL,0,7,154,1.5,-150,7,-126,106,-169,-1.5,130,2.76,Turner Field,7,-7
5/25/2014,2014,CLE,BAL,2,4,102,1.5,-210,8.5,-120,100,-112,-1.5,180,4.21,Camden Yards,6,-2
5/25/2014,2014,TB,BOS,8,5,-121,-1.5,170,7.5,100,-120,111,1.5,-200,4.11,Tropicana Field,13,3
5/25/2014,2014,SD,CHC,4,3,-141,-1.5,165,6.5,100,-120,126,1.5,-195,3.8,PETCO Park,7,1
5/25/2014,2014,STL,CIN,4,0,-141,-1.5,125,6.5,-123,103,126,1.5,-145,3.8,Great American Ballpark,4,4
5/25/2014,2014,BAL,CLE,4,2,-112,-1.5,180,8.5,-120,100,102,1.5,-210,4.49,Camden Yards,6,2
5/25/2014,2014,ATL,COL,7,0,-169,-1.5,130,7,-126,106,154,1.5,-150,4.4,Turner Field,7,7
5/25/2014,2014,NYY,CWS,7,1,-195,-1.5,-125,7.5,-120,100,175,1.5,105,4.96,Guaranteed Rate Field,8,6
5/25/2014,2014,TEX,DET,12,4,149,1.5,-145,8.5,-120,100,-164,-1.5,125,3.41,Comerica Park,16,8
5/25/2014,2014,SEA,HOU,1,4,-139,-1.5,175,6.5,105,-125,124,1.5,-205,3.78,T-Mobile Park,5,-3
5/25/2014,2014,LAA,KC,4,3,-159,-1.5,140,8,-110,-110,144,1.5,-160,4.91,Angel Stadium,7,1
5/25/2014,2014,KC,LAA,3,4,144,1.5,-160,8,-110,-110,-159,-1.5,140,3.28,Angel Stadium,7,-1
5/25/2014,2014,PHI,LAD,0,6,103,1.5,-165,7.5,-105,-115,-113,-1.5,145,3.69,Citizens Bank Park,6,-6
5/25/2014,2014,MIL,MIA,7,1,-126,-1.5,135,8,100,-120,116,1.5,-155,4.46,Marlins Park,8,6
5/25/2014,2014,MIA,MIL,1,7,116,1.5,-155,8,100,-120,-126,-1.5,135,3.7,Marlins Park,8,-6
5/25/2014,2014,SF,MIN,8,1,-180,-1.5,125,7,-120,100,160,1.5,-145,4.5,AT&T Park,9,7
5/25/2014,2014,ARI,NYM,2,1,-111,-1.5,150,7,-120,100,101,1.5,-170,3.68,Citi Field,3,1
5/25/2014,2014,ARI,NYM,2,4,111,1.5,-200,7.5,-110,-110,-121,-1.5,170,3.55,Citi Field,6,-2
5/25/2014,2014,CWS,NYY,1,7,175,1.5,105,7.5,-120,100,-195,-1.5,-125,2.73,Guaranteed Rate Field,8,-6
5/25/2014,2014,TOR,OAK,3,1,104,1.5,-155,9.5,-120,100,-114,-1.5,135,4.66,Rogers Centre,4,2
5/25/2014,2014,LAD,PHI,6,0,-113,-1.5,145,7.5,-105,-115,103,1.5,-165,3.98,Citizens Bank Park,6,6
5/25/2014,2014,WSH,PIT,5,2,110,1.5,-215,7,-105,-115,-120,-1.5,185,3.33,PNC Park,7,3
5/25/2014,2014,CHC,SD,3,4,126,1.5,-195,6.5,100,-120,-141,-1.5,165,2.88,PETCO Park,7,-1
5/25/2014,2014,HOU,SEA,4,1,124,1.5,-205,6.5,105,-125,-139,-1.5,175,2.9,T-Mobile Park,5,3
5/25/2014,2014,MIN,SF,1,8,160,1.5,-145,7,-120,100,-180,-1.5,125,2.69,AT&T Park,9,-7
5/25/2014,2014,CIN,STL,0,4,126,1.5,-145,6.5,-123,103,-141,-1.5,125,2.88,Great American Ballpark,4,-4
5/25/2014,2014,BOS,TB,5,8,111,1.5,-200,7.5,100,-120,-121,-1.5,170,3.55,Tropicana Field,13,-3
5/25/2014,2014,DET,TEX,4,12,-164,-1.5,125,8.5,-120,100,149,1.5,-145,5.28,Comerica Park,16,-8
5/25/2014,2014,OAK,TOR,1,3,-114,-1.5,135,9.5,-120,100,104,1.5,-155,5.06,Rogers Centre,4,-2
5/25/2014,2014,PIT,WSH,2,5,-120,-1.5,185,7,-105,-115,110,1.5,-215,3.82,PNC Park,7,-3
5/26/2014,2014,SD,ARI,5,7,114,1.5,-200,8,100,-120,-124,-1.5,170,3.74,Chase Field,12,-2
5/26/2014,2014,BOS,ATL,8,6,117,1.5,-195,7,-115,-105,-132,-1.5,165,3.23,Turner Field,14,2
5/26/2014,2014,MIL,BAL,6,7,-162,-1.5,135,7.5,100,-120,147,1.5,-155,4.64,Miller Park,13,-1
5/26/2014,2014,ATL,BOS,6,8,-132,-1.5,165,7,-115,-105,117,1.5,-195,3.98,Turner Field,14,-2
5/26/2014,2014,SF,CHC,4,8,-127,-1.5,175,7,105,-125,117,1.5,-205,3.92,AT&T Park,12,-4
5/26/2014,2014,LAD,CIN,4,3,-120,-1.5,190,6,-105,-115,110,1.5,-230,3.27,Dodger Stadium,7,1
5/26/2014,2014,CWS,CLE,6,2,-118,-1.5,175,8.5,-125,105,108,1.5,-205,4.6,Guaranteed Rate Field,8,4
5/26/2014,2014,PHI,COL,9,0,-104,-1.5,180,9,-125,105,-106,1.5,-210,4.59,Citizens Bank Park,9,9
5/26/2014,2014,CLE,CWS,2,6,108,1.5,-205,8.5,-125,105,-118,-1.5,175,4.09,Guaranteed Rate Field,8,-4
